,time_between,service_time,arrival_time,start_time,end_time,wait_time,system_time,idle_time
0,0,1,0,0,1,0,1,0
1,5,3,5,5,8,0,3,4
2,6,2,11,11,13,0,2,3
3,3,1,14,14,15,0,1,1
4,1,2,15,15,17,0,2,0
5,1,2,16,17,19,1,3,0
6,3,2,19,19,21,0,2,0
7,1,2,20,21,23,1,3,0
8,4,2,24,24,26,0,2,1
9,1,1,25,26,27,1,2,0
10,3,3,28,28,31,0,3,1
11,6,2,34,34,36,0,2,3
12,3,1,37,37,38,0,1,1
13,3,1,40,40,41,0,1,2
14,6,1,46,46,47,0,1,5
15,1,2,47,47,49,0,2,0
16,4,2,51,51,53,0,2,2
17,1,2,52,53,55,1,3,0
18,3,2,55,55,57,0,2,0
19,6,1,61,61,62,0,1,4
20,4,1,65,65,66,0,1,3
21,3,1,68,68,69,0,1,2
22,6,1,74,74,75,0,1,5
23,1,2,75,75,77,0,2,0
24,5,3,80,80,83,0,3,3
25,1,2,81,83,85,2,4,0
26,4,2,85,85,87,0,2,0
27,3,2,88,88,90,0,2,1
28,2,2,90,90,92,0,2,0
29,1,1,91,92,93,1,2,0
30,4,2,95,95,97,0,2,2
31,4,1,99,99,100,0,1,2
32,6,2,105,105,107,0,2,5
33,2,3,107,107,110,0,3,0
34,1,2,108,110,112,2,4,0
35,6,1,114,114,115,0,1,2
36,5,2,119,119,121,0,2,4
37,1,2,120,121,123,1,3,0
38,1,2,121,123,125,2,4,0
39,4,3,125,125,128,0,3,0
40,3,2,128,128,130,0,2,0
41,4,1,132,132,133,0,1,2
42,1,2,133,133,135,0,2,0
43,2,3,135,135,138,0,3,0
44,4,1,139,139,140,0,1,1
45,3,3,142,142,145,0,3,2
46,1,1,143,145,146,2,3,0
47,1,3,144,146,149,2,5,0
48,2,1,146,149,150,3,4,0
49,3,2,149,150,152,1,3,0
50,3,3,152,152,155,0,3,0
51,6,3,158,158,161,0,3,3
52,6,3,164,164,167,0,3,3
53,5,1,169,169,170,0,1,2
54,5,3,174,174,177,0,3,4
55,6,2,180,180,182,0,2,3
56,6,3,186,186,189,0,3,4
57,6,1,192,192,193,0,1,3
58,6,2,198,198,200,0,2,5
59,5,2,203,203,205,0,2,3
60,1,3,204,205,208,1,4,0
61,4,2,208,208,210,0,2,0
62,3,1,211,211,212,0,1,1
63,6,2,217,217,219,0,2,5
64,4,2,221,221,223,0,2,2
65,3,1,224,224,225,0,1,1
66,6,2,230,230,232,0,2,5
67,4,2,234,234,236,0,2,2
68,5,1,239,239,240,0,1,3
69,2,1,241,241,242,0,1,1
70,5,3,246,246,249,0,3,4
71,6,2,252,252,254,0,2,3
72,3,1,255,255,256,0,1,1
73,2,3,257,257,260,0,3,1
74,5,2,262,262,264,0,2,2
75,1,1,263,264,265,1,2,0
76,5,1,268,268,269,0,1,3
77,1,1,269,269,270,0,1,0
78,4,2,273,273,275,0,2,3
79,3,2,276,276,278,0,2,1
80,6,2,282,282,284,0,2,4
81,6,2,288,288,290,0,2,4
82,6,1,294,294,295,0,1,4
83,2,1,296,296,297,0,1,1
84,6,2,302,302,304,0,2,5
85,3,2,305,305,307,0,2,1
86,3,2,308,308,310,0,2,1
87,3,1,311,311,312,0,1,1
88,5,2,316,316,318,0,2,4
89,3,3,319,319,322,0,3,1
90,4,1,323,323,324,0,1,1
91,2,1,325,325,326,0,1,1
92,2,2,327,327,329,0,2,1
93,5,2,332,332,334,0,2,3
94,3,3,335,335,338,0,3,1
95,6,2,341,341,343,0,2,3
96,2,1,343,343,344,0,1,0
97,6,2,349,349,351,0,2,5
98,5,2,354,354,356,0,2,3
99,2,3,356,356,359,0,3,0
100,3,3,359,359,362,0,3,0
101,5,3,364,364,367,0,3,2
102,1,3,365,367,370,2,5,0
103,4,1,369,370,371,1,2,0
104,5,1,374,374,375,0,1,3
105,5,2,379,379,381,0,2,4
106,4,3,383,383,386,0,3,2
107,1,1,384,386,387,2,3,0
108,4,1,388,388,389,0,1,1
109,4,2,392,392,394,0,2,3
110,5,2,397,397,399,0,2,3
111,3,2,400,400,402,0,2,1
112,5,3,405,405,408,0,3,3
113,2,2,407,408,410,1,3,0
114,4,3,411,411,414,0,3,1
115,5,1,416,416,417,0,1,2
116,2,3,418,418,421,0,3,1
117,5,2,423,423,425,0,2,2
118,6,2,429,429,431,0,2,4
119,6,1,435,435,436,0,1,4
120,2,1,437,437,438,0,1,1
121,2,2,439,439,441,0,2,1
122,3,3,442,442,445,0,3,1
123,4,1,446,446,447,0,1,1
124,5,3,451,451,454,0,3,4
125,4,1,455,455,456,0,1,1
126,3,1,458,458,459,0,1,2
127,5,2,463,463,465,0,2,4
128,2,2,465,465,467,0,2,0
129,5,3,470,470,473,0,3,3
130,6,3,476,476,479,0,3,3
131,1,3,477,479,482,2,5,0
132,4,3,481,482,485,1,4,0
133,5,3,486,486,489,0,3,1
134,2,2,488,489,491,1,3,0
135,1,2,489,491,493,2,4,0
136,1,2,490,493,495,3,5,0
137,6,3,496,496,499,0,3,1
138,3,3,499,499,502,0,3,0
139,5,2,504,504,506,0,2,2
140,5,3,509,509,512,0,3,3
141,6,1,515,515,516,0,1,3
142,3,1,518,518,519,0,1,2
143,5,2,523,523,525,0,2,4
144,2,3,525,525,528,0,3,0
145,4,2,529,529,531,0,2,1
146,2,2,531,531,533,0,2,0
147,4,1,535,535,536,0,1,2
148,3,2,538,538,540,0,2,2
149,3,3,541,541,544,0,3,1
150,2,2,543,544,546,1,3,0
151,2,2,545,546,548,1,3,0
152,5,2,550,550,552,0,2,2
153,6,3,556,556,559,0,3,4
154,5,1,561,561,562,0,1,2
155,6,2,567,567,569,0,2,5
156,3,2,570,570,572,0,2,1
157,2,1,572,572,573,0,1,0
158,2,3,574,574,577,0,3,1
159,1,2,575,577,579,2,4,0
160,1,2,576,579,581,3,5,0
161,3,2,579,581,583,2,4,0
162,3,3,582,583,586,1,4,0
163,5,2,587,587,589,0,2,1
164,5,3,592,592,595,0,3,3
165,1,3,593,595,598,2,5,0
166,6,3,599,599,602,0,3,1
167,1,1,600,602,603,2,3,0
168,6,2,606,606,608,0,2,3
169,2,2,608,608,610,0,2,0
170,1,1,609,610,611,1,2,0
171,4,2,613,613,615,0,2,2
172,6,3,619,619,622,0,3,4
173,6,3,625,625,628,0,3,3
174,3,1,628,628,629,0,1,0
175,1,2,629,629,631,0,2,0
176,4,3,633,633,636,0,3,2
177,6,2,639,639,641,0,2,3
178,1,3,640,641,644,1,4,0
179,6,2,646,646,648,0,2,2
180,3,3,649,649,652,0,3,1
181,5,3,654,654,657,0,3,2
182,4,3,658,658,661,0,3,1
183,5,3,663,663,666,0,3,2
184,1,2,664,666,668,2,4,0
185,6,2,670,670,672,0,2,2
186,2,3,672,672,675,0,3,0
187,4,1,676,676,677,0,1,1
188,5,2,681,681,683,0,2,4
189,2,2,683,683,685,0,2,0
190,6,2,689,689,691,0,2,4
191,5,3,694,694,697,0,3,3
192,5,1,699,699,700,0,1,2
193,2,1,701,701,702,0,1,1
194,1,3,702,702,705,0,3,0
195,6,3,708,708,711,0,3,3
196,5,3,713,713,716,0,3,2
197,5,2,718,718,720,0,2,2
198,4,1,722,722,723,0,1,2
199,3,3,725,725,728,0,3,2
200,6,3,731,731,734,0,3,3
201,5,2,736,736,738,0,2,2
202,4,1,740,740,741,0,1,2
203,1,2,741,741,743,0,2,0
204,6,2,747,747,749,0,2,4
205,6,2,753,753,755,0,2,4
206,4,2,757,757,759,0,2,2
207,4,1,761,761,762,0,1,2
208,4,2,765,765,767,0,2,3
209,6,1,771,771,772,0,1,4
210,6,3,777,777,780,0,3,5
211,1,2,778,780,782,2,4,0
212,2,1,780,782,783,2,3,0
213,3,1,783,783,784,0,1,0
214,3,2,786,786,788,0,2,2
215,4,2,790,790,792,0,2,2
216,3,2,793,793,795,0,2,1
217,4,2,797,797,799,0,2,2
218,5,2,802,802,804,0,2,3
219,6,2,808,808,810,0,2,4
220,2,2,810,810,812,0,2,0
221,4,3,814,814,817,0,3,2
222,3,3,817,817,820,0,3,0
223,2,3,819,820,823,1,4,0
224,5,2,824,824,826,0,2,1
225,1,1,825,826,827,1,2,0
226,3,3,828,828,831,0,3,1
227,2,3,830,831,834,1,4,0
228,5,1,835,835,836,0,1,1
229,6,3,841,841,844,0,3,5
230,5,1,846,846,847,0,1,2
231,3,2,849,849,851,0,2,2
232,1,3,850,851,854,1,4,0
233,1,1,851,854,855,3,4,0
234,1,1,852,855,856,3,4,0
235,6,2,858,858,860,0,2,2
236,1,1,859,860,861,1,2,0
237,5,2,864,864,866,0,2,3
238,6,1,870,870,871,0,1,4
239,6,2,876,876,878,0,2,5
240,3,3,879,879,882,0,3,1
241,2,3,881,882,885,1,4,0
242,2,2,883,885,887,2,4,0
243,4,2,887,887,889,0,2,0
244,5,3,892,892,895,0,3,3
245,3,2,895,895,897,0,2,0
246,6,1,901,901,902,0,1,4
247,1,2,902,902,904,0,2,0
248,4,3,906,906,909,0,3,2
249,5,3,911,911,914,0,3,2
250,5,1,916,916,917,0,1,2
251,3,2,919,919,921,0,2,2
252,6,1,925,925,926,0,1,4
253,6,3,931,931,934,0,3,5
254,1,2,932,934,936,2,4,0
255,1,2,933,936,938,3,5,0
256,4,1,937,938,939,1,2,0
257,1,3,938,939,942,1,4,0
258,1,1,939,942,943,3,4,0
259,4,3,943,943,946,0,3,0
260,2,2,945,946,948,1,3,0
261,5,2,950,950,952,0,2,2
262,3,2,953,953,955,0,2,1
263,1,3,954,955,958,1,4,0
264,5,2,959,959,961,0,2,1
265,4,3,963,963,966,0,3,2
266,2,1,965,966,967,1,2,0
267,6,2,971,971,973,0,2,4
268,6,2,977,977,979,0,2,4
269,4,1,981,981,982,0,1,2
270,6,1,987,987,988,0,1,5
271,5,1,992,992,993,0,1,4
272,1,1,993,993,994,0,1,0
273,1,2,994,994,996,0,2,0
274,6,1,1000,1000,1001,0,1,4
275,2,3,1002,1002,1005,0,3,1
276,3,1,1005,1005,1006,0,1,0
277,1,1,1006,1006,1007,0,1,0
278,4,1,1010,1010,1011,0,1,3
279,1,3,1011,1011,1014,0,3,0
280,6,2,1017,1017,1019,0,2,3
281,2,3,1019,1019,1022,0,3,0
282,2,3,1021,1022,1025,1,4,0
283,1,1,1022,1025,1026,3,4,0
284,3,1,1025,1026,1027,1,2,0
285,3,3,1028,1028,1031,0,3,1
286,4,2,1032,1032,1034,0,2,1
287,3,2,1035,1035,1037,0,2,1
288,6,1,1041,1041,1042,0,1,4
289,3,1,1044,1044,1045,0,1,2
290,2,1,1046,1046,1047,0,1,1
291,3,3,1049,1049,1052,0,3,2
292,1,1,1050,1052,1053,2,3,0
293,3,3,1053,1053,1056,0,3,0
294,4,2,1057,1057,1059,0,2,1
295,4,1,1061,1061,1062,0,1,2
296,1,3,1062,1062,1065,0,3,0
297,3,2,1065,1065,1067,0,2,0
298,1,1,1066,1067,1068,1,2,0
299,1,1,1067,1068,1069,1,2,0
300,6,2,1073,1073,1075,0,2,4
301,3,1,1076,1076,1077,0,1,1
302,2,3,1078,1078,1081,0,3,1
303,2,1,1080,1081,1082,1,2,0
304,6,3,1086,1086,1089,0,3,4
305,5,3,1091,1091,1094,0,3,2
306,2,3,1093,1094,1097,1,4,0
307,5,1,1098,1098,1099,0,1,1
308,3,2,1101,1101,1103,0,2,2
309,6,2,1107,1107,1109,0,2,4
310,1,3,1108,1109,1112,1,4,0
311,6,1,1114,1114,1115,0,1,2
312,2,3,1116,1116,1119,0,3,1
313,2,2,1118,1119,1121,1,3,0
314,3,2,1121,1121,1123,0,2,0
315,5,3,1126,1126,1129,0,3,3
316,5,3,1131,1131,1134,0,3,2
317,2,2,1133,1134,1136,1,3,0
318,5,2,1138,1138,1140,0,2,2
319,6,2,1144,1144,1146,0,2,4
320,5,1,1149,1149,1150,0,1,3
321,1,1,1150,1150,1151,0,1,0
322,3,3,1153,1153,1156,0,3,2
323,2,2,1155,1156,1158,1,3,0
324,5,1,1160,1160,1161,0,1,2
325,3,3,1163,1163,1166,0,3,2
326,1,1,1164,1166,1167,2,3,0
327,6,1,1170,1170,1171,0,1,3
328,2,1,1172,1172,1173,0,1,1
329,4,3,1176,1176,1179,0,3,3
330,2,1,1178,1179,1180,1,2,0
331,2,2,1180,1180,1182,0,2,0
332,6,3,1186,1186,1189,0,3,4
333,5,1,1191,1191,1192,0,1,2
334,2,2,1193,1193,1195,0,2,1
335,2,2,1195,1195,1197,0,2,0
336,4,2,1199,1199,1201,0,2,2
337,2,3,1201,1201,1204,0,3,0
338,6,1,1207,1207,1208,0,1,3
339,4,3,1211,1211,1214,0,3,3
340,1,1,1212,1214,1215,2,3,0
341,6,3,1218,1218,1221,0,3,3
342,1,2,1219,1221,1223,2,4,0
343,1,2,1220,1223,1225,3,5,0
344,2,3,1222,1225,1228,3,6,0
345,2,1,1224,1228,1229,4,5,0
346,5,1,1229,1229,1230,0,1,0
347,4,2,1233,1233,1235,0,2,3
348,1,1,1234,1235,1236,1,2,0
349,5,2,1239,1239,1241,0,2,3
350,3,2,1242,1242,1244,0,2,1
351,3,2,1245,1245,1247,0,2,1
352,1,3,1246,1247,1250,1,4,0
353,3,3,1249,1250,1253,1,4,0
354,2,2,1251,1253,1255,2,4,0
355,2,3,1253,1255,1258,2,5,0
356,1,1,1254,1258,1259,4,5,0
357,6,1,1260,1260,1261,0,1,1
358,3,1,1263,1263,1264,0,1,2
359,5,2,1268,1268,1270,0,2,4
360,5,1,1273,1273,1274,0,1,3
361,5,2,1278,1278,1280,0,2,4
362,4,2,1282,1282,1284,0,2,2
363,6,3,1288,1288,1291,0,3,4
364,5,1,1293,1293,1294,0,1,2
365,5,2,1298,1298,1300,0,2,4
366,1,2,1299,1300,1302,1,3,0
367,3,3,1302,1302,1305,0,3,0
368,2,3,1304,1305,1308,1,4,0
369,1,1,1305,1308,1309,3,4,0
370,6,1,1311,1311,1312,0,1,2
371,4,1,1315,1315,1316,0,1,3
372,2,1,1317,1317,1318,0,1,1
373,4,1,1321,1321,1322,0,1,3
374,2,3,1323,1323,1326,0,3,1
375,6,2,1329,1329,1331,0,2,3
376,2,2,1331,1331,1333,0,2,0
377,1,1,1332,1333,1334,1,2,0
378,3,1,1335,1335,1336,0,1,1
379,1,2,1336,1336,1338,0,2,0
380,4,3,1340,1340,1343,0,3,2
381,1,2,1341,1343,1345,2,4,0
382,1,2,1342,1345,1347,3,5,0
383,3,3,1345,1347,1350,2,5,0
384,5,2,1350,1350,1352,0,2,0
385,3,2,1353,1353,1355,0,2,1
386,5,2,1358,1358,1360,0,2,3
387,5,2,1363,1363,1365,0,2,3
388,1,1,1364,1365,1366,1,2,0
389,5,3,1369,1369,1372,0,3,3
390,2,3,1371,1372,1375,1,4,0
391,3,3,1374,1375,1378,1,4,0
392,1,3,1375,1378,1381,3,6,0
393,6,3,1381,1381,1384,0,3,0
394,1,1,1382,1384,1385,2,3,0
395,4,3,1386,1386,1389,0,3,1
396,6,3,1392,1392,1395,0,3,3
397,5,1,1397,1397,1398,0,1,2
398,4,3,1401,1401,1404,0,3,3
399,6,3,1407,1407,1410,0,3,3
400,4,2,1411,1411,1413,0,2,1
401,6,1,1417,1417,1418,0,1,4
402,3,1,1420,1420,1421,0,1,2
403,3,1,1423,1423,1424,0,1,2
404,3,2,1426,1426,1428,0,2,2
405,3,1,1429,1429,1430,0,1,1
406,1,3,1430,1430,1433,0,3,0
407,4,2,1434,1434,1436,0,2,1
408,5,1,1439,1439,1440,0,1,3
409,3,3,1442,1442,1445,0,3,2
410,4,1,1446,1446,1447,0,1,1
411,2,3,1448,1448,1451,0,3,1
412,5,3,1453,1453,1456,0,3,2
413,3,3,1456,1456,1459,0,3,0
414,2,2,1458,1459,1461,1,3,0
415,6,3,1464,1464,1467,0,3,3
416,5,3,1469,1469,1472,0,3,2
417,1,2,1470,1472,1474,2,4,0
418,2,1,1472,1474,1475,2,3,0
419,5,3,1477,1477,1480,0,3,2
420,3,1,1480,1480,1481,0,1,0
421,3,2,1483,1483,1485,0,2,2
422,4,1,1487,1487,1488,0,1,2
423,2,1,1489,1489,1490,0,1,1
424,3,3,1492,1492,1495,0,3,2
425,1,1,1493,1495,1496,2,3,0
426,4,3,1497,1497,1500,0,3,1
427,6,3,1503,1503,1506,0,3,3
428,4,3,1507,1507,1510,0,3,1
429,6,1,1513,1513,1514,0,1,3
430,3,1,1516,1516,1517,0,1,2
431,6,1,1522,1522,1523,0,1,5
432,4,3,1526,1526,1529,0,3,3
433,4,2,1530,1530,1532,0,2,1
434,1,3,1531,1532,1535,1,4,0
435,2,3,1533,1535,1538,2,5,0
436,1,3,1534,1538,1541,4,7,0
437,4,3,1538,1541,1544,3,6,0
438,1,3,1539,1544,1547,5,8,0
439,6,2,1545,1547,1549,2,4,0
440,1,3,1546,1549,1552,3,6,0
441,2,3,1548,1552,1555,4,7,0
442,6,1,1554,1555,1556,1,2,0
443,6,1,1560,1560,1561,0,1,4
444,3,1,1563,1563,1564,0,1,2
445,6,2,1569,1569,1571,0,2,5
446,6,3,1575,1575,1578,0,3,4
447,2,1,1577,1578,1579,1,2,0
448,4,3,1581,1581,1584,0,3,2
449,4,3,1585,1585,1588,0,3,1
450,3,3,1588,1588,1591,0,3,0
451,6,1,1594,1594,1595,0,1,3
452,4,3,1598,1598,1601,0,3,3
453,4,3,1602,1602,1605,0,3,1
454,1,3,1603,1605,1608,2,5,0
455,6,1,1609,1609,1610,0,1,1
456,5,1,1614,1614,1615,0,1,4
457,4,1,1618,1618,1619,0,1,3
458,2,1,1620,1620,1621,0,1,1
459,1,1,1621,1621,1622,0,1,0
460,1,1,1622,1622,1623,0,1,0
461,6,1,1628,1628,1629,0,1,5
462,6,1,1634,1634,1635,0,1,5
463,6,2,1640,1640,1642,0,2,5
464,6,2,1646,1646,1648,0,2,4
465,4,2,1650,1650,1652,0,2,2
466,6,1,1656,1656,1657,0,1,4
467,6,2,1662,1662,1664,0,2,5
468,1,1,1663,1664,1665,1,2,0
469,1,2,1664,1665,1667,1,3,0
470,3,3,1667,1667,1670,0,3,0
471,2,1,1669,1670,1671,1,2,0
472,1,3,1670,1671,1674,1,4,0
473,3,1,1673,1674,1675,1,2,0
474,2,3,1675,1675,1678,0,3,0
475,3,2,1678,1678,1680,0,2,0
476,2,3,1680,1680,1683,0,3,0
477,3,3,1683,1683,1686,0,3,0
478,2,1,1685,1686,1687,1,2,0
479,3,3,1688,1688,1691,0,3,1
480,2,1,1690,1691,1692,1,2,0
481,1,1,1691,1692,1693,1,2,0
482,3,2,1694,1694,1696,0,2,1
483,6,3,1700,1700,1703,0,3,4
484,2,2,1702,1703,1705,1,3,0
485,4,3,1706,1706,1709,0,3,1
486,1,2,1707,1709,1711,2,4,0
487,3,1,1710,1711,1712,1,2,0
488,4,3,1714,1714,1717,0,3,2
489,5,2,1719,1719,1721,0,2,2
490,4,3,1723,1723,1726,0,3,2
491,5,2,1728,1728,1730,0,2,2
492,4,3,1732,1732,1735,0,3,2
493,5,3,1737,1737,1740,0,3,2
494,3,3,1740,1740,1743,0,3,0
495,1,2,1741,1743,1745,2,4,0
496,3,2,1744,1745,1747,1,3,0
497,4,2,1748,1748,1750,0,2,1
498,1,3,1749,1750,1753,1,4,0
499,3,1,1752,1753,1754,1,2,0
500,6,2,1758,1758,1760,0,2,4
501,5,3,1763,1763,1766,0,3,3
502,2,2,1765,1766,1768,1,3,0
503,2,2,1767,1768,1770,1,3,0
504,6,2,1773,1773,1775,0,2,3
505,1,1,1774,1775,1776,1,2,0
506,2,2,1776,1776,1778,0,2,0
507,1,3,1777,1778,1781,1,4,0
508,2,1,1779,1781,1782,2,3,0
509,5,3,1784,1784,1787,0,3,2
510,2,3,1786,1787,1790,1,4,0
511,2,1,1788,1790,1791,2,3,0
512,1,2,1789,1791,1793,2,4,0
513,4,3,1793,1793,1796,0,3,0
514,2,3,1795,1796,1799,1,4,0
515,6,2,1801,1801,1803,0,2,2
516,1,2,1802,1803,1805,1,3,0
517,4,3,1806,1806,1809,0,3,1
518,6,2,1812,1812,1814,0,2,3
519,3,3,1815,1815,1818,0,3,1
520,4,1,1819,1819,1820,0,1,1
521,4,1,1823,1823,1824,0,1,3
522,2,1,1825,1825,1826,0,1,1
523,5,3,1830,1830,1833,0,3,4
524,4,3,1834,1834,1837,0,3,1
525,2,2,1836,1837,1839,1,3,0
526,4,1,1840,1840,1841,0,1,1
527,4,2,1844,1844,1846,0,2,3
528,3,3,1847,1847,1850,0,3,1
529,6,3,1853,1853,1856,0,3,3
530,5,2,1858,1858,1860,0,2,2
531,4,1,1862,1862,1863,0,1,2
532,4,2,1866,1866,1868,0,2,3
533,4,2,1870,1870,1872,0,2,2
534,6,3,1876,1876,1879,0,3,4
535,3,3,1879,1879,1882,0,3,0
536,4,1,1883,1883,1884,0,1,1
537,4,2,1887,1887,1889,0,2,3
538,5,1,1892,1892,1893,0,1,3
539,3,1,1895,1895,1896,0,1,2
540,2,2,1897,1897,1899,0,2,1
541,6,1,1903,1903,1904,0,1,4
542,2,2,1905,1905,1907,0,2,1
543,4,2,1909,1909,1911,0,2,2
544,4,3,1913,1913,1916,0,3,2
545,4,3,1917,1917,1920,0,3,1
546,1,3,1918,1920,1923,2,5,0
547,5,1,1923,1923,1924,0,1,0
548,3,3,1926,1926,1929,0,3,2
549,4,2,1930,1930,1932,0,2,1
550,1,3,1931,1932,1935,1,4,0
551,1,1,1932,1935,1936,3,4,0
552,2,3,1934,1936,1939,2,5,0
553,4,2,1938,1939,1941,1,3,0
554,6,1,1944,1944,1945,0,1,3
555,6,3,1950,1950,1953,0,3,5
556,3,2,1953,1953,1955,0,2,0
557,2,1,1955,1955,1956,0,1,0
558,3,2,1958,1958,1960,0,2,2
559,5,2,1963,1963,1965,0,2,3
560,4,1,1967,1967,1968,0,1,2
561,1,1,1968,1968,1969,0,1,0
562,2,2,1970,1970,1972,0,2,1
563,4,3,1974,1974,1977,0,3,2
564,5,2,1979,1979,1981,0,2,2
565,5,3,1984,1984,1987,0,3,3
566,6,1,1990,1990,1991,0,1,3
567,2,2,1992,1992,1994,0,2,1
568,3,1,1995,1995,1996,0,1,1
569,6,1,2001,2001,2002,0,1,5
570,3,1,2004,2004,2005,0,1,2
571,6,2,2010,2010,2012,0,2,5
572,4,2,2014,2014,2016,0,2,2
573,3,1,2017,2017,2018,0,1,1
574,4,1,2021,2021,2022,0,1,3
575,1,2,2022,2022,2024,0,2,0
576,5,3,2027,2027,2030,0,3,3
577,6,3,2033,2033,2036,0,3,3
578,5,1,2038,2038,2039,0,1,2
579,5,1,2043,2043,2044,0,1,4
580,3,3,2046,2046,2049,0,3,2
581,5,2,2051,2051,2053,0,2,2
582,5,1,2056,2056,2057,0,1,3
583,6,1,2062,2062,2063,0,1,5
584,2,3,2064,2064,2067,0,3,1
585,6,1,2070,2070,2071,0,1,3
586,6,3,2076,2076,2079,0,3,5
587,6,3,2082,2082,2085,0,3,3
588,4,2,2086,2086,2088,0,2,1
589,1,1,2087,2088,2089,1,2,0
590,2,2,2089,2089,2091,0,2,0
591,6,2,2095,2095,2097,0,2,4
592,6,3,2101,2101,2104,0,3,4
593,5,3,2106,2106,2109,0,3,2
594,6,1,2112,2112,2113,0,1,3
595,2,3,2114,2114,2117,0,3,1
596,1,2,2115,2117,2119,2,4,0
597,5,3,2120,2120,2123,0,3,1
598,2,2,2122,2123,2125,1,3,0
599,3,3,2125,2125,2128,0,3,0
600,1,2,2126,2128,2130,2,4,0
601,3,1,2129,2130,2131,1,2,0
602,3,1,2132,2132,2133,0,1,1
603,4,2,2136,2136,2138,0,2,3
604,5,1,2141,2141,2142,0,1,3
605,6,2,2147,2147,2149,0,2,5
606,6,2,2153,2153,2155,0,2,4
607,3,3,2156,2156,2159,0,3,1
608,4,2,2160,2160,2162,0,2,1
609,3,3,2163,2163,2166,0,3,1
610,6,2,2169,2169,2171,0,2,3
611,1,3,2170,2171,2174,1,4,0
612,1,3,2171,2174,2177,3,6,0
613,5,3,2176,2177,2180,1,4,0
614,4,2,2180,2180,2182,0,2,0
615,3,2,2183,2183,2185,0,2,1
616,2,3,2185,2185,2188,0,3,0
617,2,3,2187,2188,2191,1,4,0
618,1,2,2188,2191,2193,3,5,0
619,2,1,2190,2193,2194,3,4,0
620,1,2,2191,2194,2196,3,5,0
621,4,1,2195,2196,2197,1,2,0
622,4,3,2199,2199,2202,0,3,2
623,4,2,2203,2203,2205,0,2,1
624,2,2,2205,2205,2207,0,2,0
625,5,3,2210,2210,2213,0,3,3
626,1,1,2211,2213,2214,2,3,0
627,1,3,2212,2214,2217,2,5,0
628,2,2,2214,2217,2219,3,5,0
629,1,3,2215,2219,2222,4,7,0
630,4,1,2219,2222,2223,3,4,0
631,3,1,2222,2223,2224,1,2,0
632,5,1,2227,2227,2228,0,1,3
633,6,1,2233,2233,2234,0,1,5
634,2,2,2235,2235,2237,0,2,1
635,4,3,2239,2239,2242,0,3,2
636,6,3,2245,2245,2248,0,3,3
637,5,3,2250,2250,2253,0,3,2
638,4,2,2254,2254,2256,0,2,1
639,5,2,2259,2259,2261,0,2,3
640,3,3,2262,2262,2265,0,3,1
641,3,1,2265,2265,2266,0,1,0
642,5,1,2270,2270,2271,0,1,4
643,5,1,2275,2275,2276,0,1,4
644,1,1,2276,2276,2277,0,1,0
645,6,3,2282,2282,2285,0,3,5
646,4,1,2286,2286,2287,0,1,1
647,4,1,2290,2290,2291,0,1,3
648,2,3,2292,2292,2295,0,3,1
649,1,3,2293,2295,2298,2,5,0
650,2,2,2295,2298,2300,3,5,0
651,6,1,2301,2301,2302,0,1,1
652,4,2,2305,2305,2307,0,2,3
653,4,3,2309,2309,2312,0,3,2
654,2,2,2311,2312,2314,1,3,0
655,4,1,2315,2315,2316,0,1,1
656,3,2,2318,2318,2320,0,2,2
657,2,3,2320,2320,2323,0,3,0
658,6,3,2326,2326,2329,0,3,3
659,2,3,2328,2329,2332,1,4,0
660,4,2,2332,2332,2334,0,2,0
661,3,1,2335,2335,2336,0,1,1
662,6,2,2341,2341,2343,0,2,5
663,4,1,2345,2345,2346,0,1,2
664,5,2,2350,2350,2352,0,2,4
665,1,3,2351,2352,2355,1,4,0
666,5,3,2356,2356,2359,0,3,1
667,4,3,2360,2360,2363,0,3,1
668,6,1,2366,2366,2367,0,1,3
669,3,2,2369,2369,2371,0,2,2
670,2,1,2371,2371,2372,0,1,0
671,4,2,2375,2375,2377,0,2,3
672,3,1,2378,2378,2379,0,1,1
673,4,2,2382,2382,2384,0,2,3
674,6,3,2388,2388,2391,0,3,4
675,2,3,2390,2391,2394,1,4,0
676,6,1,2396,2396,2397,0,1,2
677,5,2,2401,2401,2403,0,2,4
678,4,3,2405,2405,2408,0,3,2
679,6,2,2411,2411,2413,0,2,3
680,2,3,2413,2413,2416,0,3,0
681,6,3,2419,2419,2422,0,3,3
682,5,2,2424,2424,2426,0,2,2
683,4,1,2428,2428,2429,0,1,2
684,2,2,2430,2430,2432,0,2,1
685,1,2,2431,2432,2434,1,3,0
686,4,3,2435,2435,2438,0,3,1
687,6,3,2441,2441,2444,0,3,3
688,6,2,2447,2447,2449,0,2,3
689,3,1,2450,2450,2451,0,1,1
690,2,2,2452,2452,2454,0,2,1
691,2,1,2454,2454,2455,0,1,0
692,2,3,2456,2456,2459,0,3,1
693,6,1,2462,2462,2463,0,1,3
694,6,3,2468,2468,2471,0,3,5
695,2,2,2470,2471,2473,1,3,0
696,4,1,2474,2474,2475,0,1,1
697,4,3,2478,2478,2481,0,3,3
698,3,3,2481,2481,2484,0,3,0
699,3,3,2484,2484,2487,0,3,0
700,3,3,2487,2487,2490,0,3,0
701,1,2,2488,2490,2492,2,4,0
702,5,1,2493,2493,2494,0,1,1
703,2,2,2495,2495,2497,0,2,1
704,6,3,2501,2501,2504,0,3,4
705,2,2,2503,2504,2506,1,3,0
706,5,1,2508,2508,2509,0,1,2
707,6,1,2514,2514,2515,0,1,5
708,1,1,2515,2515,2516,0,1,0
709,1,2,2516,2516,2518,0,2,0
710,3,1,2519,2519,2520,0,1,1
711,5,3,2524,2524,2527,0,3,4
712,4,1,2528,2528,2529,0,1,1
713,4,3,2532,2532,2535,0,3,3
714,1,3,2533,2535,2538,2,5,0
715,1,2,2534,2538,2540,4,6,0
716,3,1,2537,2540,2541,3,4,0
717,2,3,2539,2541,2544,2,5,0
718,6,2,2545,2545,2547,0,2,1
719,1,1,2546,2547,2548,1,2,0
720,2,1,2548,2548,2549,0,1,0
721,5,1,2553,2553,2554,0,1,4
722,6,1,2559,2559,2560,0,1,5
723,4,1,2563,2563,2564,0,1,3
724,5,2,2568,2568,2570,0,2,4
725,4,1,2572,2572,2573,0,1,2
726,1,3,2573,2573,2576,0,3,0
727,5,2,2578,2578,2580,0,2,2
728,4,3,2582,2582,2585,0,3,2
729,5,1,2587,2587,2588,0,1,2
730,5,2,2592,2592,2594,0,2,4
731,4,1,2596,2596,2597,0,1,2
732,4,2,2600,2600,2602,0,2,3
733,2,2,2602,2602,2604,0,2,0
734,3,1,2605,2605,2606,0,1,1
735,1,2,2606,2606,2608,0,2,0
736,4,1,2610,2610,2611,0,1,2
737,1,3,2611,2611,2614,0,3,0
738,2,1,2613,2614,2615,1,2,0
739,6,2,2619,2619,2621,0,2,4
740,3,1,2622,2622,2623,0,1,1
741,4,2,2626,2626,2628,0,2,3
742,2,2,2628,2628,2630,0,2,0
743,1,3,2629,2630,2633,1,4,0
744,6,3,2635,2635,2638,0,3,2
745,4,2,2639,2639,2641,0,2,1
746,6,3,2645,2645,2648,0,3,4
747,5,3,2650,2650,2653,0,3,2
748,1,1,2651,2653,2654,2,3,0
749,4,2,2655,2655,2657,0,2,1
750,2,1,2657,2657,2658,0,1,0
751,4,1,2661,2661,2662,0,1,3
752,2,3,2663,2663,2666,0,3,1
753,6,3,2669,2669,2672,0,3,3
754,6,3,2675,2675,2678,0,3,3
755,6,3,2681,2681,2684,0,3,3
756,6,2,2687,2687,2689,0,2,3
757,2,1,2689,2689,2690,0,1,0
758,2,2,2691,2691,2693,0,2,1
759,4,2,2695,2695,2697,0,2,2
760,4,3,2699,2699,2702,0,3,2
761,3,2,2702,2702,2704,0,2,0
762,6,3,2708,2708,2711,0,3,4
763,5,2,2713,2713,2715,0,2,2
764,2,3,2715,2715,2718,0,3,0
765,4,2,2719,2719,2721,0,2,1
766,1,2,2720,2721,2723,1,3,0
767,4,2,2724,2724,2726,0,2,1
768,6,2,2730,2730,2732,0,2,4
769,6,3,2736,2736,2739,0,3,4
770,2,2,2738,2739,2741,1,3,0
771,6,3,2744,2744,2747,0,3,3
772,1,3,2745,2747,2750,2,5,0
773,2,3,2747,2750,2753,3,6,0
774,1,2,2748,2753,2755,5,7,0
775,4,2,2752,2755,2757,3,5,0
776,1,1,2753,2757,2758,4,5,0
777,4,2,2757,2758,2760,1,3,0
778,4,2,2761,2761,2763,0,2,1
779,4,3,2765,2765,2768,0,3,2
780,3,1,2768,2768,2769,0,1,0
781,3,3,2771,2771,2774,0,3,2
782,1,2,2772,2774,2776,2,4,0
783,6,1,2778,2778,2779,0,1,2
784,3,1,2781,2781,2782,0,1,2
785,6,2,2787,2787,2789,0,2,5
786,6,2,2793,2793,2795,0,2,4
787,5,2,2798,2798,2800,0,2,3
788,2,2,2800,2800,2802,0,2,0
789,1,3,2801,2802,2805,1,4,0
790,6,3,2807,2807,2810,0,3,2
791,6,1,2813,2813,2814,0,1,3
792,5,1,2818,2818,2819,0,1,4
793,1,3,2819,2819,2822,0,3,0
794,5,3,2824,2824,2827,0,3,2
795,1,2,2825,2827,2829,2,4,0
796,2,3,2827,2829,2832,2,5,0
797,3,3,2830,2832,2835,2,5,0
798,3,2,2833,2835,2837,2,4,0
799,1,1,2834,2837,2838,3,4,0
800,2,2,2836,2838,2840,2,4,0
801,4,1,2840,2840,2841,0,1,0
802,6,3,2846,2846,2849,0,3,5
803,3,1,2849,2849,2850,0,1,0
804,6,2,2855,2855,2857,0,2,5
805,5,1,2860,2860,2861,0,1,3
806,2,2,2862,2862,2864,0,2,1
807,6,1,2868,2868,2869,0,1,4
808,5,1,2873,2873,2874,0,1,4
809,1,2,2874,2874,2876,0,2,0
810,1,3,2875,2876,2879,1,4,0
811,5,3,2880,2880,2883,0,3,1
812,1,1,2881,2883,2884,2,3,0
813,4,3,2885,2885,2888,0,3,1
814,2,2,2887,2888,2890,1,3,0
815,3,3,2890,2890,2893,0,3,0
816,4,1,2894,2894,2895,0,1,1
817,2,3,2896,2896,2899,0,3,1
818,6,2,2902,2902,2904,0,2,3
819,1,1,2903,2904,2905,1,2,0
820,1,2,2904,2905,2907,1,3,0
821,2,1,2906,2907,2908,1,2,0
822,6,2,2912,2912,2914,0,2,4
823,6,3,2918,2918,2921,0,3,4
824,4,1,2922,2922,2923,0,1,1
825,5,2,2927,2927,2929,0,2,4
826,2,3,2929,2929,2932,0,3,0
827,1,3,2930,2932,2935,2,5,0
828,3,3,2933,2935,2938,2,5,0
829,6,2,2939,2939,2941,0,2,1
830,1,3,2940,2941,2944,1,4,0
831,4,3,2944,2944,2947,0,3,0
832,5,1,2949,2949,2950,0,1,2
833,2,3,2951,2951,2954,0,3,1
834,3,3,2954,2954,2957,0,3,0
835,2,2,2956,2957,2959,1,3,0
836,6,2,2962,2962,2964,0,2,3
837,3,3,2965,2965,2968,0,3,1
838,1,1,2966,2968,2969,2,3,0
839,1,1,2967,2969,2970,2,3,0
840,4,3,2971,2971,2974,0,3,1
841,6,2,2977,2977,2979,0,2,3
842,6,3,2983,2983,2986,0,3,4
843,3,1,2986,2986,2987,0,1,0
844,5,2,2991,2991,2993,0,2,4
845,2,3,2993,2993,2996,0,3,0
846,5,3,2998,2998,3001,0,3,2
847,6,2,3004,3004,3006,0,2,3
848,1,1,3005,3006,3007,1,2,0
849,5,3,3010,3010,3013,0,3,3
850,5,1,3015,3015,3016,0,1,2
851,4,2,3019,3019,3021,0,2,3
852,2,2,3021,3021,3023,0,2,0
853,6,1,3027,3027,3028,0,1,4
854,5,2,3032,3032,3034,0,2,4
855,6,2,3038,3038,3040,0,2,4
856,1,3,3039,3040,3043,1,4,0
857,5,2,3044,3044,3046,0,2,1
858,5,2,3049,3049,3051,0,2,3
859,1,2,3050,3051,3053,1,3,0
860,2,3,3052,3053,3056,1,4,0
861,5,3,3057,3057,3060,0,3,1
862,6,2,3063,3063,3065,0,2,3
863,4,1,3067,3067,3068,0,1,2
864,2,3,3069,3069,3072,0,3,1
865,5,1,3074,3074,3075,0,1,2
866,2,2,3076,3076,3078,0,2,1
867,2,3,3078,3078,3081,0,3,0
868,5,2,3083,3083,3085,0,2,2
869,1,2,3084,3085,3087,1,3,0
870,3,1,3087,3087,3088,0,1,0
871,6,3,3093,3093,3096,0,3,5
872,6,1,3099,3099,3100,0,1,3
873,6,2,3105,3105,3107,0,2,5
874,4,2,3109,3109,3111,0,2,2
875,3,1,3112,3112,3113,0,1,1
876,2,2,3114,3114,3116,0,2,1
877,3,2,3117,3117,3119,0,2,1
878,3,3,3120,3120,3123,0,3,1
879,3,1,3123,3123,3124,0,1,0
880,2,3,3125,3125,3128,0,3,1
881,3,2,3128,3128,3130,0,2,0
882,5,3,3133,3133,3136,0,3,3
883,1,2,3134,3136,3138,2,4,0
884,4,2,3138,3138,3140,0,2,0
885,2,3,3140,3140,3143,0,3,0
886,3,1,3143,3143,3144,0,1,0
887,3,2,3146,3146,3148,0,2,2
888,4,1,3150,3150,3151,0,1,2
889,6,2,3156,3156,3158,0,2,5
890,3,3,3159,3159,3162,0,3,1
891,6,3,3165,3165,3168,0,3,3
892,4,2,3169,3169,3171,0,2,1
893,2,3,3171,3171,3174,0,3,0
894,5,2,3176,3176,3178,0,2,2
895,4,3,3180,3180,3183,0,3,2
896,1,1,3181,3183,3184,2,3,0
897,6,2,3187,3187,3189,0,2,3
898,5,3,3192,3192,3195,0,3,3
899,6,1,3198,3198,3199,0,1,3
900,1,1,3199,3199,3200,0,1,0
901,2,2,3201,3201,3203,0,2,1
902,2,2,3203,3203,3205,0,2,0
903,1,1,3204,3205,3206,1,2,0
904,4,3,3208,3208,3211,0,3,2
905,4,1,3212,3212,3213,0,1,1
906,6,1,3218,3218,3219,0,1,5
907,4,2,3222,3222,3224,0,2,3
908,2,3,3224,3224,3227,0,3,0
909,1,1,3225,3227,3228,2,3,0
910,3,2,3228,3228,3230,0,2,0
911,4,2,3232,3232,3234,0,2,2
912,5,3,3237,3237,3240,0,3,3
913,5,3,3242,3242,3245,0,3,2
914,6,3,3248,3248,3251,0,3,3
915,2,2,3250,3251,3253,1,3,0
916,1,3,3251,3253,3256,2,5,0
917,3,3,3254,3256,3259,2,5,0
918,2,1,3256,3259,3260,3,4,0
919,4,3,3260,3260,3263,0,3,0
920,1,2,3261,3263,3265,2,4,0
921,2,3,3263,3265,3268,2,5,0
922,5,3,3268,3268,3271,0,3,0
923,5,1,3273,3273,3274,0,1,2
924,4,3,3277,3277,3280,0,3,3
925,5,2,3282,3282,3284,0,2,2
926,6,3,3288,3288,3291,0,3,4
927,6,2,3294,3294,3296,0,2,3
928,6,3,3300,3300,3303,0,3,4
929,2,2,3302,3303,3305,1,3,0
930,6,1,3308,3308,3309,0,1,3
931,5,2,3313,3313,3315,0,2,4
932,2,1,3315,3315,3316,0,1,0
933,6,1,3321,3321,3322,0,1,5
934,1,2,3322,3322,3324,0,2,0
935,1,2,3323,3324,3326,1,3,0
936,4,2,3327,3327,3329,0,2,1
937,4,2,3331,3331,3333,0,2,2
938,5,2,3336,3336,3338,0,2,3
939,4,3,3340,3340,3343,0,3,2
940,1,3,3341,3343,3346,2,5,0
941,4,3,3345,3346,3349,1,4,0
942,4,1,3349,3349,3350,0,1,0
943,3,1,3352,3352,3353,0,1,2
944,3,1,3355,3355,3356,0,1,2
945,1,1,3356,3356,3357,0,1,0
946,4,3,3360,3360,3363,0,3,3
947,4,2,3364,3364,3366,0,2,1
948,2,2,3366,3366,3368,0,2,0
949,4,2,3370,3370,3372,0,2,2
950,3,3,3373,3373,3376,0,3,1
951,2,2,3375,3376,3378,1,3,0
952,1,1,3376,3378,3379,2,3,0
953,4,1,3380,3380,3381,0,1,1
954,1,1,3381,3381,3382,0,1,0
955,5,3,3386,3386,3389,0,3,4
956,5,2,3391,3391,3393,0,2,2
957,5,2,3396,3396,3398,0,2,3
958,3,3,3399,3399,3402,0,3,1
959,4,2,3403,3403,3405,0,2,1
960,6,2,3409,3409,3411,0,2,4
961,6,2,3415,3415,3417,0,2,4
962,4,3,3419,3419,3422,0,3,2
963,5,2,3424,3424,3426,0,2,2
964,1,2,3425,3426,3428,1,3,0
965,5,3,3430,3430,3433,0,3,2
966,3,2,3433,3433,3435,0,2,0
967,6,2,3439,3439,3441,0,2,4
968,6,2,3445,3445,3447,0,2,4
969,5,1,3450,3450,3451,0,1,3
970,3,2,3453,3453,3455,0,2,2
971,5,1,3458,3458,3459,0,1,3
972,2,1,3460,3460,3461,0,1,1
973,3,1,3463,3463,3464,0,1,2
974,2,2,3465,3465,3467,0,2,1
975,4,1,3469,3469,3470,0,1,2
976,1,2,3470,3470,3472,0,2,0
977,1,2,3471,3472,3474,1,3,0
978,4,3,3475,3475,3478,0,3,1
979,1,1,3476,3478,3479,2,3,0
980,3,1,3479,3479,3480,0,1,0
981,3,3,3482,3482,3485,0,3,2
982,6,3,3488,3488,3491,0,3,3
983,5,1,3493,3493,3494,0,1,2
984,3,3,3496,3496,3499,0,3,2
985,2,1,3498,3499,3500,1,2,0
986,3,2,3501,3501,3503,0,2,1
987,6,3,3507,3507,3510,0,3,4
988,1,2,3508,3510,3512,2,4,0
989,1,3,3509,3512,3515,3,6,0
990,5,2,3514,3515,3517,1,3,0
991,5,2,3519,3519,3521,0,2,2
992,3,3,3522,3522,3525,0,3,1
993,1,1,3523,3525,3526,2,3,0
994,6,1,3529,3529,3530,0,1,3
995,6,1,3535,3535,3536,0,1,5
996,4,3,3539,3539,3542,0,3,3
997,2,2,3541,3542,3544,1,3,0
998,3,2,3544,3544,3546,0,2,0
999,5,2,3549,3549,3551,0,2,3
1000,1,1,3550,3551,3552,1,2,0
1001,2,1,3552,3552,3553,0,1,0
1002,1,2,3553,3553,3555,0,2,0
1003,1,2,3554,3555,3557,1,3,0
1004,6,2,3560,3560,3562,0,2,3
1005,1,1,3561,3562,3563,1,2,0
1006,6,1,3567,3567,3568,0,1,4
1007,6,2,3573,3573,3575,0,2,5
1008,1,2,3574,3575,3577,1,3,0
1009,4,2,3578,3578,3580,0,2,1
1010,2,2,3580,3580,3582,0,2,0
1011,2,1,3582,3582,3583,0,1,0
1012,4,2,3586,3586,3588,0,2,3
1013,2,2,3588,3588,3590,0,2,0
1014,1,1,3589,3590,3591,1,2,0
1015,3,2,3592,3592,3594,0,2,1
1016,6,1,3598,3598,3599,0,1,4
1017,5,1,3603,3603,3604,0,1,4
1018,1,2,3604,3604,3606,0,2,0
1019,2,1,3606,3606,3607,0,1,0
1020,2,3,3608,3608,3611,0,3,1
1021,1,3,3609,3611,3614,2,5,0
1022,3,3,3612,3614,3617,2,5,0
1023,1,3,3613,3617,3620,4,7,0
1024,2,2,3615,3620,3622,5,7,0
1025,5,3,3620,3622,3625,2,5,0
1026,1,2,3621,3625,3627,4,6,0
1027,5,1,3626,3627,3628,1,2,0
1028,5,1,3631,3631,3632,0,1,3
1029,2,3,3633,3633,3636,0,3,1
1030,1,1,3634,3636,3637,2,3,0
1031,5,2,3639,3639,3641,0,2,2
1032,5,3,3644,3644,3647,0,3,3
1033,4,1,3648,3648,3649,0,1,1
1034,3,3,3651,3651,3654,0,3,2
1035,3,2,3654,3654,3656,0,2,0
1036,2,1,3656,3656,3657,0,1,0
1037,6,3,3662,3662,3665,0,3,5
1038,3,2,3665,3665,3667,0,2,0
1039,1,2,3666,3667,3669,1,3,0
1040,2,3,3668,3669,3672,1,4,0
1041,1,1,3669,3672,3673,3,4,0
1042,3,3,3672,3673,3676,1,4,0
1043,4,3,3676,3676,3679,0,3,0
1044,3,3,3679,3679,3682,0,3,0
1045,5,3,3684,3684,3687,0,3,2
1046,2,2,3686,3687,3689,1,3,0
1047,4,3,3690,3690,3693,0,3,1
1048,5,3,3695,3695,3698,0,3,2
1049,3,3,3698,3698,3701,0,3,0
1050,1,3,3699,3701,3704,2,5,0
1051,6,2,3705,3705,3707,0,2,1
1052,4,1,3709,3709,3710,0,1,2
1053,5,2,3714,3714,3716,0,2,4
1054,6,2,3720,3720,3722,0,2,4
1055,6,3,3726,3726,3729,0,3,4
1056,5,3,3731,3731,3734,0,3,2
1057,6,3,3737,3737,3740,0,3,3
1058,5,3,3742,3742,3745,0,3,2
1059,4,1,3746,3746,3747,0,1,1
1060,5,3,3751,3751,3754,0,3,4
1061,5,1,3756,3756,3757,0,1,2
1062,4,1,3760,3760,3761,0,1,3
1063,6,1,3766,3766,3767,0,1,5
1064,4,3,3770,3770,3773,0,3,3
1065,4,3,3774,3774,3777,0,3,1
1066,5,1,3779,3779,3780,0,1,2
1067,2,3,3781,3781,3784,0,3,1
1068,6,1,3787,3787,3788,0,1,3
1069,3,2,3790,3790,3792,0,2,2
1070,5,1,3795,3795,3796,0,1,3
1071,6,2,3801,3801,3803,0,2,5
1072,1,1,3802,3803,3804,1,2,0
1073,6,3,3808,3808,3811,0,3,4
1074,4,1,3812,3812,3813,0,1,1
1075,5,1,3817,3817,3818,0,1,4
1076,6,3,3823,3823,3826,0,3,5
1077,1,3,3824,3826,3829,2,5,0
1078,1,2,3825,3829,3831,4,6,0
1079,4,2,3829,3831,3833,2,4,0
1080,6,2,3835,3835,3837,0,2,2
1081,5,3,3840,3840,3843,0,3,3
1082,6,3,3846,3846,3849,0,3,3
1083,6,2,3852,3852,3854,0,2,3
1084,1,3,3853,3854,3857,1,4,0
1085,4,2,3857,3857,3859,0,2,0
1086,6,2,3863,3863,3865,0,2,4
1087,3,1,3866,3866,3867,0,1,1
1088,5,1,3871,3871,3872,0,1,4
1089,5,3,3876,3876,3879,0,3,4
1090,1,2,3877,3879,3881,2,4,0
1091,5,2,3882,3882,3884,0,2,1
1092,3,2,3885,3885,3887,0,2,1
1093,4,2,3889,3889,3891,0,2,2
1094,3,1,3892,3892,3893,0,1,1
1095,5,3,3897,3897,3900,0,3,4
1096,5,3,3902,3902,3905,0,3,2
1097,2,3,3904,3905,3908,1,4,0
1098,3,2,3907,3908,3910,1,3,0
1099,6,2,3913,3913,3915,0,2,3
1100,6,2,3919,3919,3921,0,2,4
1101,6,1,3925,3925,3926,0,1,4
1102,6,3,3931,3931,3934,0,3,5
1103,5,3,3936,3936,3939,0,3,2
1104,2,3,3938,3939,3942,1,4,0
1105,3,1,3941,3942,3943,1,2,0
1106,5,2,3946,3946,3948,0,2,3
1107,6,1,3952,3952,3953,0,1,4
1108,2,3,3954,3954,3957,0,3,1
1109,1,1,3955,3957,3958,2,3,0
1110,2,3,3957,3958,3961,1,4,0
1111,5,2,3962,3962,3964,0,2,1
1112,2,3,3964,3964,3967,0,3,0
1113,4,2,3968,3968,3970,0,2,1
1114,2,2,3970,3970,3972,0,2,0
1115,3,1,3973,3973,3974,0,1,1
1116,5,3,3978,3978,3981,0,3,4
1117,1,2,3979,3981,3983,2,4,0
1118,1,2,3980,3983,3985,3,5,0
1119,3,2,3983,3985,3987,2,4,0
1120,4,1,3987,3987,3988,0,1,0
1121,5,1,3992,3992,3993,0,1,4
1122,5,1,3997,3997,3998,0,1,4
1123,3,3,4000,4000,4003,0,3,2
1124,5,3,4005,4005,4008,0,3,2
1125,5,2,4010,4010,4012,0,2,2
1126,5,3,4015,4015,4018,0,3,3
1127,2,2,4017,4018,4020,1,3,0
1128,2,1,4019,4020,4021,1,2,0
1129,6,3,4025,4025,4028,0,3,4
1130,2,3,4027,4028,4031,1,4,0
1131,3,2,4030,4031,4033,1,3,0
1132,1,1,4031,4033,4034,2,3,0
1133,3,2,4034,4034,4036,0,2,0
1134,4,3,4038,4038,4041,0,3,2
1135,1,3,4039,4041,4044,2,5,0
1136,2,3,4041,4044,4047,3,6,0
1137,6,1,4047,4047,4048,0,1,0
1138,3,2,4050,4050,4052,0,2,2
1139,3,2,4053,4053,4055,0,2,1
1140,4,3,4057,4057,4060,0,3,2
1141,5,3,4062,4062,4065,0,3,2
1142,3,2,4065,4065,4067,0,2,0
1143,4,2,4069,4069,4071,0,2,2
1144,5,3,4074,4074,4077,0,3,3
1145,5,3,4079,4079,4082,0,3,2
1146,1,3,4080,4082,4085,2,5,0
1147,6,1,4086,4086,4087,0,1,1
1148,5,1,4091,4091,4092,0,1,4
1149,2,3,4093,4093,4096,0,3,1
1150,4,1,4097,4097,4098,0,1,1
1151,6,3,4103,4103,4106,0,3,5
1152,5,3,4108,4108,4111,0,3,2
1153,2,1,4110,4111,4112,1,2,0
1154,3,3,4113,4113,4116,0,3,1
1155,2,2,4115,4116,4118,1,3,0
1156,5,2,4120,4120,4122,0,2,2
1157,2,2,4122,4122,4124,0,2,0
1158,4,1,4126,4126,4127,0,1,2
1159,1,2,4127,4127,4129,0,2,0
1160,1,2,4128,4129,4131,1,3,0
1161,1,1,4129,4131,4132,2,3,0
1162,4,1,4133,4133,4134,0,1,1
1163,3,2,4136,4136,4138,0,2,2
1164,2,3,4138,4138,4141,0,3,0
1165,6,3,4144,4144,4147,0,3,3
1166,6,2,4150,4150,4152,0,2,3
1167,2,3,4152,4152,4155,0,3,0
1168,3,3,4155,4155,4158,0,3,0
1169,6,1,4161,4161,4162,0,1,3
1170,1,2,4162,4162,4164,0,2,0
1171,1,3,4163,4164,4167,1,4,0
1172,5,1,4168,4168,4169,0,1,1
1173,3,1,4171,4171,4172,0,1,2
1174,6,3,4177,4177,4180,0,3,5
1175,1,1,4178,4180,4181,2,3,0
1176,1,3,4179,4181,4184,2,5,0
1177,3,1,4182,4184,4185,2,3,0
1178,3,2,4185,4185,4187,0,2,0
1179,2,3,4187,4187,4190,0,3,0
1180,2,2,4189,4190,4192,1,3,0
1181,5,2,4194,4194,4196,0,2,2
1182,3,2,4197,4197,4199,0,2,1
1183,3,3,4200,4200,4203,0,3,1
1184,3,1,4203,4203,4204,0,1,0
1185,2,1,4205,4205,4206,0,1,1
1186,5,2,4210,4210,4212,0,2,4
1187,4,1,4214,4214,4215,0,1,2
1188,2,2,4216,4216,4218,0,2,1
1189,4,3,4220,4220,4223,0,3,2
1190,6,2,4226,4226,4228,0,2,3
1191,1,3,4227,4228,4231,1,4,0
1192,3,1,4230,4231,4232,1,2,0
1193,3,3,4233,4233,4236,0,3,1
1194,1,2,4234,4236,4238,2,4,0
1195,6,3,4240,4240,4243,0,3,2
1196,1,2,4241,4243,4245,2,4,0
1197,4,3,4245,4245,4248,0,3,0
1198,6,2,4251,4251,4253,0,2,3
1199,1,1,4252,4253,4254,1,2,0
1200,3,1,4255,4255,4256,0,1,1
1201,1,3,4256,4256,4259,0,3,0
1202,5,1,4261,4261,4262,0,1,2
1203,5,1,4266,4266,4267,0,1,4
1204,4,3,4270,4270,4273,0,3,3
1205,5,1,4275,4275,4276,0,1,2
1206,1,1,4276,4276,4277,0,1,0
1207,2,1,4278,4278,4279,0,1,1
1208,4,2,4282,4282,4284,0,2,3
1209,4,1,4286,4286,4287,0,1,2
1210,6,3,4292,4292,4295,0,3,5
1211,2,2,4294,4295,4297,1,3,0
1212,1,1,4295,4297,4298,2,3,0
1213,5,1,4300,4300,4301,0,1,2
1214,3,2,4303,4303,4305,0,2,2
1215,5,2,4308,4308,4310,0,2,3
1216,1,1,4309,4310,4311,1,2,0
1217,3,2,4312,4312,4314,0,2,1
1218,5,2,4317,4317,4319,0,2,3
1219,5,3,4322,4322,4325,0,3,3
1220,2,2,4324,4325,4327,1,3,0
1221,1,1,4325,4327,4328,2,3,0
1222,6,2,4331,4331,4333,0,2,3
1223,6,2,4337,4337,4339,0,2,4
1224,6,2,4343,4343,4345,0,2,4
1225,6,3,4349,4349,4352,0,3,4
1226,5,1,4354,4354,4355,0,1,2
1227,3,3,4357,4357,4360,0,3,2
1228,2,2,4359,4360,4362,1,3,0
1229,5,3,4364,4364,4367,0,3,2
1230,1,2,4365,4367,4369,2,4,0
1231,3,2,4368,4369,4371,1,3,0
1232,3,2,4371,4371,4373,0,2,0
1233,5,1,4376,4376,4377,0,1,3
1234,5,3,4381,4381,4384,0,3,4
1235,3,1,4384,4384,4385,0,1,0
1236,4,1,4388,4388,4389,0,1,3
1237,4,3,4392,4392,4395,0,3,3
1238,6,3,4398,4398,4401,0,3,3
1239,2,2,4400,4401,4403,1,3,0
1240,1,2,4401,4403,4405,2,4,0
1241,3,3,4404,4405,4408,1,4,0
1242,5,1,4409,4409,4410,0,1,1
1243,3,2,4412,4412,4414,0,2,2
1244,4,3,4416,4416,4419,0,3,2
1245,6,3,4422,4422,4425,0,3,3
1246,1,2,4423,4425,4427,2,4,0
1247,2,3,4425,4427,4430,2,5,0
1248,5,3,4430,4430,4433,0,3,0
1249,5,2,4435,4435,4437,0,2,2
1250,2,2,4437,4437,4439,0,2,0
1251,1,3,4438,4439,4442,1,4,0
1252,6,1,4444,4444,4445,0,1,2
1253,5,3,4449,4449,4452,0,3,4
1254,6,3,4455,4455,4458,0,3,3
1255,3,1,4458,4458,4459,0,1,0
1256,2,3,4460,4460,4463,0,3,1
1257,4,1,4464,4464,4465,0,1,1
1258,2,2,4466,4466,4468,0,2,1
1259,1,2,4467,4468,4470,1,3,0
1260,3,3,4470,4470,4473,0,3,0
1261,5,2,4475,4475,4477,0,2,2
1262,1,3,4476,4477,4480,1,4,0
1263,2,1,4478,4480,4481,2,3,0
1264,1,1,4479,4481,4482,2,3,0
1265,5,3,4484,4484,4487,0,3,2
1266,5,2,4489,4489,4491,0,2,2
1267,2,2,4491,4491,4493,0,2,0
1268,5,1,4496,4496,4497,0,1,3
1269,1,1,4497,4497,4498,0,1,0
1270,2,1,4499,4499,4500,0,1,1
1271,1,3,4500,4500,4503,0,3,0
1272,2,1,4502,4503,4504,1,2,0
1273,4,2,4506,4506,4508,0,2,2
1274,6,1,4512,4512,4513,0,1,4
1275,5,1,4517,4517,4518,0,1,4
1276,2,1,4519,4519,4520,0,1,1
1277,4,3,4523,4523,4526,0,3,3
1278,3,2,4526,4526,4528,0,2,0
1279,2,3,4528,4528,4531,0,3,0
1280,6,2,4534,4534,4536,0,2,3
1281,3,3,4537,4537,4540,0,3,1
1282,3,3,4540,4540,4543,0,3,0
1283,6,1,4546,4546,4547,0,1,3
1284,5,1,4551,4551,4552,0,1,4
1285,5,3,4556,4556,4559,0,3,4
1286,1,3,4557,4559,4562,2,5,0
1287,1,3,4558,4562,4565,4,7,0
1288,5,2,4563,4565,4567,2,4,0
1289,4,2,4567,4567,4569,0,2,0
1290,4,1,4571,4571,4572,0,1,2
1291,6,1,4577,4577,4578,0,1,5
1292,3,1,4580,4580,4581,0,1,2
1293,2,2,4582,4582,4584,0,2,1
1294,2,1,4584,4584,4585,0,1,0
1295,5,2,4589,4589,4591,0,2,4
1296,4,2,4593,4593,4595,0,2,2
1297,3,1,4596,4596,4597,0,1,1
1298,1,2,4597,4597,4599,0,2,0
1299,4,3,4601,4601,4604,0,3,2
1300,3,1,4604,4604,4605,0,1,0
1301,4,3,4608,4608,4611,0,3,3
1302,4,2,4612,4612,4614,0,2,1
1303,2,3,4614,4614,4617,0,3,0
1304,3,3,4617,4617,4620,0,3,0
1305,1,3,4618,4620,4623,2,5,0
1306,3,1,4621,4623,4624,2,3,0
1307,5,2,4626,4626,4628,0,2,2
1308,2,2,4628,4628,4630,0,2,0
1309,1,1,4629,4630,4631,1,2,0
1310,5,3,4634,4634,4637,0,3,3
1311,5,1,4639,4639,4640,0,1,2
1312,3,1,4642,4642,4643,0,1,2
1313,4,3,4646,4646,4649,0,3,3
1314,2,2,4648,4649,4651,1,3,0
1315,6,3,4654,4654,4657,0,3,3
1316,4,2,4658,4658,4660,0,2,1
1317,6,2,4664,4664,4666,0,2,4
1318,4,2,4668,4668,4670,0,2,2
1319,4,3,4672,4672,4675,0,3,2
1320,1,3,4673,4675,4678,2,5,0
1321,1,2,4674,4678,4680,4,6,0
1322,2,3,4676,4680,4683,4,7,0
1323,2,3,4678,4683,4686,5,8,0
1324,1,1,4679,4686,4687,7,8,0
1325,5,3,4684,4687,4690,3,6,0
1326,2,3,4686,4690,4693,4,7,0
1327,2,1,4688,4693,4694,5,6,0
1328,5,2,4693,4694,4696,1,3,0
1329,1,1,4694,4696,4697,2,3,0
1330,4,2,4698,4698,4700,0,2,1
1331,6,3,4704,4704,4707,0,3,4
1332,1,3,4705,4707,4710,2,5,0
1333,2,3,4707,4710,4713,3,6,0
1334,3,2,4710,4713,4715,3,5,0
1335,4,2,4714,4715,4717,1,3,0
1336,4,2,4718,4718,4720,0,2,1
1337,6,2,4724,4724,4726,0,2,4
1338,5,3,4729,4729,4732,0,3,3
1339,4,2,4733,4733,4735,0,2,1
1340,2,1,4735,4735,4736,0,1,0
1341,3,3,4738,4738,4741,0,3,2
1342,3,3,4741,4741,4744,0,3,0
1343,4,1,4745,4745,4746,0,1,1
1344,5,2,4750,4750,4752,0,2,4
1345,1,1,4751,4752,4753,1,2,0
1346,4,3,4755,4755,4758,0,3,2
1347,2,1,4757,4758,4759,1,2,0
1348,1,3,4758,4759,4762,1,4,0
1349,3,2,4761,4762,4764,1,3,0
1350,2,3,4763,4764,4767,1,4,0
1351,1,3,4764,4767,4770,3,6,0
1352,3,1,4767,4770,4771,3,4,0
1353,1,1,4768,4771,4772,3,4,0
1354,2,2,4770,4772,4774,2,4,0
1355,1,1,4771,4774,4775,3,4,0
1356,2,1,4773,4775,4776,2,3,0
1357,1,2,4774,4776,4778,2,4,0
1358,4,2,4778,4778,4780,0,2,0
1359,2,3,4780,4780,4783,0,3,0
1360,4,3,4784,4784,4787,0,3,1
1361,5,2,4789,4789,4791,0,2,2
1362,4,2,4793,4793,4795,0,2,2
1363,1,3,4794,4795,4798,1,4,0
1364,3,1,4797,4798,4799,1,2,0
1365,6,1,4803,4803,4804,0,1,4
1366,6,1,4809,4809,4810,0,1,5
1367,2,1,4811,4811,4812,0,1,1
1368,1,2,4812,4812,4814,0,2,0
1369,6,1,4818,4818,4819,0,1,4
1370,5,2,4823,4823,4825,0,2,4
1371,4,2,4827,4827,4829,0,2,2
1372,6,3,4833,4833,4836,0,3,4
1373,4,3,4837,4837,4840,0,3,1
1374,6,1,4843,4843,4844,0,1,3
1375,1,1,4844,4844,4845,0,1,0
1376,5,2,4849,4849,4851,0,2,4
1377,2,2,4851,4851,4853,0,2,0
1378,6,1,4857,4857,4858,0,1,4
1379,3,1,4860,4860,4861,0,1,2
1380,6,1,4866,4866,4867,0,1,5
1381,5,3,4871,4871,4874,0,3,4
1382,2,1,4873,4874,4875,1,2,0
1383,3,2,4876,4876,4878,0,2,1
1384,4,1,4880,4880,4881,0,1,2
1385,1,3,4881,4881,4884,0,3,0
1386,5,2,4886,4886,4888,0,2,2
1387,6,3,4892,4892,4895,0,3,4
1388,2,1,4894,4895,4896,1,2,0
1389,3,3,4897,4897,4900,0,3,1
1390,3,3,4900,4900,4903,0,3,0
1391,5,2,4905,4905,4907,0,2,2
1392,2,3,4907,4907,4910,0,3,0
1393,1,3,4908,4910,4913,2,5,0
1394,6,2,4914,4914,4916,0,2,1
1395,1,1,4915,4916,4917,1,2,0
1396,5,1,4920,4920,4921,0,1,3
1397,2,3,4922,4922,4925,0,3,1
1398,3,1,4925,4925,4926,0,1,0
1399,1,3,4926,4926,4929,0,3,0
1400,5,2,4931,4931,4933,0,2,2
1401,3,2,4934,4934,4936,0,2,1
1402,4,3,4938,4938,4941,0,3,2
1403,3,2,4941,4941,4943,0,2,0
1404,4,1,4945,4945,4946,0,1,2
1405,3,3,4948,4948,4951,0,3,2
1406,2,2,4950,4951,4953,1,3,0
1407,6,3,4956,4956,4959,0,3,3
1408,4,1,4960,4960,4961,0,1,1
1409,2,2,4962,4962,4964,0,2,1
1410,5,1,4967,4967,4968,0,1,3
1411,5,3,4972,4972,4975,0,3,4
1412,4,1,4976,4976,4977,0,1,1
1413,4,1,4980,4980,4981,0,1,3
1414,1,1,4981,4981,4982,0,1,0
1415,6,3,4987,4987,4990,0,3,5
1416,3,3,4990,4990,4993,0,3,0
1417,4,1,4994,4994,4995,0,1,1
1418,4,3,4998,4998,5001,0,3,3
1419,5,1,5003,5003,5004,0,1,2
1420,3,1,5006,5006,5007,0,1,2
1421,1,1,5007,5007,5008,0,1,0
1422,3,3,5010,5010,5013,0,3,2
1423,4,3,5014,5014,5017,0,3,1
1424,6,3,5020,5020,5023,0,3,3
1425,6,1,5026,5026,5027,0,1,3
1426,4,3,5030,5030,5033,0,3,3
1427,2,3,5032,5033,5036,1,4,0
1428,1,1,5033,5036,5037,3,4,0
1429,6,1,5039,5039,5040,0,1,2
1430,6,3,5045,5045,5048,0,3,5
1431,2,1,5047,5048,5049,1,2,0
1432,4,3,5051,5051,5054,0,3,2
1433,6,3,5057,5057,5060,0,3,3
1434,2,2,5059,5060,5062,1,3,0
1435,3,2,5062,5062,5064,0,2,0
1436,6,1,5068,5068,5069,0,1,4
1437,6,1,5074,5074,5075,0,1,5
1438,6,3,5080,5080,5083,0,3,5
1439,4,2,5084,5084,5086,0,2,1
1440,1,3,5085,5086,5089,1,4,0
1441,2,2,5087,5089,5091,2,4,0
1442,1,3,5088,5091,5094,3,6,0
1443,2,1,5090,5094,5095,4,5,0
1444,4,1,5094,5095,5096,1,2,0
1445,6,3,5100,5100,5103,0,3,4
1446,1,1,5101,5103,5104,2,3,0
1447,3,1,5104,5104,5105,0,1,0
1448,2,2,5106,5106,5108,0,2,1
1449,1,1,5107,5108,5109,1,2,0
1450,6,1,5113,5113,5114,0,1,4
1451,5,1,5118,5118,5119,0,1,4
1452,3,1,5121,5121,5122,0,1,2
1453,6,3,5127,5127,5130,0,3,5
1454,2,1,5129,5130,5131,1,2,0
1455,5,3,5134,5134,5137,0,3,3
1456,1,3,5135,5137,5140,2,5,0
1457,4,1,5139,5140,5141,1,2,0
1458,6,1,5145,5145,5146,0,1,4
1459,6,3,5151,5151,5154,0,3,5
1460,6,3,5157,5157,5160,0,3,3
1461,3,2,5160,5160,5162,0,2,0
1462,2,3,5162,5162,5165,0,3,0
1463,2,2,5164,5165,5167,1,3,0
1464,4,1,5168,5168,5169,0,1,1
1465,4,3,5172,5172,5175,0,3,3
1466,3,1,5175,5175,5176,0,1,0
1467,5,3,5180,5180,5183,0,3,4
1468,2,3,5182,5183,5186,1,4,0
1469,1,1,5183,5186,5187,3,4,0
1470,2,1,5185,5187,5188,2,3,0
1471,3,2,5188,5188,5190,0,2,0
1472,5,2,5193,5193,5195,0,2,3
1473,6,2,5199,5199,5201,0,2,4
1474,4,1,5203,5203,5204,0,1,2
1475,3,2,5206,5206,5208,0,2,2
1476,6,2,5212,5212,5214,0,2,4
1477,4,3,5216,5216,5219,0,3,2
1478,4,3,5220,5220,5223,0,3,1
1479,6,3,5226,5226,5229,0,3,3
1480,4,1,5230,5230,5231,0,1,1
1481,5,2,5235,5235,5237,0,2,4
1482,2,2,5237,5237,5239,0,2,0
1483,4,3,5241,5241,5244,0,3,2
1484,3,1,5244,5244,5245,0,1,0
1485,3,1,5247,5247,5248,0,1,2
1486,3,1,5250,5250,5251,0,1,2
1487,6,2,5256,5256,5258,0,2,5
1488,3,1,5259,5259,5260,0,1,1
1489,3,3,5262,5262,5265,0,3,2
1490,2,1,5264,5265,5266,1,2,0
1491,4,3,5268,5268,5271,0,3,2
1492,4,1,5272,5272,5273,0,1,1
1493,6,3,5278,5278,5281,0,3,5
1494,5,3,5283,5283,5286,0,3,2
1495,2,1,5285,5286,5287,1,2,0
1496,3,2,5288,5288,5290,0,2,1
1497,2,1,5290,5290,5291,0,1,0
1498,2,2,5292,5292,5294,0,2,1
1499,4,3,5296,5296,5299,0,3,2
1500,1,1,5297,5299,5300,2,3,0
1501,4,2,5301,5301,5303,0,2,1
1502,4,1,5305,5305,5306,0,1,2
1503,3,1,5308,5308,5309,0,1,2
1504,2,3,5310,5310,5313,0,3,1
1505,3,2,5313,5313,5315,0,2,0
1506,5,1,5318,5318,5319,0,1,3
1507,4,1,5322,5322,5323,0,1,3
1508,5,3,5327,5327,5330,0,3,4
1509,6,3,5333,5333,5336,0,3,3
1510,2,2,5335,5336,5338,1,3,0
1511,3,2,5338,5338,5340,0,2,0
1512,2,2,5340,5340,5342,0,2,0
1513,4,1,5344,5344,5345,0,1,2
1514,2,3,5346,5346,5349,0,3,1
1515,2,3,5348,5349,5352,1,4,0
1516,6,3,5354,5354,5357,0,3,2
1517,6,2,5360,5360,5362,0,2,3
1518,3,1,5363,5363,5364,0,1,1
1519,4,1,5367,5367,5368,0,1,3
1520,2,3,5369,5369,5372,0,3,1
1521,2,3,5371,5372,5375,1,4,0
1522,1,2,5372,5375,5377,3,5,0
1523,3,1,5375,5377,5378,2,3,0
1524,5,3,5380,5380,5383,0,3,2
1525,1,2,5381,5383,5385,2,4,0
1526,1,2,5382,5385,5387,3,5,0
1527,5,2,5387,5387,5389,0,2,0
1528,4,2,5391,5391,5393,0,2,2
1529,1,1,5392,5393,5394,1,2,0
1530,4,2,5396,5396,5398,0,2,2
1531,6,3,5402,5402,5405,0,3,4
1532,1,3,5403,5405,5408,2,5,0
1533,2,1,5405,5408,5409,3,4,0
1534,5,1,5410,5410,5411,0,1,1
1535,3,3,5413,5413,5416,0,3,2
1536,2,3,5415,5416,5419,1,4,0
1537,2,3,5417,5419,5422,2,5,0
1538,3,3,5420,5422,5425,2,5,0
1539,3,3,5423,5425,5428,2,5,0
1540,4,2,5427,5428,5430,1,3,0
1541,1,3,5428,5430,5433,2,5,0
1542,5,1,5433,5433,5434,0,1,0
1543,5,2,5438,5438,5440,0,2,4
1544,5,2,5443,5443,5445,0,2,3
1545,3,3,5446,5446,5449,0,3,1
1546,4,3,5450,5450,5453,0,3,1
1547,3,3,5453,5453,5456,0,3,0
1548,3,1,5456,5456,5457,0,1,0
1549,2,3,5458,5458,5461,0,3,1
1550,2,2,5460,5461,5463,1,3,0
1551,1,2,5461,5463,5465,2,4,0
1552,5,2,5466,5466,5468,0,2,1
1553,6,3,5472,5472,5475,0,3,4
1554,2,2,5474,5475,5477,1,3,0
1555,5,2,5479,5479,5481,0,2,2
1556,6,3,5485,5485,5488,0,3,4
1557,5,2,5490,5490,5492,0,2,2
1558,2,3,5492,5492,5495,0,3,0
1559,4,2,5496,5496,5498,0,2,1
1560,6,2,5502,5502,5504,0,2,4
1561,6,2,5508,5508,5510,0,2,4
1562,5,1,5513,5513,5514,0,1,3
1563,5,1,5518,5518,5519,0,1,4
1564,2,3,5520,5520,5523,0,3,1
1565,6,3,5526,5526,5529,0,3,3
1566,6,3,5532,5532,5535,0,3,3
1567,2,2,5534,5535,5537,1,3,0
1568,4,2,5538,5538,5540,0,2,1
1569,6,3,5544,5544,5547,0,3,4
1570,6,1,5550,5550,5551,0,1,3
1571,6,1,5556,5556,5557,0,1,5
1572,3,3,5559,5559,5562,0,3,2
1573,2,1,5561,5562,5563,1,2,0
1574,4,3,5565,5565,5568,0,3,2
1575,2,1,5567,5568,5569,1,2,0
1576,5,3,5572,5572,5575,0,3,3
1577,5,1,5577,5577,5578,0,1,2
1578,3,1,5580,5580,5581,0,1,2
1579,4,2,5584,5584,5586,0,2,3
1580,2,2,5586,5586,5588,0,2,0
1581,5,2,5591,5591,5593,0,2,3
1582,2,3,5593,5593,5596,0,3,0
1583,2,1,5595,5596,5597,1,2,0
1584,3,2,5598,5598,5600,0,2,1
1585,2,1,5600,5600,5601,0,1,0
1586,3,1,5603,5603,5604,0,1,2
1587,4,1,5607,5607,5608,0,1,3
1588,4,3,5611,5611,5614,0,3,3
1589,1,2,5612,5614,5616,2,4,0
1590,4,2,5616,5616,5618,0,2,0
1591,4,1,5620,5620,5621,0,1,2
1592,1,1,5621,5621,5622,0,1,0
1593,1,3,5622,5622,5625,0,3,0
1594,6,1,5628,5628,5629,0,1,3
1595,6,3,5634,5634,5637,0,3,5
1596,1,2,5635,5637,5639,2,4,0
1597,4,1,5639,5639,5640,0,1,0
1598,4,1,5643,5643,5644,0,1,3
1599,3,3,5646,5646,5649,0,3,2
1600,4,1,5650,5650,5651,0,1,1
1601,1,1,5651,5651,5652,0,1,0
1602,5,3,5656,5656,5659,0,3,4
1603,3,2,5659,5659,5661,0,2,0
1604,6,1,5665,5665,5666,0,1,4
1605,2,1,5667,5667,5668,0,1,1
1606,1,1,5668,5668,5669,0,1,0
1607,2,1,5670,5670,5671,0,1,1
1608,2,3,5672,5672,5675,0,3,1
1609,1,2,5673,5675,5677,2,4,0
1610,6,1,5679,5679,5680,0,1,2
1611,3,3,5682,5682,5685,0,3,2
1612,1,1,5683,5685,5686,2,3,0
1613,1,1,5684,5686,5687,2,3,0
1614,1,3,5685,5687,5690,2,5,0
1615,5,2,5690,5690,5692,0,2,0
1616,2,2,5692,5692,5694,0,2,0
1617,4,1,5696,5696,5697,0,1,2
1618,4,1,5700,5700,5701,0,1,3
1619,2,3,5702,5702,5705,0,3,1
1620,6,2,5708,5708,5710,0,2,3
1621,1,3,5709,5710,5713,1,4,0
1622,3,2,5712,5713,5715,1,3,0
1623,6,1,5718,5718,5719,0,1,3
1624,6,2,5724,5724,5726,0,2,5
1625,5,1,5729,5729,5730,0,1,3
1626,4,3,5733,5733,5736,0,3,3
1627,4,2,5737,5737,5739,0,2,1
1628,6,1,5743,5743,5744,0,1,4
1629,5,2,5748,5748,5750,0,2,4
1630,3,1,5751,5751,5752,0,1,1
1631,2,2,5753,5753,5755,0,2,1
1632,5,2,5758,5758,5760,0,2,3
1633,6,2,5764,5764,5766,0,2,4
1634,5,1,5769,5769,5770,0,1,3
1635,5,2,5774,5774,5776,0,2,4
1636,5,2,5779,5779,5781,0,2,3
1637,3,1,5782,5782,5783,0,1,1
1638,1,2,5783,5783,5785,0,2,0
1639,3,3,5786,5786,5789,0,3,1
1640,2,1,5788,5789,5790,1,2,0
1641,3,1,5791,5791,5792,0,1,1
1642,6,2,5797,5797,5799,0,2,5
1643,5,2,5802,5802,5804,0,2,3
1644,6,1,5808,5808,5809,0,1,4
1645,6,3,5814,5814,5817,0,3,5
1646,5,3,5819,5819,5822,0,3,2
1647,1,1,5820,5822,5823,2,3,0
1648,5,3,5825,5825,5828,0,3,2
1649,4,1,5829,5829,5830,0,1,1
1650,5,1,5834,5834,5835,0,1,4
1651,4,2,5838,5838,5840,0,2,3
1652,2,2,5840,5840,5842,0,2,0
1653,5,2,5845,5845,5847,0,2,3
1654,4,1,5849,5849,5850,0,1,2
1655,5,2,5854,5854,5856,0,2,4
1656,6,2,5860,5860,5862,0,2,4
1657,4,2,5864,5864,5866,0,2,2
1658,5,2,5869,5869,5871,0,2,3
1659,4,2,5873,5873,5875,0,2,2
1660,6,1,5879,5879,5880,0,1,4
1661,6,1,5885,5885,5886,0,1,5
1662,3,3,5888,5888,5891,0,3,2
1663,3,3,5891,5891,5894,0,3,0
1664,5,3,5896,5896,5899,0,3,2
1665,2,2,5898,5899,5901,1,3,0
1666,5,2,5903,5903,5905,0,2,2
1667,2,3,5905,5905,5908,0,3,0
1668,5,3,5910,5910,5913,0,3,2
1669,5,1,5915,5915,5916,0,1,2
1670,1,3,5916,5916,5919,0,3,0
1671,1,3,5917,5919,5922,2,5,0
1672,3,1,5920,5922,5923,2,3,0
1673,2,1,5922,5923,5924,1,2,0
1674,6,2,5928,5928,5930,0,2,4
1675,5,1,5933,5933,5934,0,1,3
1676,5,3,5938,5938,5941,0,3,4
1677,1,1,5939,5941,5942,2,3,0
1678,6,3,5945,5945,5948,0,3,3
1679,3,3,5948,5948,5951,0,3,0
1680,6,2,5954,5954,5956,0,2,3
1681,4,3,5958,5958,5961,0,3,2
1682,6,2,5964,5964,5966,0,2,3
1683,5,1,5969,5969,5970,0,1,3
1684,3,2,5972,5972,5974,0,2,2
1685,3,2,5975,5975,5977,0,2,1
1686,5,1,5980,5980,5981,0,1,3
1687,5,3,5985,5985,5988,0,3,4
1688,3,3,5988,5988,5991,0,3,0
1689,2,3,5990,5991,5994,1,4,0
1690,3,2,5993,5994,5996,1,3,0
1691,4,3,5997,5997,6000,0,3,1
1692,2,2,5999,6000,6002,1,3,0
1693,4,3,6003,6003,6006,0,3,1
1694,2,1,6005,6006,6007,1,2,0
1695,2,2,6007,6007,6009,0,2,0
1696,1,2,6008,6009,6011,1,3,0
1697,3,2,6011,6011,6013,0,2,0
1698,2,2,6013,6013,6015,0,2,0
1699,3,3,6016,6016,6019,0,3,1
1700,2,3,6018,6019,6022,1,4,0
1701,3,3,6021,6022,6025,1,4,0
1702,1,1,6022,6025,6026,3,4,0
1703,1,3,6023,6026,6029,3,6,0
1704,4,3,6027,6029,6032,2,5,0
1705,4,2,6031,6032,6034,1,3,0
1706,4,3,6035,6035,6038,0,3,1
1707,2,3,6037,6038,6041,1,4,0
1708,5,3,6042,6042,6045,0,3,1
1709,2,2,6044,6045,6047,1,3,0
1710,1,2,6045,6047,6049,2,4,0
1711,2,2,6047,6049,6051,2,4,0
1712,6,1,6053,6053,6054,0,1,2
1713,3,3,6056,6056,6059,0,3,2
1714,1,2,6057,6059,6061,2,4,0
1715,5,1,6062,6062,6063,0,1,1
1716,4,3,6066,6066,6069,0,3,3
1717,2,3,6068,6069,6072,1,4,0
1718,3,2,6071,6072,6074,1,3,0
1719,2,3,6073,6074,6077,1,4,0
1720,5,2,6078,6078,6080,0,2,1
1721,1,2,6079,6080,6082,1,3,0
1722,1,3,6080,6082,6085,2,5,0
1723,2,3,6082,6085,6088,3,6,0
1724,3,2,6085,6088,6090,3,5,0
1725,6,3,6091,6091,6094,0,3,1
1726,5,1,6096,6096,6097,0,1,2
1727,5,1,6101,6101,6102,0,1,4
1728,2,3,6103,6103,6106,0,3,1
1729,3,2,6106,6106,6108,0,2,0
1730,6,1,6112,6112,6113,0,1,4
1731,4,2,6116,6116,6118,0,2,3
1732,6,2,6122,6122,6124,0,2,4
1733,6,1,6128,6128,6129,0,1,4
1734,4,2,6132,6132,6134,0,2,3
1735,1,2,6133,6134,6136,1,3,0
1736,6,3,6139,6139,6142,0,3,3
1737,5,2,6144,6144,6146,0,2,2
1738,3,1,6147,6147,6148,0,1,1
1739,4,3,6151,6151,6154,0,3,3
1740,1,1,6152,6154,6155,2,3,0
1741,6,3,6158,6158,6161,0,3,3
1742,1,3,6159,6161,6164,2,5,0
1743,4,3,6163,6164,6167,1,4,0
1744,5,1,6168,6168,6169,0,1,1
1745,6,3,6174,6174,6177,0,3,5
1746,1,1,6175,6177,6178,2,3,0
1747,5,3,6180,6180,6183,0,3,2
1748,6,3,6186,6186,6189,0,3,3
1749,1,2,6187,6189,6191,2,4,0
1750,2,2,6189,6191,6193,2,4,0
1751,1,2,6190,6193,6195,3,5,0
1752,1,2,6191,6195,6197,4,6,0
1753,1,1,6192,6197,6198,5,6,0
1754,1,3,6193,6198,6201,5,8,0
1755,2,3,6195,6201,6204,6,9,0
1756,1,3,6196,6204,6207,8,11,0
1757,1,2,6197,6207,6209,10,12,0
1758,3,2,6200,6209,6211,9,11,0
1759,6,3,6206,6211,6214,5,8,0
1760,1,2,6207,6214,6216,7,9,0
1761,3,2,6210,6216,6218,6,8,0
1762,2,3,6212,6218,6221,6,9,0
1763,5,1,6217,6221,6222,4,5,0
1764,5,3,6222,6222,6225,0,3,0
1765,5,3,6227,6227,6230,0,3,2
1766,6,1,6233,6233,6234,0,1,3
1767,2,1,6235,6235,6236,0,1,1
1768,5,1,6240,6240,6241,0,1,4
1769,6,2,6246,6246,6248,0,2,5
1770,4,1,6250,6250,6251,0,1,2
1771,1,1,6251,6251,6252,0,1,0
1772,6,3,6257,6257,6260,0,3,5
1773,6,3,6263,6263,6266,0,3,3
1774,5,3,6268,6268,6271,0,3,2
1775,5,3,6273,6273,6276,0,3,2
1776,4,3,6277,6277,6280,0,3,1
1777,5,3,6282,6282,6285,0,3,2
1778,4,3,6286,6286,6289,0,3,1
1779,6,2,6292,6292,6294,0,2,3
1780,5,2,6297,6297,6299,0,2,3
1781,4,2,6301,6301,6303,0,2,2
1782,1,1,6302,6303,6304,1,2,0
1783,5,2,6307,6307,6309,0,2,3
1784,6,1,6313,6313,6314,0,1,4
1785,1,2,6314,6314,6316,0,2,0
1786,2,2,6316,6316,6318,0,2,0
1787,6,2,6322,6322,6324,0,2,4
1788,5,1,6327,6327,6328,0,1,3
1789,2,1,6329,6329,6330,0,1,1
1790,4,1,6333,6333,6334,0,1,3
1791,3,2,6336,6336,6338,0,2,2
1792,5,1,6341,6341,6342,0,1,3
1793,3,3,6344,6344,6347,0,3,2
1794,3,3,6347,6347,6350,0,3,0
1795,6,1,6353,6353,6354,0,1,3
1796,6,1,6359,6359,6360,0,1,5
1797,2,1,6361,6361,6362,0,1,1
1798,2,3,6363,6363,6366,0,3,1
1799,2,2,6365,6366,6368,1,3,0
1800,2,2,6367,6368,6370,1,3,0
1801,4,2,6371,6371,6373,0,2,1
1802,5,3,6376,6376,6379,0,3,3
1803,4,3,6380,6380,6383,0,3,1
1804,6,3,6386,6386,6389,0,3,3
1805,1,1,6387,6389,6390,2,3,0
1806,2,1,6389,6390,6391,1,2,0
1807,5,1,6394,6394,6395,0,1,3
1808,2,2,6396,6396,6398,0,2,1
1809,4,1,6400,6400,6401,0,1,2
1810,5,1,6405,6405,6406,0,1,4
1811,4,2,6409,6409,6411,0,2,3
1812,1,2,6410,6411,6413,1,3,0
1813,1,3,6411,6413,6416,2,5,0
1814,5,3,6416,6416,6419,0,3,0
1815,5,1,6421,6421,6422,0,1,2
1816,1,3,6422,6422,6425,0,3,0
1817,2,2,6424,6425,6427,1,3,0
1818,5,2,6429,6429,6431,0,2,2
1819,6,2,6435,6435,6437,0,2,4
1820,3,2,6438,6438,6440,0,2,1
1821,4,3,6442,6442,6445,0,3,2
1822,4,3,6446,6446,6449,0,3,1
1823,4,3,6450,6450,6453,0,3,1
1824,5,3,6455,6455,6458,0,3,2
1825,4,2,6459,6459,6461,0,2,1
1826,2,2,6461,6461,6463,0,2,0
1827,6,1,6467,6467,6468,0,1,4
1828,5,2,6472,6472,6474,0,2,4
1829,4,3,6476,6476,6479,0,3,2
1830,5,2,6481,6481,6483,0,2,2
1831,3,3,6484,6484,6487,0,3,1
1832,1,1,6485,6487,6488,2,3,0
1833,3,1,6488,6488,6489,0,1,0
1834,5,3,6493,6493,6496,0,3,4
1835,5,1,6498,6498,6499,0,1,2
1836,5,3,6503,6503,6506,0,3,4
1837,2,1,6505,6506,6507,1,2,0
1838,2,3,6507,6507,6510,0,3,0
1839,3,2,6510,6510,6512,0,2,0
1840,6,3,6516,6516,6519,0,3,4
1841,2,2,6518,6519,6521,1,3,0
1842,5,3,6523,6523,6526,0,3,2
1843,4,1,6527,6527,6528,0,1,1
1844,2,3,6529,6529,6532,0,3,1
1845,5,2,6534,6534,6536,0,2,2
1846,3,3,6537,6537,6540,0,3,1
1847,1,2,6538,6540,6542,2,4,0
1848,4,2,6542,6542,6544,0,2,0
1849,3,3,6545,6545,6548,0,3,1
1850,4,2,6549,6549,6551,0,2,1
1851,6,3,6555,6555,6558,0,3,4
1852,4,1,6559,6559,6560,0,1,1
1853,4,3,6563,6563,6566,0,3,3
1854,2,2,6565,6566,6568,1,3,0
1855,5,2,6570,6570,6572,0,2,2
1856,2,2,6572,6572,6574,0,2,0
1857,6,2,6578,6578,6580,0,2,4
1858,1,1,6579,6580,6581,1,2,0
1859,4,1,6583,6583,6584,0,1,2
1860,5,3,6588,6588,6591,0,3,4
1861,3,3,6591,6591,6594,0,3,0
1862,2,3,6593,6594,6597,1,4,0
1863,5,3,6598,6598,6601,0,3,1
1864,4,2,6602,6602,6604,0,2,1
1865,6,3,6608,6608,6611,0,3,4
1866,3,3,6611,6611,6614,0,3,0
1867,2,1,6613,6614,6615,1,2,0
1868,4,3,6617,6617,6620,0,3,2
1869,2,1,6619,6620,6621,1,2,0
1870,2,3,6621,6621,6624,0,3,0
1871,1,2,6622,6624,6626,2,4,0
1872,4,1,6626,6626,6627,0,1,0
1873,2,1,6628,6628,6629,0,1,1
1874,6,1,6634,6634,6635,0,1,5
1875,3,1,6637,6637,6638,0,1,2
1876,6,3,6643,6643,6646,0,3,5
1877,1,3,6644,6646,6649,2,5,0
1878,6,3,6650,6650,6653,0,3,1
1879,5,3,6655,6655,6658,0,3,2
1880,6,3,6661,6661,6664,0,3,3
1881,6,2,6667,6667,6669,0,2,3
1882,1,3,6668,6669,6672,1,4,0
1883,6,1,6674,6674,6675,0,1,2
1884,1,3,6675,6675,6678,0,3,0
1885,3,3,6678,6678,6681,0,3,0
1886,2,1,6680,6681,6682,1,2,0
1887,4,2,6684,6684,6686,0,2,2
1888,4,3,6688,6688,6691,0,3,2
1889,3,1,6691,6691,6692,0,1,0
1890,4,3,6695,6695,6698,0,3,3
1891,4,2,6699,6699,6701,0,2,1
1892,6,3,6705,6705,6708,0,3,4
1893,5,2,6710,6710,6712,0,2,2
1894,6,1,6716,6716,6717,0,1,4
1895,2,2,6718,6718,6720,0,2,1
1896,3,2,6721,6721,6723,0,2,1
1897,2,1,6723,6723,6724,0,1,0
1898,4,2,6727,6727,6729,0,2,3
1899,4,1,6731,6731,6732,0,1,2
1900,2,1,6733,6733,6734,0,1,1
1901,5,2,6738,6738,6740,0,2,4
1902,4,3,6742,6742,6745,0,3,2
1903,3,2,6745,6745,6747,0,2,0
1904,3,2,6748,6748,6750,0,2,1
1905,4,2,6752,6752,6754,0,2,2
1906,5,2,6757,6757,6759,0,2,3
1907,6,1,6763,6763,6764,0,1,4
1908,1,1,6764,6764,6765,0,1,0
1909,6,2,6770,6770,6772,0,2,5
1910,5,1,6775,6775,6776,0,1,3
1911,1,2,6776,6776,6778,0,2,0
1912,4,1,6780,6780,6781,0,1,2
1913,4,1,6784,6784,6785,0,1,3
1914,5,2,6789,6789,6791,0,2,4
1915,4,2,6793,6793,6795,0,2,2
1916,4,1,6797,6797,6798,0,1,2
1917,6,3,6803,6803,6806,0,3,5
1918,6,1,6809,6809,6810,0,1,3
1919,4,1,6813,6813,6814,0,1,3
1920,4,2,6817,6817,6819,0,2,3
1921,3,3,6820,6820,6823,0,3,1
1922,1,1,6821,6823,6824,2,3,0
1923,5,1,6826,6826,6827,0,1,2
1924,1,2,6827,6827,6829,0,2,0
1925,4,3,6831,6831,6834,0,3,2
1926,5,3,6836,6836,6839,0,3,2
1927,3,1,6839,6839,6840,0,1,0
1928,2,2,6841,6841,6843,0,2,1
1929,5,2,6846,6846,6848,0,2,3
1930,1,2,6847,6848,6850,1,3,0
1931,3,1,6850,6850,6851,0,1,0
1932,3,3,6853,6853,6856,0,3,2
1933,2,1,6855,6856,6857,1,2,0
1934,2,1,6857,6857,6858,0,1,0
1935,1,1,6858,6858,6859,0,1,0
1936,4,1,6862,6862,6863,0,1,3
1937,3,2,6865,6865,6867,0,2,2
1938,4,1,6869,6869,6870,0,1,2
1939,2,2,6871,6871,6873,0,2,1
1940,1,3,6872,6873,6876,1,4,0
1941,5,3,6877,6877,6880,0,3,1
1942,5,1,6882,6882,6883,0,1,2
1943,6,1,6888,6888,6889,0,1,5
1944,6,2,6894,6894,6896,0,2,5
1945,5,1,6899,6899,6900,0,1,3
1946,5,2,6904,6904,6906,0,2,4
1947,5,1,6909,6909,6910,0,1,3
1948,5,1,6914,6914,6915,0,1,4
1949,4,2,6918,6918,6920,0,2,3
1950,5,1,6923,6923,6924,0,1,3
1951,1,2,6924,6924,6926,0,2,0
1952,6,3,6930,6930,6933,0,3,4
1953,4,2,6934,6934,6936,0,2,1
1954,4,2,6938,6938,6940,0,2,2
1955,1,1,6939,6940,6941,1,2,0
1956,3,3,6942,6942,6945,0,3,1
1957,5,2,6947,6947,6949,0,2,2
1958,1,3,6948,6949,6952,1,4,0
1959,4,2,6952,6952,6954,0,2,0
1960,1,2,6953,6954,6956,1,3,0
1961,2,1,6955,6956,6957,1,2,0
1962,3,1,6958,6958,6959,0,1,1
1963,5,2,6963,6963,6965,0,2,4
1964,3,3,6966,6966,6969,0,3,1
1965,5,2,6971,6971,6973,0,2,2
1966,3,1,6974,6974,6975,0,1,1
1967,6,2,6980,6980,6982,0,2,5
1968,3,3,6983,6983,6986,0,3,1
1969,4,1,6987,6987,6988,0,1,1
1970,5,1,6992,6992,6993,0,1,4
1971,4,3,6996,6996,6999,0,3,3
1972,1,1,6997,6999,7000,2,3,0
1973,2,2,6999,7000,7002,1,3,0
1974,1,2,7000,7002,7004,2,4,0
1975,4,1,7004,7004,7005,0,1,0
1976,4,3,7008,7008,7011,0,3,3
1977,3,2,7011,7011,7013,0,2,0
1978,4,1,7015,7015,7016,0,1,2
1979,6,3,7021,7021,7024,0,3,5
1980,6,3,7027,7027,7030,0,3,3
1981,2,1,7029,7030,7031,1,2,0
1982,3,2,7032,7032,7034,0,2,1
1983,1,1,7033,7034,7035,1,2,0
1984,1,1,7034,7035,7036,1,2,0
1985,2,3,7036,7036,7039,0,3,0
1986,4,3,7040,7040,7043,0,3,1
1987,2,1,7042,7043,7044,1,2,0
1988,2,3,7044,7044,7047,0,3,0
1989,3,1,7047,7047,7048,0,1,0
1990,3,3,7050,7050,7053,0,3,2
1991,6,3,7056,7056,7059,0,3,3
1992,2,1,7058,7059,7060,1,2,0
1993,6,3,7064,7064,7067,0,3,4
1994,5,3,7069,7069,7072,0,3,2
1995,4,3,7073,7073,7076,0,3,1
1996,4,2,7077,7077,7079,0,2,1
1997,1,2,7078,7079,7081,1,3,0
1998,1,1,7079,7081,7082,2,3,0
1999,5,1,7084,7084,7085,0,1,2
2000,4,2,7088,7088,7090,0,2,3
2001,4,3,7092,7092,7095,0,3,2
2002,2,1,7094,7095,7096,1,2,0
2003,3,1,7097,7097,7098,0,1,1
2004,1,2,7098,7098,7100,0,2,0
2005,6,1,7104,7104,7105,0,1,4
2006,1,1,7105,7105,7106,0,1,0
2007,4,2,7109,7109,7111,0,2,3
2008,2,3,7111,7111,7114,0,3,0
2009,1,3,7112,7114,7117,2,5,0
2010,4,1,7116,7117,7118,1,2,0
2011,3,2,7119,7119,7121,0,2,1
2012,6,3,7125,7125,7128,0,3,4
2013,4,1,7129,7129,7130,0,1,1
2014,4,2,7133,7133,7135,0,2,3
2015,3,1,7136,7136,7137,0,1,1
2016,6,2,7142,7142,7144,0,2,5
2017,6,3,7148,7148,7151,0,3,4
2018,4,1,7152,7152,7153,0,1,1
2019,2,1,7154,7154,7155,0,1,1
2020,1,2,7155,7155,7157,0,2,0
2021,6,1,7161,7161,7162,0,1,4
2022,4,1,7165,7165,7166,0,1,3
2023,3,3,7168,7168,7171,0,3,2
2024,2,1,7170,7171,7172,1,2,0
2025,2,2,7172,7172,7174,0,2,0
2026,6,2,7178,7178,7180,0,2,4
2027,2,3,7180,7180,7183,0,3,0
2028,1,3,7181,7183,7186,2,5,0
2029,2,3,7183,7186,7189,3,6,0
2030,1,1,7184,7189,7190,5,6,0
2031,3,2,7187,7190,7192,3,5,0
2032,2,1,7189,7192,7193,3,4,0
2033,2,2,7191,7193,7195,2,4,0
2034,3,2,7194,7195,7197,1,3,0
2035,1,3,7195,7197,7200,2,5,0
2036,5,1,7200,7200,7201,0,1,0
2037,1,1,7201,7201,7202,0,1,0
2038,3,1,7204,7204,7205,0,1,2
2039,6,3,7210,7210,7213,0,3,5
2040,5,1,7215,7215,7216,0,1,2
2041,2,2,7217,7217,7219,0,2,1
2042,2,3,7219,7219,7222,0,3,0
2043,2,1,7221,7222,7223,1,2,0
2044,6,3,7227,7227,7230,0,3,4
2045,6,2,7233,7233,7235,0,2,3
2046,1,2,7234,7235,7237,1,3,0
2047,1,3,7235,7237,7240,2,5,0
2048,3,3,7238,7240,7243,2,5,0
2049,1,3,7239,7243,7246,4,7,0
2050,1,1,7240,7246,7247,6,7,0
2051,1,1,7241,7247,7248,6,7,0
2052,6,2,7247,7248,7250,1,3,0
2053,5,3,7252,7252,7255,0,3,2
2054,1,1,7253,7255,7256,2,3,0
2055,3,1,7256,7256,7257,0,1,0
2056,6,1,7262,7262,7263,0,1,5
2057,6,1,7268,7268,7269,0,1,5
2058,4,3,7272,7272,7275,0,3,3
2059,5,2,7277,7277,7279,0,2,2
2060,2,1,7279,7279,7280,0,1,0
2061,4,1,7283,7283,7284,0,1,3
2062,3,2,7286,7286,7288,0,2,2
2063,1,1,7287,7288,7289,1,2,0
2064,3,2,7290,7290,7292,0,2,1
2065,1,2,7291,7292,7294,1,3,0
2066,2,2,7293,7294,7296,1,3,0
2067,5,1,7298,7298,7299,0,1,2
2068,5,3,7303,7303,7306,0,3,4
2069,3,2,7306,7306,7308,0,2,0
2070,6,3,7312,7312,7315,0,3,4
2071,5,1,7317,7317,7318,0,1,2
2072,2,1,7319,7319,7320,0,1,1
2073,5,3,7324,7324,7327,0,3,4
2074,3,2,7327,7327,7329,0,2,0
2075,3,3,7330,7330,7333,0,3,1
2076,5,2,7335,7335,7337,0,2,2
2077,3,3,7338,7338,7341,0,3,1
2078,5,2,7343,7343,7345,0,2,2
2079,3,1,7346,7346,7347,0,1,1
2080,6,1,7352,7352,7353,0,1,5
2081,5,1,7357,7357,7358,0,1,4
2082,5,2,7362,7362,7364,0,2,4
2083,6,2,7368,7368,7370,0,2,4
2084,3,1,7371,7371,7372,0,1,1
2085,3,1,7374,7374,7375,0,1,2
2086,2,3,7376,7376,7379,0,3,1
2087,1,1,7377,7379,7380,2,3,0
2088,5,1,7382,7382,7383,0,1,2
2089,2,1,7384,7384,7385,0,1,1
2090,4,1,7388,7388,7389,0,1,3
2091,4,1,7392,7392,7393,0,1,3
2092,1,1,7393,7393,7394,0,1,0
2093,4,2,7397,7397,7399,0,2,3
2094,5,1,7402,7402,7403,0,1,3
2095,4,2,7406,7406,7408,0,2,3
2096,3,2,7409,7409,7411,0,2,1
2097,5,1,7414,7414,7415,0,1,3
2098,3,1,7417,7417,7418,0,1,2
2099,2,1,7419,7419,7420,0,1,1
2100,1,3,7420,7420,7423,0,3,0
2101,6,3,7426,7426,7429,0,3,3
2102,1,3,7427,7429,7432,2,5,0
2103,4,1,7431,7432,7433,1,2,0
2104,6,2,7437,7437,7439,0,2,4
2105,1,2,7438,7439,7441,1,3,0
2106,2,3,7440,7441,7444,1,4,0
2107,6,2,7446,7446,7448,0,2,2
2108,3,2,7449,7449,7451,0,2,1
2109,1,1,7450,7451,7452,1,2,0
2110,1,2,7451,7452,7454,1,3,0
2111,5,2,7456,7456,7458,0,2,2
2112,2,3,7458,7458,7461,0,3,0
2113,3,3,7461,7461,7464,0,3,0
2114,6,3,7467,7467,7470,0,3,3
2115,3,1,7470,7470,7471,0,1,0
2116,2,2,7472,7472,7474,0,2,1
2117,4,2,7476,7476,7478,0,2,2
2118,5,3,7481,7481,7484,0,3,3
2119,4,3,7485,7485,7488,0,3,1
2120,5,2,7490,7490,7492,0,2,2
2121,2,3,7492,7492,7495,0,3,0
2122,2,3,7494,7495,7498,1,4,0
2123,5,2,7499,7499,7501,0,2,1
2124,1,2,7500,7501,7503,1,3,0
2125,4,3,7504,7504,7507,0,3,1
2126,1,1,7505,7507,7508,2,3,0
2127,4,1,7509,7509,7510,0,1,1
2128,6,3,7515,7515,7518,0,3,5
2129,3,2,7518,7518,7520,0,2,0
2130,4,1,7522,7522,7523,0,1,2
2131,6,3,7528,7528,7531,0,3,5
2132,6,2,7534,7534,7536,0,2,3
2133,6,2,7540,7540,7542,0,2,4
2134,6,3,7546,7546,7549,0,3,4
2135,4,2,7550,7550,7552,0,2,1
2136,3,3,7553,7553,7556,0,3,1
2137,6,1,7559,7559,7560,0,1,3
2138,2,3,7561,7561,7564,0,3,1
2139,3,3,7564,7564,7567,0,3,0
2140,6,2,7570,7570,7572,0,2,3
2141,1,2,7571,7572,7574,1,3,0
2142,3,1,7574,7574,7575,0,1,0
2143,6,2,7580,7580,7582,0,2,5
2144,1,1,7581,7582,7583,1,2,0
2145,5,3,7586,7586,7589,0,3,3
2146,4,2,7590,7590,7592,0,2,1
2147,3,2,7593,7593,7595,0,2,1
2148,1,1,7594,7595,7596,1,2,0
2149,6,1,7600,7600,7601,0,1,4
2150,4,2,7604,7604,7606,0,2,3
2151,6,1,7610,7610,7611,0,1,4
2152,5,1,7615,7615,7616,0,1,4
2153,3,3,7618,7618,7621,0,3,2
2154,4,2,7622,7622,7624,0,2,1
2155,1,1,7623,7624,7625,1,2,0
2156,4,3,7627,7627,7630,0,3,2
2157,3,1,7630,7630,7631,0,1,0
2158,4,1,7634,7634,7635,0,1,3
2159,6,1,7640,7640,7641,0,1,5
2160,6,3,7646,7646,7649,0,3,5
2161,2,2,7648,7649,7651,1,3,0
2162,5,1,7653,7653,7654,0,1,2
2163,3,2,7656,7656,7658,0,2,2
2164,4,3,7660,7660,7663,0,3,2
2165,6,3,7666,7666,7669,0,3,3
2166,3,3,7669,7669,7672,0,3,0
2167,6,1,7675,7675,7676,0,1,3
2168,3,1,7678,7678,7679,0,1,2
2169,4,2,7682,7682,7684,0,2,3
2170,2,2,7684,7684,7686,0,2,0
2171,3,3,7687,7687,7690,0,3,1
2172,4,3,7691,7691,7694,0,3,1
2173,3,3,7694,7694,7697,0,3,0
2174,4,1,7698,7698,7699,0,1,1
2175,4,3,7702,7702,7705,0,3,3
2176,5,3,7707,7707,7710,0,3,2
2177,3,1,7710,7710,7711,0,1,0
2178,3,3,7713,7713,7716,0,3,2
2179,2,3,7715,7716,7719,1,4,0
2180,5,3,7720,7720,7723,0,3,1
2181,2,3,7722,7723,7726,1,4,0
2182,5,2,7727,7727,7729,0,2,1
2183,6,2,7733,7733,7735,0,2,4
2184,3,3,7736,7736,7739,0,3,1
2185,5,1,7741,7741,7742,0,1,2
2186,6,2,7747,7747,7749,0,2,5
2187,4,1,7751,7751,7752,0,1,2
2188,5,2,7756,7756,7758,0,2,4
2189,5,2,7761,7761,7763,0,2,3
2190,3,1,7764,7764,7765,0,1,1
2191,6,2,7770,7770,7772,0,2,5
2192,1,1,7771,7772,7773,1,2,0
2193,3,2,7774,7774,7776,0,2,1
2194,5,2,7779,7779,7781,0,2,3
2195,6,3,7785,7785,7788,0,3,4
2196,2,3,7787,7788,7791,1,4,0
2197,4,1,7791,7791,7792,0,1,0
2198,1,3,7792,7792,7795,0,3,0
2199,6,3,7798,7798,7801,0,3,3
2200,2,2,7800,7801,7803,1,3,0
2201,1,1,7801,7803,7804,2,3,0
2202,5,1,7806,7806,7807,0,1,2
2203,1,2,7807,7807,7809,0,2,0
2204,4,2,7811,7811,7813,0,2,2
2205,5,3,7816,7816,7819,0,3,3
2206,3,2,7819,7819,7821,0,2,0
2207,1,2,7820,7821,7823,1,3,0
2208,1,2,7821,7823,7825,2,4,0
2209,3,3,7824,7825,7828,1,4,0
2210,3,2,7827,7828,7830,1,3,0
2211,6,3,7833,7833,7836,0,3,3
2212,2,1,7835,7836,7837,1,2,0
2213,1,2,7836,7837,7839,1,3,0
2214,6,3,7842,7842,7845,0,3,3
2215,6,1,7848,7848,7849,0,1,3
2216,6,3,7854,7854,7857,0,3,5
2217,3,2,7857,7857,7859,0,2,0
2218,4,3,7861,7861,7864,0,3,2
2219,1,3,7862,7864,7867,2,5,0
2220,4,2,7866,7867,7869,1,3,0
2221,6,1,7872,7872,7873,0,1,3
2222,3,3,7875,7875,7878,0,3,2
2223,3,1,7878,7878,7879,0,1,0
2224,4,2,7882,7882,7884,0,2,3
2225,1,3,7883,7884,7887,1,4,0
2226,3,1,7886,7887,7888,1,2,0
2227,6,1,7892,7892,7893,0,1,4
2228,3,1,7895,7895,7896,0,1,2
2229,5,3,7900,7900,7903,0,3,4
2230,4,1,7904,7904,7905,0,1,1
2231,1,3,7905,7905,7908,0,3,0
2232,2,1,7907,7908,7909,1,2,0
2233,5,1,7912,7912,7913,0,1,3
2234,6,2,7918,7918,7920,0,2,5
2235,1,3,7919,7920,7923,1,4,0
2236,6,1,7925,7925,7926,0,1,2
2237,5,2,7930,7930,7932,0,2,4
2238,4,3,7934,7934,7937,0,3,2
2239,1,1,7935,7937,7938,2,3,0
2240,6,1,7941,7941,7942,0,1,3
2241,2,3,7943,7943,7946,0,3,1
2242,1,2,7944,7946,7948,2,4,0
2243,5,1,7949,7949,7950,0,1,1
2244,1,2,7950,7950,7952,0,2,0
2245,1,1,7951,7952,7953,1,2,0
2246,2,3,7953,7953,7956,0,3,0
2247,2,1,7955,7956,7957,1,2,0
2248,6,3,7961,7961,7964,0,3,4
2249,2,3,7963,7964,7967,1,4,0
2250,1,2,7964,7967,7969,3,5,0
2251,1,3,7965,7969,7972,4,7,0
2252,5,3,7970,7972,7975,2,5,0
2253,6,1,7976,7976,7977,0,1,1
2254,4,2,7980,7980,7982,0,2,3
2255,4,2,7984,7984,7986,0,2,2
2256,5,1,7989,7989,7990,0,1,3
2257,5,1,7994,7994,7995,0,1,4
2258,6,3,8000,8000,8003,0,3,5
2259,4,3,8004,8004,8007,0,3,1
2260,4,1,8008,8008,8009,0,1,1
2261,1,2,8009,8009,8011,0,2,0
2262,1,1,8010,8011,8012,1,2,0
2263,3,1,8013,8013,8014,0,1,1
2264,4,2,8017,8017,8019,0,2,3
2265,6,2,8023,8023,8025,0,2,4
2266,2,3,8025,8025,8028,0,3,0
2267,1,2,8026,8028,8030,2,4,0
2268,1,1,8027,8030,8031,3,4,0
2269,1,2,8028,8031,8033,3,5,0
2270,4,2,8032,8033,8035,1,3,0
2271,4,1,8036,8036,8037,0,1,1
2272,4,2,8040,8040,8042,0,2,3
2273,3,3,8043,8043,8046,0,3,1
2274,5,2,8048,8048,8050,0,2,2
2275,6,2,8054,8054,8056,0,2,4
2276,6,2,8060,8060,8062,0,2,4
2277,6,3,8066,8066,8069,0,3,4
2278,4,3,8070,8070,8073,0,3,1
2279,2,2,8072,8073,8075,1,3,0
2280,4,2,8076,8076,8078,0,2,1
2281,3,2,8079,8079,8081,0,2,1
2282,5,3,8084,8084,8087,0,3,3
2283,6,2,8090,8090,8092,0,2,3
2284,4,2,8094,8094,8096,0,2,2
2285,6,1,8100,8100,8101,0,1,4
2286,2,3,8102,8102,8105,0,3,1
2287,1,3,8103,8105,8108,2,5,0
2288,6,2,8109,8109,8111,0,2,1
2289,1,1,8110,8111,8112,1,2,0
2290,4,3,8114,8114,8117,0,3,2
2291,2,1,8116,8117,8118,1,2,0
2292,6,3,8122,8122,8125,0,3,4
2293,1,2,8123,8125,8127,2,4,0
2294,2,3,8125,8127,8130,2,5,0
2295,3,1,8128,8130,8131,2,3,0
2296,1,3,8129,8131,8134,2,5,0
2297,1,2,8130,8134,8136,4,6,0
2298,5,3,8135,8136,8139,1,4,0
2299,3,1,8138,8139,8140,1,2,0
2300,3,3,8141,8141,8144,0,3,1
2301,4,1,8145,8145,8146,0,1,1
2302,4,2,8149,8149,8151,0,2,3
2303,4,2,8153,8153,8155,0,2,2
2304,1,1,8154,8155,8156,1,2,0
2305,2,3,8156,8156,8159,0,3,0
2306,2,1,8158,8159,8160,1,2,0
2307,1,1,8159,8160,8161,1,2,0
2308,1,3,8160,8161,8164,1,4,0
2309,5,3,8165,8165,8168,0,3,1
2310,4,3,8169,8169,8172,0,3,1
2311,2,3,8171,8172,8175,1,4,0
2312,6,1,8177,8177,8178,0,1,2
2313,1,2,8178,8178,8180,0,2,0
2314,2,3,8180,8180,8183,0,3,0
2315,1,1,8181,8183,8184,2,3,0
2316,6,1,8187,8187,8188,0,1,3
2317,4,1,8191,8191,8192,0,1,3
2318,1,2,8192,8192,8194,0,2,0
2319,3,1,8195,8195,8196,0,1,1
2320,5,1,8200,8200,8201,0,1,4
2321,5,3,8205,8205,8208,0,3,4
2322,3,2,8208,8208,8210,0,2,0
2323,4,3,8212,8212,8215,0,3,2
2324,6,3,8218,8218,8221,0,3,3
2325,5,3,8223,8223,8226,0,3,2
2326,2,1,8225,8226,8227,1,2,0
2327,6,1,8231,8231,8232,0,1,4
2328,6,1,8237,8237,8238,0,1,5
2329,1,3,8238,8238,8241,0,3,0
2330,5,3,8243,8243,8246,0,3,2
2331,6,1,8249,8249,8250,0,1,3
2332,5,3,8254,8254,8257,0,3,4
2333,4,1,8258,8258,8259,0,1,1
2334,4,3,8262,8262,8265,0,3,3
2335,3,3,8265,8265,8268,0,3,0
2336,2,3,8267,8268,8271,1,4,0
2337,4,2,8271,8271,8273,0,2,0
2338,4,2,8275,8275,8277,0,2,2
2339,4,1,8279,8279,8280,0,1,2
2340,4,1,8283,8283,8284,0,1,3
2341,5,3,8288,8288,8291,0,3,4
2342,1,1,8289,8291,8292,2,3,0
2343,1,2,8290,8292,8294,2,4,0
2344,5,2,8295,8295,8297,0,2,1
2345,4,2,8299,8299,8301,0,2,2
2346,1,2,8300,8301,8303,1,3,0
2347,4,3,8304,8304,8307,0,3,1
2348,4,1,8308,8308,8309,0,1,1
2349,4,3,8312,8312,8315,0,3,3
2350,5,2,8317,8317,8319,0,2,2
2351,4,3,8321,8321,8324,0,3,2
2352,4,2,8325,8325,8327,0,2,1
2353,2,1,8327,8327,8328,0,1,0
2354,2,1,8329,8329,8330,0,1,1
2355,4,2,8333,8333,8335,0,2,3
2356,5,2,8338,8338,8340,0,2,3
2357,4,2,8342,8342,8344,0,2,2
2358,6,2,8348,8348,8350,0,2,4
2359,3,1,8351,8351,8352,0,1,1
2360,5,3,8356,8356,8359,0,3,4
2361,2,1,8358,8359,8360,1,2,0
2362,2,2,8360,8360,8362,0,2,0
2363,1,3,8361,8362,8365,1,4,0
2364,5,2,8366,8366,8368,0,2,1
2365,6,1,8372,8372,8373,0,1,4
2366,2,2,8374,8374,8376,0,2,1
2367,2,2,8376,8376,8378,0,2,0
2368,6,3,8382,8382,8385,0,3,4
2369,6,3,8388,8388,8391,0,3,3
2370,4,1,8392,8392,8393,0,1,1
2371,5,1,8397,8397,8398,0,1,4
2372,4,3,8401,8401,8404,0,3,3
2373,2,1,8403,8404,8405,1,2,0
2374,2,2,8405,8405,8407,0,2,0
2375,3,1,8408,8408,8409,0,1,1
2376,3,3,8411,8411,8414,0,3,2
2377,2,1,8413,8414,8415,1,2,0
2378,3,1,8416,8416,8417,0,1,1
2379,3,3,8419,8419,8422,0,3,2
2380,3,2,8422,8422,8424,0,2,0
2381,3,3,8425,8425,8428,0,3,1
2382,6,2,8431,8431,8433,0,2,3
2383,1,3,8432,8433,8436,1,4,0
2384,1,3,8433,8436,8439,3,6,0
2385,3,3,8436,8439,8442,3,6,0
2386,2,2,8438,8442,8444,4,6,0
2387,1,1,8439,8444,8445,5,6,0
2388,4,2,8443,8445,8447,2,4,0
2389,3,2,8446,8447,8449,1,3,0
2390,4,2,8450,8450,8452,0,2,1
2391,3,2,8453,8453,8455,0,2,1
2392,1,2,8454,8455,8457,1,3,0
2393,1,2,8455,8457,8459,2,4,0
2394,3,1,8458,8459,8460,1,2,0
2395,4,2,8462,8462,8464,0,2,2
2396,2,1,8464,8464,8465,0,1,0
2397,6,2,8470,8470,8472,0,2,5
2398,5,2,8475,8475,8477,0,2,3
2399,5,1,8480,8480,8481,0,1,3
2400,4,2,8484,8484,8486,0,2,3
2401,6,3,8490,8490,8493,0,3,4
2402,6,1,8496,8496,8497,0,1,3
2403,5,1,8501,8501,8502,0,1,4
2404,4,3,8505,8505,8508,0,3,3
2405,6,3,8511,8511,8514,0,3,3
2406,2,2,8513,8514,8516,1,3,0
2407,6,3,8519,8519,8522,0,3,3
2408,4,1,8523,8523,8524,0,1,1
2409,4,2,8527,8527,8529,0,2,3
2410,2,2,8529,8529,8531,0,2,0
2411,1,3,8530,8531,8534,1,4,0
2412,5,3,8535,8535,8538,0,3,1
2413,5,3,8540,8540,8543,0,3,2
2414,5,1,8545,8545,8546,0,1,2
2415,4,1,8549,8549,8550,0,1,3
2416,6,1,8555,8555,8556,0,1,5
2417,3,3,8558,8558,8561,0,3,2
2418,1,3,8559,8561,8564,2,5,0
2419,6,1,8565,8565,8566,0,1,1
2420,6,1,8571,8571,8572,0,1,5
2421,3,3,8574,8574,8577,0,3,2
2422,3,1,8577,8577,8578,0,1,0
2423,4,3,8581,8581,8584,0,3,3
2424,2,1,8583,8584,8585,1,2,0
2425,5,3,8588,8588,8591,0,3,3
2426,1,2,8589,8591,8593,2,4,0
2427,2,3,8591,8593,8596,2,5,0
2428,1,3,8592,8596,8599,4,7,0
2429,4,2,8596,8599,8601,3,5,0
2430,5,2,8601,8601,8603,0,2,0
2431,5,2,8606,8606,8608,0,2,3
2432,2,2,8608,8608,8610,0,2,0
2433,6,3,8614,8614,8617,0,3,4
2434,5,2,8619,8619,8621,0,2,2
2435,6,2,8625,8625,8627,0,2,4
2436,3,3,8628,8628,8631,0,3,1
2437,5,1,8633,8633,8634,0,1,2
2438,6,1,8639,8639,8640,0,1,5
2439,6,1,8645,8645,8646,0,1,5
2440,1,3,8646,8646,8649,0,3,0
2441,4,3,8650,8650,8653,0,3,1
2442,4,3,8654,8654,8657,0,3,1
2443,6,3,8660,8660,8663,0,3,3
2444,1,3,8661,8663,8666,2,5,0
2445,6,2,8667,8667,8669,0,2,1
2446,1,1,8668,8669,8670,1,2,0
2447,4,2,8672,8672,8674,0,2,2
2448,5,3,8677,8677,8680,0,3,3
2449,5,1,8682,8682,8683,0,1,2
2450,3,2,8685,8685,8687,0,2,2
2451,3,1,8688,8688,8689,0,1,1
2452,5,2,8693,8693,8695,0,2,4
2453,1,2,8694,8695,8697,1,3,0
2454,3,2,8697,8697,8699,0,2,0
2455,3,3,8700,8700,8703,0,3,1
2456,4,3,8704,8704,8707,0,3,1
2457,3,2,8707,8707,8709,0,2,0
2458,3,2,8710,8710,8712,0,2,1
2459,5,3,8715,8715,8718,0,3,3
2460,3,2,8718,8718,8720,0,2,0
2461,3,3,8721,8721,8724,0,3,1
2462,6,2,8727,8727,8729,0,2,3
2463,5,3,8732,8732,8735,0,3,3
2464,2,1,8734,8735,8736,1,2,0
2465,4,3,8738,8738,8741,0,3,2
2466,6,2,8744,8744,8746,0,2,3
2467,4,1,8748,8748,8749,0,1,2
2468,6,3,8754,8754,8757,0,3,5
2469,6,2,8760,8760,8762,0,2,3
2470,1,2,8761,8762,8764,1,3,0
2471,5,2,8766,8766,8768,0,2,2
2472,6,2,8772,8772,8774,0,2,4
2473,5,2,8777,8777,8779,0,2,3
2474,3,3,8780,8780,8783,0,3,1
2475,2,1,8782,8783,8784,1,2,0
2476,1,2,8783,8784,8786,1,3,0
2477,5,2,8788,8788,8790,0,2,2
2478,3,1,8791,8791,8792,0,1,1
2479,1,3,8792,8792,8795,0,3,0
2480,3,2,8795,8795,8797,0,2,0
2481,3,2,8798,8798,8800,0,2,1
2482,1,3,8799,8800,8803,1,4,0
2483,6,2,8805,8805,8807,0,2,2
2484,6,2,8811,8811,8813,0,2,4
2485,3,3,8814,8814,8817,0,3,1
2486,2,1,8816,8817,8818,1,2,0
2487,4,3,8820,8820,8823,0,3,2
2488,6,1,8826,8826,8827,0,1,3
2489,1,1,8827,8827,8828,0,1,0
2490,4,1,8831,8831,8832,0,1,3
2491,2,1,8833,8833,8834,0,1,1
2492,2,2,8835,8835,8837,0,2,1
2493,2,3,8837,8837,8840,0,3,0
2494,3,2,8840,8840,8842,0,2,0
2495,2,3,8842,8842,8845,0,3,0
2496,3,1,8845,8845,8846,0,1,0
2497,2,2,8847,8847,8849,0,2,1
2498,2,1,8849,8849,8850,0,1,0
2499,2,2,8851,8851,8853,0,2,1
2500,5,3,8856,8856,8859,0,3,3
2501,2,2,8858,8859,8861,1,3,0
2502,5,1,8863,8863,8864,0,1,2
2503,3,1,8866,8866,8867,0,1,2
2504,1,3,8867,8867,8870,0,3,0
2505,5,3,8872,8872,8875,0,3,2
2506,4,1,8876,8876,8877,0,1,1
2507,3,1,8879,8879,8880,0,1,2
2508,1,2,8880,8880,8882,0,2,0
2509,6,1,8886,8886,8887,0,1,4
2510,1,3,8887,8887,8890,0,3,0
2511,1,3,8888,8890,8893,2,5,0
2512,1,1,8889,8893,8894,4,5,0
2513,2,2,8891,8894,8896,3,5,0
2514,6,2,8897,8897,8899,0,2,1
2515,1,1,8898,8899,8900,1,2,0
2516,3,1,8901,8901,8902,0,1,1
2517,1,1,8902,8902,8903,0,1,0
2518,5,2,8907,8907,8909,0,2,4
2519,1,2,8908,8909,8911,1,3,0
2520,6,2,8914,8914,8916,0,2,3
2521,6,2,8920,8920,8922,0,2,4
2522,2,3,8922,8922,8925,0,3,0
2523,4,3,8926,8926,8929,0,3,1
2524,6,2,8932,8932,8934,0,2,3
2525,2,1,8934,8934,8935,0,1,0
2526,6,1,8940,8940,8941,0,1,5
2527,2,1,8942,8942,8943,0,1,1
2528,5,2,8947,8947,8949,0,2,4
2529,3,2,8950,8950,8952,0,2,1
2530,2,1,8952,8952,8953,0,1,0
2531,6,2,8958,8958,8960,0,2,5
2532,4,2,8962,8962,8964,0,2,2
2533,2,2,8964,8964,8966,0,2,0
2534,6,2,8970,8970,8972,0,2,4
2535,6,1,8976,8976,8977,0,1,4
2536,3,3,8979,8979,8982,0,3,2
2537,1,2,8980,8982,8984,2,4,0
2538,6,2,8986,8986,8988,0,2,2
2539,5,3,8991,8991,8994,0,3,3
2540,3,3,8994,8994,8997,0,3,0
2541,2,2,8996,8997,8999,1,3,0
2542,1,1,8997,8999,9000,2,3,0
2543,6,1,9003,9003,9004,0,1,3
2544,4,3,9007,9007,9010,0,3,3
2545,3,1,9010,9010,9011,0,1,0
2546,1,3,9011,9011,9014,0,3,0
2547,6,3,9017,9017,9020,0,3,3
2548,2,3,9019,9020,9023,1,4,0
2549,6,3,9025,9025,9028,0,3,2
2550,4,3,9029,9029,9032,0,3,1
2551,1,2,9030,9032,9034,2,4,0
2552,5,1,9035,9035,9036,0,1,1
2553,4,1,9039,9039,9040,0,1,3
2554,2,2,9041,9041,9043,0,2,1
2555,2,3,9043,9043,9046,0,3,0
2556,6,1,9049,9049,9050,0,1,3
2557,4,1,9053,9053,9054,0,1,3
2558,1,1,9054,9054,9055,0,1,0
2559,4,1,9058,9058,9059,0,1,3
2560,6,2,9064,9064,9066,0,2,5
2561,6,1,9070,9070,9071,0,1,4
2562,6,3,9076,9076,9079,0,3,5
2563,2,1,9078,9079,9080,1,2,0
2564,6,3,9084,9084,9087,0,3,4
2565,3,1,9087,9087,9088,0,1,0
2566,6,3,9093,9093,9096,0,3,5
2567,4,1,9097,9097,9098,0,1,1
2568,4,2,9101,9101,9103,0,2,3
2569,1,1,9102,9103,9104,1,2,0
2570,5,2,9107,9107,9109,0,2,3
2571,6,1,9113,9113,9114,0,1,4
2572,6,3,9119,9119,9122,0,3,5
2573,6,1,9125,9125,9126,0,1,3
2574,2,2,9127,9127,9129,0,2,1
2575,2,3,9129,9129,9132,0,3,0
2576,1,3,9130,9132,9135,2,5,0
2577,4,1,9134,9135,9136,1,2,0
2578,1,2,9135,9136,9138,1,3,0
2579,3,3,9138,9138,9141,0,3,0
2580,5,2,9143,9143,9145,0,2,2
2581,4,1,9147,9147,9148,0,1,2
2582,3,2,9150,9150,9152,0,2,2
2583,5,3,9155,9155,9158,0,3,3
2584,4,1,9159,9159,9160,0,1,1
2585,5,1,9164,9164,9165,0,1,4
2586,5,1,9169,9169,9170,0,1,4
2587,2,3,9171,9171,9174,0,3,1
2588,1,1,9172,9174,9175,2,3,0
2589,3,3,9175,9175,9178,0,3,0
2590,2,2,9177,9178,9180,1,3,0
2591,4,3,9181,9181,9184,0,3,1
2592,6,1,9187,9187,9188,0,1,3
2593,2,1,9189,9189,9190,0,1,1
2594,2,2,9191,9191,9193,0,2,1
2595,1,3,9192,9193,9196,1,4,0
2596,2,2,9194,9196,9198,2,4,0
2597,6,1,9200,9200,9201,0,1,2
2598,3,3,9203,9203,9206,0,3,2
2599,2,2,9205,9206,9208,1,3,0
2600,6,2,9211,9211,9213,0,2,3
2601,2,3,9213,9213,9216,0,3,0
2602,6,3,9219,9219,9222,0,3,3
2603,5,3,9224,9224,9227,0,3,2
2604,3,3,9227,9227,9230,0,3,0
2605,2,2,9229,9230,9232,1,3,0
2606,5,1,9234,9234,9235,0,1,2
2607,4,3,9238,9238,9241,0,3,3
2608,2,3,9240,9241,9244,1,4,0
2609,1,2,9241,9244,9246,3,5,0
2610,5,2,9246,9246,9248,0,2,0
2611,1,3,9247,9248,9251,1,4,0
2612,5,3,9252,9252,9255,0,3,1
2613,1,1,9253,9255,9256,2,3,0
2614,3,2,9256,9256,9258,0,2,0
2615,3,1,9259,9259,9260,0,1,1
2616,6,2,9265,9265,9267,0,2,5
2617,6,2,9271,9271,9273,0,2,4
2618,3,2,9274,9274,9276,0,2,1
2619,6,3,9280,9280,9283,0,3,4
2620,4,2,9284,9284,9286,0,2,1
2621,4,3,9288,9288,9291,0,3,2
2622,3,1,9291,9291,9292,0,1,0
2623,6,1,9297,9297,9298,0,1,5
2624,1,3,9298,9298,9301,0,3,0
2625,1,3,9299,9301,9304,2,5,0
2626,5,3,9304,9304,9307,0,3,0
2627,6,3,9310,9310,9313,0,3,3
2628,1,1,9311,9313,9314,2,3,0
2629,2,1,9313,9314,9315,1,2,0
2630,4,2,9317,9317,9319,0,2,2
2631,5,1,9322,9322,9323,0,1,3
2632,1,1,9323,9323,9324,0,1,0
2633,2,3,9325,9325,9328,0,3,1
2634,4,2,9329,9329,9331,0,2,1
2635,6,1,9335,9335,9336,0,1,4
2636,6,2,9341,9341,9343,0,2,5
2637,6,2,9347,9347,9349,0,2,4
2638,2,1,9349,9349,9350,0,1,0
2639,3,3,9352,9352,9355,0,3,2
2640,1,2,9353,9355,9357,2,4,0
2641,5,1,9358,9358,9359,0,1,1
2642,4,1,9362,9362,9363,0,1,3
2643,5,3,9367,9367,9370,0,3,4
2644,6,1,9373,9373,9374,0,1,3
2645,3,2,9376,9376,9378,0,2,2
2646,6,2,9382,9382,9384,0,2,4
2647,2,1,9384,9384,9385,0,1,0
2648,1,1,9385,9385,9386,0,1,0
2649,1,1,9386,9386,9387,0,1,0
2650,1,1,9387,9387,9388,0,1,0
2651,3,3,9390,9390,9393,0,3,2
2652,1,1,9391,9393,9394,2,3,0
2653,2,3,9393,9394,9397,1,4,0
2654,6,3,9399,9399,9402,0,3,2
2655,4,2,9403,9403,9405,0,2,1
2656,2,1,9405,9405,9406,0,1,0
2657,1,3,9406,9406,9409,0,3,0
2658,2,2,9408,9409,9411,1,3,0
2659,3,1,9411,9411,9412,0,1,0
2660,3,1,9414,9414,9415,0,1,2
2661,4,1,9418,9418,9419,0,1,3
2662,1,2,9419,9419,9421,0,2,0
2663,1,3,9420,9421,9424,1,4,0
2664,2,3,9422,9424,9427,2,5,0
2665,1,1,9423,9427,9428,4,5,0
2666,1,2,9424,9428,9430,4,6,0
2667,1,3,9425,9430,9433,5,8,0
2668,3,1,9428,9433,9434,5,6,0
2669,5,1,9433,9434,9435,1,2,0
2670,2,2,9435,9435,9437,0,2,0
2671,2,2,9437,9437,9439,0,2,0
2672,5,2,9442,9442,9444,0,2,3
2673,4,3,9446,9446,9449,0,3,2
2674,6,2,9452,9452,9454,0,2,3
2675,3,3,9455,9455,9458,0,3,1
2676,3,2,9458,9458,9460,0,2,0
2677,3,2,9461,9461,9463,0,2,1
2678,3,1,9464,9464,9465,0,1,1
2679,2,3,9466,9466,9469,0,3,1
2680,4,2,9470,9470,9472,0,2,1
2681,2,2,9472,9472,9474,0,2,0
2682,2,3,9474,9474,9477,0,3,0
2683,2,1,9476,9477,9478,1,2,0
2684,5,1,9481,9481,9482,0,1,3
2685,1,3,9482,9482,9485,0,3,0
2686,4,3,9486,9486,9489,0,3,1
2687,5,3,9491,9491,9494,0,3,2
2688,5,2,9496,9496,9498,0,2,2
2689,5,1,9501,9501,9502,0,1,3
2690,5,2,9506,9506,9508,0,2,4
2691,2,3,9508,9508,9511,0,3,0
2692,3,3,9511,9511,9514,0,3,0
2693,3,3,9514,9514,9517,0,3,0
2694,2,1,9516,9517,9518,1,2,0
2695,2,2,9518,9518,9520,0,2,0
2696,3,2,9521,9521,9523,0,2,1
2697,2,2,9523,9523,9525,0,2,0
2698,2,1,9525,9525,9526,0,1,0
2699,2,3,9527,9527,9530,0,3,1
2700,1,1,9528,9530,9531,2,3,0
2701,4,2,9532,9532,9534,0,2,1
2702,1,2,9533,9534,9536,1,3,0
2703,4,3,9537,9537,9540,0,3,1
2704,2,3,9539,9540,9543,1,4,0
2705,1,2,9540,9543,9545,3,5,0
2706,3,1,9543,9545,9546,2,3,0
2707,2,3,9545,9546,9549,1,4,0
2708,3,3,9548,9549,9552,1,4,0
2709,1,2,9549,9552,9554,3,5,0
2710,6,1,9555,9555,9556,0,1,1
2711,1,3,9556,9556,9559,0,3,0
2712,1,3,9557,9559,9562,2,5,0
2713,5,1,9562,9562,9563,0,1,0
2714,5,2,9567,9567,9569,0,2,4
2715,4,1,9571,9571,9572,0,1,2
2716,1,1,9572,9572,9573,0,1,0
2717,3,3,9575,9575,9578,0,3,2
2718,5,3,9580,9580,9583,0,3,2
2719,2,3,9582,9583,9586,1,4,0
2720,1,3,9583,9586,9589,3,6,0
2721,6,2,9589,9589,9591,0,2,0
2722,2,1,9591,9591,9592,0,1,0
2723,3,2,9594,9594,9596,0,2,2
2724,6,1,9600,9600,9601,0,1,4
2725,2,1,9602,9602,9603,0,1,1
2726,3,3,9605,9605,9608,0,3,2
2727,6,1,9611,9611,9612,0,1,3
2728,6,3,9617,9617,9620,0,3,5
2729,5,1,9622,9622,9623,0,1,2
2730,1,2,9623,9623,9625,0,2,0
2731,4,1,9627,9627,9628,0,1,2
2732,5,1,9632,9632,9633,0,1,4
2733,6,1,9638,9638,9639,0,1,5
2734,6,1,9644,9644,9645,0,1,5
2735,3,1,9647,9647,9648,0,1,2
2736,4,2,9651,9651,9653,0,2,3
2737,5,1,9656,9656,9657,0,1,3
2738,4,2,9660,9660,9662,0,2,3
2739,1,1,9661,9662,9663,1,2,0
2740,6,2,9667,9667,9669,0,2,4
2741,6,3,9673,9673,9676,0,3,4
2742,4,2,9677,9677,9679,0,2,1
2743,5,3,9682,9682,9685,0,3,3
2744,6,1,9688,9688,9689,0,1,3
2745,6,2,9694,9694,9696,0,2,5
2746,4,3,9698,9698,9701,0,3,2
2747,4,2,9702,9702,9704,0,2,1
2748,2,3,9704,9704,9707,0,3,0
2749,1,3,9705,9707,9710,2,5,0
2750,3,3,9708,9710,9713,2,5,0
2751,2,1,9710,9713,9714,3,4,0
2752,6,3,9716,9716,9719,0,3,2
2753,1,2,9717,9719,9721,2,4,0
2754,6,1,9723,9723,9724,0,1,2
2755,4,1,9727,9727,9728,0,1,3
2756,5,2,9732,9732,9734,0,2,4
2757,6,3,9738,9738,9741,0,3,4
2758,2,1,9740,9741,9742,1,2,0
2759,5,3,9745,9745,9748,0,3,3
2760,4,2,9749,9749,9751,0,2,1
2761,4,2,9753,9753,9755,0,2,2
2762,3,2,9756,9756,9758,0,2,1
2763,1,3,9757,9758,9761,1,4,0
2764,4,2,9761,9761,9763,0,2,0
2765,4,3,9765,9765,9768,0,3,2
2766,1,3,9766,9768,9771,2,5,0
2767,3,1,9769,9771,9772,2,3,0
2768,3,1,9772,9772,9773,0,1,0
2769,2,3,9774,9774,9777,0,3,1
2770,2,2,9776,9777,9779,1,3,0
2771,1,1,9777,9779,9780,2,3,0
2772,4,2,9781,9781,9783,0,2,1
2773,3,1,9784,9784,9785,0,1,1
2774,2,1,9786,9786,9787,0,1,1
2775,6,2,9792,9792,9794,0,2,5
2776,4,1,9796,9796,9797,0,1,2
2777,6,2,9802,9802,9804,0,2,5
2778,5,1,9807,9807,9808,0,1,3
2779,5,3,9812,9812,9815,0,3,4
2780,4,3,9816,9816,9819,0,3,1
2781,6,1,9822,9822,9823,0,1,3
2782,3,3,9825,9825,9828,0,3,2
2783,6,1,9831,9831,9832,0,1,3
2784,1,1,9832,9832,9833,0,1,0
2785,2,1,9834,9834,9835,0,1,1
2786,4,1,9838,9838,9839,0,1,3
2787,1,3,9839,9839,9842,0,3,0
2788,2,1,9841,9842,9843,1,2,0
2789,1,2,9842,9843,9845,1,3,0
2790,6,2,9848,9848,9850,0,2,3
2791,1,3,9849,9850,9853,1,4,0
2792,1,1,9850,9853,9854,3,4,0
2793,4,1,9854,9854,9855,0,1,0
2794,5,1,9859,9859,9860,0,1,4
2795,4,1,9863,9863,9864,0,1,3
2796,3,2,9866,9866,9868,0,2,2
2797,3,1,9869,9869,9870,0,1,1
2798,5,3,9874,9874,9877,0,3,4
2799,1,1,9875,9877,9878,2,3,0
2800,3,1,9878,9878,9879,0,1,0
2801,5,2,9883,9883,9885,0,2,4
2802,5,2,9888,9888,9890,0,2,3
2803,4,3,9892,9892,9895,0,3,2
2804,1,3,9893,9895,9898,2,5,0
2805,2,2,9895,9898,9900,3,5,0
2806,1,1,9896,9900,9901,4,5,0
2807,3,1,9899,9901,9902,2,3,0
2808,2,2,9901,9902,9904,1,3,0
2809,1,2,9902,9904,9906,2,4,0
2810,4,2,9906,9906,9908,0,2,0
2811,4,1,9910,9910,9911,0,1,2
2812,5,1,9915,9915,9916,0,1,4
2813,3,1,9918,9918,9919,0,1,2
2814,4,2,9922,9922,9924,0,2,3
2815,1,2,9923,9924,9926,1,3,0
2816,2,1,9925,9926,9927,1,2,0
2817,2,2,9927,9927,9929,0,2,0
2818,1,3,9928,9929,9932,1,4,0
2819,3,1,9931,9932,9933,1,2,0
2820,6,3,9937,9937,9940,0,3,4
2821,3,1,9940,9940,9941,0,1,0
2822,3,1,9943,9943,9944,0,1,2
2823,3,3,9946,9946,9949,0,3,2
2824,1,1,9947,9949,9950,2,3,0
2825,5,3,9952,9952,9955,0,3,2
2826,1,2,9953,9955,9957,2,4,0
2827,5,3,9958,9958,9961,0,3,1
2828,2,1,9960,9961,9962,1,2,0
2829,2,3,9962,9962,9965,0,3,0
2830,5,1,9967,9967,9968,0,1,2
2831,2,3,9969,9969,9972,0,3,1
2832,5,2,9974,9974,9976,0,2,2
2833,6,1,9980,9980,9981,0,1,4
2834,3,1,9983,9983,9984,0,1,2
2835,6,2,9989,9989,9991,0,2,5
2836,4,3,9993,9993,9996,0,3,2
2837,2,3,9995,9996,9999,1,4,0
2838,3,1,9998,9999,10000,1,2,0
2839,1,1,9999,10000,10001,1,2,0
2840,5,3,10004,10004,10007,0,3,3
2841,2,3,10006,10007,10010,1,4,0
2842,3,1,10009,10010,10011,1,2,0
2843,2,2,10011,10011,10013,0,2,0
2844,4,2,10015,10015,10017,0,2,2
2845,2,3,10017,10017,10020,0,3,0
2846,3,3,10020,10020,10023,0,3,0
2847,6,1,10026,10026,10027,0,1,3
2848,4,1,10030,10030,10031,0,1,3
2849,3,1,10033,10033,10034,0,1,2
2850,6,1,10039,10039,10040,0,1,5
2851,2,3,10041,10041,10044,0,3,1
2852,4,2,10045,10045,10047,0,2,1
2853,6,3,10051,10051,10054,0,3,4
2854,4,2,10055,10055,10057,0,2,1
2855,6,2,10061,10061,10063,0,2,4
2856,5,2,10066,10066,10068,0,2,3
2857,3,2,10069,10069,10071,0,2,1
2858,4,3,10073,10073,10076,0,3,2
2859,1,2,10074,10076,10078,2,4,0
2860,6,2,10080,10080,10082,0,2,2
2861,3,3,10083,10083,10086,0,3,1
2862,1,2,10084,10086,10088,2,4,0
2863,5,2,10089,10089,10091,0,2,1
2864,4,1,10093,10093,10094,0,1,2
2865,6,1,10099,10099,10100,0,1,5
2866,3,3,10102,10102,10105,0,3,2
2867,6,1,10108,10108,10109,0,1,3
2868,1,3,10109,10109,10112,0,3,0
2869,4,1,10113,10113,10114,0,1,1
2870,5,1,10118,10118,10119,0,1,4
2871,5,2,10123,10123,10125,0,2,4
2872,3,2,10126,10126,10128,0,2,1
2873,6,3,10132,10132,10135,0,3,4
2874,4,2,10136,10136,10138,0,2,1
2875,5,3,10141,10141,10144,0,3,3
2876,5,1,10146,10146,10147,0,1,2
2877,4,2,10150,10150,10152,0,2,3
2878,6,2,10156,10156,10158,0,2,4
2879,1,3,10157,10158,10161,1,4,0
2880,1,2,10158,10161,10163,3,5,0
2881,5,3,10163,10163,10166,0,3,0
2882,5,2,10168,10168,10170,0,2,2
2883,6,3,10174,10174,10177,0,3,4
2884,3,2,10177,10177,10179,0,2,0
2885,5,1,10182,10182,10183,0,1,3
2886,6,1,10188,10188,10189,0,1,5
2887,4,1,10192,10192,10193,0,1,3
2888,1,1,10193,10193,10194,0,1,0
2889,5,3,10198,10198,10201,0,3,4
2890,5,3,10203,10203,10206,0,3,2
2891,1,3,10204,10206,10209,2,5,0
2892,1,2,10205,10209,10211,4,6,0
2893,5,1,10210,10211,10212,1,2,0
2894,6,3,10216,10216,10219,0,3,4
2895,6,3,10222,10222,10225,0,3,3
2896,6,1,10228,10228,10229,0,1,3
2897,4,1,10232,10232,10233,0,1,3
2898,6,3,10238,10238,10241,0,3,5
2899,1,2,10239,10241,10243,2,4,0
2900,5,1,10244,10244,10245,0,1,1
2901,1,3,10245,10245,10248,0,3,0
2902,1,2,10246,10248,10250,2,4,0
2903,4,1,10250,10250,10251,0,1,0
2904,2,1,10252,10252,10253,0,1,1
2905,1,3,10253,10253,10256,0,3,0
2906,3,1,10256,10256,10257,0,1,0
2907,5,3,10261,10261,10264,0,3,4
2908,2,3,10263,10264,10267,1,4,0
2909,2,3,10265,10267,10270,2,5,0
2910,2,1,10267,10270,10271,3,4,0
2911,5,1,10272,10272,10273,0,1,1
2912,2,1,10274,10274,10275,0,1,1
2913,4,3,10278,10278,10281,0,3,3
2914,6,3,10284,10284,10287,0,3,3
2915,5,1,10289,10289,10290,0,1,2
2916,4,3,10293,10293,10296,0,3,3
2917,4,2,10297,10297,10299,0,2,1
2918,2,3,10299,10299,10302,0,3,0
2919,3,3,10302,10302,10305,0,3,0
2920,1,3,10303,10305,10308,2,5,0
2921,4,2,10307,10308,10310,1,3,0
2922,2,2,10309,10310,10312,1,3,0
2923,1,1,10310,10312,10313,2,3,0
2924,4,3,10314,10314,10317,0,3,1
2925,2,2,10316,10317,10319,1,3,0
2926,4,1,10320,10320,10321,0,1,1
2927,1,2,10321,10321,10323,0,2,0
2928,5,2,10326,10326,10328,0,2,3
2929,1,3,10327,10328,10331,1,4,0
2930,1,3,10328,10331,10334,3,6,0
2931,3,2,10331,10334,10336,3,5,0
2932,3,1,10334,10336,10337,2,3,0
2933,1,1,10335,10337,10338,2,3,0
2934,1,3,10336,10338,10341,2,5,0
2935,3,1,10339,10341,10342,2,3,0
2936,2,2,10341,10342,10344,1,3,0
2937,3,2,10344,10344,10346,0,2,0
2938,1,1,10345,10346,10347,1,2,0
2939,5,2,10350,10350,10352,0,2,3
2940,6,3,10356,10356,10359,0,3,4
2941,6,1,10362,10362,10363,0,1,3
2942,6,1,10368,10368,10369,0,1,5
2943,3,3,10371,10371,10374,0,3,2
2944,1,2,10372,10374,10376,2,4,0
2945,3,2,10375,10376,10378,1,3,0
2946,2,3,10377,10378,10381,1,4,0
2947,1,1,10378,10381,10382,3,4,0
2948,4,1,10382,10382,10383,0,1,0
2949,6,2,10388,10388,10390,0,2,5
2950,5,2,10393,10393,10395,0,2,3
2951,3,3,10396,10396,10399,0,3,1
2952,1,3,10397,10399,10402,2,5,0
2953,5,3,10402,10402,10405,0,3,0
2954,4,3,10406,10406,10409,0,3,1
2955,3,2,10409,10409,10411,0,2,0
2956,5,2,10414,10414,10416,0,2,3
2957,2,3,10416,10416,10419,0,3,0
2958,1,1,10417,10419,10420,2,3,0
2959,4,2,10421,10421,10423,0,2,1
2960,3,1,10424,10424,10425,0,1,1
2961,5,3,10429,10429,10432,0,3,4
2962,1,3,10430,10432,10435,2,5,0
2963,1,1,10431,10435,10436,4,5,0
2964,1,1,10432,10436,10437,4,5,0
2965,5,2,10437,10437,10439,0,2,0
2966,4,3,10441,10441,10444,0,3,2
2967,4,1,10445,10445,10446,0,1,1
2968,4,2,10449,10449,10451,0,2,3
2969,5,2,10454,10454,10456,0,2,3
2970,4,2,10458,10458,10460,0,2,2
2971,1,1,10459,10460,10461,1,2,0
2972,5,3,10464,10464,10467,0,3,3
2973,5,2,10469,10469,10471,0,2,2
2974,1,3,10470,10471,10474,1,4,0
2975,4,1,10474,10474,10475,0,1,0
2976,3,2,10477,10477,10479,0,2,2
2977,1,2,10478,10479,10481,1,3,0
2978,3,2,10481,10481,10483,0,2,0
2979,6,3,10487,10487,10490,0,3,4
2980,4,2,10491,10491,10493,0,2,1
2981,3,1,10494,10494,10495,0,1,1
2982,1,2,10495,10495,10497,0,2,0
2983,4,2,10499,10499,10501,0,2,2
2984,4,3,10503,10503,10506,0,3,2
2985,3,2,10506,10506,10508,0,2,0
2986,1,3,10507,10508,10511,1,4,0
2987,6,3,10513,10513,10516,0,3,2
2988,6,3,10519,10519,10522,0,3,3
2989,6,1,10525,10525,10526,0,1,3
2990,6,3,10531,10531,10534,0,3,5
2991,3,3,10534,10534,10537,0,3,0
2992,4,2,10538,10538,10540,0,2,1
2993,3,1,10541,10541,10542,0,1,1
2994,5,1,10546,10546,10547,0,1,4
2995,5,2,10551,10551,10553,0,2,4
2996,5,1,10556,10556,10557,0,1,3
2997,6,2,10562,10562,10564,0,2,5
2998,2,3,10564,10564,10567,0,3,0
2999,1,3,10565,10567,10570,2,5,0
3000,1,1,10566,10570,10571,4,5,0
3001,3,1,10569,10571,10572,2,3,0
3002,3,2,10572,10572,10574,0,2,0
3003,6,1,10578,10578,10579,0,1,4
3004,1,2,10579,10579,10581,0,2,0
3005,5,3,10584,10584,10587,0,3,3
3006,2,1,10586,10587,10588,1,2,0
3007,4,3,10590,10590,10593,0,3,2
3008,4,2,10594,10594,10596,0,2,1
3009,5,3,10599,10599,10602,0,3,3
3010,3,3,10602,10602,10605,0,3,0
3011,3,3,10605,10605,10608,0,3,0
3012,6,2,10611,10611,10613,0,2,3
3013,4,3,10615,10615,10618,0,3,2
3014,5,3,10620,10620,10623,0,3,2
3015,2,3,10622,10623,10626,1,4,0
3016,6,1,10628,10628,10629,0,1,2
3017,2,1,10630,10630,10631,0,1,1
3018,6,3,10636,10636,10639,0,3,5
3019,6,2,10642,10642,10644,0,2,3
3020,4,3,10646,10646,10649,0,3,2
3021,1,3,10647,10649,10652,2,5,0
3022,6,1,10653,10653,10654,0,1,1
3023,3,3,10656,10656,10659,0,3,2
3024,6,3,10662,10662,10665,0,3,3
3025,3,1,10665,10665,10666,0,1,0
3026,3,3,10668,10668,10671,0,3,2
3027,5,2,10673,10673,10675,0,2,2
3028,3,2,10676,10676,10678,0,2,1
3029,1,1,10677,10678,10679,1,2,0
3030,6,3,10683,10683,10686,0,3,4
3031,3,3,10686,10686,10689,0,3,0
3032,4,2,10690,10690,10692,0,2,1
3033,2,2,10692,10692,10694,0,2,0
3034,3,3,10695,10695,10698,0,3,1
3035,6,1,10701,10701,10702,0,1,3
3036,3,1,10704,10704,10705,0,1,2
3037,3,3,10707,10707,10710,0,3,2
3038,5,1,10712,10712,10713,0,1,2
3039,6,3,10718,10718,10721,0,3,5
3040,4,2,10722,10722,10724,0,2,1
3041,1,2,10723,10724,10726,1,3,0
3042,3,1,10726,10726,10727,0,1,0
3043,5,2,10731,10731,10733,0,2,4
3044,2,3,10733,10733,10736,0,3,0
3045,1,2,10734,10736,10738,2,4,0
3046,4,3,10738,10738,10741,0,3,0
3047,4,2,10742,10742,10744,0,2,1
3048,4,3,10746,10746,10749,0,3,2
3049,3,1,10749,10749,10750,0,1,0
3050,6,2,10755,10755,10757,0,2,5
3051,5,3,10760,10760,10763,0,3,3
3052,5,2,10765,10765,10767,0,2,2
3053,2,2,10767,10767,10769,0,2,0
3054,2,3,10769,10769,10772,0,3,0
3055,1,1,10770,10772,10773,2,3,0
3056,2,3,10772,10773,10776,1,4,0
3057,4,3,10776,10776,10779,0,3,0
3058,6,3,10782,10782,10785,0,3,3
3059,4,3,10786,10786,10789,0,3,1
3060,3,1,10789,10789,10790,0,1,0
3061,3,3,10792,10792,10795,0,3,2
3062,3,1,10795,10795,10796,0,1,0
3063,3,1,10798,10798,10799,0,1,2
3064,1,3,10799,10799,10802,0,3,0
3065,5,2,10804,10804,10806,0,2,2
3066,6,1,10810,10810,10811,0,1,4
3067,5,2,10815,10815,10817,0,2,4
3068,6,2,10821,10821,10823,0,2,4
3069,3,1,10824,10824,10825,0,1,1
3070,2,2,10826,10826,10828,0,2,1
3071,5,1,10831,10831,10832,0,1,3
3072,4,3,10835,10835,10838,0,3,3
3073,1,2,10836,10838,10840,2,4,0
3074,1,3,10837,10840,10843,3,6,0
3075,5,1,10842,10843,10844,1,2,0
3076,1,1,10843,10844,10845,1,2,0
3077,2,1,10845,10845,10846,0,1,0
3078,4,1,10849,10849,10850,0,1,3
3079,6,1,10855,10855,10856,0,1,5
3080,5,1,10860,10860,10861,0,1,4
3081,5,2,10865,10865,10867,0,2,4
3082,5,3,10870,10870,10873,0,3,3
3083,2,2,10872,10873,10875,1,3,0
3084,1,3,10873,10875,10878,2,5,0
3085,4,3,10877,10878,10881,1,4,0
3086,1,2,10878,10881,10883,3,5,0
3087,5,3,10883,10883,10886,0,3,0
3088,3,2,10886,10886,10888,0,2,0
3089,3,1,10889,10889,10890,0,1,1
3090,5,3,10894,10894,10897,0,3,4
3091,1,3,10895,10897,10900,2,5,0
3092,3,2,10898,10900,10902,2,4,0
3093,4,1,10902,10902,10903,0,1,0
3094,3,1,10905,10905,10906,0,1,2
3095,2,2,10907,10907,10909,0,2,1
3096,6,3,10913,10913,10916,0,3,4
3097,2,1,10915,10916,10917,1,2,0
3098,3,3,10918,10918,10921,0,3,1
3099,2,3,10920,10921,10924,1,4,0
3100,2,2,10922,10924,10926,2,4,0
3101,4,3,10926,10926,10929,0,3,0
3102,4,3,10930,10930,10933,0,3,1
3103,4,3,10934,10934,10937,0,3,1
3104,2,2,10936,10937,10939,1,3,0
3105,5,2,10941,10941,10943,0,2,2
3106,1,2,10942,10943,10945,1,3,0
3107,2,2,10944,10945,10947,1,3,0
3108,2,3,10946,10947,10950,1,4,0
3109,3,1,10949,10950,10951,1,2,0
3110,1,3,10950,10951,10954,1,4,0
3111,3,1,10953,10954,10955,1,2,0
3112,3,3,10956,10956,10959,0,3,1
3113,3,1,10959,10959,10960,0,1,0
3114,4,2,10963,10963,10965,0,2,3
3115,1,2,10964,10965,10967,1,3,0
3116,6,3,10970,10970,10973,0,3,3
3117,5,2,10975,10975,10977,0,2,2
3118,6,3,10981,10981,10984,0,3,4
3119,2,3,10983,10984,10987,1,4,0
3120,4,2,10987,10987,10989,0,2,0
3121,3,3,10990,10990,10993,0,3,1
3122,3,2,10993,10993,10995,0,2,0
3123,1,2,10994,10995,10997,1,3,0
3124,4,2,10998,10998,11000,0,2,1
3125,3,2,11001,11001,11003,0,2,1
3126,4,3,11005,11005,11008,0,3,2
3127,2,1,11007,11008,11009,1,2,0
3128,1,2,11008,11009,11011,1,3,0
3129,5,1,11013,11013,11014,0,1,2
3130,4,1,11017,11017,11018,0,1,3
3131,3,1,11020,11020,11021,0,1,2
3132,3,2,11023,11023,11025,0,2,2
3133,6,2,11029,11029,11031,0,2,4
3134,4,1,11033,11033,11034,0,1,2
3135,4,3,11037,11037,11040,0,3,3
3136,5,3,11042,11042,11045,0,3,2
3137,2,3,11044,11045,11048,1,4,0
3138,6,1,11050,11050,11051,0,1,2
3139,1,3,11051,11051,11054,0,3,0
3140,5,1,11056,11056,11057,0,1,2
3141,4,3,11060,11060,11063,0,3,3
3142,3,1,11063,11063,11064,0,1,0
3143,4,3,11067,11067,11070,0,3,3
3144,4,3,11071,11071,11074,0,3,1
3145,5,2,11076,11076,11078,0,2,2
3146,4,3,11080,11080,11083,0,3,2
3147,2,2,11082,11083,11085,1,3,0
3148,2,3,11084,11085,11088,1,4,0
3149,1,3,11085,11088,11091,3,6,0
3150,6,3,11091,11091,11094,0,3,0
3151,5,3,11096,11096,11099,0,3,2
3152,6,1,11102,11102,11103,0,1,3
3153,5,3,11107,11107,11110,0,3,4
3154,4,3,11111,11111,11114,0,3,1
3155,5,3,11116,11116,11119,0,3,2
3156,2,2,11118,11119,11121,1,3,0
3157,1,3,11119,11121,11124,2,5,0
3158,5,2,11124,11124,11126,0,2,0
3159,4,3,11128,11128,11131,0,3,2
3160,3,2,11131,11131,11133,0,2,0
3161,4,3,11135,11135,11138,0,3,2
3162,5,3,11140,11140,11143,0,3,2
3163,6,2,11146,11146,11148,0,2,3
3164,1,2,11147,11148,11150,1,3,0
3165,5,3,11152,11152,11155,0,3,2
3166,1,2,11153,11155,11157,2,4,0
3167,4,1,11157,11157,11158,0,1,0
3168,4,2,11161,11161,11163,0,2,3
3169,4,3,11165,11165,11168,0,3,2
3170,2,1,11167,11168,11169,1,2,0
3171,5,3,11172,11172,11175,0,3,3
3172,1,1,11173,11175,11176,2,3,0
3173,5,2,11178,11178,11180,0,2,2
3174,2,3,11180,11180,11183,0,3,0
3175,1,2,11181,11183,11185,2,4,0
3176,2,2,11183,11185,11187,2,4,0
3177,4,2,11187,11187,11189,0,2,0
3178,4,2,11191,11191,11193,0,2,2
3179,3,3,11194,11194,11197,0,3,1
3180,3,2,11197,11197,11199,0,2,0
3181,5,1,11202,11202,11203,0,1,3
3182,2,2,11204,11204,11206,0,2,1
3183,5,2,11209,11209,11211,0,2,3
3184,2,1,11211,11211,11212,0,1,0
3185,2,3,11213,11213,11216,0,3,1
3186,1,2,11214,11216,11218,2,4,0
3187,2,3,11216,11218,11221,2,5,0
3188,5,2,11221,11221,11223,0,2,0
3189,3,3,11224,11224,11227,0,3,1
3190,5,1,11229,11229,11230,0,1,2
3191,4,2,11233,11233,11235,0,2,3
3192,4,2,11237,11237,11239,0,2,2
3193,2,1,11239,11239,11240,0,1,0
3194,4,3,11243,11243,11246,0,3,3
3195,3,3,11246,11246,11249,0,3,0
3196,2,2,11248,11249,11251,1,3,0
3197,4,2,11252,11252,11254,0,2,1
3198,2,3,11254,11254,11257,0,3,0
3199,4,3,11258,11258,11261,0,3,1
3200,6,1,11264,11264,11265,0,1,3
3201,2,2,11266,11266,11268,0,2,1
3202,1,1,11267,11268,11269,1,2,0
3203,3,2,11270,11270,11272,0,2,1
3204,4,3,11274,11274,11277,0,3,2
3205,5,3,11279,11279,11282,0,3,2
3206,1,2,11280,11282,11284,2,4,0
3207,1,3,11281,11284,11287,3,6,0
3208,6,3,11287,11287,11290,0,3,0
3209,4,1,11291,11291,11292,0,1,1
3210,4,3,11295,11295,11298,0,3,3
3211,6,3,11301,11301,11304,0,3,3
3212,6,2,11307,11307,11309,0,2,3
3213,2,2,11309,11309,11311,0,2,0
3214,6,1,11315,11315,11316,0,1,4
3215,2,3,11317,11317,11320,0,3,1
3216,2,2,11319,11320,11322,1,3,0
3217,5,1,11324,11324,11325,0,1,2
3218,6,3,11330,11330,11333,0,3,5
3219,3,2,11333,11333,11335,0,2,0
3220,6,1,11339,11339,11340,0,1,4
3221,1,3,11340,11340,11343,0,3,0
3222,3,1,11343,11343,11344,0,1,0
3223,5,2,11348,11348,11350,0,2,4
3224,2,2,11350,11350,11352,0,2,0
3225,6,2,11356,11356,11358,0,2,4
3226,5,1,11361,11361,11362,0,1,3
3227,3,1,11364,11364,11365,0,1,2
3228,6,3,11370,11370,11373,0,3,5
3229,5,1,11375,11375,11376,0,1,2
3230,2,3,11377,11377,11380,0,3,1
3231,1,3,11378,11380,11383,2,5,0
3232,5,3,11383,11383,11386,0,3,0
3233,5,2,11388,11388,11390,0,2,2
3234,2,3,11390,11390,11393,0,3,0
3235,1,3,11391,11393,11396,2,5,0
3236,2,2,11393,11396,11398,3,5,0
3237,4,2,11397,11398,11400,1,3,0
3238,6,2,11403,11403,11405,0,2,3
3239,5,2,11408,11408,11410,0,2,3
3240,1,1,11409,11410,11411,1,2,0
3241,5,1,11414,11414,11415,0,1,3
3242,2,3,11416,11416,11419,0,3,1
3243,3,3,11419,11419,11422,0,3,0
3244,1,3,11420,11422,11425,2,5,0
3245,5,2,11425,11425,11427,0,2,0
3246,2,3,11427,11427,11430,0,3,0
3247,2,3,11429,11430,11433,1,4,0
3248,4,3,11433,11433,11436,0,3,0
3249,6,2,11439,11439,11441,0,2,3
3250,6,1,11445,11445,11446,0,1,4
3251,2,3,11447,11447,11450,0,3,1
3252,1,3,11448,11450,11453,2,5,0
3253,5,3,11453,11453,11456,0,3,0
3254,6,3,11459,11459,11462,0,3,3
3255,5,3,11464,11464,11467,0,3,2
3256,4,1,11468,11468,11469,0,1,1
3257,1,1,11469,11469,11470,0,1,0
3258,2,1,11471,11471,11472,0,1,1
3259,3,3,11474,11474,11477,0,3,2
3260,5,2,11479,11479,11481,0,2,2
3261,5,3,11484,11484,11487,0,3,3
3262,1,1,11485,11487,11488,2,3,0
3263,3,3,11488,11488,11491,0,3,0
3264,6,1,11494,11494,11495,0,1,3
3265,6,2,11500,11500,11502,0,2,5
3266,3,1,11503,11503,11504,0,1,1
3267,2,3,11505,11505,11508,0,3,1
3268,1,1,11506,11508,11509,2,3,0
3269,2,2,11508,11509,11511,1,3,0
3270,4,1,11512,11512,11513,0,1,1
3271,3,1,11515,11515,11516,0,1,2
3272,4,1,11519,11519,11520,0,1,3
3273,6,1,11525,11525,11526,0,1,5
3274,1,2,11526,11526,11528,0,2,0
3275,3,1,11529,11529,11530,0,1,1
3276,1,3,11530,11530,11533,0,3,0
3277,2,2,11532,11533,11535,1,3,0
3278,4,1,11536,11536,11537,0,1,1
3279,4,2,11540,11540,11542,0,2,3
3280,1,3,11541,11542,11545,1,4,0
3281,4,2,11545,11545,11547,0,2,0
3282,5,2,11550,11550,11552,0,2,3
3283,1,2,11551,11552,11554,1,3,0
3284,2,3,11553,11554,11557,1,4,0
3285,2,3,11555,11557,11560,2,5,0
3286,6,3,11561,11561,11564,0,3,1
3287,6,3,11567,11567,11570,0,3,3
3288,1,2,11568,11570,11572,2,4,0
3289,1,2,11569,11572,11574,3,5,0
3290,5,2,11574,11574,11576,0,2,0
3291,6,3,11580,11580,11583,0,3,4
3292,2,1,11582,11583,11584,1,2,0
3293,1,3,11583,11584,11587,1,4,0
3294,2,3,11585,11587,11590,2,5,0
3295,2,3,11587,11590,11593,3,6,0
3296,6,1,11593,11593,11594,0,1,0
3297,3,1,11596,11596,11597,0,1,2
3298,1,2,11597,11597,11599,0,2,0
3299,5,3,11602,11602,11605,0,3,3
3300,5,2,11607,11607,11609,0,2,2
3301,1,1,11608,11609,11610,1,2,0
3302,4,2,11612,11612,11614,0,2,2
3303,3,3,11615,11615,11618,0,3,1
3304,1,3,11616,11618,11621,2,5,0
3305,4,1,11620,11621,11622,1,2,0
3306,4,1,11624,11624,11625,0,1,2
3307,1,1,11625,11625,11626,0,1,0
3308,3,2,11628,11628,11630,0,2,2
3309,3,1,11631,11631,11632,0,1,1
3310,5,3,11636,11636,11639,0,3,4
3311,4,2,11640,11640,11642,0,2,1
3312,1,3,11641,11642,11645,1,4,0
3313,1,1,11642,11645,11646,3,4,0
3314,6,1,11648,11648,11649,0,1,2
3315,6,1,11654,11654,11655,0,1,5
3316,6,3,11660,11660,11663,0,3,5
3317,2,1,11662,11663,11664,1,2,0
3318,2,1,11664,11664,11665,0,1,0
3319,1,3,11665,11665,11668,0,3,0
3320,1,3,11666,11668,11671,2,5,0
3321,5,3,11671,11671,11674,0,3,0
3322,1,1,11672,11674,11675,2,3,0
3323,1,3,11673,11675,11678,2,5,0
3324,5,1,11678,11678,11679,0,1,0
3325,4,1,11682,11682,11683,0,1,3
3326,3,3,11685,11685,11688,0,3,2
3327,1,3,11686,11688,11691,2,5,0
3328,3,2,11689,11691,11693,2,4,0
3329,2,1,11691,11693,11694,2,3,0
3330,5,2,11696,11696,11698,0,2,2
3331,4,2,11700,11700,11702,0,2,2
3332,5,3,11705,11705,11708,0,3,3
3333,4,1,11709,11709,11710,0,1,1
3334,2,2,11711,11711,11713,0,2,1
3335,4,1,11715,11715,11716,0,1,2
3336,6,3,11721,11721,11724,0,3,5
3337,4,1,11725,11725,11726,0,1,1
3338,3,1,11728,11728,11729,0,1,2
3339,1,1,11729,11729,11730,0,1,0
3340,1,3,11730,11730,11733,0,3,0
3341,3,3,11733,11733,11736,0,3,0
3342,3,1,11736,11736,11737,0,1,0
3343,6,2,11742,11742,11744,0,2,5
3344,2,3,11744,11744,11747,0,3,0
3345,3,2,11747,11747,11749,0,2,0
3346,1,2,11748,11749,11751,1,3,0
3347,6,2,11754,11754,11756,0,2,3
3348,6,3,11760,11760,11763,0,3,4
3349,5,1,11765,11765,11766,0,1,2
3350,1,3,11766,11766,11769,0,3,0
3351,2,1,11768,11769,11770,1,2,0
3352,5,1,11773,11773,11774,0,1,3
3353,1,3,11774,11774,11777,0,3,0
3354,3,3,11777,11777,11780,0,3,0
3355,5,2,11782,11782,11784,0,2,2
3356,1,3,11783,11784,11787,1,4,0
3357,3,3,11786,11787,11790,1,4,0
3358,6,3,11792,11792,11795,0,3,2
3359,4,1,11796,11796,11797,0,1,1
3360,5,1,11801,11801,11802,0,1,4
3361,1,2,11802,11802,11804,0,2,0
3362,6,1,11808,11808,11809,0,1,4
3363,3,3,11811,11811,11814,0,3,2
3364,4,2,11815,11815,11817,0,2,1
3365,6,2,11821,11821,11823,0,2,4
3366,1,1,11822,11823,11824,1,2,0
3367,4,1,11826,11826,11827,0,1,2
3368,5,3,11831,11831,11834,0,3,4
3369,4,1,11835,11835,11836,0,1,1
3370,2,1,11837,11837,11838,0,1,1
3371,5,1,11842,11842,11843,0,1,4
3372,3,3,11845,11845,11848,0,3,2
3373,2,2,11847,11848,11850,1,3,0
3374,2,3,11849,11850,11853,1,4,0
3375,4,2,11853,11853,11855,0,2,0
3376,4,2,11857,11857,11859,0,2,2
3377,3,1,11860,11860,11861,0,1,1
3378,4,1,11864,11864,11865,0,1,3
3379,3,3,11867,11867,11870,0,3,2
3380,6,1,11873,11873,11874,0,1,3
3381,3,3,11876,11876,11879,0,3,2
3382,3,1,11879,11879,11880,0,1,0
3383,3,3,11882,11882,11885,0,3,2
3384,1,3,11883,11885,11888,2,5,0
3385,5,3,11888,11888,11891,0,3,0
3386,1,3,11889,11891,11894,2,5,0
3387,3,3,11892,11894,11897,2,5,0
3388,6,1,11898,11898,11899,0,1,1
3389,4,2,11902,11902,11904,0,2,3
3390,4,1,11906,11906,11907,0,1,2
3391,2,2,11908,11908,11910,0,2,1
3392,2,2,11910,11910,11912,0,2,0
3393,1,3,11911,11912,11915,1,4,0
3394,4,2,11915,11915,11917,0,2,0
3395,1,1,11916,11917,11918,1,2,0
3396,2,1,11918,11918,11919,0,1,0
3397,5,1,11923,11923,11924,0,1,4
3398,2,1,11925,11925,11926,0,1,1
3399,3,3,11928,11928,11931,0,3,2
3400,2,2,11930,11931,11933,1,3,0
3401,3,1,11933,11933,11934,0,1,0
3402,6,3,11939,11939,11942,0,3,5
3403,5,3,11944,11944,11947,0,3,2
3404,6,3,11950,11950,11953,0,3,3
3405,6,3,11956,11956,11959,0,3,3
3406,1,2,11957,11959,11961,2,4,0
3407,1,3,11958,11961,11964,3,6,0
3408,1,2,11959,11964,11966,5,7,0
3409,3,1,11962,11966,11967,4,5,0
3410,2,3,11964,11967,11970,3,6,0
3411,5,3,11969,11970,11973,1,4,0
3412,1,1,11970,11973,11974,3,4,0
3413,3,2,11973,11974,11976,1,3,0
3414,4,1,11977,11977,11978,0,1,1
3415,3,3,11980,11980,11983,0,3,2
3416,2,3,11982,11983,11986,1,4,0
3417,1,3,11983,11986,11989,3,6,0
3418,6,2,11989,11989,11991,0,2,0
3419,3,2,11992,11992,11994,0,2,1
3420,4,3,11996,11996,11999,0,3,2
3421,3,1,11999,11999,12000,0,1,0
3422,4,3,12003,12003,12006,0,3,3
3423,6,1,12009,12009,12010,0,1,3
3424,4,1,12013,12013,12014,0,1,3
3425,6,2,12019,12019,12021,0,2,5
3426,5,2,12024,12024,12026,0,2,3
3427,4,1,12028,12028,12029,0,1,2
3428,3,1,12031,12031,12032,0,1,2
3429,5,3,12036,12036,12039,0,3,4
3430,3,1,12039,12039,12040,0,1,0
3431,4,1,12043,12043,12044,0,1,3
3432,6,2,12049,12049,12051,0,2,5
3433,2,2,12051,12051,12053,0,2,0
3434,2,2,12053,12053,12055,0,2,0
3435,2,2,12055,12055,12057,0,2,0
3436,5,2,12060,12060,12062,0,2,3
3437,5,1,12065,12065,12066,0,1,3
3438,3,2,12068,12068,12070,0,2,2
3439,3,2,12071,12071,12073,0,2,1
3440,3,1,12074,12074,12075,0,1,1
3441,2,2,12076,12076,12078,0,2,1
3442,2,1,12078,12078,12079,0,1,0
3443,1,1,12079,12079,12080,0,1,0
3444,4,1,12083,12083,12084,0,1,3
3445,6,1,12089,12089,12090,0,1,5
3446,4,3,12093,12093,12096,0,3,3
3447,2,2,12095,12096,12098,1,3,0
3448,4,2,12099,12099,12101,0,2,1
3449,3,1,12102,12102,12103,0,1,1
3450,6,2,12108,12108,12110,0,2,5
3451,4,1,12112,12112,12113,0,1,2
3452,3,1,12115,12115,12116,0,1,2
3453,1,1,12116,12116,12117,0,1,0
3454,2,2,12118,12118,12120,0,2,1
3455,5,1,12123,12123,12124,0,1,3
3456,2,3,12125,12125,12128,0,3,1
3457,4,1,12129,12129,12130,0,1,1
3458,2,3,12131,12131,12134,0,3,1
3459,4,2,12135,12135,12137,0,2,1
3460,3,1,12138,12138,12139,0,1,1
3461,4,2,12142,12142,12144,0,2,3
3462,1,3,12143,12144,12147,1,4,0
3463,6,2,12149,12149,12151,0,2,2
3464,5,1,12154,12154,12155,0,1,3
3465,1,2,12155,12155,12157,0,2,0
3466,4,2,12159,12159,12161,0,2,2
3467,5,3,12164,12164,12167,0,3,3
3468,3,3,12167,12167,12170,0,3,0
3469,4,2,12171,12171,12173,0,2,1
3470,6,1,12177,12177,12178,0,1,4
3471,6,3,12183,12183,12186,0,3,5
3472,6,1,12189,12189,12190,0,1,3
3473,1,2,12190,12190,12192,0,2,0
3474,5,3,12195,12195,12198,0,3,3
3475,3,2,12198,12198,12200,0,2,0
3476,5,2,12203,12203,12205,0,2,3
3477,4,1,12207,12207,12208,0,1,2
3478,2,1,12209,12209,12210,0,1,1
3479,1,3,12210,12210,12213,0,3,0
3480,1,3,12211,12213,12216,2,5,0
3481,6,1,12217,12217,12218,0,1,1
3482,5,2,12222,12222,12224,0,2,4
3483,1,1,12223,12224,12225,1,2,0
3484,5,3,12228,12228,12231,0,3,3
3485,6,3,12234,12234,12237,0,3,3
3486,4,2,12238,12238,12240,0,2,1
3487,5,2,12243,12243,12245,0,2,3
3488,4,1,12247,12247,12248,0,1,2
3489,1,3,12248,12248,12251,0,3,0
3490,1,1,12249,12251,12252,2,3,0
3491,6,2,12255,12255,12257,0,2,3
3492,6,2,12261,12261,12263,0,2,4
3493,6,3,12267,12267,12270,0,3,4
3494,3,3,12270,12270,12273,0,3,0
3495,3,2,12273,12273,12275,0,2,0
3496,4,1,12277,12277,12278,0,1,2
3497,1,1,12278,12278,12279,0,1,0
3498,1,1,12279,12279,12280,0,1,0
3499,2,3,12281,12281,12284,0,3,1
3500,5,1,12286,12286,12287,0,1,2
3501,5,3,12291,12291,12294,0,3,4
3502,5,2,12296,12296,12298,0,2,2
3503,2,1,12298,12298,12299,0,1,0
3504,1,2,12299,12299,12301,0,2,0
3505,6,1,12305,12305,12306,0,1,4
3506,6,1,12311,12311,12312,0,1,5
3507,1,2,12312,12312,12314,0,2,0
3508,1,3,12313,12314,12317,1,4,0
3509,2,3,12315,12317,12320,2,5,0
3510,3,1,12318,12320,12321,2,3,0
3511,2,1,12320,12321,12322,1,2,0
3512,5,1,12325,12325,12326,0,1,3
3513,5,3,12330,12330,12333,0,3,4
3514,5,1,12335,12335,12336,0,1,2
3515,2,3,12337,12337,12340,0,3,1
3516,5,2,12342,12342,12344,0,2,2
3517,4,1,12346,12346,12347,0,1,2
3518,1,1,12347,12347,12348,0,1,0
3519,1,1,12348,12348,12349,0,1,0
3520,5,3,12353,12353,12356,0,3,4
3521,2,1,12355,12356,12357,1,2,0
3522,6,2,12361,12361,12363,0,2,4
3523,2,1,12363,12363,12364,0,1,0
3524,3,2,12366,12366,12368,0,2,2
3525,5,1,12371,12371,12372,0,1,3
3526,5,2,12376,12376,12378,0,2,4
3527,3,2,12379,12379,12381,0,2,1
3528,5,1,12384,12384,12385,0,1,3
3529,3,1,12387,12387,12388,0,1,2
3530,6,1,12393,12393,12394,0,1,5
3531,6,3,12399,12399,12402,0,3,5
3532,1,2,12400,12402,12404,2,4,0
3533,1,3,12401,12404,12407,3,6,0
3534,6,3,12407,12407,12410,0,3,0
3535,3,1,12410,12410,12411,0,1,0
3536,6,1,12416,12416,12417,0,1,5
3537,1,2,12417,12417,12419,0,2,0
3538,2,2,12419,12419,12421,0,2,0
3539,3,3,12422,12422,12425,0,3,1
3540,4,3,12426,12426,12429,0,3,1
3541,2,3,12428,12429,12432,1,4,0
3542,1,2,12429,12432,12434,3,5,0
3543,5,1,12434,12434,12435,0,1,0
3544,5,3,12439,12439,12442,0,3,4
3545,3,2,12442,12442,12444,0,2,0
3546,4,1,12446,12446,12447,0,1,2
3547,6,2,12452,12452,12454,0,2,5
3548,5,3,12457,12457,12460,0,3,3
3549,6,1,12463,12463,12464,0,1,3
3550,2,2,12465,12465,12467,0,2,1
3551,5,3,12470,12470,12473,0,3,3
3552,2,1,12472,12473,12474,1,2,0
3553,3,2,12475,12475,12477,0,2,1
3554,3,3,12478,12478,12481,0,3,1
3555,2,1,12480,12481,12482,1,2,0
3556,6,2,12486,12486,12488,0,2,4
3557,4,2,12490,12490,12492,0,2,2
3558,6,2,12496,12496,12498,0,2,4
3559,4,3,12500,12500,12503,0,3,2
3560,6,3,12506,12506,12509,0,3,3
3561,3,3,12509,12509,12512,0,3,0
3562,6,3,12515,12515,12518,0,3,3
3563,5,3,12520,12520,12523,0,3,2
3564,1,3,12521,12523,12526,2,5,0
3565,2,1,12523,12526,12527,3,4,0
3566,4,2,12527,12527,12529,0,2,0
3567,1,3,12528,12529,12532,1,4,0
3568,5,1,12533,12533,12534,0,1,1
3569,3,3,12536,12536,12539,0,3,2
3570,6,3,12542,12542,12545,0,3,3
3571,4,3,12546,12546,12549,0,3,1
3572,3,2,12549,12549,12551,0,2,0
3573,5,2,12554,12554,12556,0,2,3
3574,4,3,12558,12558,12561,0,3,2
3575,6,3,12564,12564,12567,0,3,3
3576,3,1,12567,12567,12568,0,1,0
3577,3,3,12570,12570,12573,0,3,2
3578,6,3,12576,12576,12579,0,3,3
3579,1,3,12577,12579,12582,2,5,0
3580,1,3,12578,12582,12585,4,7,0
3581,5,2,12583,12585,12587,2,4,0
3582,5,1,12588,12588,12589,0,1,1
3583,2,3,12590,12590,12593,0,3,1
3584,3,1,12593,12593,12594,0,1,0
3585,5,2,12598,12598,12600,0,2,4
3586,5,1,12603,12603,12604,0,1,3
3587,3,1,12606,12606,12607,0,1,2
3588,3,2,12609,12609,12611,0,2,2
3589,4,2,12613,12613,12615,0,2,2
3590,2,2,12615,12615,12617,0,2,0
3591,3,1,12618,12618,12619,0,1,1
3592,1,1,12619,12619,12620,0,1,0
3593,1,1,12620,12620,12621,0,1,0
3594,2,3,12622,12622,12625,0,3,1
3595,3,1,12625,12625,12626,0,1,0
3596,2,3,12627,12627,12630,0,3,1
3597,3,3,12630,12630,12633,0,3,0
3598,2,3,12632,12633,12636,1,4,0
3599,6,3,12638,12638,12641,0,3,2
3600,6,2,12644,12644,12646,0,2,3
3601,6,1,12650,12650,12651,0,1,4
3602,6,1,12656,12656,12657,0,1,5
3603,4,2,12660,12660,12662,0,2,3
3604,2,2,12662,12662,12664,0,2,0
3605,1,2,12663,12664,12666,1,3,0
3606,2,1,12665,12666,12667,1,2,0
3607,5,1,12670,12670,12671,0,1,3
3608,3,3,12673,12673,12676,0,3,2
3609,6,2,12679,12679,12681,0,2,3
3610,5,2,12684,12684,12686,0,2,3
3611,1,2,12685,12686,12688,1,3,0
3612,3,3,12688,12688,12691,0,3,0
3613,6,1,12694,12694,12695,0,1,3
3614,5,3,12699,12699,12702,0,3,4
3615,4,2,12703,12703,12705,0,2,1
3616,5,3,12708,12708,12711,0,3,3
3617,1,2,12709,12711,12713,2,4,0
3618,6,2,12715,12715,12717,0,2,2
3619,6,3,12721,12721,12724,0,3,4
3620,4,2,12725,12725,12727,0,2,1
3621,6,2,12731,12731,12733,0,2,4
3622,5,1,12736,12736,12737,0,1,3
3623,2,1,12738,12738,12739,0,1,1
3624,2,1,12740,12740,12741,0,1,1
3625,6,3,12746,12746,12749,0,3,5
3626,6,1,12752,12752,12753,0,1,3
3627,1,3,12753,12753,12756,0,3,0
3628,2,2,12755,12756,12758,1,3,0
3629,4,1,12759,12759,12760,0,1,1
3630,4,3,12763,12763,12766,0,3,3
3631,1,3,12764,12766,12769,2,5,0
3632,3,3,12767,12769,12772,2,5,0
3633,3,1,12770,12772,12773,2,3,0
3634,4,1,12774,12774,12775,0,1,1
3635,1,3,12775,12775,12778,0,3,0
3636,5,2,12780,12780,12782,0,2,2
3637,5,3,12785,12785,12788,0,3,3
3638,4,2,12789,12789,12791,0,2,1
3639,1,1,12790,12791,12792,1,2,0
3640,3,2,12793,12793,12795,0,2,1
3641,4,3,12797,12797,12800,0,3,2
3642,5,1,12802,12802,12803,0,1,2
3643,1,3,12803,12803,12806,0,3,0
3644,5,2,12808,12808,12810,0,2,2
3645,5,1,12813,12813,12814,0,1,3
3646,4,3,12817,12817,12820,0,3,3
3647,1,1,12818,12820,12821,2,3,0
3648,4,3,12822,12822,12825,0,3,1
3649,2,1,12824,12825,12826,1,2,0
3650,3,2,12827,12827,12829,0,2,1
3651,2,1,12829,12829,12830,0,1,0
3652,1,3,12830,12830,12833,0,3,0
3653,3,1,12833,12833,12834,0,1,0
3654,6,2,12839,12839,12841,0,2,5
3655,2,2,12841,12841,12843,0,2,0
3656,2,2,12843,12843,12845,0,2,0
3657,1,2,12844,12845,12847,1,3,0
3658,4,3,12848,12848,12851,0,3,1
3659,6,3,12854,12854,12857,0,3,3
3660,6,3,12860,12860,12863,0,3,3
3661,2,2,12862,12863,12865,1,3,0
3662,2,3,12864,12865,12868,1,4,0
3663,1,2,12865,12868,12870,3,5,0
3664,6,2,12871,12871,12873,0,2,1
3665,3,1,12874,12874,12875,0,1,1
3666,1,2,12875,12875,12877,0,2,0
3667,6,2,12881,12881,12883,0,2,4
3668,5,2,12886,12886,12888,0,2,3
3669,6,2,12892,12892,12894,0,2,4
3670,4,1,12896,12896,12897,0,1,2
3671,6,2,12902,12902,12904,0,2,5
3672,6,2,12908,12908,12910,0,2,4
3673,3,2,12911,12911,12913,0,2,1
3674,6,3,12917,12917,12920,0,3,4
3675,6,1,12923,12923,12924,0,1,3
3676,1,2,12924,12924,12926,0,2,0
3677,4,2,12928,12928,12930,0,2,2
3678,4,2,12932,12932,12934,0,2,2
3679,4,3,12936,12936,12939,0,3,2
3680,1,2,12937,12939,12941,2,4,0
3681,6,3,12943,12943,12946,0,3,2
3682,5,2,12948,12948,12950,0,2,2
3683,3,2,12951,12951,12953,0,2,1
3684,4,2,12955,12955,12957,0,2,2
3685,5,3,12960,12960,12963,0,3,3
3686,4,3,12964,12964,12967,0,3,1
3687,1,2,12965,12967,12969,2,4,0
3688,1,3,12966,12969,12972,3,6,0
3689,4,1,12970,12972,12973,2,3,0
3690,5,2,12975,12975,12977,0,2,2
3691,1,1,12976,12977,12978,1,2,0
3692,5,2,12981,12981,12983,0,2,3
3693,1,3,12982,12983,12986,1,4,0
3694,3,2,12985,12986,12988,1,3,0
3695,1,1,12986,12988,12989,2,3,0
3696,2,3,12988,12989,12992,1,4,0
3697,1,2,12989,12992,12994,3,5,0
3698,6,1,12995,12995,12996,0,1,1
3699,3,2,12998,12998,13000,0,2,2
3700,5,2,13003,13003,13005,0,2,3
3701,2,3,13005,13005,13008,0,3,0
3702,6,2,13011,13011,13013,0,2,3
3703,6,3,13017,13017,13020,0,3,4
3704,4,3,13021,13021,13024,0,3,1
3705,1,2,13022,13024,13026,2,4,0
3706,2,3,13024,13026,13029,2,5,0
3707,6,1,13030,13030,13031,0,1,1
3708,4,3,13034,13034,13037,0,3,3
3709,5,1,13039,13039,13040,0,1,2
3710,1,3,13040,13040,13043,0,3,0
3711,6,1,13046,13046,13047,0,1,3
3712,3,2,13049,13049,13051,0,2,2
3713,4,2,13053,13053,13055,0,2,2
3714,5,3,13058,13058,13061,0,3,3
3715,5,2,13063,13063,13065,0,2,2
3716,6,3,13069,13069,13072,0,3,4
3717,6,3,13075,13075,13078,0,3,3
3718,5,2,13080,13080,13082,0,2,2
3719,4,3,13084,13084,13087,0,3,2
3720,4,3,13088,13088,13091,0,3,1
3721,6,1,13094,13094,13095,0,1,3
3722,1,1,13095,13095,13096,0,1,0
3723,1,3,13096,13096,13099,0,3,0
3724,3,1,13099,13099,13100,0,1,0
3725,1,3,13100,13100,13103,0,3,0
3726,3,3,13103,13103,13106,0,3,0
3727,4,2,13107,13107,13109,0,2,1
3728,1,1,13108,13109,13110,1,2,0
3729,1,1,13109,13110,13111,1,2,0
3730,5,2,13114,13114,13116,0,2,3
3731,6,2,13120,13120,13122,0,2,4
3732,6,3,13126,13126,13129,0,3,4
3733,2,2,13128,13129,13131,1,3,0
3734,1,1,13129,13131,13132,2,3,0
3735,5,2,13134,13134,13136,0,2,2
3736,1,2,13135,13136,13138,1,3,0
3737,1,1,13136,13138,13139,2,3,0
3738,1,2,13137,13139,13141,2,4,0
3739,6,2,13143,13143,13145,0,2,2
3740,1,3,13144,13145,13148,1,4,0
3741,5,1,13149,13149,13150,0,1,1
3742,4,1,13153,13153,13154,0,1,3
3743,6,1,13159,13159,13160,0,1,5
3744,3,3,13162,13162,13165,0,3,2
3745,2,2,13164,13165,13167,1,3,0
3746,2,1,13166,13167,13168,1,2,0
3747,3,2,13169,13169,13171,0,2,1
3748,6,2,13175,13175,13177,0,2,4
3749,3,3,13178,13178,13181,0,3,1
3750,6,3,13184,13184,13187,0,3,3
3751,4,3,13188,13188,13191,0,3,1
3752,3,3,13191,13191,13194,0,3,0
3753,2,1,13193,13194,13195,1,2,0
3754,3,2,13196,13196,13198,0,2,1
3755,3,1,13199,13199,13200,0,1,1
3756,6,1,13205,13205,13206,0,1,5
3757,6,1,13211,13211,13212,0,1,5
3758,5,3,13216,13216,13219,0,3,4
3759,2,1,13218,13219,13220,1,2,0
3760,2,1,13220,13220,13221,0,1,0
3761,5,1,13225,13225,13226,0,1,4
3762,2,2,13227,13227,13229,0,2,1
3763,3,1,13230,13230,13231,0,1,1
3764,1,1,13231,13231,13232,0,1,0
3765,5,2,13236,13236,13238,0,2,4
3766,3,2,13239,13239,13241,0,2,1
3767,6,3,13245,13245,13248,0,3,4
3768,5,1,13250,13250,13251,0,1,2
3769,2,3,13252,13252,13255,0,3,1
3770,2,3,13254,13255,13258,1,4,0
3771,6,3,13260,13260,13263,0,3,2
3772,2,3,13262,13263,13266,1,4,0
3773,5,3,13267,13267,13270,0,3,1
3774,2,1,13269,13270,13271,1,2,0
3775,2,1,13271,13271,13272,0,1,0
3776,6,3,13277,13277,13280,0,3,5
3777,2,2,13279,13280,13282,1,3,0
3778,5,3,13284,13284,13287,0,3,2
3779,5,2,13289,13289,13291,0,2,2
3780,2,3,13291,13291,13294,0,3,0
3781,3,3,13294,13294,13297,0,3,0
3782,5,2,13299,13299,13301,0,2,2
3783,1,3,13300,13301,13304,1,4,0
3784,5,3,13305,13305,13308,0,3,1
3785,3,1,13308,13308,13309,0,1,0
3786,1,2,13309,13309,13311,0,2,0
3787,3,1,13312,13312,13313,0,1,1
3788,6,1,13318,13318,13319,0,1,5
3789,4,2,13322,13322,13324,0,2,3
3790,1,2,13323,13324,13326,1,3,0
3791,1,1,13324,13326,13327,2,3,0
3792,3,1,13327,13327,13328,0,1,0
3793,6,2,13333,13333,13335,0,2,5
3794,2,3,13335,13335,13338,0,3,0
3795,5,2,13340,13340,13342,0,2,2
3796,2,1,13342,13342,13343,0,1,0
3797,5,1,13347,13347,13348,0,1,4
3798,1,2,13348,13348,13350,0,2,0
3799,6,1,13354,13354,13355,0,1,4
3800,3,1,13357,13357,13358,0,1,2
3801,6,1,13363,13363,13364,0,1,5
3802,4,2,13367,13367,13369,0,2,3
3803,3,3,13370,13370,13373,0,3,1
3804,5,1,13375,13375,13376,0,1,2
3805,4,1,13379,13379,13380,0,1,3
3806,5,2,13384,13384,13386,0,2,4
3807,3,2,13387,13387,13389,0,2,1
3808,2,3,13389,13389,13392,0,3,0
3809,4,1,13393,13393,13394,0,1,1
3810,4,1,13397,13397,13398,0,1,3
3811,1,2,13398,13398,13400,0,2,0
3812,6,3,13404,13404,13407,0,3,4
3813,1,3,13405,13407,13410,2,5,0
3814,5,2,13410,13410,13412,0,2,0
3815,2,1,13412,13412,13413,0,1,0
3816,1,2,13413,13413,13415,0,2,0
3817,2,3,13415,13415,13418,0,3,0
3818,3,1,13418,13418,13419,0,1,0
3819,4,2,13422,13422,13424,0,2,3
3820,4,2,13426,13426,13428,0,2,2
3821,1,1,13427,13428,13429,1,2,0
3822,3,2,13430,13430,13432,0,2,1
3823,5,1,13435,13435,13436,0,1,3
3824,5,2,13440,13440,13442,0,2,4
3825,4,1,13444,13444,13445,0,1,2
3826,1,2,13445,13445,13447,0,2,0
3827,4,2,13449,13449,13451,0,2,2
3828,2,2,13451,13451,13453,0,2,0
3829,6,3,13457,13457,13460,0,3,4
3830,5,2,13462,13462,13464,0,2,2
3831,2,2,13464,13464,13466,0,2,0
3832,5,2,13469,13469,13471,0,2,3
3833,6,1,13475,13475,13476,0,1,4
3834,1,2,13476,13476,13478,0,2,0
3835,6,1,13482,13482,13483,0,1,4
3836,6,1,13488,13488,13489,0,1,5
3837,2,3,13490,13490,13493,0,3,1
3838,5,2,13495,13495,13497,0,2,2
3839,5,2,13500,13500,13502,0,2,3
3840,5,2,13505,13505,13507,0,2,3
3841,3,1,13508,13508,13509,0,1,1
3842,3,2,13511,13511,13513,0,2,2
3843,3,3,13514,13514,13517,0,3,1
3844,4,2,13518,13518,13520,0,2,1
3845,3,3,13521,13521,13524,0,3,1
3846,6,1,13527,13527,13528,0,1,3
3847,1,2,13528,13528,13530,0,2,0
3848,5,3,13533,13533,13536,0,3,3
3849,1,3,13534,13536,13539,2,5,0
3850,6,1,13540,13540,13541,0,1,1
3851,4,3,13544,13544,13547,0,3,3
3852,5,3,13549,13549,13552,0,3,2
3853,6,2,13555,13555,13557,0,2,3
3854,5,1,13560,13560,13561,0,1,3
3855,1,3,13561,13561,13564,0,3,0
3856,1,3,13562,13564,13567,2,5,0
3857,2,2,13564,13567,13569,3,5,0
3858,6,2,13570,13570,13572,0,2,1
3859,4,2,13574,13574,13576,0,2,2
3860,4,1,13578,13578,13579,0,1,2
3861,2,1,13580,13580,13581,0,1,1
3862,3,3,13583,13583,13586,0,3,2
3863,3,1,13586,13586,13587,0,1,0
3864,1,1,13587,13587,13588,0,1,0
3865,2,3,13589,13589,13592,0,3,1
3866,5,2,13594,13594,13596,0,2,2
3867,3,1,13597,13597,13598,0,1,1
3868,2,2,13599,13599,13601,0,2,1
3869,5,1,13604,13604,13605,0,1,3
3870,4,1,13608,13608,13609,0,1,3
3871,2,1,13610,13610,13611,0,1,1
3872,3,2,13613,13613,13615,0,2,2
3873,3,2,13616,13616,13618,0,2,1
3874,3,3,13619,13619,13622,0,3,1
3875,5,1,13624,13624,13625,0,1,2
3876,5,1,13629,13629,13630,0,1,4
3877,3,3,13632,13632,13635,0,3,2
3878,6,3,13638,13638,13641,0,3,3
3879,2,1,13640,13641,13642,1,2,0
3880,1,2,13641,13642,13644,1,3,0
3881,3,2,13644,13644,13646,0,2,0
3882,4,1,13648,13648,13649,0,1,2
3883,1,3,13649,13649,13652,0,3,0
3884,2,1,13651,13652,13653,1,2,0
3885,6,3,13657,13657,13660,0,3,4
3886,6,3,13663,13663,13666,0,3,3
3887,4,2,13667,13667,13669,0,2,1
3888,3,3,13670,13670,13673,0,3,1
3889,6,2,13676,13676,13678,0,2,3
3890,2,1,13678,13678,13679,0,1,0
3891,4,1,13682,13682,13683,0,1,3
3892,3,2,13685,13685,13687,0,2,2
3893,1,1,13686,13687,13688,1,2,0
3894,5,2,13691,13691,13693,0,2,3
3895,3,3,13694,13694,13697,0,3,1
3896,3,3,13697,13697,13700,0,3,0
3897,3,2,13700,13700,13702,0,2,0
3898,1,1,13701,13702,13703,1,2,0
3899,1,2,13702,13703,13705,1,3,0
3900,5,2,13707,13707,13709,0,2,2
3901,3,2,13710,13710,13712,0,2,1
3902,6,1,13716,13716,13717,0,1,4
3903,6,1,13722,13722,13723,0,1,5
3904,3,2,13725,13725,13727,0,2,2
3905,4,1,13729,13729,13730,0,1,2
3906,3,2,13732,13732,13734,0,2,2
3907,4,2,13736,13736,13738,0,2,2
3908,2,2,13738,13738,13740,0,2,0
3909,6,3,13744,13744,13747,0,3,4
3910,6,1,13750,13750,13751,0,1,3
3911,3,1,13753,13753,13754,0,1,2
3912,2,2,13755,13755,13757,0,2,1
3913,3,3,13758,13758,13761,0,3,1
3914,4,1,13762,13762,13763,0,1,1
3915,1,3,13763,13763,13766,0,3,0
3916,5,3,13768,13768,13771,0,3,2
3917,5,3,13773,13773,13776,0,3,2
3918,4,3,13777,13777,13780,0,3,1
3919,5,1,13782,13782,13783,0,1,2
3920,6,3,13788,13788,13791,0,3,5
3921,5,3,13793,13793,13796,0,3,2
3922,3,1,13796,13796,13797,0,1,0
3923,4,1,13800,13800,13801,0,1,3
3924,6,1,13806,13806,13807,0,1,5
3925,4,3,13810,13810,13813,0,3,3
3926,2,3,13812,13813,13816,1,4,0
3927,5,1,13817,13817,13818,0,1,1
3928,3,3,13820,13820,13823,0,3,2
3929,3,1,13823,13823,13824,0,1,0
3930,4,3,13827,13827,13830,0,3,3
3931,6,1,13833,13833,13834,0,1,3
3932,4,2,13837,13837,13839,0,2,3
3933,1,1,13838,13839,13840,1,2,0
3934,2,3,13840,13840,13843,0,3,0
3935,2,3,13842,13843,13846,1,4,0
3936,6,1,13848,13848,13849,0,1,2
3937,1,3,13849,13849,13852,0,3,0
3938,2,3,13851,13852,13855,1,4,0
3939,2,2,13853,13855,13857,2,4,0
3940,1,2,13854,13857,13859,3,5,0
3941,4,1,13858,13859,13860,1,2,0
3942,4,2,13862,13862,13864,0,2,2
3943,6,1,13868,13868,13869,0,1,4
3944,1,3,13869,13869,13872,0,3,0
3945,3,2,13872,13872,13874,0,2,0
3946,3,1,13875,13875,13876,0,1,1
3947,4,2,13879,13879,13881,0,2,3
3948,2,3,13881,13881,13884,0,3,0
3949,5,1,13886,13886,13887,0,1,2
3950,3,1,13889,13889,13890,0,1,2
3951,3,1,13892,13892,13893,0,1,2
3952,4,2,13896,13896,13898,0,2,3
3953,2,1,13898,13898,13899,0,1,0
3954,6,3,13904,13904,13907,0,3,5
3955,6,3,13910,13910,13913,0,3,3
3956,6,3,13916,13916,13919,0,3,3
3957,5,2,13921,13921,13923,0,2,2
3958,2,1,13923,13923,13924,0,1,0
3959,2,1,13925,13925,13926,0,1,1
3960,5,2,13930,13930,13932,0,2,4
3961,5,1,13935,13935,13936,0,1,3
3962,5,1,13940,13940,13941,0,1,4
3963,1,2,13941,13941,13943,0,2,0
3964,1,1,13942,13943,13944,1,2,0
3965,4,1,13946,13946,13947,0,1,2
3966,5,1,13951,13951,13952,0,1,4
3967,3,1,13954,13954,13955,0,1,2
3968,4,2,13958,13958,13960,0,2,3
3969,1,3,13959,13960,13963,1,4,0
3970,4,2,13963,13963,13965,0,2,0
3971,3,2,13966,13966,13968,0,2,1
3972,4,3,13970,13970,13973,0,3,2
3973,4,3,13974,13974,13977,0,3,1
3974,6,3,13980,13980,13983,0,3,3
3975,2,2,13982,13983,13985,1,3,0
3976,5,2,13987,13987,13989,0,2,2
3977,4,1,13991,13991,13992,0,1,2
3978,5,3,13996,13996,13999,0,3,4
3979,1,2,13997,13999,14001,2,4,0
3980,2,2,13999,14001,14003,2,4,0
3981,4,1,14003,14003,14004,0,1,0
3982,1,1,14004,14004,14005,0,1,0
3983,5,2,14009,14009,14011,0,2,4
3984,4,3,14013,14013,14016,0,3,2
3985,6,2,14019,14019,14021,0,2,3
3986,3,2,14022,14022,14024,0,2,1
3987,6,3,14028,14028,14031,0,3,4
3988,5,2,14033,14033,14035,0,2,2
3989,2,3,14035,14035,14038,0,3,0
3990,1,3,14036,14038,14041,2,5,0
3991,4,3,14040,14041,14044,1,4,0
3992,4,1,14044,14044,14045,0,1,0
3993,2,2,14046,14046,14048,0,2,1
3994,4,3,14050,14050,14053,0,3,2
3995,5,3,14055,14055,14058,0,3,2
3996,2,2,14057,14058,14060,1,3,0
3997,3,2,14060,14060,14062,0,2,0
3998,4,1,14064,14064,14065,0,1,2
3999,5,2,14069,14069,14071,0,2,4
4000,1,3,14070,14071,14074,1,4,0
4001,1,1,14071,14074,14075,3,4,0
4002,3,2,14074,14075,14077,1,3,0
4003,4,3,14078,14078,14081,0,3,1
4004,4,3,14082,14082,14085,0,3,1
4005,2,2,14084,14085,14087,1,3,0
4006,4,2,14088,14088,14090,0,2,1
4007,5,1,14093,14093,14094,0,1,3
4008,2,2,14095,14095,14097,0,2,1
4009,6,3,14101,14101,14104,0,3,4
4010,1,3,14102,14104,14107,2,5,0
4011,3,1,14105,14107,14108,2,3,0
4012,6,2,14111,14111,14113,0,2,3
4013,1,3,14112,14113,14116,1,4,0
4014,4,2,14116,14116,14118,0,2,0
4015,1,2,14117,14118,14120,1,3,0
4016,5,2,14122,14122,14124,0,2,2
4017,3,3,14125,14125,14128,0,3,1
4018,1,2,14126,14128,14130,2,4,0
4019,3,3,14129,14130,14133,1,4,0
4020,2,3,14131,14133,14136,2,5,0
4021,4,2,14135,14136,14138,1,3,0
4022,4,2,14139,14139,14141,0,2,1
4023,4,3,14143,14143,14146,0,3,2
4024,3,1,14146,14146,14147,0,1,0
4025,4,1,14150,14150,14151,0,1,3
4026,6,1,14156,14156,14157,0,1,5
4027,5,3,14161,14161,14164,0,3,4
4028,3,2,14164,14164,14166,0,2,0
4029,1,3,14165,14166,14169,1,4,0
4030,4,3,14169,14169,14172,0,3,0
4031,1,2,14170,14172,14174,2,4,0
4032,2,1,14172,14174,14175,2,3,0
4033,1,2,14173,14175,14177,2,4,0
4034,4,3,14177,14177,14180,0,3,0
4035,4,1,14181,14181,14182,0,1,1
4036,4,3,14185,14185,14188,0,3,3
4037,5,1,14190,14190,14191,0,1,2
4038,1,1,14191,14191,14192,0,1,0
4039,2,1,14193,14193,14194,0,1,1
4040,5,1,14198,14198,14199,0,1,4
4041,4,1,14202,14202,14203,0,1,3
4042,1,1,14203,14203,14204,0,1,0
4043,4,3,14207,14207,14210,0,3,3
4044,5,2,14212,14212,14214,0,2,2
4045,3,2,14215,14215,14217,0,2,1
4046,5,1,14220,14220,14221,0,1,3
4047,6,3,14226,14226,14229,0,3,5
4048,5,1,14231,14231,14232,0,1,2
4049,4,3,14235,14235,14238,0,3,3
4050,4,1,14239,14239,14240,0,1,1
4051,5,2,14244,14244,14246,0,2,4
4052,3,1,14247,14247,14248,0,1,1
4053,1,2,14248,14248,14250,0,2,0
4054,6,2,14254,14254,14256,0,2,4
4055,1,1,14255,14256,14257,1,2,0
4056,4,3,14259,14259,14262,0,3,2
4057,5,3,14264,14264,14267,0,3,2
4058,4,3,14268,14268,14271,0,3,1
4059,4,2,14272,14272,14274,0,2,1
4060,1,3,14273,14274,14277,1,4,0
4061,6,1,14279,14279,14280,0,1,2
4062,3,3,14282,14282,14285,0,3,2
4063,6,1,14288,14288,14289,0,1,3
4064,4,1,14292,14292,14293,0,1,3
4065,1,2,14293,14293,14295,0,2,0
4066,2,3,14295,14295,14298,0,3,0
4067,3,2,14298,14298,14300,0,2,0
4068,5,2,14303,14303,14305,0,2,3
4069,4,1,14307,14307,14308,0,1,2
4070,2,2,14309,14309,14311,0,2,1
4071,5,2,14314,14314,14316,0,2,3
4072,5,1,14319,14319,14320,0,1,3
4073,6,2,14325,14325,14327,0,2,5
4074,1,3,14326,14327,14330,1,4,0
4075,5,3,14331,14331,14334,0,3,1
4076,6,3,14337,14337,14340,0,3,3
4077,3,1,14340,14340,14341,0,1,0
4078,2,1,14342,14342,14343,0,1,1
4079,6,1,14348,14348,14349,0,1,5
4080,4,2,14352,14352,14354,0,2,3
4081,3,1,14355,14355,14356,0,1,1
4082,1,2,14356,14356,14358,0,2,0
4083,6,1,14362,14362,14363,0,1,4
4084,2,1,14364,14364,14365,0,1,1
4085,5,1,14369,14369,14370,0,1,4
4086,6,2,14375,14375,14377,0,2,5
4087,3,3,14378,14378,14381,0,3,1
4088,3,3,14381,14381,14384,0,3,0
4089,6,3,14387,14387,14390,0,3,3
4090,4,1,14391,14391,14392,0,1,1
4091,2,2,14393,14393,14395,0,2,1
4092,3,3,14396,14396,14399,0,3,1
4093,6,3,14402,14402,14405,0,3,3
4094,1,2,14403,14405,14407,2,4,0
4095,3,1,14406,14407,14408,1,2,0
4096,4,1,14410,14410,14411,0,1,2
4097,3,2,14413,14413,14415,0,2,2
4098,5,2,14418,14418,14420,0,2,3
4099,5,3,14423,14423,14426,0,3,3
4100,1,2,14424,14426,14428,2,4,0
4101,4,1,14428,14428,14429,0,1,0
4102,3,3,14431,14431,14434,0,3,2
4103,3,1,14434,14434,14435,0,1,0
4104,3,3,14437,14437,14440,0,3,2
4105,3,2,14440,14440,14442,0,2,0
4106,5,3,14445,14445,14448,0,3,3
4107,6,1,14451,14451,14452,0,1,3
4108,4,1,14455,14455,14456,0,1,3
4109,1,2,14456,14456,14458,0,2,0
4110,6,3,14462,14462,14465,0,3,4
4111,1,3,14463,14465,14468,2,5,0
4112,5,1,14468,14468,14469,0,1,0
4113,4,3,14472,14472,14475,0,3,3
4114,5,3,14477,14477,14480,0,3,2
4115,2,1,14479,14480,14481,1,2,0
4116,1,2,14480,14481,14483,1,3,0
4117,4,1,14484,14484,14485,0,1,1
4118,3,2,14487,14487,14489,0,2,2
4119,5,3,14492,14492,14495,0,3,3
4120,4,3,14496,14496,14499,0,3,1
4121,6,2,14502,14502,14504,0,2,3
4122,3,1,14505,14505,14506,0,1,1
4123,3,3,14508,14508,14511,0,3,2
4124,2,2,14510,14511,14513,1,3,0
4125,4,1,14514,14514,14515,0,1,1
4126,1,2,14515,14515,14517,0,2,0
4127,1,3,14516,14517,14520,1,4,0
4128,3,3,14519,14520,14523,1,4,0
4129,1,1,14520,14523,14524,3,4,0
4130,2,1,14522,14524,14525,2,3,0
4131,2,2,14524,14525,14527,1,3,0
4132,3,2,14527,14527,14529,0,2,0
4133,1,3,14528,14529,14532,1,4,0
4134,6,1,14534,14534,14535,0,1,2
4135,6,2,14540,14540,14542,0,2,5
4136,5,1,14545,14545,14546,0,1,3
4137,3,1,14548,14548,14549,0,1,2
4138,3,1,14551,14551,14552,0,1,2
4139,1,2,14552,14552,14554,0,2,0
4140,5,2,14557,14557,14559,0,2,3
4141,5,2,14562,14562,14564,0,2,3
4142,6,3,14568,14568,14571,0,3,4
4143,2,1,14570,14571,14572,1,2,0
4144,3,2,14573,14573,14575,0,2,1
4145,4,1,14577,14577,14578,0,1,2
4146,6,1,14583,14583,14584,0,1,5
4147,4,2,14587,14587,14589,0,2,3
4148,1,2,14588,14589,14591,1,3,0
4149,5,2,14593,14593,14595,0,2,2
4150,5,3,14598,14598,14601,0,3,3
4151,1,1,14599,14601,14602,2,3,0
4152,2,2,14601,14602,14604,1,3,0
4153,3,2,14604,14604,14606,0,2,0
4154,5,1,14609,14609,14610,0,1,3
4155,6,2,14615,14615,14617,0,2,5
4156,5,2,14620,14620,14622,0,2,3
4157,2,2,14622,14622,14624,0,2,0
4158,1,2,14623,14624,14626,1,3,0
4159,6,3,14629,14629,14632,0,3,3
4160,2,3,14631,14632,14635,1,4,0
4161,3,2,14634,14635,14637,1,3,0
4162,3,3,14637,14637,14640,0,3,0
4163,3,3,14640,14640,14643,0,3,0
4164,3,3,14643,14643,14646,0,3,0
4165,5,3,14648,14648,14651,0,3,2
4166,1,3,14649,14651,14654,2,5,0
4167,3,2,14652,14654,14656,2,4,0
4168,1,2,14653,14656,14658,3,5,0
4169,1,1,14654,14658,14659,4,5,0
4170,2,2,14656,14659,14661,3,5,0
4171,3,3,14659,14661,14664,2,5,0
4172,4,3,14663,14664,14667,1,4,0
4173,6,3,14669,14669,14672,0,3,2
4174,6,3,14675,14675,14678,0,3,3
4175,3,2,14678,14678,14680,0,2,0
4176,5,1,14683,14683,14684,0,1,3
4177,5,3,14688,14688,14691,0,3,4
4178,4,2,14692,14692,14694,0,2,1
4179,4,1,14696,14696,14697,0,1,2
4180,3,1,14699,14699,14700,0,1,2
4181,4,2,14703,14703,14705,0,2,3
4182,4,2,14707,14707,14709,0,2,2
4183,3,3,14710,14710,14713,0,3,1
4184,5,3,14715,14715,14718,0,3,2
4185,6,2,14721,14721,14723,0,2,3
4186,2,2,14723,14723,14725,0,2,0
4187,5,2,14728,14728,14730,0,2,3
4188,1,1,14729,14730,14731,1,2,0
4189,5,1,14734,14734,14735,0,1,3
4190,5,3,14739,14739,14742,0,3,4
4191,3,3,14742,14742,14745,0,3,0
4192,2,2,14744,14745,14747,1,3,0
4193,6,3,14750,14750,14753,0,3,3
4194,2,3,14752,14753,14756,1,4,0
4195,1,3,14753,14756,14759,3,6,0
4196,3,1,14756,14759,14760,3,4,0
4197,2,3,14758,14760,14763,2,5,0
4198,1,2,14759,14763,14765,4,6,0
4199,5,3,14764,14765,14768,1,4,0
4200,3,1,14767,14768,14769,1,2,0
4201,5,1,14772,14772,14773,0,1,3
4202,1,3,14773,14773,14776,0,3,0
4203,6,1,14779,14779,14780,0,1,3
4204,6,1,14785,14785,14786,0,1,5
4205,6,1,14791,14791,14792,0,1,5
4206,5,3,14796,14796,14799,0,3,4
4207,6,1,14802,14802,14803,0,1,3
4208,6,3,14808,14808,14811,0,3,5
4209,2,2,14810,14811,14813,1,3,0
4210,1,1,14811,14813,14814,2,3,0
4211,2,1,14813,14814,14815,1,2,0
4212,1,2,14814,14815,14817,1,3,0
4213,6,2,14820,14820,14822,0,2,3
4214,1,3,14821,14822,14825,1,4,0
4215,3,3,14824,14825,14828,1,4,0
4216,2,3,14826,14828,14831,2,5,0
4217,3,2,14829,14831,14833,2,4,0
4218,1,2,14830,14833,14835,3,5,0
4219,4,3,14834,14835,14838,1,4,0
4220,2,1,14836,14838,14839,2,3,0
4221,3,3,14839,14839,14842,0,3,0
4222,1,2,14840,14842,14844,2,4,0
4223,4,3,14844,14844,14847,0,3,0
4224,2,3,14846,14847,14850,1,4,0
4225,1,3,14847,14850,14853,3,6,0
4226,1,2,14848,14853,14855,5,7,0
4227,1,3,14849,14855,14858,6,9,0
4228,1,1,14850,14858,14859,8,9,0
4229,1,1,14851,14859,14860,8,9,0
4230,5,1,14856,14860,14861,4,5,0
4231,3,2,14859,14861,14863,2,4,0
4232,3,2,14862,14863,14865,1,3,0
4233,4,2,14866,14866,14868,0,2,1
4234,5,1,14871,14871,14872,0,1,3
4235,1,2,14872,14872,14874,0,2,0
4236,4,1,14876,14876,14877,0,1,2
4237,1,1,14877,14877,14878,0,1,0
4238,5,1,14882,14882,14883,0,1,4
4239,6,2,14888,14888,14890,0,2,5
4240,1,2,14889,14890,14892,1,3,0
4241,3,1,14892,14892,14893,0,1,0
4242,2,2,14894,14894,14896,0,2,1
4243,5,2,14899,14899,14901,0,2,3
4244,1,1,14900,14901,14902,1,2,0
4245,5,3,14905,14905,14908,0,3,3
4246,3,2,14908,14908,14910,0,2,0
4247,5,2,14913,14913,14915,0,2,3
4248,4,2,14917,14917,14919,0,2,2
4249,1,3,14918,14919,14922,1,4,0
4250,2,1,14920,14922,14923,2,3,0
4251,2,2,14922,14923,14925,1,3,0
4252,3,1,14925,14925,14926,0,1,0
4253,5,3,14930,14930,14933,0,3,4
4254,5,3,14935,14935,14938,0,3,2
4255,1,3,14936,14938,14941,2,5,0
4256,2,3,14938,14941,14944,3,6,0
4257,1,3,14939,14944,14947,5,8,0
4258,1,1,14940,14947,14948,7,8,0
4259,2,2,14942,14948,14950,6,8,0
4260,1,3,14943,14950,14953,7,10,0
4261,5,2,14948,14953,14955,5,7,0
4262,3,1,14951,14955,14956,4,5,0
4263,2,3,14953,14956,14959,3,6,0
4264,1,1,14954,14959,14960,5,6,0
4265,3,1,14957,14960,14961,3,4,0
4266,1,2,14958,14961,14963,3,5,0
4267,3,1,14961,14963,14964,2,3,0
4268,6,1,14967,14967,14968,0,1,3
4269,4,3,14971,14971,14974,0,3,3
4270,1,1,14972,14974,14975,2,3,0
4271,1,2,14973,14975,14977,2,4,0
4272,1,2,14974,14977,14979,3,5,0
4273,2,1,14976,14979,14980,3,4,0
4274,3,3,14979,14980,14983,1,4,0
4275,1,1,14980,14983,14984,3,4,0
4276,6,1,14986,14986,14987,0,1,2
4277,3,2,14989,14989,14991,0,2,2
4278,1,3,14990,14991,14994,1,4,0
4279,2,1,14992,14994,14995,2,3,0
4280,2,3,14994,14995,14998,1,4,0
4281,2,1,14996,14998,14999,2,3,0
4282,1,3,14997,14999,15002,2,5,0
4283,6,3,15003,15003,15006,0,3,1
4284,1,1,15004,15006,15007,2,3,0
4285,3,3,15007,15007,15010,0,3,0
4286,3,1,15010,15010,15011,0,1,0
4287,4,1,15014,15014,15015,0,1,3
4288,1,3,15015,15015,15018,0,3,0
4289,1,2,15016,15018,15020,2,4,0
4290,4,1,15020,15020,15021,0,1,0
4291,4,1,15024,15024,15025,0,1,3
4292,4,3,15028,15028,15031,0,3,3
4293,4,3,15032,15032,15035,0,3,1
4294,4,3,15036,15036,15039,0,3,1
4295,5,2,15041,15041,15043,0,2,2
4296,3,2,15044,15044,15046,0,2,1
4297,1,3,15045,15046,15049,1,4,0
4298,3,2,15048,15049,15051,1,3,0
4299,6,2,15054,15054,15056,0,2,3
4300,6,3,15060,15060,15063,0,3,4
4301,3,1,15063,15063,15064,0,1,0
4302,1,2,15064,15064,15066,0,2,0
4303,6,1,15070,15070,15071,0,1,4
4304,4,3,15074,15074,15077,0,3,3
4305,4,2,15078,15078,15080,0,2,1
4306,2,3,15080,15080,15083,0,3,0
4307,4,2,15084,15084,15086,0,2,1
4308,6,2,15090,15090,15092,0,2,4
4309,6,3,15096,15096,15099,0,3,4
4310,1,1,15097,15099,15100,2,3,0
4311,1,1,15098,15100,15101,2,3,0
4312,1,3,15099,15101,15104,2,5,0
4313,6,3,15105,15105,15108,0,3,1
4314,1,1,15106,15108,15109,2,3,0
4315,1,2,15107,15109,15111,2,4,0
4316,5,2,15112,15112,15114,0,2,1
4317,6,3,15118,15118,15121,0,3,4
4318,4,3,15122,15122,15125,0,3,1
4319,6,2,15128,15128,15130,0,2,3
4320,2,3,15130,15130,15133,0,3,0
4321,3,3,15133,15133,15136,0,3,0
4322,2,3,15135,15136,15139,1,4,0
4323,3,2,15138,15139,15141,1,3,0
4324,4,2,15142,15142,15144,0,2,1
4325,4,1,15146,15146,15147,0,1,2
4326,5,2,15151,15151,15153,0,2,4
4327,1,3,15152,15153,15156,1,4,0
4328,5,1,15157,15157,15158,0,1,1
4329,5,1,15162,15162,15163,0,1,4
4330,3,2,15165,15165,15167,0,2,2
4331,6,3,15171,15171,15174,0,3,4
4332,5,2,15176,15176,15178,0,2,2
4333,4,1,15180,15180,15181,0,1,2
4334,3,3,15183,15183,15186,0,3,2
4335,6,3,15189,15189,15192,0,3,3
4336,1,2,15190,15192,15194,2,4,0
4337,1,3,15191,15194,15197,3,6,0
4338,3,3,15194,15197,15200,3,6,0
4339,4,3,15198,15200,15203,2,5,0
4340,1,1,15199,15203,15204,4,5,0
4341,5,1,15204,15204,15205,0,1,0
4342,4,3,15208,15208,15211,0,3,3
4343,1,3,15209,15211,15214,2,5,0
4344,3,1,15212,15214,15215,2,3,0
4345,4,2,15216,15216,15218,0,2,1
4346,1,1,15217,15218,15219,1,2,0
4347,2,1,15219,15219,15220,0,1,0
4348,1,2,15220,15220,15222,0,2,0
4349,2,1,15222,15222,15223,0,1,0
4350,4,2,15226,15226,15228,0,2,3
4351,6,1,15232,15232,15233,0,1,4
4352,6,3,15238,15238,15241,0,3,5
4353,1,3,15239,15241,15244,2,5,0
4354,4,2,15243,15244,15246,1,3,0
4355,2,1,15245,15246,15247,1,2,0
4356,6,1,15251,15251,15252,0,1,4
4357,6,1,15257,15257,15258,0,1,5
4358,6,2,15263,15263,15265,0,2,5
4359,2,3,15265,15265,15268,0,3,0
4360,4,3,15269,15269,15272,0,3,1
4361,3,3,15272,15272,15275,0,3,0
4362,4,1,15276,15276,15277,0,1,1
4363,4,2,15280,15280,15282,0,2,3
4364,5,3,15285,15285,15288,0,3,3
4365,6,2,15291,15291,15293,0,2,3
4366,1,3,15292,15293,15296,1,4,0
4367,2,2,15294,15296,15298,2,4,0
4368,1,1,15295,15298,15299,3,4,0
4369,2,1,15297,15299,15300,2,3,0
4370,3,2,15300,15300,15302,0,2,0
4371,4,3,15304,15304,15307,0,3,2
4372,2,1,15306,15307,15308,1,2,0
4373,3,1,15309,15309,15310,0,1,1
4374,2,3,15311,15311,15314,0,3,1
4375,2,1,15313,15314,15315,1,2,0
4376,1,3,15314,15315,15318,1,4,0
4377,2,1,15316,15318,15319,2,3,0
4378,3,3,15319,15319,15322,0,3,0
4379,5,2,15324,15324,15326,0,2,2
4380,5,3,15329,15329,15332,0,3,3
4381,5,3,15334,15334,15337,0,3,2
4382,3,1,15337,15337,15338,0,1,0
4383,1,3,15338,15338,15341,0,3,0
4384,6,1,15344,15344,15345,0,1,3
4385,6,3,15350,15350,15353,0,3,5
4386,1,1,15351,15353,15354,2,3,0
4387,4,1,15355,15355,15356,0,1,1
4388,2,1,15357,15357,15358,0,1,1
4389,3,2,15360,15360,15362,0,2,2
4390,5,2,15365,15365,15367,0,2,3
4391,5,1,15370,15370,15371,0,1,3
4392,6,1,15376,15376,15377,0,1,5
4393,3,1,15379,15379,15380,0,1,2
4394,3,1,15382,15382,15383,0,1,2
4395,5,3,15387,15387,15390,0,3,4
4396,1,3,15388,15390,15393,2,5,0
4397,6,1,15394,15394,15395,0,1,1
4398,1,2,15395,15395,15397,0,2,0
4399,4,3,15399,15399,15402,0,3,2
4400,5,2,15404,15404,15406,0,2,2
4401,5,1,15409,15409,15410,0,1,3
4402,4,3,15413,15413,15416,0,3,3
4403,5,2,15418,15418,15420,0,2,2
4404,6,3,15424,15424,15427,0,3,4
4405,2,1,15426,15427,15428,1,2,0
4406,3,2,15429,15429,15431,0,2,1
4407,4,3,15433,15433,15436,0,3,2
4408,4,3,15437,15437,15440,0,3,1
4409,3,1,15440,15440,15441,0,1,0
4410,3,3,15443,15443,15446,0,3,2
4411,2,1,15445,15446,15447,1,2,0
4412,5,1,15450,15450,15451,0,1,3
4413,2,2,15452,15452,15454,0,2,1
4414,4,2,15456,15456,15458,0,2,2
4415,3,3,15459,15459,15462,0,3,1
4416,4,3,15463,15463,15466,0,3,1
4417,4,3,15467,15467,15470,0,3,1
4418,6,3,15473,15473,15476,0,3,3
4419,5,1,15478,15478,15479,0,1,2
4420,4,3,15482,15482,15485,0,3,3
4421,3,1,15485,15485,15486,0,1,0
4422,3,1,15488,15488,15489,0,1,2
4423,1,3,15489,15489,15492,0,3,0
4424,4,2,15493,15493,15495,0,2,1
4425,4,1,15497,15497,15498,0,1,2
4426,4,3,15501,15501,15504,0,3,3
4427,1,2,15502,15504,15506,2,4,0
4428,3,3,15505,15506,15509,1,4,0
4429,6,1,15511,15511,15512,0,1,2
4430,3,2,15514,15514,15516,0,2,2
4431,4,2,15518,15518,15520,0,2,2
4432,3,1,15521,15521,15522,0,1,1
4433,6,1,15527,15527,15528,0,1,5
4434,3,3,15530,15530,15533,0,3,2
4435,2,3,15532,15533,15536,1,4,0
4436,5,2,15537,15537,15539,0,2,1
4437,4,3,15541,15541,15544,0,3,2
4438,4,2,15545,15545,15547,0,2,1
4439,5,1,15550,15550,15551,0,1,3
4440,1,2,15551,15551,15553,0,2,0
4441,5,2,15556,15556,15558,0,2,3
4442,4,1,15560,15560,15561,0,1,2
4443,6,2,15566,15566,15568,0,2,5
4444,5,2,15571,15571,15573,0,2,3
4445,6,3,15577,15577,15580,0,3,4
4446,2,3,15579,15580,15583,1,4,0
4447,5,3,15584,15584,15587,0,3,1
4448,4,2,15588,15588,15590,0,2,1
4449,5,2,15593,15593,15595,0,2,3
4450,4,2,15597,15597,15599,0,2,2
4451,4,1,15601,15601,15602,0,1,2
4452,5,2,15606,15606,15608,0,2,4
4453,6,3,15612,15612,15615,0,3,4
4454,1,3,15613,15615,15618,2,5,0
4455,1,1,15614,15618,15619,4,5,0
4456,4,2,15618,15619,15621,1,3,0
4457,3,3,15621,15621,15624,0,3,0
4458,6,3,15627,15627,15630,0,3,3
4459,6,1,15633,15633,15634,0,1,3
4460,3,1,15636,15636,15637,0,1,2
4461,6,3,15642,15642,15645,0,3,5
4462,6,1,15648,15648,15649,0,1,3
4463,4,2,15652,15652,15654,0,2,3
4464,5,2,15657,15657,15659,0,2,3
4465,2,3,15659,15659,15662,0,3,0
4466,6,1,15665,15665,15666,0,1,3
4467,5,3,15670,15670,15673,0,3,4
4468,4,2,15674,15674,15676,0,2,1
4469,1,2,15675,15676,15678,1,3,0
4470,1,3,15676,15678,15681,2,5,0
4471,4,1,15680,15681,15682,1,2,0
4472,4,1,15684,15684,15685,0,1,2
4473,5,2,15689,15689,15691,0,2,4
4474,4,2,15693,15693,15695,0,2,2
4475,6,1,15699,15699,15700,0,1,4
4476,4,3,15703,15703,15706,0,3,3
4477,1,3,15704,15706,15709,2,5,0
4478,1,2,15705,15709,15711,4,6,0
4479,1,1,15706,15711,15712,5,6,0
4480,2,1,15708,15712,15713,4,5,0
4481,4,1,15712,15713,15714,1,2,0
4482,3,2,15715,15715,15717,0,2,1
4483,5,2,15720,15720,15722,0,2,3
4484,4,3,15724,15724,15727,0,3,2
4485,5,2,15729,15729,15731,0,2,2
4486,6,3,15735,15735,15738,0,3,4
4487,1,2,15736,15738,15740,2,4,0
4488,5,1,15741,15741,15742,0,1,1
4489,4,3,15745,15745,15748,0,3,3
4490,2,1,15747,15748,15749,1,2,0
4491,6,3,15753,15753,15756,0,3,4
4492,5,2,15758,15758,15760,0,2,2
4493,4,1,15762,15762,15763,0,1,2
4494,4,3,15766,15766,15769,0,3,3
4495,6,3,15772,15772,15775,0,3,3
4496,4,1,15776,15776,15777,0,1,1
4497,5,1,15781,15781,15782,0,1,4
4498,6,2,15787,15787,15789,0,2,5
4499,2,1,15789,15789,15790,0,1,0
4500,4,1,15793,15793,15794,0,1,3
4501,1,3,15794,15794,15797,0,3,0
4502,6,3,15800,15800,15803,0,3,3
4503,1,2,15801,15803,15805,2,4,0
4504,2,1,15803,15805,15806,2,3,0
4505,1,2,15804,15806,15808,2,4,0
4506,2,2,15806,15808,15810,2,4,0
4507,5,1,15811,15811,15812,0,1,1
4508,2,1,15813,15813,15814,0,1,1
4509,6,2,15819,15819,15821,0,2,5
4510,6,1,15825,15825,15826,0,1,4
4511,3,3,15828,15828,15831,0,3,2
4512,5,2,15833,15833,15835,0,2,2
4513,6,2,15839,15839,15841,0,2,4
4514,3,2,15842,15842,15844,0,2,1
4515,3,3,15845,15845,15848,0,3,1
4516,1,2,15846,15848,15850,2,4,0
4517,3,2,15849,15850,15852,1,3,0
4518,5,2,15854,15854,15856,0,2,2
4519,6,2,15860,15860,15862,0,2,4
4520,1,3,15861,15862,15865,1,4,0
4521,4,1,15865,15865,15866,0,1,0
4522,1,1,15866,15866,15867,0,1,0
4523,2,1,15868,15868,15869,0,1,1
4524,1,2,15869,15869,15871,0,2,0
4525,2,3,15871,15871,15874,0,3,0
4526,6,3,15877,15877,15880,0,3,3
4527,6,2,15883,15883,15885,0,2,3
4528,5,3,15888,15888,15891,0,3,3
4529,3,2,15891,15891,15893,0,2,0
4530,5,3,15896,15896,15899,0,3,3
4531,3,3,15899,15899,15902,0,3,0
4532,6,3,15905,15905,15908,0,3,3
4533,2,1,15907,15908,15909,1,2,0
4534,3,3,15910,15910,15913,0,3,1
4535,6,2,15916,15916,15918,0,2,3
4536,4,2,15920,15920,15922,0,2,2
4537,2,3,15922,15922,15925,0,3,0
4538,3,2,15925,15925,15927,0,2,0
4539,4,3,15929,15929,15932,0,3,2
4540,6,2,15935,15935,15937,0,2,3
4541,6,2,15941,15941,15943,0,2,4
4542,6,3,15947,15947,15950,0,3,4
4543,4,2,15951,15951,15953,0,2,1
4544,4,1,15955,15955,15956,0,1,2
4545,6,3,15961,15961,15964,0,3,5
4546,2,2,15963,15964,15966,1,3,0
4547,1,1,15964,15966,15967,2,3,0
4548,3,2,15967,15967,15969,0,2,0
4549,1,2,15968,15969,15971,1,3,0
4550,1,2,15969,15971,15973,2,4,0
4551,2,2,15971,15973,15975,2,4,0
4552,6,2,15977,15977,15979,0,2,2
4553,5,2,15982,15982,15984,0,2,3
4554,5,1,15987,15987,15988,0,1,3
4555,5,3,15992,15992,15995,0,3,4
4556,2,2,15994,15995,15997,1,3,0
4557,5,3,15999,15999,16002,0,3,2
4558,1,1,16000,16002,16003,2,3,0
4559,1,3,16001,16003,16006,2,5,0
4560,2,3,16003,16006,16009,3,6,0
4561,5,3,16008,16009,16012,1,4,0
4562,3,2,16011,16012,16014,1,3,0
4563,4,2,16015,16015,16017,0,2,1
4564,6,2,16021,16021,16023,0,2,4
4565,4,3,16025,16025,16028,0,3,2
4566,2,3,16027,16028,16031,1,4,0
4567,2,1,16029,16031,16032,2,3,0
4568,3,3,16032,16032,16035,0,3,0
4569,2,3,16034,16035,16038,1,4,0
4570,2,3,16036,16038,16041,2,5,0
4571,3,2,16039,16041,16043,2,4,0
4572,1,1,16040,16043,16044,3,4,0
4573,6,2,16046,16046,16048,0,2,2
4574,4,2,16050,16050,16052,0,2,2
4575,1,3,16051,16052,16055,1,4,0
4576,1,2,16052,16055,16057,3,5,0
4577,4,1,16056,16057,16058,1,2,0
4578,6,2,16062,16062,16064,0,2,4
4579,6,1,16068,16068,16069,0,1,4
4580,2,3,16070,16070,16073,0,3,1
4581,5,2,16075,16075,16077,0,2,2
4582,2,2,16077,16077,16079,0,2,0
4583,2,3,16079,16079,16082,0,3,0
4584,6,1,16085,16085,16086,0,1,3
4585,6,3,16091,16091,16094,0,3,5
4586,4,1,16095,16095,16096,0,1,1
4587,1,3,16096,16096,16099,0,3,0
4588,6,1,16102,16102,16103,0,1,3
4589,1,3,16103,16103,16106,0,3,0
4590,4,2,16107,16107,16109,0,2,1
4591,2,2,16109,16109,16111,0,2,0
4592,6,2,16115,16115,16117,0,2,4
4593,4,1,16119,16119,16120,0,1,2
4594,6,2,16125,16125,16127,0,2,5
4595,5,1,16130,16130,16131,0,1,3
4596,3,2,16133,16133,16135,0,2,2
4597,5,1,16138,16138,16139,0,1,3
4598,1,3,16139,16139,16142,0,3,0
4599,5,1,16144,16144,16145,0,1,2
4600,1,1,16145,16145,16146,0,1,0
4601,6,2,16151,16151,16153,0,2,5
4602,4,1,16155,16155,16156,0,1,2
4603,6,1,16161,16161,16162,0,1,5
4604,1,1,16162,16162,16163,0,1,0
4605,5,2,16167,16167,16169,0,2,4
4606,2,3,16169,16169,16172,0,3,0
4607,4,3,16173,16173,16176,0,3,1
4608,5,2,16178,16178,16180,0,2,2
4609,2,1,16180,16180,16181,0,1,0
4610,1,3,16181,16181,16184,0,3,0
4611,3,1,16184,16184,16185,0,1,0
4612,6,3,16190,16190,16193,0,3,5
4613,5,3,16195,16195,16198,0,3,2
4614,6,3,16201,16201,16204,0,3,3
4615,2,3,16203,16204,16207,1,4,0
4616,6,3,16209,16209,16212,0,3,2
4617,4,3,16213,16213,16216,0,3,1
4618,2,1,16215,16216,16217,1,2,0
4619,2,3,16217,16217,16220,0,3,0
4620,4,2,16221,16221,16223,0,2,1
4621,6,1,16227,16227,16228,0,1,4
4622,4,2,16231,16231,16233,0,2,3
4623,6,1,16237,16237,16238,0,1,4
4624,5,3,16242,16242,16245,0,3,4
4625,2,2,16244,16245,16247,1,3,0
4626,5,3,16249,16249,16252,0,3,2
4627,5,3,16254,16254,16257,0,3,2
4628,2,1,16256,16257,16258,1,2,0
4629,3,2,16259,16259,16261,0,2,1
4630,2,3,16261,16261,16264,0,3,0
4631,3,3,16264,16264,16267,0,3,0
4632,4,3,16268,16268,16271,0,3,1
4633,4,3,16272,16272,16275,0,3,1
4634,3,1,16275,16275,16276,0,1,0
4635,4,1,16279,16279,16280,0,1,3
4636,1,1,16280,16280,16281,0,1,0
4637,1,1,16281,16281,16282,0,1,0
4638,6,1,16287,16287,16288,0,1,5
4639,6,1,16293,16293,16294,0,1,5
4640,1,3,16294,16294,16297,0,3,0
4641,6,3,16300,16300,16303,0,3,3
4642,4,3,16304,16304,16307,0,3,1
4643,2,3,16306,16307,16310,1,4,0
4644,4,1,16310,16310,16311,0,1,0
4645,6,3,16316,16316,16319,0,3,5
4646,3,3,16319,16319,16322,0,3,0
4647,4,3,16323,16323,16326,0,3,1
4648,5,3,16328,16328,16331,0,3,2
4649,4,1,16332,16332,16333,0,1,1
4650,6,2,16338,16338,16340,0,2,5
4651,1,2,16339,16340,16342,1,3,0
4652,3,1,16342,16342,16343,0,1,0
4653,4,3,16346,16346,16349,0,3,3
4654,4,2,16350,16350,16352,0,2,1
4655,2,2,16352,16352,16354,0,2,0
4656,2,1,16354,16354,16355,0,1,0
4657,1,3,16355,16355,16358,0,3,0
4658,3,1,16358,16358,16359,0,1,0
4659,5,2,16363,16363,16365,0,2,4
4660,6,3,16369,16369,16372,0,3,4
4661,2,2,16371,16372,16374,1,3,0
4662,2,3,16373,16374,16377,1,4,0
4663,2,3,16375,16377,16380,2,5,0
4664,1,3,16376,16380,16383,4,7,0
4665,4,2,16380,16383,16385,3,5,0
4666,4,1,16384,16385,16386,1,2,0
4667,1,3,16385,16386,16389,1,4,0
4668,6,3,16391,16391,16394,0,3,2
4669,4,1,16395,16395,16396,0,1,1
4670,6,1,16401,16401,16402,0,1,5
4671,2,3,16403,16403,16406,0,3,1
4672,6,3,16409,16409,16412,0,3,3
4673,4,2,16413,16413,16415,0,2,1
4674,1,1,16414,16415,16416,1,2,0
4675,2,2,16416,16416,16418,0,2,0
4676,6,2,16422,16422,16424,0,2,4
4677,3,1,16425,16425,16426,0,1,1
4678,5,2,16430,16430,16432,0,2,4
4679,1,2,16431,16432,16434,1,3,0
4680,5,2,16436,16436,16438,0,2,2
4681,1,1,16437,16438,16439,1,2,0
4682,5,2,16442,16442,16444,0,2,3
4683,6,2,16448,16448,16450,0,2,4
4684,1,1,16449,16450,16451,1,2,0
4685,6,2,16455,16455,16457,0,2,4
4686,4,1,16459,16459,16460,0,1,2
4687,2,1,16461,16461,16462,0,1,1
4688,3,1,16464,16464,16465,0,1,2
4689,1,3,16465,16465,16468,0,3,0
4690,6,1,16471,16471,16472,0,1,3
4691,1,2,16472,16472,16474,0,2,0
4692,6,1,16478,16478,16479,0,1,4
4693,1,3,16479,16479,16482,0,3,0
4694,2,3,16481,16482,16485,1,4,0
4695,1,1,16482,16485,16486,3,4,0
4696,4,1,16486,16486,16487,0,1,0
4697,6,2,16492,16492,16494,0,2,5
4698,6,2,16498,16498,16500,0,2,4
4699,1,2,16499,16500,16502,1,3,0
4700,5,2,16504,16504,16506,0,2,2
4701,1,3,16505,16506,16509,1,4,0
4702,1,2,16506,16509,16511,3,5,0
4703,2,1,16508,16511,16512,3,4,0
4704,2,3,16510,16512,16515,2,5,0
4705,6,2,16516,16516,16518,0,2,1
4706,5,3,16521,16521,16524,0,3,3
4707,5,1,16526,16526,16527,0,1,2
4708,6,2,16532,16532,16534,0,2,5
4709,5,2,16537,16537,16539,0,2,3
4710,4,2,16541,16541,16543,0,2,2
4711,5,3,16546,16546,16549,0,3,3
4712,1,3,16547,16549,16552,2,5,0
4713,2,3,16549,16552,16555,3,6,0
4714,3,2,16552,16555,16557,3,5,0
4715,4,1,16556,16557,16558,1,2,0
4716,5,2,16561,16561,16563,0,2,3
4717,5,1,16566,16566,16567,0,1,3
4718,4,3,16570,16570,16573,0,3,3
4719,6,3,16576,16576,16579,0,3,3
4720,5,3,16581,16581,16584,0,3,2
4721,3,1,16584,16584,16585,0,1,0
4722,1,3,16585,16585,16588,0,3,0
4723,5,3,16590,16590,16593,0,3,2
4724,1,2,16591,16593,16595,2,4,0
4725,2,1,16593,16595,16596,2,3,0
4726,4,1,16597,16597,16598,0,1,1
4727,4,3,16601,16601,16604,0,3,3
4728,4,3,16605,16605,16608,0,3,1
4729,3,1,16608,16608,16609,0,1,0
4730,6,3,16614,16614,16617,0,3,5
4731,6,2,16620,16620,16622,0,2,3
4732,3,3,16623,16623,16626,0,3,1
4733,2,3,16625,16626,16629,1,4,0
4734,6,1,16631,16631,16632,0,1,2
4735,1,3,16632,16632,16635,0,3,0
4736,4,2,16636,16636,16638,0,2,1
4737,5,1,16641,16641,16642,0,1,3
4738,5,3,16646,16646,16649,0,3,4
4739,4,2,16650,16650,16652,0,2,1
4740,6,3,16656,16656,16659,0,3,4
4741,5,2,16661,16661,16663,0,2,2
4742,5,2,16666,16666,16668,0,2,3
4743,4,1,16670,16670,16671,0,1,2
4744,6,1,16676,16676,16677,0,1,5
4745,2,1,16678,16678,16679,0,1,1
4746,5,1,16683,16683,16684,0,1,4
4747,3,3,16686,16686,16689,0,3,2
4748,4,1,16690,16690,16691,0,1,1
4749,3,3,16693,16693,16696,0,3,2
4750,3,3,16696,16696,16699,0,3,0
4751,1,1,16697,16699,16700,2,3,0
4752,1,2,16698,16700,16702,2,4,0
4753,4,2,16702,16702,16704,0,2,0
4754,2,1,16704,16704,16705,0,1,0
4755,3,1,16707,16707,16708,0,1,2
4756,1,1,16708,16708,16709,0,1,0
4757,6,3,16714,16714,16717,0,3,5
4758,5,1,16719,16719,16720,0,1,2
4759,4,1,16723,16723,16724,0,1,3
4760,6,3,16729,16729,16732,0,3,5
4761,5,2,16734,16734,16736,0,2,2
4762,4,3,16738,16738,16741,0,3,2
4763,6,1,16744,16744,16745,0,1,3
4764,3,3,16747,16747,16750,0,3,2
4765,2,3,16749,16750,16753,1,4,0
4766,3,3,16752,16753,16756,1,4,0
4767,4,3,16756,16756,16759,0,3,0
4768,6,2,16762,16762,16764,0,2,3
4769,5,1,16767,16767,16768,0,1,3
4770,2,2,16769,16769,16771,0,2,1
4771,1,3,16770,16771,16774,1,4,0
4772,4,3,16774,16774,16777,0,3,0
4773,5,2,16779,16779,16781,0,2,2
4774,2,3,16781,16781,16784,0,3,0
4775,6,3,16787,16787,16790,0,3,3
4776,4,2,16791,16791,16793,0,2,1
4777,5,2,16796,16796,16798,0,2,3
4778,2,3,16798,16798,16801,0,3,0
4779,4,2,16802,16802,16804,0,2,1
4780,1,3,16803,16804,16807,1,4,0
4781,1,3,16804,16807,16810,3,6,0
4782,4,1,16808,16810,16811,2,3,0
4783,3,1,16811,16811,16812,0,1,0
4784,3,2,16814,16814,16816,0,2,2
4785,3,3,16817,16817,16820,0,3,1
4786,6,3,16823,16823,16826,0,3,3
4787,4,1,16827,16827,16828,0,1,1
4788,2,3,16829,16829,16832,0,3,1
4789,6,3,16835,16835,16838,0,3,3
4790,4,3,16839,16839,16842,0,3,1
4791,1,2,16840,16842,16844,2,4,0
4792,5,2,16845,16845,16847,0,2,1
4793,1,1,16846,16847,16848,1,2,0
4794,2,2,16848,16848,16850,0,2,0
4795,4,3,16852,16852,16855,0,3,2
4796,6,2,16858,16858,16860,0,2,3
4797,1,3,16859,16860,16863,1,4,0
4798,1,2,16860,16863,16865,3,5,0
4799,3,1,16863,16865,16866,2,3,0
4800,1,2,16864,16866,16868,2,4,0
4801,5,1,16869,16869,16870,0,1,1
4802,1,3,16870,16870,16873,0,3,0
4803,2,2,16872,16873,16875,1,3,0
4804,4,1,16876,16876,16877,0,1,1
4805,4,1,16880,16880,16881,0,1,3
4806,1,2,16881,16881,16883,0,2,0
4807,4,1,16885,16885,16886,0,1,2
4808,1,3,16886,16886,16889,0,3,0
4809,3,3,16889,16889,16892,0,3,0
4810,6,3,16895,16895,16898,0,3,3
4811,1,2,16896,16898,16900,2,4,0
4812,5,3,16901,16901,16904,0,3,1
4813,5,3,16906,16906,16909,0,3,2
4814,4,1,16910,16910,16911,0,1,1
4815,1,3,16911,16911,16914,0,3,0
4816,1,3,16912,16914,16917,2,5,0
4817,2,3,16914,16917,16920,3,6,0
4818,2,2,16916,16920,16922,4,6,0
4819,3,2,16919,16922,16924,3,5,0
4820,2,1,16921,16924,16925,3,4,0
4821,1,3,16922,16925,16928,3,6,0
4822,1,3,16923,16928,16931,5,8,0
4823,3,3,16926,16931,16934,5,8,0
4824,2,3,16928,16934,16937,6,9,0
4825,1,2,16929,16937,16939,8,10,0
4826,4,3,16933,16939,16942,6,9,0
4827,2,3,16935,16942,16945,7,10,0
4828,5,1,16940,16945,16946,5,6,0
4829,6,3,16946,16946,16949,0,3,0
4830,3,3,16949,16949,16952,0,3,0
4831,5,1,16954,16954,16955,0,1,2
4832,1,3,16955,16955,16958,0,3,0
4833,4,3,16959,16959,16962,0,3,1
4834,5,3,16964,16964,16967,0,3,2
4835,2,3,16966,16967,16970,1,4,0
4836,1,2,16967,16970,16972,3,5,0
4837,6,2,16973,16973,16975,0,2,1
4838,2,3,16975,16975,16978,0,3,0
4839,6,2,16981,16981,16983,0,2,3
4840,5,2,16986,16986,16988,0,2,3
4841,6,1,16992,16992,16993,0,1,4
4842,4,2,16996,16996,16998,0,2,3
4843,3,3,16999,16999,17002,0,3,1
4844,3,2,17002,17002,17004,0,2,0
4845,1,2,17003,17004,17006,1,3,0
4846,1,3,17004,17006,17009,2,5,0
4847,2,1,17006,17009,17010,3,4,0
4848,1,2,17007,17010,17012,3,5,0
4849,4,2,17011,17012,17014,1,3,0
4850,6,3,17017,17017,17020,0,3,3
4851,4,2,17021,17021,17023,0,2,1
4852,4,2,17025,17025,17027,0,2,2
4853,5,3,17030,17030,17033,0,3,3
4854,4,2,17034,17034,17036,0,2,1
4855,2,1,17036,17036,17037,0,1,0
4856,2,1,17038,17038,17039,0,1,1
4857,5,2,17043,17043,17045,0,2,4
4858,5,3,17048,17048,17051,0,3,3
4859,5,1,17053,17053,17054,0,1,2
4860,5,3,17058,17058,17061,0,3,4
4861,2,3,17060,17061,17064,1,4,0
4862,5,3,17065,17065,17068,0,3,1
4863,2,3,17067,17068,17071,1,4,0
4864,2,2,17069,17071,17073,2,4,0
4865,3,1,17072,17073,17074,1,2,0
4866,3,2,17075,17075,17077,0,2,1
4867,1,2,17076,17077,17079,1,3,0
4868,6,1,17082,17082,17083,0,1,3
4869,2,1,17084,17084,17085,0,1,1
4870,3,3,17087,17087,17090,0,3,2
4871,1,1,17088,17090,17091,2,3,0
4872,2,2,17090,17091,17093,1,3,0
4873,5,3,17095,17095,17098,0,3,2
4874,6,1,17101,17101,17102,0,1,3
4875,5,3,17106,17106,17109,0,3,4
4876,3,3,17109,17109,17112,0,3,0
4877,3,1,17112,17112,17113,0,1,0
4878,6,1,17118,17118,17119,0,1,5
4879,2,1,17120,17120,17121,0,1,1
4880,4,1,17124,17124,17125,0,1,3
4881,3,1,17127,17127,17128,0,1,2
4882,3,2,17130,17130,17132,0,2,2
4883,3,1,17133,17133,17134,0,1,1
4884,5,1,17138,17138,17139,0,1,4
4885,6,1,17144,17144,17145,0,1,5
4886,6,2,17150,17150,17152,0,2,5
4887,2,3,17152,17152,17155,0,3,0
4888,6,2,17158,17158,17160,0,2,3
4889,1,3,17159,17160,17163,1,4,0
4890,5,3,17164,17164,17167,0,3,1
4891,3,1,17167,17167,17168,0,1,0
4892,5,3,17172,17172,17175,0,3,4
4893,2,1,17174,17175,17176,1,2,0
4894,2,2,17176,17176,17178,0,2,0
4895,6,2,17182,17182,17184,0,2,4
4896,2,1,17184,17184,17185,0,1,0
4897,2,2,17186,17186,17188,0,2,1
4898,4,3,17190,17190,17193,0,3,2
4899,3,3,17193,17193,17196,0,3,0
4900,4,2,17197,17197,17199,0,2,1
4901,5,1,17202,17202,17203,0,1,3
4902,2,2,17204,17204,17206,0,2,1
4903,6,1,17210,17210,17211,0,1,4
4904,5,1,17215,17215,17216,0,1,4
4905,5,3,17220,17220,17223,0,3,4
4906,4,2,17224,17224,17226,0,2,1
4907,5,2,17229,17229,17231,0,2,3
4908,3,1,17232,17232,17233,0,1,1
4909,4,2,17236,17236,17238,0,2,3
4910,5,2,17241,17241,17243,0,2,3
4911,4,3,17245,17245,17248,0,3,2
4912,4,3,17249,17249,17252,0,3,1
4913,3,2,17252,17252,17254,0,2,0
4914,4,1,17256,17256,17257,0,1,2
4915,5,1,17261,17261,17262,0,1,4
4916,2,3,17263,17263,17266,0,3,1
4917,6,3,17269,17269,17272,0,3,3
4918,2,2,17271,17272,17274,1,3,0
4919,2,2,17273,17274,17276,1,3,0
4920,2,3,17275,17276,17279,1,4,0
4921,2,1,17277,17279,17280,2,3,0
4922,5,2,17282,17282,17284,0,2,2
4923,5,3,17287,17287,17290,0,3,3
4924,4,1,17291,17291,17292,0,1,1
4925,1,1,17292,17292,17293,0,1,0
4926,3,3,17295,17295,17298,0,3,2
4927,2,3,17297,17298,17301,1,4,0
4928,1,3,17298,17301,17304,3,6,0
4929,2,2,17300,17304,17306,4,6,0
4930,3,2,17303,17306,17308,3,5,0
4931,6,3,17309,17309,17312,0,3,1
4932,2,1,17311,17312,17313,1,2,0
4933,5,2,17316,17316,17318,0,2,3
4934,5,2,17321,17321,17323,0,2,3
4935,6,2,17327,17327,17329,0,2,4
4936,3,1,17330,17330,17331,0,1,1
4937,4,1,17334,17334,17335,0,1,3
4938,3,1,17337,17337,17338,0,1,2
4939,5,3,17342,17342,17345,0,3,4
4940,1,3,17343,17345,17348,2,5,0
4941,5,2,17348,17348,17350,0,2,0
4942,2,1,17350,17350,17351,0,1,0
4943,4,2,17354,17354,17356,0,2,3
4944,3,1,17357,17357,17358,0,1,1
4945,4,2,17361,17361,17363,0,2,3
4946,1,3,17362,17363,17366,1,4,0
4947,3,1,17365,17366,17367,1,2,0
4948,5,3,17370,17370,17373,0,3,3
4949,6,1,17376,17376,17377,0,1,3
4950,1,3,17377,17377,17380,0,3,0
4951,2,1,17379,17380,17381,1,2,0
4952,3,3,17382,17382,17385,0,3,1
4953,4,2,17386,17386,17388,0,2,1
4954,6,1,17392,17392,17393,0,1,4
4955,3,3,17395,17395,17398,0,3,2
4956,5,1,17400,17400,17401,0,1,2
4957,3,2,17403,17403,17405,0,2,2
4958,3,2,17406,17406,17408,0,2,1
4959,1,2,17407,17408,17410,1,3,0
4960,3,2,17410,17410,17412,0,2,0
4961,2,3,17412,17412,17415,0,3,0
4962,5,1,17417,17417,17418,0,1,2
4963,5,3,17422,17422,17425,0,3,4
4964,2,2,17424,17425,17427,1,3,0
4965,3,1,17427,17427,17428,0,1,0
4966,4,3,17431,17431,17434,0,3,3
4967,4,2,17435,17435,17437,0,2,1
4968,2,2,17437,17437,17439,0,2,0
4969,1,3,17438,17439,17442,1,4,0
4970,4,2,17442,17442,17444,0,2,0
4971,4,1,17446,17446,17447,0,1,2
4972,2,1,17448,17448,17449,0,1,1
4973,5,1,17453,17453,17454,0,1,4
4974,3,3,17456,17456,17459,0,3,2
4975,6,2,17462,17462,17464,0,2,3
4976,5,3,17467,17467,17470,0,3,3
4977,1,2,17468,17470,17472,2,4,0
4978,1,3,17469,17472,17475,3,6,0
4979,3,3,17472,17475,17478,3,6,0
4980,2,3,17474,17478,17481,4,7,0
4981,4,1,17478,17481,17482,3,4,0
4982,1,2,17479,17482,17484,3,5,0
4983,4,2,17483,17484,17486,1,3,0
4984,4,2,17487,17487,17489,0,2,1
4985,2,3,17489,17489,17492,0,3,0
4986,6,3,17495,17495,17498,0,3,3
4987,4,1,17499,17499,17500,0,1,1
4988,1,1,17500,17500,17501,0,1,0
4989,2,3,17502,17502,17505,0,3,1
4990,2,2,17504,17505,17507,1,3,0
4991,5,3,17509,17509,17512,0,3,2
4992,1,1,17510,17512,17513,2,3,0
4993,6,2,17516,17516,17518,0,2,3
4994,3,1,17519,17519,17520,0,1,1
4995,5,2,17524,17524,17526,0,2,4
4996,2,3,17526,17526,17529,0,3,0
4997,1,2,17527,17529,17531,2,4,0
4998,4,3,17531,17531,17534,0,3,0
4999,3,1,17534,17534,17535,0,1,0
5000,1,2,17535,17535,17537,0,2,0
5001,1,2,17536,17537,17539,1,3,0
5002,5,1,17541,17541,17542,0,1,2
5003,3,3,17544,17544,17547,0,3,2
5004,5,2,17549,17549,17551,0,2,2
5005,3,2,17552,17552,17554,0,2,1
5006,1,1,17553,17554,17555,1,2,0
5007,2,1,17555,17555,17556,0,1,0
5008,5,1,17560,17560,17561,0,1,4
5009,6,1,17566,17566,17567,0,1,5
5010,1,2,17567,17567,17569,0,2,0
5011,5,3,17572,17572,17575,0,3,3
5012,6,1,17578,17578,17579,0,1,3
5013,3,2,17581,17581,17583,0,2,2
5014,3,2,17584,17584,17586,0,2,1
5015,3,2,17587,17587,17589,0,2,1
5016,4,3,17591,17591,17594,0,3,2
5017,4,3,17595,17595,17598,0,3,1
5018,3,1,17598,17598,17599,0,1,0
5019,3,1,17601,17601,17602,0,1,2
5020,3,2,17604,17604,17606,0,2,2
5021,6,2,17610,17610,17612,0,2,4
5022,2,2,17612,17612,17614,0,2,0
5023,6,2,17618,17618,17620,0,2,4
5024,2,2,17620,17620,17622,0,2,0
5025,6,1,17626,17626,17627,0,1,4
5026,3,2,17629,17629,17631,0,2,2
5027,3,2,17632,17632,17634,0,2,1
5028,5,1,17637,17637,17638,0,1,3
5029,6,3,17643,17643,17646,0,3,5
5030,3,2,17646,17646,17648,0,2,0
5031,3,3,17649,17649,17652,0,3,1
5032,5,3,17654,17654,17657,0,3,2
5033,2,2,17656,17657,17659,1,3,0
5034,2,2,17658,17659,17661,1,3,0
5035,5,2,17663,17663,17665,0,2,2
5036,5,1,17668,17668,17669,0,1,3
5037,1,1,17669,17669,17670,0,1,0
5038,1,2,17670,17670,17672,0,2,0
5039,6,1,17676,17676,17677,0,1,4
5040,5,3,17681,17681,17684,0,3,4
5041,6,1,17687,17687,17688,0,1,3
5042,3,3,17690,17690,17693,0,3,2
5043,2,2,17692,17693,17695,1,3,0
5044,5,1,17697,17697,17698,0,1,2
5045,3,2,17700,17700,17702,0,2,2
5046,6,2,17706,17706,17708,0,2,4
5047,5,2,17711,17711,17713,0,2,3
5048,3,2,17714,17714,17716,0,2,1
5049,1,2,17715,17716,17718,1,3,0
5050,2,3,17717,17718,17721,1,4,0
5051,2,2,17719,17721,17723,2,4,0
5052,6,3,17725,17725,17728,0,3,2
5053,6,1,17731,17731,17732,0,1,3
5054,6,1,17737,17737,17738,0,1,5
5055,4,1,17741,17741,17742,0,1,3
5056,5,2,17746,17746,17748,0,2,4
5057,5,1,17751,17751,17752,0,1,3
5058,1,1,17752,17752,17753,0,1,0
5059,4,2,17756,17756,17758,0,2,3
5060,3,1,17759,17759,17760,0,1,1
5061,2,3,17761,17761,17764,0,3,1
5062,5,2,17766,17766,17768,0,2,2
5063,6,2,17772,17772,17774,0,2,4
5064,5,1,17777,17777,17778,0,1,3
5065,4,1,17781,17781,17782,0,1,3
5066,5,1,17786,17786,17787,0,1,4
5067,4,2,17790,17790,17792,0,2,3
5068,3,3,17793,17793,17796,0,3,1
5069,3,2,17796,17796,17798,0,2,0
5070,5,2,17801,17801,17803,0,2,3
5071,5,2,17806,17806,17808,0,2,3
5072,2,2,17808,17808,17810,0,2,0
5073,2,3,17810,17810,17813,0,3,0
5074,4,1,17814,17814,17815,0,1,1
5075,5,1,17819,17819,17820,0,1,4
5076,2,1,17821,17821,17822,0,1,1
5077,1,1,17822,17822,17823,0,1,0
5078,3,3,17825,17825,17828,0,3,2
5079,2,3,17827,17828,17831,1,4,0
5080,6,3,17833,17833,17836,0,3,2
5081,1,3,17834,17836,17839,2,5,0
5082,1,3,17835,17839,17842,4,7,0
5083,3,2,17838,17842,17844,4,6,0
5084,5,3,17843,17844,17847,1,4,0
5085,1,2,17844,17847,17849,3,5,0
5086,5,2,17849,17849,17851,0,2,0
5087,3,3,17852,17852,17855,0,3,1
5088,5,1,17857,17857,17858,0,1,2
5089,1,3,17858,17858,17861,0,3,0
5090,4,2,17862,17862,17864,0,2,1
5091,4,2,17866,17866,17868,0,2,2
5092,5,1,17871,17871,17872,0,1,3
5093,1,1,17872,17872,17873,0,1,0
5094,2,1,17874,17874,17875,0,1,1
5095,1,3,17875,17875,17878,0,3,0
5096,2,2,17877,17878,17880,1,3,0
5097,5,3,17882,17882,17885,0,3,2
5098,6,2,17888,17888,17890,0,2,3
5099,4,2,17892,17892,17894,0,2,2
5100,2,3,17894,17894,17897,0,3,0
5101,2,2,17896,17897,17899,1,3,0
5102,2,3,17898,17899,17902,1,4,0
5103,6,2,17904,17904,17906,0,2,2
5104,4,2,17908,17908,17910,0,2,2
5105,1,3,17909,17910,17913,1,4,0
5106,1,1,17910,17913,17914,3,4,0
5107,5,2,17915,17915,17917,0,2,1
5108,2,3,17917,17917,17920,0,3,0
5109,5,2,17922,17922,17924,0,2,2
5110,3,2,17925,17925,17927,0,2,1
5111,3,1,17928,17928,17929,0,1,1
5112,1,2,17929,17929,17931,0,2,0
5113,4,2,17933,17933,17935,0,2,2
5114,4,2,17937,17937,17939,0,2,2
5115,3,2,17940,17940,17942,0,2,1
5116,1,2,17941,17942,17944,1,3,0
5117,1,3,17942,17944,17947,2,5,0
5118,6,2,17948,17948,17950,0,2,1
5119,3,2,17951,17951,17953,0,2,1
5120,1,1,17952,17953,17954,1,2,0
5121,5,2,17957,17957,17959,0,2,3
5122,5,1,17962,17962,17963,0,1,3
5123,2,2,17964,17964,17966,0,2,1
5124,6,1,17970,17970,17971,0,1,4
5125,6,3,17976,17976,17979,0,3,5
5126,4,3,17980,17980,17983,0,3,1
5127,3,3,17983,17983,17986,0,3,0
5128,1,1,17984,17986,17987,2,3,0
5129,2,1,17986,17987,17988,1,2,0
5130,5,2,17991,17991,17993,0,2,3
5131,5,3,17996,17996,17999,0,3,3
5132,4,3,18000,18000,18003,0,3,1
5133,6,1,18006,18006,18007,0,1,3
5134,2,2,18008,18008,18010,0,2,1
5135,5,1,18013,18013,18014,0,1,3
5136,4,3,18017,18017,18020,0,3,3
5137,5,2,18022,18022,18024,0,2,2
5138,2,3,18024,18024,18027,0,3,0
5139,4,2,18028,18028,18030,0,2,1
5140,2,1,18030,18030,18031,0,1,0
5141,4,2,18034,18034,18036,0,2,3
5142,3,3,18037,18037,18040,0,3,1
5143,4,1,18041,18041,18042,0,1,1
5144,3,3,18044,18044,18047,0,3,2
5145,1,1,18045,18047,18048,2,3,0
5146,5,2,18050,18050,18052,0,2,2
5147,1,3,18051,18052,18055,1,4,0
5148,3,3,18054,18055,18058,1,4,0
5149,3,1,18057,18058,18059,1,2,0
5150,6,2,18063,18063,18065,0,2,4
5151,2,1,18065,18065,18066,0,1,0
5152,4,3,18069,18069,18072,0,3,3
5153,2,3,18071,18072,18075,1,4,0
5154,4,2,18075,18075,18077,0,2,0
5155,2,2,18077,18077,18079,0,2,0
5156,6,1,18083,18083,18084,0,1,4
5157,1,1,18084,18084,18085,0,1,0
5158,3,1,18087,18087,18088,0,1,2
5159,4,3,18091,18091,18094,0,3,3
5160,6,3,18097,18097,18100,0,3,3
5161,6,1,18103,18103,18104,0,1,3
5162,6,2,18109,18109,18111,0,2,5
5163,3,1,18112,18112,18113,0,1,1
5164,5,3,18117,18117,18120,0,3,4
5165,2,2,18119,18120,18122,1,3,0
5166,3,3,18122,18122,18125,0,3,0
5167,4,2,18126,18126,18128,0,2,1
5168,6,2,18132,18132,18134,0,2,4
5169,5,3,18137,18137,18140,0,3,3
5170,4,1,18141,18141,18142,0,1,1
5171,1,3,18142,18142,18145,0,3,0
5172,6,1,18148,18148,18149,0,1,3
5173,1,2,18149,18149,18151,0,2,0
5174,1,2,18150,18151,18153,1,3,0
5175,4,2,18154,18154,18156,0,2,1
5176,6,1,18160,18160,18161,0,1,4
5177,1,1,18161,18161,18162,0,1,0
5178,2,3,18163,18163,18166,0,3,1
5179,6,3,18169,18169,18172,0,3,3
5180,4,1,18173,18173,18174,0,1,1
5181,6,1,18179,18179,18180,0,1,5
5182,2,1,18181,18181,18182,0,1,1
5183,3,3,18184,18184,18187,0,3,2
5184,3,1,18187,18187,18188,0,1,0
5185,1,2,18188,18188,18190,0,2,0
5186,6,1,18194,18194,18195,0,1,4
5187,5,3,18199,18199,18202,0,3,4
5188,1,1,18200,18202,18203,2,3,0
5189,3,1,18203,18203,18204,0,1,0
5190,1,3,18204,18204,18207,0,3,0
5191,6,3,18210,18210,18213,0,3,3
5192,6,3,18216,18216,18219,0,3,3
5193,5,3,18221,18221,18224,0,3,2
5194,3,2,18224,18224,18226,0,2,0
5195,4,3,18228,18228,18231,0,3,2
5196,3,2,18231,18231,18233,0,2,0
5197,6,3,18237,18237,18240,0,3,4
5198,3,2,18240,18240,18242,0,2,0
5199,6,2,18246,18246,18248,0,2,4
5200,1,1,18247,18248,18249,1,2,0
5201,2,1,18249,18249,18250,0,1,0
5202,5,3,18254,18254,18257,0,3,4
5203,2,2,18256,18257,18259,1,3,0
5204,2,2,18258,18259,18261,1,3,0
5205,1,1,18259,18261,18262,2,3,0
5206,4,3,18263,18263,18266,0,3,1
5207,2,3,18265,18266,18269,1,4,0
5208,5,2,18270,18270,18272,0,2,1
5209,5,3,18275,18275,18278,0,3,3
5210,2,2,18277,18278,18280,1,3,0
5211,2,2,18279,18280,18282,1,3,0
5212,6,2,18285,18285,18287,0,2,3
5213,6,3,18291,18291,18294,0,3,4
5214,3,1,18294,18294,18295,0,1,0
5215,4,2,18298,18298,18300,0,2,3
5216,4,2,18302,18302,18304,0,2,2
5217,4,2,18306,18306,18308,0,2,2
5218,1,2,18307,18308,18310,1,3,0
5219,1,3,18308,18310,18313,2,5,0
5220,1,3,18309,18313,18316,4,7,0
5221,4,2,18313,18316,18318,3,5,0
5222,3,3,18316,18318,18321,2,5,0
5223,1,3,18317,18321,18324,4,7,0
5224,4,3,18321,18324,18327,3,6,0
5225,6,3,18327,18327,18330,0,3,0
5226,4,3,18331,18331,18334,0,3,1
5227,4,2,18335,18335,18337,0,2,1
5228,2,3,18337,18337,18340,0,3,0
5229,6,1,18343,18343,18344,0,1,3
5230,2,2,18345,18345,18347,0,2,1
5231,1,1,18346,18347,18348,1,2,0
5232,2,3,18348,18348,18351,0,3,0
5233,3,3,18351,18351,18354,0,3,0
5234,2,3,18353,18354,18357,1,4,0
5235,1,3,18354,18357,18360,3,6,0
5236,2,2,18356,18360,18362,4,6,0
5237,6,2,18362,18362,18364,0,2,0
5238,2,3,18364,18364,18367,0,3,0
5239,4,1,18368,18368,18369,0,1,1
5240,6,2,18374,18374,18376,0,2,5
5241,3,3,18377,18377,18380,0,3,1
5242,3,2,18380,18380,18382,0,2,0
5243,5,2,18385,18385,18387,0,2,3
5244,3,3,18388,18388,18391,0,3,1
5245,3,3,18391,18391,18394,0,3,0
5246,6,2,18397,18397,18399,0,2,3
5247,3,3,18400,18400,18403,0,3,1
5248,2,1,18402,18403,18404,1,2,0
5249,3,2,18405,18405,18407,0,2,1
5250,1,1,18406,18407,18408,1,2,0
5251,4,3,18410,18410,18413,0,3,2
5252,2,1,18412,18413,18414,1,2,0
5253,1,2,18413,18414,18416,1,3,0
5254,3,1,18416,18416,18417,0,1,0
5255,5,1,18421,18421,18422,0,1,4
5256,6,3,18427,18427,18430,0,3,5
5257,5,1,18432,18432,18433,0,1,2
5258,2,3,18434,18434,18437,0,3,1
5259,4,3,18438,18438,18441,0,3,1
5260,3,1,18441,18441,18442,0,1,0
5261,5,3,18446,18446,18449,0,3,4
5262,4,3,18450,18450,18453,0,3,1
5263,4,3,18454,18454,18457,0,3,1
5264,2,2,18456,18457,18459,1,3,0
5265,2,3,18458,18459,18462,1,4,0
5266,6,3,18464,18464,18467,0,3,2
5267,5,1,18469,18469,18470,0,1,2
5268,3,2,18472,18472,18474,0,2,2
5269,2,3,18474,18474,18477,0,3,0
5270,4,2,18478,18478,18480,0,2,1
5271,6,2,18484,18484,18486,0,2,4
5272,1,2,18485,18486,18488,1,3,0
5273,4,3,18489,18489,18492,0,3,1
5274,4,1,18493,18493,18494,0,1,1
5275,6,1,18499,18499,18500,0,1,5
5276,2,2,18501,18501,18503,0,2,1
5277,5,2,18506,18506,18508,0,2,3
5278,4,3,18510,18510,18513,0,3,2
5279,2,2,18512,18513,18515,1,3,0
5280,3,3,18515,18515,18518,0,3,0
5281,5,2,18520,18520,18522,0,2,2
5282,2,2,18522,18522,18524,0,2,0
5283,2,2,18524,18524,18526,0,2,0
5284,4,3,18528,18528,18531,0,3,2
5285,4,2,18532,18532,18534,0,2,1
5286,1,2,18533,18534,18536,1,3,0
5287,3,1,18536,18536,18537,0,1,0
5288,6,2,18542,18542,18544,0,2,5
5289,1,1,18543,18544,18545,1,2,0
5290,3,3,18546,18546,18549,0,3,1
5291,2,1,18548,18549,18550,1,2,0
5292,1,3,18549,18550,18553,1,4,0
5293,2,1,18551,18553,18554,2,3,0
5294,5,1,18556,18556,18557,0,1,2
5295,6,2,18562,18562,18564,0,2,5
5296,4,3,18566,18566,18569,0,3,2
5297,1,2,18567,18569,18571,2,4,0
5298,4,3,18571,18571,18574,0,3,0
5299,6,1,18577,18577,18578,0,1,3
5300,1,3,18578,18578,18581,0,3,0
5301,1,1,18579,18581,18582,2,3,0
5302,6,3,18585,18585,18588,0,3,3
5303,3,3,18588,18588,18591,0,3,0
5304,4,3,18592,18592,18595,0,3,1
5305,4,3,18596,18596,18599,0,3,1
5306,5,1,18601,18601,18602,0,1,2
5307,4,2,18605,18605,18607,0,2,3
5308,4,2,18609,18609,18611,0,2,2
5309,1,3,18610,18611,18614,1,4,0
5310,6,2,18616,18616,18618,0,2,2
5311,4,1,18620,18620,18621,0,1,2
5312,6,2,18626,18626,18628,0,2,5
5313,5,3,18631,18631,18634,0,3,3
5314,5,3,18636,18636,18639,0,3,2
5315,4,2,18640,18640,18642,0,2,1
5316,1,1,18641,18642,18643,1,2,0
5317,3,2,18644,18644,18646,0,2,1
5318,2,3,18646,18646,18649,0,3,0
5319,3,3,18649,18649,18652,0,3,0
5320,4,2,18653,18653,18655,0,2,1
5321,4,2,18657,18657,18659,0,2,2
5322,6,3,18663,18663,18666,0,3,4
5323,4,3,18667,18667,18670,0,3,1
5324,6,2,18673,18673,18675,0,2,3
5325,4,1,18677,18677,18678,0,1,2
5326,5,1,18682,18682,18683,0,1,4
5327,4,3,18686,18686,18689,0,3,3
5328,5,3,18691,18691,18694,0,3,2
5329,4,1,18695,18695,18696,0,1,1
5330,1,1,18696,18696,18697,0,1,0
5331,4,1,18700,18700,18701,0,1,3
5332,3,1,18703,18703,18704,0,1,2
5333,3,3,18706,18706,18709,0,3,2
5334,1,3,18707,18709,18712,2,5,0
5335,5,2,18712,18712,18714,0,2,0
5336,2,1,18714,18714,18715,0,1,0
5337,4,2,18718,18718,18720,0,2,3
5338,5,1,18723,18723,18724,0,1,3
5339,1,2,18724,18724,18726,0,2,0
5340,6,3,18730,18730,18733,0,3,4
5341,1,2,18731,18733,18735,2,4,0
5342,1,2,18732,18735,18737,3,5,0
5343,6,1,18738,18738,18739,0,1,1
5344,6,1,18744,18744,18745,0,1,5
5345,4,2,18748,18748,18750,0,2,3
5346,5,2,18753,18753,18755,0,2,3
5347,4,2,18757,18757,18759,0,2,2
5348,1,2,18758,18759,18761,1,3,0
5349,1,2,18759,18761,18763,2,4,0
5350,5,2,18764,18764,18766,0,2,1
5351,4,2,18768,18768,18770,0,2,2
5352,5,1,18773,18773,18774,0,1,3
5353,4,3,18777,18777,18780,0,3,3
5354,3,1,18780,18780,18781,0,1,0
5355,1,1,18781,18781,18782,0,1,0
5356,4,1,18785,18785,18786,0,1,3
5357,6,2,18791,18791,18793,0,2,5
5358,4,2,18795,18795,18797,0,2,2
5359,2,3,18797,18797,18800,0,3,0
5360,4,3,18801,18801,18804,0,3,1
5361,2,1,18803,18804,18805,1,2,0
5362,1,2,18804,18805,18807,1,3,0
5363,5,3,18809,18809,18812,0,3,2
5364,2,3,18811,18812,18815,1,4,0
5365,5,2,18816,18816,18818,0,2,1
5366,6,3,18822,18822,18825,0,3,4
5367,3,2,18825,18825,18827,0,2,0
5368,2,2,18827,18827,18829,0,2,0
5369,3,1,18830,18830,18831,0,1,1
5370,4,1,18834,18834,18835,0,1,3
5371,2,2,18836,18836,18838,0,2,1
5372,6,2,18842,18842,18844,0,2,4
5373,1,3,18843,18844,18847,1,4,0
5374,6,1,18849,18849,18850,0,1,2
5375,3,2,18852,18852,18854,0,2,2
5376,4,1,18856,18856,18857,0,1,2
5377,5,3,18861,18861,18864,0,3,4
5378,2,1,18863,18864,18865,1,2,0
5379,2,3,18865,18865,18868,0,3,0
5380,5,2,18870,18870,18872,0,2,2
5381,1,1,18871,18872,18873,1,2,0
5382,3,1,18874,18874,18875,0,1,1
5383,3,2,18877,18877,18879,0,2,2
5384,5,3,18882,18882,18885,0,3,3
5385,3,1,18885,18885,18886,0,1,0
5386,6,1,18891,18891,18892,0,1,5
5387,5,3,18896,18896,18899,0,3,4
5388,5,3,18901,18901,18904,0,3,2
5389,5,1,18906,18906,18907,0,1,2
5390,3,1,18909,18909,18910,0,1,2
5391,3,3,18912,18912,18915,0,3,2
5392,6,1,18918,18918,18919,0,1,3
5393,5,1,18923,18923,18924,0,1,4
5394,3,2,18926,18926,18928,0,2,2
5395,3,1,18929,18929,18930,0,1,1
5396,4,2,18933,18933,18935,0,2,3
5397,5,3,18938,18938,18941,0,3,3
5398,3,2,18941,18941,18943,0,2,0
5399,5,2,18946,18946,18948,0,2,3
5400,3,2,18949,18949,18951,0,2,1
5401,2,1,18951,18951,18952,0,1,0
5402,2,1,18953,18953,18954,0,1,1
5403,6,2,18959,18959,18961,0,2,5
5404,4,3,18963,18963,18966,0,3,2
5405,6,2,18969,18969,18971,0,2,3
5406,6,1,18975,18975,18976,0,1,4
5407,5,3,18980,18980,18983,0,3,4
5408,6,3,18986,18986,18989,0,3,3
5409,6,3,18992,18992,18995,0,3,3
5410,1,1,18993,18995,18996,2,3,0
5411,5,2,18998,18998,19000,0,2,2
5412,2,3,19000,19000,19003,0,3,0
5413,6,3,19006,19006,19009,0,3,3
5414,5,1,19011,19011,19012,0,1,2
5415,4,2,19015,19015,19017,0,2,3
5416,6,3,19021,19021,19024,0,3,4
5417,4,1,19025,19025,19026,0,1,1
5418,5,2,19030,19030,19032,0,2,4
5419,5,2,19035,19035,19037,0,2,3
5420,5,2,19040,19040,19042,0,2,3
5421,4,1,19044,19044,19045,0,1,2
5422,5,1,19049,19049,19050,0,1,4
5423,6,3,19055,19055,19058,0,3,5
5424,2,2,19057,19058,19060,1,3,0
5425,4,1,19061,19061,19062,0,1,1
5426,6,3,19067,19067,19070,0,3,5
5427,6,1,19073,19073,19074,0,1,3
5428,1,2,19074,19074,19076,0,2,0
5429,6,2,19080,19080,19082,0,2,4
5430,6,1,19086,19086,19087,0,1,4
5431,1,2,19087,19087,19089,0,2,0
5432,4,3,19091,19091,19094,0,3,2
5433,3,2,19094,19094,19096,0,2,0
5434,1,3,19095,19096,19099,1,4,0
5435,6,1,19101,19101,19102,0,1,2
5436,6,2,19107,19107,19109,0,2,5
5437,3,1,19110,19110,19111,0,1,1
5438,1,3,19111,19111,19114,0,3,0
5439,3,2,19114,19114,19116,0,2,0
5440,6,2,19120,19120,19122,0,2,4
5441,2,1,19122,19122,19123,0,1,0
5442,3,2,19125,19125,19127,0,2,2
5443,6,1,19131,19131,19132,0,1,4
5444,3,2,19134,19134,19136,0,2,2
5445,2,3,19136,19136,19139,0,3,0
5446,1,3,19137,19139,19142,2,5,0
5447,5,2,19142,19142,19144,0,2,0
5448,4,2,19146,19146,19148,0,2,2
5449,6,2,19152,19152,19154,0,2,4
5450,4,2,19156,19156,19158,0,2,2
5451,1,2,19157,19158,19160,1,3,0
5452,1,3,19158,19160,19163,2,5,0
5453,4,1,19162,19163,19164,1,2,0
5454,3,2,19165,19165,19167,0,2,1
5455,3,1,19168,19168,19169,0,1,1
5456,2,3,19170,19170,19173,0,3,1
5457,4,3,19174,19174,19177,0,3,1
5458,6,1,19180,19180,19181,0,1,3
5459,1,2,19181,19181,19183,0,2,0
5460,6,3,19187,19187,19190,0,3,4
5461,3,3,19190,19190,19193,0,3,0
5462,5,1,19195,19195,19196,0,1,2
5463,3,3,19198,19198,19201,0,3,2
5464,3,1,19201,19201,19202,0,1,0
5465,6,2,19207,19207,19209,0,2,5
5466,3,2,19210,19210,19212,0,2,1
5467,2,1,19212,19212,19213,0,1,0
5468,5,2,19217,19217,19219,0,2,4
5469,6,2,19223,19223,19225,0,2,4
5470,3,3,19226,19226,19229,0,3,1
5471,3,2,19229,19229,19231,0,2,0
5472,2,3,19231,19231,19234,0,3,0
5473,1,3,19232,19234,19237,2,5,0
5474,4,3,19236,19237,19240,1,4,0
5475,3,1,19239,19240,19241,1,2,0
5476,4,3,19243,19243,19246,0,3,2
5477,6,3,19249,19249,19252,0,3,3
5478,5,1,19254,19254,19255,0,1,2
5479,4,2,19258,19258,19260,0,2,3
5480,6,2,19264,19264,19266,0,2,4
5481,4,2,19268,19268,19270,0,2,2
5482,3,3,19271,19271,19274,0,3,1
5483,6,2,19277,19277,19279,0,2,3
5484,2,2,19279,19279,19281,0,2,0
5485,5,2,19284,19284,19286,0,2,3
5486,3,1,19287,19287,19288,0,1,1
5487,3,3,19290,19290,19293,0,3,2
5488,5,2,19295,19295,19297,0,2,2
5489,6,1,19301,19301,19302,0,1,4
5490,1,3,19302,19302,19305,0,3,0
5491,3,3,19305,19305,19308,0,3,0
5492,2,2,19307,19308,19310,1,3,0
5493,3,3,19310,19310,19313,0,3,0
5494,4,1,19314,19314,19315,0,1,1
5495,1,3,19315,19315,19318,0,3,0
5496,4,2,19319,19319,19321,0,2,1
5497,4,1,19323,19323,19324,0,1,2
5498,2,2,19325,19325,19327,0,2,1
5499,1,2,19326,19327,19329,1,3,0
5500,2,2,19328,19329,19331,1,3,0
5501,6,3,19334,19334,19337,0,3,3
5502,3,2,19337,19337,19339,0,2,0
5503,2,3,19339,19339,19342,0,3,0
5504,5,1,19344,19344,19345,0,1,2
5505,5,2,19349,19349,19351,0,2,4
5506,5,1,19354,19354,19355,0,1,3
5507,2,1,19356,19356,19357,0,1,1
5508,4,2,19360,19360,19362,0,2,3
5509,6,1,19366,19366,19367,0,1,4
5510,3,3,19369,19369,19372,0,3,2
5511,3,2,19372,19372,19374,0,2,0
5512,4,2,19376,19376,19378,0,2,2
5513,3,3,19379,19379,19382,0,3,1
5514,1,2,19380,19382,19384,2,4,0
5515,5,1,19385,19385,19386,0,1,1
5516,4,1,19389,19389,19390,0,1,3
5517,2,1,19391,19391,19392,0,1,1
5518,1,2,19392,19392,19394,0,2,0
5519,2,3,19394,19394,19397,0,3,0
5520,1,3,19395,19397,19400,2,5,0
5521,4,3,19399,19400,19403,1,4,0
5522,6,3,19405,19405,19408,0,3,2
5523,5,2,19410,19410,19412,0,2,2
5524,5,1,19415,19415,19416,0,1,3
5525,4,1,19419,19419,19420,0,1,3
5526,2,3,19421,19421,19424,0,3,1
5527,6,1,19427,19427,19428,0,1,3
5528,3,2,19430,19430,19432,0,2,2
5529,2,2,19432,19432,19434,0,2,0
5530,5,3,19437,19437,19440,0,3,3
5531,3,1,19440,19440,19441,0,1,0
5532,4,3,19444,19444,19447,0,3,3
5533,4,2,19448,19448,19450,0,2,1
5534,2,2,19450,19450,19452,0,2,0
5535,1,2,19451,19452,19454,1,3,0
5536,1,1,19452,19454,19455,2,3,0
5537,2,1,19454,19455,19456,1,2,0
5538,1,3,19455,19456,19459,1,4,0
5539,2,2,19457,19459,19461,2,4,0
5540,4,2,19461,19461,19463,0,2,0
5541,1,2,19462,19463,19465,1,3,0
5542,3,2,19465,19465,19467,0,2,0
5543,1,2,19466,19467,19469,1,3,0
5544,6,3,19472,19472,19475,0,3,3
5545,5,1,19477,19477,19478,0,1,2
5546,5,3,19482,19482,19485,0,3,4
5547,3,1,19485,19485,19486,0,1,0
5548,1,1,19486,19486,19487,0,1,0
5549,6,2,19492,19492,19494,0,2,5
5550,5,2,19497,19497,19499,0,2,3
5551,1,3,19498,19499,19502,1,4,0
5552,3,1,19501,19502,19503,1,2,0
5553,5,1,19506,19506,19507,0,1,3
5554,5,1,19511,19511,19512,0,1,4
5555,2,1,19513,19513,19514,0,1,1
5556,2,3,19515,19515,19518,0,3,1
5557,3,1,19518,19518,19519,0,1,0
5558,2,2,19520,19520,19522,0,2,1
5559,3,1,19523,19523,19524,0,1,1
5560,3,1,19526,19526,19527,0,1,2
5561,5,3,19531,19531,19534,0,3,4
5562,4,1,19535,19535,19536,0,1,1
5563,4,3,19539,19539,19542,0,3,3
5564,1,2,19540,19542,19544,2,4,0
5565,2,1,19542,19544,19545,2,3,0
5566,6,3,19548,19548,19551,0,3,3
5567,6,1,19554,19554,19555,0,1,3
5568,4,1,19558,19558,19559,0,1,3
5569,2,3,19560,19560,19563,0,3,1
5570,6,3,19566,19566,19569,0,3,3
5571,4,2,19570,19570,19572,0,2,1
5572,5,2,19575,19575,19577,0,2,3
5573,2,2,19577,19577,19579,0,2,0
5574,1,1,19578,19579,19580,1,2,0
5575,3,2,19581,19581,19583,0,2,1
5576,5,2,19586,19586,19588,0,2,3
5577,4,1,19590,19590,19591,0,1,2
5578,5,3,19595,19595,19598,0,3,4
5579,4,3,19599,19599,19602,0,3,1
5580,5,3,19604,19604,19607,0,3,2
5581,3,2,19607,19607,19609,0,2,0
5582,2,1,19609,19609,19610,0,1,0
5583,4,1,19613,19613,19614,0,1,3
5584,5,2,19618,19618,19620,0,2,4
5585,5,3,19623,19623,19626,0,3,3
5586,2,2,19625,19626,19628,1,3,0
5587,4,1,19629,19629,19630,0,1,1
5588,1,1,19630,19630,19631,0,1,0
5589,1,2,19631,19631,19633,0,2,0
5590,4,1,19635,19635,19636,0,1,2
5591,1,2,19636,19636,19638,0,2,0
5592,6,1,19642,19642,19643,0,1,4
5593,4,3,19646,19646,19649,0,3,3
5594,3,2,19649,19649,19651,0,2,0
5595,3,2,19652,19652,19654,0,2,1
5596,2,2,19654,19654,19656,0,2,0
5597,6,1,19660,19660,19661,0,1,4
5598,4,1,19664,19664,19665,0,1,3
5599,4,1,19668,19668,19669,0,1,3
5600,5,1,19673,19673,19674,0,1,4
5601,3,2,19676,19676,19678,0,2,2
5602,1,1,19677,19678,19679,1,2,0
5603,6,3,19683,19683,19686,0,3,4
5604,3,1,19686,19686,19687,0,1,0
5605,5,2,19691,19691,19693,0,2,4
5606,6,1,19697,19697,19698,0,1,4
5607,6,1,19703,19703,19704,0,1,5
5608,4,3,19707,19707,19710,0,3,3
5609,5,2,19712,19712,19714,0,2,2
5610,2,3,19714,19714,19717,0,3,0
5611,4,3,19718,19718,19721,0,3,1
5612,5,2,19723,19723,19725,0,2,2
5613,5,2,19728,19728,19730,0,2,3
5614,5,3,19733,19733,19736,0,3,3
5615,1,2,19734,19736,19738,2,4,0
5616,5,3,19739,19739,19742,0,3,1
5617,3,2,19742,19742,19744,0,2,0
5618,4,3,19746,19746,19749,0,3,2
5619,4,3,19750,19750,19753,0,3,1
5620,3,3,19753,19753,19756,0,3,0
5621,6,3,19759,19759,19762,0,3,3
5622,4,1,19763,19763,19764,0,1,1
5623,6,3,19769,19769,19772,0,3,5
5624,4,1,19773,19773,19774,0,1,1
5625,6,1,19779,19779,19780,0,1,5
5626,5,3,19784,19784,19787,0,3,4
5627,2,1,19786,19787,19788,1,2,0
5628,4,2,19790,19790,19792,0,2,2
5629,1,3,19791,19792,19795,1,4,0
5630,2,3,19793,19795,19798,2,5,0
5631,1,1,19794,19798,19799,4,5,0
5632,3,1,19797,19799,19800,2,3,0
5633,6,2,19803,19803,19805,0,2,3
5634,1,3,19804,19805,19808,1,4,0
5635,1,3,19805,19808,19811,3,6,0
5636,2,3,19807,19811,19814,4,7,0
5637,1,2,19808,19814,19816,6,8,0
5638,5,2,19813,19816,19818,3,5,0
5639,5,2,19818,19818,19820,0,2,0
5640,2,3,19820,19820,19823,0,3,0
5641,3,3,19823,19823,19826,0,3,0
5642,4,1,19827,19827,19828,0,1,1
5643,1,1,19828,19828,19829,0,1,0
5644,3,1,19831,19831,19832,0,1,2
5645,1,3,19832,19832,19835,0,3,0
5646,3,2,19835,19835,19837,0,2,0
5647,6,3,19841,19841,19844,0,3,4
5648,1,3,19842,19844,19847,2,5,0
5649,6,3,19848,19848,19851,0,3,1
5650,2,3,19850,19851,19854,1,4,0
5651,5,3,19855,19855,19858,0,3,1
5652,4,2,19859,19859,19861,0,2,1
5653,4,1,19863,19863,19864,0,1,2
5654,6,2,19869,19869,19871,0,2,5
5655,1,1,19870,19871,19872,1,2,0
5656,1,2,19871,19872,19874,1,3,0
5657,1,3,19872,19874,19877,2,5,0
5658,4,2,19876,19877,19879,1,3,0
5659,2,1,19878,19879,19880,1,2,0
5660,5,2,19883,19883,19885,0,2,3
5661,5,2,19888,19888,19890,0,2,3
5662,2,1,19890,19890,19891,0,1,0
5663,3,3,19893,19893,19896,0,3,2
5664,2,2,19895,19896,19898,1,3,0
5665,1,3,19896,19898,19901,2,5,0
5666,1,3,19897,19901,19904,4,7,0
5667,1,3,19898,19904,19907,6,9,0
5668,1,2,19899,19907,19909,8,10,0
5669,1,2,19900,19909,19911,9,11,0
5670,2,3,19902,19911,19914,9,12,0
5671,5,3,19907,19914,19917,7,10,0
5672,3,3,19910,19917,19920,7,10,0
5673,6,2,19916,19920,19922,4,6,0
5674,2,2,19918,19922,19924,4,6,0
5675,1,1,19919,19924,19925,5,6,0
5676,4,1,19923,19925,19926,2,3,0
5677,3,3,19926,19926,19929,0,3,0
5678,1,3,19927,19929,19932,2,5,0
5679,3,1,19930,19932,19933,2,3,0
5680,5,1,19935,19935,19936,0,1,2
5681,1,1,19936,19936,19937,0,1,0
5682,1,2,19937,19937,19939,0,2,0
5683,4,3,19941,19941,19944,0,3,2
5684,2,1,19943,19944,19945,1,2,0
5685,5,2,19948,19948,19950,0,2,3
5686,6,3,19954,19954,19957,0,3,4
5687,3,3,19957,19957,19960,0,3,0
5688,2,1,19959,19960,19961,1,2,0
5689,4,1,19963,19963,19964,0,1,2
5690,3,2,19966,19966,19968,0,2,2
5691,4,2,19970,19970,19972,0,2,2
5692,3,2,19973,19973,19975,0,2,1
5693,2,1,19975,19975,19976,0,1,0
5694,6,1,19981,19981,19982,0,1,5
5695,2,2,19983,19983,19985,0,2,1
5696,5,3,19988,19988,19991,0,3,3
5697,3,1,19991,19991,19992,0,1,0
5698,3,1,19994,19994,19995,0,1,2
5699,3,3,19997,19997,20000,0,3,2
5700,2,1,19999,20000,20001,1,2,0
5701,5,1,20004,20004,20005,0,1,3
5702,1,1,20005,20005,20006,0,1,0
5703,3,2,20008,20008,20010,0,2,2
5704,4,2,20012,20012,20014,0,2,2
5705,2,3,20014,20014,20017,0,3,0
5706,2,1,20016,20017,20018,1,2,0
5707,1,2,20017,20018,20020,1,3,0
5708,2,3,20019,20020,20023,1,4,0
5709,3,3,20022,20023,20026,1,4,0
5710,1,3,20023,20026,20029,3,6,0
5711,1,2,20024,20029,20031,5,7,0
5712,1,3,20025,20031,20034,6,9,0
5713,5,3,20030,20034,20037,4,7,0
5714,3,2,20033,20037,20039,4,6,0
5715,1,2,20034,20039,20041,5,7,0
5716,4,3,20038,20041,20044,3,6,0
5717,2,3,20040,20044,20047,4,7,0
5718,1,3,20041,20047,20050,6,9,0
5719,2,3,20043,20050,20053,7,10,0
5720,1,2,20044,20053,20055,9,11,0
5721,5,2,20049,20055,20057,6,8,0
5722,5,1,20054,20057,20058,3,4,0
5723,4,2,20058,20058,20060,0,2,0
5724,3,1,20061,20061,20062,0,1,1
5725,2,3,20063,20063,20066,0,3,1
5726,5,1,20068,20068,20069,0,1,2
5727,4,2,20072,20072,20074,0,2,3
5728,4,1,20076,20076,20077,0,1,2
5729,3,1,20079,20079,20080,0,1,2
5730,6,1,20085,20085,20086,0,1,5
5731,6,3,20091,20091,20094,0,3,5
5732,3,1,20094,20094,20095,0,1,0
5733,2,2,20096,20096,20098,0,2,1
5734,1,1,20097,20098,20099,1,2,0
5735,4,1,20101,20101,20102,0,1,2
5736,3,3,20104,20104,20107,0,3,2
5737,6,2,20110,20110,20112,0,2,3
5738,2,2,20112,20112,20114,0,2,0
5739,2,2,20114,20114,20116,0,2,0
5740,6,3,20120,20120,20123,0,3,4
5741,2,1,20122,20123,20124,1,2,0
5742,2,2,20124,20124,20126,0,2,0
5743,6,2,20130,20130,20132,0,2,4
5744,6,2,20136,20136,20138,0,2,4
5745,2,1,20138,20138,20139,0,1,0
5746,6,1,20144,20144,20145,0,1,5
5747,5,1,20149,20149,20150,0,1,4
5748,1,2,20150,20150,20152,0,2,0
5749,2,1,20152,20152,20153,0,1,0
5750,1,1,20153,20153,20154,0,1,0
5751,2,2,20155,20155,20157,0,2,1
5752,1,3,20156,20157,20160,1,4,0
5753,1,2,20157,20160,20162,3,5,0
5754,5,2,20162,20162,20164,0,2,0
5755,3,3,20165,20165,20168,0,3,1
5756,3,3,20168,20168,20171,0,3,0
5757,2,1,20170,20171,20172,1,2,0
5758,3,1,20173,20173,20174,0,1,1
5759,5,3,20178,20178,20181,0,3,4
5760,6,2,20184,20184,20186,0,2,3
5761,6,1,20190,20190,20191,0,1,4
5762,6,3,20196,20196,20199,0,3,5
5763,2,3,20198,20199,20202,1,4,0
5764,5,1,20203,20203,20204,0,1,1
5765,3,1,20206,20206,20207,0,1,2
5766,2,1,20208,20208,20209,0,1,1
5767,1,2,20209,20209,20211,0,2,0
5768,6,1,20215,20215,20216,0,1,4
5769,3,3,20218,20218,20221,0,3,2
5770,2,2,20220,20221,20223,1,3,0
5771,6,3,20226,20226,20229,0,3,3
5772,4,2,20230,20230,20232,0,2,1
5773,3,1,20233,20233,20234,0,1,1
5774,4,3,20237,20237,20240,0,3,3
5775,6,3,20243,20243,20246,0,3,3
5776,1,3,20244,20246,20249,2,5,0
5777,4,1,20248,20249,20250,1,2,0
5778,3,1,20251,20251,20252,0,1,1
5779,5,1,20256,20256,20257,0,1,4
5780,4,1,20260,20260,20261,0,1,3
5781,5,2,20265,20265,20267,0,2,4
5782,1,2,20266,20267,20269,1,3,0
5783,1,1,20267,20269,20270,2,3,0
5784,6,1,20273,20273,20274,0,1,3
5785,5,1,20278,20278,20279,0,1,4
5786,2,1,20280,20280,20281,0,1,1
5787,6,3,20286,20286,20289,0,3,5
5788,4,3,20290,20290,20293,0,3,1
5789,4,1,20294,20294,20295,0,1,1
5790,6,1,20300,20300,20301,0,1,5
5791,4,1,20304,20304,20305,0,1,3
5792,3,3,20307,20307,20310,0,3,2
5793,6,3,20313,20313,20316,0,3,3
5794,1,2,20314,20316,20318,2,4,0
5795,1,2,20315,20318,20320,3,5,0
5796,3,3,20318,20320,20323,2,5,0
5797,5,1,20323,20323,20324,0,1,0
5798,1,1,20324,20324,20325,0,1,0
5799,4,2,20328,20328,20330,0,2,3
5800,4,1,20332,20332,20333,0,1,2
5801,4,2,20336,20336,20338,0,2,3
5802,5,1,20341,20341,20342,0,1,3
5803,2,2,20343,20343,20345,0,2,1
5804,3,3,20346,20346,20349,0,3,1
5805,4,2,20350,20350,20352,0,2,1
5806,2,3,20352,20352,20355,0,3,0
5807,2,3,20354,20355,20358,1,4,0
5808,3,1,20357,20358,20359,1,2,0
5809,6,2,20363,20363,20365,0,2,4
5810,3,2,20366,20366,20368,0,2,1
5811,6,3,20372,20372,20375,0,3,4
5812,4,3,20376,20376,20379,0,3,1
5813,1,3,20377,20379,20382,2,5,0
5814,5,2,20382,20382,20384,0,2,0
5815,5,3,20387,20387,20390,0,3,3
5816,2,2,20389,20390,20392,1,3,0
5817,2,2,20391,20392,20394,1,3,0
5818,4,2,20395,20395,20397,0,2,1
5819,2,1,20397,20397,20398,0,1,0
5820,5,2,20402,20402,20404,0,2,4
5821,4,1,20406,20406,20407,0,1,2
5822,1,1,20407,20407,20408,0,1,0
5823,3,3,20410,20410,20413,0,3,2
5824,2,2,20412,20413,20415,1,3,0
5825,2,1,20414,20415,20416,1,2,0
5826,2,1,20416,20416,20417,0,1,0
5827,1,1,20417,20417,20418,0,1,0
5828,3,2,20420,20420,20422,0,2,2
5829,3,1,20423,20423,20424,0,1,1
5830,6,3,20429,20429,20432,0,3,5
5831,3,1,20432,20432,20433,0,1,0
5832,1,2,20433,20433,20435,0,2,0
5833,6,2,20439,20439,20441,0,2,4
5834,1,1,20440,20441,20442,1,2,0
5835,6,2,20446,20446,20448,0,2,4
5836,1,1,20447,20448,20449,1,2,0
5837,5,2,20452,20452,20454,0,2,3
5838,3,1,20455,20455,20456,0,1,1
5839,2,3,20457,20457,20460,0,3,1
5840,5,2,20462,20462,20464,0,2,2
5841,6,1,20468,20468,20469,0,1,4
5842,2,3,20470,20470,20473,0,3,1
5843,1,1,20471,20473,20474,2,3,0
5844,6,2,20477,20477,20479,0,2,3
5845,6,1,20483,20483,20484,0,1,4
5846,4,1,20487,20487,20488,0,1,3
5847,5,3,20492,20492,20495,0,3,4
5848,1,3,20493,20495,20498,2,5,0
5849,6,3,20499,20499,20502,0,3,1
5850,6,2,20505,20505,20507,0,2,3
5851,2,3,20507,20507,20510,0,3,0
5852,1,1,20508,20510,20511,2,3,0
5853,4,2,20512,20512,20514,0,2,1
5854,3,1,20515,20515,20516,0,1,1
5855,4,3,20519,20519,20522,0,3,3
5856,3,3,20522,20522,20525,0,3,0
5857,5,2,20527,20527,20529,0,2,2
5858,1,1,20528,20529,20530,1,2,0
5859,3,1,20531,20531,20532,0,1,1
5860,4,3,20535,20535,20538,0,3,3
5861,6,1,20541,20541,20542,0,1,3
5862,4,1,20545,20545,20546,0,1,3
5863,6,1,20551,20551,20552,0,1,5
5864,3,3,20554,20554,20557,0,3,2
5865,4,1,20558,20558,20559,0,1,1
5866,6,3,20564,20564,20567,0,3,5
5867,6,3,20570,20570,20573,0,3,3
5868,3,1,20573,20573,20574,0,1,0
5869,3,1,20576,20576,20577,0,1,2
5870,3,3,20579,20579,20582,0,3,2
5871,5,3,20584,20584,20587,0,3,2
5872,4,2,20588,20588,20590,0,2,1
5873,6,1,20594,20594,20595,0,1,4
5874,6,2,20600,20600,20602,0,2,5
5875,2,2,20602,20602,20604,0,2,0
5876,1,2,20603,20604,20606,1,3,0
5877,5,3,20608,20608,20611,0,3,2
5878,3,1,20611,20611,20612,0,1,0
5879,3,1,20614,20614,20615,0,1,2
5880,2,3,20616,20616,20619,0,3,1
5881,5,3,20621,20621,20624,0,3,2
5882,6,1,20627,20627,20628,0,1,3
5883,2,3,20629,20629,20632,0,3,1
5884,6,3,20635,20635,20638,0,3,3
5885,6,3,20641,20641,20644,0,3,3
5886,6,1,20647,20647,20648,0,1,3
5887,3,3,20650,20650,20653,0,3,2
5888,6,2,20656,20656,20658,0,2,3
5889,6,3,20662,20662,20665,0,3,4
5890,2,3,20664,20665,20668,1,4,0
5891,2,1,20666,20668,20669,2,3,0
5892,6,2,20672,20672,20674,0,2,3
5893,6,3,20678,20678,20681,0,3,4
5894,2,1,20680,20681,20682,1,2,0
5895,1,3,20681,20682,20685,1,4,0
5896,5,3,20686,20686,20689,0,3,1
5897,6,3,20692,20692,20695,0,3,3
5898,1,1,20693,20695,20696,2,3,0
5899,1,2,20694,20696,20698,2,4,0
5900,2,2,20696,20698,20700,2,4,0
5901,2,3,20698,20700,20703,2,5,0
5902,3,2,20701,20703,20705,2,4,0
5903,2,3,20703,20705,20708,2,5,0
5904,5,1,20708,20708,20709,0,1,0
5905,2,2,20710,20710,20712,0,2,1
5906,3,1,20713,20713,20714,0,1,1
5907,1,2,20714,20714,20716,0,2,0
5908,2,1,20716,20716,20717,0,1,0
5909,2,1,20718,20718,20719,0,1,1
5910,3,3,20721,20721,20724,0,3,2
5911,1,3,20722,20724,20727,2,5,0
5912,4,2,20726,20727,20729,1,3,0
5913,3,3,20729,20729,20732,0,3,0
5914,3,2,20732,20732,20734,0,2,0
5915,3,2,20735,20735,20737,0,2,1
5916,3,1,20738,20738,20739,0,1,1
5917,1,2,20739,20739,20741,0,2,0
5918,4,2,20743,20743,20745,0,2,2
5919,1,2,20744,20745,20747,1,3,0
5920,3,3,20747,20747,20750,0,3,0
5921,1,3,20748,20750,20753,2,5,0
5922,1,3,20749,20753,20756,4,7,0
5923,6,3,20755,20756,20759,1,4,0
5924,1,2,20756,20759,20761,3,5,0
5925,5,2,20761,20761,20763,0,2,0
5926,3,3,20764,20764,20767,0,3,1
5927,1,3,20765,20767,20770,2,5,0
5928,2,3,20767,20770,20773,3,6,0
5929,4,3,20771,20773,20776,2,5,0
5930,1,2,20772,20776,20778,4,6,0
5931,4,2,20776,20778,20780,2,4,0
5932,2,1,20778,20780,20781,2,3,0
5933,3,2,20781,20781,20783,0,2,0
5934,4,1,20785,20785,20786,0,1,2
5935,1,1,20786,20786,20787,0,1,0
5936,6,1,20792,20792,20793,0,1,5
5937,2,3,20794,20794,20797,0,3,1
5938,1,1,20795,20797,20798,2,3,0
5939,4,1,20799,20799,20800,0,1,1
5940,6,3,20805,20805,20808,0,3,5
5941,5,3,20810,20810,20813,0,3,2
5942,2,1,20812,20813,20814,1,2,0
5943,2,2,20814,20814,20816,0,2,0
5944,2,3,20816,20816,20819,0,3,0
5945,4,3,20820,20820,20823,0,3,1
5946,3,1,20823,20823,20824,0,1,0
5947,1,3,20824,20824,20827,0,3,0
5948,4,1,20828,20828,20829,0,1,1
5949,6,1,20834,20834,20835,0,1,5
5950,3,3,20837,20837,20840,0,3,2
5951,1,3,20838,20840,20843,2,5,0
5952,3,3,20841,20843,20846,2,5,0
5953,4,1,20845,20846,20847,1,2,0
5954,5,1,20850,20850,20851,0,1,3
5955,1,3,20851,20851,20854,0,3,0
5956,2,1,20853,20854,20855,1,2,0
5957,6,3,20859,20859,20862,0,3,4
5958,2,2,20861,20862,20864,1,3,0
5959,4,1,20865,20865,20866,0,1,1
5960,3,3,20868,20868,20871,0,3,2
5961,6,3,20874,20874,20877,0,3,3
5962,2,1,20876,20877,20878,1,2,0
5963,5,2,20881,20881,20883,0,2,3
5964,3,3,20884,20884,20887,0,3,1
5965,4,2,20888,20888,20890,0,2,1
5966,3,1,20891,20891,20892,0,1,1
5967,2,3,20893,20893,20896,0,3,1
5968,5,2,20898,20898,20900,0,2,2
5969,5,3,20903,20903,20906,0,3,3
5970,1,3,20904,20906,20909,2,5,0
5971,2,2,20906,20909,20911,3,5,0
5972,3,1,20909,20911,20912,2,3,0
5973,6,2,20915,20915,20917,0,2,3
5974,2,1,20917,20917,20918,0,1,0
5975,5,2,20922,20922,20924,0,2,4
5976,4,1,20926,20926,20927,0,1,2
5977,1,2,20927,20927,20929,0,2,0
5978,2,3,20929,20929,20932,0,3,0
5979,5,2,20934,20934,20936,0,2,2
5980,6,2,20940,20940,20942,0,2,4
5981,3,3,20943,20943,20946,0,3,1
5982,4,1,20947,20947,20948,0,1,1
5983,5,2,20952,20952,20954,0,2,4
5984,4,3,20956,20956,20959,0,3,2
5985,2,3,20958,20959,20962,1,4,0
5986,6,1,20964,20964,20965,0,1,2
5987,2,2,20966,20966,20968,0,2,1
5988,5,3,20971,20971,20974,0,3,3
5989,5,2,20976,20976,20978,0,2,2
5990,6,1,20982,20982,20983,0,1,4
5991,2,3,20984,20984,20987,0,3,1
5992,1,3,20985,20987,20990,2,5,0
5993,1,3,20986,20990,20993,4,7,0
5994,6,2,20992,20993,20995,1,3,0
5995,1,1,20993,20995,20996,2,3,0
5996,1,3,20994,20996,20999,2,5,0
5997,6,3,21000,21000,21003,0,3,1
5998,6,1,21006,21006,21007,0,1,3
5999,3,3,21009,21009,21012,0,3,2
6000,5,2,21014,21014,21016,0,2,2
6001,5,1,21019,21019,21020,0,1,3
6002,2,3,21021,21021,21024,0,3,1
6003,1,1,21022,21024,21025,2,3,0
6004,6,3,21028,21028,21031,0,3,3
6005,6,3,21034,21034,21037,0,3,3
6006,4,2,21038,21038,21040,0,2,1
6007,5,3,21043,21043,21046,0,3,3
6008,3,1,21046,21046,21047,0,1,0
6009,5,3,21051,21051,21054,0,3,4
6010,4,1,21055,21055,21056,0,1,1
6011,3,1,21058,21058,21059,0,1,2
6012,4,2,21062,21062,21064,0,2,3
6013,6,3,21068,21068,21071,0,3,4
6014,4,2,21072,21072,21074,0,2,1
6015,4,3,21076,21076,21079,0,3,2
6016,5,3,21081,21081,21084,0,3,2
6017,4,2,21085,21085,21087,0,2,1
6018,1,1,21086,21087,21088,1,2,0
6019,3,3,21089,21089,21092,0,3,1
6020,4,2,21093,21093,21095,0,2,1
6021,3,3,21096,21096,21099,0,3,1
6022,6,1,21102,21102,21103,0,1,3
6023,3,2,21105,21105,21107,0,2,2
6024,3,3,21108,21108,21111,0,3,1
6025,6,2,21114,21114,21116,0,2,3
6026,1,2,21115,21116,21118,1,3,0
6027,6,1,21121,21121,21122,0,1,3
6028,1,2,21122,21122,21124,0,2,0
6029,1,2,21123,21124,21126,1,3,0
6030,4,1,21127,21127,21128,0,1,1
6031,6,1,21133,21133,21134,0,1,5
6032,1,1,21134,21134,21135,0,1,0
6033,2,2,21136,21136,21138,0,2,1
6034,3,3,21139,21139,21142,0,3,1
6035,4,2,21143,21143,21145,0,2,1
6036,1,3,21144,21145,21148,1,4,0
6037,3,1,21147,21148,21149,1,2,0
6038,4,3,21151,21151,21154,0,3,2
6039,5,1,21156,21156,21157,0,1,2
6040,2,2,21158,21158,21160,0,2,1
6041,6,1,21164,21164,21165,0,1,4
6042,2,1,21166,21166,21167,0,1,1
6043,4,3,21170,21170,21173,0,3,3
6044,4,1,21174,21174,21175,0,1,1
6045,1,2,21175,21175,21177,0,2,0
6046,3,3,21178,21178,21181,0,3,1
6047,4,2,21182,21182,21184,0,2,1
6048,4,3,21186,21186,21189,0,3,2
6049,4,1,21190,21190,21191,0,1,1
6050,2,1,21192,21192,21193,0,1,1
6051,3,2,21195,21195,21197,0,2,2
6052,3,3,21198,21198,21201,0,3,1
6053,6,2,21204,21204,21206,0,2,3
6054,2,1,21206,21206,21207,0,1,0
6055,4,2,21210,21210,21212,0,2,3
6056,4,2,21214,21214,21216,0,2,2
6057,1,3,21215,21216,21219,1,4,0
6058,2,2,21217,21219,21221,2,4,0
6059,2,3,21219,21221,21224,2,5,0
6060,5,3,21224,21224,21227,0,3,0
6061,6,1,21230,21230,21231,0,1,3
6062,3,1,21233,21233,21234,0,1,2
6063,6,3,21239,21239,21242,0,3,5
6064,2,1,21241,21242,21243,1,2,0
6065,4,1,21245,21245,21246,0,1,2
6066,5,3,21250,21250,21253,0,3,4
6067,4,2,21254,21254,21256,0,2,1
6068,6,3,21260,21260,21263,0,3,4
6069,3,3,21263,21263,21266,0,3,0
6070,6,1,21269,21269,21270,0,1,3
6071,3,2,21272,21272,21274,0,2,2
6072,2,3,21274,21274,21277,0,3,0
6073,6,3,21280,21280,21283,0,3,3
6074,3,1,21283,21283,21284,0,1,0
6075,3,3,21286,21286,21289,0,3,2
6076,4,2,21290,21290,21292,0,2,1
6077,4,2,21294,21294,21296,0,2,2
6078,1,3,21295,21296,21299,1,4,0
6079,3,1,21298,21299,21300,1,2,0
6080,4,3,21302,21302,21305,0,3,2
6081,6,3,21308,21308,21311,0,3,3
6082,6,1,21314,21314,21315,0,1,3
6083,1,3,21315,21315,21318,0,3,0
6084,4,2,21319,21319,21321,0,2,1
6085,6,1,21325,21325,21326,0,1,4
6086,6,3,21331,21331,21334,0,3,5
6087,2,1,21333,21334,21335,1,2,0
6088,4,1,21337,21337,21338,0,1,2
6089,6,3,21343,21343,21346,0,3,5
6090,3,3,21346,21346,21349,0,3,0
6091,5,1,21351,21351,21352,0,1,2
6092,5,1,21356,21356,21357,0,1,4
6093,5,1,21361,21361,21362,0,1,4
6094,3,3,21364,21364,21367,0,3,2
6095,1,1,21365,21367,21368,2,3,0
6096,3,3,21368,21368,21371,0,3,0
6097,5,2,21373,21373,21375,0,2,2
6098,2,3,21375,21375,21378,0,3,0
6099,6,3,21381,21381,21384,0,3,3
6100,2,2,21383,21384,21386,1,3,0
6101,4,2,21387,21387,21389,0,2,1
6102,4,1,21391,21391,21392,0,1,2
6103,6,3,21397,21397,21400,0,3,5
6104,2,1,21399,21400,21401,1,2,0
6105,2,2,21401,21401,21403,0,2,0
6106,3,1,21404,21404,21405,0,1,1
6107,6,1,21410,21410,21411,0,1,5
6108,3,2,21413,21413,21415,0,2,2
6109,3,3,21416,21416,21419,0,3,1
6110,6,3,21422,21422,21425,0,3,3
6111,4,1,21426,21426,21427,0,1,1
6112,2,2,21428,21428,21430,0,2,1
6113,4,1,21432,21432,21433,0,1,2
6114,3,3,21435,21435,21438,0,3,2
6115,6,3,21441,21441,21444,0,3,3
6116,2,3,21443,21444,21447,1,4,0
6117,5,2,21448,21448,21450,0,2,1
6118,3,1,21451,21451,21452,0,1,1
6119,2,2,21453,21453,21455,0,2,1
6120,1,1,21454,21455,21456,1,2,0
6121,6,1,21460,21460,21461,0,1,4
6122,2,2,21462,21462,21464,0,2,1
6123,5,2,21467,21467,21469,0,2,3
6124,2,3,21469,21469,21472,0,3,0
6125,1,2,21470,21472,21474,2,4,0
6126,2,1,21472,21474,21475,2,3,0
6127,2,1,21474,21475,21476,1,2,0
6128,3,1,21477,21477,21478,0,1,1
6129,5,3,21482,21482,21485,0,3,4
6130,5,2,21487,21487,21489,0,2,2
6131,2,1,21489,21489,21490,0,1,0
6132,6,3,21495,21495,21498,0,3,5
6133,1,1,21496,21498,21499,2,3,0
6134,4,3,21500,21500,21503,0,3,1
6135,2,1,21502,21503,21504,1,2,0
6136,3,3,21505,21505,21508,0,3,1
6137,1,2,21506,21508,21510,2,4,0
6138,1,3,21507,21510,21513,3,6,0
6139,4,1,21511,21513,21514,2,3,0
6140,2,2,21513,21514,21516,1,3,0
6141,6,3,21519,21519,21522,0,3,3
6142,6,2,21525,21525,21527,0,2,3
6143,2,1,21527,21527,21528,0,1,0
6144,5,3,21532,21532,21535,0,3,4
6145,5,1,21537,21537,21538,0,1,2
6146,3,2,21540,21540,21542,0,2,2
6147,5,3,21545,21545,21548,0,3,3
6148,2,3,21547,21548,21551,1,4,0
6149,6,2,21553,21553,21555,0,2,2
6150,3,1,21556,21556,21557,0,1,1
6151,2,3,21558,21558,21561,0,3,1
6152,2,3,21560,21561,21564,1,4,0
6153,6,1,21566,21566,21567,0,1,2
6154,3,1,21569,21569,21570,0,1,2
6155,3,1,21572,21572,21573,0,1,2
6156,4,3,21576,21576,21579,0,3,3
6157,5,3,21581,21581,21584,0,3,2
6158,5,2,21586,21586,21588,0,2,2
6159,5,2,21591,21591,21593,0,2,3
6160,2,1,21593,21593,21594,0,1,0
6161,4,1,21597,21597,21598,0,1,3
6162,4,2,21601,21601,21603,0,2,3
6163,2,1,21603,21603,21604,0,1,0
6164,3,2,21606,21606,21608,0,2,2
6165,6,2,21612,21612,21614,0,2,4
6166,6,1,21618,21618,21619,0,1,4
6167,4,3,21622,21622,21625,0,3,3
6168,6,1,21628,21628,21629,0,1,3
6169,2,3,21630,21630,21633,0,3,1
6170,3,2,21633,21633,21635,0,2,0
6171,4,3,21637,21637,21640,0,3,2
6172,6,2,21643,21643,21645,0,2,3
6173,5,1,21648,21648,21649,0,1,3
6174,1,2,21649,21649,21651,0,2,0
6175,4,2,21653,21653,21655,0,2,2
6176,1,1,21654,21655,21656,1,2,0
6177,1,2,21655,21656,21658,1,3,0
6178,1,3,21656,21658,21661,2,5,0
6179,2,2,21658,21661,21663,3,5,0
6180,6,1,21664,21664,21665,0,1,1
6181,1,1,21665,21665,21666,0,1,0
6182,6,1,21671,21671,21672,0,1,5
6183,6,2,21677,21677,21679,0,2,5
6184,5,1,21682,21682,21683,0,1,3
6185,4,1,21686,21686,21687,0,1,3
6186,1,1,21687,21687,21688,0,1,0
6187,5,3,21692,21692,21695,0,3,4
6188,5,3,21697,21697,21700,0,3,2
6189,4,1,21701,21701,21702,0,1,1
6190,3,3,21704,21704,21707,0,3,2
6191,3,1,21707,21707,21708,0,1,0
6192,1,1,21708,21708,21709,0,1,0
6193,4,1,21712,21712,21713,0,1,3
6194,5,3,21717,21717,21720,0,3,4
6195,4,3,21721,21721,21724,0,3,1
6196,2,3,21723,21724,21727,1,4,0
6197,3,3,21726,21727,21730,1,4,0
6198,6,3,21732,21732,21735,0,3,2
6199,5,1,21737,21737,21738,0,1,2
6200,2,3,21739,21739,21742,0,3,1
6201,6,1,21745,21745,21746,0,1,3
6202,1,3,21746,21746,21749,0,3,0
6203,5,3,21751,21751,21754,0,3,2
6204,6,3,21757,21757,21760,0,3,3
6205,5,3,21762,21762,21765,0,3,2
6206,3,3,21765,21765,21768,0,3,0
6207,6,1,21771,21771,21772,0,1,3
6208,5,2,21776,21776,21778,0,2,4
6209,6,2,21782,21782,21784,0,2,4
6210,2,2,21784,21784,21786,0,2,0
6211,2,3,21786,21786,21789,0,3,0
6212,4,1,21790,21790,21791,0,1,1
6213,2,3,21792,21792,21795,0,3,1
6214,4,3,21796,21796,21799,0,3,1
6215,6,1,21802,21802,21803,0,1,3
6216,2,1,21804,21804,21805,0,1,1
6217,6,3,21810,21810,21813,0,3,5
6218,5,3,21815,21815,21818,0,3,2
6219,6,1,21821,21821,21822,0,1,3
6220,4,2,21825,21825,21827,0,2,3
6221,1,1,21826,21827,21828,1,2,0
6222,4,1,21830,21830,21831,0,1,2
6223,3,2,21833,21833,21835,0,2,2
6224,4,3,21837,21837,21840,0,3,2
6225,3,1,21840,21840,21841,0,1,0
6226,4,2,21844,21844,21846,0,2,3
6227,3,2,21847,21847,21849,0,2,1
6228,4,3,21851,21851,21854,0,3,2
6229,5,1,21856,21856,21857,0,1,2
6230,6,3,21862,21862,21865,0,3,5
6231,5,3,21867,21867,21870,0,3,2
6232,6,1,21873,21873,21874,0,1,3
6233,1,2,21874,21874,21876,0,2,0
6234,5,2,21879,21879,21881,0,2,3
6235,2,3,21881,21881,21884,0,3,0
6236,5,3,21886,21886,21889,0,3,2
6237,1,1,21887,21889,21890,2,3,0
6238,5,3,21892,21892,21895,0,3,2
6239,3,3,21895,21895,21898,0,3,0
6240,6,3,21901,21901,21904,0,3,3
6241,5,2,21906,21906,21908,0,2,2
6242,5,2,21911,21911,21913,0,2,3
6243,2,2,21913,21913,21915,0,2,0
6244,4,2,21917,21917,21919,0,2,2
6245,1,3,21918,21919,21922,1,4,0
6246,2,2,21920,21922,21924,2,4,0
6247,1,3,21921,21924,21927,3,6,0
6248,4,3,21925,21927,21930,2,5,0
6249,4,3,21929,21930,21933,1,4,0
6250,3,1,21932,21933,21934,1,2,0
6251,3,2,21935,21935,21937,0,2,1
6252,3,2,21938,21938,21940,0,2,1
6253,6,3,21944,21944,21947,0,3,4
6254,1,3,21945,21947,21950,2,5,0
6255,4,1,21949,21950,21951,1,2,0
6256,5,3,21954,21954,21957,0,3,3
6257,3,3,21957,21957,21960,0,3,0
6258,4,1,21961,21961,21962,0,1,1
6259,3,1,21964,21964,21965,0,1,2
6260,6,3,21970,21970,21973,0,3,5
6261,1,2,21971,21973,21975,2,4,0
6262,3,1,21974,21975,21976,1,2,0
6263,6,2,21980,21980,21982,0,2,4
6264,6,3,21986,21986,21989,0,3,4
6265,2,3,21988,21989,21992,1,4,0
6266,6,3,21994,21994,21997,0,3,2
6267,4,3,21998,21998,22001,0,3,1
6268,5,2,22003,22003,22005,0,2,2
6269,4,2,22007,22007,22009,0,2,2
6270,1,2,22008,22009,22011,1,3,0
6271,6,3,22014,22014,22017,0,3,3
6272,1,3,22015,22017,22020,2,5,0
6273,4,3,22019,22020,22023,1,4,0
6274,3,1,22022,22023,22024,1,2,0
6275,1,1,22023,22024,22025,1,2,0
6276,4,2,22027,22027,22029,0,2,2
6277,5,3,22032,22032,22035,0,3,3
6278,5,1,22037,22037,22038,0,1,2
6279,4,2,22041,22041,22043,0,2,3
6280,5,1,22046,22046,22047,0,1,3
6281,1,3,22047,22047,22050,0,3,0
6282,2,1,22049,22050,22051,1,2,0
6283,3,2,22052,22052,22054,0,2,1
6284,1,2,22053,22054,22056,1,3,0
6285,4,3,22057,22057,22060,0,3,1
6286,6,1,22063,22063,22064,0,1,3
6287,4,2,22067,22067,22069,0,2,3
6288,5,3,22072,22072,22075,0,3,3
6289,2,1,22074,22075,22076,1,2,0
6290,2,2,22076,22076,22078,0,2,0
6291,3,2,22079,22079,22081,0,2,1
6292,2,3,22081,22081,22084,0,3,0
6293,2,1,22083,22084,22085,1,2,0
6294,5,3,22088,22088,22091,0,3,3
6295,3,2,22091,22091,22093,0,2,0
6296,4,1,22095,22095,22096,0,1,2
6297,2,2,22097,22097,22099,0,2,1
6298,2,3,22099,22099,22102,0,3,0
6299,4,2,22103,22103,22105,0,2,1
6300,2,2,22105,22105,22107,0,2,0
6301,2,2,22107,22107,22109,0,2,0
6302,1,1,22108,22109,22110,1,2,0
6303,6,3,22114,22114,22117,0,3,4
6304,1,3,22115,22117,22120,2,5,0
6305,5,1,22120,22120,22121,0,1,0
6306,6,1,22126,22126,22127,0,1,5
6307,1,2,22127,22127,22129,0,2,0
6308,2,2,22129,22129,22131,0,2,0
6309,6,2,22135,22135,22137,0,2,4
6310,6,3,22141,22141,22144,0,3,4
6311,5,3,22146,22146,22149,0,3,2
6312,4,1,22150,22150,22151,0,1,1
6313,4,3,22154,22154,22157,0,3,3
6314,2,3,22156,22157,22160,1,4,0
6315,1,3,22157,22160,22163,3,6,0
6316,3,3,22160,22163,22166,3,6,0
6317,6,1,22166,22166,22167,0,1,0
6318,4,1,22170,22170,22171,0,1,3
6319,5,1,22175,22175,22176,0,1,4
6320,2,2,22177,22177,22179,0,2,1
6321,5,2,22182,22182,22184,0,2,3
6322,4,3,22186,22186,22189,0,3,2
6323,1,1,22187,22189,22190,2,3,0
6324,3,1,22190,22190,22191,0,1,0
6325,5,1,22195,22195,22196,0,1,4
6326,6,1,22201,22201,22202,0,1,5
6327,4,3,22205,22205,22208,0,3,3
6328,3,2,22208,22208,22210,0,2,0
6329,2,3,22210,22210,22213,0,3,0
6330,4,1,22214,22214,22215,0,1,1
6331,3,3,22217,22217,22220,0,3,2
6332,1,2,22218,22220,22222,2,4,0
6333,4,2,22222,22222,22224,0,2,0
6334,6,2,22228,22228,22230,0,2,4
6335,4,2,22232,22232,22234,0,2,2
6336,3,1,22235,22235,22236,0,1,1
6337,3,1,22238,22238,22239,0,1,2
6338,5,1,22243,22243,22244,0,1,4
6339,4,2,22247,22247,22249,0,2,3
6340,2,2,22249,22249,22251,0,2,0
6341,2,1,22251,22251,22252,0,1,0
6342,6,2,22257,22257,22259,0,2,5
6343,1,2,22258,22259,22261,1,3,0
6344,2,2,22260,22261,22263,1,3,0
6345,1,3,22261,22263,22266,2,5,0
6346,2,3,22263,22266,22269,3,6,0
6347,1,3,22264,22269,22272,5,8,0
6348,6,3,22270,22272,22275,2,5,0
6349,3,2,22273,22275,22277,2,4,0
6350,4,2,22277,22277,22279,0,2,0
6351,3,3,22280,22280,22283,0,3,1
6352,2,1,22282,22283,22284,1,2,0
6353,4,1,22286,22286,22287,0,1,2
6354,4,1,22290,22290,22291,0,1,3
6355,4,2,22294,22294,22296,0,2,3
6356,6,1,22300,22300,22301,0,1,4
6357,5,1,22305,22305,22306,0,1,4
6358,1,2,22306,22306,22308,0,2,0
6359,5,3,22311,22311,22314,0,3,3
6360,4,1,22315,22315,22316,0,1,1
6361,4,2,22319,22319,22321,0,2,3
6362,4,1,22323,22323,22324,0,1,2
6363,6,2,22329,22329,22331,0,2,5
6364,2,1,22331,22331,22332,0,1,0
6365,2,2,22333,22333,22335,0,2,1
6366,2,3,22335,22335,22338,0,3,0
6367,6,3,22341,22341,22344,0,3,3
6368,4,3,22345,22345,22348,0,3,1
6369,3,1,22348,22348,22349,0,1,0
6370,4,2,22352,22352,22354,0,2,3
6371,3,1,22355,22355,22356,0,1,1
6372,6,3,22361,22361,22364,0,3,5
6373,4,1,22365,22365,22366,0,1,1
6374,2,2,22367,22367,22369,0,2,1
6375,1,2,22368,22369,22371,1,3,0
6376,1,2,22369,22371,22373,2,4,0
6377,5,3,22374,22374,22377,0,3,1
6378,1,2,22375,22377,22379,2,4,0
6379,3,2,22378,22379,22381,1,3,0
6380,6,3,22384,22384,22387,0,3,3
6381,3,3,22387,22387,22390,0,3,0
6382,6,1,22393,22393,22394,0,1,3
6383,6,1,22399,22399,22400,0,1,5
6384,3,1,22402,22402,22403,0,1,2
6385,2,3,22404,22404,22407,0,3,1
6386,1,2,22405,22407,22409,2,4,0
6387,6,3,22411,22411,22414,0,3,2
6388,6,2,22417,22417,22419,0,2,3
6389,2,3,22419,22419,22422,0,3,0
6390,3,2,22422,22422,22424,0,2,0
6391,6,2,22428,22428,22430,0,2,4
6392,1,2,22429,22430,22432,1,3,0
6393,5,1,22434,22434,22435,0,1,2
6394,3,3,22437,22437,22440,0,3,2
6395,1,1,22438,22440,22441,2,3,0
6396,1,3,22439,22441,22444,2,5,0
6397,4,2,22443,22444,22446,1,3,0
6398,2,3,22445,22446,22449,1,4,0
6399,3,1,22448,22449,22450,1,2,0
6400,4,3,22452,22452,22455,0,3,2
6401,5,1,22457,22457,22458,0,1,2
6402,1,3,22458,22458,22461,0,3,0
6403,2,1,22460,22461,22462,1,2,0
6404,5,2,22465,22465,22467,0,2,3
6405,6,1,22471,22471,22472,0,1,4
6406,6,3,22477,22477,22480,0,3,5
6407,5,2,22482,22482,22484,0,2,2
6408,3,1,22485,22485,22486,0,1,1
6409,5,1,22490,22490,22491,0,1,4
6410,1,1,22491,22491,22492,0,1,0
6411,5,2,22496,22496,22498,0,2,4
6412,2,1,22498,22498,22499,0,1,0
6413,5,2,22503,22503,22505,0,2,4
6414,2,3,22505,22505,22508,0,3,0
6415,5,2,22510,22510,22512,0,2,2
6416,4,3,22514,22514,22517,0,3,2
6417,2,2,22516,22517,22519,1,3,0
6418,2,2,22518,22519,22521,1,3,0
6419,4,2,22522,22522,22524,0,2,1
6420,6,3,22528,22528,22531,0,3,4
6421,1,3,22529,22531,22534,2,5,0
6422,4,1,22533,22534,22535,1,2,0
6423,5,1,22538,22538,22539,0,1,3
6424,5,1,22543,22543,22544,0,1,4
6425,5,1,22548,22548,22549,0,1,4
6426,4,3,22552,22552,22555,0,3,3
6427,2,2,22554,22555,22557,1,3,0
6428,6,2,22560,22560,22562,0,2,3
6429,4,3,22564,22564,22567,0,3,2
6430,1,1,22565,22567,22568,2,3,0
6431,5,3,22570,22570,22573,0,3,2
6432,5,3,22575,22575,22578,0,3,2
6433,3,1,22578,22578,22579,0,1,0
6434,2,1,22580,22580,22581,0,1,1
6435,2,3,22582,22582,22585,0,3,1
6436,3,2,22585,22585,22587,0,2,0
6437,5,3,22590,22590,22593,0,3,3
6438,5,3,22595,22595,22598,0,3,2
6439,2,2,22597,22598,22600,1,3,0
6440,4,3,22601,22601,22604,0,3,1
6441,4,2,22605,22605,22607,0,2,1
6442,6,1,22611,22611,22612,0,1,4
6443,1,1,22612,22612,22613,0,1,0
6444,2,3,22614,22614,22617,0,3,1
6445,4,2,22618,22618,22620,0,2,1
6446,6,3,22624,22624,22627,0,3,4
6447,3,3,22627,22627,22630,0,3,0
6448,2,3,22629,22630,22633,1,4,0
6449,3,2,22632,22633,22635,1,3,0
6450,2,1,22634,22635,22636,1,2,0
6451,1,1,22635,22636,22637,1,2,0
6452,3,3,22638,22638,22641,0,3,1
6453,5,3,22643,22643,22646,0,3,2
6454,6,3,22649,22649,22652,0,3,3
6455,1,2,22650,22652,22654,2,4,0
6456,4,3,22654,22654,22657,0,3,0
6457,4,1,22658,22658,22659,0,1,1
6458,5,3,22663,22663,22666,0,3,4
6459,6,1,22669,22669,22670,0,1,3
6460,5,2,22674,22674,22676,0,2,4
6461,5,2,22679,22679,22681,0,2,3
6462,3,3,22682,22682,22685,0,3,1
6463,3,3,22685,22685,22688,0,3,0
6464,5,1,22690,22690,22691,0,1,2
6465,1,3,22691,22691,22694,0,3,0
6466,1,2,22692,22694,22696,2,4,0
6467,6,3,22698,22698,22701,0,3,2
6468,4,1,22702,22702,22703,0,1,1
6469,5,1,22707,22707,22708,0,1,4
6470,6,2,22713,22713,22715,0,2,5
6471,2,2,22715,22715,22717,0,2,0
6472,6,3,22721,22721,22724,0,3,4
6473,2,2,22723,22724,22726,1,3,0
6474,6,2,22729,22729,22731,0,2,3
6475,2,2,22731,22731,22733,0,2,0
6476,1,1,22732,22733,22734,1,2,0
6477,2,2,22734,22734,22736,0,2,0
6478,2,2,22736,22736,22738,0,2,0
6479,5,1,22741,22741,22742,0,1,3
6480,6,2,22747,22747,22749,0,2,5
6481,5,3,22752,22752,22755,0,3,3
6482,3,2,22755,22755,22757,0,2,0
6483,6,2,22761,22761,22763,0,2,4
6484,1,2,22762,22763,22765,1,3,0
6485,3,2,22765,22765,22767,0,2,0
6486,6,1,22771,22771,22772,0,1,4
6487,5,2,22776,22776,22778,0,2,4
6488,3,1,22779,22779,22780,0,1,1
6489,2,1,22781,22781,22782,0,1,1
6490,3,3,22784,22784,22787,0,3,2
6491,3,3,22787,22787,22790,0,3,0
6492,3,2,22790,22790,22792,0,2,0
6493,3,2,22793,22793,22795,0,2,1
6494,5,2,22798,22798,22800,0,2,3
6495,6,1,22804,22804,22805,0,1,4
6496,2,2,22806,22806,22808,0,2,1
6497,3,3,22809,22809,22812,0,3,1
6498,5,1,22814,22814,22815,0,1,2
6499,3,3,22817,22817,22820,0,3,2
6500,3,2,22820,22820,22822,0,2,0
6501,4,2,22824,22824,22826,0,2,2
6502,5,2,22829,22829,22831,0,2,3
6503,6,3,22835,22835,22838,0,3,4
6504,5,1,22840,22840,22841,0,1,2
6505,4,3,22844,22844,22847,0,3,3
6506,3,2,22847,22847,22849,0,2,0
6507,3,3,22850,22850,22853,0,3,1
6508,3,2,22853,22853,22855,0,2,0
6509,1,3,22854,22855,22858,1,4,0
6510,3,1,22857,22858,22859,1,2,0
6511,5,2,22862,22862,22864,0,2,3
6512,2,3,22864,22864,22867,0,3,0
6513,1,3,22865,22867,22870,2,5,0
6514,1,3,22866,22870,22873,4,7,0
6515,4,2,22870,22873,22875,3,5,0
6516,6,3,22876,22876,22879,0,3,1
6517,3,2,22879,22879,22881,0,2,0
6518,5,1,22884,22884,22885,0,1,3
6519,3,3,22887,22887,22890,0,3,2
6520,6,3,22893,22893,22896,0,3,3
6521,3,3,22896,22896,22899,0,3,0
6522,1,1,22897,22899,22900,2,3,0
6523,2,1,22899,22900,22901,1,2,0
6524,2,2,22901,22901,22903,0,2,0
6525,4,3,22905,22905,22908,0,3,2
6526,4,3,22909,22909,22912,0,3,1
6527,4,3,22913,22913,22916,0,3,1
6528,6,2,22919,22919,22921,0,2,3
6529,2,3,22921,22921,22924,0,3,0
6530,6,2,22927,22927,22929,0,2,3
6531,4,3,22931,22931,22934,0,3,2
6532,3,2,22934,22934,22936,0,2,0
6533,6,1,22940,22940,22941,0,1,4
6534,5,1,22945,22945,22946,0,1,4
6535,2,3,22947,22947,22950,0,3,1
6536,5,2,22952,22952,22954,0,2,2
6537,5,2,22957,22957,22959,0,2,3
6538,2,3,22959,22959,22962,0,3,0
6539,1,2,22960,22962,22964,2,4,0
6540,5,3,22965,22965,22968,0,3,1
6541,3,3,22968,22968,22971,0,3,0
6542,4,1,22972,22972,22973,0,1,1
6543,5,3,22977,22977,22980,0,3,4
6544,4,1,22981,22981,22982,0,1,1
6545,4,2,22985,22985,22987,0,2,3
6546,6,2,22991,22991,22993,0,2,4
6547,1,2,22992,22993,22995,1,3,0
6548,4,2,22996,22996,22998,0,2,1
6549,4,2,23000,23000,23002,0,2,2
6550,3,2,23003,23003,23005,0,2,1
6551,2,2,23005,23005,23007,0,2,0
6552,4,1,23009,23009,23010,0,1,2
6553,4,3,23013,23013,23016,0,3,3
6554,4,1,23017,23017,23018,0,1,1
6555,4,1,23021,23021,23022,0,1,3
6556,1,3,23022,23022,23025,0,3,0
6557,3,3,23025,23025,23028,0,3,0
6558,4,2,23029,23029,23031,0,2,1
6559,2,1,23031,23031,23032,0,1,0
6560,5,2,23036,23036,23038,0,2,4
6561,5,3,23041,23041,23044,0,3,3
6562,6,1,23047,23047,23048,0,1,3
6563,5,2,23052,23052,23054,0,2,4
6564,1,2,23053,23054,23056,1,3,0
6565,2,2,23055,23056,23058,1,3,0
6566,4,1,23059,23059,23060,0,1,1
6567,3,1,23062,23062,23063,0,1,2
6568,6,1,23068,23068,23069,0,1,5
6569,2,1,23070,23070,23071,0,1,1
6570,1,2,23071,23071,23073,0,2,0
6571,2,2,23073,23073,23075,0,2,0
6572,2,1,23075,23075,23076,0,1,0
6573,1,1,23076,23076,23077,0,1,0
6574,2,1,23078,23078,23079,0,1,1
6575,4,3,23082,23082,23085,0,3,3
6576,3,1,23085,23085,23086,0,1,0
6577,3,2,23088,23088,23090,0,2,2
6578,1,3,23089,23090,23093,1,4,0
6579,1,2,23090,23093,23095,3,5,0
6580,2,1,23092,23095,23096,3,4,0
6581,2,2,23094,23096,23098,2,4,0
6582,5,3,23099,23099,23102,0,3,1
6583,3,1,23102,23102,23103,0,1,0
6584,1,1,23103,23103,23104,0,1,0
6585,6,3,23109,23109,23112,0,3,5
6586,3,2,23112,23112,23114,0,2,0
6587,3,2,23115,23115,23117,0,2,1
6588,5,2,23120,23120,23122,0,2,3
6589,3,2,23123,23123,23125,0,2,1
6590,6,1,23129,23129,23130,0,1,4
6591,3,3,23132,23132,23135,0,3,2
6592,5,2,23137,23137,23139,0,2,2
6593,6,3,23143,23143,23146,0,3,4
6594,2,1,23145,23146,23147,1,2,0
6595,5,2,23150,23150,23152,0,2,3
6596,5,1,23155,23155,23156,0,1,3
6597,5,1,23160,23160,23161,0,1,4
6598,3,2,23163,23163,23165,0,2,2
6599,4,2,23167,23167,23169,0,2,2
6600,3,1,23170,23170,23171,0,1,1
6601,4,1,23174,23174,23175,0,1,3
6602,1,1,23175,23175,23176,0,1,0
6603,6,2,23181,23181,23183,0,2,5
6604,2,1,23183,23183,23184,0,1,0
6605,4,1,23187,23187,23188,0,1,3
6606,1,3,23188,23188,23191,0,3,0
6607,4,2,23192,23192,23194,0,2,1
6608,2,2,23194,23194,23196,0,2,0
6609,4,2,23198,23198,23200,0,2,2
6610,1,2,23199,23200,23202,1,3,0
6611,1,3,23200,23202,23205,2,5,0
6612,5,2,23205,23205,23207,0,2,0
6613,2,2,23207,23207,23209,0,2,0
6614,1,2,23208,23209,23211,1,3,0
6615,6,3,23214,23214,23217,0,3,3
6616,5,2,23219,23219,23221,0,2,2
6617,4,3,23223,23223,23226,0,3,2
6618,2,1,23225,23226,23227,1,2,0
6619,3,1,23228,23228,23229,0,1,1
6620,5,3,23233,23233,23236,0,3,4
6621,4,1,23237,23237,23238,0,1,1
6622,5,1,23242,23242,23243,0,1,4
6623,3,2,23245,23245,23247,0,2,2
6624,4,3,23249,23249,23252,0,3,2
6625,4,3,23253,23253,23256,0,3,1
6626,6,3,23259,23259,23262,0,3,3
6627,5,3,23264,23264,23267,0,3,2
6628,6,2,23270,23270,23272,0,2,3
6629,3,2,23273,23273,23275,0,2,1
6630,4,3,23277,23277,23280,0,3,2
6631,4,2,23281,23281,23283,0,2,1
6632,4,1,23285,23285,23286,0,1,2
6633,4,2,23289,23289,23291,0,2,3
6634,5,2,23294,23294,23296,0,2,3
6635,4,1,23298,23298,23299,0,1,2
6636,5,3,23303,23303,23306,0,3,4
6637,2,2,23305,23306,23308,1,3,0
6638,1,1,23306,23308,23309,2,3,0
6639,6,2,23312,23312,23314,0,2,3
6640,6,2,23318,23318,23320,0,2,4
6641,4,3,23322,23322,23325,0,3,2
6642,4,3,23326,23326,23329,0,3,1
6643,1,2,23327,23329,23331,2,4,0
6644,5,2,23332,23332,23334,0,2,1
6645,3,2,23335,23335,23337,0,2,1
6646,3,1,23338,23338,23339,0,1,1
6647,2,3,23340,23340,23343,0,3,1
6648,4,1,23344,23344,23345,0,1,1
6649,6,1,23350,23350,23351,0,1,5
6650,5,2,23355,23355,23357,0,2,4
6651,5,1,23360,23360,23361,0,1,3
6652,3,3,23363,23363,23366,0,3,2
6653,4,3,23367,23367,23370,0,3,1
6654,3,1,23370,23370,23371,0,1,0
6655,5,1,23375,23375,23376,0,1,4
6656,1,3,23376,23376,23379,0,3,0
6657,5,2,23381,23381,23383,0,2,2
6658,3,2,23384,23384,23386,0,2,1
6659,3,3,23387,23387,23390,0,3,1
6660,2,2,23389,23390,23392,1,3,0
6661,6,2,23395,23395,23397,0,2,3
6662,3,2,23398,23398,23400,0,2,1
6663,6,3,23404,23404,23407,0,3,4
6664,1,3,23405,23407,23410,2,5,0
6665,4,1,23409,23410,23411,1,2,0
6666,4,3,23413,23413,23416,0,3,2
6667,4,1,23417,23417,23418,0,1,1
6668,3,1,23420,23420,23421,0,1,2
6669,1,2,23421,23421,23423,0,2,0
6670,4,3,23425,23425,23428,0,3,2
6671,3,1,23428,23428,23429,0,1,0
6672,6,3,23434,23434,23437,0,3,5
6673,4,1,23438,23438,23439,0,1,1
6674,4,1,23442,23442,23443,0,1,3
6675,2,3,23444,23444,23447,0,3,1
6676,4,1,23448,23448,23449,0,1,1
6677,5,3,23453,23453,23456,0,3,4
6678,6,2,23459,23459,23461,0,2,3
6679,5,2,23464,23464,23466,0,2,3
6680,1,1,23465,23466,23467,1,2,0
6681,6,1,23471,23471,23472,0,1,4
6682,3,3,23474,23474,23477,0,3,2
6683,4,3,23478,23478,23481,0,3,1
6684,1,2,23479,23481,23483,2,4,0
6685,1,1,23480,23483,23484,3,4,0
6686,5,3,23485,23485,23488,0,3,1
6687,2,1,23487,23488,23489,1,2,0
6688,4,1,23491,23491,23492,0,1,2
6689,1,3,23492,23492,23495,0,3,0
6690,6,1,23498,23498,23499,0,1,3
6691,2,3,23500,23500,23503,0,3,1
6692,6,1,23506,23506,23507,0,1,3
6693,2,3,23508,23508,23511,0,3,1
6694,4,3,23512,23512,23515,0,3,1
6695,4,3,23516,23516,23519,0,3,1
6696,6,3,23522,23522,23525,0,3,3
6697,4,2,23526,23526,23528,0,2,1
6698,1,1,23527,23528,23529,1,2,0
6699,3,1,23530,23530,23531,0,1,1
6700,1,3,23531,23531,23534,0,3,0
6701,6,1,23537,23537,23538,0,1,3
6702,3,2,23540,23540,23542,0,2,2
6703,2,2,23542,23542,23544,0,2,0
6704,5,1,23547,23547,23548,0,1,3
6705,5,2,23552,23552,23554,0,2,4
6706,6,1,23558,23558,23559,0,1,4
6707,5,3,23563,23563,23566,0,3,4
6708,1,1,23564,23566,23567,2,3,0
6709,4,3,23568,23568,23571,0,3,1
6710,3,2,23571,23571,23573,0,2,0
6711,5,3,23576,23576,23579,0,3,3
6712,3,2,23579,23579,23581,0,2,0
6713,6,2,23585,23585,23587,0,2,4
6714,6,2,23591,23591,23593,0,2,4
6715,6,2,23597,23597,23599,0,2,4
6716,6,1,23603,23603,23604,0,1,4
6717,6,2,23609,23609,23611,0,2,5
6718,5,3,23614,23614,23617,0,3,3
6719,6,3,23620,23620,23623,0,3,3
6720,2,3,23622,23623,23626,1,4,0
6721,1,2,23623,23626,23628,3,5,0
6722,5,3,23628,23628,23631,0,3,0
6723,5,1,23633,23633,23634,0,1,2
6724,5,1,23638,23638,23639,0,1,4
6725,1,3,23639,23639,23642,0,3,0
6726,5,3,23644,23644,23647,0,3,2
6727,5,2,23649,23649,23651,0,2,2
6728,4,3,23653,23653,23656,0,3,2
6729,5,3,23658,23658,23661,0,3,2
6730,4,1,23662,23662,23663,0,1,1
6731,2,2,23664,23664,23666,0,2,1
6732,4,1,23668,23668,23669,0,1,2
6733,5,3,23673,23673,23676,0,3,4
6734,6,1,23679,23679,23680,0,1,3
6735,3,3,23682,23682,23685,0,3,2
6736,4,1,23686,23686,23687,0,1,1
6737,2,3,23688,23688,23691,0,3,1
6738,5,2,23693,23693,23695,0,2,2
6739,5,2,23698,23698,23700,0,2,3
6740,4,2,23702,23702,23704,0,2,2
6741,2,1,23704,23704,23705,0,1,0
6742,4,1,23708,23708,23709,0,1,3
6743,4,3,23712,23712,23715,0,3,3
6744,6,1,23718,23718,23719,0,1,3
6745,4,1,23722,23722,23723,0,1,3
6746,3,2,23725,23725,23727,0,2,2
6747,5,2,23730,23730,23732,0,2,3
6748,1,2,23731,23732,23734,1,3,0
6749,5,3,23736,23736,23739,0,3,2
6750,6,1,23742,23742,23743,0,1,3
6751,1,1,23743,23743,23744,0,1,0
6752,4,2,23747,23747,23749,0,2,3
6753,5,2,23752,23752,23754,0,2,3
6754,1,1,23753,23754,23755,1,2,0
6755,4,3,23757,23757,23760,0,3,2
6756,4,3,23761,23761,23764,0,3,1
6757,2,1,23763,23764,23765,1,2,0
6758,2,3,23765,23765,23768,0,3,0
6759,5,1,23770,23770,23771,0,1,2
6760,1,3,23771,23771,23774,0,3,0
6761,1,1,23772,23774,23775,2,3,0
6762,6,2,23778,23778,23780,0,2,3
6763,3,2,23781,23781,23783,0,2,1
6764,6,3,23787,23787,23790,0,3,4
6765,4,1,23791,23791,23792,0,1,1
6766,1,2,23792,23792,23794,0,2,0
6767,1,3,23793,23794,23797,1,4,0
6768,2,3,23795,23797,23800,2,5,0
6769,1,2,23796,23800,23802,4,6,0
6770,1,2,23797,23802,23804,5,7,0
6771,1,1,23798,23804,23805,6,7,0
6772,2,3,23800,23805,23808,5,8,0
6773,6,1,23806,23808,23809,2,3,0
6774,5,3,23811,23811,23814,0,3,2
6775,4,3,23815,23815,23818,0,3,1
6776,4,2,23819,23819,23821,0,2,1
6777,2,3,23821,23821,23824,0,3,0
6778,4,3,23825,23825,23828,0,3,1
6779,6,2,23831,23831,23833,0,2,3
6780,1,2,23832,23833,23835,1,3,0
6781,1,3,23833,23835,23838,2,5,0
6782,6,1,23839,23839,23840,0,1,1
6783,1,2,23840,23840,23842,0,2,0
6784,3,1,23843,23843,23844,0,1,1
6785,3,2,23846,23846,23848,0,2,2
6786,3,3,23849,23849,23852,0,3,1
6787,1,3,23850,23852,23855,2,5,0
6788,1,2,23851,23855,23857,4,6,0
6789,3,2,23854,23857,23859,3,5,0
6790,4,2,23858,23859,23861,1,3,0
6791,3,3,23861,23861,23864,0,3,0
6792,5,3,23866,23866,23869,0,3,2
6793,4,1,23870,23870,23871,0,1,1
6794,1,2,23871,23871,23873,0,2,0
6795,6,3,23877,23877,23880,0,3,4
6796,5,3,23882,23882,23885,0,3,2
6797,1,1,23883,23885,23886,2,3,0
6798,5,1,23888,23888,23889,0,1,2
6799,4,3,23892,23892,23895,0,3,3
6800,6,2,23898,23898,23900,0,2,3
6801,5,3,23903,23903,23906,0,3,3
6802,4,2,23907,23907,23909,0,2,1
6803,5,1,23912,23912,23913,0,1,3
6804,2,2,23914,23914,23916,0,2,1
6805,3,1,23917,23917,23918,0,1,1
6806,4,2,23921,23921,23923,0,2,3
6807,2,2,23923,23923,23925,0,2,0
6808,6,1,23929,23929,23930,0,1,4
6809,6,1,23935,23935,23936,0,1,5
6810,4,3,23939,23939,23942,0,3,3
6811,5,3,23944,23944,23947,0,3,2
6812,1,1,23945,23947,23948,2,3,0
6813,2,2,23947,23948,23950,1,3,0
6814,5,2,23952,23952,23954,0,2,2
6815,4,2,23956,23956,23958,0,2,2
6816,3,3,23959,23959,23962,0,3,1
6817,6,2,23965,23965,23967,0,2,3
6818,4,3,23969,23969,23972,0,3,2
6819,6,1,23975,23975,23976,0,1,3
6820,6,3,23981,23981,23984,0,3,5
6821,2,3,23983,23984,23987,1,4,0
6822,4,2,23987,23987,23989,0,2,0
6823,6,1,23993,23993,23994,0,1,4
6824,4,3,23997,23997,24000,0,3,3
6825,4,1,24001,24001,24002,0,1,1
6826,4,2,24005,24005,24007,0,2,3
6827,3,2,24008,24008,24010,0,2,1
6828,5,2,24013,24013,24015,0,2,3
6829,3,1,24016,24016,24017,0,1,1
6830,4,3,24020,24020,24023,0,3,3
6831,6,2,24026,24026,24028,0,2,3
6832,4,3,24030,24030,24033,0,3,2
6833,6,2,24036,24036,24038,0,2,3
6834,3,3,24039,24039,24042,0,3,1
6835,6,1,24045,24045,24046,0,1,3
6836,1,3,24046,24046,24049,0,3,0
6837,4,1,24050,24050,24051,0,1,1
6838,2,2,24052,24052,24054,0,2,1
6839,1,2,24053,24054,24056,1,3,0
6840,2,3,24055,24056,24059,1,4,0
6841,5,2,24060,24060,24062,0,2,1
6842,1,2,24061,24062,24064,1,3,0
6843,2,2,24063,24064,24066,1,3,0
6844,5,3,24068,24068,24071,0,3,2
6845,4,3,24072,24072,24075,0,3,1
6846,4,3,24076,24076,24079,0,3,1
6847,2,2,24078,24079,24081,1,3,0
6848,5,2,24083,24083,24085,0,2,2
6849,4,3,24087,24087,24090,0,3,2
6850,2,2,24089,24090,24092,1,3,0
6851,5,2,24094,24094,24096,0,2,2
6852,4,2,24098,24098,24100,0,2,2
6853,2,2,24100,24100,24102,0,2,0
6854,2,2,24102,24102,24104,0,2,0
6855,3,2,24105,24105,24107,0,2,1
6856,1,2,24106,24107,24109,1,3,0
6857,3,3,24109,24109,24112,0,3,0
6858,4,1,24113,24113,24114,0,1,1
6859,4,1,24117,24117,24118,0,1,3
6860,2,2,24119,24119,24121,0,2,1
6861,4,1,24123,24123,24124,0,1,2
6862,2,1,24125,24125,24126,0,1,1
6863,6,2,24131,24131,24133,0,2,5
6864,1,1,24132,24133,24134,1,2,0
6865,5,1,24137,24137,24138,0,1,3
6866,4,2,24141,24141,24143,0,2,3
6867,6,1,24147,24147,24148,0,1,4
6868,3,3,24150,24150,24153,0,3,2
6869,3,3,24153,24153,24156,0,3,0
6870,2,3,24155,24156,24159,1,4,0
6871,4,2,24159,24159,24161,0,2,0
6872,3,3,24162,24162,24165,0,3,1
6873,6,1,24168,24168,24169,0,1,3
6874,4,3,24172,24172,24175,0,3,3
6875,5,1,24177,24177,24178,0,1,2
6876,2,2,24179,24179,24181,0,2,1
6877,6,3,24185,24185,24188,0,3,4
6878,3,2,24188,24188,24190,0,2,0
6879,5,2,24193,24193,24195,0,2,3
6880,5,1,24198,24198,24199,0,1,3
6881,6,2,24204,24204,24206,0,2,5
6882,3,3,24207,24207,24210,0,3,1
6883,1,1,24208,24210,24211,2,3,0
6884,3,1,24211,24211,24212,0,1,0
6885,6,2,24217,24217,24219,0,2,5
6886,1,1,24218,24219,24220,1,2,0
6887,1,1,24219,24220,24221,1,2,0
6888,4,3,24223,24223,24226,0,3,2
6889,3,1,24226,24226,24227,0,1,0
6890,4,3,24230,24230,24233,0,3,3
6891,5,2,24235,24235,24237,0,2,2
6892,4,1,24239,24239,24240,0,1,2
6893,2,2,24241,24241,24243,0,2,1
6894,1,2,24242,24243,24245,1,3,0
6895,5,3,24247,24247,24250,0,3,2
6896,4,2,24251,24251,24253,0,2,1
6897,3,3,24254,24254,24257,0,3,1
6898,4,1,24258,24258,24259,0,1,1
6899,4,2,24262,24262,24264,0,2,3
6900,3,3,24265,24265,24268,0,3,1
6901,1,2,24266,24268,24270,2,4,0
6902,2,1,24268,24270,24271,2,3,0
6903,1,1,24269,24271,24272,2,3,0
6904,5,1,24274,24274,24275,0,1,2
6905,4,2,24278,24278,24280,0,2,3
6906,5,1,24283,24283,24284,0,1,3
6907,3,3,24286,24286,24289,0,3,2
6908,2,3,24288,24289,24292,1,4,0
6909,2,1,24290,24292,24293,2,3,0
6910,5,3,24295,24295,24298,0,3,2
6911,1,2,24296,24298,24300,2,4,0
6912,2,2,24298,24300,24302,2,4,0
6913,1,3,24299,24302,24305,3,6,0
6914,2,3,24301,24305,24308,4,7,0
6915,6,3,24307,24308,24311,1,4,0
6916,4,2,24311,24311,24313,0,2,0
6917,5,3,24316,24316,24319,0,3,3
6918,1,3,24317,24319,24322,2,5,0
6919,5,2,24322,24322,24324,0,2,0
6920,2,1,24324,24324,24325,0,1,0
6921,1,3,24325,24325,24328,0,3,0
6922,5,1,24330,24330,24331,0,1,2
6923,1,2,24331,24331,24333,0,2,0
6924,4,1,24335,24335,24336,0,1,2
6925,4,2,24339,24339,24341,0,2,3
6926,1,2,24340,24341,24343,1,3,0
6927,1,2,24341,24343,24345,2,4,0
6928,1,1,24342,24345,24346,3,4,0
6929,5,3,24347,24347,24350,0,3,1
6930,1,2,24348,24350,24352,2,4,0
6931,6,3,24354,24354,24357,0,3,2
6932,6,2,24360,24360,24362,0,2,3
6933,3,1,24363,24363,24364,0,1,1
6934,6,2,24369,24369,24371,0,2,5
6935,1,1,24370,24371,24372,1,2,0
6936,1,3,24371,24372,24375,1,4,0
6937,2,2,24373,24375,24377,2,4,0
6938,5,1,24378,24378,24379,0,1,1
6939,6,3,24384,24384,24387,0,3,5
6940,4,2,24388,24388,24390,0,2,1
6941,1,2,24389,24390,24392,1,3,0
6942,4,3,24393,24393,24396,0,3,1
6943,3,3,24396,24396,24399,0,3,0
6944,4,3,24400,24400,24403,0,3,1
6945,4,1,24404,24404,24405,0,1,1
6946,6,2,24410,24410,24412,0,2,5
6947,4,1,24414,24414,24415,0,1,2
6948,6,1,24420,24420,24421,0,1,5
6949,4,1,24424,24424,24425,0,1,3
6950,4,2,24428,24428,24430,0,2,3
6951,6,1,24434,24434,24435,0,1,4
6952,1,2,24435,24435,24437,0,2,0
6953,6,2,24441,24441,24443,0,2,4
6954,2,1,24443,24443,24444,0,1,0
6955,6,2,24449,24449,24451,0,2,5
6956,4,1,24453,24453,24454,0,1,2
6957,2,3,24455,24455,24458,0,3,1
6958,4,2,24459,24459,24461,0,2,1
6959,1,3,24460,24461,24464,1,4,0
6960,3,1,24463,24464,24465,1,2,0
6961,3,1,24466,24466,24467,0,1,1
6962,1,1,24467,24467,24468,0,1,0
6963,1,2,24468,24468,24470,0,2,0
6964,5,2,24473,24473,24475,0,2,3
6965,4,3,24477,24477,24480,0,3,2
6966,2,2,24479,24480,24482,1,3,0
6967,4,2,24483,24483,24485,0,2,1
6968,6,2,24489,24489,24491,0,2,4
6969,1,2,24490,24491,24493,1,3,0
6970,2,1,24492,24493,24494,1,2,0
6971,3,1,24495,24495,24496,0,1,1
6972,3,1,24498,24498,24499,0,1,2
6973,1,2,24499,24499,24501,0,2,0
6974,2,2,24501,24501,24503,0,2,0
6975,1,3,24502,24503,24506,1,4,0
6976,6,1,24508,24508,24509,0,1,2
6977,4,1,24512,24512,24513,0,1,3
6978,3,3,24515,24515,24518,0,3,2
6979,6,1,24521,24521,24522,0,1,3
6980,6,1,24527,24527,24528,0,1,5
6981,6,2,24533,24533,24535,0,2,5
6982,6,3,24539,24539,24542,0,3,4
6983,3,2,24542,24542,24544,0,2,0
6984,3,3,24545,24545,24548,0,3,1
6985,5,2,24550,24550,24552,0,2,2
6986,4,1,24554,24554,24555,0,1,2
6987,4,2,24558,24558,24560,0,2,3
6988,3,3,24561,24561,24564,0,3,1
6989,2,2,24563,24564,24566,1,3,0
6990,1,3,24564,24566,24569,2,5,0
6991,1,2,24565,24569,24571,4,6,0
6992,5,1,24570,24571,24572,1,2,0
6993,2,2,24572,24572,24574,0,2,0
6994,2,1,24574,24574,24575,0,1,0
6995,3,1,24577,24577,24578,0,1,2
6996,6,3,24583,24583,24586,0,3,5
6997,1,2,24584,24586,24588,2,4,0
6998,6,3,24590,24590,24593,0,3,2
6999,6,2,24596,24596,24598,0,2,3
7000,1,2,24597,24598,24600,1,3,0
7001,6,2,24603,24603,24605,0,2,3
7002,3,3,24606,24606,24609,0,3,1
7003,6,1,24612,24612,24613,0,1,3
7004,6,3,24618,24618,24621,0,3,5
7005,4,2,24622,24622,24624,0,2,1
7006,6,1,24628,24628,24629,0,1,4
7007,1,2,24629,24629,24631,0,2,0
7008,1,3,24630,24631,24634,1,4,0
7009,6,2,24636,24636,24638,0,2,2
7010,2,3,24638,24638,24641,0,3,0
7011,4,1,24642,24642,24643,0,1,1
7012,1,3,24643,24643,24646,0,3,0
7013,4,3,24647,24647,24650,0,3,1
7014,1,2,24648,24650,24652,2,4,0
7015,3,3,24651,24652,24655,1,4,0
7016,2,2,24653,24655,24657,2,4,0
7017,6,3,24659,24659,24662,0,3,2
7018,5,2,24664,24664,24666,0,2,2
7019,4,1,24668,24668,24669,0,1,2
7020,6,1,24674,24674,24675,0,1,5
7021,5,1,24679,24679,24680,0,1,4
7022,5,1,24684,24684,24685,0,1,4
7023,4,2,24688,24688,24690,0,2,3
7024,1,1,24689,24690,24691,1,2,0
7025,5,3,24694,24694,24697,0,3,3
7026,3,1,24697,24697,24698,0,1,0
7027,2,2,24699,24699,24701,0,2,1
7028,3,3,24702,24702,24705,0,3,1
7029,5,1,24707,24707,24708,0,1,2
7030,1,1,24708,24708,24709,0,1,0
7031,3,2,24711,24711,24713,0,2,2
7032,4,1,24715,24715,24716,0,1,2
7033,4,3,24719,24719,24722,0,3,3
7034,3,2,24722,24722,24724,0,2,0
7035,5,3,24727,24727,24730,0,3,3
7036,4,3,24731,24731,24734,0,3,1
7037,2,1,24733,24734,24735,1,2,0
7038,2,1,24735,24735,24736,0,1,0
7039,1,2,24736,24736,24738,0,2,0
7040,1,2,24737,24738,24740,1,3,0
7041,3,2,24740,24740,24742,0,2,0
7042,3,2,24743,24743,24745,0,2,1
7043,6,2,24749,24749,24751,0,2,4
7044,2,1,24751,24751,24752,0,1,0
7045,1,3,24752,24752,24755,0,3,0
7046,2,3,24754,24755,24758,1,4,0
7047,1,2,24755,24758,24760,3,5,0
7048,2,1,24757,24760,24761,3,4,0
7049,4,2,24761,24761,24763,0,2,0
7050,5,1,24766,24766,24767,0,1,3
7051,6,2,24772,24772,24774,0,2,5
7052,3,1,24775,24775,24776,0,1,1
7053,5,3,24780,24780,24783,0,3,4
7054,4,1,24784,24784,24785,0,1,1
7055,4,3,24788,24788,24791,0,3,3
7056,4,3,24792,24792,24795,0,3,1
7057,2,3,24794,24795,24798,1,4,0
7058,2,3,24796,24798,24801,2,5,0
7059,6,1,24802,24802,24803,0,1,1
7060,2,1,24804,24804,24805,0,1,1
7061,1,1,24805,24805,24806,0,1,0
7062,2,3,24807,24807,24810,0,3,1
7063,2,3,24809,24810,24813,1,4,0
7064,5,1,24814,24814,24815,0,1,1
7065,3,2,24817,24817,24819,0,2,2
7066,2,2,24819,24819,24821,0,2,0
7067,6,1,24825,24825,24826,0,1,4
7068,3,2,24828,24828,24830,0,2,2
7069,4,2,24832,24832,24834,0,2,2
7070,1,1,24833,24834,24835,1,2,0
7071,2,3,24835,24835,24838,0,3,0
7072,4,1,24839,24839,24840,0,1,1
7073,1,1,24840,24840,24841,0,1,0
7074,3,1,24843,24843,24844,0,1,2
7075,2,2,24845,24845,24847,0,2,1
7076,5,2,24850,24850,24852,0,2,3
7077,2,1,24852,24852,24853,0,1,0
7078,6,2,24858,24858,24860,0,2,5
7079,4,2,24862,24862,24864,0,2,2
7080,3,2,24865,24865,24867,0,2,1
7081,1,3,24866,24867,24870,1,4,0
7082,1,3,24867,24870,24873,3,6,0
7083,1,1,24868,24873,24874,5,6,0
7084,1,1,24869,24874,24875,5,6,0
7085,4,1,24873,24875,24876,2,3,0
7086,3,1,24876,24876,24877,0,1,0
7087,1,3,24877,24877,24880,0,3,0
7088,5,2,24882,24882,24884,0,2,2
7089,5,1,24887,24887,24888,0,1,3
7090,5,3,24892,24892,24895,0,3,4
7091,5,1,24897,24897,24898,0,1,2
7092,2,3,24899,24899,24902,0,3,1
7093,1,1,24900,24902,24903,2,3,0
7094,3,1,24903,24903,24904,0,1,0
7095,5,2,24908,24908,24910,0,2,4
7096,6,3,24914,24914,24917,0,3,4
7097,3,3,24917,24917,24920,0,3,0
7098,1,2,24918,24920,24922,2,4,0
7099,4,3,24922,24922,24925,0,3,0
7100,1,1,24923,24925,24926,2,3,0
7101,1,3,24924,24926,24929,2,5,0
7102,6,1,24930,24930,24931,0,1,1
7103,5,1,24935,24935,24936,0,1,4
7104,2,1,24937,24937,24938,0,1,1
7105,3,2,24940,24940,24942,0,2,2
7106,6,2,24946,24946,24948,0,2,4
7107,5,3,24951,24951,24954,0,3,3
7108,1,3,24952,24954,24957,2,5,0
7109,6,3,24958,24958,24961,0,3,1
7110,5,2,24963,24963,24965,0,2,2
7111,4,2,24967,24967,24969,0,2,2
7112,1,1,24968,24969,24970,1,2,0
7113,5,3,24973,24973,24976,0,3,3
7114,5,3,24978,24978,24981,0,3,2
7115,1,2,24979,24981,24983,2,4,0
7116,3,2,24982,24983,24985,1,3,0
7117,3,3,24985,24985,24988,0,3,0
7118,2,1,24987,24988,24989,1,2,0
7119,5,3,24992,24992,24995,0,3,3
7120,6,1,24998,24998,24999,0,1,3
7121,3,1,25001,25001,25002,0,1,2
7122,1,2,25002,25002,25004,0,2,0
7123,2,2,25004,25004,25006,0,2,0
7124,2,2,25006,25006,25008,0,2,0
7125,2,3,25008,25008,25011,0,3,0
7126,1,3,25009,25011,25014,2,5,0
7127,2,2,25011,25014,25016,3,5,0
7128,3,3,25014,25016,25019,2,5,0
7129,3,1,25017,25019,25020,2,3,0
7130,2,2,25019,25020,25022,1,3,0
7131,5,3,25024,25024,25027,0,3,2
7132,3,3,25027,25027,25030,0,3,0
7133,1,1,25028,25030,25031,2,3,0
7134,3,1,25031,25031,25032,0,1,0
7135,5,1,25036,25036,25037,0,1,4
7136,5,3,25041,25041,25044,0,3,4
7137,1,3,25042,25044,25047,2,5,0
7138,2,1,25044,25047,25048,3,4,0
7139,2,1,25046,25048,25049,2,3,0
7140,3,1,25049,25049,25050,0,1,0
7141,1,3,25050,25050,25053,0,3,0
7142,3,3,25053,25053,25056,0,3,0
7143,2,2,25055,25056,25058,1,3,0
7144,6,2,25061,25061,25063,0,2,3
7145,5,3,25066,25066,25069,0,3,3
7146,4,2,25070,25070,25072,0,2,1
7147,1,3,25071,25072,25075,1,4,0
7148,6,3,25077,25077,25080,0,3,2
7149,2,2,25079,25080,25082,1,3,0
7150,6,2,25085,25085,25087,0,2,3
7151,2,3,25087,25087,25090,0,3,0
7152,1,3,25088,25090,25093,2,5,0
7153,6,2,25094,25094,25096,0,2,1
7154,3,1,25097,25097,25098,0,1,1
7155,2,2,25099,25099,25101,0,2,1
7156,3,2,25102,25102,25104,0,2,1
7157,6,2,25108,25108,25110,0,2,4
7158,6,3,25114,25114,25117,0,3,4
7159,3,2,25117,25117,25119,0,2,0
7160,2,3,25119,25119,25122,0,3,0
7161,6,1,25125,25125,25126,0,1,3
7162,5,2,25130,25130,25132,0,2,4
7163,6,3,25136,25136,25139,0,3,4
7164,5,3,25141,25141,25144,0,3,2
7165,2,1,25143,25144,25145,1,2,0
7166,4,1,25147,25147,25148,0,1,2
7167,3,2,25150,25150,25152,0,2,2
7168,4,2,25154,25154,25156,0,2,2
7169,5,3,25159,25159,25162,0,3,3
7170,4,1,25163,25163,25164,0,1,1
7171,2,2,25165,25165,25167,0,2,1
7172,6,2,25171,25171,25173,0,2,4
7173,6,3,25177,25177,25180,0,3,4
7174,3,2,25180,25180,25182,0,2,0
7175,1,3,25181,25182,25185,1,4,0
7176,3,2,25184,25185,25187,1,3,0
7177,2,3,25186,25187,25190,1,4,0
7178,4,1,25190,25190,25191,0,1,0
7179,5,3,25195,25195,25198,0,3,4
7180,1,1,25196,25198,25199,2,3,0
7181,1,2,25197,25199,25201,2,4,0
7182,4,2,25201,25201,25203,0,2,0
7183,2,2,25203,25203,25205,0,2,0
7184,4,2,25207,25207,25209,0,2,2
7185,4,2,25211,25211,25213,0,2,2
7186,3,2,25214,25214,25216,0,2,1
7187,1,2,25215,25216,25218,1,3,0
7188,4,1,25219,25219,25220,0,1,1
7189,1,2,25220,25220,25222,0,2,0
7190,1,3,25221,25222,25225,1,4,0
7191,6,1,25227,25227,25228,0,1,2
7192,4,2,25231,25231,25233,0,2,3
7193,6,2,25237,25237,25239,0,2,4
7194,1,2,25238,25239,25241,1,3,0
7195,4,2,25242,25242,25244,0,2,1
7196,1,2,25243,25244,25246,1,3,0
7197,1,2,25244,25246,25248,2,4,0
7198,6,1,25250,25250,25251,0,1,2
7199,4,1,25254,25254,25255,0,1,3
7200,2,2,25256,25256,25258,0,2,1
7201,2,3,25258,25258,25261,0,3,0
7202,4,2,25262,25262,25264,0,2,1
7203,4,1,25266,25266,25267,0,1,2
7204,1,3,25267,25267,25270,0,3,0
7205,4,3,25271,25271,25274,0,3,1
7206,5,2,25276,25276,25278,0,2,2
7207,4,1,25280,25280,25281,0,1,2
7208,3,2,25283,25283,25285,0,2,2
7209,1,1,25284,25285,25286,1,2,0
7210,2,3,25286,25286,25289,0,3,0
7211,6,2,25292,25292,25294,0,2,3
7212,1,1,25293,25294,25295,1,2,0
7213,2,2,25295,25295,25297,0,2,0
7214,3,2,25298,25298,25300,0,2,1
7215,5,3,25303,25303,25306,0,3,3
7216,3,3,25306,25306,25309,0,3,0
7217,4,3,25310,25310,25313,0,3,1
7218,4,3,25314,25314,25317,0,3,1
7219,6,1,25320,25320,25321,0,1,3
7220,3,3,25323,25323,25326,0,3,2
7221,1,3,25324,25326,25329,2,5,0
7222,5,2,25329,25329,25331,0,2,0
7223,2,1,25331,25331,25332,0,1,0
7224,6,1,25337,25337,25338,0,1,5
7225,1,1,25338,25338,25339,0,1,0
7226,2,3,25340,25340,25343,0,3,1
7227,4,2,25344,25344,25346,0,2,1
7228,6,1,25350,25350,25351,0,1,4
7229,5,2,25355,25355,25357,0,2,4
7230,6,2,25361,25361,25363,0,2,4
7231,3,1,25364,25364,25365,0,1,1
7232,6,1,25370,25370,25371,0,1,5
7233,5,3,25375,25375,25378,0,3,4
7234,6,2,25381,25381,25383,0,2,3
7235,3,1,25384,25384,25385,0,1,1
7236,6,3,25390,25390,25393,0,3,5
7237,4,1,25394,25394,25395,0,1,1
7238,6,2,25400,25400,25402,0,2,5
7239,2,2,25402,25402,25404,0,2,0
7240,3,2,25405,25405,25407,0,2,1
7241,6,1,25411,25411,25412,0,1,4
7242,4,2,25415,25415,25417,0,2,3
7243,6,3,25421,25421,25424,0,3,4
7244,1,1,25422,25424,25425,2,3,0
7245,6,3,25428,25428,25431,0,3,3
7246,3,2,25431,25431,25433,0,2,0
7247,4,1,25435,25435,25436,0,1,2
7248,3,1,25438,25438,25439,0,1,2
7249,3,3,25441,25441,25444,0,3,2
7250,3,1,25444,25444,25445,0,1,0
7251,3,2,25447,25447,25449,0,2,2
7252,5,1,25452,25452,25453,0,1,3
7253,3,2,25455,25455,25457,0,2,2
7254,5,2,25460,25460,25462,0,2,3
7255,1,3,25461,25462,25465,1,4,0
7256,6,3,25467,25467,25470,0,3,2
7257,4,1,25471,25471,25472,0,1,1
7258,1,1,25472,25472,25473,0,1,0
7259,3,2,25475,25475,25477,0,2,2
7260,5,3,25480,25480,25483,0,3,3
7261,1,2,25481,25483,25485,2,4,0
7262,3,1,25484,25485,25486,1,2,0
7263,1,1,25485,25486,25487,1,2,0
7264,4,2,25489,25489,25491,0,2,2
7265,3,2,25492,25492,25494,0,2,1
7266,3,3,25495,25495,25498,0,3,1
7267,2,3,25497,25498,25501,1,4,0
7268,1,3,25498,25501,25504,3,6,0
7269,5,2,25503,25504,25506,1,3,0
7270,5,1,25508,25508,25509,0,1,2
7271,6,3,25514,25514,25517,0,3,5
7272,4,1,25518,25518,25519,0,1,1
7273,6,2,25524,25524,25526,0,2,5
7274,6,3,25530,25530,25533,0,3,4
7275,2,3,25532,25533,25536,1,4,0
7276,4,1,25536,25536,25537,0,1,0
7277,6,2,25542,25542,25544,0,2,5
7278,6,2,25548,25548,25550,0,2,4
7279,2,1,25550,25550,25551,0,1,0
7280,5,2,25555,25555,25557,0,2,4
7281,1,1,25556,25557,25558,1,2,0
7282,3,3,25559,25559,25562,0,3,1
7283,4,1,25563,25563,25564,0,1,1
7284,1,1,25564,25564,25565,0,1,0
7285,4,1,25568,25568,25569,0,1,3
7286,4,2,25572,25572,25574,0,2,3
7287,3,2,25575,25575,25577,0,2,1
7288,1,3,25576,25577,25580,1,4,0
7289,3,3,25579,25580,25583,1,4,0
7290,5,3,25584,25584,25587,0,3,1
7291,4,1,25588,25588,25589,0,1,1
7292,6,1,25594,25594,25595,0,1,5
7293,2,2,25596,25596,25598,0,2,1
7294,6,1,25602,25602,25603,0,1,4
7295,4,2,25606,25606,25608,0,2,3
7296,4,2,25610,25610,25612,0,2,2
7297,1,3,25611,25612,25615,1,4,0
7298,1,1,25612,25615,25616,3,4,0
7299,2,2,25614,25616,25618,2,4,0
7300,2,2,25616,25618,25620,2,4,0
7301,6,1,25622,25622,25623,0,1,2
7302,4,3,25626,25626,25629,0,3,3
7303,1,1,25627,25629,25630,2,3,0
7304,1,2,25628,25630,25632,2,4,0
7305,6,1,25634,25634,25635,0,1,2
7306,3,3,25637,25637,25640,0,3,2
7307,4,1,25641,25641,25642,0,1,1
7308,1,1,25642,25642,25643,0,1,0
7309,4,2,25646,25646,25648,0,2,3
7310,1,2,25647,25648,25650,1,3,0
7311,2,1,25649,25650,25651,1,2,0
7312,6,2,25655,25655,25657,0,2,4
7313,4,1,25659,25659,25660,0,1,2
7314,6,3,25665,25665,25668,0,3,5
7315,4,3,25669,25669,25672,0,3,1
7316,5,2,25674,25674,25676,0,2,2
7317,3,1,25677,25677,25678,0,1,1
7318,6,1,25683,25683,25684,0,1,5
7319,3,3,25686,25686,25689,0,3,2
7320,4,1,25690,25690,25691,0,1,1
7321,6,1,25696,25696,25697,0,1,5
7322,2,3,25698,25698,25701,0,3,1
7323,6,1,25704,25704,25705,0,1,3
7324,3,2,25707,25707,25709,0,2,2
7325,5,2,25712,25712,25714,0,2,3
7326,1,2,25713,25714,25716,1,3,0
7327,1,3,25714,25716,25719,2,5,0
7328,5,1,25719,25719,25720,0,1,0
7329,4,2,25723,25723,25725,0,2,3
7330,5,2,25728,25728,25730,0,2,3
7331,2,1,25730,25730,25731,0,1,0
7332,1,3,25731,25731,25734,0,3,0
7333,5,3,25736,25736,25739,0,3,2
7334,4,3,25740,25740,25743,0,3,1
7335,5,3,25745,25745,25748,0,3,2
7336,1,2,25746,25748,25750,2,4,0
7337,1,3,25747,25750,25753,3,6,0
7338,1,2,25748,25753,25755,5,7,0
7339,6,1,25754,25755,25756,1,2,0
7340,3,3,25757,25757,25760,0,3,1
7341,5,2,25762,25762,25764,0,2,2
7342,1,3,25763,25764,25767,1,4,0
7343,3,3,25766,25767,25770,1,4,0
7344,4,3,25770,25770,25773,0,3,0
7345,4,3,25774,25774,25777,0,3,1
7346,3,2,25777,25777,25779,0,2,0
7347,3,1,25780,25780,25781,0,1,1
7348,6,3,25786,25786,25789,0,3,5
7349,3,3,25789,25789,25792,0,3,0
7350,4,2,25793,25793,25795,0,2,1
7351,1,2,25794,25795,25797,1,3,0
7352,2,2,25796,25797,25799,1,3,0
7353,4,3,25800,25800,25803,0,3,1
7354,6,2,25806,25806,25808,0,2,3
7355,2,3,25808,25808,25811,0,3,0
7356,6,3,25814,25814,25817,0,3,3
7357,2,3,25816,25817,25820,1,4,0
7358,1,3,25817,25820,25823,3,6,0
7359,4,2,25821,25823,25825,2,4,0
7360,1,1,25822,25825,25826,3,4,0
7361,1,1,25823,25826,25827,3,4,0
7362,6,1,25829,25829,25830,0,1,2
7363,6,1,25835,25835,25836,0,1,5
7364,4,3,25839,25839,25842,0,3,3
7365,4,1,25843,25843,25844,0,1,1
7366,6,3,25849,25849,25852,0,3,5
7367,5,3,25854,25854,25857,0,3,2
7368,4,1,25858,25858,25859,0,1,1
7369,2,3,25860,25860,25863,0,3,1
7370,6,2,25866,25866,25868,0,2,3
7371,1,2,25867,25868,25870,1,3,0
7372,5,1,25872,25872,25873,0,1,2
7373,3,3,25875,25875,25878,0,3,2
7374,2,2,25877,25878,25880,1,3,0
7375,4,1,25881,25881,25882,0,1,1
7376,4,2,25885,25885,25887,0,2,3
7377,5,3,25890,25890,25893,0,3,3
7378,2,2,25892,25893,25895,1,3,0
7379,4,3,25896,25896,25899,0,3,1
7380,1,1,25897,25899,25900,2,3,0
7381,6,2,25903,25903,25905,0,2,3
7382,4,1,25907,25907,25908,0,1,2
7383,4,2,25911,25911,25913,0,2,3
7384,1,3,25912,25913,25916,1,4,0
7385,1,2,25913,25916,25918,3,5,0
7386,2,3,25915,25918,25921,3,6,0
7387,3,2,25918,25921,25923,3,5,0
7388,6,2,25924,25924,25926,0,2,1
7389,3,3,25927,25927,25930,0,3,1
7390,2,3,25929,25930,25933,1,4,0
7391,2,1,25931,25933,25934,2,3,0
7392,2,2,25933,25934,25936,1,3,0
7393,3,1,25936,25936,25937,0,1,0
7394,5,2,25941,25941,25943,0,2,4
7395,6,1,25947,25947,25948,0,1,4
7396,6,1,25953,25953,25954,0,1,5
7397,4,1,25957,25957,25958,0,1,3
7398,3,1,25960,25960,25961,0,1,2
7399,2,2,25962,25962,25964,0,2,1
7400,6,3,25968,25968,25971,0,3,4
7401,5,1,25973,25973,25974,0,1,2
7402,5,2,25978,25978,25980,0,2,4
7403,2,3,25980,25980,25983,0,3,0
7404,2,1,25982,25983,25984,1,2,0
7405,5,3,25987,25987,25990,0,3,3
7406,4,3,25991,25991,25994,0,3,1
7407,5,2,25996,25996,25998,0,2,2
7408,4,1,26000,26000,26001,0,1,2
7409,2,2,26002,26002,26004,0,2,1
7410,1,1,26003,26004,26005,1,2,0
7411,2,2,26005,26005,26007,0,2,0
7412,6,3,26011,26011,26014,0,3,4
7413,6,1,26017,26017,26018,0,1,3
7414,3,2,26020,26020,26022,0,2,2
7415,2,2,26022,26022,26024,0,2,0
7416,5,3,26027,26027,26030,0,3,3
7417,5,3,26032,26032,26035,0,3,2
7418,3,1,26035,26035,26036,0,1,0
7419,5,3,26040,26040,26043,0,3,4
7420,6,2,26046,26046,26048,0,2,3
7421,5,3,26051,26051,26054,0,3,3
7422,4,1,26055,26055,26056,0,1,1
7423,1,2,26056,26056,26058,0,2,0
7424,4,2,26060,26060,26062,0,2,2
7425,6,1,26066,26066,26067,0,1,4
7426,4,2,26070,26070,26072,0,2,3
7427,1,3,26071,26072,26075,1,4,0
7428,3,3,26074,26075,26078,1,4,0
7429,2,3,26076,26078,26081,2,5,0
7430,3,3,26079,26081,26084,2,5,0
7431,5,1,26084,26084,26085,0,1,0
7432,5,1,26089,26089,26090,0,1,4
7433,6,3,26095,26095,26098,0,3,5
7434,5,1,26100,26100,26101,0,1,2
7435,5,2,26105,26105,26107,0,2,4
7436,2,2,26107,26107,26109,0,2,0
7437,6,3,26113,26113,26116,0,3,4
7438,4,1,26117,26117,26118,0,1,1
7439,3,3,26120,26120,26123,0,3,2
7440,5,3,26125,26125,26128,0,3,2
7441,1,1,26126,26128,26129,2,3,0
7442,2,3,26128,26129,26132,1,4,0
7443,5,1,26133,26133,26134,0,1,1
7444,5,2,26138,26138,26140,0,2,4
7445,2,3,26140,26140,26143,0,3,0
7446,3,3,26143,26143,26146,0,3,0
7447,1,3,26144,26146,26149,2,5,0
7448,1,1,26145,26149,26150,4,5,0
7449,4,3,26149,26150,26153,1,4,0
7450,1,2,26150,26153,26155,3,5,0
7451,1,3,26151,26155,26158,4,7,0
7452,5,2,26156,26158,26160,2,4,0
7453,1,2,26157,26160,26162,3,5,0
7454,1,3,26158,26162,26165,4,7,0
7455,1,1,26159,26165,26166,6,7,0
7456,2,2,26161,26166,26168,5,7,0
7457,6,1,26167,26168,26169,1,2,0
7458,4,2,26171,26171,26173,0,2,2
7459,3,3,26174,26174,26177,0,3,1
7460,6,3,26180,26180,26183,0,3,3
7461,5,3,26185,26185,26188,0,3,2
7462,3,1,26188,26188,26189,0,1,0
7463,2,2,26190,26190,26192,0,2,1
7464,5,2,26195,26195,26197,0,2,3
7465,5,3,26200,26200,26203,0,3,3
7466,2,1,26202,26203,26204,1,2,0
7467,1,1,26203,26204,26205,1,2,0
7468,5,3,26208,26208,26211,0,3,3
7469,1,3,26209,26211,26214,2,5,0
7470,1,3,26210,26214,26217,4,7,0
7471,6,2,26216,26217,26219,1,3,0
7472,6,1,26222,26222,26223,0,1,3
7473,1,2,26223,26223,26225,0,2,0
7474,1,2,26224,26225,26227,1,3,0
7475,1,3,26225,26227,26230,2,5,0
7476,3,3,26228,26230,26233,2,5,0
7477,6,2,26234,26234,26236,0,2,1
7478,1,1,26235,26236,26237,1,2,0
7479,5,1,26240,26240,26241,0,1,3
7480,6,1,26246,26246,26247,0,1,5
7481,4,3,26250,26250,26253,0,3,3
7482,6,3,26256,26256,26259,0,3,3
7483,6,1,26262,26262,26263,0,1,3
7484,5,2,26267,26267,26269,0,2,4
7485,4,3,26271,26271,26274,0,3,2
7486,5,2,26276,26276,26278,0,2,2
7487,6,1,26282,26282,26283,0,1,4
7488,5,2,26287,26287,26289,0,2,4
7489,5,1,26292,26292,26293,0,1,3
7490,5,1,26297,26297,26298,0,1,4
7491,3,3,26300,26300,26303,0,3,2
7492,2,1,26302,26303,26304,1,2,0
7493,5,1,26307,26307,26308,0,1,3
7494,4,2,26311,26311,26313,0,2,3
7495,2,3,26313,26313,26316,0,3,0
7496,3,1,26316,26316,26317,0,1,0
7497,3,1,26319,26319,26320,0,1,2
7498,4,2,26323,26323,26325,0,2,3
7499,1,1,26324,26325,26326,1,2,0
7500,1,2,26325,26326,26328,1,3,0
7501,6,1,26331,26331,26332,0,1,3
7502,4,1,26335,26335,26336,0,1,3
7503,6,1,26341,26341,26342,0,1,5
7504,6,2,26347,26347,26349,0,2,5
7505,4,1,26351,26351,26352,0,1,2
7506,5,1,26356,26356,26357,0,1,4
7507,1,2,26357,26357,26359,0,2,0
7508,5,3,26362,26362,26365,0,3,3
7509,4,2,26366,26366,26368,0,2,1
7510,5,1,26371,26371,26372,0,1,3
7511,1,1,26372,26372,26373,0,1,0
7512,6,2,26378,26378,26380,0,2,5
7513,2,3,26380,26380,26383,0,3,0
7514,5,3,26385,26385,26388,0,3,2
7515,6,2,26391,26391,26393,0,2,3
7516,3,1,26394,26394,26395,0,1,1
7517,5,1,26399,26399,26400,0,1,4
7518,1,1,26400,26400,26401,0,1,0
7519,4,2,26404,26404,26406,0,2,3
7520,1,1,26405,26406,26407,1,2,0
7521,2,3,26407,26407,26410,0,3,0
7522,6,1,26413,26413,26414,0,1,3
7523,3,1,26416,26416,26417,0,1,2
7524,6,1,26422,26422,26423,0,1,5
7525,5,2,26427,26427,26429,0,2,4
7526,1,3,26428,26429,26432,1,4,0
7527,4,3,26432,26432,26435,0,3,0
7528,1,2,26433,26435,26437,2,4,0
7529,6,2,26439,26439,26441,0,2,2
7530,1,3,26440,26441,26444,1,4,0
7531,4,1,26444,26444,26445,0,1,0
7532,1,1,26445,26445,26446,0,1,0
7533,3,3,26448,26448,26451,0,3,2
7534,5,2,26453,26453,26455,0,2,2
7535,4,2,26457,26457,26459,0,2,2
7536,1,1,26458,26459,26460,1,2,0
7537,3,1,26461,26461,26462,0,1,1
7538,1,1,26462,26462,26463,0,1,0
7539,6,2,26468,26468,26470,0,2,5
7540,2,1,26470,26470,26471,0,1,0
7541,3,2,26473,26473,26475,0,2,2
7542,6,2,26479,26479,26481,0,2,4
7543,1,2,26480,26481,26483,1,3,0
7544,4,3,26484,26484,26487,0,3,1
7545,6,3,26490,26490,26493,0,3,3
7546,3,3,26493,26493,26496,0,3,0
7547,3,3,26496,26496,26499,0,3,0
7548,4,1,26500,26500,26501,0,1,1
7549,5,2,26505,26505,26507,0,2,4
7550,5,3,26510,26510,26513,0,3,3
7551,1,1,26511,26513,26514,2,3,0
7552,1,3,26512,26514,26517,2,5,0
7553,2,3,26514,26517,26520,3,6,0
7554,2,3,26516,26520,26523,4,7,0
7555,2,2,26518,26523,26525,5,7,0
7556,3,1,26521,26525,26526,4,5,0
7557,5,1,26526,26526,26527,0,1,0
7558,2,1,26528,26528,26529,0,1,1
7559,4,2,26532,26532,26534,0,2,3
7560,1,1,26533,26534,26535,1,2,0
7561,1,2,26534,26535,26537,1,3,0
7562,3,3,26537,26537,26540,0,3,0
7563,5,1,26542,26542,26543,0,1,2
7564,6,1,26548,26548,26549,0,1,5
7565,4,1,26552,26552,26553,0,1,3
7566,6,2,26558,26558,26560,0,2,5
7567,2,3,26560,26560,26563,0,3,0
7568,4,3,26564,26564,26567,0,3,1
7569,3,3,26567,26567,26570,0,3,0
7570,2,1,26569,26570,26571,1,2,0
7571,2,3,26571,26571,26574,0,3,0
7572,4,1,26575,26575,26576,0,1,1
7573,3,3,26578,26578,26581,0,3,2
7574,5,1,26583,26583,26584,0,1,2
7575,2,2,26585,26585,26587,0,2,1
7576,2,3,26587,26587,26590,0,3,0
7577,6,1,26593,26593,26594,0,1,3
7578,5,2,26598,26598,26600,0,2,4
7579,3,2,26601,26601,26603,0,2,1
7580,3,2,26604,26604,26606,0,2,1
7581,6,2,26610,26610,26612,0,2,4
7582,2,2,26612,26612,26614,0,2,0
7583,4,1,26616,26616,26617,0,1,2
7584,6,2,26622,26622,26624,0,2,5
7585,1,2,26623,26624,26626,1,3,0
7586,5,3,26628,26628,26631,0,3,2
7587,6,1,26634,26634,26635,0,1,3
7588,6,3,26640,26640,26643,0,3,5
7589,6,3,26646,26646,26649,0,3,3
7590,1,1,26647,26649,26650,2,3,0
7591,4,2,26651,26651,26653,0,2,1
7592,1,1,26652,26653,26654,1,2,0
7593,1,1,26653,26654,26655,1,2,0
7594,1,2,26654,26655,26657,1,3,0
7595,3,3,26657,26657,26660,0,3,0
7596,2,3,26659,26660,26663,1,4,0
7597,3,3,26662,26663,26666,1,4,0
7598,6,2,26668,26668,26670,0,2,2
7599,1,2,26669,26670,26672,1,3,0
7600,1,1,26670,26672,26673,2,3,0
7601,5,1,26675,26675,26676,0,1,2
7602,2,1,26677,26677,26678,0,1,1
7603,3,3,26680,26680,26683,0,3,2
7604,3,3,26683,26683,26686,0,3,0
7605,6,2,26689,26689,26691,0,2,3
7606,2,3,26691,26691,26694,0,3,0
7607,1,3,26692,26694,26697,2,5,0
7608,5,1,26697,26697,26698,0,1,0
7609,6,1,26703,26703,26704,0,1,5
7610,4,3,26707,26707,26710,0,3,3
7611,1,3,26708,26710,26713,2,5,0
7612,3,1,26711,26713,26714,2,3,0
7613,1,1,26712,26714,26715,2,3,0
7614,3,2,26715,26715,26717,0,2,0
7615,3,3,26718,26718,26721,0,3,1
7616,5,3,26723,26723,26726,0,3,2
7617,6,1,26729,26729,26730,0,1,3
7618,1,3,26730,26730,26733,0,3,0
7619,1,3,26731,26733,26736,2,5,0
7620,1,2,26732,26736,26738,4,6,0
7621,6,3,26738,26738,26741,0,3,0
7622,5,2,26743,26743,26745,0,2,2
7623,5,3,26748,26748,26751,0,3,3
7624,1,1,26749,26751,26752,2,3,0
7625,3,1,26752,26752,26753,0,1,0
7626,3,3,26755,26755,26758,0,3,2
7627,6,2,26761,26761,26763,0,2,3
7628,4,1,26765,26765,26766,0,1,2
7629,4,1,26769,26769,26770,0,1,3
7630,4,3,26773,26773,26776,0,3,3
7631,5,3,26778,26778,26781,0,3,2
7632,6,2,26784,26784,26786,0,2,3
7633,2,3,26786,26786,26789,0,3,0
7634,4,2,26790,26790,26792,0,2,1
7635,2,2,26792,26792,26794,0,2,0
7636,2,3,26794,26794,26797,0,3,0
7637,1,1,26795,26797,26798,2,3,0
7638,1,2,26796,26798,26800,2,4,0
7639,6,1,26802,26802,26803,0,1,2
7640,1,1,26803,26803,26804,0,1,0
7641,4,3,26807,26807,26810,0,3,3
7642,5,1,26812,26812,26813,0,1,2
7643,6,2,26818,26818,26820,0,2,5
7644,5,2,26823,26823,26825,0,2,3
7645,4,1,26827,26827,26828,0,1,2
7646,4,3,26831,26831,26834,0,3,3
7647,2,2,26833,26834,26836,1,3,0
7648,1,3,26834,26836,26839,2,5,0
7649,6,3,26840,26840,26843,0,3,1
7650,3,1,26843,26843,26844,0,1,0
7651,4,1,26847,26847,26848,0,1,3
7652,3,2,26850,26850,26852,0,2,2
7653,1,1,26851,26852,26853,1,2,0
7654,4,3,26855,26855,26858,0,3,2
7655,3,2,26858,26858,26860,0,2,0
7656,3,1,26861,26861,26862,0,1,1
7657,6,1,26867,26867,26868,0,1,5
7658,1,3,26868,26868,26871,0,3,0
7659,6,1,26874,26874,26875,0,1,3
7660,4,2,26878,26878,26880,0,2,3
7661,6,2,26884,26884,26886,0,2,4
7662,6,1,26890,26890,26891,0,1,4
7663,4,2,26894,26894,26896,0,2,3
7664,2,1,26896,26896,26897,0,1,0
7665,5,2,26901,26901,26903,0,2,4
7666,3,2,26904,26904,26906,0,2,1
7667,6,3,26910,26910,26913,0,3,4
7668,2,2,26912,26913,26915,1,3,0
7669,6,3,26918,26918,26921,0,3,3
7670,2,3,26920,26921,26924,1,4,0
7671,2,2,26922,26924,26926,2,4,0
7672,3,3,26925,26926,26929,1,4,0
7673,6,1,26931,26931,26932,0,1,2
7674,3,1,26934,26934,26935,0,1,2
7675,3,3,26937,26937,26940,0,3,2
7676,3,2,26940,26940,26942,0,2,0
7677,1,1,26941,26942,26943,1,2,0
7678,6,1,26947,26947,26948,0,1,4
7679,4,2,26951,26951,26953,0,2,3
7680,3,3,26954,26954,26957,0,3,1
7681,5,1,26959,26959,26960,0,1,2
7682,5,3,26964,26964,26967,0,3,4
7683,2,3,26966,26967,26970,1,4,0
7684,2,3,26968,26970,26973,2,5,0
7685,4,3,26972,26973,26976,1,4,0
7686,3,1,26975,26976,26977,1,2,0
7687,3,1,26978,26978,26979,0,1,1
7688,6,3,26984,26984,26987,0,3,5
7689,6,3,26990,26990,26993,0,3,3
7690,1,1,26991,26993,26994,2,3,0
7691,4,2,26995,26995,26997,0,2,1
7692,4,2,26999,26999,27001,0,2,2
7693,4,2,27003,27003,27005,0,2,2
7694,4,2,27007,27007,27009,0,2,2
7695,6,3,27013,27013,27016,0,3,4
7696,2,2,27015,27016,27018,1,3,0
7697,2,3,27017,27018,27021,1,4,0
7698,4,1,27021,27021,27022,0,1,0
7699,2,1,27023,27023,27024,0,1,1
7700,6,1,27029,27029,27030,0,1,5
7701,3,2,27032,27032,27034,0,2,2
7702,1,1,27033,27034,27035,1,2,0
7703,2,2,27035,27035,27037,0,2,0
7704,4,2,27039,27039,27041,0,2,2
7705,1,3,27040,27041,27044,1,4,0
7706,4,1,27044,27044,27045,0,1,0
7707,6,3,27050,27050,27053,0,3,5
7708,1,3,27051,27053,27056,2,5,0
7709,5,2,27056,27056,27058,0,2,0
7710,6,2,27062,27062,27064,0,2,4
7711,3,1,27065,27065,27066,0,1,1
7712,1,3,27066,27066,27069,0,3,0
7713,5,1,27071,27071,27072,0,1,2
7714,3,3,27074,27074,27077,0,3,2
7715,3,2,27077,27077,27079,0,2,0
7716,2,3,27079,27079,27082,0,3,0
7717,5,2,27084,27084,27086,0,2,2
7718,1,1,27085,27086,27087,1,2,0
7719,2,3,27087,27087,27090,0,3,0
7720,2,1,27089,27090,27091,1,2,0
7721,5,1,27094,27094,27095,0,1,3
7722,4,3,27098,27098,27101,0,3,3
7723,4,1,27102,27102,27103,0,1,1
7724,1,3,27103,27103,27106,0,3,0
7725,6,2,27109,27109,27111,0,2,3
7726,2,2,27111,27111,27113,0,2,0
7727,3,2,27114,27114,27116,0,2,1
7728,4,3,27118,27118,27121,0,3,2
7729,3,3,27121,27121,27124,0,3,0
7730,6,3,27127,27127,27130,0,3,3
7731,3,1,27130,27130,27131,0,1,0
7732,2,3,27132,27132,27135,0,3,1
7733,3,2,27135,27135,27137,0,2,0
7734,6,1,27141,27141,27142,0,1,4
7735,3,3,27144,27144,27147,0,3,2
7736,2,2,27146,27147,27149,1,3,0
7737,5,2,27151,27151,27153,0,2,2
7738,6,3,27157,27157,27160,0,3,4
7739,1,2,27158,27160,27162,2,4,0
7740,3,1,27161,27162,27163,1,2,0
7741,3,2,27164,27164,27166,0,2,1
7742,6,1,27170,27170,27171,0,1,4
7743,1,2,27171,27171,27173,0,2,0
7744,5,1,27176,27176,27177,0,1,3
7745,5,1,27181,27181,27182,0,1,4
7746,1,1,27182,27182,27183,0,1,0
7747,5,3,27187,27187,27190,0,3,4
7748,4,2,27191,27191,27193,0,2,1
7749,6,2,27197,27197,27199,0,2,4
7750,5,1,27202,27202,27203,0,1,3
7751,5,3,27207,27207,27210,0,3,4
7752,3,1,27210,27210,27211,0,1,0
7753,1,2,27211,27211,27213,0,2,0
7754,3,1,27214,27214,27215,0,1,1
7755,6,2,27220,27220,27222,0,2,5
7756,6,2,27226,27226,27228,0,2,4
7757,5,3,27231,27231,27234,0,3,3
7758,6,2,27237,27237,27239,0,2,3
7759,5,2,27242,27242,27244,0,2,3
7760,4,1,27246,27246,27247,0,1,2
7761,2,2,27248,27248,27250,0,2,1
7762,5,3,27253,27253,27256,0,3,3
7763,6,3,27259,27259,27262,0,3,3
7764,2,3,27261,27262,27265,1,4,0
7765,2,3,27263,27265,27268,2,5,0
7766,4,1,27267,27268,27269,1,2,0
7767,1,3,27268,27269,27272,1,4,0
7768,5,1,27273,27273,27274,0,1,1
7769,3,1,27276,27276,27277,0,1,2
7770,3,1,27279,27279,27280,0,1,2
7771,5,2,27284,27284,27286,0,2,4
7772,6,1,27290,27290,27291,0,1,4
7773,6,3,27296,27296,27299,0,3,5
7774,5,3,27301,27301,27304,0,3,2
7775,3,3,27304,27304,27307,0,3,0
7776,6,2,27310,27310,27312,0,2,3
7777,5,1,27315,27315,27316,0,1,3
7778,1,2,27316,27316,27318,0,2,0
7779,4,3,27320,27320,27323,0,3,2
7780,5,3,27325,27325,27328,0,3,2
7781,1,2,27326,27328,27330,2,4,0
7782,1,3,27327,27330,27333,3,6,0
7783,5,2,27332,27333,27335,1,3,0
7784,6,1,27338,27338,27339,0,1,3
7785,6,3,27344,27344,27347,0,3,5
7786,6,2,27350,27350,27352,0,2,3
7787,5,2,27355,27355,27357,0,2,3
7788,6,3,27361,27361,27364,0,3,4
7789,2,3,27363,27364,27367,1,4,0
7790,6,2,27369,27369,27371,0,2,2
7791,3,2,27372,27372,27374,0,2,1
7792,4,2,27376,27376,27378,0,2,2
7793,6,3,27382,27382,27385,0,3,4
7794,2,2,27384,27385,27387,1,3,0
7795,4,3,27388,27388,27391,0,3,1
7796,2,2,27390,27391,27393,1,3,0
7797,3,2,27393,27393,27395,0,2,0
7798,4,2,27397,27397,27399,0,2,2
7799,4,1,27401,27401,27402,0,1,2
7800,6,1,27407,27407,27408,0,1,5
7801,2,2,27409,27409,27411,0,2,1
7802,6,1,27415,27415,27416,0,1,4
7803,6,1,27421,27421,27422,0,1,5
7804,5,1,27426,27426,27427,0,1,4
7805,3,3,27429,27429,27432,0,3,2
7806,2,2,27431,27432,27434,1,3,0
7807,1,2,27432,27434,27436,2,4,0
7808,5,3,27437,27437,27440,0,3,1
7809,2,2,27439,27440,27442,1,3,0
7810,6,2,27445,27445,27447,0,2,3
7811,5,2,27450,27450,27452,0,2,3
7812,6,3,27456,27456,27459,0,3,4
7813,3,2,27459,27459,27461,0,2,0
7814,6,1,27465,27465,27466,0,1,4
7815,4,3,27469,27469,27472,0,3,3
7816,2,2,27471,27472,27474,1,3,0
7817,2,3,27473,27474,27477,1,4,0
7818,3,3,27476,27477,27480,1,4,0
7819,1,1,27477,27480,27481,3,4,0
7820,3,1,27480,27481,27482,1,2,0
7821,4,2,27484,27484,27486,0,2,2
7822,5,3,27489,27489,27492,0,3,3
7823,1,2,27490,27492,27494,2,4,0
7824,1,1,27491,27494,27495,3,4,0
7825,1,2,27492,27495,27497,3,5,0
7826,5,1,27497,27497,27498,0,1,0
7827,1,3,27498,27498,27501,0,3,0
7828,5,3,27503,27503,27506,0,3,2
7829,3,3,27506,27506,27509,0,3,0
7830,3,3,27509,27509,27512,0,3,0
7831,2,1,27511,27512,27513,1,2,0
7832,1,2,27512,27513,27515,1,3,0
7833,5,3,27517,27517,27520,0,3,2
7834,4,1,27521,27521,27522,0,1,1
7835,3,3,27524,27524,27527,0,3,2
7836,6,3,27530,27530,27533,0,3,3
7837,1,1,27531,27533,27534,2,3,0
7838,3,3,27534,27534,27537,0,3,0
7839,1,3,27535,27537,27540,2,5,0
7840,4,3,27539,27540,27543,1,4,0
7841,4,1,27543,27543,27544,0,1,0
7842,1,2,27544,27544,27546,0,2,0
7843,5,3,27549,27549,27552,0,3,3
7844,1,3,27550,27552,27555,2,5,0
7845,6,3,27556,27556,27559,0,3,1
7846,1,1,27557,27559,27560,2,3,0
7847,3,2,27560,27560,27562,0,2,0
7848,5,1,27565,27565,27566,0,1,3
7849,2,1,27567,27567,27568,0,1,1
7850,2,2,27569,27569,27571,0,2,1
7851,3,1,27572,27572,27573,0,1,1
7852,4,1,27576,27576,27577,0,1,3
7853,4,3,27580,27580,27583,0,3,3
7854,4,2,27584,27584,27586,0,2,1
7855,4,1,27588,27588,27589,0,1,2
7856,4,1,27592,27592,27593,0,1,3
7857,6,3,27598,27598,27601,0,3,5
7858,3,3,27601,27601,27604,0,3,0
7859,1,3,27602,27604,27607,2,5,0
7860,6,3,27608,27608,27611,0,3,1
7861,6,2,27614,27614,27616,0,2,3
7862,6,2,27620,27620,27622,0,2,4
7863,2,2,27622,27622,27624,0,2,0
7864,4,3,27626,27626,27629,0,3,2
7865,5,2,27631,27631,27633,0,2,2
7866,5,2,27636,27636,27638,0,2,3
7867,4,3,27640,27640,27643,0,3,2
7868,3,2,27643,27643,27645,0,2,0
7869,3,3,27646,27646,27649,0,3,1
7870,3,1,27649,27649,27650,0,1,0
7871,2,1,27651,27651,27652,0,1,1
7872,5,3,27656,27656,27659,0,3,4
7873,6,3,27662,27662,27665,0,3,3
7874,2,1,27664,27665,27666,1,2,0
7875,3,3,27667,27667,27670,0,3,1
7876,1,3,27668,27670,27673,2,5,0
7877,5,1,27673,27673,27674,0,1,0
7878,6,1,27679,27679,27680,0,1,5
7879,2,2,27681,27681,27683,0,2,1
7880,6,3,27687,27687,27690,0,3,4
7881,3,2,27690,27690,27692,0,2,0
7882,2,2,27692,27692,27694,0,2,0
7883,5,2,27697,27697,27699,0,2,3
7884,3,1,27700,27700,27701,0,1,1
7885,2,1,27702,27702,27703,0,1,1
7886,1,2,27703,27703,27705,0,2,0
7887,1,1,27704,27705,27706,1,2,0
7888,6,1,27710,27710,27711,0,1,4
7889,4,2,27714,27714,27716,0,2,3
7890,4,1,27718,27718,27719,0,1,2
7891,4,1,27722,27722,27723,0,1,3
7892,3,3,27725,27725,27728,0,3,2
7893,5,3,27730,27730,27733,0,3,2
7894,1,1,27731,27733,27734,2,3,0
7895,2,2,27733,27734,27736,1,3,0
7896,2,1,27735,27736,27737,1,2,0
7897,5,2,27740,27740,27742,0,2,3
7898,6,1,27746,27746,27747,0,1,4
7899,4,2,27750,27750,27752,0,2,3
7900,3,1,27753,27753,27754,0,1,1
7901,1,2,27754,27754,27756,0,2,0
7902,3,3,27757,27757,27760,0,3,1
7903,1,2,27758,27760,27762,2,4,0
7904,6,1,27764,27764,27765,0,1,2
7905,1,1,27765,27765,27766,0,1,0
7906,3,1,27768,27768,27769,0,1,2
7907,6,3,27774,27774,27777,0,3,5
7908,4,1,27778,27778,27779,0,1,1
7909,4,2,27782,27782,27784,0,2,3
7910,4,1,27786,27786,27787,0,1,2
7911,2,2,27788,27788,27790,0,2,1
7912,5,2,27793,27793,27795,0,2,3
7913,1,1,27794,27795,27796,1,2,0
7914,4,1,27798,27798,27799,0,1,2
7915,2,2,27800,27800,27802,0,2,1
7916,1,2,27801,27802,27804,1,3,0
7917,4,3,27805,27805,27808,0,3,1
7918,6,1,27811,27811,27812,0,1,3
7919,4,1,27815,27815,27816,0,1,3
7920,6,1,27821,27821,27822,0,1,5
7921,3,1,27824,27824,27825,0,1,2
7922,5,1,27829,27829,27830,0,1,4
7923,4,1,27833,27833,27834,0,1,3
7924,3,1,27836,27836,27837,0,1,2
7925,2,3,27838,27838,27841,0,3,1
7926,3,2,27841,27841,27843,0,2,0
7927,2,1,27843,27843,27844,0,1,0
7928,4,1,27847,27847,27848,0,1,3
7929,1,2,27848,27848,27850,0,2,0
7930,1,3,27849,27850,27853,1,4,0
7931,4,3,27853,27853,27856,0,3,0
7932,1,1,27854,27856,27857,2,3,0
7933,4,3,27858,27858,27861,0,3,1
7934,4,2,27862,27862,27864,0,2,1
7935,5,1,27867,27867,27868,0,1,3
7936,3,1,27870,27870,27871,0,1,2
7937,2,3,27872,27872,27875,0,3,1
7938,1,2,27873,27875,27877,2,4,0
7939,3,1,27876,27877,27878,1,2,0
7940,5,1,27881,27881,27882,0,1,3
7941,4,1,27885,27885,27886,0,1,3
7942,5,1,27890,27890,27891,0,1,4
7943,4,3,27894,27894,27897,0,3,3
7944,5,1,27899,27899,27900,0,1,2
7945,1,3,27900,27900,27903,0,3,0
7946,3,3,27903,27903,27906,0,3,0
7947,6,1,27909,27909,27910,0,1,3
7948,2,2,27911,27911,27913,0,2,1
7949,4,1,27915,27915,27916,0,1,2
7950,3,2,27918,27918,27920,0,2,2
7951,5,2,27923,27923,27925,0,2,3
7952,1,3,27924,27925,27928,1,4,0
7953,2,2,27926,27928,27930,2,4,0
7954,2,2,27928,27930,27932,2,4,0
7955,3,1,27931,27932,27933,1,2,0
7956,1,3,27932,27933,27936,1,4,0
7957,5,2,27937,27937,27939,0,2,1
7958,1,1,27938,27939,27940,1,2,0
7959,4,1,27942,27942,27943,0,1,2
7960,3,3,27945,27945,27948,0,3,2
7961,1,3,27946,27948,27951,2,5,0
7962,2,1,27948,27951,27952,3,4,0
7963,4,1,27952,27952,27953,0,1,0
7964,3,2,27955,27955,27957,0,2,2
7965,4,1,27959,27959,27960,0,1,2
7966,6,1,27965,27965,27966,0,1,5
7967,6,3,27971,27971,27974,0,3,5
7968,2,2,27973,27974,27976,1,3,0
7969,6,2,27979,27979,27981,0,2,3
7970,4,2,27983,27983,27985,0,2,2
7971,1,3,27984,27985,27988,1,4,0
7972,2,2,27986,27988,27990,2,4,0
7973,1,3,27987,27990,27993,3,6,0
7974,4,1,27991,27993,27994,2,3,0
7975,6,3,27997,27997,28000,0,3,3
7976,3,3,28000,28000,28003,0,3,0
7977,3,3,28003,28003,28006,0,3,0
7978,3,3,28006,28006,28009,0,3,0
7979,2,2,28008,28009,28011,1,3,0
7980,1,2,28009,28011,28013,2,4,0
7981,5,3,28014,28014,28017,0,3,1
7982,3,1,28017,28017,28018,0,1,0
7983,5,2,28022,28022,28024,0,2,4
7984,6,3,28028,28028,28031,0,3,4
7985,6,2,28034,28034,28036,0,2,3
7986,6,1,28040,28040,28041,0,1,4
7987,2,2,28042,28042,28044,0,2,1
7988,1,3,28043,28044,28047,1,4,0
7989,4,3,28047,28047,28050,0,3,0
7990,5,3,28052,28052,28055,0,3,2
7991,3,1,28055,28055,28056,0,1,0
7992,1,2,28056,28056,28058,0,2,0
7993,1,1,28057,28058,28059,1,2,0
7994,6,2,28063,28063,28065,0,2,4
7995,4,1,28067,28067,28068,0,1,2
7996,1,3,28068,28068,28071,0,3,0
7997,4,2,28072,28072,28074,0,2,1
7998,5,3,28077,28077,28080,0,3,3
7999,5,1,28082,28082,28083,0,1,2
8000,1,1,28083,28083,28084,0,1,0
8001,3,2,28086,28086,28088,0,2,2
8002,3,3,28089,28089,28092,0,3,1
8003,2,3,28091,28092,28095,1,4,0
8004,6,3,28097,28097,28100,0,3,2
8005,6,3,28103,28103,28106,0,3,3
8006,5,2,28108,28108,28110,0,2,2
8007,3,3,28111,28111,28114,0,3,1
8008,6,1,28117,28117,28118,0,1,3
8009,6,3,28123,28123,28126,0,3,5
8010,3,2,28126,28126,28128,0,2,0
8011,1,1,28127,28128,28129,1,2,0
8012,6,2,28133,28133,28135,0,2,4
8013,5,1,28138,28138,28139,0,1,3
8014,2,1,28140,28140,28141,0,1,1
8015,1,2,28141,28141,28143,0,2,0
8016,4,3,28145,28145,28148,0,3,2
8017,6,2,28151,28151,28153,0,2,3
8018,4,1,28155,28155,28156,0,1,2
8019,6,3,28161,28161,28164,0,3,5
8020,2,3,28163,28164,28167,1,4,0
8021,1,1,28164,28167,28168,3,4,0
8022,3,1,28167,28168,28169,1,2,0
8023,2,2,28169,28169,28171,0,2,0
8024,2,1,28171,28171,28172,0,1,0
8025,6,2,28177,28177,28179,0,2,5
8026,6,3,28183,28183,28186,0,3,4
8027,6,2,28189,28189,28191,0,2,3
8028,1,1,28190,28191,28192,1,2,0
8029,6,2,28196,28196,28198,0,2,4
8030,3,3,28199,28199,28202,0,3,1
8031,5,3,28204,28204,28207,0,3,2
8032,2,2,28206,28207,28209,1,3,0
8033,6,1,28212,28212,28213,0,1,3
8034,2,1,28214,28214,28215,0,1,1
8035,1,3,28215,28215,28218,0,3,0
8036,6,3,28221,28221,28224,0,3,3
8037,5,3,28226,28226,28229,0,3,2
8038,2,1,28228,28229,28230,1,2,0
8039,6,2,28234,28234,28236,0,2,4
8040,5,2,28239,28239,28241,0,2,3
8041,1,1,28240,28241,28242,1,2,0
8042,2,2,28242,28242,28244,0,2,0
8043,1,2,28243,28244,28246,1,3,0
8044,3,1,28246,28246,28247,0,1,0
8045,1,2,28247,28247,28249,0,2,0
8046,3,3,28250,28250,28253,0,3,1
8047,4,1,28254,28254,28255,0,1,1
8048,4,3,28258,28258,28261,0,3,3
8049,4,1,28262,28262,28263,0,1,1
8050,4,2,28266,28266,28268,0,2,3
8051,3,1,28269,28269,28270,0,1,1
8052,6,2,28275,28275,28277,0,2,5
8053,5,1,28280,28280,28281,0,1,3
8054,3,1,28283,28283,28284,0,1,2
8055,4,1,28287,28287,28288,0,1,3
8056,4,1,28291,28291,28292,0,1,3
8057,2,1,28293,28293,28294,0,1,1
8058,1,1,28294,28294,28295,0,1,0
8059,6,2,28300,28300,28302,0,2,5
8060,4,3,28304,28304,28307,0,3,2
8061,2,1,28306,28307,28308,1,2,0
8062,4,1,28310,28310,28311,0,1,2
8063,5,2,28315,28315,28317,0,2,4
8064,4,2,28319,28319,28321,0,2,2
8065,6,3,28325,28325,28328,0,3,4
8066,1,1,28326,28328,28329,2,3,0
8067,5,2,28331,28331,28333,0,2,2
8068,4,1,28335,28335,28336,0,1,2
8069,5,1,28340,28340,28341,0,1,4
8070,5,2,28345,28345,28347,0,2,4
8071,2,3,28347,28347,28350,0,3,0
8072,3,1,28350,28350,28351,0,1,0
8073,6,1,28356,28356,28357,0,1,5
8074,5,2,28361,28361,28363,0,2,4
8075,3,2,28364,28364,28366,0,2,1
8076,6,1,28370,28370,28371,0,1,4
8077,6,2,28376,28376,28378,0,2,5
8078,1,1,28377,28378,28379,1,2,0
8079,1,3,28378,28379,28382,1,4,0
8080,2,1,28380,28382,28383,2,3,0
8081,6,3,28386,28386,28389,0,3,3
8082,4,3,28390,28390,28393,0,3,1
8083,4,2,28394,28394,28396,0,2,1
8084,2,1,28396,28396,28397,0,1,0
8085,1,3,28397,28397,28400,0,3,0
8086,1,2,28398,28400,28402,2,4,0
8087,3,1,28401,28402,28403,1,2,0
8088,4,2,28405,28405,28407,0,2,2
8089,5,3,28410,28410,28413,0,3,3
8090,4,3,28414,28414,28417,0,3,1
8091,4,1,28418,28418,28419,0,1,1
8092,6,1,28424,28424,28425,0,1,5
8093,2,1,28426,28426,28427,0,1,1
8094,5,3,28431,28431,28434,0,3,4
8095,2,3,28433,28434,28437,1,4,0
8096,3,3,28436,28437,28440,1,4,0
8097,4,3,28440,28440,28443,0,3,0
8098,4,1,28444,28444,28445,0,1,1
8099,6,2,28450,28450,28452,0,2,5
8100,4,3,28454,28454,28457,0,3,2
8101,5,3,28459,28459,28462,0,3,2
8102,6,2,28465,28465,28467,0,2,3
8103,1,2,28466,28467,28469,1,3,0
8104,6,2,28472,28472,28474,0,2,3
8105,3,1,28475,28475,28476,0,1,1
8106,2,1,28477,28477,28478,0,1,1
8107,5,1,28482,28482,28483,0,1,4
8108,6,3,28488,28488,28491,0,3,5
8109,3,3,28491,28491,28494,0,3,0
8110,6,1,28497,28497,28498,0,1,3
8111,2,2,28499,28499,28501,0,2,1
8112,5,3,28504,28504,28507,0,3,3
8113,1,2,28505,28507,28509,2,4,0
8114,1,1,28506,28509,28510,3,4,0
8115,6,2,28512,28512,28514,0,2,2
8116,2,1,28514,28514,28515,0,1,0
8117,2,1,28516,28516,28517,0,1,1
8118,1,3,28517,28517,28520,0,3,0
8119,4,3,28521,28521,28524,0,3,1
8120,2,1,28523,28524,28525,1,2,0
8121,2,3,28525,28525,28528,0,3,0
8122,6,2,28531,28531,28533,0,2,3
8123,6,3,28537,28537,28540,0,3,4
8124,5,2,28542,28542,28544,0,2,2
8125,3,3,28545,28545,28548,0,3,1
8126,5,3,28550,28550,28553,0,3,2
8127,2,2,28552,28553,28555,1,3,0
8128,3,3,28555,28555,28558,0,3,0
8129,1,1,28556,28558,28559,2,3,0
8130,4,2,28560,28560,28562,0,2,1
8131,3,2,28563,28563,28565,0,2,1
8132,1,3,28564,28565,28568,1,4,0
8133,3,1,28567,28568,28569,1,2,0
8134,6,2,28573,28573,28575,0,2,4
8135,2,1,28575,28575,28576,0,1,0
8136,4,3,28579,28579,28582,0,3,3
8137,2,3,28581,28582,28585,1,4,0
8138,6,3,28587,28587,28590,0,3,2
8139,5,3,28592,28592,28595,0,3,2
8140,3,1,28595,28595,28596,0,1,0
8141,6,1,28601,28601,28602,0,1,5
8142,6,1,28607,28607,28608,0,1,5
8143,4,1,28611,28611,28612,0,1,3
8144,3,2,28614,28614,28616,0,2,2
8145,6,2,28620,28620,28622,0,2,4
8146,3,2,28623,28623,28625,0,2,1
8147,2,1,28625,28625,28626,0,1,0
8148,2,1,28627,28627,28628,0,1,1
8149,1,3,28628,28628,28631,0,3,0
8150,2,3,28630,28631,28634,1,4,0
8151,5,1,28635,28635,28636,0,1,1
8152,4,3,28639,28639,28642,0,3,3
8153,6,1,28645,28645,28646,0,1,3
8154,4,3,28649,28649,28652,0,3,3
8155,4,2,28653,28653,28655,0,2,1
8156,4,3,28657,28657,28660,0,3,2
8157,2,3,28659,28660,28663,1,4,0
8158,6,2,28665,28665,28667,0,2,2
8159,6,3,28671,28671,28674,0,3,4
8160,1,1,28672,28674,28675,2,3,0
8161,4,2,28676,28676,28678,0,2,1
8162,4,3,28680,28680,28683,0,3,2
8163,4,3,28684,28684,28687,0,3,1
8164,4,1,28688,28688,28689,0,1,1
8165,1,2,28689,28689,28691,0,2,0
8166,3,3,28692,28692,28695,0,3,1
8167,5,3,28697,28697,28700,0,3,2
8168,2,2,28699,28700,28702,1,3,0
8169,5,1,28704,28704,28705,0,1,2
8170,1,1,28705,28705,28706,0,1,0
8171,1,1,28706,28706,28707,0,1,0
8172,1,2,28707,28707,28709,0,2,0
8173,3,3,28710,28710,28713,0,3,1
8174,3,2,28713,28713,28715,0,2,0
8175,5,3,28718,28718,28721,0,3,3
8176,6,3,28724,28724,28727,0,3,3
8177,4,1,28728,28728,28729,0,1,1
8178,1,3,28729,28729,28732,0,3,0
8179,6,1,28735,28735,28736,0,1,3
8180,4,3,28739,28739,28742,0,3,3
8181,6,1,28745,28745,28746,0,1,3
8182,2,3,28747,28747,28750,0,3,1
8183,2,2,28749,28750,28752,1,3,0
8184,3,1,28752,28752,28753,0,1,0
8185,1,1,28753,28753,28754,0,1,0
8186,3,2,28756,28756,28758,0,2,2
8187,2,3,28758,28758,28761,0,3,0
8188,3,2,28761,28761,28763,0,2,0
8189,2,3,28763,28763,28766,0,3,0
8190,2,1,28765,28766,28767,1,2,0
8191,6,1,28771,28771,28772,0,1,4
8192,6,3,28777,28777,28780,0,3,5
8193,3,3,28780,28780,28783,0,3,0
8194,1,1,28781,28783,28784,2,3,0
8195,3,3,28784,28784,28787,0,3,0
8196,6,2,28790,28790,28792,0,2,3
8197,6,2,28796,28796,28798,0,2,4
8198,3,3,28799,28799,28802,0,3,1
8199,6,3,28805,28805,28808,0,3,3
8200,2,2,28807,28808,28810,1,3,0
8201,5,2,28812,28812,28814,0,2,2
8202,3,2,28815,28815,28817,0,2,1
8203,2,3,28817,28817,28820,0,3,0
8204,5,1,28822,28822,28823,0,1,2
8205,4,3,28826,28826,28829,0,3,3
8206,4,2,28830,28830,28832,0,2,1
8207,2,3,28832,28832,28835,0,3,0
8208,2,1,28834,28835,28836,1,2,0
8209,1,2,28835,28836,28838,1,3,0
8210,3,2,28838,28838,28840,0,2,0
8211,3,3,28841,28841,28844,0,3,1
8212,2,2,28843,28844,28846,1,3,0
8213,2,1,28845,28846,28847,1,2,0
8214,1,2,28846,28847,28849,1,3,0
8215,1,2,28847,28849,28851,2,4,0
8216,1,3,28848,28851,28854,3,6,0
8217,5,3,28853,28854,28857,1,4,0
8218,3,2,28856,28857,28859,1,3,0
8219,1,3,28857,28859,28862,2,5,0
8220,1,3,28858,28862,28865,4,7,0
8221,4,2,28862,28865,28867,3,5,0
8222,1,3,28863,28867,28870,4,7,0
8223,2,3,28865,28870,28873,5,8,0
8224,4,1,28869,28873,28874,4,5,0
8225,3,1,28872,28874,28875,2,3,0
8226,4,1,28876,28876,28877,0,1,1
8227,4,2,28880,28880,28882,0,2,3
8228,4,3,28884,28884,28887,0,3,2
8229,5,2,28889,28889,28891,0,2,2
8230,3,1,28892,28892,28893,0,1,1
8231,1,2,28893,28893,28895,0,2,0
8232,3,1,28896,28896,28897,0,1,1
8233,3,3,28899,28899,28902,0,3,2
8234,1,3,28900,28902,28905,2,5,0
8235,5,3,28905,28905,28908,0,3,0
8236,2,1,28907,28908,28909,1,2,0
8237,2,3,28909,28909,28912,0,3,0
8238,1,3,28910,28912,28915,2,5,0
8239,6,3,28916,28916,28919,0,3,1
8240,5,1,28921,28921,28922,0,1,2
8241,5,2,28926,28926,28928,0,2,4
8242,4,3,28930,28930,28933,0,3,2
8243,6,2,28936,28936,28938,0,2,3
8244,2,1,28938,28938,28939,0,1,0
8245,1,3,28939,28939,28942,0,3,0
8246,5,1,28944,28944,28945,0,1,2
8247,2,2,28946,28946,28948,0,2,1
8248,2,1,28948,28948,28949,0,1,0
8249,1,3,28949,28949,28952,0,3,0
8250,2,3,28951,28952,28955,1,4,0
8251,6,1,28957,28957,28958,0,1,2
8252,2,1,28959,28959,28960,0,1,1
8253,1,3,28960,28960,28963,0,3,0
8254,4,1,28964,28964,28965,0,1,1
8255,6,3,28970,28970,28973,0,3,5
8256,2,2,28972,28973,28975,1,3,0
8257,4,1,28976,28976,28977,0,1,1
8258,2,1,28978,28978,28979,0,1,1
8259,3,2,28981,28981,28983,0,2,2
8260,3,1,28984,28984,28985,0,1,1
8261,5,1,28989,28989,28990,0,1,4
8262,4,3,28993,28993,28996,0,3,3
8263,4,3,28997,28997,29000,0,3,1
8264,5,1,29002,29002,29003,0,1,2
8265,4,1,29006,29006,29007,0,1,3
8266,3,1,29009,29009,29010,0,1,2
8267,2,3,29011,29011,29014,0,3,1
8268,4,2,29015,29015,29017,0,2,1
8269,5,3,29020,29020,29023,0,3,3
8270,4,1,29024,29024,29025,0,1,1
8271,4,1,29028,29028,29029,0,1,3
8272,2,1,29030,29030,29031,0,1,1
8273,2,2,29032,29032,29034,0,2,1
8274,6,1,29038,29038,29039,0,1,4
8275,5,2,29043,29043,29045,0,2,4
8276,4,1,29047,29047,29048,0,1,2
8277,6,3,29053,29053,29056,0,3,5
8278,1,1,29054,29056,29057,2,3,0
8279,1,1,29055,29057,29058,2,3,0
8280,4,2,29059,29059,29061,0,2,1
8281,2,2,29061,29061,29063,0,2,0
8282,5,2,29066,29066,29068,0,2,3
8283,4,2,29070,29070,29072,0,2,2
8284,5,2,29075,29075,29077,0,2,3
8285,1,2,29076,29077,29079,1,3,0
8286,4,2,29080,29080,29082,0,2,1
8287,1,1,29081,29082,29083,1,2,0
8288,4,2,29085,29085,29087,0,2,2
8289,4,2,29089,29089,29091,0,2,2
8290,2,2,29091,29091,29093,0,2,0
8291,5,1,29096,29096,29097,0,1,3
8292,4,3,29100,29100,29103,0,3,3
8293,3,3,29103,29103,29106,0,3,0
8294,5,3,29108,29108,29111,0,3,2
8295,3,1,29111,29111,29112,0,1,0
8296,4,3,29115,29115,29118,0,3,3
8297,6,1,29121,29121,29122,0,1,3
8298,4,1,29125,29125,29126,0,1,3
8299,6,1,29131,29131,29132,0,1,5
8300,6,3,29137,29137,29140,0,3,5
8301,2,1,29139,29140,29141,1,2,0
8302,2,1,29141,29141,29142,0,1,0
8303,2,2,29143,29143,29145,0,2,1
8304,1,1,29144,29145,29146,1,2,0
8305,3,3,29147,29147,29150,0,3,1
8306,6,2,29153,29153,29155,0,2,3
8307,2,2,29155,29155,29157,0,2,0
8308,2,3,29157,29157,29160,0,3,0
8309,2,3,29159,29160,29163,1,4,0
8310,1,1,29160,29163,29164,3,4,0
8311,2,1,29162,29164,29165,2,3,0
8312,5,1,29167,29167,29168,0,1,2
8313,3,3,29170,29170,29173,0,3,2
8314,3,1,29173,29173,29174,0,1,0
8315,2,3,29175,29175,29178,0,3,1
8316,6,3,29181,29181,29184,0,3,3
8317,6,3,29187,29187,29190,0,3,3
8318,4,1,29191,29191,29192,0,1,1
8319,6,2,29197,29197,29199,0,2,5
8320,1,1,29198,29199,29200,1,2,0
8321,4,2,29202,29202,29204,0,2,2
8322,6,2,29208,29208,29210,0,2,4
8323,1,2,29209,29210,29212,1,3,0
8324,1,1,29210,29212,29213,2,3,0
8325,6,1,29216,29216,29217,0,1,3
8326,1,1,29217,29217,29218,0,1,0
8327,3,2,29220,29220,29222,0,2,2
8328,2,2,29222,29222,29224,0,2,0
8329,2,2,29224,29224,29226,0,2,0
8330,3,2,29227,29227,29229,0,2,1
8331,4,2,29231,29231,29233,0,2,2
8332,6,1,29237,29237,29238,0,1,4
8333,2,2,29239,29239,29241,0,2,1
8334,1,3,29240,29241,29244,1,4,0
8335,4,3,29244,29244,29247,0,3,0
8336,3,2,29247,29247,29249,0,2,0
8337,4,2,29251,29251,29253,0,2,2
8338,5,2,29256,29256,29258,0,2,3
8339,6,3,29262,29262,29265,0,3,4
8340,2,2,29264,29265,29267,1,3,0
8341,3,2,29267,29267,29269,0,2,0
8342,4,1,29271,29271,29272,0,1,2
8343,2,3,29273,29273,29276,0,3,1
8344,2,2,29275,29276,29278,1,3,0
8345,2,1,29277,29278,29279,1,2,0
8346,5,2,29282,29282,29284,0,2,3
8347,4,1,29286,29286,29287,0,1,2
8348,5,3,29291,29291,29294,0,3,4
8349,4,2,29295,29295,29297,0,2,1
8350,6,2,29301,29301,29303,0,2,4
8351,5,2,29306,29306,29308,0,2,3
8352,1,3,29307,29308,29311,1,4,0
8353,5,2,29312,29312,29314,0,2,1
8354,6,2,29318,29318,29320,0,2,4
8355,3,3,29321,29321,29324,0,3,1
8356,5,3,29326,29326,29329,0,3,2
8357,3,3,29329,29329,29332,0,3,0
8358,3,1,29332,29332,29333,0,1,0
8359,5,3,29337,29337,29340,0,3,4
8360,4,2,29341,29341,29343,0,2,1
8361,4,1,29345,29345,29346,0,1,2
8362,1,1,29346,29346,29347,0,1,0
8363,5,1,29351,29351,29352,0,1,4
8364,3,1,29354,29354,29355,0,1,2
8365,1,3,29355,29355,29358,0,3,0
8366,2,2,29357,29358,29360,1,3,0
8367,6,2,29363,29363,29365,0,2,3
8368,6,2,29369,29369,29371,0,2,4
8369,6,3,29375,29375,29378,0,3,4
8370,4,3,29379,29379,29382,0,3,1
8371,2,3,29381,29382,29385,1,4,0
8372,5,2,29386,29386,29388,0,2,1
8373,4,1,29390,29390,29391,0,1,2
8374,6,1,29396,29396,29397,0,1,5
8375,4,1,29400,29400,29401,0,1,3
8376,6,1,29406,29406,29407,0,1,5
8377,4,3,29410,29410,29413,0,3,3
8378,2,2,29412,29413,29415,1,3,0
8379,5,1,29417,29417,29418,0,1,2
8380,3,2,29420,29420,29422,0,2,2
8381,5,3,29425,29425,29428,0,3,3
8382,1,2,29426,29428,29430,2,4,0
8383,6,3,29432,29432,29435,0,3,2
8384,6,3,29438,29438,29441,0,3,3
8385,4,1,29442,29442,29443,0,1,1
8386,2,1,29444,29444,29445,0,1,1
8387,2,2,29446,29446,29448,0,2,1
8388,5,3,29451,29451,29454,0,3,3
8389,1,2,29452,29454,29456,2,4,0
8390,5,1,29457,29457,29458,0,1,1
8391,3,1,29460,29460,29461,0,1,2
8392,5,1,29465,29465,29466,0,1,4
8393,2,1,29467,29467,29468,0,1,1
8394,2,3,29469,29469,29472,0,3,1
8395,6,2,29475,29475,29477,0,2,3
8396,3,2,29478,29478,29480,0,2,1
8397,1,2,29479,29480,29482,1,3,0
8398,4,3,29483,29483,29486,0,3,1
8399,5,2,29488,29488,29490,0,2,2
8400,3,3,29491,29491,29494,0,3,1
8401,4,3,29495,29495,29498,0,3,1
8402,5,2,29500,29500,29502,0,2,2
8403,1,2,29501,29502,29504,1,3,0
8404,3,2,29504,29504,29506,0,2,0
8405,5,3,29509,29509,29512,0,3,3
8406,5,2,29514,29514,29516,0,2,2
8407,5,1,29519,29519,29520,0,1,3
8408,2,3,29521,29521,29524,0,3,1
8409,4,2,29525,29525,29527,0,2,1
8410,4,1,29529,29529,29530,0,1,2
8411,2,1,29531,29531,29532,0,1,1
8412,6,2,29537,29537,29539,0,2,5
8413,6,3,29543,29543,29546,0,3,4
8414,6,2,29549,29549,29551,0,2,3
8415,5,2,29554,29554,29556,0,2,3
8416,3,2,29557,29557,29559,0,2,1
8417,1,1,29558,29559,29560,1,2,0
8418,2,3,29560,29560,29563,0,3,0
8419,2,2,29562,29563,29565,1,3,0
8420,4,2,29566,29566,29568,0,2,1
8421,6,3,29572,29572,29575,0,3,4
8422,4,2,29576,29576,29578,0,2,1
8423,2,3,29578,29578,29581,0,3,0
8424,6,2,29584,29584,29586,0,2,3
8425,1,3,29585,29586,29589,1,4,0
8426,6,2,29591,29591,29593,0,2,2
8427,6,2,29597,29597,29599,0,2,4
8428,3,2,29600,29600,29602,0,2,1
8429,1,3,29601,29602,29605,1,4,0
8430,6,3,29607,29607,29610,0,3,2
8431,4,2,29611,29611,29613,0,2,1
8432,5,1,29616,29616,29617,0,1,3
8433,2,1,29618,29618,29619,0,1,1
8434,6,1,29624,29624,29625,0,1,5
8435,3,1,29627,29627,29628,0,1,2
8436,4,3,29631,29631,29634,0,3,3
8437,3,3,29634,29634,29637,0,3,0
8438,4,3,29638,29638,29641,0,3,1
8439,2,1,29640,29641,29642,1,2,0
8440,4,2,29644,29644,29646,0,2,2
8441,2,1,29646,29646,29647,0,1,0
8442,2,3,29648,29648,29651,0,3,1
8443,2,1,29650,29651,29652,1,2,0
8444,4,2,29654,29654,29656,0,2,2
8445,5,3,29659,29659,29662,0,3,3
8446,2,2,29661,29662,29664,1,3,0
8447,1,3,29662,29664,29667,2,5,0
8448,1,1,29663,29667,29668,4,5,0
8449,2,3,29665,29668,29671,3,6,0
8450,5,3,29670,29671,29674,1,4,0
8451,5,1,29675,29675,29676,0,1,1
8452,2,1,29677,29677,29678,0,1,1
8453,3,1,29680,29680,29681,0,1,2
8454,1,3,29681,29681,29684,0,3,0
8455,2,1,29683,29684,29685,1,2,0
8456,1,2,29684,29685,29687,1,3,0
8457,1,1,29685,29687,29688,2,3,0
8458,4,1,29689,29689,29690,0,1,1
8459,5,3,29694,29694,29697,0,3,4
8460,4,3,29698,29698,29701,0,3,1
8461,4,1,29702,29702,29703,0,1,1
8462,2,2,29704,29704,29706,0,2,1
8463,6,2,29710,29710,29712,0,2,4
8464,5,3,29715,29715,29718,0,3,3
8465,2,2,29717,29718,29720,1,3,0
8466,6,1,29723,29723,29724,0,1,3
8467,1,2,29724,29724,29726,0,2,0
8468,6,3,29730,29730,29733,0,3,4
8469,3,2,29733,29733,29735,0,2,0
8470,2,3,29735,29735,29738,0,3,0
8471,2,1,29737,29738,29739,1,2,0
8472,2,2,29739,29739,29741,0,2,0
8473,1,1,29740,29741,29742,1,2,0
8474,3,1,29743,29743,29744,0,1,1
8475,2,2,29745,29745,29747,0,2,1
8476,6,2,29751,29751,29753,0,2,4
8477,3,2,29754,29754,29756,0,2,1
8478,5,2,29759,29759,29761,0,2,3
8479,4,2,29763,29763,29765,0,2,2
8480,5,1,29768,29768,29769,0,1,3
8481,6,2,29774,29774,29776,0,2,5
8482,6,2,29780,29780,29782,0,2,4
8483,4,1,29784,29784,29785,0,1,2
8484,3,3,29787,29787,29790,0,3,2
8485,6,3,29793,29793,29796,0,3,3
8486,2,1,29795,29796,29797,1,2,0
8487,6,2,29801,29801,29803,0,2,4
8488,1,2,29802,29803,29805,1,3,0
8489,1,3,29803,29805,29808,2,5,0
8490,4,2,29807,29808,29810,1,3,0
8491,4,1,29811,29811,29812,0,1,1
8492,3,2,29814,29814,29816,0,2,2
8493,5,1,29819,29819,29820,0,1,3
8494,6,3,29825,29825,29828,0,3,5
8495,6,1,29831,29831,29832,0,1,3
8496,1,3,29832,29832,29835,0,3,0
8497,4,2,29836,29836,29838,0,2,1
8498,4,3,29840,29840,29843,0,3,2
8499,2,3,29842,29843,29846,1,4,0
8500,4,3,29846,29846,29849,0,3,0
8501,5,2,29851,29851,29853,0,2,2
8502,4,2,29855,29855,29857,0,2,2
8503,2,1,29857,29857,29858,0,1,0
8504,2,1,29859,29859,29860,0,1,1
8505,4,3,29863,29863,29866,0,3,3
8506,1,1,29864,29866,29867,2,3,0
8507,4,2,29868,29868,29870,0,2,1
8508,5,1,29873,29873,29874,0,1,3
8509,2,2,29875,29875,29877,0,2,1
8510,6,3,29881,29881,29884,0,3,4
8511,3,2,29884,29884,29886,0,2,0
8512,6,3,29890,29890,29893,0,3,4
8513,3,3,29893,29893,29896,0,3,0
8514,3,1,29896,29896,29897,0,1,0
8515,5,2,29901,29901,29903,0,2,4
8516,2,2,29903,29903,29905,0,2,0
8517,2,3,29905,29905,29908,0,3,0
8518,2,3,29907,29908,29911,1,4,0
8519,6,3,29913,29913,29916,0,3,2
8520,2,3,29915,29916,29919,1,4,0
8521,6,1,29921,29921,29922,0,1,2
8522,2,3,29923,29923,29926,0,3,1
8523,1,2,29924,29926,29928,2,4,0
8524,3,3,29927,29928,29931,1,4,0
8525,1,1,29928,29931,29932,3,4,0
8526,6,1,29934,29934,29935,0,1,2
8527,6,2,29940,29940,29942,0,2,5
8528,4,1,29944,29944,29945,0,1,2
8529,1,3,29945,29945,29948,0,3,0
8530,1,3,29946,29948,29951,2,5,0
8531,1,1,29947,29951,29952,4,5,0
8532,5,2,29952,29952,29954,0,2,0
8533,1,2,29953,29954,29956,1,3,0
8534,3,3,29956,29956,29959,0,3,0
8535,5,3,29961,29961,29964,0,3,2
8536,3,1,29964,29964,29965,0,1,0
8537,4,2,29968,29968,29970,0,2,3
8538,6,3,29974,29974,29977,0,3,4
8539,1,1,29975,29977,29978,2,3,0
8540,3,1,29978,29978,29979,0,1,0
8541,5,2,29983,29983,29985,0,2,4
8542,6,3,29989,29989,29992,0,3,4
8543,2,2,29991,29992,29994,1,3,0
8544,5,2,29996,29996,29998,0,2,2
8545,3,1,29999,29999,30000,0,1,1
8546,2,1,30001,30001,30002,0,1,1
8547,5,1,30006,30006,30007,0,1,4
8548,3,3,30009,30009,30012,0,3,2
8549,6,3,30015,30015,30018,0,3,3
8550,4,2,30019,30019,30021,0,2,1
8551,1,2,30020,30021,30023,1,3,0
8552,4,3,30024,30024,30027,0,3,1
8553,6,1,30030,30030,30031,0,1,3
8554,1,3,30031,30031,30034,0,3,0
8555,5,2,30036,30036,30038,0,2,2
8556,2,2,30038,30038,30040,0,2,0
8557,1,2,30039,30040,30042,1,3,0
8558,3,1,30042,30042,30043,0,1,0
8559,6,2,30048,30048,30050,0,2,5
8560,2,3,30050,30050,30053,0,3,0
8561,3,1,30053,30053,30054,0,1,0
8562,2,2,30055,30055,30057,0,2,1
8563,1,3,30056,30057,30060,1,4,0
8564,2,3,30058,30060,30063,2,5,0
8565,5,3,30063,30063,30066,0,3,0
8566,6,1,30069,30069,30070,0,1,3
8567,5,2,30074,30074,30076,0,2,4
8568,3,2,30077,30077,30079,0,2,1
8569,6,3,30083,30083,30086,0,3,4
8570,2,2,30085,30086,30088,1,3,0
8571,1,3,30086,30088,30091,2,5,0
8572,5,2,30091,30091,30093,0,2,0
8573,2,2,30093,30093,30095,0,2,0
8574,6,1,30099,30099,30100,0,1,4
8575,4,2,30103,30103,30105,0,2,3
8576,5,1,30108,30108,30109,0,1,3
8577,4,2,30112,30112,30114,0,2,3
8578,4,3,30116,30116,30119,0,3,2
8579,4,3,30120,30120,30123,0,3,1
8580,6,1,30126,30126,30127,0,1,3
8581,1,3,30127,30127,30130,0,3,0
8582,3,1,30130,30130,30131,0,1,0
8583,3,3,30133,30133,30136,0,3,2
8584,6,1,30139,30139,30140,0,1,3
8585,6,3,30145,30145,30148,0,3,5
8586,4,3,30149,30149,30152,0,3,1
8587,4,3,30153,30153,30156,0,3,1
8588,4,1,30157,30157,30158,0,1,1
8589,3,2,30160,30160,30162,0,2,2
8590,6,3,30166,30166,30169,0,3,4
8591,1,1,30167,30169,30170,2,3,0
8592,4,2,30171,30171,30173,0,2,1
8593,5,3,30176,30176,30179,0,3,3
8594,5,1,30181,30181,30182,0,1,2
8595,5,2,30186,30186,30188,0,2,4
8596,1,1,30187,30188,30189,1,2,0
8597,1,3,30188,30189,30192,1,4,0
8598,2,3,30190,30192,30195,2,5,0
8599,3,1,30193,30195,30196,2,3,0
8600,6,2,30199,30199,30201,0,2,3
8601,2,1,30201,30201,30202,0,1,0
8602,4,2,30205,30205,30207,0,2,3
8603,6,1,30211,30211,30212,0,1,4
8604,1,2,30212,30212,30214,0,2,0
8605,6,1,30218,30218,30219,0,1,4
8606,2,1,30220,30220,30221,0,1,1
8607,2,2,30222,30222,30224,0,2,1
8608,6,2,30228,30228,30230,0,2,4
8609,1,2,30229,30230,30232,1,3,0
8610,6,2,30235,30235,30237,0,2,3
8611,4,3,30239,30239,30242,0,3,2
8612,2,1,30241,30242,30243,1,2,0
8613,4,1,30245,30245,30246,0,1,2
8614,3,1,30248,30248,30249,0,1,2
8615,3,2,30251,30251,30253,0,2,2
8616,2,3,30253,30253,30256,0,3,0
8617,1,3,30254,30256,30259,2,5,0
8618,6,2,30260,30260,30262,0,2,1
8619,5,2,30265,30265,30267,0,2,3
8620,5,2,30270,30270,30272,0,2,3
8621,3,3,30273,30273,30276,0,3,1
8622,2,3,30275,30276,30279,1,4,0
8623,5,3,30280,30280,30283,0,3,1
8624,6,3,30286,30286,30289,0,3,3
8625,1,1,30287,30289,30290,2,3,0
8626,2,3,30289,30290,30293,1,4,0
8627,4,3,30293,30293,30296,0,3,0
8628,6,2,30299,30299,30301,0,2,3
8629,1,3,30300,30301,30304,1,4,0
8630,3,2,30303,30304,30306,1,3,0
8631,5,2,30308,30308,30310,0,2,2
8632,3,3,30311,30311,30314,0,3,1
8633,3,3,30314,30314,30317,0,3,0
8634,3,1,30317,30317,30318,0,1,0
8635,6,2,30323,30323,30325,0,2,5
8636,5,3,30328,30328,30331,0,3,3
8637,2,2,30330,30331,30333,1,3,0
8638,6,1,30336,30336,30337,0,1,3
8639,2,2,30338,30338,30340,0,2,1
8640,1,2,30339,30340,30342,1,3,0
8641,4,2,30343,30343,30345,0,2,1
8642,3,3,30346,30346,30349,0,3,1
8643,3,2,30349,30349,30351,0,2,0
8644,1,3,30350,30351,30354,1,4,0
8645,3,2,30353,30354,30356,1,3,0
8646,5,1,30358,30358,30359,0,1,2
8647,4,3,30362,30362,30365,0,3,3
8648,4,1,30366,30366,30367,0,1,1
8649,6,1,30372,30372,30373,0,1,5
8650,2,1,30374,30374,30375,0,1,1
8651,6,2,30380,30380,30382,0,2,5
8652,5,1,30385,30385,30386,0,1,3
8653,1,1,30386,30386,30387,0,1,0
8654,5,1,30391,30391,30392,0,1,4
8655,2,1,30393,30393,30394,0,1,1
8656,3,1,30396,30396,30397,0,1,2
8657,2,2,30398,30398,30400,0,2,1
8658,5,2,30403,30403,30405,0,2,3
8659,3,2,30406,30406,30408,0,2,1
8660,4,2,30410,30410,30412,0,2,2
8661,2,1,30412,30412,30413,0,1,0
8662,1,1,30413,30413,30414,0,1,0
8663,3,2,30416,30416,30418,0,2,2
8664,1,2,30417,30418,30420,1,3,0
8665,3,1,30420,30420,30421,0,1,0
8666,6,3,30426,30426,30429,0,3,5
8667,6,3,30432,30432,30435,0,3,3
8668,1,3,30433,30435,30438,2,5,0
8669,6,2,30439,30439,30441,0,2,1
8670,3,3,30442,30442,30445,0,3,1
8671,4,2,30446,30446,30448,0,2,1
8672,6,3,30452,30452,30455,0,3,4
8673,4,1,30456,30456,30457,0,1,1
8674,2,3,30458,30458,30461,0,3,1
8675,2,1,30460,30461,30462,1,2,0
8676,5,3,30465,30465,30468,0,3,3
8677,3,2,30468,30468,30470,0,2,0
8678,4,1,30472,30472,30473,0,1,2
8679,2,3,30474,30474,30477,0,3,1
8680,4,2,30478,30478,30480,0,2,1
8681,3,1,30481,30481,30482,0,1,1
8682,6,3,30487,30487,30490,0,3,5
8683,5,3,30492,30492,30495,0,3,2
8684,3,2,30495,30495,30497,0,2,0
8685,4,1,30499,30499,30500,0,1,2
8686,6,3,30505,30505,30508,0,3,5
8687,5,1,30510,30510,30511,0,1,2
8688,6,3,30516,30516,30519,0,3,5
8689,6,1,30522,30522,30523,0,1,3
8690,4,2,30526,30526,30528,0,2,3
8691,2,1,30528,30528,30529,0,1,0
8692,5,3,30533,30533,30536,0,3,4
8693,4,1,30537,30537,30538,0,1,1
8694,2,2,30539,30539,30541,0,2,1
8695,2,1,30541,30541,30542,0,1,0
8696,1,3,30542,30542,30545,0,3,0
8697,6,3,30548,30548,30551,0,3,3
8698,1,2,30549,30551,30553,2,4,0
8699,3,3,30552,30553,30556,1,4,0
8700,1,3,30553,30556,30559,3,6,0
8701,3,1,30556,30559,30560,3,4,0
8702,3,1,30559,30560,30561,1,2,0
8703,6,2,30565,30565,30567,0,2,4
8704,6,3,30571,30571,30574,0,3,4
8705,1,1,30572,30574,30575,2,3,0
8706,5,2,30577,30577,30579,0,2,2
8707,2,1,30579,30579,30580,0,1,0
8708,4,3,30583,30583,30586,0,3,3
8709,3,3,30586,30586,30589,0,3,0
8710,4,3,30590,30590,30593,0,3,1
8711,2,3,30592,30593,30596,1,4,0
8712,6,2,30598,30598,30600,0,2,2
8713,1,3,30599,30600,30603,1,4,0
8714,1,3,30600,30603,30606,3,6,0
8715,1,2,30601,30606,30608,5,7,0
8716,6,3,30607,30608,30611,1,4,0
8717,1,3,30608,30611,30614,3,6,0
8718,6,1,30614,30614,30615,0,1,0
8719,5,2,30619,30619,30621,0,2,4
8720,6,2,30625,30625,30627,0,2,4
8721,2,2,30627,30627,30629,0,2,0
8722,2,2,30629,30629,30631,0,2,0
8723,2,2,30631,30631,30633,0,2,0
8724,1,2,30632,30633,30635,1,3,0
8725,1,2,30633,30635,30637,2,4,0
8726,4,3,30637,30637,30640,0,3,0
8727,2,1,30639,30640,30641,1,2,0
8728,2,1,30641,30641,30642,0,1,0
8729,5,3,30646,30646,30649,0,3,4
8730,5,1,30651,30651,30652,0,1,2
8731,4,2,30655,30655,30657,0,2,3
8732,3,3,30658,30658,30661,0,3,1
8733,5,1,30663,30663,30664,0,1,2
8734,2,2,30665,30665,30667,0,2,1
8735,3,3,30668,30668,30671,0,3,1
8736,3,2,30671,30671,30673,0,2,0
8737,5,2,30676,30676,30678,0,2,3
8738,3,1,30679,30679,30680,0,1,1
8739,4,1,30683,30683,30684,0,1,3
8740,6,3,30689,30689,30692,0,3,5
8741,5,2,30694,30694,30696,0,2,2
8742,4,2,30698,30698,30700,0,2,2
8743,1,1,30699,30700,30701,1,2,0
8744,3,1,30702,30702,30703,0,1,1
8745,6,1,30708,30708,30709,0,1,5
8746,2,2,30710,30710,30712,0,2,1
8747,2,2,30712,30712,30714,0,2,0
8748,6,2,30718,30718,30720,0,2,4
8749,4,1,30722,30722,30723,0,1,2
8750,4,1,30726,30726,30727,0,1,3
8751,1,2,30727,30727,30729,0,2,0
8752,2,1,30729,30729,30730,0,1,0
8753,2,1,30731,30731,30732,0,1,1
8754,1,1,30732,30732,30733,0,1,0
8755,2,1,30734,30734,30735,0,1,1
8756,5,1,30739,30739,30740,0,1,4
8757,1,2,30740,30740,30742,0,2,0
8758,3,3,30743,30743,30746,0,3,1
8759,3,2,30746,30746,30748,0,2,0
8760,1,2,30747,30748,30750,1,3,0
8761,6,2,30753,30753,30755,0,2,3
8762,2,3,30755,30755,30758,0,3,0
8763,1,1,30756,30758,30759,2,3,0
8764,4,3,30760,30760,30763,0,3,1
8765,5,1,30765,30765,30766,0,1,2
8766,3,2,30768,30768,30770,0,2,2
8767,6,3,30774,30774,30777,0,3,4
8768,4,3,30778,30778,30781,0,3,1
8769,6,1,30784,30784,30785,0,1,3
8770,4,3,30788,30788,30791,0,3,3
8771,2,2,30790,30791,30793,1,3,0
8772,1,3,30791,30793,30796,2,5,0
8773,1,3,30792,30796,30799,4,7,0
8774,1,1,30793,30799,30800,6,7,0
8775,6,3,30799,30800,30803,1,4,0
8776,5,1,30804,30804,30805,0,1,1
8777,1,3,30805,30805,30808,0,3,0
8778,4,2,30809,30809,30811,0,2,1
8779,6,2,30815,30815,30817,0,2,4
8780,1,1,30816,30817,30818,1,2,0
8781,3,2,30819,30819,30821,0,2,1
8782,3,1,30822,30822,30823,0,1,1
8783,1,1,30823,30823,30824,0,1,0
8784,2,3,30825,30825,30828,0,3,1
8785,4,1,30829,30829,30830,0,1,1
8786,4,2,30833,30833,30835,0,2,3
8787,3,1,30836,30836,30837,0,1,1
8788,3,2,30839,30839,30841,0,2,2
8789,2,3,30841,30841,30844,0,3,0
8790,1,2,30842,30844,30846,2,4,0
8791,2,2,30844,30846,30848,2,4,0
8792,6,2,30850,30850,30852,0,2,2
8793,5,2,30855,30855,30857,0,2,3
8794,3,2,30858,30858,30860,0,2,1
8795,6,1,30864,30864,30865,0,1,4
8796,3,2,30867,30867,30869,0,2,2
8797,6,3,30873,30873,30876,0,3,4
8798,5,3,30878,30878,30881,0,3,2
8799,6,1,30884,30884,30885,0,1,3
8800,5,2,30889,30889,30891,0,2,4
8801,2,1,30891,30891,30892,0,1,0
8802,6,1,30897,30897,30898,0,1,5
8803,4,3,30901,30901,30904,0,3,3
8804,4,2,30905,30905,30907,0,2,1
8805,2,2,30907,30907,30909,0,2,0
8806,2,3,30909,30909,30912,0,3,0
8807,5,3,30914,30914,30917,0,3,2
8808,5,2,30919,30919,30921,0,2,2
8809,5,1,30924,30924,30925,0,1,3
8810,2,3,30926,30926,30929,0,3,1
8811,1,1,30927,30929,30930,2,3,0
8812,3,1,30930,30930,30931,0,1,0
8813,6,1,30936,30936,30937,0,1,5
8814,4,2,30940,30940,30942,0,2,3
8815,2,1,30942,30942,30943,0,1,0
8816,2,1,30944,30944,30945,0,1,1
8817,3,2,30947,30947,30949,0,2,2
8818,6,1,30953,30953,30954,0,1,4
8819,5,2,30958,30958,30960,0,2,4
8820,2,1,30960,30960,30961,0,1,0
8821,3,1,30963,30963,30964,0,1,2
8822,5,1,30968,30968,30969,0,1,4
8823,3,3,30971,30971,30974,0,3,2
8824,5,2,30976,30976,30978,0,2,2
8825,3,1,30979,30979,30980,0,1,1
8826,2,1,30981,30981,30982,0,1,1
8827,4,1,30985,30985,30986,0,1,3
8828,2,2,30987,30987,30989,0,2,1
8829,4,2,30991,30991,30993,0,2,2
8830,1,2,30992,30993,30995,1,3,0
8831,5,3,30997,30997,31000,0,3,2
8832,1,1,30998,31000,31001,2,3,0
8833,2,1,31000,31001,31002,1,2,0
8834,4,3,31004,31004,31007,0,3,2
8835,6,2,31010,31010,31012,0,2,3
8836,6,1,31016,31016,31017,0,1,4
8837,3,3,31019,31019,31022,0,3,2
8838,1,2,31020,31022,31024,2,4,0
8839,5,2,31025,31025,31027,0,2,1
8840,6,1,31031,31031,31032,0,1,4
8841,2,1,31033,31033,31034,0,1,1
8842,6,2,31039,31039,31041,0,2,5
8843,4,2,31043,31043,31045,0,2,2
8844,6,3,31049,31049,31052,0,3,4
8845,1,1,31050,31052,31053,2,3,0
8846,2,2,31052,31053,31055,1,3,0
8847,1,3,31053,31055,31058,2,5,0
8848,1,1,31054,31058,31059,4,5,0
8849,5,1,31059,31059,31060,0,1,0
8850,1,3,31060,31060,31063,0,3,0
8851,4,3,31064,31064,31067,0,3,1
8852,6,1,31070,31070,31071,0,1,3
8853,5,1,31075,31075,31076,0,1,4
8854,5,1,31080,31080,31081,0,1,4
8855,5,3,31085,31085,31088,0,3,4
8856,3,2,31088,31088,31090,0,2,0
8857,6,2,31094,31094,31096,0,2,4
8858,1,1,31095,31096,31097,1,2,0
8859,2,3,31097,31097,31100,0,3,0
8860,4,2,31101,31101,31103,0,2,1
8861,4,2,31105,31105,31107,0,2,2
8862,4,1,31109,31109,31110,0,1,2
8863,6,2,31115,31115,31117,0,2,5
8864,5,3,31120,31120,31123,0,3,3
8865,2,3,31122,31123,31126,1,4,0
8866,4,2,31126,31126,31128,0,2,0
8867,1,3,31127,31128,31131,1,4,0
8868,5,2,31132,31132,31134,0,2,1
8869,5,1,31137,31137,31138,0,1,3
8870,2,2,31139,31139,31141,0,2,1
8871,1,3,31140,31141,31144,1,4,0
8872,6,1,31146,31146,31147,0,1,2
8873,6,1,31152,31152,31153,0,1,5
8874,5,1,31157,31157,31158,0,1,4
8875,2,3,31159,31159,31162,0,3,1
8876,6,2,31165,31165,31167,0,2,3
8877,1,2,31166,31167,31169,1,3,0
8878,6,3,31172,31172,31175,0,3,3
8879,5,2,31177,31177,31179,0,2,2
8880,6,3,31183,31183,31186,0,3,4
8881,2,1,31185,31186,31187,1,2,0
8882,1,2,31186,31187,31189,1,3,0
8883,3,3,31189,31189,31192,0,3,0
8884,1,3,31190,31192,31195,2,5,0
8885,5,1,31195,31195,31196,0,1,0
8886,4,3,31199,31199,31202,0,3,3
8887,5,2,31204,31204,31206,0,2,2
8888,6,2,31210,31210,31212,0,2,4
8889,6,3,31216,31216,31219,0,3,4
8890,2,1,31218,31219,31220,1,2,0
8891,4,3,31222,31222,31225,0,3,2
8892,2,2,31224,31225,31227,1,3,0
8893,1,1,31225,31227,31228,2,3,0
8894,5,2,31230,31230,31232,0,2,2
8895,6,3,31236,31236,31239,0,3,4
8896,6,2,31242,31242,31244,0,2,3
8897,5,2,31247,31247,31249,0,2,3
8898,2,1,31249,31249,31250,0,1,0
8899,2,1,31251,31251,31252,0,1,1
8900,2,1,31253,31253,31254,0,1,1
8901,6,3,31259,31259,31262,0,3,5
8902,6,3,31265,31265,31268,0,3,3
8903,1,3,31266,31268,31271,2,5,0
8904,2,2,31268,31271,31273,3,5,0
8905,1,3,31269,31273,31276,4,7,0
8906,3,3,31272,31276,31279,4,7,0
8907,2,3,31274,31279,31282,5,8,0
8908,3,2,31277,31282,31284,5,7,0
8909,2,3,31279,31284,31287,5,8,0
8910,2,2,31281,31287,31289,6,8,0
8911,3,3,31284,31289,31292,5,8,0
8912,2,2,31286,31292,31294,6,8,0
8913,1,2,31287,31294,31296,7,9,0
8914,2,1,31289,31296,31297,7,8,0
8915,2,2,31291,31297,31299,6,8,0
8916,2,1,31293,31299,31300,6,7,0
8917,3,1,31296,31300,31301,4,5,0
8918,5,3,31301,31301,31304,0,3,0
8919,1,3,31302,31304,31307,2,5,0
8920,6,3,31308,31308,31311,0,3,1
8921,3,2,31311,31311,31313,0,2,0
8922,1,3,31312,31313,31316,1,4,0
8923,4,3,31316,31316,31319,0,3,0
8924,3,2,31319,31319,31321,0,2,0
8925,4,2,31323,31323,31325,0,2,2
8926,6,1,31329,31329,31330,0,1,4
8927,5,2,31334,31334,31336,0,2,4
8928,4,1,31338,31338,31339,0,1,2
8929,1,3,31339,31339,31342,0,3,0
8930,4,1,31343,31343,31344,0,1,1
8931,4,1,31347,31347,31348,0,1,3
8932,1,3,31348,31348,31351,0,3,0
8933,1,3,31349,31351,31354,2,5,0
8934,5,2,31354,31354,31356,0,2,0
8935,1,3,31355,31356,31359,1,4,0
8936,3,2,31358,31359,31361,1,3,0
8937,1,2,31359,31361,31363,2,4,0
8938,3,2,31362,31363,31365,1,3,0
8939,3,2,31365,31365,31367,0,2,0
8940,2,1,31367,31367,31368,0,1,0
8941,3,1,31370,31370,31371,0,1,2
8942,2,1,31372,31372,31373,0,1,1
8943,6,3,31378,31378,31381,0,3,5
8944,6,1,31384,31384,31385,0,1,3
8945,2,2,31386,31386,31388,0,2,1
8946,4,3,31390,31390,31393,0,3,2
8947,4,1,31394,31394,31395,0,1,1
8948,2,3,31396,31396,31399,0,3,1
8949,5,2,31401,31401,31403,0,2,2
8950,1,1,31402,31403,31404,1,2,0
8951,6,2,31408,31408,31410,0,2,4
8952,3,1,31411,31411,31412,0,1,1
8953,4,2,31415,31415,31417,0,2,3
8954,2,1,31417,31417,31418,0,1,0
8955,4,3,31421,31421,31424,0,3,3
8956,2,3,31423,31424,31427,1,4,0
8957,6,3,31429,31429,31432,0,3,2
8958,1,1,31430,31432,31433,2,3,0
8959,5,2,31435,31435,31437,0,2,2
8960,1,3,31436,31437,31440,1,4,0
8961,6,2,31442,31442,31444,0,2,2
8962,5,1,31447,31447,31448,0,1,3
8963,5,1,31452,31452,31453,0,1,4
8964,2,1,31454,31454,31455,0,1,1
8965,4,2,31458,31458,31460,0,2,3
8966,4,1,31462,31462,31463,0,1,2
8967,5,2,31467,31467,31469,0,2,4
8968,4,3,31471,31471,31474,0,3,2
8969,3,1,31474,31474,31475,0,1,0
8970,4,2,31478,31478,31480,0,2,3
8971,3,1,31481,31481,31482,0,1,1
8972,3,1,31484,31484,31485,0,1,2
8973,3,2,31487,31487,31489,0,2,2
8974,3,1,31490,31490,31491,0,1,1
8975,6,1,31496,31496,31497,0,1,5
8976,1,1,31497,31497,31498,0,1,0
8977,1,1,31498,31498,31499,0,1,0
8978,1,3,31499,31499,31502,0,3,0
8979,3,3,31502,31502,31505,0,3,0
8980,2,3,31504,31505,31508,1,4,0
8981,4,3,31508,31508,31511,0,3,0
8982,2,1,31510,31511,31512,1,2,0
8983,6,2,31516,31516,31518,0,2,4
8984,1,1,31517,31518,31519,1,2,0
8985,5,2,31522,31522,31524,0,2,3
8986,6,2,31528,31528,31530,0,2,4
8987,6,2,31534,31534,31536,0,2,4
8988,1,3,31535,31536,31539,1,4,0
8989,2,1,31537,31539,31540,2,3,0
8990,5,3,31542,31542,31545,0,3,2
8991,5,1,31547,31547,31548,0,1,2
8992,2,2,31549,31549,31551,0,2,1
8993,2,1,31551,31551,31552,0,1,0
8994,4,2,31555,31555,31557,0,2,3
8995,5,3,31560,31560,31563,0,3,3
8996,4,3,31564,31564,31567,0,3,1
8997,2,1,31566,31567,31568,1,2,0
8998,1,2,31567,31568,31570,1,3,0
8999,5,2,31572,31572,31574,0,2,2
9000,1,2,31573,31574,31576,1,3,0
9001,1,2,31574,31576,31578,2,4,0
9002,3,2,31577,31578,31580,1,3,0
9003,5,2,31582,31582,31584,0,2,2
9004,2,1,31584,31584,31585,0,1,0
9005,4,3,31588,31588,31591,0,3,3
9006,3,1,31591,31591,31592,0,1,0
9007,6,1,31597,31597,31598,0,1,5
9008,1,2,31598,31598,31600,0,2,0
9009,5,2,31603,31603,31605,0,2,3
9010,6,2,31609,31609,31611,0,2,4
9011,5,3,31614,31614,31617,0,3,3
9012,2,3,31616,31617,31620,1,4,0
9013,4,2,31620,31620,31622,0,2,0
9014,5,3,31625,31625,31628,0,3,3
9015,1,3,31626,31628,31631,2,5,0
9016,5,3,31631,31631,31634,0,3,0
9017,3,3,31634,31634,31637,0,3,0
9018,5,3,31639,31639,31642,0,3,2
9019,3,2,31642,31642,31644,0,2,0
9020,4,3,31646,31646,31649,0,3,2
9021,6,3,31652,31652,31655,0,3,3
9022,5,3,31657,31657,31660,0,3,2
9023,2,1,31659,31660,31661,1,2,0
9024,6,1,31665,31665,31666,0,1,4
9025,1,1,31666,31666,31667,0,1,0
9026,4,2,31670,31670,31672,0,2,3
9027,2,2,31672,31672,31674,0,2,0
9028,3,1,31675,31675,31676,0,1,1
9029,3,3,31678,31678,31681,0,3,2
9030,5,3,31683,31683,31686,0,3,2
9031,4,2,31687,31687,31689,0,2,1
9032,1,1,31688,31689,31690,1,2,0
9033,5,1,31693,31693,31694,0,1,3
9034,2,1,31695,31695,31696,0,1,1
9035,1,3,31696,31696,31699,0,3,0
9036,3,3,31699,31699,31702,0,3,0
9037,1,2,31700,31702,31704,2,4,0
9038,6,3,31706,31706,31709,0,3,2
9039,1,2,31707,31709,31711,2,4,0
9040,6,2,31713,31713,31715,0,2,2
9041,5,3,31718,31718,31721,0,3,3
9042,4,3,31722,31722,31725,0,3,1
9043,3,1,31725,31725,31726,0,1,0
9044,6,2,31731,31731,31733,0,2,5
9045,2,1,31733,31733,31734,0,1,0
9046,2,1,31735,31735,31736,0,1,1
9047,3,2,31738,31738,31740,0,2,2
9048,2,3,31740,31740,31743,0,3,0
9049,1,3,31741,31743,31746,2,5,0
9050,3,3,31744,31746,31749,2,5,0
9051,5,2,31749,31749,31751,0,2,0
9052,1,1,31750,31751,31752,1,2,0
9053,3,2,31753,31753,31755,0,2,1
9054,5,3,31758,31758,31761,0,3,3
9055,6,1,31764,31764,31765,0,1,3
9056,4,1,31768,31768,31769,0,1,3
9057,6,1,31774,31774,31775,0,1,5
9058,2,1,31776,31776,31777,0,1,1
9059,6,3,31782,31782,31785,0,3,5
9060,6,2,31788,31788,31790,0,2,3
9061,1,2,31789,31790,31792,1,3,0
9062,5,2,31794,31794,31796,0,2,2
9063,3,3,31797,31797,31800,0,3,1
9064,4,3,31801,31801,31804,0,3,1
9065,2,2,31803,31804,31806,1,3,0
9066,2,2,31805,31806,31808,1,3,0
9067,5,1,31810,31810,31811,0,1,2
9068,1,3,31811,31811,31814,0,3,0
9069,4,1,31815,31815,31816,0,1,1
9070,1,2,31816,31816,31818,0,2,0
9071,6,1,31822,31822,31823,0,1,4
9072,1,1,31823,31823,31824,0,1,0
9073,6,3,31829,31829,31832,0,3,5
9074,5,3,31834,31834,31837,0,3,2
9075,1,1,31835,31837,31838,2,3,0
9076,3,3,31838,31838,31841,0,3,0
9077,5,2,31843,31843,31845,0,2,2
9078,1,3,31844,31845,31848,1,4,0
9079,3,3,31847,31848,31851,1,4,0
9080,1,1,31848,31851,31852,3,4,0
9081,1,3,31849,31852,31855,3,6,0
9082,4,3,31853,31855,31858,2,5,0
9083,6,3,31859,31859,31862,0,3,1
9084,6,1,31865,31865,31866,0,1,3
9085,5,1,31870,31870,31871,0,1,4
9086,1,3,31871,31871,31874,0,3,0
9087,1,3,31872,31874,31877,2,5,0
9088,4,1,31876,31877,31878,1,2,0
9089,1,2,31877,31878,31880,1,3,0
9090,3,3,31880,31880,31883,0,3,0
9091,6,1,31886,31886,31887,0,1,3
9092,5,3,31891,31891,31894,0,3,4
9093,1,1,31892,31894,31895,2,3,0
9094,3,1,31895,31895,31896,0,1,0
9095,5,1,31900,31900,31901,0,1,4
9096,4,1,31904,31904,31905,0,1,3
9097,6,1,31910,31910,31911,0,1,5
9098,4,3,31914,31914,31917,0,3,3
9099,3,3,31917,31917,31920,0,3,0
9100,5,2,31922,31922,31924,0,2,2
9101,6,2,31928,31928,31930,0,2,4
9102,4,3,31932,31932,31935,0,3,2
9103,2,3,31934,31935,31938,1,4,0
9104,2,1,31936,31938,31939,2,3,0
9105,3,3,31939,31939,31942,0,3,0
9106,6,1,31945,31945,31946,0,1,3
9107,3,2,31948,31948,31950,0,2,2
9108,3,3,31951,31951,31954,0,3,1
9109,2,3,31953,31954,31957,1,4,0
9110,2,3,31955,31957,31960,2,5,0
9111,4,3,31959,31960,31963,1,4,0
9112,3,2,31962,31963,31965,1,3,0
9113,3,2,31965,31965,31967,0,2,0
9114,1,1,31966,31967,31968,1,2,0
9115,1,3,31967,31968,31971,1,4,0
9116,5,1,31972,31972,31973,0,1,1
9117,5,1,31977,31977,31978,0,1,4
9118,3,2,31980,31980,31982,0,2,2
9119,5,3,31985,31985,31988,0,3,3
9120,4,2,31989,31989,31991,0,2,1
9121,5,3,31994,31994,31997,0,3,3
9122,4,3,31998,31998,32001,0,3,1
9123,6,3,32004,32004,32007,0,3,3
9124,3,3,32007,32007,32010,0,3,0
9125,3,1,32010,32010,32011,0,1,0
9126,4,2,32014,32014,32016,0,2,3
9127,6,3,32020,32020,32023,0,3,4
9128,2,1,32022,32023,32024,1,2,0
9129,4,3,32026,32026,32029,0,3,2
9130,6,3,32032,32032,32035,0,3,3
9131,2,1,32034,32035,32036,1,2,0
9132,6,3,32040,32040,32043,0,3,4
9133,5,3,32045,32045,32048,0,3,2
9134,4,1,32049,32049,32050,0,1,1
9135,3,2,32052,32052,32054,0,2,2
9136,2,3,32054,32054,32057,0,3,0
9137,1,3,32055,32057,32060,2,5,0
9138,3,3,32058,32060,32063,2,5,0
9139,4,3,32062,32063,32066,1,4,0
9140,4,2,32066,32066,32068,0,2,0
9141,4,1,32070,32070,32071,0,1,2
9142,1,3,32071,32071,32074,0,3,0
9143,2,3,32073,32074,32077,1,4,0
9144,6,2,32079,32079,32081,0,2,2
9145,1,2,32080,32081,32083,1,3,0
9146,4,3,32084,32084,32087,0,3,1
9147,1,1,32085,32087,32088,2,3,0
9148,6,3,32091,32091,32094,0,3,3
9149,6,3,32097,32097,32100,0,3,3
9150,6,3,32103,32103,32106,0,3,3
9151,2,2,32105,32106,32108,1,3,0
9152,3,1,32108,32108,32109,0,1,0
9153,1,1,32109,32109,32110,0,1,0
9154,1,2,32110,32110,32112,0,2,0
9155,6,1,32116,32116,32117,0,1,4
9156,2,1,32118,32118,32119,0,1,1
9157,5,1,32123,32123,32124,0,1,4
9158,3,2,32126,32126,32128,0,2,2
9159,2,3,32128,32128,32131,0,3,0
9160,3,3,32131,32131,32134,0,3,0
9161,4,2,32135,32135,32137,0,2,1
9162,4,2,32139,32139,32141,0,2,2
9163,3,3,32142,32142,32145,0,3,1
9164,6,1,32148,32148,32149,0,1,3
9165,3,1,32151,32151,32152,0,1,2
9166,5,2,32156,32156,32158,0,2,4
9167,3,3,32159,32159,32162,0,3,1
9168,4,3,32163,32163,32166,0,3,1
9169,4,1,32167,32167,32168,0,1,1
9170,1,1,32168,32168,32169,0,1,0
9171,5,3,32173,32173,32176,0,3,4
9172,6,3,32179,32179,32182,0,3,3
9173,1,1,32180,32182,32183,2,3,0
9174,5,2,32185,32185,32187,0,2,2
9175,3,3,32188,32188,32191,0,3,1
9176,6,3,32194,32194,32197,0,3,3
9177,3,3,32197,32197,32200,0,3,0
9178,4,3,32201,32201,32204,0,3,1
9179,1,3,32202,32204,32207,2,5,0
9180,2,2,32204,32207,32209,3,5,0
9181,6,3,32210,32210,32213,0,3,1
9182,1,2,32211,32213,32215,2,4,0
9183,6,3,32217,32217,32220,0,3,2
9184,4,2,32221,32221,32223,0,2,1
9185,2,2,32223,32223,32225,0,2,0
9186,4,3,32227,32227,32230,0,3,2
9187,4,1,32231,32231,32232,0,1,1
9188,1,1,32232,32232,32233,0,1,0
9189,1,1,32233,32233,32234,0,1,0
9190,3,3,32236,32236,32239,0,3,2
9191,5,1,32241,32241,32242,0,1,2
9192,5,3,32246,32246,32249,0,3,4
9193,4,2,32250,32250,32252,0,2,1
9194,2,2,32252,32252,32254,0,2,0
9195,5,2,32257,32257,32259,0,2,3
9196,6,3,32263,32263,32266,0,3,4
9197,3,2,32266,32266,32268,0,2,0
9198,3,2,32269,32269,32271,0,2,1
9199,3,1,32272,32272,32273,0,1,1
9200,5,3,32277,32277,32280,0,3,4
9201,6,3,32283,32283,32286,0,3,3
9202,4,2,32287,32287,32289,0,2,1
9203,2,1,32289,32289,32290,0,1,0
9204,1,3,32290,32290,32293,0,3,0
9205,6,3,32296,32296,32299,0,3,3
9206,4,1,32300,32300,32301,0,1,1
9207,4,3,32304,32304,32307,0,3,3
9208,4,2,32308,32308,32310,0,2,1
9209,6,3,32314,32314,32317,0,3,4
9210,6,1,32320,32320,32321,0,1,3
9211,2,1,32322,32322,32323,0,1,1
9212,1,3,32323,32323,32326,0,3,0
9213,5,1,32328,32328,32329,0,1,2
9214,4,3,32332,32332,32335,0,3,3
9215,3,1,32335,32335,32336,0,1,0
9216,6,1,32341,32341,32342,0,1,5
9217,4,2,32345,32345,32347,0,2,3
9218,2,3,32347,32347,32350,0,3,0
9219,1,2,32348,32350,32352,2,4,0
9220,5,1,32353,32353,32354,0,1,1
9221,4,2,32357,32357,32359,0,2,3
9222,3,2,32360,32360,32362,0,2,1
9223,5,3,32365,32365,32368,0,3,3
9224,3,1,32368,32368,32369,0,1,0
9225,2,3,32370,32370,32373,0,3,1
9226,6,1,32376,32376,32377,0,1,3
9227,2,1,32378,32378,32379,0,1,1
9228,3,1,32381,32381,32382,0,1,2
9229,6,2,32387,32387,32389,0,2,5
9230,2,2,32389,32389,32391,0,2,0
9231,3,2,32392,32392,32394,0,2,1
9232,2,3,32394,32394,32397,0,3,0
9233,5,3,32399,32399,32402,0,3,2
9234,2,1,32401,32402,32403,1,2,0
9235,4,1,32405,32405,32406,0,1,2
9236,6,1,32411,32411,32412,0,1,5
9237,6,2,32417,32417,32419,0,2,5
9238,5,3,32422,32422,32425,0,3,3
9239,4,2,32426,32426,32428,0,2,1
9240,4,1,32430,32430,32431,0,1,2
9241,6,3,32436,32436,32439,0,3,5
9242,1,3,32437,32439,32442,2,5,0
9243,5,2,32442,32442,32444,0,2,0
9244,6,3,32448,32448,32451,0,3,4
9245,4,1,32452,32452,32453,0,1,1
9246,1,2,32453,32453,32455,0,2,0
9247,4,1,32457,32457,32458,0,1,2
9248,3,3,32460,32460,32463,0,3,2
9249,2,1,32462,32463,32464,1,2,0
9250,2,1,32464,32464,32465,0,1,0
9251,5,1,32469,32469,32470,0,1,4
9252,6,2,32475,32475,32477,0,2,5
9253,5,2,32480,32480,32482,0,2,3
9254,3,2,32483,32483,32485,0,2,1
9255,4,3,32487,32487,32490,0,3,2
9256,4,2,32491,32491,32493,0,2,1
9257,2,3,32493,32493,32496,0,3,0
9258,6,2,32499,32499,32501,0,2,3
9259,5,3,32504,32504,32507,0,3,3
9260,2,2,32506,32507,32509,1,3,0
9261,2,3,32508,32509,32512,1,4,0
9262,4,2,32512,32512,32514,0,2,0
9263,6,2,32518,32518,32520,0,2,4
9264,5,2,32523,32523,32525,0,2,3
9265,3,1,32526,32526,32527,0,1,1
9266,3,1,32529,32529,32530,0,1,2
9267,3,3,32532,32532,32535,0,3,2
9268,1,3,32533,32535,32538,2,5,0
9269,3,3,32536,32538,32541,2,5,0
9270,4,1,32540,32541,32542,1,2,0
9271,6,1,32546,32546,32547,0,1,4
9272,5,1,32551,32551,32552,0,1,4
9273,4,3,32555,32555,32558,0,3,3
9274,1,1,32556,32558,32559,2,3,0
9275,6,3,32562,32562,32565,0,3,3
9276,2,3,32564,32565,32568,1,4,0
9277,3,2,32567,32568,32570,1,3,0
9278,3,2,32570,32570,32572,0,2,0
9279,1,3,32571,32572,32575,1,4,0
9280,3,3,32574,32575,32578,1,4,0
9281,2,1,32576,32578,32579,2,3,0
9282,3,2,32579,32579,32581,0,2,0
9283,6,1,32585,32585,32586,0,1,4
9284,2,1,32587,32587,32588,0,1,1
9285,6,1,32593,32593,32594,0,1,5
9286,6,1,32599,32599,32600,0,1,5
9287,2,3,32601,32601,32604,0,3,1
9288,1,3,32602,32604,32607,2,5,0
9289,6,2,32608,32608,32610,0,2,1
9290,3,2,32611,32611,32613,0,2,1
9291,1,1,32612,32613,32614,1,2,0
9292,3,2,32615,32615,32617,0,2,1
9293,3,2,32618,32618,32620,0,2,1
9294,5,1,32623,32623,32624,0,1,3
9295,3,1,32626,32626,32627,0,1,2
9296,3,3,32629,32629,32632,0,3,2
9297,1,1,32630,32632,32633,2,3,0
9298,4,2,32634,32634,32636,0,2,1
9299,6,1,32640,32640,32641,0,1,4
9300,5,1,32645,32645,32646,0,1,4
9301,1,3,32646,32646,32649,0,3,0
9302,6,1,32652,32652,32653,0,1,3
9303,6,2,32658,32658,32660,0,2,5
9304,5,3,32663,32663,32666,0,3,3
9305,5,1,32668,32668,32669,0,1,2
9306,5,1,32673,32673,32674,0,1,4
9307,1,1,32674,32674,32675,0,1,0
9308,2,3,32676,32676,32679,0,3,1
9309,2,3,32678,32679,32682,1,4,0
9310,2,2,32680,32682,32684,2,4,0
9311,5,1,32685,32685,32686,0,1,1
9312,4,1,32689,32689,32690,0,1,3
9313,2,2,32691,32691,32693,0,2,1
9314,4,2,32695,32695,32697,0,2,2
9315,5,1,32700,32700,32701,0,1,3
9316,3,2,32703,32703,32705,0,2,2
9317,2,3,32705,32705,32708,0,3,0
9318,4,2,32709,32709,32711,0,2,1
9319,3,1,32712,32712,32713,0,1,1
9320,2,2,32714,32714,32716,0,2,1
9321,3,3,32717,32717,32720,0,3,1
9322,5,2,32722,32722,32724,0,2,2
9323,2,2,32724,32724,32726,0,2,0
9324,2,2,32726,32726,32728,0,2,0
9325,6,2,32732,32732,32734,0,2,4
9326,3,3,32735,32735,32738,0,3,1
9327,1,2,32736,32738,32740,2,4,0
9328,5,2,32741,32741,32743,0,2,1
9329,3,3,32744,32744,32747,0,3,1
9330,6,2,32750,32750,32752,0,2,3
9331,2,3,32752,32752,32755,0,3,0
9332,4,1,32756,32756,32757,0,1,1
9333,2,3,32758,32758,32761,0,3,1
9334,4,1,32762,32762,32763,0,1,1
9335,4,1,32766,32766,32767,0,1,3
9336,4,2,32770,32770,32772,0,2,3
9337,3,2,32773,32773,32775,0,2,1
9338,4,1,32777,32777,32778,0,1,2
9339,1,1,32778,32778,32779,0,1,0
9340,4,1,32782,32782,32783,0,1,3
9341,6,2,32788,32788,32790,0,2,5
9342,5,2,32793,32793,32795,0,2,3
9343,2,3,32795,32795,32798,0,3,0
9344,1,2,32796,32798,32800,2,4,0
9345,4,2,32800,32800,32802,0,2,0
9346,4,2,32804,32804,32806,0,2,2
9347,3,2,32807,32807,32809,0,2,1
9348,6,1,32813,32813,32814,0,1,4
9349,5,1,32818,32818,32819,0,1,4
9350,2,1,32820,32820,32821,0,1,1
9351,3,1,32823,32823,32824,0,1,2
9352,6,3,32829,32829,32832,0,3,5
9353,5,2,32834,32834,32836,0,2,2
9354,3,2,32837,32837,32839,0,2,1
9355,1,1,32838,32839,32840,1,2,0
9356,4,2,32842,32842,32844,0,2,2
9357,2,2,32844,32844,32846,0,2,0
9358,1,3,32845,32846,32849,1,4,0
9359,1,3,32846,32849,32852,3,6,0
9360,5,1,32851,32852,32853,1,2,0
9361,2,1,32853,32853,32854,0,1,0
9362,6,2,32859,32859,32861,0,2,5
9363,6,2,32865,32865,32867,0,2,4
9364,2,2,32867,32867,32869,0,2,0
9365,4,1,32871,32871,32872,0,1,2
9366,3,3,32874,32874,32877,0,3,2
9367,4,3,32878,32878,32881,0,3,1
9368,6,1,32884,32884,32885,0,1,3
9369,5,1,32889,32889,32890,0,1,4
9370,5,3,32894,32894,32897,0,3,4
9371,6,2,32900,32900,32902,0,2,3
9372,5,1,32905,32905,32906,0,1,3
9373,6,2,32911,32911,32913,0,2,5
9374,1,1,32912,32913,32914,1,2,0
9375,4,2,32916,32916,32918,0,2,2
9376,4,3,32920,32920,32923,0,3,2
9377,6,1,32926,32926,32927,0,1,3
9378,6,1,32932,32932,32933,0,1,5
9379,5,1,32937,32937,32938,0,1,4
9380,4,2,32941,32941,32943,0,2,3
9381,5,2,32946,32946,32948,0,2,3
9382,1,3,32947,32948,32951,1,4,0
9383,5,1,32952,32952,32953,0,1,1
9384,6,3,32958,32958,32961,0,3,5
9385,6,1,32964,32964,32965,0,1,3
9386,3,3,32967,32967,32970,0,3,2
9387,4,1,32971,32971,32972,0,1,1
9388,3,1,32974,32974,32975,0,1,2
9389,5,2,32979,32979,32981,0,2,4
9390,1,3,32980,32981,32984,1,4,0
9391,6,2,32986,32986,32988,0,2,2
9392,6,1,32992,32992,32993,0,1,4
9393,1,3,32993,32993,32996,0,3,0
9394,4,1,32997,32997,32998,0,1,1
9395,1,3,32998,32998,33001,0,3,0
9396,2,2,33000,33001,33003,1,3,0
9397,3,3,33003,33003,33006,0,3,0
9398,2,3,33005,33006,33009,1,4,0
9399,3,2,33008,33009,33011,1,3,0
9400,6,2,33014,33014,33016,0,2,3
9401,4,2,33018,33018,33020,0,2,2
9402,2,2,33020,33020,33022,0,2,0
9403,1,1,33021,33022,33023,1,2,0
9404,4,1,33025,33025,33026,0,1,2
9405,1,2,33026,33026,33028,0,2,0
9406,5,2,33031,33031,33033,0,2,3
9407,1,1,33032,33033,33034,1,2,0
9408,4,3,33036,33036,33039,0,3,2
9409,2,3,33038,33039,33042,1,4,0
9410,3,2,33041,33042,33044,1,3,0
9411,2,2,33043,33044,33046,1,3,0
9412,1,3,33044,33046,33049,2,5,0
9413,4,1,33048,33049,33050,1,2,0
9414,5,1,33053,33053,33054,0,1,3
9415,1,1,33054,33054,33055,0,1,0
9416,2,1,33056,33056,33057,0,1,1
9417,2,1,33058,33058,33059,0,1,1
9418,1,1,33059,33059,33060,0,1,0
9419,3,2,33062,33062,33064,0,2,2
9420,4,1,33066,33066,33067,0,1,2
9421,3,1,33069,33069,33070,0,1,2
9422,5,2,33074,33074,33076,0,2,4
9423,5,3,33079,33079,33082,0,3,3
9424,4,1,33083,33083,33084,0,1,1
9425,3,1,33086,33086,33087,0,1,2
9426,2,3,33088,33088,33091,0,3,1
9427,5,2,33093,33093,33095,0,2,2
9428,6,2,33099,33099,33101,0,2,4
9429,6,3,33105,33105,33108,0,3,4
9430,4,2,33109,33109,33111,0,2,1
9431,1,1,33110,33111,33112,1,2,0
9432,5,2,33115,33115,33117,0,2,3
9433,2,1,33117,33117,33118,0,1,0
9434,5,2,33122,33122,33124,0,2,4
9435,5,1,33127,33127,33128,0,1,3
9436,3,3,33130,33130,33133,0,3,2
9437,1,1,33131,33133,33134,2,3,0
9438,2,3,33133,33134,33137,1,4,0
9439,6,1,33139,33139,33140,0,1,2
9440,2,3,33141,33141,33144,0,3,1
9441,1,2,33142,33144,33146,2,4,0
9442,6,1,33148,33148,33149,0,1,2
9443,3,2,33151,33151,33153,0,2,2
9444,2,2,33153,33153,33155,0,2,0
9445,1,1,33154,33155,33156,1,2,0
9446,6,2,33160,33160,33162,0,2,4
9447,1,3,33161,33162,33165,1,4,0
9448,5,2,33166,33166,33168,0,2,1
9449,1,1,33167,33168,33169,1,2,0
9450,1,1,33168,33169,33170,1,2,0
9451,4,3,33172,33172,33175,0,3,2
9452,6,3,33178,33178,33181,0,3,3
9453,1,1,33179,33181,33182,2,3,0
9454,3,3,33182,33182,33185,0,3,0
9455,4,3,33186,33186,33189,0,3,1
9456,1,1,33187,33189,33190,2,3,0
9457,1,3,33188,33190,33193,2,5,0
9458,5,1,33193,33193,33194,0,1,0
9459,6,3,33199,33199,33202,0,3,5
9460,3,3,33202,33202,33205,0,3,0
9461,1,2,33203,33205,33207,2,4,0
9462,2,2,33205,33207,33209,2,4,0
9463,2,2,33207,33209,33211,2,4,0
9464,4,1,33211,33211,33212,0,1,0
9465,2,3,33213,33213,33216,0,3,1
9466,6,3,33219,33219,33222,0,3,3
9467,5,3,33224,33224,33227,0,3,2
9468,6,3,33230,33230,33233,0,3,3
9469,1,1,33231,33233,33234,2,3,0
9470,1,3,33232,33234,33237,2,5,0
9471,6,2,33238,33238,33240,0,2,1
9472,5,1,33243,33243,33244,0,1,3
9473,2,3,33245,33245,33248,0,3,1
9474,3,3,33248,33248,33251,0,3,0
9475,5,1,33253,33253,33254,0,1,2
9476,6,3,33259,33259,33262,0,3,5
9477,6,3,33265,33265,33268,0,3,3
9478,5,2,33270,33270,33272,0,2,2
9479,4,3,33274,33274,33277,0,3,2
9480,2,1,33276,33277,33278,1,2,0
9481,6,2,33282,33282,33284,0,2,4
9482,2,1,33284,33284,33285,0,1,0
9483,1,2,33285,33285,33287,0,2,0
9484,3,3,33288,33288,33291,0,3,1
9485,4,2,33292,33292,33294,0,2,1
9486,1,2,33293,33294,33296,1,3,0
9487,4,1,33297,33297,33298,0,1,1
9488,1,2,33298,33298,33300,0,2,0
9489,3,2,33301,33301,33303,0,2,1
9490,2,3,33303,33303,33306,0,3,0
9491,4,2,33307,33307,33309,0,2,1
9492,5,2,33312,33312,33314,0,2,3
9493,3,1,33315,33315,33316,0,1,1
9494,1,3,33316,33316,33319,0,3,0
9495,2,3,33318,33319,33322,1,4,0
9496,2,2,33320,33322,33324,2,4,0
9497,2,3,33322,33324,33327,2,5,0
9498,6,2,33328,33328,33330,0,2,1
9499,5,2,33333,33333,33335,0,2,3
9500,3,3,33336,33336,33339,0,3,1
9501,4,3,33340,33340,33343,0,3,1
9502,5,3,33345,33345,33348,0,3,2
9503,2,2,33347,33348,33350,1,3,0
9504,2,3,33349,33350,33353,1,4,0
9505,4,2,33353,33353,33355,0,2,0
9506,5,1,33358,33358,33359,0,1,3
9507,1,3,33359,33359,33362,0,3,0
9508,6,2,33365,33365,33367,0,2,3
9509,5,2,33370,33370,33372,0,2,3
9510,4,3,33374,33374,33377,0,3,2
9511,2,1,33376,33377,33378,1,2,0
9512,1,1,33377,33378,33379,1,2,0
9513,5,2,33382,33382,33384,0,2,3
9514,3,1,33385,33385,33386,0,1,1
9515,4,1,33389,33389,33390,0,1,3
9516,6,3,33395,33395,33398,0,3,5
9517,5,2,33400,33400,33402,0,2,2
9518,3,1,33403,33403,33404,0,1,1
9519,1,3,33404,33404,33407,0,3,0
9520,3,1,33407,33407,33408,0,1,0
9521,4,2,33411,33411,33413,0,2,3
9522,5,3,33416,33416,33419,0,3,3
9523,1,2,33417,33419,33421,2,4,0
9524,5,3,33422,33422,33425,0,3,1
9525,6,3,33428,33428,33431,0,3,3
9526,4,3,33432,33432,33435,0,3,1
9527,1,2,33433,33435,33437,2,4,0
9528,3,3,33436,33437,33440,1,4,0
9529,1,1,33437,33440,33441,3,4,0
9530,3,2,33440,33441,33443,1,3,0
9531,6,3,33446,33446,33449,0,3,3
9532,2,1,33448,33449,33450,1,2,0
9533,4,2,33452,33452,33454,0,2,2
9534,2,3,33454,33454,33457,0,3,0
9535,6,2,33460,33460,33462,0,2,3
9536,2,3,33462,33462,33465,0,3,0
9537,4,1,33466,33466,33467,0,1,1
9538,5,3,33471,33471,33474,0,3,4
9539,4,1,33475,33475,33476,0,1,1
9540,6,1,33481,33481,33482,0,1,5
9541,2,2,33483,33483,33485,0,2,1
9542,5,2,33488,33488,33490,0,2,3
9543,4,2,33492,33492,33494,0,2,2
9544,6,2,33498,33498,33500,0,2,4
9545,3,3,33501,33501,33504,0,3,1
9546,5,3,33506,33506,33509,0,3,2
9547,3,1,33509,33509,33510,0,1,0
9548,6,2,33515,33515,33517,0,2,5
9549,2,2,33517,33517,33519,0,2,0
9550,5,1,33522,33522,33523,0,1,3
9551,4,3,33526,33526,33529,0,3,3
9552,4,2,33530,33530,33532,0,2,1
9553,5,1,33535,33535,33536,0,1,3
9554,6,1,33541,33541,33542,0,1,5
9555,2,1,33543,33543,33544,0,1,1
9556,2,3,33545,33545,33548,0,3,1
9557,4,1,33549,33549,33550,0,1,1
9558,1,1,33550,33550,33551,0,1,0
9559,5,2,33555,33555,33557,0,2,4
9560,6,2,33561,33561,33563,0,2,4
9561,3,2,33564,33564,33566,0,2,1
9562,2,2,33566,33566,33568,0,2,0
9563,1,2,33567,33568,33570,1,3,0
9564,6,3,33573,33573,33576,0,3,3
9565,4,2,33577,33577,33579,0,2,1
9566,5,2,33582,33582,33584,0,2,3
9567,5,3,33587,33587,33590,0,3,3
9568,5,1,33592,33592,33593,0,1,2
9569,5,1,33597,33597,33598,0,1,4
9570,1,3,33598,33598,33601,0,3,0
9571,5,1,33603,33603,33604,0,1,2
9572,4,2,33607,33607,33609,0,2,3
9573,1,2,33608,33609,33611,1,3,0
9574,5,3,33613,33613,33616,0,3,2
9575,5,1,33618,33618,33619,0,1,2
9576,3,3,33621,33621,33624,0,3,2
9577,6,1,33627,33627,33628,0,1,3
9578,6,1,33633,33633,33634,0,1,5
9579,1,2,33634,33634,33636,0,2,0
9580,2,1,33636,33636,33637,0,1,0
9581,1,1,33637,33637,33638,0,1,0
9582,2,3,33639,33639,33642,0,3,1
9583,6,3,33645,33645,33648,0,3,3
9584,4,1,33649,33649,33650,0,1,1
9585,4,3,33653,33653,33656,0,3,3
9586,2,3,33655,33656,33659,1,4,0
9587,3,3,33658,33659,33662,1,4,0
9588,4,2,33662,33662,33664,0,2,0
9589,1,2,33663,33664,33666,1,3,0
9590,6,1,33669,33669,33670,0,1,3
9591,3,3,33672,33672,33675,0,3,2
9592,1,2,33673,33675,33677,2,4,0
9593,5,1,33678,33678,33679,0,1,1
9594,1,2,33679,33679,33681,0,2,0
9595,5,3,33684,33684,33687,0,3,3
9596,6,3,33690,33690,33693,0,3,3
9597,3,1,33693,33693,33694,0,1,0
9598,2,2,33695,33695,33697,0,2,1
9599,4,3,33699,33699,33702,0,3,2
9600,6,3,33705,33705,33708,0,3,3
9601,2,1,33707,33708,33709,1,2,0
9602,5,3,33712,33712,33715,0,3,3
9603,6,3,33718,33718,33721,0,3,3
9604,3,2,33721,33721,33723,0,2,0
9605,5,2,33726,33726,33728,0,2,3
9606,5,3,33731,33731,33734,0,3,3
9607,4,1,33735,33735,33736,0,1,1
9608,4,1,33739,33739,33740,0,1,3
9609,5,2,33744,33744,33746,0,2,4
9610,6,1,33750,33750,33751,0,1,4
9611,4,3,33754,33754,33757,0,3,3
9612,4,3,33758,33758,33761,0,3,1
9613,5,2,33763,33763,33765,0,2,2
9614,6,2,33769,33769,33771,0,2,4
9615,6,1,33775,33775,33776,0,1,4
9616,6,1,33781,33781,33782,0,1,5
9617,3,2,33784,33784,33786,0,2,2
9618,4,2,33788,33788,33790,0,2,2
9619,2,3,33790,33790,33793,0,3,0
9620,5,3,33795,33795,33798,0,3,2
9621,4,2,33799,33799,33801,0,2,1
9622,2,3,33801,33801,33804,0,3,0
9623,6,3,33807,33807,33810,0,3,3
9624,6,3,33813,33813,33816,0,3,3
9625,1,3,33814,33816,33819,2,5,0
9626,5,1,33819,33819,33820,0,1,0
9627,5,2,33824,33824,33826,0,2,4
9628,5,1,33829,33829,33830,0,1,3
9629,5,3,33834,33834,33837,0,3,4
9630,6,1,33840,33840,33841,0,1,3
9631,4,3,33844,33844,33847,0,3,3
9632,3,1,33847,33847,33848,0,1,0
9633,3,2,33850,33850,33852,0,2,2
9634,3,2,33853,33853,33855,0,2,1
9635,1,2,33854,33855,33857,1,3,0
9636,4,2,33858,33858,33860,0,2,1
9637,5,2,33863,33863,33865,0,2,3
9638,2,2,33865,33865,33867,0,2,0
9639,2,2,33867,33867,33869,0,2,0
9640,4,2,33871,33871,33873,0,2,2
9641,5,3,33876,33876,33879,0,3,3
9642,3,2,33879,33879,33881,0,2,0
9643,4,3,33883,33883,33886,0,3,2
9644,4,1,33887,33887,33888,0,1,1
9645,2,3,33889,33889,33892,0,3,1
9646,4,2,33893,33893,33895,0,2,1
9647,3,2,33896,33896,33898,0,2,1
9648,6,3,33902,33902,33905,0,3,4
9649,3,2,33905,33905,33907,0,2,0
9650,2,3,33907,33907,33910,0,3,0
9651,5,1,33912,33912,33913,0,1,2
9652,3,2,33915,33915,33917,0,2,2
9653,5,1,33920,33920,33921,0,1,3
9654,6,3,33926,33926,33929,0,3,5
9655,1,3,33927,33929,33932,2,5,0
9656,6,1,33933,33933,33934,0,1,1
9657,6,3,33939,33939,33942,0,3,5
9658,1,3,33940,33942,33945,2,5,0
9659,2,3,33942,33945,33948,3,6,0
9660,5,2,33947,33948,33950,1,3,0
9661,2,1,33949,33950,33951,1,2,0
9662,3,3,33952,33952,33955,0,3,1
9663,1,2,33953,33955,33957,2,4,0
9664,1,1,33954,33957,33958,3,4,0
9665,1,1,33955,33958,33959,3,4,0
9666,1,3,33956,33959,33962,3,6,0
9667,4,3,33960,33962,33965,2,5,0
9668,1,3,33961,33965,33968,4,7,0
9669,3,3,33964,33968,33971,4,7,0
9670,1,3,33965,33971,33974,6,9,0
9671,1,2,33966,33974,33976,8,10,0
9672,4,1,33970,33976,33977,6,7,0
9673,2,2,33972,33977,33979,5,7,0
9674,2,1,33974,33979,33980,5,6,0
9675,6,1,33980,33980,33981,0,1,0
9676,2,1,33982,33982,33983,0,1,1
9677,2,1,33984,33984,33985,0,1,1
9678,2,2,33986,33986,33988,0,2,1
9679,6,2,33992,33992,33994,0,2,4
9680,5,1,33997,33997,33998,0,1,3
9681,1,2,33998,33998,34000,0,2,0
9682,1,2,33999,34000,34002,1,3,0
9683,4,1,34003,34003,34004,0,1,1
9684,4,2,34007,34007,34009,0,2,3
9685,3,2,34010,34010,34012,0,2,1
9686,1,1,34011,34012,34013,1,2,0
9687,2,3,34013,34013,34016,0,3,0
9688,5,1,34018,34018,34019,0,1,2
9689,1,1,34019,34019,34020,0,1,0
9690,5,1,34024,34024,34025,0,1,4
9691,1,3,34025,34025,34028,0,3,0
9692,4,3,34029,34029,34032,0,3,1
9693,6,3,34035,34035,34038,0,3,3
9694,5,3,34040,34040,34043,0,3,2
9695,5,3,34045,34045,34048,0,3,2
9696,6,2,34051,34051,34053,0,2,3
9697,5,3,34056,34056,34059,0,3,3
9698,1,1,34057,34059,34060,2,3,0
9699,6,2,34063,34063,34065,0,2,3
9700,3,2,34066,34066,34068,0,2,1
9701,5,1,34071,34071,34072,0,1,3
9702,4,3,34075,34075,34078,0,3,3
9703,1,3,34076,34078,34081,2,5,0
9704,4,2,34080,34081,34083,1,3,0
9705,5,1,34085,34085,34086,0,1,2
9706,2,3,34087,34087,34090,0,3,1
9707,4,1,34091,34091,34092,0,1,1
9708,3,2,34094,34094,34096,0,2,2
9709,4,1,34098,34098,34099,0,1,2
9710,5,1,34103,34103,34104,0,1,4
9711,3,1,34106,34106,34107,0,1,2
9712,1,1,34107,34107,34108,0,1,0
9713,3,3,34110,34110,34113,0,3,2
9714,6,1,34116,34116,34117,0,1,3
9715,5,1,34121,34121,34122,0,1,4
9716,4,3,34125,34125,34128,0,3,3
9717,5,1,34130,34130,34131,0,1,2
9718,5,1,34135,34135,34136,0,1,4
9719,5,3,34140,34140,34143,0,3,4
9720,2,3,34142,34143,34146,1,4,0
9721,4,2,34146,34146,34148,0,2,0
9722,3,1,34149,34149,34150,0,1,1
9723,2,3,34151,34151,34154,0,3,1
9724,6,3,34157,34157,34160,0,3,3
9725,1,3,34158,34160,34163,2,5,0
9726,4,3,34162,34163,34166,1,4,0
9727,4,3,34166,34166,34169,0,3,0
9728,6,2,34172,34172,34174,0,2,3
9729,5,1,34177,34177,34178,0,1,3
9730,6,1,34183,34183,34184,0,1,5
9731,5,2,34188,34188,34190,0,2,4
9732,2,1,34190,34190,34191,0,1,0
9733,6,3,34196,34196,34199,0,3,5
9734,6,3,34202,34202,34205,0,3,3
9735,5,2,34207,34207,34209,0,2,2
9736,1,3,34208,34209,34212,1,4,0
9737,1,2,34209,34212,34214,3,5,0
9738,5,1,34214,34214,34215,0,1,0
9739,2,3,34216,34216,34219,0,3,1
9740,3,2,34219,34219,34221,0,2,0
9741,2,2,34221,34221,34223,0,2,0
9742,2,3,34223,34223,34226,0,3,0
9743,4,2,34227,34227,34229,0,2,1
9744,3,3,34230,34230,34233,0,3,1
9745,3,3,34233,34233,34236,0,3,0
9746,2,3,34235,34236,34239,1,4,0
9747,4,3,34239,34239,34242,0,3,0
9748,5,2,34244,34244,34246,0,2,2
9749,1,1,34245,34246,34247,1,2,0
9750,3,2,34248,34248,34250,0,2,1
9751,5,1,34253,34253,34254,0,1,3
9752,2,1,34255,34255,34256,0,1,1
9753,6,3,34261,34261,34264,0,3,5
9754,2,1,34263,34264,34265,1,2,0
9755,3,3,34266,34266,34269,0,3,1
9756,2,1,34268,34269,34270,1,2,0
9757,5,1,34273,34273,34274,0,1,3
9758,4,2,34277,34277,34279,0,2,3
9759,1,3,34278,34279,34282,1,4,0
9760,4,3,34282,34282,34285,0,3,0
9761,5,3,34287,34287,34290,0,3,2
9762,5,2,34292,34292,34294,0,2,2
9763,5,3,34297,34297,34300,0,3,3
9764,2,2,34299,34300,34302,1,3,0
9765,6,1,34305,34305,34306,0,1,3
9766,5,2,34310,34310,34312,0,2,4
9767,6,1,34316,34316,34317,0,1,4
9768,4,1,34320,34320,34321,0,1,3
9769,6,3,34326,34326,34329,0,3,5
9770,1,3,34327,34329,34332,2,5,0
9771,2,3,34329,34332,34335,3,6,0
9772,3,3,34332,34335,34338,3,6,0
9773,6,3,34338,34338,34341,0,3,0
9774,4,3,34342,34342,34345,0,3,1
9775,1,3,34343,34345,34348,2,5,0
9776,2,1,34345,34348,34349,3,4,0
9777,4,3,34349,34349,34352,0,3,0
9778,4,3,34353,34353,34356,0,3,1
9779,1,2,34354,34356,34358,2,4,0
9780,1,2,34355,34358,34360,3,5,0
9781,3,3,34358,34360,34363,2,5,0
9782,2,3,34360,34363,34366,3,6,0
9783,1,2,34361,34366,34368,5,7,0
9784,3,1,34364,34368,34369,4,5,0
9785,4,3,34368,34369,34372,1,4,0
9786,4,1,34372,34372,34373,0,1,0
9787,1,2,34373,34373,34375,0,2,0
9788,2,2,34375,34375,34377,0,2,0
9789,3,1,34378,34378,34379,0,1,1
9790,6,2,34384,34384,34386,0,2,5
9791,2,3,34386,34386,34389,0,3,0
9792,3,2,34389,34389,34391,0,2,0
9793,3,2,34392,34392,34394,0,2,1
9794,3,2,34395,34395,34397,0,2,1
9795,3,3,34398,34398,34401,0,3,1
9796,3,1,34401,34401,34402,0,1,0
9797,6,2,34407,34407,34409,0,2,5
9798,6,3,34413,34413,34416,0,3,4
9799,5,1,34418,34418,34419,0,1,2
9800,6,3,34424,34424,34427,0,3,5
9801,5,1,34429,34429,34430,0,1,2
9802,5,2,34434,34434,34436,0,2,4
9803,5,3,34439,34439,34442,0,3,3
9804,2,1,34441,34442,34443,1,2,0
9805,1,1,34442,34443,34444,1,2,0
9806,2,2,34444,34444,34446,0,2,0
9807,3,2,34447,34447,34449,0,2,1
9808,1,3,34448,34449,34452,1,4,0
9809,2,2,34450,34452,34454,2,4,0
9810,4,2,34454,34454,34456,0,2,0
9811,6,2,34460,34460,34462,0,2,4
9812,3,3,34463,34463,34466,0,3,1
9813,4,2,34467,34467,34469,0,2,1
9814,1,1,34468,34469,34470,1,2,0
9815,3,2,34471,34471,34473,0,2,1
9816,6,1,34477,34477,34478,0,1,4
9817,5,3,34482,34482,34485,0,3,4
9818,4,1,34486,34486,34487,0,1,1
9819,1,1,34487,34487,34488,0,1,0
9820,3,3,34490,34490,34493,0,3,2
9821,6,3,34496,34496,34499,0,3,3
9822,3,2,34499,34499,34501,0,2,0
9823,5,3,34504,34504,34507,0,3,3
9824,5,3,34509,34509,34512,0,3,2
9825,5,1,34514,34514,34515,0,1,2
9826,5,2,34519,34519,34521,0,2,4
9827,4,1,34523,34523,34524,0,1,2
9828,4,3,34527,34527,34530,0,3,3
9829,4,1,34531,34531,34532,0,1,1
9830,6,3,34537,34537,34540,0,3,5
9831,6,1,34543,34543,34544,0,1,3
9832,4,1,34547,34547,34548,0,1,3
9833,6,2,34553,34553,34555,0,2,5
9834,4,2,34557,34557,34559,0,2,2
9835,6,1,34563,34563,34564,0,1,4
9836,2,3,34565,34565,34568,0,3,1
9837,4,3,34569,34569,34572,0,3,1
9838,4,3,34573,34573,34576,0,3,1
9839,5,2,34578,34578,34580,0,2,2
9840,4,3,34582,34582,34585,0,3,2
9841,1,1,34583,34585,34586,2,3,0
9842,5,3,34588,34588,34591,0,3,2
9843,2,3,34590,34591,34594,1,4,0
9844,5,3,34595,34595,34598,0,3,1
9845,3,2,34598,34598,34600,0,2,0
9846,5,3,34603,34603,34606,0,3,3
9847,4,2,34607,34607,34609,0,2,1
9848,1,2,34608,34609,34611,1,3,0
9849,1,1,34609,34611,34612,2,3,0
9850,3,2,34612,34612,34614,0,2,0
9851,1,3,34613,34614,34617,1,4,0
9852,3,1,34616,34617,34618,1,2,0
9853,3,1,34619,34619,34620,0,1,1
9854,5,1,34624,34624,34625,0,1,4
9855,1,2,34625,34625,34627,0,2,0
9856,3,3,34628,34628,34631,0,3,1
9857,2,1,34630,34631,34632,1,2,0
9858,6,1,34636,34636,34637,0,1,4
9859,3,2,34639,34639,34641,0,2,2
9860,1,1,34640,34641,34642,1,2,0
9861,3,2,34643,34643,34645,0,2,1
9862,3,3,34646,34646,34649,0,3,1
9863,1,2,34647,34649,34651,2,4,0
9864,2,2,34649,34651,34653,2,4,0
9865,1,3,34650,34653,34656,3,6,0
9866,3,3,34653,34656,34659,3,6,0
9867,3,1,34656,34659,34660,3,4,0
9868,5,3,34661,34661,34664,0,3,1
9869,6,3,34667,34667,34670,0,3,3
9870,2,1,34669,34670,34671,1,2,0
9871,6,3,34675,34675,34678,0,3,4
9872,5,3,34680,34680,34683,0,3,2
9873,2,3,34682,34683,34686,1,4,0
9874,6,3,34688,34688,34691,0,3,2
9875,3,1,34691,34691,34692,0,1,0
9876,2,1,34693,34693,34694,0,1,1
9877,5,2,34698,34698,34700,0,2,4
9878,3,3,34701,34701,34704,0,3,1
9879,1,3,34702,34704,34707,2,5,0
9880,3,1,34705,34707,34708,2,3,0
9881,6,1,34711,34711,34712,0,1,3
9882,4,1,34715,34715,34716,0,1,3
9883,3,3,34718,34718,34721,0,3,2
9884,6,1,34724,34724,34725,0,1,3
9885,4,3,34728,34728,34731,0,3,3
9886,3,1,34731,34731,34732,0,1,0
9887,2,3,34733,34733,34736,0,3,1
9888,3,2,34736,34736,34738,0,2,0
9889,5,3,34741,34741,34744,0,3,3
9890,5,2,34746,34746,34748,0,2,2
9891,3,3,34749,34749,34752,0,3,1
9892,6,2,34755,34755,34757,0,2,3
9893,3,1,34758,34758,34759,0,1,1
9894,6,2,34764,34764,34766,0,2,5
9895,1,2,34765,34766,34768,1,3,0
9896,6,1,34771,34771,34772,0,1,3
9897,1,1,34772,34772,34773,0,1,0
9898,3,1,34775,34775,34776,0,1,2
9899,5,2,34780,34780,34782,0,2,4
9900,1,1,34781,34782,34783,1,2,0
9901,6,1,34787,34787,34788,0,1,4
9902,5,1,34792,34792,34793,0,1,4
9903,2,2,34794,34794,34796,0,2,1
9904,5,3,34799,34799,34802,0,3,3
9905,2,3,34801,34802,34805,1,4,0
9906,4,1,34805,34805,34806,0,1,0
9907,4,3,34809,34809,34812,0,3,3
9908,5,1,34814,34814,34815,0,1,2
9909,2,3,34816,34816,34819,0,3,1
9910,2,3,34818,34819,34822,1,4,0
9911,3,3,34821,34822,34825,1,4,0
9912,2,3,34823,34825,34828,2,5,0
9913,1,2,34824,34828,34830,4,6,0
9914,1,1,34825,34830,34831,5,6,0
9915,3,1,34828,34831,34832,3,4,0
9916,5,1,34833,34833,34834,0,1,1
9917,1,3,34834,34834,34837,0,3,0
9918,3,3,34837,34837,34840,0,3,0
9919,3,3,34840,34840,34843,0,3,0
9920,3,3,34843,34843,34846,0,3,0
9921,1,1,34844,34846,34847,2,3,0
9922,6,3,34850,34850,34853,0,3,3
9923,4,1,34854,34854,34855,0,1,1
9924,5,3,34859,34859,34862,0,3,4
9925,4,1,34863,34863,34864,0,1,1
9926,6,3,34869,34869,34872,0,3,5
9927,5,2,34874,34874,34876,0,2,2
9928,1,3,34875,34876,34879,1,4,0
9929,1,2,34876,34879,34881,3,5,0
9930,2,3,34878,34881,34884,3,6,0
9931,3,3,34881,34884,34887,3,6,0
9932,2,2,34883,34887,34889,4,6,0
9933,2,1,34885,34889,34890,4,5,0
9934,2,2,34887,34890,34892,3,5,0
9935,3,3,34890,34892,34895,2,5,0
9936,6,1,34896,34896,34897,0,1,1
9937,2,2,34898,34898,34900,0,2,1
9938,6,3,34904,34904,34907,0,3,4
9939,3,3,34907,34907,34910,0,3,0
9940,2,3,34909,34910,34913,1,4,0
9941,4,1,34913,34913,34914,0,1,0
9942,6,2,34919,34919,34921,0,2,5
9943,2,2,34921,34921,34923,0,2,0
9944,2,3,34923,34923,34926,0,3,0
9945,5,2,34928,34928,34930,0,2,2
9946,5,3,34933,34933,34936,0,3,3
9947,1,3,34934,34936,34939,2,5,0
9948,4,3,34938,34939,34942,1,4,0
9949,4,2,34942,34942,34944,0,2,0
9950,3,1,34945,34945,34946,0,1,1
9951,5,2,34950,34950,34952,0,2,4
9952,3,3,34953,34953,34956,0,3,1
9953,3,3,34956,34956,34959,0,3,0
9954,1,3,34957,34959,34962,2,5,0
9955,3,2,34960,34962,34964,2,4,0
9956,2,2,34962,34964,34966,2,4,0
9957,3,2,34965,34966,34968,1,3,0
9958,3,3,34968,34968,34971,0,3,0
9959,5,2,34973,34973,34975,0,2,2
9960,4,1,34977,34977,34978,0,1,2
9961,6,1,34983,34983,34984,0,1,5
9962,4,2,34987,34987,34989,0,2,3
9963,5,3,34992,34992,34995,0,3,3
9964,3,1,34995,34995,34996,0,1,0
9965,3,3,34998,34998,35001,0,3,2
9966,5,3,35003,35003,35006,0,3,2
9967,3,3,35006,35006,35009,0,3,0
9968,4,3,35010,35010,35013,0,3,1
9969,6,1,35016,35016,35017,0,1,3
9970,1,1,35017,35017,35018,0,1,0
9971,6,3,35023,35023,35026,0,3,5
9972,3,1,35026,35026,35027,0,1,0
9973,4,2,35030,35030,35032,0,2,3
9974,2,1,35032,35032,35033,0,1,0
9975,6,3,35038,35038,35041,0,3,5
9976,2,1,35040,35041,35042,1,2,0
9977,1,2,35041,35042,35044,1,3,0
9978,4,2,35045,35045,35047,0,2,1
9979,1,1,35046,35047,35048,1,2,0
9980,6,3,35052,35052,35055,0,3,4
9981,3,1,35055,35055,35056,0,1,0
9982,3,1,35058,35058,35059,0,1,2
9983,2,3,35060,35060,35063,0,3,1
9984,1,3,35061,35063,35066,2,5,0
9985,2,2,35063,35066,35068,3,5,0
9986,1,1,35064,35068,35069,4,5,0
9987,6,1,35070,35070,35071,0,1,1
9988,6,1,35076,35076,35077,0,1,5
9989,2,1,35078,35078,35079,0,1,1
9990,5,2,35083,35083,35085,0,2,4
9991,4,2,35087,35087,35089,0,2,2
9992,5,3,35092,35092,35095,0,3,3
9993,5,1,35097,35097,35098,0,1,2
9994,1,2,35098,35098,35100,0,2,0
9995,6,1,35104,35104,35105,0,1,4
9996,2,3,35106,35106,35109,0,3,1
9997,4,1,35110,35110,35111,0,1,1
9998,1,2,35111,35111,35113,0,2,0
9999,6,1,35117,35117,35118,0,1,4
10000,3,3,35120,35120,35123,0,3,2
10001,2,3,35122,35123,35126,1,4,0
10002,3,2,35125,35126,35128,1,3,0
10003,4,1,35129,35129,35130,0,1,1
10004,2,3,35131,35131,35134,0,3,1
10005,6,1,35137,35137,35138,0,1,3
10006,2,2,35139,35139,35141,0,2,1
10007,3,3,35142,35142,35145,0,3,1
10008,4,1,35146,35146,35147,0,1,1
10009,4,2,35150,35150,35152,0,2,3
10010,2,1,35152,35152,35153,0,1,0
10011,6,2,35158,35158,35160,0,2,5
10012,6,1,35164,35164,35165,0,1,4
10013,2,1,35166,35166,35167,0,1,1
10014,5,3,35171,35171,35174,0,3,4
10015,1,3,35172,35174,35177,2,5,0
10016,2,1,35174,35177,35178,3,4,0
10017,5,2,35179,35179,35181,0,2,1
10018,6,1,35185,35185,35186,0,1,4
10019,1,2,35186,35186,35188,0,2,0
10020,4,1,35190,35190,35191,0,1,2
10021,6,1,35196,35196,35197,0,1,5
10022,6,2,35202,35202,35204,0,2,5
10023,2,1,35204,35204,35205,0,1,0
10024,5,3,35209,35209,35212,0,3,4
10025,5,1,35214,35214,35215,0,1,2
10026,2,1,35216,35216,35217,0,1,1
10027,5,3,35221,35221,35224,0,3,4
10028,2,2,35223,35224,35226,1,3,0
10029,2,2,35225,35226,35228,1,3,0
10030,6,2,35231,35231,35233,0,2,3
10031,3,2,35234,35234,35236,0,2,1
10032,4,1,35238,35238,35239,0,1,2
10033,6,3,35244,35244,35247,0,3,5
10034,3,2,35247,35247,35249,0,2,0
10035,6,2,35253,35253,35255,0,2,4
10036,4,3,35257,35257,35260,0,3,2
10037,3,1,35260,35260,35261,0,1,0
10038,1,2,35261,35261,35263,0,2,0
10039,3,3,35264,35264,35267,0,3,1
10040,6,1,35270,35270,35271,0,1,3
10041,5,1,35275,35275,35276,0,1,4
10042,4,1,35279,35279,35280,0,1,3
10043,5,1,35284,35284,35285,0,1,4
10044,6,2,35290,35290,35292,0,2,5
10045,2,2,35292,35292,35294,0,2,0
10046,2,1,35294,35294,35295,0,1,0
10047,3,2,35297,35297,35299,0,2,2
10048,2,3,35299,35299,35302,0,3,0
10049,1,1,35300,35302,35303,2,3,0
10050,1,3,35301,35303,35306,2,5,0
10051,6,1,35307,35307,35308,0,1,1
10052,6,1,35313,35313,35314,0,1,5
10053,2,2,35315,35315,35317,0,2,1
10054,5,3,35320,35320,35323,0,3,3
10055,1,1,35321,35323,35324,2,3,0
10056,1,2,35322,35324,35326,2,4,0
10057,2,3,35324,35326,35329,2,5,0
10058,1,3,35325,35329,35332,4,7,0
10059,6,3,35331,35332,35335,1,4,0
10060,6,3,35337,35337,35340,0,3,2
10061,6,2,35343,35343,35345,0,2,3
10062,4,3,35347,35347,35350,0,3,2
10063,3,1,35350,35350,35351,0,1,0
10064,2,2,35352,35352,35354,0,2,1
10065,4,1,35356,35356,35357,0,1,2
10066,2,2,35358,35358,35360,0,2,1
10067,4,2,35362,35362,35364,0,2,2
10068,6,2,35368,35368,35370,0,2,4
10069,2,2,35370,35370,35372,0,2,0
10070,1,2,35371,35372,35374,1,3,0
10071,1,3,35372,35374,35377,2,5,0
10072,3,1,35375,35377,35378,2,3,0
10073,4,3,35379,35379,35382,0,3,1
10074,6,2,35385,35385,35387,0,2,3
10075,1,3,35386,35387,35390,1,4,0
10076,4,3,35390,35390,35393,0,3,0
10077,6,3,35396,35396,35399,0,3,3
10078,3,3,35399,35399,35402,0,3,0
10079,2,2,35401,35402,35404,1,3,0
10080,1,2,35402,35404,35406,2,4,0
10081,2,3,35404,35406,35409,2,5,0
10082,6,3,35410,35410,35413,0,3,1
10083,6,2,35416,35416,35418,0,2,3
10084,1,2,35417,35418,35420,1,3,0
10085,3,1,35420,35420,35421,0,1,0
10086,1,3,35421,35421,35424,0,3,0
10087,6,1,35427,35427,35428,0,1,3
10088,4,3,35431,35431,35434,0,3,3
10089,1,3,35432,35434,35437,2,5,0
10090,3,1,35435,35437,35438,2,3,0
10091,5,1,35440,35440,35441,0,1,2
10092,6,2,35446,35446,35448,0,2,5
10093,3,1,35449,35449,35450,0,1,1
10094,4,1,35453,35453,35454,0,1,3
10095,4,1,35457,35457,35458,0,1,3
10096,2,1,35459,35459,35460,0,1,1
10097,4,2,35463,35463,35465,0,2,3
10098,4,3,35467,35467,35470,0,3,2
10099,4,2,35471,35471,35473,0,2,1
10100,4,1,35475,35475,35476,0,1,2
10101,3,2,35478,35478,35480,0,2,2
10102,2,1,35480,35480,35481,0,1,0
10103,5,2,35485,35485,35487,0,2,4
10104,5,2,35490,35490,35492,0,2,3
10105,4,2,35494,35494,35496,0,2,2
10106,5,3,35499,35499,35502,0,3,3
10107,3,2,35502,35502,35504,0,2,0
10108,4,3,35506,35506,35509,0,3,2
10109,6,3,35512,35512,35515,0,3,3
10110,2,1,35514,35515,35516,1,2,0
10111,4,3,35518,35518,35521,0,3,2
10112,4,3,35522,35522,35525,0,3,1
10113,6,2,35528,35528,35530,0,2,3
10114,6,3,35534,35534,35537,0,3,4
10115,6,3,35540,35540,35543,0,3,3
10116,5,1,35545,35545,35546,0,1,2
10117,5,1,35550,35550,35551,0,1,4
10118,5,2,35555,35555,35557,0,2,4
10119,3,1,35558,35558,35559,0,1,1
10120,3,3,35561,35561,35564,0,3,2
10121,4,3,35565,35565,35568,0,3,1
10122,3,3,35568,35568,35571,0,3,0
10123,5,2,35573,35573,35575,0,2,2
10124,3,3,35576,35576,35579,0,3,1
10125,4,2,35580,35580,35582,0,2,1
10126,4,1,35584,35584,35585,0,1,2
10127,4,3,35588,35588,35591,0,3,3
10128,2,3,35590,35591,35594,1,4,0
10129,2,1,35592,35594,35595,2,3,0
10130,3,2,35595,35595,35597,0,2,0
10131,1,1,35596,35597,35598,1,2,0
10132,3,2,35599,35599,35601,0,2,1
10133,3,3,35602,35602,35605,0,3,1
10134,2,2,35604,35605,35607,1,3,0
10135,6,3,35610,35610,35613,0,3,3
10136,5,3,35615,35615,35618,0,3,2
10137,5,3,35620,35620,35623,0,3,2
10138,6,3,35626,35626,35629,0,3,3
10139,6,2,35632,35632,35634,0,2,3
10140,5,1,35637,35637,35638,0,1,3
10141,1,1,35638,35638,35639,0,1,0
10142,1,3,35639,35639,35642,0,3,0
10143,2,3,35641,35642,35645,1,4,0
10144,3,3,35644,35645,35648,1,4,0
10145,6,3,35650,35650,35653,0,3,2
10146,4,2,35654,35654,35656,0,2,1
10147,6,2,35660,35660,35662,0,2,4
10148,4,1,35664,35664,35665,0,1,2
10149,4,3,35668,35668,35671,0,3,3
10150,2,1,35670,35671,35672,1,2,0
10151,1,2,35671,35672,35674,1,3,0
10152,3,1,35674,35674,35675,0,1,0
10153,5,3,35679,35679,35682,0,3,4
10154,2,1,35681,35682,35683,1,2,0
10155,4,2,35685,35685,35687,0,2,2
10156,6,1,35691,35691,35692,0,1,4
10157,1,2,35692,35692,35694,0,2,0
10158,3,1,35695,35695,35696,0,1,1
10159,5,1,35700,35700,35701,0,1,4
10160,6,3,35706,35706,35709,0,3,5
10161,1,3,35707,35709,35712,2,5,0
10162,1,3,35708,35712,35715,4,7,0
10163,1,2,35709,35715,35717,6,8,0
10164,5,1,35714,35717,35718,3,4,0
10165,1,3,35715,35718,35721,3,6,0
10166,5,2,35720,35721,35723,1,3,0
10167,3,3,35723,35723,35726,0,3,0
10168,1,3,35724,35726,35729,2,5,0
10169,5,2,35729,35729,35731,0,2,0
10170,1,1,35730,35731,35732,1,2,0
10171,1,1,35731,35732,35733,1,2,0
10172,6,3,35737,35737,35740,0,3,4
10173,1,3,35738,35740,35743,2,5,0
10174,1,1,35739,35743,35744,4,5,0
10175,3,1,35742,35744,35745,2,3,0
10176,4,1,35746,35746,35747,0,1,1
10177,6,1,35752,35752,35753,0,1,5
10178,6,2,35758,35758,35760,0,2,5
10179,6,3,35764,35764,35767,0,3,4
10180,4,1,35768,35768,35769,0,1,1
10181,2,3,35770,35770,35773,0,3,1
10182,2,2,35772,35773,35775,1,3,0
10183,2,3,35774,35775,35778,1,4,0
10184,1,3,35775,35778,35781,3,6,0
10185,1,1,35776,35781,35782,5,6,0
10186,2,2,35778,35782,35784,4,6,0
10187,3,3,35781,35784,35787,3,6,0
10188,3,1,35784,35787,35788,3,4,0
10189,4,3,35788,35788,35791,0,3,0
10190,1,3,35789,35791,35794,2,5,0
10191,1,1,35790,35794,35795,4,5,0
10192,2,2,35792,35795,35797,3,5,0
10193,1,2,35793,35797,35799,4,6,0
10194,6,1,35799,35799,35800,0,1,0
10195,4,2,35803,35803,35805,0,2,3
10196,2,1,35805,35805,35806,0,1,0
10197,1,2,35806,35806,35808,0,2,0
10198,3,2,35809,35809,35811,0,2,1
10199,1,1,35810,35811,35812,1,2,0
10200,6,1,35816,35816,35817,0,1,4
10201,6,3,35822,35822,35825,0,3,5
10202,1,3,35823,35825,35828,2,5,0
10203,5,2,35828,35828,35830,0,2,0
10204,3,2,35831,35831,35833,0,2,1
10205,3,3,35834,35834,35837,0,3,1
10206,4,1,35838,35838,35839,0,1,1
10207,4,2,35842,35842,35844,0,2,3
10208,3,3,35845,35845,35848,0,3,1
10209,4,2,35849,35849,35851,0,2,1
10210,2,2,35851,35851,35853,0,2,0
10211,3,3,35854,35854,35857,0,3,1
10212,5,3,35859,35859,35862,0,3,2
10213,1,1,35860,35862,35863,2,3,0
10214,3,1,35863,35863,35864,0,1,0
10215,5,3,35868,35868,35871,0,3,4
10216,3,2,35871,35871,35873,0,2,0
10217,6,1,35877,35877,35878,0,1,4
10218,1,3,35878,35878,35881,0,3,0
10219,2,1,35880,35881,35882,1,2,0
10220,1,2,35881,35882,35884,1,3,0
10221,3,2,35884,35884,35886,0,2,0
10222,6,2,35890,35890,35892,0,2,4
10223,3,2,35893,35893,35895,0,2,1
10224,3,1,35896,35896,35897,0,1,1
10225,3,1,35899,35899,35900,0,1,2
10226,4,3,35903,35903,35906,0,3,3
10227,5,2,35908,35908,35910,0,2,2
10228,6,3,35914,35914,35917,0,3,4
10229,2,3,35916,35917,35920,1,4,0
10230,5,1,35921,35921,35922,0,1,1
10231,3,3,35924,35924,35927,0,3,2
10232,4,3,35928,35928,35931,0,3,1
10233,1,2,35929,35931,35933,2,4,0
10234,5,3,35934,35934,35937,0,3,1
10235,3,1,35937,35937,35938,0,1,0
10236,4,2,35941,35941,35943,0,2,3
10237,3,2,35944,35944,35946,0,2,1
10238,1,1,35945,35946,35947,1,2,0
10239,2,3,35947,35947,35950,0,3,0
10240,4,3,35951,35951,35954,0,3,1
10241,1,1,35952,35954,35955,2,3,0
10242,4,1,35956,35956,35957,0,1,1
10243,6,2,35962,35962,35964,0,2,5
10244,1,1,35963,35964,35965,1,2,0
10245,2,2,35965,35965,35967,0,2,0
10246,2,1,35967,35967,35968,0,1,0
10247,2,2,35969,35969,35971,0,2,1
10248,4,3,35973,35973,35976,0,3,2
10249,5,3,35978,35978,35981,0,3,2
10250,3,1,35981,35981,35982,0,1,0
10251,4,1,35985,35985,35986,0,1,3
10252,4,1,35989,35989,35990,0,1,3
10253,4,1,35993,35993,35994,0,1,3
10254,3,1,35996,35996,35997,0,1,2
10255,5,1,36001,36001,36002,0,1,4
10256,6,3,36007,36007,36010,0,3,5
10257,2,2,36009,36010,36012,1,3,0
10258,3,2,36012,36012,36014,0,2,0
10259,4,2,36016,36016,36018,0,2,2
10260,3,3,36019,36019,36022,0,3,1
10261,4,1,36023,36023,36024,0,1,1
10262,5,2,36028,36028,36030,0,2,4
10263,1,2,36029,36030,36032,1,3,0
10264,5,2,36034,36034,36036,0,2,2
10265,5,2,36039,36039,36041,0,2,3
10266,1,2,36040,36041,36043,1,3,0
10267,4,3,36044,36044,36047,0,3,1
10268,5,1,36049,36049,36050,0,1,2
10269,3,2,36052,36052,36054,0,2,2
10270,1,1,36053,36054,36055,1,2,0
10271,6,1,36059,36059,36060,0,1,4
10272,2,3,36061,36061,36064,0,3,1
10273,2,3,36063,36064,36067,1,4,0
10274,3,1,36066,36067,36068,1,2,0
10275,6,3,36072,36072,36075,0,3,4
10276,4,3,36076,36076,36079,0,3,1
10277,4,2,36080,36080,36082,0,2,1
10278,4,2,36084,36084,36086,0,2,2
10279,4,3,36088,36088,36091,0,3,2
10280,2,2,36090,36091,36093,1,3,0
10281,3,1,36093,36093,36094,0,1,0
10282,4,2,36097,36097,36099,0,2,3
10283,1,3,36098,36099,36102,1,4,0
10284,5,3,36103,36103,36106,0,3,1
10285,5,1,36108,36108,36109,0,1,2
10286,2,1,36110,36110,36111,0,1,1
10287,5,1,36115,36115,36116,0,1,4
10288,3,1,36118,36118,36119,0,1,2
10289,1,2,36119,36119,36121,0,2,0
10290,4,2,36123,36123,36125,0,2,2
10291,4,3,36127,36127,36130,0,3,2
10292,5,1,36132,36132,36133,0,1,2
10293,6,3,36138,36138,36141,0,3,5
10294,3,3,36141,36141,36144,0,3,0
10295,1,1,36142,36144,36145,2,3,0
10296,1,1,36143,36145,36146,2,3,0
10297,1,2,36144,36146,36148,2,4,0
10298,4,1,36148,36148,36149,0,1,0
10299,6,2,36154,36154,36156,0,2,5
10300,1,1,36155,36156,36157,1,2,0
10301,3,3,36158,36158,36161,0,3,1
10302,5,1,36163,36163,36164,0,1,2
10303,5,3,36168,36168,36171,0,3,4
10304,4,2,36172,36172,36174,0,2,1
10305,5,3,36177,36177,36180,0,3,3
10306,4,3,36181,36181,36184,0,3,1
10307,1,1,36182,36184,36185,2,3,0
10308,3,2,36185,36185,36187,0,2,0
10309,5,1,36190,36190,36191,0,1,3
10310,5,2,36195,36195,36197,0,2,4
10311,6,1,36201,36201,36202,0,1,4
10312,6,1,36207,36207,36208,0,1,5
10313,6,1,36213,36213,36214,0,1,5
10314,4,3,36217,36217,36220,0,3,3
10315,5,1,36222,36222,36223,0,1,2
10316,2,2,36224,36224,36226,0,2,1
10317,2,3,36226,36226,36229,0,3,0
10318,2,2,36228,36229,36231,1,3,0
10319,1,3,36229,36231,36234,2,5,0
10320,1,3,36230,36234,36237,4,7,0
10321,1,3,36231,36237,36240,6,9,0
10322,2,1,36233,36240,36241,7,8,0
10323,6,3,36239,36241,36244,2,5,0
10324,2,2,36241,36244,36246,3,5,0
10325,2,2,36243,36246,36248,3,5,0
10326,1,1,36244,36248,36249,4,5,0
10327,6,3,36250,36250,36253,0,3,1
10328,4,1,36254,36254,36255,0,1,1
10329,4,2,36258,36258,36260,0,2,3
10330,1,3,36259,36260,36263,1,4,0
10331,1,1,36260,36263,36264,3,4,0
10332,2,1,36262,36264,36265,2,3,0
10333,5,1,36267,36267,36268,0,1,2
10334,2,1,36269,36269,36270,0,1,1
10335,3,1,36272,36272,36273,0,1,2
10336,5,1,36277,36277,36278,0,1,4
10337,4,1,36281,36281,36282,0,1,3
10338,3,3,36284,36284,36287,0,3,2
10339,3,3,36287,36287,36290,0,3,0
10340,3,1,36290,36290,36291,0,1,0
10341,6,1,36296,36296,36297,0,1,5
10342,5,3,36301,36301,36304,0,3,4
10343,3,1,36304,36304,36305,0,1,0
10344,2,1,36306,36306,36307,0,1,1
10345,6,3,36312,36312,36315,0,3,5
10346,5,2,36317,36317,36319,0,2,2
10347,2,1,36319,36319,36320,0,1,0
10348,4,2,36323,36323,36325,0,2,3
10349,5,2,36328,36328,36330,0,2,3
10350,6,1,36334,36334,36335,0,1,4
10351,5,3,36339,36339,36342,0,3,4
10352,3,1,36342,36342,36343,0,1,0
10353,4,2,36346,36346,36348,0,2,3
10354,4,2,36350,36350,36352,0,2,2
10355,2,2,36352,36352,36354,0,2,0
10356,5,3,36357,36357,36360,0,3,3
10357,2,1,36359,36360,36361,1,2,0
10358,4,3,36363,36363,36366,0,3,2
10359,3,2,36366,36366,36368,0,2,0
10360,4,1,36370,36370,36371,0,1,2
10361,5,2,36375,36375,36377,0,2,4
10362,1,1,36376,36377,36378,1,2,0
10363,6,2,36382,36382,36384,0,2,4
10364,5,1,36387,36387,36388,0,1,3
10365,1,2,36388,36388,36390,0,2,0
10366,6,3,36394,36394,36397,0,3,4
10367,3,3,36397,36397,36400,0,3,0
10368,1,2,36398,36400,36402,2,4,0
10369,1,3,36399,36402,36405,3,6,0
10370,6,2,36405,36405,36407,0,2,0
10371,3,2,36408,36408,36410,0,2,1
10372,3,2,36411,36411,36413,0,2,1
10373,1,2,36412,36413,36415,1,3,0
10374,3,3,36415,36415,36418,0,3,0
10375,5,1,36420,36420,36421,0,1,2
10376,1,3,36421,36421,36424,0,3,0
10377,5,1,36426,36426,36427,0,1,2
10378,4,1,36430,36430,36431,0,1,3
10379,2,1,36432,36432,36433,0,1,1
10380,5,3,36437,36437,36440,0,3,4
10381,6,1,36443,36443,36444,0,1,3
10382,3,1,36446,36446,36447,0,1,2
10383,5,1,36451,36451,36452,0,1,4
10384,4,2,36455,36455,36457,0,2,3
10385,6,2,36461,36461,36463,0,2,4
10386,4,2,36465,36465,36467,0,2,2
10387,1,1,36466,36467,36468,1,2,0
10388,4,1,36470,36470,36471,0,1,2
10389,6,2,36476,36476,36478,0,2,5
10390,4,1,36480,36480,36481,0,1,2
10391,2,1,36482,36482,36483,0,1,1
10392,2,1,36484,36484,36485,0,1,1
10393,6,1,36490,36490,36491,0,1,5
10394,2,3,36492,36492,36495,0,3,1
10395,4,1,36496,36496,36497,0,1,1
10396,5,3,36501,36501,36504,0,3,4
10397,6,2,36507,36507,36509,0,2,3
10398,5,3,36512,36512,36515,0,3,3
10399,6,1,36518,36518,36519,0,1,3
10400,4,3,36522,36522,36525,0,3,3
10401,4,2,36526,36526,36528,0,2,1
10402,1,1,36527,36528,36529,1,2,0
10403,5,1,36532,36532,36533,0,1,3
10404,1,3,36533,36533,36536,0,3,0
10405,3,3,36536,36536,36539,0,3,0
10406,6,2,36542,36542,36544,0,2,3
10407,3,2,36545,36545,36547,0,2,1
10408,6,3,36551,36551,36554,0,3,4
10409,1,2,36552,36554,36556,2,4,0
10410,2,1,36554,36556,36557,2,3,0
10411,2,2,36556,36557,36559,1,3,0
10412,3,2,36559,36559,36561,0,2,0
10413,6,3,36565,36565,36568,0,3,4
10414,5,3,36570,36570,36573,0,3,2
10415,4,3,36574,36574,36577,0,3,1
10416,1,1,36575,36577,36578,2,3,0
10417,3,3,36578,36578,36581,0,3,0
10418,3,1,36581,36581,36582,0,1,0
10419,3,1,36584,36584,36585,0,1,2
10420,2,2,36586,36586,36588,0,2,1
10421,1,2,36587,36588,36590,1,3,0
10422,6,3,36593,36593,36596,0,3,3
10423,2,3,36595,36596,36599,1,4,0
10424,2,2,36597,36599,36601,2,4,0
10425,3,3,36600,36601,36604,1,4,0
10426,5,3,36605,36605,36608,0,3,1
10427,4,2,36609,36609,36611,0,2,1
10428,3,2,36612,36612,36614,0,2,1
10429,3,1,36615,36615,36616,0,1,1
10430,1,3,36616,36616,36619,0,3,0
10431,2,3,36618,36619,36622,1,4,0
10432,2,1,36620,36622,36623,2,3,0
10433,5,1,36625,36625,36626,0,1,2
10434,5,1,36630,36630,36631,0,1,4
10435,4,1,36634,36634,36635,0,1,3
10436,3,2,36637,36637,36639,0,2,2
10437,3,2,36640,36640,36642,0,2,1
10438,1,1,36641,36642,36643,1,2,0
10439,4,1,36645,36645,36646,0,1,2
10440,2,2,36647,36647,36649,0,2,1
10441,1,2,36648,36649,36651,1,3,0
10442,2,3,36650,36651,36654,1,4,0
10443,5,2,36655,36655,36657,0,2,1
10444,2,3,36657,36657,36660,0,3,0
10445,5,1,36662,36662,36663,0,1,2
10446,2,1,36664,36664,36665,0,1,1
10447,3,2,36667,36667,36669,0,2,2
10448,2,2,36669,36669,36671,0,2,0
10449,1,2,36670,36671,36673,1,3,0
10450,6,1,36676,36676,36677,0,1,3
10451,6,2,36682,36682,36684,0,2,5
10452,1,3,36683,36684,36687,1,4,0
10453,5,3,36688,36688,36691,0,3,1
10454,5,3,36693,36693,36696,0,3,2
10455,2,2,36695,36696,36698,1,3,0
10456,5,3,36700,36700,36703,0,3,2
10457,5,2,36705,36705,36707,0,2,2
10458,4,1,36709,36709,36710,0,1,2
10459,4,3,36713,36713,36716,0,3,3
10460,5,1,36718,36718,36719,0,1,2
10461,3,3,36721,36721,36724,0,3,2
10462,5,3,36726,36726,36729,0,3,2
10463,1,1,36727,36729,36730,2,3,0
10464,2,1,36729,36730,36731,1,2,0
10465,3,1,36732,36732,36733,0,1,1
10466,5,3,36737,36737,36740,0,3,4
10467,2,2,36739,36740,36742,1,3,0
10468,3,2,36742,36742,36744,0,2,0
10469,3,3,36745,36745,36748,0,3,1
10470,6,3,36751,36751,36754,0,3,3
10471,2,3,36753,36754,36757,1,4,0
10472,3,1,36756,36757,36758,1,2,0
10473,5,2,36761,36761,36763,0,2,3
10474,1,2,36762,36763,36765,1,3,0
10475,1,3,36763,36765,36768,2,5,0
10476,6,1,36769,36769,36770,0,1,1
10477,5,1,36774,36774,36775,0,1,4
10478,1,3,36775,36775,36778,0,3,0
10479,4,1,36779,36779,36780,0,1,1
10480,6,1,36785,36785,36786,0,1,5
10481,3,3,36788,36788,36791,0,3,2
10482,1,1,36789,36791,36792,2,3,0
10483,5,2,36794,36794,36796,0,2,2
10484,6,2,36800,36800,36802,0,2,4
10485,5,3,36805,36805,36808,0,3,3
10486,5,2,36810,36810,36812,0,2,2
10487,5,3,36815,36815,36818,0,3,3
10488,1,3,36816,36818,36821,2,5,0
10489,4,2,36820,36821,36823,1,3,0
10490,2,2,36822,36823,36825,1,3,0
10491,6,1,36828,36828,36829,0,1,3
10492,1,2,36829,36829,36831,0,2,0
10493,1,3,36830,36831,36834,1,4,0
10494,5,2,36835,36835,36837,0,2,1
10495,1,2,36836,36837,36839,1,3,0
10496,4,2,36840,36840,36842,0,2,1
10497,3,1,36843,36843,36844,0,1,1
10498,1,1,36844,36844,36845,0,1,0
10499,6,2,36850,36850,36852,0,2,5
10500,3,1,36853,36853,36854,0,1,1
10501,2,2,36855,36855,36857,0,2,1
10502,3,2,36858,36858,36860,0,2,1
10503,5,1,36863,36863,36864,0,1,3
10504,1,2,36864,36864,36866,0,2,0
10505,2,2,36866,36866,36868,0,2,0
10506,1,3,36867,36868,36871,1,4,0
10507,3,3,36870,36871,36874,1,4,0
10508,2,2,36872,36874,36876,2,4,0
10509,5,3,36877,36877,36880,0,3,1
10510,5,3,36882,36882,36885,0,3,2
10511,2,1,36884,36885,36886,1,2,0
10512,4,3,36888,36888,36891,0,3,2
10513,5,2,36893,36893,36895,0,2,2
10514,6,3,36899,36899,36902,0,3,4
10515,6,3,36905,36905,36908,0,3,3
10516,3,1,36908,36908,36909,0,1,0
10517,3,1,36911,36911,36912,0,1,2
10518,4,1,36915,36915,36916,0,1,3
10519,4,2,36919,36919,36921,0,2,3
10520,4,1,36923,36923,36924,0,1,2
10521,6,2,36929,36929,36931,0,2,5
10522,3,1,36932,36932,36933,0,1,1
10523,3,1,36935,36935,36936,0,1,2
10524,1,2,36936,36936,36938,0,2,0
10525,6,2,36942,36942,36944,0,2,4
10526,4,2,36946,36946,36948,0,2,2
10527,3,2,36949,36949,36951,0,2,1
10528,2,3,36951,36951,36954,0,3,0
10529,6,3,36957,36957,36960,0,3,3
10530,1,1,36958,36960,36961,2,3,0
10531,3,3,36961,36961,36964,0,3,0
10532,4,1,36965,36965,36966,0,1,1
10533,2,2,36967,36967,36969,0,2,1
10534,2,1,36969,36969,36970,0,1,0
10535,5,2,36974,36974,36976,0,2,4
10536,6,2,36980,36980,36982,0,2,4
10537,5,1,36985,36985,36986,0,1,3
10538,4,2,36989,36989,36991,0,2,3
10539,4,3,36993,36993,36996,0,3,2
10540,2,3,36995,36996,36999,1,4,0
10541,5,1,37000,37000,37001,0,1,1
10542,2,3,37002,37002,37005,0,3,1
10543,1,2,37003,37005,37007,2,4,0
10544,4,2,37007,37007,37009,0,2,0
10545,1,1,37008,37009,37010,1,2,0
10546,6,2,37014,37014,37016,0,2,4
10547,1,1,37015,37016,37017,1,2,0
10548,3,2,37018,37018,37020,0,2,1
10549,6,3,37024,37024,37027,0,3,4
10550,6,3,37030,37030,37033,0,3,3
10551,1,3,37031,37033,37036,2,5,0
10552,3,3,37034,37036,37039,2,5,0
10553,6,3,37040,37040,37043,0,3,1
10554,2,1,37042,37043,37044,1,2,0
10555,2,1,37044,37044,37045,0,1,0
10556,3,1,37047,37047,37048,0,1,2
10557,1,3,37048,37048,37051,0,3,0
10558,6,1,37054,37054,37055,0,1,3
10559,6,3,37060,37060,37063,0,3,5
10560,6,1,37066,37066,37067,0,1,3
10561,1,2,37067,37067,37069,0,2,0
10562,1,3,37068,37069,37072,1,4,0
10563,5,2,37073,37073,37075,0,2,1
10564,1,3,37074,37075,37078,1,4,0
10565,5,1,37079,37079,37080,0,1,1
10566,3,3,37082,37082,37085,0,3,2
10567,5,1,37087,37087,37088,0,1,2
10568,1,1,37088,37088,37089,0,1,0
10569,2,1,37090,37090,37091,0,1,1
10570,4,2,37094,37094,37096,0,2,3
10571,5,1,37099,37099,37100,0,1,3
10572,1,1,37100,37100,37101,0,1,0
10573,1,1,37101,37101,37102,0,1,0
10574,3,3,37104,37104,37107,0,3,2
10575,3,1,37107,37107,37108,0,1,0
10576,5,3,37112,37112,37115,0,3,4
10577,4,1,37116,37116,37117,0,1,1
10578,4,1,37120,37120,37121,0,1,3
10579,3,2,37123,37123,37125,0,2,2
10580,5,3,37128,37128,37131,0,3,3
10581,3,1,37131,37131,37132,0,1,0
10582,6,1,37137,37137,37138,0,1,5
10583,5,3,37142,37142,37145,0,3,4
10584,6,1,37148,37148,37149,0,1,3
10585,3,3,37151,37151,37154,0,3,2
10586,5,1,37156,37156,37157,0,1,2
10587,3,3,37159,37159,37162,0,3,2
10588,3,3,37162,37162,37165,0,3,0
10589,2,3,37164,37165,37168,1,4,0
10590,6,3,37170,37170,37173,0,3,2
10591,5,1,37175,37175,37176,0,1,2
10592,5,2,37180,37180,37182,0,2,4
10593,4,3,37184,37184,37187,0,3,2
10594,2,1,37186,37187,37188,1,2,0
10595,5,1,37191,37191,37192,0,1,3
10596,2,3,37193,37193,37196,0,3,1
10597,1,3,37194,37196,37199,2,5,0
10598,6,3,37200,37200,37203,0,3,1
10599,4,3,37204,37204,37207,0,3,1
10600,5,1,37209,37209,37210,0,1,2
10601,5,2,37214,37214,37216,0,2,4
10602,3,1,37217,37217,37218,0,1,1
10603,5,3,37222,37222,37225,0,3,4
10604,2,1,37224,37225,37226,1,2,0
10605,6,3,37230,37230,37233,0,3,4
10606,6,2,37236,37236,37238,0,2,3
10607,1,3,37237,37238,37241,1,4,0
10608,3,3,37240,37241,37244,1,4,0
10609,6,2,37246,37246,37248,0,2,2
10610,1,2,37247,37248,37250,1,3,0
10611,5,2,37252,37252,37254,0,2,2
10612,5,2,37257,37257,37259,0,2,3
10613,1,2,37258,37259,37261,1,3,0
10614,2,2,37260,37261,37263,1,3,0
10615,3,2,37263,37263,37265,0,2,0
10616,2,2,37265,37265,37267,0,2,0
10617,6,1,37271,37271,37272,0,1,4
10618,2,1,37273,37273,37274,0,1,1
10619,6,2,37279,37279,37281,0,2,5
10620,5,1,37284,37284,37285,0,1,3
10621,1,2,37285,37285,37287,0,2,0
10622,4,3,37289,37289,37292,0,3,2
10623,5,3,37294,37294,37297,0,3,2
10624,5,3,37299,37299,37302,0,3,2
10625,3,3,37302,37302,37305,0,3,0
10626,4,1,37306,37306,37307,0,1,1
10627,5,1,37311,37311,37312,0,1,4
10628,5,1,37316,37316,37317,0,1,4
10629,1,1,37317,37317,37318,0,1,0
10630,1,3,37318,37318,37321,0,3,0
10631,5,3,37323,37323,37326,0,3,2
10632,1,2,37324,37326,37328,2,4,0
10633,5,3,37329,37329,37332,0,3,1
10634,2,1,37331,37332,37333,1,2,0
10635,1,1,37332,37333,37334,1,2,0
10636,6,3,37338,37338,37341,0,3,4
10637,3,2,37341,37341,37343,0,2,0
10638,6,2,37347,37347,37349,0,2,4
10639,2,1,37349,37349,37350,0,1,0
10640,6,2,37355,37355,37357,0,2,5
10641,3,1,37358,37358,37359,0,1,1
10642,2,2,37360,37360,37362,0,2,1
10643,3,2,37363,37363,37365,0,2,1
10644,3,2,37366,37366,37368,0,2,1
10645,1,2,37367,37368,37370,1,3,0
10646,5,1,37372,37372,37373,0,1,2
10647,2,1,37374,37374,37375,0,1,1
10648,3,2,37377,37377,37379,0,2,2
10649,6,1,37383,37383,37384,0,1,4
10650,3,2,37386,37386,37388,0,2,2
10651,6,3,37392,37392,37395,0,3,4
10652,2,3,37394,37395,37398,1,4,0
10653,1,2,37395,37398,37400,3,5,0
10654,4,2,37399,37400,37402,1,3,0
10655,1,2,37400,37402,37404,2,4,0
10656,5,3,37405,37405,37408,0,3,1
10657,2,3,37407,37408,37411,1,4,0
10658,6,1,37413,37413,37414,0,1,2
10659,2,2,37415,37415,37417,0,2,1
10660,4,2,37419,37419,37421,0,2,2
10661,6,1,37425,37425,37426,0,1,4
10662,1,3,37426,37426,37429,0,3,0
10663,4,2,37430,37430,37432,0,2,1
10664,4,2,37434,37434,37436,0,2,2
10665,2,2,37436,37436,37438,0,2,0
10666,4,1,37440,37440,37441,0,1,2
10667,5,2,37445,37445,37447,0,2,4
10668,1,3,37446,37447,37450,1,4,0
10669,3,1,37449,37450,37451,1,2,0
10670,4,3,37453,37453,37456,0,3,2
10671,4,3,37457,37457,37460,0,3,1
10672,5,1,37462,37462,37463,0,1,2
10673,6,1,37468,37468,37469,0,1,5
10674,6,3,37474,37474,37477,0,3,5
10675,3,2,37477,37477,37479,0,2,0
10676,1,2,37478,37479,37481,1,3,0
10677,5,2,37483,37483,37485,0,2,2
10678,5,2,37488,37488,37490,0,2,3
10679,4,1,37492,37492,37493,0,1,2
10680,1,2,37493,37493,37495,0,2,0
10681,5,2,37498,37498,37500,0,2,3
10682,1,1,37499,37500,37501,1,2,0
10683,4,3,37503,37503,37506,0,3,2
10684,6,3,37509,37509,37512,0,3,3
10685,1,3,37510,37512,37515,2,5,0
10686,5,1,37515,37515,37516,0,1,0
10687,2,2,37517,37517,37519,0,2,1
10688,6,1,37523,37523,37524,0,1,4
10689,5,2,37528,37528,37530,0,2,4
10690,1,1,37529,37530,37531,1,2,0
10691,4,3,37533,37533,37536,0,3,2
10692,2,2,37535,37536,37538,1,3,0
10693,2,1,37537,37538,37539,1,2,0
10694,2,1,37539,37539,37540,0,1,0
10695,4,2,37543,37543,37545,0,2,3
10696,1,2,37544,37545,37547,1,3,0
10697,1,1,37545,37547,37548,2,3,0
10698,5,1,37550,37550,37551,0,1,2
10699,3,3,37553,37553,37556,0,3,2
10700,3,1,37556,37556,37557,0,1,0
10701,3,3,37559,37559,37562,0,3,2
10702,5,3,37564,37564,37567,0,3,2
10703,3,1,37567,37567,37568,0,1,0
10704,2,3,37569,37569,37572,0,3,1
10705,6,2,37575,37575,37577,0,2,3
10706,4,3,37579,37579,37582,0,3,2
10707,1,2,37580,37582,37584,2,4,0
10708,3,1,37583,37584,37585,1,2,0
10709,2,1,37585,37585,37586,0,1,0
10710,5,1,37590,37590,37591,0,1,4
10711,3,3,37593,37593,37596,0,3,2
10712,1,3,37594,37596,37599,2,5,0
10713,2,2,37596,37599,37601,3,5,0
10714,5,1,37601,37601,37602,0,1,0
10715,4,3,37605,37605,37608,0,3,3
10716,5,2,37610,37610,37612,0,2,2
10717,3,3,37613,37613,37616,0,3,1
10718,3,1,37616,37616,37617,0,1,0
10719,6,3,37622,37622,37625,0,3,5
10720,3,2,37625,37625,37627,0,2,0
10721,1,3,37626,37627,37630,1,4,0
10722,1,2,37627,37630,37632,3,5,0
10723,4,3,37631,37632,37635,1,4,0
10724,1,2,37632,37635,37637,3,5,0
10725,1,3,37633,37637,37640,4,7,0
10726,2,3,37635,37640,37643,5,8,0
10727,5,1,37640,37643,37644,3,4,0
10728,4,1,37644,37644,37645,0,1,0
10729,1,3,37645,37645,37648,0,3,0
10730,1,3,37646,37648,37651,2,5,0
10731,2,2,37648,37651,37653,3,5,0
10732,5,1,37653,37653,37654,0,1,0
10733,3,2,37656,37656,37658,0,2,2
10734,6,2,37662,37662,37664,0,2,4
10735,1,1,37663,37664,37665,1,2,0
10736,5,1,37668,37668,37669,0,1,3
10737,5,1,37673,37673,37674,0,1,4
10738,4,2,37677,37677,37679,0,2,3
10739,2,3,37679,37679,37682,0,3,0
10740,1,1,37680,37682,37683,2,3,0
10741,1,1,37681,37683,37684,2,3,0
10742,4,3,37685,37685,37688,0,3,1
10743,3,3,37688,37688,37691,0,3,0
10744,6,1,37694,37694,37695,0,1,3
10745,5,2,37699,37699,37701,0,2,4
10746,5,3,37704,37704,37707,0,3,3
10747,5,1,37709,37709,37710,0,1,2
10748,5,1,37714,37714,37715,0,1,4
10749,6,1,37720,37720,37721,0,1,5
10750,1,2,37721,37721,37723,0,2,0
10751,4,1,37725,37725,37726,0,1,2
10752,6,1,37731,37731,37732,0,1,5
10753,4,3,37735,37735,37738,0,3,3
10754,3,1,37738,37738,37739,0,1,0
10755,3,1,37741,37741,37742,0,1,2
10756,6,1,37747,37747,37748,0,1,5
10757,2,2,37749,37749,37751,0,2,1
10758,3,2,37752,37752,37754,0,2,1
10759,6,1,37758,37758,37759,0,1,4
10760,4,3,37762,37762,37765,0,3,3
10761,2,1,37764,37765,37766,1,2,0
10762,5,3,37769,37769,37772,0,3,3
10763,5,3,37774,37774,37777,0,3,2
10764,1,2,37775,37777,37779,2,4,0
10765,5,1,37780,37780,37781,0,1,1
10766,4,3,37784,37784,37787,0,3,3
10767,3,2,37787,37787,37789,0,2,0
10768,5,3,37792,37792,37795,0,3,3
10769,2,1,37794,37795,37796,1,2,0
10770,5,2,37799,37799,37801,0,2,3
10771,1,3,37800,37801,37804,1,4,0
10772,6,2,37806,37806,37808,0,2,2
10773,4,2,37810,37810,37812,0,2,2
10774,2,2,37812,37812,37814,0,2,0
10775,2,1,37814,37814,37815,0,1,0
10776,6,3,37820,37820,37823,0,3,5
10777,4,2,37824,37824,37826,0,2,1
10778,3,1,37827,37827,37828,0,1,1
10779,3,1,37830,37830,37831,0,1,2
10780,4,2,37834,37834,37836,0,2,3
10781,5,1,37839,37839,37840,0,1,3
10782,3,2,37842,37842,37844,0,2,2
10783,1,1,37843,37844,37845,1,2,0
10784,5,3,37848,37848,37851,0,3,3
10785,2,3,37850,37851,37854,1,4,0
10786,3,2,37853,37854,37856,1,3,0
10787,2,2,37855,37856,37858,1,3,0
10788,3,3,37858,37858,37861,0,3,0
10789,5,2,37863,37863,37865,0,2,2
10790,3,3,37866,37866,37869,0,3,1
10791,3,2,37869,37869,37871,0,2,0
10792,4,3,37873,37873,37876,0,3,2
10793,3,3,37876,37876,37879,0,3,0
10794,3,1,37879,37879,37880,0,1,0
10795,5,3,37884,37884,37887,0,3,4
10796,5,1,37889,37889,37890,0,1,2
10797,5,2,37894,37894,37896,0,2,4
10798,5,2,37899,37899,37901,0,2,3
10799,6,3,37905,37905,37908,0,3,4
10800,6,1,37911,37911,37912,0,1,3
10801,3,3,37914,37914,37917,0,3,2
10802,5,2,37919,37919,37921,0,2,2
10803,3,3,37922,37922,37925,0,3,1
10804,2,3,37924,37925,37928,1,4,0
10805,5,3,37929,37929,37932,0,3,1
10806,3,3,37932,37932,37935,0,3,0
10807,2,1,37934,37935,37936,1,2,0
10808,3,2,37937,37937,37939,0,2,1
10809,2,2,37939,37939,37941,0,2,0
10810,1,1,37940,37941,37942,1,2,0
10811,6,1,37946,37946,37947,0,1,4
10812,6,1,37952,37952,37953,0,1,5
10813,1,1,37953,37953,37954,0,1,0
10814,6,2,37959,37959,37961,0,2,5
10815,1,2,37960,37961,37963,1,3,0
10816,2,2,37962,37963,37965,1,3,0
10817,2,2,37964,37965,37967,1,3,0
10818,5,2,37969,37969,37971,0,2,2
10819,3,2,37972,37972,37974,0,2,1
10820,6,1,37978,37978,37979,0,1,4
10821,3,1,37981,37981,37982,0,1,2
10822,1,2,37982,37982,37984,0,2,0
10823,3,3,37985,37985,37988,0,3,1
10824,5,1,37990,37990,37991,0,1,2
10825,3,1,37993,37993,37994,0,1,2
10826,6,3,37999,37999,38002,0,3,5
10827,6,1,38005,38005,38006,0,1,3
10828,4,3,38009,38009,38012,0,3,3
10829,6,2,38015,38015,38017,0,2,3
10830,4,2,38019,38019,38021,0,2,2
10831,4,2,38023,38023,38025,0,2,2
10832,2,2,38025,38025,38027,0,2,0
10833,4,2,38029,38029,38031,0,2,2
10834,2,1,38031,38031,38032,0,1,0
10835,6,2,38037,38037,38039,0,2,5
10836,3,2,38040,38040,38042,0,2,1
10837,5,1,38045,38045,38046,0,1,3
10838,3,3,38048,38048,38051,0,3,2
10839,5,1,38053,38053,38054,0,1,2
10840,2,1,38055,38055,38056,0,1,1
10841,1,2,38056,38056,38058,0,2,0
10842,3,2,38059,38059,38061,0,2,1
10843,2,2,38061,38061,38063,0,2,0
10844,6,2,38067,38067,38069,0,2,4
10845,5,3,38072,38072,38075,0,3,3
10846,3,2,38075,38075,38077,0,2,0
10847,1,3,38076,38077,38080,1,4,0
10848,1,2,38077,38080,38082,3,5,0
10849,6,2,38083,38083,38085,0,2,1
10850,3,2,38086,38086,38088,0,2,1
10851,6,3,38092,38092,38095,0,3,4
10852,3,2,38095,38095,38097,0,2,0
10853,6,2,38101,38101,38103,0,2,4
10854,4,2,38105,38105,38107,0,2,2
10855,2,2,38107,38107,38109,0,2,0
10856,5,3,38112,38112,38115,0,3,3
10857,3,1,38115,38115,38116,0,1,0
10858,5,3,38120,38120,38123,0,3,4
10859,1,3,38121,38123,38126,2,5,0
10860,4,1,38125,38126,38127,1,2,0
10861,4,2,38129,38129,38131,0,2,2
10862,4,1,38133,38133,38134,0,1,2
10863,3,2,38136,38136,38138,0,2,2
10864,4,1,38140,38140,38141,0,1,2
10865,2,2,38142,38142,38144,0,2,1
10866,4,3,38146,38146,38149,0,3,2
10867,6,2,38152,38152,38154,0,2,3
10868,5,1,38157,38157,38158,0,1,3
10869,4,3,38161,38161,38164,0,3,3
10870,6,3,38167,38167,38170,0,3,3
10871,6,3,38173,38173,38176,0,3,3
10872,4,3,38177,38177,38180,0,3,1
10873,4,2,38181,38181,38183,0,2,1
10874,6,3,38187,38187,38190,0,3,4
10875,3,1,38190,38190,38191,0,1,0
10876,2,1,38192,38192,38193,0,1,1
10877,2,2,38194,38194,38196,0,2,1
10878,2,1,38196,38196,38197,0,1,0
10879,5,3,38201,38201,38204,0,3,4
10880,4,3,38205,38205,38208,0,3,1
10881,5,3,38210,38210,38213,0,3,2
10882,1,3,38211,38213,38216,2,5,0
10883,6,1,38217,38217,38218,0,1,1
10884,1,3,38218,38218,38221,0,3,0
10885,6,2,38224,38224,38226,0,2,3
10886,3,3,38227,38227,38230,0,3,1
10887,4,1,38231,38231,38232,0,1,1
10888,3,2,38234,38234,38236,0,2,2
10889,1,1,38235,38236,38237,1,2,0
10890,2,3,38237,38237,38240,0,3,0
10891,1,3,38238,38240,38243,2,5,0
10892,3,2,38241,38243,38245,2,4,0
10893,1,2,38242,38245,38247,3,5,0
10894,1,3,38243,38247,38250,4,7,0
10895,1,1,38244,38250,38251,6,7,0
10896,3,3,38247,38251,38254,4,7,0
10897,3,3,38250,38254,38257,4,7,0
10898,1,2,38251,38257,38259,6,8,0
10899,6,1,38257,38259,38260,2,3,0
10900,4,1,38261,38261,38262,0,1,1
10901,1,1,38262,38262,38263,0,1,0
10902,4,3,38266,38266,38269,0,3,3
10903,4,2,38270,38270,38272,0,2,1
10904,6,2,38276,38276,38278,0,2,4
10905,6,1,38282,38282,38283,0,1,4
10906,5,2,38287,38287,38289,0,2,4
10907,1,3,38288,38289,38292,1,4,0
10908,1,1,38289,38292,38293,3,4,0
10909,2,3,38291,38293,38296,2,5,0
10910,3,1,38294,38296,38297,2,3,0
10911,3,2,38297,38297,38299,0,2,0
10912,6,3,38303,38303,38306,0,3,4
10913,1,2,38304,38306,38308,2,4,0
10914,5,1,38309,38309,38310,0,1,1
10915,5,1,38314,38314,38315,0,1,4
10916,6,3,38320,38320,38323,0,3,5
10917,5,3,38325,38325,38328,0,3,2
10918,3,2,38328,38328,38330,0,2,0
10919,5,1,38333,38333,38334,0,1,3
10920,1,3,38334,38334,38337,0,3,0
10921,5,3,38339,38339,38342,0,3,2
10922,6,3,38345,38345,38348,0,3,3
10923,5,3,38350,38350,38353,0,3,2
10924,5,3,38355,38355,38358,0,3,2
10925,6,1,38361,38361,38362,0,1,3
10926,6,1,38367,38367,38368,0,1,5
10927,4,3,38371,38371,38374,0,3,3
10928,2,3,38373,38374,38377,1,4,0
10929,1,1,38374,38377,38378,3,4,0
10930,2,3,38376,38378,38381,2,5,0
10931,3,3,38379,38381,38384,2,5,0
10932,1,3,38380,38384,38387,4,7,0
10933,5,3,38385,38387,38390,2,5,0
10934,4,2,38389,38390,38392,1,3,0
10935,6,1,38395,38395,38396,0,1,3
10936,3,3,38398,38398,38401,0,3,2
10937,4,1,38402,38402,38403,0,1,1
10938,5,2,38407,38407,38409,0,2,4
10939,5,3,38412,38412,38415,0,3,3
10940,1,1,38413,38415,38416,2,3,0
10941,3,3,38416,38416,38419,0,3,0
10942,4,3,38420,38420,38423,0,3,1
10943,4,1,38424,38424,38425,0,1,1
10944,5,2,38429,38429,38431,0,2,4
10945,2,2,38431,38431,38433,0,2,0
10946,1,2,38432,38433,38435,1,3,0
10947,5,1,38437,38437,38438,0,1,2
10948,4,3,38441,38441,38444,0,3,3
10949,1,3,38442,38444,38447,2,5,0
10950,3,3,38445,38447,38450,2,5,0
10951,3,2,38448,38450,38452,2,4,0
10952,2,2,38450,38452,38454,2,4,0
10953,4,2,38454,38454,38456,0,2,0
10954,1,1,38455,38456,38457,1,2,0
10955,3,3,38458,38458,38461,0,3,1
10956,6,2,38464,38464,38466,0,2,3
10957,4,2,38468,38468,38470,0,2,2
10958,3,2,38471,38471,38473,0,2,1
10959,6,1,38477,38477,38478,0,1,4
10960,1,1,38478,38478,38479,0,1,0
10961,6,1,38484,38484,38485,0,1,5
10962,3,3,38487,38487,38490,0,3,2
10963,5,2,38492,38492,38494,0,2,2
10964,6,3,38498,38498,38501,0,3,4
10965,3,1,38501,38501,38502,0,1,0
10966,5,1,38506,38506,38507,0,1,4
10967,6,3,38512,38512,38515,0,3,5
10968,2,2,38514,38515,38517,1,3,0
10969,5,1,38519,38519,38520,0,1,2
10970,3,3,38522,38522,38525,0,3,2
10971,6,2,38528,38528,38530,0,2,3
10972,3,3,38531,38531,38534,0,3,1
10973,2,2,38533,38534,38536,1,3,0
10974,1,3,38534,38536,38539,2,5,0
10975,6,1,38540,38540,38541,0,1,1
10976,5,1,38545,38545,38546,0,1,4
10977,6,2,38551,38551,38553,0,2,5
10978,1,1,38552,38553,38554,1,2,0
10979,4,2,38556,38556,38558,0,2,2
10980,4,3,38560,38560,38563,0,3,2
10981,5,3,38565,38565,38568,0,3,2
10982,4,2,38569,38569,38571,0,2,1
10983,3,1,38572,38572,38573,0,1,1
10984,4,2,38576,38576,38578,0,2,3
10985,5,3,38581,38581,38584,0,3,3
10986,3,1,38584,38584,38585,0,1,0
10987,5,2,38589,38589,38591,0,2,4
10988,5,1,38594,38594,38595,0,1,3
10989,1,3,38595,38595,38598,0,3,0
10990,5,2,38600,38600,38602,0,2,2
10991,3,2,38603,38603,38605,0,2,1
10992,2,3,38605,38605,38608,0,3,0
10993,3,3,38608,38608,38611,0,3,0
10994,3,1,38611,38611,38612,0,1,0
10995,1,3,38612,38612,38615,0,3,0
10996,5,1,38617,38617,38618,0,1,2
10997,2,1,38619,38619,38620,0,1,1
10998,2,2,38621,38621,38623,0,2,1
10999,5,2,38626,38626,38628,0,2,3
11000,1,1,38627,38628,38629,1,2,0
11001,5,1,38632,38632,38633,0,1,3
11002,1,2,38633,38633,38635,0,2,0
11003,6,2,38639,38639,38641,0,2,4
11004,3,1,38642,38642,38643,0,1,1
11005,5,1,38647,38647,38648,0,1,4
11006,2,3,38649,38649,38652,0,3,1
11007,2,1,38651,38652,38653,1,2,0
11008,4,1,38655,38655,38656,0,1,2
11009,5,3,38660,38660,38663,0,3,4
11010,6,3,38666,38666,38669,0,3,3
11011,6,1,38672,38672,38673,0,1,3
11012,2,2,38674,38674,38676,0,2,1
11013,3,3,38677,38677,38680,0,3,1
11014,2,1,38679,38680,38681,1,2,0
11015,1,2,38680,38681,38683,1,3,0
11016,4,2,38684,38684,38686,0,2,1
11017,5,1,38689,38689,38690,0,1,3
11018,4,2,38693,38693,38695,0,2,3
11019,3,2,38696,38696,38698,0,2,1
11020,3,1,38699,38699,38700,0,1,1
11021,1,3,38700,38700,38703,0,3,0
11022,5,1,38705,38705,38706,0,1,2
11023,2,3,38707,38707,38710,0,3,1
11024,6,3,38713,38713,38716,0,3,3
11025,1,1,38714,38716,38717,2,3,0
11026,5,1,38719,38719,38720,0,1,2
11027,6,1,38725,38725,38726,0,1,5
11028,5,3,38730,38730,38733,0,3,4
11029,3,1,38733,38733,38734,0,1,0
11030,5,2,38738,38738,38740,0,2,4
11031,1,3,38739,38740,38743,1,4,0
11032,6,2,38745,38745,38747,0,2,2
11033,3,1,38748,38748,38749,0,1,1
11034,4,3,38752,38752,38755,0,3,3
11035,6,2,38758,38758,38760,0,2,3
11036,5,1,38763,38763,38764,0,1,3
11037,4,3,38767,38767,38770,0,3,3
11038,1,1,38768,38770,38771,2,3,0
11039,2,2,38770,38771,38773,1,3,0
11040,4,1,38774,38774,38775,0,1,1
11041,6,3,38780,38780,38783,0,3,5
11042,6,1,38786,38786,38787,0,1,3
11043,3,3,38789,38789,38792,0,3,2
11044,3,2,38792,38792,38794,0,2,0
11045,5,1,38797,38797,38798,0,1,3
11046,6,2,38803,38803,38805,0,2,5
11047,3,3,38806,38806,38809,0,3,1
11048,4,1,38810,38810,38811,0,1,1
11049,6,3,38816,38816,38819,0,3,5
11050,6,3,38822,38822,38825,0,3,3
11051,1,2,38823,38825,38827,2,4,0
11052,5,1,38828,38828,38829,0,1,1
11053,3,3,38831,38831,38834,0,3,2
11054,4,2,38835,38835,38837,0,2,1
11055,1,1,38836,38837,38838,1,2,0
11056,4,1,38840,38840,38841,0,1,2
11057,4,1,38844,38844,38845,0,1,3
11058,3,2,38847,38847,38849,0,2,2
11059,3,1,38850,38850,38851,0,1,1
11060,4,2,38854,38854,38856,0,2,3
11061,2,3,38856,38856,38859,0,3,0
11062,4,3,38860,38860,38863,0,3,1
11063,1,2,38861,38863,38865,2,4,0
11064,1,3,38862,38865,38868,3,6,0
11065,2,2,38864,38868,38870,4,6,0
11066,3,2,38867,38870,38872,3,5,0
11067,5,1,38872,38872,38873,0,1,0
11068,1,1,38873,38873,38874,0,1,0
11069,4,1,38877,38877,38878,0,1,3
11070,3,3,38880,38880,38883,0,3,2
11071,2,2,38882,38883,38885,1,3,0
11072,1,1,38883,38885,38886,2,3,0
11073,4,3,38887,38887,38890,0,3,1
11074,3,2,38890,38890,38892,0,2,0
11075,3,2,38893,38893,38895,0,2,1
11076,1,1,38894,38895,38896,1,2,0
11077,3,3,38897,38897,38900,0,3,1
11078,5,2,38902,38902,38904,0,2,2
11079,2,3,38904,38904,38907,0,3,0
11080,1,3,38905,38907,38910,2,5,0
11081,6,1,38911,38911,38912,0,1,1
11082,3,2,38914,38914,38916,0,2,2
11083,6,1,38920,38920,38921,0,1,4
11084,4,1,38924,38924,38925,0,1,3
11085,3,2,38927,38927,38929,0,2,2
11086,6,1,38933,38933,38934,0,1,4
11087,2,3,38935,38935,38938,0,3,1
11088,3,3,38938,38938,38941,0,3,0
11089,4,1,38942,38942,38943,0,1,1
11090,1,1,38943,38943,38944,0,1,0
11091,4,3,38947,38947,38950,0,3,3
11092,6,3,38953,38953,38956,0,3,3
11093,4,1,38957,38957,38958,0,1,1
11094,2,2,38959,38959,38961,0,2,1
11095,6,2,38965,38965,38967,0,2,4
11096,2,1,38967,38967,38968,0,1,0
11097,2,1,38969,38969,38970,0,1,1
11098,4,3,38973,38973,38976,0,3,3
11099,3,3,38976,38976,38979,0,3,0
11100,1,1,38977,38979,38980,2,3,0
11101,3,2,38980,38980,38982,0,2,0
11102,5,3,38985,38985,38988,0,3,3
11103,6,3,38991,38991,38994,0,3,3
11104,5,1,38996,38996,38997,0,1,2
11105,6,1,39002,39002,39003,0,1,5
11106,3,3,39005,39005,39008,0,3,2
11107,5,3,39010,39010,39013,0,3,2
11108,6,3,39016,39016,39019,0,3,3
11109,1,1,39017,39019,39020,2,3,0
11110,1,3,39018,39020,39023,2,5,0
11111,3,2,39021,39023,39025,2,4,0
11112,4,1,39025,39025,39026,0,1,0
11113,1,3,39026,39026,39029,0,3,0
11114,5,1,39031,39031,39032,0,1,2
11115,1,2,39032,39032,39034,0,2,0
11116,1,3,39033,39034,39037,1,4,0
11117,4,1,39037,39037,39038,0,1,0
11118,2,3,39039,39039,39042,0,3,1
11119,6,1,39045,39045,39046,0,1,3
11120,4,1,39049,39049,39050,0,1,3
11121,3,3,39052,39052,39055,0,3,2
11122,5,3,39057,39057,39060,0,3,2
11123,5,1,39062,39062,39063,0,1,2
11124,2,3,39064,39064,39067,0,3,1
11125,1,2,39065,39067,39069,2,4,0
11126,6,2,39071,39071,39073,0,2,2
11127,6,2,39077,39077,39079,0,2,4
11128,2,1,39079,39079,39080,0,1,0
11129,1,2,39080,39080,39082,0,2,0
11130,5,1,39085,39085,39086,0,1,3
11131,6,2,39091,39091,39093,0,2,5
11132,4,1,39095,39095,39096,0,1,2
11133,3,2,39098,39098,39100,0,2,2
11134,6,2,39104,39104,39106,0,2,4
11135,2,2,39106,39106,39108,0,2,0
11136,2,1,39108,39108,39109,0,1,0
11137,5,2,39113,39113,39115,0,2,4
11138,1,1,39114,39115,39116,1,2,0
11139,3,2,39117,39117,39119,0,2,1
11140,6,1,39123,39123,39124,0,1,4
11141,4,2,39127,39127,39129,0,2,3
11142,6,3,39133,39133,39136,0,3,4
11143,1,1,39134,39136,39137,2,3,0
11144,1,1,39135,39137,39138,2,3,0
11145,1,3,39136,39138,39141,2,5,0
11146,3,2,39139,39141,39143,2,4,0
11147,4,1,39143,39143,39144,0,1,0
11148,5,1,39148,39148,39149,0,1,4
11149,6,3,39154,39154,39157,0,3,5
11150,6,1,39160,39160,39161,0,1,3
11151,5,1,39165,39165,39166,0,1,4
11152,5,2,39170,39170,39172,0,2,4
11153,1,1,39171,39172,39173,1,2,0
11154,6,3,39177,39177,39180,0,3,4
11155,6,3,39183,39183,39186,0,3,3
11156,5,3,39188,39188,39191,0,3,2
11157,3,2,39191,39191,39193,0,2,0
11158,1,2,39192,39193,39195,1,3,0
11159,4,2,39196,39196,39198,0,2,1
11160,3,1,39199,39199,39200,0,1,1
11161,6,3,39205,39205,39208,0,3,5
11162,2,3,39207,39208,39211,1,4,0
11163,4,2,39211,39211,39213,0,2,0
11164,6,1,39217,39217,39218,0,1,4
11165,2,2,39219,39219,39221,0,2,1
11166,6,2,39225,39225,39227,0,2,4
11167,2,2,39227,39227,39229,0,2,0
11168,5,1,39232,39232,39233,0,1,3
11169,5,1,39237,39237,39238,0,1,4
11170,6,2,39243,39243,39245,0,2,5
11171,6,2,39249,39249,39251,0,2,4
11172,1,1,39250,39251,39252,1,2,0
11173,4,2,39254,39254,39256,0,2,2
11174,1,1,39255,39256,39257,1,2,0
11175,6,1,39261,39261,39262,0,1,4
11176,3,1,39264,39264,39265,0,1,2
11177,3,3,39267,39267,39270,0,3,2
11178,1,3,39268,39270,39273,2,5,0
11179,1,1,39269,39273,39274,4,5,0
11180,3,3,39272,39274,39277,2,5,0
11181,6,1,39278,39278,39279,0,1,1
11182,1,3,39279,39279,39282,0,3,0
11183,6,3,39285,39285,39288,0,3,3
11184,3,3,39288,39288,39291,0,3,0
11185,5,3,39293,39293,39296,0,3,2
11186,1,2,39294,39296,39298,2,4,0
11187,6,3,39300,39300,39303,0,3,2
11188,1,3,39301,39303,39306,2,5,0
11189,2,2,39303,39306,39308,3,5,0
11190,1,1,39304,39308,39309,4,5,0
11191,1,3,39305,39309,39312,4,7,0
11192,3,2,39308,39312,39314,4,6,0
11193,5,2,39313,39314,39316,1,3,0
11194,5,3,39318,39318,39321,0,3,2
11195,3,1,39321,39321,39322,0,1,0
11196,6,1,39327,39327,39328,0,1,5
11197,4,1,39331,39331,39332,0,1,3
11198,5,3,39336,39336,39339,0,3,4
11199,4,2,39340,39340,39342,0,2,1
11200,1,3,39341,39342,39345,1,4,0
11201,1,1,39342,39345,39346,3,4,0
11202,1,2,39343,39346,39348,3,5,0
11203,2,2,39345,39348,39350,3,5,0
11204,5,1,39350,39350,39351,0,1,0
11205,4,3,39354,39354,39357,0,3,3
11206,3,3,39357,39357,39360,0,3,0
11207,3,2,39360,39360,39362,0,2,0
11208,6,1,39366,39366,39367,0,1,4
11209,6,1,39372,39372,39373,0,1,5
11210,6,1,39378,39378,39379,0,1,5
11211,3,3,39381,39381,39384,0,3,2
11212,2,3,39383,39384,39387,1,4,0
11213,4,2,39387,39387,39389,0,2,0
11214,1,3,39388,39389,39392,1,4,0
11215,2,2,39390,39392,39394,2,4,0
11216,2,1,39392,39394,39395,2,3,0
11217,3,3,39395,39395,39398,0,3,0
11218,3,2,39398,39398,39400,0,2,0
11219,4,1,39402,39402,39403,0,1,2
11220,1,3,39403,39403,39406,0,3,0
11221,6,1,39409,39409,39410,0,1,3
11222,6,3,39415,39415,39418,0,3,5
11223,2,1,39417,39418,39419,1,2,0
11224,1,2,39418,39419,39421,1,3,0
11225,5,2,39423,39423,39425,0,2,2
11226,1,2,39424,39425,39427,1,3,0
11227,1,2,39425,39427,39429,2,4,0
11228,3,2,39428,39429,39431,1,3,0
11229,3,1,39431,39431,39432,0,1,0
11230,3,3,39434,39434,39437,0,3,2
11231,2,2,39436,39437,39439,1,3,0
11232,1,1,39437,39439,39440,2,3,0
11233,4,3,39441,39441,39444,0,3,1
11234,4,1,39445,39445,39446,0,1,1
11235,1,3,39446,39446,39449,0,3,0
11236,6,3,39452,39452,39455,0,3,3
11237,4,2,39456,39456,39458,0,2,1
11238,3,3,39459,39459,39462,0,3,1
11239,5,1,39464,39464,39465,0,1,2
11240,5,1,39469,39469,39470,0,1,4
11241,6,1,39475,39475,39476,0,1,5
11242,6,3,39481,39481,39484,0,3,5
11243,5,2,39486,39486,39488,0,2,2
11244,3,2,39489,39489,39491,0,2,1
11245,6,3,39495,39495,39498,0,3,4
11246,3,1,39498,39498,39499,0,1,0
11247,4,2,39502,39502,39504,0,2,3
11248,5,1,39507,39507,39508,0,1,3
11249,5,2,39512,39512,39514,0,2,4
11250,3,1,39515,39515,39516,0,1,1
11251,6,3,39521,39521,39524,0,3,5
11252,4,3,39525,39525,39528,0,3,1
11253,5,1,39530,39530,39531,0,1,2
11254,3,2,39533,39533,39535,0,2,2
11255,5,3,39538,39538,39541,0,3,3
11256,5,1,39543,39543,39544,0,1,2
11257,1,3,39544,39544,39547,0,3,0
11258,2,3,39546,39547,39550,1,4,0
11259,6,3,39552,39552,39555,0,3,2
11260,3,3,39555,39555,39558,0,3,0
11261,6,3,39561,39561,39564,0,3,3
11262,1,3,39562,39564,39567,2,5,0
11263,4,1,39566,39567,39568,1,2,0
11264,6,3,39572,39572,39575,0,3,4
11265,3,3,39575,39575,39578,0,3,0
11266,3,3,39578,39578,39581,0,3,0
11267,6,2,39584,39584,39586,0,2,3
11268,6,3,39590,39590,39593,0,3,4
11269,5,2,39595,39595,39597,0,2,2
11270,2,2,39597,39597,39599,0,2,0
11271,5,3,39602,39602,39605,0,3,3
11272,4,2,39606,39606,39608,0,2,1
11273,5,3,39611,39611,39614,0,3,3
11274,2,1,39613,39614,39615,1,2,0
11275,3,2,39616,39616,39618,0,2,1
11276,5,3,39621,39621,39624,0,3,3
11277,5,3,39626,39626,39629,0,3,2
11278,1,3,39627,39629,39632,2,5,0
11279,2,2,39629,39632,39634,3,5,0
11280,1,2,39630,39634,39636,4,6,0
11281,6,2,39636,39636,39638,0,2,0
11282,4,2,39640,39640,39642,0,2,2
11283,3,2,39643,39643,39645,0,2,1
11284,2,1,39645,39645,39646,0,1,0
11285,2,2,39647,39647,39649,0,2,1
11286,2,3,39649,39649,39652,0,3,0
11287,2,1,39651,39652,39653,1,2,0
11288,5,2,39656,39656,39658,0,2,3
11289,6,3,39662,39662,39665,0,3,4
11290,1,1,39663,39665,39666,2,3,0
11291,6,3,39669,39669,39672,0,3,3
11292,2,1,39671,39672,39673,1,2,0
11293,6,3,39677,39677,39680,0,3,4
11294,2,1,39679,39680,39681,1,2,0
11295,6,2,39685,39685,39687,0,2,4
11296,6,3,39691,39691,39694,0,3,4
11297,2,3,39693,39694,39697,1,4,0
11298,1,2,39694,39697,39699,3,5,0
11299,3,2,39697,39699,39701,2,4,0
11300,3,2,39700,39701,39703,1,3,0
11301,5,1,39705,39705,39706,0,1,2
11302,1,1,39706,39706,39707,0,1,0
11303,3,3,39709,39709,39712,0,3,2
11304,1,2,39710,39712,39714,2,4,0
11305,2,2,39712,39714,39716,2,4,0
11306,2,3,39714,39716,39719,2,5,0
11307,5,2,39719,39719,39721,0,2,0
11308,3,3,39722,39722,39725,0,3,1
11309,6,2,39728,39728,39730,0,2,3
11310,5,2,39733,39733,39735,0,2,3
11311,3,1,39736,39736,39737,0,1,1
11312,3,2,39739,39739,39741,0,2,2
11313,4,3,39743,39743,39746,0,3,2
11314,3,2,39746,39746,39748,0,2,0
11315,6,2,39752,39752,39754,0,2,4
11316,4,3,39756,39756,39759,0,3,2
11317,3,1,39759,39759,39760,0,1,0
11318,2,3,39761,39761,39764,0,3,1
11319,5,1,39766,39766,39767,0,1,2
11320,3,1,39769,39769,39770,0,1,2
11321,1,3,39770,39770,39773,0,3,0
11322,1,1,39771,39773,39774,2,3,0
11323,1,1,39772,39774,39775,2,3,0
11324,6,3,39778,39778,39781,0,3,3
11325,1,2,39779,39781,39783,2,4,0
11326,5,3,39784,39784,39787,0,3,1
11327,3,2,39787,39787,39789,0,2,0
11328,5,3,39792,39792,39795,0,3,3
11329,3,2,39795,39795,39797,0,2,0
11330,6,1,39801,39801,39802,0,1,4
11331,4,3,39805,39805,39808,0,3,3
11332,6,2,39811,39811,39813,0,2,3
11333,2,1,39813,39813,39814,0,1,0
11334,4,1,39817,39817,39818,0,1,3
11335,3,1,39820,39820,39821,0,1,2
11336,5,1,39825,39825,39826,0,1,4
11337,3,2,39828,39828,39830,0,2,2
11338,6,1,39834,39834,39835,0,1,4
11339,3,2,39837,39837,39839,0,2,2
11340,1,3,39838,39839,39842,1,4,0
11341,6,1,39844,39844,39845,0,1,2
11342,1,1,39845,39845,39846,0,1,0
11343,6,3,39851,39851,39854,0,3,5
11344,5,3,39856,39856,39859,0,3,2
11345,2,2,39858,39859,39861,1,3,0
11346,4,2,39862,39862,39864,0,2,1
11347,6,3,39868,39868,39871,0,3,4
11348,3,2,39871,39871,39873,0,2,0
11349,5,2,39876,39876,39878,0,2,3
11350,5,1,39881,39881,39882,0,1,3
11351,6,1,39887,39887,39888,0,1,5
11352,6,1,39893,39893,39894,0,1,5
11353,3,3,39896,39896,39899,0,3,2
11354,2,2,39898,39899,39901,1,3,0
11355,4,1,39902,39902,39903,0,1,1
11356,3,3,39905,39905,39908,0,3,2
11357,6,1,39911,39911,39912,0,1,3
11358,1,1,39912,39912,39913,0,1,0
11359,3,3,39915,39915,39918,0,3,2
11360,6,3,39921,39921,39924,0,3,3
11361,5,1,39926,39926,39927,0,1,2
11362,6,1,39932,39932,39933,0,1,5
11363,6,3,39938,39938,39941,0,3,5
11364,6,1,39944,39944,39945,0,1,3
11365,6,2,39950,39950,39952,0,2,5
11366,4,2,39954,39954,39956,0,2,2
11367,1,3,39955,39956,39959,1,4,0
11368,2,1,39957,39959,39960,2,3,0
11369,1,1,39958,39960,39961,2,3,0
11370,3,3,39961,39961,39964,0,3,0
11371,6,1,39967,39967,39968,0,1,3
11372,6,3,39973,39973,39976,0,3,5
11373,4,2,39977,39977,39979,0,2,1
11374,5,1,39982,39982,39983,0,1,3
11375,1,2,39983,39983,39985,0,2,0
11376,2,3,39985,39985,39988,0,3,0
11377,2,1,39987,39988,39989,1,2,0
11378,1,2,39988,39989,39991,1,3,0
11379,6,3,39994,39994,39997,0,3,3
11380,1,2,39995,39997,39999,2,4,0
11381,3,1,39998,39999,40000,1,2,0
11382,4,2,40002,40002,40004,0,2,2
11383,3,1,40005,40005,40006,0,1,1
11384,4,3,40009,40009,40012,0,3,3
11385,4,2,40013,40013,40015,0,2,1
11386,5,1,40018,40018,40019,0,1,3
11387,5,1,40023,40023,40024,0,1,4
11388,3,3,40026,40026,40029,0,3,2
11389,5,1,40031,40031,40032,0,1,2
11390,1,3,40032,40032,40035,0,3,0
11391,5,2,40037,40037,40039,0,2,2
11392,2,1,40039,40039,40040,0,1,0
11393,2,1,40041,40041,40042,0,1,1
11394,4,3,40045,40045,40048,0,3,3
11395,5,3,40050,40050,40053,0,3,2
11396,2,1,40052,40053,40054,1,2,0
11397,2,1,40054,40054,40055,0,1,0
11398,4,1,40058,40058,40059,0,1,3
11399,2,1,40060,40060,40061,0,1,1
11400,2,3,40062,40062,40065,0,3,1
11401,3,2,40065,40065,40067,0,2,0
11402,2,1,40067,40067,40068,0,1,0
11403,2,3,40069,40069,40072,0,3,1
11404,6,1,40075,40075,40076,0,1,3
11405,4,1,40079,40079,40080,0,1,3
11406,6,1,40085,40085,40086,0,1,5
11407,1,1,40086,40086,40087,0,1,0
11408,4,2,40090,40090,40092,0,2,3
11409,5,1,40095,40095,40096,0,1,3
11410,3,1,40098,40098,40099,0,1,2
11411,2,1,40100,40100,40101,0,1,1
11412,6,1,40106,40106,40107,0,1,5
11413,1,3,40107,40107,40110,0,3,0
11414,1,3,40108,40110,40113,2,5,0
11415,6,2,40114,40114,40116,0,2,1
11416,4,3,40118,40118,40121,0,3,2
11417,1,3,40119,40121,40124,2,5,0
11418,4,3,40123,40124,40127,1,4,0
11419,6,2,40129,40129,40131,0,2,2
11420,2,1,40131,40131,40132,0,1,0
11421,1,3,40132,40132,40135,0,3,0
11422,6,2,40138,40138,40140,0,2,3
11423,3,2,40141,40141,40143,0,2,1
11424,1,3,40142,40143,40146,1,4,0
11425,1,2,40143,40146,40148,3,5,0
11426,2,3,40145,40148,40151,3,6,0
11427,5,1,40150,40151,40152,1,2,0
11428,2,1,40152,40152,40153,0,1,0
11429,1,2,40153,40153,40155,0,2,0
11430,5,2,40158,40158,40160,0,2,3
11431,1,3,40159,40160,40163,1,4,0
11432,5,3,40164,40164,40167,0,3,1
11433,5,3,40169,40169,40172,0,3,2
11434,1,1,40170,40172,40173,2,3,0
11435,2,2,40172,40173,40175,1,3,0
11436,4,1,40176,40176,40177,0,1,1
11437,6,2,40182,40182,40184,0,2,5
11438,6,3,40188,40188,40191,0,3,4
11439,4,3,40192,40192,40195,0,3,1
11440,1,3,40193,40195,40198,2,5,0
11441,6,2,40199,40199,40201,0,2,1
11442,1,2,40200,40201,40203,1,3,0
11443,6,1,40206,40206,40207,0,1,3
11444,4,1,40210,40210,40211,0,1,3
11445,3,3,40213,40213,40216,0,3,2
11446,4,2,40217,40217,40219,0,2,1
11447,4,1,40221,40221,40222,0,1,2
11448,1,2,40222,40222,40224,0,2,0
11449,4,3,40226,40226,40229,0,3,2
11450,6,2,40232,40232,40234,0,2,3
11451,3,2,40235,40235,40237,0,2,1
11452,4,3,40239,40239,40242,0,3,2
11453,5,1,40244,40244,40245,0,1,2
11454,5,3,40249,40249,40252,0,3,4
11455,5,2,40254,40254,40256,0,2,2
11456,1,1,40255,40256,40257,1,2,0
11457,6,3,40261,40261,40264,0,3,4
11458,5,1,40266,40266,40267,0,1,2
11459,2,3,40268,40268,40271,0,3,1
11460,3,2,40271,40271,40273,0,2,0
11461,4,3,40275,40275,40278,0,3,2
11462,6,3,40281,40281,40284,0,3,3
11463,1,3,40282,40284,40287,2,5,0
11464,1,2,40283,40287,40289,4,6,0
11465,2,3,40285,40289,40292,4,7,0
11466,4,3,40289,40292,40295,3,6,0
11467,2,3,40291,40295,40298,4,7,0
11468,1,3,40292,40298,40301,6,9,0
11469,3,2,40295,40301,40303,6,8,0
11470,4,2,40299,40303,40305,4,6,0
11471,5,1,40304,40305,40306,1,2,0
11472,4,2,40308,40308,40310,0,2,2
11473,4,1,40312,40312,40313,0,1,2
11474,2,3,40314,40314,40317,0,3,1
11475,3,1,40317,40317,40318,0,1,0
11476,2,2,40319,40319,40321,0,2,1
11477,5,3,40324,40324,40327,0,3,3
11478,1,1,40325,40327,40328,2,3,0
11479,5,3,40330,40330,40333,0,3,2
11480,4,3,40334,40334,40337,0,3,1
11481,2,2,40336,40337,40339,1,3,0
11482,2,2,40338,40339,40341,1,3,0
11483,6,1,40344,40344,40345,0,1,3
11484,4,2,40348,40348,40350,0,2,3
11485,6,2,40354,40354,40356,0,2,4
11486,5,3,40359,40359,40362,0,3,3
11487,3,3,40362,40362,40365,0,3,0
11488,3,2,40365,40365,40367,0,2,0
11489,4,3,40369,40369,40372,0,3,2
11490,2,1,40371,40372,40373,1,2,0
11491,2,3,40373,40373,40376,0,3,0
11492,2,3,40375,40376,40379,1,4,0
11493,2,2,40377,40379,40381,2,4,0
11494,4,3,40381,40381,40384,0,3,0
11495,1,2,40382,40384,40386,2,4,0
11496,4,3,40386,40386,40389,0,3,0
11497,5,1,40391,40391,40392,0,1,2
11498,6,2,40397,40397,40399,0,2,5
11499,6,1,40403,40403,40404,0,1,4
11500,3,1,40406,40406,40407,0,1,2
11501,3,1,40409,40409,40410,0,1,2
11502,1,1,40410,40410,40411,0,1,0
11503,5,2,40415,40415,40417,0,2,4
11504,2,3,40417,40417,40420,0,3,0
11505,3,2,40420,40420,40422,0,2,0
11506,4,2,40424,40424,40426,0,2,2
11507,4,2,40428,40428,40430,0,2,2
11508,5,1,40433,40433,40434,0,1,3
11509,4,2,40437,40437,40439,0,2,3
11510,1,1,40438,40439,40440,1,2,0
11511,6,3,40444,40444,40447,0,3,4
11512,6,3,40450,40450,40453,0,3,3
11513,3,3,40453,40453,40456,0,3,0
11514,3,2,40456,40456,40458,0,2,0
11515,1,1,40457,40458,40459,1,2,0
11516,4,2,40461,40461,40463,0,2,2
11517,1,1,40462,40463,40464,1,2,0
11518,6,3,40468,40468,40471,0,3,4
11519,1,2,40469,40471,40473,2,4,0
11520,4,2,40473,40473,40475,0,2,0
11521,6,1,40479,40479,40480,0,1,4
11522,3,1,40482,40482,40483,0,1,2
11523,2,2,40484,40484,40486,0,2,1
11524,5,3,40489,40489,40492,0,3,3
11525,6,3,40495,40495,40498,0,3,3
11526,3,3,40498,40498,40501,0,3,0
11527,3,3,40501,40501,40504,0,3,0
11528,3,2,40504,40504,40506,0,2,0
11529,2,2,40506,40506,40508,0,2,0
11530,2,1,40508,40508,40509,0,1,0
11531,4,3,40512,40512,40515,0,3,3
11532,3,3,40515,40515,40518,0,3,0
11533,6,1,40521,40521,40522,0,1,3
11534,2,1,40523,40523,40524,0,1,1
11535,4,1,40527,40527,40528,0,1,3
11536,1,3,40528,40528,40531,0,3,0
11537,4,2,40532,40532,40534,0,2,1
11538,5,2,40537,40537,40539,0,2,3
11539,4,2,40541,40541,40543,0,2,2
11540,5,1,40546,40546,40547,0,1,3
11541,1,3,40547,40547,40550,0,3,0
11542,6,1,40553,40553,40554,0,1,3
11543,1,3,40554,40554,40557,0,3,0
11544,2,3,40556,40557,40560,1,4,0
11545,5,3,40561,40561,40564,0,3,1
11546,4,1,40565,40565,40566,0,1,1
11547,2,3,40567,40567,40570,0,3,1
11548,3,1,40570,40570,40571,0,1,0
11549,3,2,40573,40573,40575,0,2,2
11550,6,2,40579,40579,40581,0,2,4
11551,3,1,40582,40582,40583,0,1,1
11552,3,1,40585,40585,40586,0,1,2
11553,5,2,40590,40590,40592,0,2,4
11554,4,3,40594,40594,40597,0,3,2
11555,4,1,40598,40598,40599,0,1,1
11556,6,1,40604,40604,40605,0,1,5
11557,3,2,40607,40607,40609,0,2,2
11558,5,3,40612,40612,40615,0,3,3
11559,3,2,40615,40615,40617,0,2,0
11560,3,2,40618,40618,40620,0,2,1
11561,6,1,40624,40624,40625,0,1,4
11562,6,1,40630,40630,40631,0,1,5
11563,5,2,40635,40635,40637,0,2,4
11564,3,3,40638,40638,40641,0,3,1
11565,4,2,40642,40642,40644,0,2,1
11566,2,3,40644,40644,40647,0,3,0
11567,2,2,40646,40647,40649,1,3,0
11568,1,1,40647,40649,40650,2,3,0
11569,3,3,40650,40650,40653,0,3,0
11570,2,2,40652,40653,40655,1,3,0
11571,3,1,40655,40655,40656,0,1,0
11572,4,2,40659,40659,40661,0,2,3
11573,4,2,40663,40663,40665,0,2,2
11574,5,1,40668,40668,40669,0,1,3
11575,6,3,40674,40674,40677,0,3,5
11576,5,2,40679,40679,40681,0,2,2
11577,2,2,40681,40681,40683,0,2,0
11578,3,3,40684,40684,40687,0,3,1
11579,2,1,40686,40687,40688,1,2,0
11580,1,2,40687,40688,40690,1,3,0
11581,2,1,40689,40690,40691,1,2,0
11582,5,1,40694,40694,40695,0,1,3
11583,6,3,40700,40700,40703,0,3,5
11584,1,2,40701,40703,40705,2,4,0
11585,1,1,40702,40705,40706,3,4,0
11586,5,3,40707,40707,40710,0,3,1
11587,4,2,40711,40711,40713,0,2,1
11588,3,2,40714,40714,40716,0,2,1
11589,5,2,40719,40719,40721,0,2,3
11590,1,3,40720,40721,40724,1,4,0
11591,5,1,40725,40725,40726,0,1,1
11592,6,1,40731,40731,40732,0,1,5
11593,3,2,40734,40734,40736,0,2,2
11594,6,3,40740,40740,40743,0,3,4
11595,2,3,40742,40743,40746,1,4,0
11596,6,2,40748,40748,40750,0,2,2
11597,4,3,40752,40752,40755,0,3,2
11598,3,3,40755,40755,40758,0,3,0
11599,6,3,40761,40761,40764,0,3,3
11600,6,2,40767,40767,40769,0,2,3
11601,5,2,40772,40772,40774,0,2,3
11602,5,3,40777,40777,40780,0,3,3
11603,3,1,40780,40780,40781,0,1,0
11604,4,1,40784,40784,40785,0,1,3
11605,3,3,40787,40787,40790,0,3,2
11606,1,1,40788,40790,40791,2,3,0
11607,5,1,40793,40793,40794,0,1,2
11608,5,3,40798,40798,40801,0,3,4
11609,5,2,40803,40803,40805,0,2,2
11610,4,1,40807,40807,40808,0,1,2
11611,6,1,40813,40813,40814,0,1,5
11612,1,2,40814,40814,40816,0,2,0
11613,6,2,40820,40820,40822,0,2,4
11614,5,1,40825,40825,40826,0,1,3
11615,6,2,40831,40831,40833,0,2,5
11616,5,2,40836,40836,40838,0,2,3
11617,2,1,40838,40838,40839,0,1,0
11618,4,2,40842,40842,40844,0,2,3
11619,3,3,40845,40845,40848,0,3,1
11620,2,1,40847,40848,40849,1,2,0
11621,4,2,40851,40851,40853,0,2,2
11622,3,1,40854,40854,40855,0,1,1
11623,4,3,40858,40858,40861,0,3,3
11624,1,3,40859,40861,40864,2,5,0
11625,1,1,40860,40864,40865,4,5,0
11626,3,3,40863,40865,40868,2,5,0
11627,5,2,40868,40868,40870,0,2,0
11628,2,2,40870,40870,40872,0,2,0
11629,3,3,40873,40873,40876,0,3,1
11630,5,3,40878,40878,40881,0,3,2
11631,1,2,40879,40881,40883,2,4,0
11632,5,1,40884,40884,40885,0,1,1
11633,3,3,40887,40887,40890,0,3,2
11634,4,2,40891,40891,40893,0,2,1
11635,6,3,40897,40897,40900,0,3,4
11636,1,1,40898,40900,40901,2,3,0
11637,2,2,40900,40901,40903,1,3,0
11638,5,3,40905,40905,40908,0,3,2
11639,5,2,40910,40910,40912,0,2,2
11640,6,1,40916,40916,40917,0,1,4
11641,5,3,40921,40921,40924,0,3,4
11642,6,2,40927,40927,40929,0,2,3
11643,3,2,40930,40930,40932,0,2,1
11644,1,3,40931,40932,40935,1,4,0
11645,2,1,40933,40935,40936,2,3,0
11646,1,1,40934,40936,40937,2,3,0
11647,4,3,40938,40938,40941,0,3,1
11648,1,1,40939,40941,40942,2,3,0
11649,3,1,40942,40942,40943,0,1,0
11650,1,2,40943,40943,40945,0,2,0
11651,6,3,40949,40949,40952,0,3,4
11652,3,3,40952,40952,40955,0,3,0
11653,1,2,40953,40955,40957,2,4,0
11654,5,1,40958,40958,40959,0,1,1
11655,6,1,40964,40964,40965,0,1,5
11656,4,2,40968,40968,40970,0,2,3
11657,4,2,40972,40972,40974,0,2,2
11658,6,2,40978,40978,40980,0,2,4
11659,4,1,40982,40982,40983,0,1,2
11660,4,2,40986,40986,40988,0,2,3
11661,3,3,40989,40989,40992,0,3,1
11662,3,3,40992,40992,40995,0,3,0
11663,3,3,40995,40995,40998,0,3,0
11664,4,3,40999,40999,41002,0,3,1
11665,3,1,41002,41002,41003,0,1,0
11666,2,2,41004,41004,41006,0,2,1
11667,3,3,41007,41007,41010,0,3,1
11668,4,1,41011,41011,41012,0,1,1
11669,1,2,41012,41012,41014,0,2,0
11670,1,2,41013,41014,41016,1,3,0
11671,6,1,41019,41019,41020,0,1,3
11672,5,1,41024,41024,41025,0,1,4
11673,1,1,41025,41025,41026,0,1,0
11674,1,2,41026,41026,41028,0,2,0
11675,4,2,41030,41030,41032,0,2,2
11676,4,1,41034,41034,41035,0,1,2
11677,1,2,41035,41035,41037,0,2,0
11678,4,2,41039,41039,41041,0,2,2
11679,1,2,41040,41041,41043,1,3,0
11680,5,1,41045,41045,41046,0,1,2
11681,4,3,41049,41049,41052,0,3,3
11682,6,2,41055,41055,41057,0,2,3
11683,3,3,41058,41058,41061,0,3,1
11684,1,3,41059,41061,41064,2,5,0
11685,3,1,41062,41064,41065,2,3,0
11686,6,3,41068,41068,41071,0,3,3
11687,4,3,41072,41072,41075,0,3,1
11688,4,1,41076,41076,41077,0,1,1
11689,6,1,41082,41082,41083,0,1,5
11690,4,1,41086,41086,41087,0,1,3
11691,3,3,41089,41089,41092,0,3,2
11692,1,2,41090,41092,41094,2,4,0
11693,3,3,41093,41094,41097,1,4,0
11694,3,3,41096,41097,41100,1,4,0
11695,3,2,41099,41100,41102,1,3,0
11696,4,1,41103,41103,41104,0,1,1
11697,6,3,41109,41109,41112,0,3,5
11698,5,2,41114,41114,41116,0,2,2
11699,6,2,41120,41120,41122,0,2,4
11700,3,3,41123,41123,41126,0,3,1
11701,2,2,41125,41126,41128,1,3,0
11702,4,3,41129,41129,41132,0,3,1
11703,1,3,41130,41132,41135,2,5,0
11704,1,1,41131,41135,41136,4,5,0
11705,1,3,41132,41136,41139,4,7,0
11706,3,1,41135,41139,41140,4,5,0
11707,4,1,41139,41140,41141,1,2,0
11708,1,2,41140,41141,41143,1,3,0
11709,5,3,41145,41145,41148,0,3,2
11710,6,2,41151,41151,41153,0,2,3
11711,1,2,41152,41153,41155,1,3,0
11712,6,1,41158,41158,41159,0,1,3
11713,3,2,41161,41161,41163,0,2,2
11714,1,2,41162,41163,41165,1,3,0
11715,2,2,41164,41165,41167,1,3,0
11716,1,3,41165,41167,41170,2,5,0
11717,2,3,41167,41170,41173,3,6,0
11718,4,3,41171,41173,41176,2,5,0
11719,1,3,41172,41176,41179,4,7,0
11720,1,2,41173,41179,41181,6,8,0
11721,5,2,41178,41181,41183,3,5,0
11722,3,1,41181,41183,41184,2,3,0
11723,5,3,41186,41186,41189,0,3,2
11724,4,3,41190,41190,41193,0,3,1
11725,4,2,41194,41194,41196,0,2,1
11726,5,3,41199,41199,41202,0,3,3
11727,3,1,41202,41202,41203,0,1,0
11728,1,3,41203,41203,41206,0,3,0
11729,4,3,41207,41207,41210,0,3,1
11730,4,3,41211,41211,41214,0,3,1
11731,3,1,41214,41214,41215,0,1,0
11732,6,1,41220,41220,41221,0,1,5
11733,6,1,41226,41226,41227,0,1,5
11734,3,1,41229,41229,41230,0,1,2
11735,4,3,41233,41233,41236,0,3,3
11736,3,2,41236,41236,41238,0,2,0
11737,1,1,41237,41238,41239,1,2,0
11738,1,1,41238,41239,41240,1,2,0
11739,3,1,41241,41241,41242,0,1,1
11740,1,2,41242,41242,41244,0,2,0
11741,6,2,41248,41248,41250,0,2,4
11742,5,1,41253,41253,41254,0,1,3
11743,6,2,41259,41259,41261,0,2,5
11744,4,2,41263,41263,41265,0,2,2
11745,4,2,41267,41267,41269,0,2,2
11746,2,1,41269,41269,41270,0,1,0
11747,1,2,41270,41270,41272,0,2,0
11748,2,3,41272,41272,41275,0,3,0
11749,3,3,41275,41275,41278,0,3,0
11750,6,2,41281,41281,41283,0,2,3
11751,2,3,41283,41283,41286,0,3,0
11752,3,3,41286,41286,41289,0,3,0
11753,6,3,41292,41292,41295,0,3,3
11754,1,2,41293,41295,41297,2,4,0
11755,6,1,41299,41299,41300,0,1,2
11756,5,2,41304,41304,41306,0,2,4
11757,3,2,41307,41307,41309,0,2,1
11758,1,3,41308,41309,41312,1,4,0
11759,4,1,41312,41312,41313,0,1,0
11760,5,3,41317,41317,41320,0,3,4
11761,6,3,41323,41323,41326,0,3,3
11762,3,1,41326,41326,41327,0,1,0
11763,6,1,41332,41332,41333,0,1,5
11764,1,1,41333,41333,41334,0,1,0
11765,2,2,41335,41335,41337,0,2,1
11766,1,2,41336,41337,41339,1,3,0
11767,5,3,41341,41341,41344,0,3,2
11768,5,3,41346,41346,41349,0,3,2
11769,4,2,41350,41350,41352,0,2,1
11770,2,1,41352,41352,41353,0,1,0
11771,4,2,41356,41356,41358,0,2,3
11772,5,2,41361,41361,41363,0,2,3
11773,6,3,41367,41367,41370,0,3,4
11774,2,1,41369,41370,41371,1,2,0
11775,1,2,41370,41371,41373,1,3,0
11776,1,1,41371,41373,41374,2,3,0
11777,3,1,41374,41374,41375,0,1,0
11778,6,1,41380,41380,41381,0,1,5
11779,1,2,41381,41381,41383,0,2,0
11780,2,1,41383,41383,41384,0,1,0
11781,2,3,41385,41385,41388,0,3,1
11782,1,1,41386,41388,41389,2,3,0
11783,1,2,41387,41389,41391,2,4,0
11784,3,2,41390,41391,41393,1,3,0
11785,6,3,41396,41396,41399,0,3,3
11786,6,3,41402,41402,41405,0,3,3
11787,2,1,41404,41405,41406,1,2,0
11788,5,2,41409,41409,41411,0,2,3
11789,5,1,41414,41414,41415,0,1,3
11790,6,2,41420,41420,41422,0,2,5
11791,4,2,41424,41424,41426,0,2,2
11792,2,3,41426,41426,41429,0,3,0
11793,4,2,41430,41430,41432,0,2,1
11794,6,1,41436,41436,41437,0,1,4
11795,6,1,41442,41442,41443,0,1,5
11796,4,2,41446,41446,41448,0,2,3
11797,6,3,41452,41452,41455,0,3,4
11798,5,3,41457,41457,41460,0,3,2
11799,3,2,41460,41460,41462,0,2,0
11800,2,2,41462,41462,41464,0,2,0
11801,3,3,41465,41465,41468,0,3,1
11802,3,3,41468,41468,41471,0,3,0
11803,6,2,41474,41474,41476,0,2,3
11804,4,1,41478,41478,41479,0,1,2
11805,3,1,41481,41481,41482,0,1,2
11806,4,3,41485,41485,41488,0,3,3
11807,4,1,41489,41489,41490,0,1,1
11808,2,3,41491,41491,41494,0,3,1
11809,2,2,41493,41494,41496,1,3,0
11810,4,1,41497,41497,41498,0,1,1
11811,2,3,41499,41499,41502,0,3,1
11812,1,3,41500,41502,41505,2,5,0
11813,3,2,41503,41505,41507,2,4,0
11814,1,1,41504,41507,41508,3,4,0
11815,3,3,41507,41508,41511,1,4,0
11816,5,2,41512,41512,41514,0,2,1
11817,3,3,41515,41515,41518,0,3,1
11818,1,1,41516,41518,41519,2,3,0
11819,2,1,41518,41519,41520,1,2,0
11820,2,2,41520,41520,41522,0,2,0
11821,1,2,41521,41522,41524,1,3,0
11822,3,1,41524,41524,41525,0,1,0
11823,1,3,41525,41525,41528,0,3,0
11824,6,1,41531,41531,41532,0,1,3
11825,3,1,41534,41534,41535,0,1,2
11826,2,2,41536,41536,41538,0,2,1
11827,4,1,41540,41540,41541,0,1,2
11828,1,2,41541,41541,41543,0,2,0
11829,4,1,41545,41545,41546,0,1,2
11830,1,1,41546,41546,41547,0,1,0
11831,6,3,41552,41552,41555,0,3,5
11832,6,1,41558,41558,41559,0,1,3
11833,5,1,41563,41563,41564,0,1,4
11834,1,1,41564,41564,41565,0,1,0
11835,5,3,41569,41569,41572,0,3,4
11836,3,2,41572,41572,41574,0,2,0
11837,3,3,41575,41575,41578,0,3,1
11838,2,3,41577,41578,41581,1,4,0
11839,3,3,41580,41581,41584,1,4,0
11840,5,3,41585,41585,41588,0,3,1
11841,3,2,41588,41588,41590,0,2,0
11842,5,1,41593,41593,41594,0,1,3
11843,4,1,41597,41597,41598,0,1,3
11844,3,2,41600,41600,41602,0,2,2
11845,3,2,41603,41603,41605,0,2,1
11846,5,1,41608,41608,41609,0,1,3
11847,5,2,41613,41613,41615,0,2,4
11848,2,1,41615,41615,41616,0,1,0
11849,1,2,41616,41616,41618,0,2,0
11850,2,2,41618,41618,41620,0,2,0
11851,2,3,41620,41620,41623,0,3,0
11852,6,3,41626,41626,41629,0,3,3
11853,1,1,41627,41629,41630,2,3,0
11854,3,2,41630,41630,41632,0,2,0
11855,1,3,41631,41632,41635,1,4,0
11856,1,1,41632,41635,41636,3,4,0
11857,5,1,41637,41637,41638,0,1,1
11858,4,1,41641,41641,41642,0,1,3
11859,5,2,41646,41646,41648,0,2,4
11860,4,1,41650,41650,41651,0,1,2
11861,6,3,41656,41656,41659,0,3,5
11862,6,2,41662,41662,41664,0,2,3
11863,4,3,41666,41666,41669,0,3,2
11864,1,1,41667,41669,41670,2,3,0
11865,3,3,41670,41670,41673,0,3,0
11866,2,1,41672,41673,41674,1,2,0
11867,5,1,41677,41677,41678,0,1,3
11868,4,3,41681,41681,41684,0,3,3
11869,2,2,41683,41684,41686,1,3,0
11870,2,1,41685,41686,41687,1,2,0
11871,1,3,41686,41687,41690,1,4,0
11872,6,3,41692,41692,41695,0,3,2
11873,3,2,41695,41695,41697,0,2,0
11874,3,3,41698,41698,41701,0,3,1
11875,1,3,41699,41701,41704,2,5,0
11876,2,2,41701,41704,41706,3,5,0
11877,6,3,41707,41707,41710,0,3,1
11878,2,3,41709,41710,41713,1,4,0
11879,4,2,41713,41713,41715,0,2,0
11880,1,1,41714,41715,41716,1,2,0
11881,2,2,41716,41716,41718,0,2,0
11882,5,1,41721,41721,41722,0,1,3
11883,2,3,41723,41723,41726,0,3,1
11884,6,1,41729,41729,41730,0,1,3
11885,5,2,41734,41734,41736,0,2,4
11886,6,3,41740,41740,41743,0,3,4
11887,4,1,41744,41744,41745,0,1,1
11888,1,1,41745,41745,41746,0,1,0
11889,2,2,41747,41747,41749,0,2,1
11890,1,3,41748,41749,41752,1,4,0
11891,1,3,41749,41752,41755,3,6,0
11892,1,1,41750,41755,41756,5,6,0
11893,1,2,41751,41756,41758,5,7,0
11894,4,2,41755,41758,41760,3,5,0
11895,3,3,41758,41760,41763,2,5,0
11896,5,2,41763,41763,41765,0,2,0
11897,6,1,41769,41769,41770,0,1,4
11898,4,1,41773,41773,41774,0,1,3
11899,6,2,41779,41779,41781,0,2,5
11900,1,1,41780,41781,41782,1,2,0
11901,1,2,41781,41782,41784,1,3,0
11902,6,1,41787,41787,41788,0,1,3
11903,2,1,41789,41789,41790,0,1,1
11904,4,1,41793,41793,41794,0,1,3
11905,6,2,41799,41799,41801,0,2,5
11906,3,1,41802,41802,41803,0,1,1
11907,4,2,41806,41806,41808,0,2,3
11908,5,1,41811,41811,41812,0,1,3
11909,3,2,41814,41814,41816,0,2,2
11910,6,2,41820,41820,41822,0,2,4
11911,3,1,41823,41823,41824,0,1,1
11912,4,3,41827,41827,41830,0,3,3
11913,3,3,41830,41830,41833,0,3,0
11914,1,3,41831,41833,41836,2,5,0
11915,6,2,41837,41837,41839,0,2,1
11916,3,1,41840,41840,41841,0,1,1
11917,5,2,41845,41845,41847,0,2,4
11918,6,2,41851,41851,41853,0,2,4
11919,1,2,41852,41853,41855,1,3,0
11920,2,1,41854,41855,41856,1,2,0
11921,4,3,41858,41858,41861,0,3,2
11922,3,3,41861,41861,41864,0,3,0
11923,3,3,41864,41864,41867,0,3,0
11924,1,2,41865,41867,41869,2,4,0
11925,6,2,41871,41871,41873,0,2,2
11926,3,1,41874,41874,41875,0,1,1
11927,6,2,41880,41880,41882,0,2,5
11928,2,3,41882,41882,41885,0,3,0
11929,4,1,41886,41886,41887,0,1,1
11930,2,2,41888,41888,41890,0,2,1
11931,2,1,41890,41890,41891,0,1,0
11932,1,1,41891,41891,41892,0,1,0
11933,1,2,41892,41892,41894,0,2,0
11934,5,3,41897,41897,41900,0,3,3
11935,6,1,41903,41903,41904,0,1,3
11936,4,3,41907,41907,41910,0,3,3
11937,5,1,41912,41912,41913,0,1,2
11938,3,2,41915,41915,41917,0,2,2
11939,6,2,41921,41921,41923,0,2,4
11940,3,3,41924,41924,41927,0,3,1
11941,5,3,41929,41929,41932,0,3,2
11942,4,2,41933,41933,41935,0,2,1
11943,5,3,41938,41938,41941,0,3,3
11944,4,1,41942,41942,41943,0,1,1
11945,3,3,41945,41945,41948,0,3,2
11946,2,1,41947,41948,41949,1,2,0
11947,5,1,41952,41952,41953,0,1,3
11948,1,3,41953,41953,41956,0,3,0
11949,3,1,41956,41956,41957,0,1,0
11950,5,2,41961,41961,41963,0,2,4
11951,4,3,41965,41965,41968,0,3,2
11952,3,3,41968,41968,41971,0,3,0
11953,4,3,41972,41972,41975,0,3,1
11954,3,2,41975,41975,41977,0,2,0
11955,1,2,41976,41977,41979,1,3,0
11956,3,3,41979,41979,41982,0,3,0
11957,4,2,41983,41983,41985,0,2,1
11958,4,3,41987,41987,41990,0,3,2
11959,2,2,41989,41990,41992,1,3,0
11960,5,1,41994,41994,41995,0,1,2
11961,5,1,41999,41999,42000,0,1,4
11962,2,1,42001,42001,42002,0,1,1
11963,6,1,42007,42007,42008,0,1,5
11964,1,2,42008,42008,42010,0,2,0
11965,1,1,42009,42010,42011,1,2,0
11966,3,3,42012,42012,42015,0,3,1
11967,3,3,42015,42015,42018,0,3,0
11968,2,2,42017,42018,42020,1,3,0
11969,1,2,42018,42020,42022,2,4,0
11970,6,1,42024,42024,42025,0,1,2
11971,1,1,42025,42025,42026,0,1,0
11972,6,3,42031,42031,42034,0,3,5
11973,4,2,42035,42035,42037,0,2,1
11974,4,3,42039,42039,42042,0,3,2
11975,3,1,42042,42042,42043,0,1,0
11976,2,3,42044,42044,42047,0,3,1
11977,6,1,42050,42050,42051,0,1,3
11978,3,3,42053,42053,42056,0,3,2
11979,1,1,42054,42056,42057,2,3,0
11980,1,1,42055,42057,42058,2,3,0
11981,6,3,42061,42061,42064,0,3,3
11982,5,3,42066,42066,42069,0,3,2
11983,5,1,42071,42071,42072,0,1,2
11984,3,1,42074,42074,42075,0,1,2
11985,1,2,42075,42075,42077,0,2,0
11986,2,1,42077,42077,42078,0,1,0
11987,4,3,42081,42081,42084,0,3,3
11988,4,2,42085,42085,42087,0,2,1
11989,5,3,42090,42090,42093,0,3,3
11990,3,2,42093,42093,42095,0,2,0
11991,4,2,42097,42097,42099,0,2,2
11992,3,2,42100,42100,42102,0,2,1
11993,2,3,42102,42102,42105,0,3,0
11994,5,2,42107,42107,42109,0,2,2
11995,1,1,42108,42109,42110,1,2,0
11996,3,1,42111,42111,42112,0,1,1
11997,5,3,42116,42116,42119,0,3,4
11998,5,2,42121,42121,42123,0,2,2
11999,6,2,42127,42127,42129,0,2,4
12000,5,2,42132,42132,42134,0,2,3
12001,6,1,42138,42138,42139,0,1,4
12002,1,2,42139,42139,42141,0,2,0
12003,2,2,42141,42141,42143,0,2,0
12004,4,2,42145,42145,42147,0,2,2
12005,3,2,42148,42148,42150,0,2,1
12006,1,1,42149,42150,42151,1,2,0
12007,2,1,42151,42151,42152,0,1,0
12008,4,1,42155,42155,42156,0,1,3
12009,6,2,42161,42161,42163,0,2,5
12010,4,2,42165,42165,42167,0,2,2
12011,6,2,42171,42171,42173,0,2,4
12012,2,1,42173,42173,42174,0,1,0
12013,5,1,42178,42178,42179,0,1,4
12014,3,3,42181,42181,42184,0,3,2
12015,1,1,42182,42184,42185,2,3,0
12016,6,3,42188,42188,42191,0,3,3
12017,3,3,42191,42191,42194,0,3,0
12018,5,1,42196,42196,42197,0,1,2
12019,2,3,42198,42198,42201,0,3,1
12020,3,3,42201,42201,42204,0,3,0
12021,1,2,42202,42204,42206,2,4,0
12022,6,1,42208,42208,42209,0,1,2
12023,3,1,42211,42211,42212,0,1,2
12024,6,1,42217,42217,42218,0,1,5
12025,3,2,42220,42220,42222,0,2,2
12026,4,3,42224,42224,42227,0,3,2
12027,2,1,42226,42227,42228,1,2,0
12028,6,2,42232,42232,42234,0,2,4
12029,6,1,42238,42238,42239,0,1,4
12030,4,1,42242,42242,42243,0,1,3
12031,6,3,42248,42248,42251,0,3,5
12032,5,2,42253,42253,42255,0,2,2
12033,5,3,42258,42258,42261,0,3,3
12034,6,2,42264,42264,42266,0,2,3
12035,3,2,42267,42267,42269,0,2,1
12036,3,2,42270,42270,42272,0,2,1
12037,5,3,42275,42275,42278,0,3,3
12038,6,2,42281,42281,42283,0,2,3
12039,6,3,42287,42287,42290,0,3,4
12040,5,1,42292,42292,42293,0,1,2
12041,6,2,42298,42298,42300,0,2,5
12042,4,2,42302,42302,42304,0,2,2
12043,4,1,42306,42306,42307,0,1,2
12044,2,1,42308,42308,42309,0,1,1
12045,2,1,42310,42310,42311,0,1,1
12046,3,2,42313,42313,42315,0,2,2
12047,6,1,42319,42319,42320,0,1,4
12048,1,1,42320,42320,42321,0,1,0
12049,5,3,42325,42325,42328,0,3,4
12050,2,1,42327,42328,42329,1,2,0
12051,4,3,42331,42331,42334,0,3,2
12052,4,2,42335,42335,42337,0,2,1
12053,3,2,42338,42338,42340,0,2,1
12054,6,3,42344,42344,42347,0,3,4
12055,6,2,42350,42350,42352,0,2,3
12056,3,1,42353,42353,42354,0,1,1
12057,3,3,42356,42356,42359,0,3,2
12058,2,3,42358,42359,42362,1,4,0
12059,2,3,42360,42362,42365,2,5,0
12060,3,2,42363,42365,42367,2,4,0
12061,4,1,42367,42367,42368,0,1,0
12062,1,3,42368,42368,42371,0,3,0
12063,6,1,42374,42374,42375,0,1,3
12064,3,3,42377,42377,42380,0,3,2
12065,5,1,42382,42382,42383,0,1,2
12066,6,1,42388,42388,42389,0,1,5
12067,2,2,42390,42390,42392,0,2,1
12068,6,1,42396,42396,42397,0,1,4
12069,3,1,42399,42399,42400,0,1,2
12070,6,2,42405,42405,42407,0,2,5
12071,4,3,42409,42409,42412,0,3,2
12072,1,3,42410,42412,42415,2,5,0
12073,6,3,42416,42416,42419,0,3,1
12074,3,1,42419,42419,42420,0,1,0
12075,5,3,42424,42424,42427,0,3,4
12076,5,1,42429,42429,42430,0,1,2
12077,5,2,42434,42434,42436,0,2,4
12078,5,1,42439,42439,42440,0,1,3
12079,3,3,42442,42442,42445,0,3,2
12080,4,2,42446,42446,42448,0,2,1
12081,3,2,42449,42449,42451,0,2,1
12082,4,2,42453,42453,42455,0,2,2
12083,4,1,42457,42457,42458,0,1,2
12084,3,1,42460,42460,42461,0,1,2
12085,4,3,42464,42464,42467,0,3,3
12086,4,2,42468,42468,42470,0,2,1
12087,3,3,42471,42471,42474,0,3,1
12088,1,2,42472,42474,42476,2,4,0
12089,5,1,42477,42477,42478,0,1,1
12090,4,1,42481,42481,42482,0,1,3
12091,6,1,42487,42487,42488,0,1,5
12092,6,3,42493,42493,42496,0,3,5
12093,2,1,42495,42496,42497,1,2,0
12094,4,3,42499,42499,42502,0,3,2
12095,6,3,42505,42505,42508,0,3,3
12096,4,3,42509,42509,42512,0,3,1
12097,6,2,42515,42515,42517,0,2,3
12098,3,2,42518,42518,42520,0,2,1
12099,4,2,42522,42522,42524,0,2,2
12100,2,2,42524,42524,42526,0,2,0
12101,6,1,42530,42530,42531,0,1,4
12102,1,2,42531,42531,42533,0,2,0
12103,1,3,42532,42533,42536,1,4,0
12104,6,3,42538,42538,42541,0,3,2
12105,1,2,42539,42541,42543,2,4,0
12106,4,3,42543,42543,42546,0,3,0
12107,4,1,42547,42547,42548,0,1,1
12108,4,2,42551,42551,42553,0,2,3
12109,4,3,42555,42555,42558,0,3,2
12110,6,1,42561,42561,42562,0,1,3
12111,6,2,42567,42567,42569,0,2,5
12112,1,3,42568,42569,42572,1,4,0
12113,2,2,42570,42572,42574,2,4,0
12114,6,2,42576,42576,42578,0,2,2
12115,3,3,42579,42579,42582,0,3,1
12116,6,3,42585,42585,42588,0,3,3
12117,1,1,42586,42588,42589,2,3,0
12118,6,3,42592,42592,42595,0,3,3
12119,5,1,42597,42597,42598,0,1,2
12120,1,1,42598,42598,42599,0,1,0
12121,1,2,42599,42599,42601,0,2,0
12122,3,1,42602,42602,42603,0,1,1
12123,5,2,42607,42607,42609,0,2,4
12124,6,3,42613,42613,42616,0,3,4
12125,2,2,42615,42616,42618,1,3,0
12126,2,3,42617,42618,42621,1,4,0
12127,6,3,42623,42623,42626,0,3,2
12128,4,3,42627,42627,42630,0,3,1
12129,2,1,42629,42630,42631,1,2,0
12130,3,2,42632,42632,42634,0,2,1
12131,4,2,42636,42636,42638,0,2,2
12132,4,3,42640,42640,42643,0,3,2
12133,4,1,42644,42644,42645,0,1,1
12134,2,1,42646,42646,42647,0,1,1
12135,2,1,42648,42648,42649,0,1,1
12136,1,2,42649,42649,42651,0,2,0
12137,2,3,42651,42651,42654,0,3,0
12138,1,1,42652,42654,42655,2,3,0
12139,3,3,42655,42655,42658,0,3,0
12140,1,3,42656,42658,42661,2,5,0
12141,6,3,42662,42662,42665,0,3,1
12142,2,2,42664,42665,42667,1,3,0
12143,5,2,42669,42669,42671,0,2,2
12144,3,3,42672,42672,42675,0,3,1
12145,3,1,42675,42675,42676,0,1,0
12146,4,2,42679,42679,42681,0,2,3
12147,1,1,42680,42681,42682,1,2,0
12148,5,3,42685,42685,42688,0,3,3
12149,5,3,42690,42690,42693,0,3,2
12150,1,3,42691,42693,42696,2,5,0
12151,1,3,42692,42696,42699,4,7,0
12152,1,1,42693,42699,42700,6,7,0
12153,5,3,42698,42700,42703,2,5,0
12154,3,3,42701,42703,42706,2,5,0
12155,3,1,42704,42706,42707,2,3,0
12156,5,1,42709,42709,42710,0,1,2
12157,5,2,42714,42714,42716,0,2,4
12158,4,3,42718,42718,42721,0,3,2
12159,6,1,42724,42724,42725,0,1,3
12160,1,1,42725,42725,42726,0,1,0
12161,4,3,42729,42729,42732,0,3,3
12162,6,1,42735,42735,42736,0,1,3
12163,3,2,42738,42738,42740,0,2,2
12164,3,1,42741,42741,42742,0,1,1
12165,4,2,42745,42745,42747,0,2,3
12166,6,1,42751,42751,42752,0,1,4
12167,3,2,42754,42754,42756,0,2,2
12168,4,2,42758,42758,42760,0,2,2
12169,5,2,42763,42763,42765,0,2,3
12170,5,1,42768,42768,42769,0,1,3
12171,1,3,42769,42769,42772,0,3,0
12172,3,2,42772,42772,42774,0,2,0
12173,5,2,42777,42777,42779,0,2,3
12174,2,2,42779,42779,42781,0,2,0
12175,6,1,42785,42785,42786,0,1,4
12176,3,2,42788,42788,42790,0,2,2
12177,3,1,42791,42791,42792,0,1,1
12178,5,1,42796,42796,42797,0,1,4
12179,1,3,42797,42797,42800,0,3,0
12180,6,1,42803,42803,42804,0,1,3
12181,3,1,42806,42806,42807,0,1,2
12182,6,1,42812,42812,42813,0,1,5
12183,4,2,42816,42816,42818,0,2,3
12184,1,1,42817,42818,42819,1,2,0
12185,5,3,42822,42822,42825,0,3,3
12186,6,1,42828,42828,42829,0,1,3
12187,3,1,42831,42831,42832,0,1,2
12188,3,1,42834,42834,42835,0,1,2
12189,5,3,42839,42839,42842,0,3,4
12190,4,3,42843,42843,42846,0,3,1
12191,6,2,42849,42849,42851,0,2,3
12192,4,1,42853,42853,42854,0,1,2
12193,5,1,42858,42858,42859,0,1,4
12194,3,1,42861,42861,42862,0,1,2
12195,6,1,42867,42867,42868,0,1,5
12196,2,1,42869,42869,42870,0,1,1
12197,6,2,42875,42875,42877,0,2,5
12198,4,3,42879,42879,42882,0,3,2
12199,4,1,42883,42883,42884,0,1,1
12200,1,3,42884,42884,42887,0,3,0
12201,5,3,42889,42889,42892,0,3,2
12202,5,3,42894,42894,42897,0,3,2
12203,1,2,42895,42897,42899,2,4,0
12204,3,1,42898,42899,42900,1,2,0
12205,6,3,42904,42904,42907,0,3,4
12206,4,2,42908,42908,42910,0,2,1
12207,4,3,42912,42912,42915,0,3,2
12208,2,1,42914,42915,42916,1,2,0
12209,5,3,42919,42919,42922,0,3,3
12210,5,1,42924,42924,42925,0,1,2
12211,4,1,42928,42928,42929,0,1,3
12212,4,1,42932,42932,42933,0,1,3
12213,5,3,42937,42937,42940,0,3,4
12214,6,2,42943,42943,42945,0,2,3
12215,2,2,42945,42945,42947,0,2,0
12216,4,1,42949,42949,42950,0,1,2
12217,5,3,42954,42954,42957,0,3,4
12218,6,2,42960,42960,42962,0,2,3
12219,2,1,42962,42962,42963,0,1,0
12220,5,1,42967,42967,42968,0,1,4
12221,6,2,42973,42973,42975,0,2,5
12222,2,2,42975,42975,42977,0,2,0
12223,3,1,42978,42978,42979,0,1,1
12224,3,3,42981,42981,42984,0,3,2
12225,6,2,42987,42987,42989,0,2,3
12226,4,2,42991,42991,42993,0,2,2
12227,1,3,42992,42993,42996,1,4,0
12228,3,2,42995,42996,42998,1,3,0
12229,5,1,43000,43000,43001,0,1,2
12230,4,2,43004,43004,43006,0,2,3
12231,1,2,43005,43006,43008,1,3,0
12232,4,1,43009,43009,43010,0,1,1
12233,3,2,43012,43012,43014,0,2,2
12234,1,3,43013,43014,43017,1,4,0
12235,3,1,43016,43017,43018,1,2,0
12236,6,3,43022,43022,43025,0,3,4
12237,6,3,43028,43028,43031,0,3,3
12238,2,2,43030,43031,43033,1,3,0
12239,5,3,43035,43035,43038,0,3,2
12240,2,2,43037,43038,43040,1,3,0
12241,6,3,43043,43043,43046,0,3,3
12242,3,2,43046,43046,43048,0,2,0
12243,3,3,43049,43049,43052,0,3,1
12244,4,2,43053,43053,43055,0,2,1
12245,4,1,43057,43057,43058,0,1,2
12246,6,2,43063,43063,43065,0,2,5
12247,6,2,43069,43069,43071,0,2,4
12248,3,2,43072,43072,43074,0,2,1
12249,3,3,43075,43075,43078,0,3,1
12250,6,1,43081,43081,43082,0,1,3
12251,1,3,43082,43082,43085,0,3,0
12252,2,3,43084,43085,43088,1,4,0
12253,4,3,43088,43088,43091,0,3,0
12254,6,1,43094,43094,43095,0,1,3
12255,3,2,43097,43097,43099,0,2,2
12256,6,2,43103,43103,43105,0,2,4
12257,5,2,43108,43108,43110,0,2,3
12258,2,2,43110,43110,43112,0,2,0
12259,6,1,43116,43116,43117,0,1,4
12260,3,1,43119,43119,43120,0,1,2
12261,4,2,43123,43123,43125,0,2,3
12262,1,2,43124,43125,43127,1,3,0
12263,5,2,43129,43129,43131,0,2,2
12264,4,3,43133,43133,43136,0,3,2
12265,3,3,43136,43136,43139,0,3,0
12266,6,1,43142,43142,43143,0,1,3
12267,1,3,43143,43143,43146,0,3,0
12268,3,1,43146,43146,43147,0,1,0
12269,5,3,43151,43151,43154,0,3,4
12270,2,1,43153,43154,43155,1,2,0
12271,1,3,43154,43155,43158,1,4,0
12272,5,2,43159,43159,43161,0,2,1
12273,4,2,43163,43163,43165,0,2,2
12274,3,1,43166,43166,43167,0,1,1
12275,3,2,43169,43169,43171,0,2,2
12276,5,1,43174,43174,43175,0,1,3
12277,1,3,43175,43175,43178,0,3,0
12278,3,1,43178,43178,43179,0,1,0
12279,3,3,43181,43181,43184,0,3,2
12280,6,3,43187,43187,43190,0,3,3
12281,2,2,43189,43190,43192,1,3,0
12282,4,2,43193,43193,43195,0,2,1
12283,3,1,43196,43196,43197,0,1,1
12284,3,2,43199,43199,43201,0,2,2
12285,2,2,43201,43201,43203,0,2,0
12286,3,1,43204,43204,43205,0,1,1
12287,5,3,43209,43209,43212,0,3,4
12288,2,1,43211,43212,43213,1,2,0
12289,3,2,43214,43214,43216,0,2,1
12290,4,2,43218,43218,43220,0,2,2
12291,2,3,43220,43220,43223,0,3,0
12292,3,2,43223,43223,43225,0,2,0
12293,4,2,43227,43227,43229,0,2,2
12294,1,1,43228,43229,43230,1,2,0
12295,1,2,43229,43230,43232,1,3,0
12296,5,2,43234,43234,43236,0,2,2
12297,4,2,43238,43238,43240,0,2,2
12298,5,3,43243,43243,43246,0,3,3
12299,3,3,43246,43246,43249,0,3,0
12300,1,1,43247,43249,43250,2,3,0
12301,3,3,43250,43250,43253,0,3,0
12302,4,1,43254,43254,43255,0,1,1
12303,1,2,43255,43255,43257,0,2,0
12304,6,1,43261,43261,43262,0,1,4
12305,3,3,43264,43264,43267,0,3,2
12306,3,1,43267,43267,43268,0,1,0
12307,4,3,43271,43271,43274,0,3,3
12308,5,1,43276,43276,43277,0,1,2
12309,2,3,43278,43278,43281,0,3,1
12310,1,1,43279,43281,43282,2,3,0
12311,6,1,43285,43285,43286,0,1,3
12312,1,3,43286,43286,43289,0,3,0
12313,1,1,43287,43289,43290,2,3,0
12314,3,1,43290,43290,43291,0,1,0
12315,1,2,43291,43291,43293,0,2,0
12316,3,3,43294,43294,43297,0,3,1
12317,6,3,43300,43300,43303,0,3,3
12318,5,2,43305,43305,43307,0,2,2
12319,5,3,43310,43310,43313,0,3,3
12320,3,2,43313,43313,43315,0,2,0
12321,4,2,43317,43317,43319,0,2,2
12322,6,2,43323,43323,43325,0,2,4
12323,2,1,43325,43325,43326,0,1,0
12324,4,3,43329,43329,43332,0,3,3
12325,6,2,43335,43335,43337,0,2,3
12326,3,3,43338,43338,43341,0,3,1
12327,2,2,43340,43341,43343,1,3,0
12328,6,3,43346,43346,43349,0,3,3
12329,2,2,43348,43349,43351,1,3,0
12330,6,2,43354,43354,43356,0,2,3
12331,1,3,43355,43356,43359,1,4,0
12332,5,2,43360,43360,43362,0,2,1
12333,4,3,43364,43364,43367,0,3,2
12334,3,3,43367,43367,43370,0,3,0
12335,3,3,43370,43370,43373,0,3,0
12336,2,2,43372,43373,43375,1,3,0
12337,4,1,43376,43376,43377,0,1,1
12338,6,3,43382,43382,43385,0,3,5
12339,3,3,43385,43385,43388,0,3,0
12340,6,2,43391,43391,43393,0,2,3
12341,4,2,43395,43395,43397,0,2,2
12342,5,2,43400,43400,43402,0,2,3
12343,5,2,43405,43405,43407,0,2,3
12344,2,3,43407,43407,43410,0,3,0
12345,5,3,43412,43412,43415,0,3,2
12346,5,3,43417,43417,43420,0,3,2
12347,5,2,43422,43422,43424,0,2,2
12348,5,2,43427,43427,43429,0,2,3
12349,3,2,43430,43430,43432,0,2,1
12350,4,3,43434,43434,43437,0,3,2
12351,1,2,43435,43437,43439,2,4,0
12352,4,2,43439,43439,43441,0,2,0
12353,3,2,43442,43442,43444,0,2,1
12354,1,3,43443,43444,43447,1,4,0
12355,5,3,43448,43448,43451,0,3,1
12356,5,1,43453,43453,43454,0,1,2
12357,4,3,43457,43457,43460,0,3,3
12358,6,3,43463,43463,43466,0,3,3
12359,4,1,43467,43467,43468,0,1,1
12360,3,3,43470,43470,43473,0,3,2
12361,6,3,43476,43476,43479,0,3,3
12362,6,2,43482,43482,43484,0,2,3
12363,4,1,43486,43486,43487,0,1,2
12364,6,2,43492,43492,43494,0,2,5
12365,1,2,43493,43494,43496,1,3,0
12366,3,1,43496,43496,43497,0,1,0
12367,5,3,43501,43501,43504,0,3,4
12368,5,1,43506,43506,43507,0,1,2
12369,2,2,43508,43508,43510,0,2,1
12370,1,1,43509,43510,43511,1,2,0
12371,5,2,43514,43514,43516,0,2,3
12372,2,2,43516,43516,43518,0,2,0
12373,1,2,43517,43518,43520,1,3,0
12374,5,3,43522,43522,43525,0,3,2
12375,1,3,43523,43525,43528,2,5,0
12376,3,2,43526,43528,43530,2,4,0
12377,6,2,43532,43532,43534,0,2,2
12378,4,1,43536,43536,43537,0,1,2
12379,1,3,43537,43537,43540,0,3,0
12380,1,2,43538,43540,43542,2,4,0
12381,1,2,43539,43542,43544,3,5,0
12382,1,3,43540,43544,43547,4,7,0
12383,3,3,43543,43547,43550,4,7,0
12384,5,3,43548,43550,43553,2,5,0
12385,2,2,43550,43553,43555,3,5,0
12386,1,3,43551,43555,43558,4,7,0
12387,2,1,43553,43558,43559,5,6,0
12388,3,1,43556,43559,43560,3,4,0
12389,1,2,43557,43560,43562,3,5,0
12390,4,2,43561,43562,43564,1,3,0
12391,5,1,43566,43566,43567,0,1,2
12392,4,2,43570,43570,43572,0,2,3
12393,1,2,43571,43572,43574,1,3,0
12394,4,3,43575,43575,43578,0,3,1
12395,1,3,43576,43578,43581,2,5,0
12396,1,3,43577,43581,43584,4,7,0
12397,6,3,43583,43584,43587,1,4,0
12398,2,2,43585,43587,43589,2,4,0
12399,3,3,43588,43589,43592,1,4,0
12400,5,3,43593,43593,43596,0,3,1
12401,6,3,43599,43599,43602,0,3,3
12402,6,1,43605,43605,43606,0,1,3
12403,6,1,43611,43611,43612,0,1,5
12404,1,1,43612,43612,43613,0,1,0
12405,6,2,43618,43618,43620,0,2,5
12406,3,3,43621,43621,43624,0,3,1
12407,6,3,43627,43627,43630,0,3,3
12408,1,2,43628,43630,43632,2,4,0
12409,6,3,43634,43634,43637,0,3,2
12410,6,1,43640,43640,43641,0,1,3
12411,1,3,43641,43641,43644,0,3,0
12412,3,1,43644,43644,43645,0,1,0
12413,2,3,43646,43646,43649,0,3,1
12414,6,1,43652,43652,43653,0,1,3
12415,6,3,43658,43658,43661,0,3,5
12416,1,1,43659,43661,43662,2,3,0
12417,2,2,43661,43662,43664,1,3,0
12418,5,3,43666,43666,43669,0,3,2
12419,4,2,43670,43670,43672,0,2,1
12420,5,3,43675,43675,43678,0,3,3
12421,5,1,43680,43680,43681,0,1,2
12422,6,1,43686,43686,43687,0,1,5
12423,6,3,43692,43692,43695,0,3,5
12424,1,2,43693,43695,43697,2,4,0
12425,4,1,43697,43697,43698,0,1,0
12426,6,2,43703,43703,43705,0,2,5
12427,4,2,43707,43707,43709,0,2,2
12428,3,1,43710,43710,43711,0,1,1
12429,6,1,43716,43716,43717,0,1,5
12430,4,1,43720,43720,43721,0,1,3
12431,4,2,43724,43724,43726,0,2,3
12432,3,3,43727,43727,43730,0,3,1
12433,4,2,43731,43731,43733,0,2,1
12434,4,3,43735,43735,43738,0,3,2
12435,4,2,43739,43739,43741,0,2,1
12436,4,2,43743,43743,43745,0,2,2
12437,2,2,43745,43745,43747,0,2,0
12438,4,1,43749,43749,43750,0,1,2
12439,2,1,43751,43751,43752,0,1,1
12440,4,1,43755,43755,43756,0,1,3
12441,5,2,43760,43760,43762,0,2,4
12442,5,1,43765,43765,43766,0,1,3
12443,1,1,43766,43766,43767,0,1,0
12444,1,2,43767,43767,43769,0,2,0
12445,1,2,43768,43769,43771,1,3,0
12446,4,2,43772,43772,43774,0,2,1
12447,2,2,43774,43774,43776,0,2,0
12448,3,1,43777,43777,43778,0,1,1
12449,3,3,43780,43780,43783,0,3,2
12450,3,2,43783,43783,43785,0,2,0
12451,3,2,43786,43786,43788,0,2,1
12452,5,3,43791,43791,43794,0,3,3
12453,2,3,43793,43794,43797,1,4,0
12454,6,3,43799,43799,43802,0,3,2
12455,2,1,43801,43802,43803,1,2,0
12456,5,2,43806,43806,43808,0,2,3
12457,4,3,43810,43810,43813,0,3,2
12458,4,3,43814,43814,43817,0,3,1
12459,4,1,43818,43818,43819,0,1,1
12460,5,3,43823,43823,43826,0,3,4
12461,1,1,43824,43826,43827,2,3,0
12462,4,1,43828,43828,43829,0,1,1
12463,1,3,43829,43829,43832,0,3,0
12464,4,1,43833,43833,43834,0,1,1
12465,4,1,43837,43837,43838,0,1,3
12466,6,1,43843,43843,43844,0,1,5
12467,3,1,43846,43846,43847,0,1,2
12468,4,3,43850,43850,43853,0,3,3
12469,3,3,43853,43853,43856,0,3,0
12470,6,3,43859,43859,43862,0,3,3
12471,1,1,43860,43862,43863,2,3,0
12472,6,1,43866,43866,43867,0,1,3
12473,2,3,43868,43868,43871,0,3,1
12474,5,2,43873,43873,43875,0,2,2
12475,5,2,43878,43878,43880,0,2,3
12476,1,1,43879,43880,43881,1,2,0
12477,2,3,43881,43881,43884,0,3,0
12478,5,3,43886,43886,43889,0,3,2
12479,3,3,43889,43889,43892,0,3,0
12480,1,1,43890,43892,43893,2,3,0
12481,1,2,43891,43893,43895,2,4,0
12482,5,1,43896,43896,43897,0,1,1
12483,1,1,43897,43897,43898,0,1,0
12484,5,3,43902,43902,43905,0,3,4
12485,1,1,43903,43905,43906,2,3,0
12486,5,1,43908,43908,43909,0,1,2
12487,3,2,43911,43911,43913,0,2,2
12488,3,3,43914,43914,43917,0,3,1
12489,5,2,43919,43919,43921,0,2,2
12490,3,3,43922,43922,43925,0,3,1
12491,5,1,43927,43927,43928,0,1,2
12492,4,1,43931,43931,43932,0,1,3
12493,1,2,43932,43932,43934,0,2,0
12494,4,1,43936,43936,43937,0,1,2
12495,2,1,43938,43938,43939,0,1,1
12496,2,2,43940,43940,43942,0,2,1
12497,6,3,43946,43946,43949,0,3,4
12498,3,3,43949,43949,43952,0,3,0
12499,4,2,43953,43953,43955,0,2,1
12500,3,2,43956,43956,43958,0,2,1
12501,3,2,43959,43959,43961,0,2,1
12502,5,2,43964,43964,43966,0,2,3
12503,4,1,43968,43968,43969,0,1,2
12504,1,1,43969,43969,43970,0,1,0
12505,5,1,43974,43974,43975,0,1,4
12506,1,3,43975,43975,43978,0,3,0
12507,2,2,43977,43978,43980,1,3,0
12508,5,1,43982,43982,43983,0,1,2
12509,4,3,43986,43986,43989,0,3,3
12510,3,2,43989,43989,43991,0,2,0
12511,3,1,43992,43992,43993,0,1,1
12512,4,2,43996,43996,43998,0,2,3
12513,4,3,44000,44000,44003,0,3,2
12514,4,1,44004,44004,44005,0,1,1
12515,1,1,44005,44005,44006,0,1,0
12516,2,2,44007,44007,44009,0,2,1
12517,2,2,44009,44009,44011,0,2,0
12518,5,3,44014,44014,44017,0,3,3
12519,1,2,44015,44017,44019,2,4,0
12520,1,3,44016,44019,44022,3,6,0
12521,2,2,44018,44022,44024,4,6,0
12522,6,3,44024,44024,44027,0,3,0
12523,5,3,44029,44029,44032,0,3,2
12524,2,2,44031,44032,44034,1,3,0
12525,6,1,44037,44037,44038,0,1,3
12526,1,1,44038,44038,44039,0,1,0
12527,3,2,44041,44041,44043,0,2,2
12528,2,1,44043,44043,44044,0,1,0
12529,3,1,44046,44046,44047,0,1,2
12530,5,2,44051,44051,44053,0,2,4
12531,2,3,44053,44053,44056,0,3,0
12532,4,2,44057,44057,44059,0,2,1
12533,6,3,44063,44063,44066,0,3,4
12534,3,2,44066,44066,44068,0,2,0
12535,3,2,44069,44069,44071,0,2,1
12536,4,3,44073,44073,44076,0,3,2
12537,5,2,44078,44078,44080,0,2,2
12538,3,3,44081,44081,44084,0,3,1
12539,3,3,44084,44084,44087,0,3,0
12540,1,2,44085,44087,44089,2,4,0
12541,5,3,44090,44090,44093,0,3,1
12542,1,3,44091,44093,44096,2,5,0
12543,2,1,44093,44096,44097,3,4,0
12544,3,3,44096,44097,44100,1,4,0
12545,3,3,44099,44100,44103,1,4,0
12546,3,3,44102,44103,44106,1,4,0
12547,6,1,44108,44108,44109,0,1,2
12548,3,2,44111,44111,44113,0,2,2
12549,6,2,44117,44117,44119,0,2,4
12550,3,3,44120,44120,44123,0,3,1
12551,6,3,44126,44126,44129,0,3,3
12552,5,1,44131,44131,44132,0,1,2
12553,3,2,44134,44134,44136,0,2,2
12554,2,1,44136,44136,44137,0,1,0
12555,1,2,44137,44137,44139,0,2,0
12556,6,1,44143,44143,44144,0,1,4
12557,5,3,44148,44148,44151,0,3,4
12558,5,2,44153,44153,44155,0,2,2
12559,5,1,44158,44158,44159,0,1,3
12560,1,2,44159,44159,44161,0,2,0
12561,3,2,44162,44162,44164,0,2,1
12562,1,2,44163,44164,44166,1,3,0
12563,2,3,44165,44166,44169,1,4,0
12564,2,3,44167,44169,44172,2,5,0
12565,3,2,44170,44172,44174,2,4,0
12566,5,1,44175,44175,44176,0,1,1
12567,4,3,44179,44179,44182,0,3,3
12568,3,1,44182,44182,44183,0,1,0
12569,1,2,44183,44183,44185,0,2,0
12570,6,3,44189,44189,44192,0,3,4
12571,5,1,44194,44194,44195,0,1,2
12572,5,3,44199,44199,44202,0,3,4
12573,3,2,44202,44202,44204,0,2,0
12574,4,3,44206,44206,44209,0,3,2
12575,6,1,44212,44212,44213,0,1,3
12576,4,2,44216,44216,44218,0,2,3
12577,3,1,44219,44219,44220,0,1,1
12578,1,2,44220,44220,44222,0,2,0
12579,1,2,44221,44222,44224,1,3,0
12580,4,3,44225,44225,44228,0,3,1
12581,6,3,44231,44231,44234,0,3,3
12582,4,2,44235,44235,44237,0,2,1
12583,3,3,44238,44238,44241,0,3,1
12584,6,3,44244,44244,44247,0,3,3
12585,1,3,44245,44247,44250,2,5,0
12586,3,3,44248,44250,44253,2,5,0
12587,2,2,44250,44253,44255,3,5,0
12588,3,1,44253,44255,44256,2,3,0
12589,4,3,44257,44257,44260,0,3,1
12590,6,3,44263,44263,44266,0,3,3
12591,6,1,44269,44269,44270,0,1,3
12592,1,3,44270,44270,44273,0,3,0
12593,4,3,44274,44274,44277,0,3,1
12594,5,2,44279,44279,44281,0,2,2
12595,2,1,44281,44281,44282,0,1,0
12596,5,1,44286,44286,44287,0,1,4
12597,1,3,44287,44287,44290,0,3,0
12598,2,1,44289,44290,44291,1,2,0
12599,5,2,44294,44294,44296,0,2,3
12600,5,1,44299,44299,44300,0,1,3
12601,1,3,44300,44300,44303,0,3,0
12602,3,3,44303,44303,44306,0,3,0
12603,6,2,44309,44309,44311,0,2,3
12604,6,2,44315,44315,44317,0,2,4
12605,1,2,44316,44317,44319,1,3,0
12606,6,2,44322,44322,44324,0,2,3
12607,5,3,44327,44327,44330,0,3,3
12608,2,1,44329,44330,44331,1,2,0
12609,5,3,44334,44334,44337,0,3,3
12610,3,1,44337,44337,44338,0,1,0
12611,4,1,44341,44341,44342,0,1,3
12612,2,2,44343,44343,44345,0,2,1
12613,2,1,44345,44345,44346,0,1,0
12614,3,2,44348,44348,44350,0,2,2
12615,3,1,44351,44351,44352,0,1,1
12616,6,3,44357,44357,44360,0,3,5
12617,3,1,44360,44360,44361,0,1,0
12618,6,3,44366,44366,44369,0,3,5
12619,1,2,44367,44369,44371,2,4,0
12620,3,1,44370,44371,44372,1,2,0
12621,5,3,44375,44375,44378,0,3,3
12622,6,2,44381,44381,44383,0,2,3
12623,1,3,44382,44383,44386,1,4,0
12624,2,1,44384,44386,44387,2,3,0
12625,5,3,44389,44389,44392,0,3,2
12626,5,1,44394,44394,44395,0,1,2
12627,1,3,44395,44395,44398,0,3,0
12628,2,2,44397,44398,44400,1,3,0
12629,4,3,44401,44401,44404,0,3,1
12630,5,1,44406,44406,44407,0,1,2
12631,6,3,44412,44412,44415,0,3,5
12632,5,2,44417,44417,44419,0,2,2
12633,6,2,44423,44423,44425,0,2,4
12634,3,2,44426,44426,44428,0,2,1
12635,4,2,44430,44430,44432,0,2,2
12636,1,2,44431,44432,44434,1,3,0
12637,5,1,44436,44436,44437,0,1,2
12638,6,1,44442,44442,44443,0,1,5
12639,1,2,44443,44443,44445,0,2,0
12640,3,1,44446,44446,44447,0,1,1
12641,6,1,44452,44452,44453,0,1,5
12642,3,1,44455,44455,44456,0,1,2
12643,1,2,44456,44456,44458,0,2,0
12644,6,1,44462,44462,44463,0,1,4
12645,5,1,44467,44467,44468,0,1,4
12646,2,3,44469,44469,44472,0,3,1
12647,4,1,44473,44473,44474,0,1,1
12648,3,1,44476,44476,44477,0,1,2
12649,5,2,44481,44481,44483,0,2,4
12650,3,2,44484,44484,44486,0,2,1
12651,4,1,44488,44488,44489,0,1,2
12652,6,2,44494,44494,44496,0,2,5
12653,2,3,44496,44496,44499,0,3,0
12654,1,2,44497,44499,44501,2,4,0
12655,1,1,44498,44501,44502,3,4,0
12656,3,3,44501,44502,44505,1,4,0
12657,5,3,44506,44506,44509,0,3,1
12658,6,2,44512,44512,44514,0,2,3
12659,5,2,44517,44517,44519,0,2,3
12660,3,1,44520,44520,44521,0,1,1
12661,1,1,44521,44521,44522,0,1,0
12662,6,2,44527,44527,44529,0,2,5
12663,2,3,44529,44529,44532,0,3,0
12664,3,1,44532,44532,44533,0,1,0
12665,4,3,44536,44536,44539,0,3,3
12666,6,3,44542,44542,44545,0,3,3
12667,2,3,44544,44545,44548,1,4,0
12668,3,3,44547,44548,44551,1,4,0
12669,1,2,44548,44551,44553,3,5,0
12670,2,1,44550,44553,44554,3,4,0
12671,5,3,44555,44555,44558,0,3,1
12672,3,3,44558,44558,44561,0,3,0
12673,1,2,44559,44561,44563,2,4,0
12674,3,2,44562,44563,44565,1,3,0
12675,5,2,44567,44567,44569,0,2,2
12676,3,2,44570,44570,44572,0,2,1
12677,3,1,44573,44573,44574,0,1,1
12678,3,2,44576,44576,44578,0,2,2
12679,4,2,44580,44580,44582,0,2,2
12680,6,3,44586,44586,44589,0,3,4
12681,4,3,44590,44590,44593,0,3,1
12682,4,1,44594,44594,44595,0,1,1
12683,6,1,44600,44600,44601,0,1,5
12684,5,3,44605,44605,44608,0,3,4
12685,1,1,44606,44608,44609,2,3,0
12686,1,3,44607,44609,44612,2,5,0
12687,1,3,44608,44612,44615,4,7,0
12688,4,3,44612,44615,44618,3,6,0
12689,3,3,44615,44618,44621,3,6,0
12690,6,3,44621,44621,44624,0,3,0
12691,4,2,44625,44625,44627,0,2,1
12692,4,2,44629,44629,44631,0,2,2
12693,6,2,44635,44635,44637,0,2,4
12694,4,2,44639,44639,44641,0,2,2
12695,2,3,44641,44641,44644,0,3,0
12696,2,3,44643,44644,44647,1,4,0
12697,3,2,44646,44647,44649,1,3,0
12698,6,3,44652,44652,44655,0,3,3
12699,1,3,44653,44655,44658,2,5,0
12700,3,3,44656,44658,44661,2,5,0
12701,6,1,44662,44662,44663,0,1,1
12702,3,1,44665,44665,44666,0,1,2
12703,5,1,44670,44670,44671,0,1,4
12704,1,3,44671,44671,44674,0,3,0
12705,4,1,44675,44675,44676,0,1,1
12706,6,3,44681,44681,44684,0,3,5
12707,3,2,44684,44684,44686,0,2,0
12708,6,3,44690,44690,44693,0,3,4
12709,5,1,44695,44695,44696,0,1,2
12710,1,2,44696,44696,44698,0,2,0
12711,1,3,44697,44698,44701,1,4,0
12712,4,2,44701,44701,44703,0,2,0
12713,1,2,44702,44703,44705,1,3,0
12714,1,1,44703,44705,44706,2,3,0
12715,1,2,44704,44706,44708,2,4,0
12716,4,2,44708,44708,44710,0,2,0
12717,1,3,44709,44710,44713,1,4,0
12718,2,3,44711,44713,44716,2,5,0
12719,6,1,44717,44717,44718,0,1,1
12720,2,3,44719,44719,44722,0,3,1
12721,4,1,44723,44723,44724,0,1,1
12722,3,2,44726,44726,44728,0,2,2
12723,1,3,44727,44728,44731,1,4,0
12724,3,2,44730,44731,44733,1,3,0
12725,4,3,44734,44734,44737,0,3,1
12726,6,3,44740,44740,44743,0,3,3
12727,4,2,44744,44744,44746,0,2,1
12728,6,3,44750,44750,44753,0,3,4
12729,5,1,44755,44755,44756,0,1,2
12730,1,3,44756,44756,44759,0,3,0
12731,2,3,44758,44759,44762,1,4,0
12732,1,2,44759,44762,44764,3,5,0
12733,3,1,44762,44764,44765,2,3,0
12734,2,3,44764,44765,44768,1,4,0
12735,5,1,44769,44769,44770,0,1,1
12736,5,3,44774,44774,44777,0,3,4
12737,6,3,44780,44780,44783,0,3,3
12738,2,1,44782,44783,44784,1,2,0
12739,2,2,44784,44784,44786,0,2,0
12740,2,3,44786,44786,44789,0,3,0
12741,6,3,44792,44792,44795,0,3,3
12742,6,3,44798,44798,44801,0,3,3
12743,6,3,44804,44804,44807,0,3,3
12744,1,2,44805,44807,44809,2,4,0
12745,1,2,44806,44809,44811,3,5,0
12746,2,1,44808,44811,44812,3,4,0
12747,4,3,44812,44812,44815,0,3,0
12748,4,2,44816,44816,44818,0,2,1
12749,3,3,44819,44819,44822,0,3,1
12750,1,1,44820,44822,44823,2,3,0
12751,3,2,44823,44823,44825,0,2,0
12752,6,3,44829,44829,44832,0,3,4
12753,4,2,44833,44833,44835,0,2,1
12754,4,1,44837,44837,44838,0,1,2
12755,6,3,44843,44843,44846,0,3,5
12756,1,1,44844,44846,44847,2,3,0
12757,2,3,44846,44847,44850,1,4,0
12758,6,3,44852,44852,44855,0,3,2
12759,2,3,44854,44855,44858,1,4,0
12760,3,1,44857,44858,44859,1,2,0
12761,3,3,44860,44860,44863,0,3,1
12762,2,3,44862,44863,44866,1,4,0
12763,6,2,44868,44868,44870,0,2,2
12764,5,3,44873,44873,44876,0,3,3
12765,6,3,44879,44879,44882,0,3,3
12766,4,2,44883,44883,44885,0,2,1
12767,4,2,44887,44887,44889,0,2,2
12768,6,3,44893,44893,44896,0,3,4
12769,4,1,44897,44897,44898,0,1,1
12770,1,1,44898,44898,44899,0,1,0
12771,3,2,44901,44901,44903,0,2,2
12772,3,1,44904,44904,44905,0,1,1
12773,5,1,44909,44909,44910,0,1,4
12774,2,2,44911,44911,44913,0,2,1
12775,4,2,44915,44915,44917,0,2,2
12776,2,1,44917,44917,44918,0,1,0
12777,5,2,44922,44922,44924,0,2,4
12778,6,1,44928,44928,44929,0,1,4
12779,1,1,44929,44929,44930,0,1,0
12780,3,2,44932,44932,44934,0,2,2
12781,2,1,44934,44934,44935,0,1,0
12782,3,1,44937,44937,44938,0,1,2
12783,1,2,44938,44938,44940,0,2,0
12784,2,2,44940,44940,44942,0,2,0
12785,3,3,44943,44943,44946,0,3,1
12786,1,3,44944,44946,44949,2,5,0
12787,3,3,44947,44949,44952,2,5,0
12788,6,2,44953,44953,44955,0,2,1
12789,6,2,44959,44959,44961,0,2,4
12790,5,1,44964,44964,44965,0,1,3
12791,6,3,44970,44970,44973,0,3,5
12792,1,1,44971,44973,44974,2,3,0
12793,5,2,44976,44976,44978,0,2,2
12794,1,3,44977,44978,44981,1,4,0
12795,4,1,44981,44981,44982,0,1,0
12796,2,1,44983,44983,44984,0,1,1
12797,1,1,44984,44984,44985,0,1,0
12798,3,2,44987,44987,44989,0,2,2
12799,2,2,44989,44989,44991,0,2,0
12800,3,2,44992,44992,44994,0,2,1
12801,2,1,44994,44994,44995,0,1,0
12802,5,1,44999,44999,45000,0,1,4
12803,1,3,45000,45000,45003,0,3,0
12804,1,3,45001,45003,45006,2,5,0
12805,3,2,45004,45006,45008,2,4,0
12806,3,1,45007,45008,45009,1,2,0
12807,2,3,45009,45009,45012,0,3,0
12808,4,2,45013,45013,45015,0,2,1
12809,1,3,45014,45015,45018,1,4,0
12810,3,2,45017,45018,45020,1,3,0
12811,4,3,45021,45021,45024,0,3,1
12812,4,2,45025,45025,45027,0,2,1
12813,6,1,45031,45031,45032,0,1,4
12814,3,3,45034,45034,45037,0,3,2
12815,3,2,45037,45037,45039,0,2,0
12816,5,1,45042,45042,45043,0,1,3
12817,3,2,45045,45045,45047,0,2,2
12818,2,2,45047,45047,45049,0,2,0
12819,4,3,45051,45051,45054,0,3,2
12820,3,1,45054,45054,45055,0,1,0
12821,1,3,45055,45055,45058,0,3,0
12822,4,2,45059,45059,45061,0,2,1
12823,4,3,45063,45063,45066,0,3,2
12824,4,1,45067,45067,45068,0,1,1
12825,3,2,45070,45070,45072,0,2,2
12826,6,1,45076,45076,45077,0,1,4
12827,4,1,45080,45080,45081,0,1,3
12828,3,1,45083,45083,45084,0,1,2
12829,1,1,45084,45084,45085,0,1,0
12830,2,2,45086,45086,45088,0,2,1
12831,5,3,45091,45091,45094,0,3,3
12832,1,3,45092,45094,45097,2,5,0
12833,5,2,45097,45097,45099,0,2,0
12834,6,2,45103,45103,45105,0,2,4
12835,6,2,45109,45109,45111,0,2,4
12836,2,1,45111,45111,45112,0,1,0
12837,4,2,45115,45115,45117,0,2,3
12838,6,3,45121,45121,45124,0,3,4
12839,4,2,45125,45125,45127,0,2,1
12840,6,1,45131,45131,45132,0,1,4
12841,6,1,45137,45137,45138,0,1,5
12842,1,2,45138,45138,45140,0,2,0
12843,3,2,45141,45141,45143,0,2,1
12844,2,3,45143,45143,45146,0,3,0
12845,4,1,45147,45147,45148,0,1,1
12846,3,1,45150,45150,45151,0,1,2
12847,3,1,45153,45153,45154,0,1,2
12848,4,2,45157,45157,45159,0,2,3
12849,5,2,45162,45162,45164,0,2,3
12850,5,3,45167,45167,45170,0,3,3
12851,5,3,45172,45172,45175,0,3,2
12852,3,3,45175,45175,45178,0,3,0
12853,5,3,45180,45180,45183,0,3,2
12854,1,2,45181,45183,45185,2,4,0
12855,3,3,45184,45185,45188,1,4,0
12856,3,2,45187,45188,45190,1,3,0
12857,4,2,45191,45191,45193,0,2,1
12858,3,2,45194,45194,45196,0,2,1
12859,1,1,45195,45196,45197,1,2,0
12860,1,2,45196,45197,45199,1,3,0
12861,5,3,45201,45201,45204,0,3,2
12862,6,2,45207,45207,45209,0,2,3
12863,4,2,45211,45211,45213,0,2,2
12864,3,3,45214,45214,45217,0,3,1
12865,6,2,45220,45220,45222,0,2,3
12866,1,3,45221,45222,45225,1,4,0
12867,3,2,45224,45225,45227,1,3,0
12868,6,2,45230,45230,45232,0,2,3
12869,5,2,45235,45235,45237,0,2,3
12870,2,2,45237,45237,45239,0,2,0
12871,4,1,45241,45241,45242,0,1,2
12872,6,3,45247,45247,45250,0,3,5
12873,2,1,45249,45250,45251,1,2,0
12874,5,1,45254,45254,45255,0,1,3
12875,6,2,45260,45260,45262,0,2,5
12876,2,1,45262,45262,45263,0,1,0
12877,4,2,45266,45266,45268,0,2,3
12878,3,1,45269,45269,45270,0,1,1
12879,4,1,45273,45273,45274,0,1,3
12880,6,3,45279,45279,45282,0,3,5
12881,3,3,45282,45282,45285,0,3,0
12882,4,1,45286,45286,45287,0,1,1
12883,3,3,45289,45289,45292,0,3,2
12884,5,2,45294,45294,45296,0,2,2
12885,1,2,45295,45296,45298,1,3,0
12886,4,2,45299,45299,45301,0,2,1
12887,3,1,45302,45302,45303,0,1,1
12888,1,1,45303,45303,45304,0,1,0
12889,6,1,45309,45309,45310,0,1,5
12890,5,2,45314,45314,45316,0,2,4
12891,2,1,45316,45316,45317,0,1,0
12892,2,2,45318,45318,45320,0,2,1
12893,5,1,45323,45323,45324,0,1,3
12894,2,2,45325,45325,45327,0,2,1
12895,1,2,45326,45327,45329,1,3,0
12896,6,2,45332,45332,45334,0,2,3
12897,3,2,45335,45335,45337,0,2,1
12898,2,2,45337,45337,45339,0,2,0
12899,1,3,45338,45339,45342,1,4,0
12900,2,2,45340,45342,45344,2,4,0
12901,5,1,45345,45345,45346,0,1,1
12902,5,1,45350,45350,45351,0,1,4
12903,4,1,45354,45354,45355,0,1,3
12904,2,3,45356,45356,45359,0,3,1
12905,4,3,45360,45360,45363,0,3,1
12906,4,3,45364,45364,45367,0,3,1
12907,5,1,45369,45369,45370,0,1,2
12908,5,2,45374,45374,45376,0,2,4
12909,4,3,45378,45378,45381,0,3,2
12910,2,3,45380,45381,45384,1,4,0
12911,6,2,45386,45386,45388,0,2,2
12912,1,2,45387,45388,45390,1,3,0
12913,3,2,45390,45390,45392,0,2,0
12914,4,3,45394,45394,45397,0,3,2
12915,2,3,45396,45397,45400,1,4,0
12916,5,1,45401,45401,45402,0,1,1
12917,6,1,45407,45407,45408,0,1,5
12918,5,3,45412,45412,45415,0,3,4
12919,5,1,45417,45417,45418,0,1,2
12920,5,3,45422,45422,45425,0,3,4
12921,4,1,45426,45426,45427,0,1,1
12922,3,1,45429,45429,45430,0,1,2
12923,4,2,45433,45433,45435,0,2,3
12924,2,1,45435,45435,45436,0,1,0
12925,6,1,45441,45441,45442,0,1,5
12926,6,3,45447,45447,45450,0,3,5
12927,6,1,45453,45453,45454,0,1,3
12928,2,3,45455,45455,45458,0,3,1
12929,3,1,45458,45458,45459,0,1,0
12930,4,3,45462,45462,45465,0,3,3
12931,6,3,45468,45468,45471,0,3,3
12932,6,1,45474,45474,45475,0,1,3
12933,5,2,45479,45479,45481,0,2,4
12934,2,1,45481,45481,45482,0,1,0
12935,2,2,45483,45483,45485,0,2,1
12936,4,1,45487,45487,45488,0,1,2
12937,2,2,45489,45489,45491,0,2,1
12938,5,3,45494,45494,45497,0,3,3
12939,4,3,45498,45498,45501,0,3,1
12940,2,3,45500,45501,45504,1,4,0
12941,2,3,45502,45504,45507,2,5,0
12942,4,1,45506,45507,45508,1,2,0
12943,4,3,45510,45510,45513,0,3,2
12944,5,3,45515,45515,45518,0,3,2
12945,2,1,45517,45518,45519,1,2,0
12946,5,3,45522,45522,45525,0,3,3
12947,1,1,45523,45525,45526,2,3,0
12948,2,2,45525,45526,45528,1,3,0
12949,6,3,45531,45531,45534,0,3,3
12950,6,2,45537,45537,45539,0,2,3
12951,1,3,45538,45539,45542,1,4,0
12952,6,3,45544,45544,45547,0,3,2
12953,4,1,45548,45548,45549,0,1,1
12954,6,2,45554,45554,45556,0,2,5
12955,6,3,45560,45560,45563,0,3,4
12956,2,1,45562,45563,45564,1,2,0
12957,2,3,45564,45564,45567,0,3,0
12958,2,2,45566,45567,45569,1,3,0
12959,1,3,45567,45569,45572,2,5,0
12960,5,2,45572,45572,45574,0,2,0
12961,4,1,45576,45576,45577,0,1,2
12962,5,1,45581,45581,45582,0,1,4
12963,4,3,45585,45585,45588,0,3,3
12964,1,1,45586,45588,45589,2,3,0
12965,5,1,45591,45591,45592,0,1,2
12966,3,1,45594,45594,45595,0,1,2
12967,1,2,45595,45595,45597,0,2,0
12968,3,3,45598,45598,45601,0,3,1
12969,3,1,45601,45601,45602,0,1,0
12970,5,2,45606,45606,45608,0,2,4
12971,4,2,45610,45610,45612,0,2,2
12972,2,1,45612,45612,45613,0,1,0
12973,3,3,45615,45615,45618,0,3,2
12974,4,1,45619,45619,45620,0,1,1
12975,2,2,45621,45621,45623,0,2,1
12976,5,3,45626,45626,45629,0,3,3
12977,6,3,45632,45632,45635,0,3,3
12978,4,2,45636,45636,45638,0,2,1
12979,4,3,45640,45640,45643,0,3,2
12980,2,3,45642,45643,45646,1,4,0
12981,3,3,45645,45646,45649,1,4,0
12982,3,2,45648,45649,45651,1,3,0
12983,4,1,45652,45652,45653,0,1,1
12984,2,2,45654,45654,45656,0,2,1
12985,3,3,45657,45657,45660,0,3,1
12986,2,3,45659,45660,45663,1,4,0
12987,1,2,45660,45663,45665,3,5,0
12988,1,1,45661,45665,45666,4,5,0
12989,1,3,45662,45666,45669,4,7,0
12990,5,3,45667,45669,45672,2,5,0
12991,2,1,45669,45672,45673,3,4,0
12992,5,1,45674,45674,45675,0,1,1
12993,1,3,45675,45675,45678,0,3,0
12994,1,3,45676,45678,45681,2,5,0
12995,4,3,45680,45681,45684,1,4,0
12996,6,1,45686,45686,45687,0,1,2
12997,4,1,45690,45690,45691,0,1,3
12998,1,3,45691,45691,45694,0,3,0
12999,6,2,45697,45697,45699,0,2,3
13000,5,1,45702,45702,45703,0,1,3
13001,5,3,45707,45707,45710,0,3,4
13002,5,1,45712,45712,45713,0,1,2
13003,5,3,45717,45717,45720,0,3,4
13004,1,3,45718,45720,45723,2,5,0
13005,1,1,45719,45723,45724,4,5,0
13006,6,2,45725,45725,45727,0,2,1
13007,3,1,45728,45728,45729,0,1,1
13008,1,3,45729,45729,45732,0,3,0
13009,2,2,45731,45732,45734,1,3,0
13010,5,2,45736,45736,45738,0,2,2
13011,5,1,45741,45741,45742,0,1,3
13012,4,1,45745,45745,45746,0,1,3
13013,1,1,45746,45746,45747,0,1,0
13014,4,2,45750,45750,45752,0,2,3
13015,5,2,45755,45755,45757,0,2,3
13016,4,3,45759,45759,45762,0,3,2
13017,5,1,45764,45764,45765,0,1,2
13018,2,3,45766,45766,45769,0,3,1
13019,5,2,45771,45771,45773,0,2,2
13020,2,1,45773,45773,45774,0,1,0
13021,6,2,45779,45779,45781,0,2,5
13022,5,3,45784,45784,45787,0,3,3
13023,2,1,45786,45787,45788,1,2,0
13024,5,2,45791,45791,45793,0,2,3
13025,6,1,45797,45797,45798,0,1,4
13026,3,1,45800,45800,45801,0,1,2
13027,1,2,45801,45801,45803,0,2,0
13028,2,1,45803,45803,45804,0,1,0
13029,5,2,45808,45808,45810,0,2,4
13030,1,3,45809,45810,45813,1,4,0
13031,1,2,45810,45813,45815,3,5,0
13032,5,1,45815,45815,45816,0,1,0
13033,2,2,45817,45817,45819,0,2,1
13034,5,1,45822,45822,45823,0,1,3
13035,1,1,45823,45823,45824,0,1,0
13036,3,2,45826,45826,45828,0,2,2
13037,1,3,45827,45828,45831,1,4,0
13038,4,3,45831,45831,45834,0,3,0
13039,2,3,45833,45834,45837,1,4,0
13040,5,3,45838,45838,45841,0,3,1
13041,2,2,45840,45841,45843,1,3,0
13042,1,2,45841,45843,45845,2,4,0
13043,4,1,45845,45845,45846,0,1,0
13044,6,3,45851,45851,45854,0,3,5
13045,5,2,45856,45856,45858,0,2,2
13046,6,3,45862,45862,45865,0,3,4
13047,4,3,45866,45866,45869,0,3,1
13048,3,3,45869,45869,45872,0,3,0
13049,2,3,45871,45872,45875,1,4,0
13050,6,3,45877,45877,45880,0,3,2
13051,5,3,45882,45882,45885,0,3,2
13052,6,3,45888,45888,45891,0,3,3
13053,4,2,45892,45892,45894,0,2,1
13054,2,1,45894,45894,45895,0,1,0
13055,6,1,45900,45900,45901,0,1,5
13056,3,3,45903,45903,45906,0,3,2
13057,3,1,45906,45906,45907,0,1,0
13058,3,2,45909,45909,45911,0,2,2
13059,2,1,45911,45911,45912,0,1,0
13060,6,3,45917,45917,45920,0,3,5
13061,4,2,45921,45921,45923,0,2,1
13062,5,1,45926,45926,45927,0,1,3
13063,1,3,45927,45927,45930,0,3,0
13064,5,2,45932,45932,45934,0,2,2
13065,1,2,45933,45934,45936,1,3,0
13066,6,3,45939,45939,45942,0,3,3
13067,6,2,45945,45945,45947,0,2,3
13068,5,2,45950,45950,45952,0,2,3
13069,5,2,45955,45955,45957,0,2,3
13070,5,1,45960,45960,45961,0,1,3
13071,3,1,45963,45963,45964,0,1,2
13072,1,2,45964,45964,45966,0,2,0
13073,3,1,45967,45967,45968,0,1,1
13074,5,1,45972,45972,45973,0,1,4
13075,2,1,45974,45974,45975,0,1,1
13076,2,3,45976,45976,45979,0,3,1
13077,3,1,45979,45979,45980,0,1,0
13078,1,2,45980,45980,45982,0,2,0
13079,3,1,45983,45983,45984,0,1,1
13080,5,2,45988,45988,45990,0,2,4
13081,6,2,45994,45994,45996,0,2,4
13082,2,2,45996,45996,45998,0,2,0
13083,2,3,45998,45998,46001,0,3,0
13084,4,1,46002,46002,46003,0,1,1
13085,6,1,46008,46008,46009,0,1,5
13086,5,1,46013,46013,46014,0,1,4
13087,5,3,46018,46018,46021,0,3,4
13088,5,2,46023,46023,46025,0,2,2
13089,3,1,46026,46026,46027,0,1,1
13090,3,2,46029,46029,46031,0,2,2
13091,4,2,46033,46033,46035,0,2,2
13092,2,3,46035,46035,46038,0,3,0
13093,6,1,46041,46041,46042,0,1,3
13094,5,2,46046,46046,46048,0,2,4
13095,4,3,46050,46050,46053,0,3,2
13096,5,3,46055,46055,46058,0,3,2
13097,6,1,46061,46061,46062,0,1,3
13098,1,2,46062,46062,46064,0,2,0
13099,5,1,46067,46067,46068,0,1,3
13100,2,2,46069,46069,46071,0,2,1
13101,2,1,46071,46071,46072,0,1,0
13102,2,2,46073,46073,46075,0,2,1
13103,4,1,46077,46077,46078,0,1,2
13104,2,3,46079,46079,46082,0,3,1
13105,3,1,46082,46082,46083,0,1,0
13106,1,2,46083,46083,46085,0,2,0
13107,1,3,46084,46085,46088,1,4,0
13108,6,2,46090,46090,46092,0,2,2
13109,1,2,46091,46092,46094,1,3,0
13110,3,1,46094,46094,46095,0,1,0
13111,2,1,46096,46096,46097,0,1,1
13112,3,1,46099,46099,46100,0,1,2
13113,1,2,46100,46100,46102,0,2,0
13114,2,1,46102,46102,46103,0,1,0
13115,5,3,46107,46107,46110,0,3,4
13116,6,3,46113,46113,46116,0,3,3
13117,1,2,46114,46116,46118,2,4,0
13118,6,2,46120,46120,46122,0,2,2
13119,2,3,46122,46122,46125,0,3,0
13120,5,1,46127,46127,46128,0,1,2
13121,1,1,46128,46128,46129,0,1,0
13122,6,3,46134,46134,46137,0,3,5
13123,4,2,46138,46138,46140,0,2,1
13124,5,3,46143,46143,46146,0,3,3
13125,4,1,46147,46147,46148,0,1,1
13126,3,3,46150,46150,46153,0,3,2
13127,5,2,46155,46155,46157,0,2,2
13128,5,1,46160,46160,46161,0,1,3
13129,1,1,46161,46161,46162,0,1,0
13130,1,3,46162,46162,46165,0,3,0
13131,5,3,46167,46167,46170,0,3,2
13132,6,1,46173,46173,46174,0,1,3
13133,1,1,46174,46174,46175,0,1,0
13134,4,2,46178,46178,46180,0,2,3
13135,5,3,46183,46183,46186,0,3,3
13136,3,3,46186,46186,46189,0,3,0
13137,6,3,46192,46192,46195,0,3,3
13138,4,3,46196,46196,46199,0,3,1
13139,3,2,46199,46199,46201,0,2,0
13140,6,1,46205,46205,46206,0,1,4
13141,1,2,46206,46206,46208,0,2,0
13142,2,1,46208,46208,46209,0,1,0
13143,6,1,46214,46214,46215,0,1,5
13144,2,3,46216,46216,46219,0,3,1
13145,1,2,46217,46219,46221,2,4,0
13146,1,1,46218,46221,46222,3,4,0
13147,4,1,46222,46222,46223,0,1,0
13148,1,2,46223,46223,46225,0,2,0
13149,1,2,46224,46225,46227,1,3,0
13150,5,1,46229,46229,46230,0,1,2
13151,5,1,46234,46234,46235,0,1,4
13152,4,3,46238,46238,46241,0,3,3
13153,5,3,46243,46243,46246,0,3,2
13154,6,3,46249,46249,46252,0,3,3
13155,5,1,46254,46254,46255,0,1,2
13156,4,1,46258,46258,46259,0,1,3
13157,3,3,46261,46261,46264,0,3,2
13158,5,1,46266,46266,46267,0,1,2
13159,5,2,46271,46271,46273,0,2,4
13160,4,1,46275,46275,46276,0,1,2
13161,2,1,46277,46277,46278,0,1,1
13162,6,1,46283,46283,46284,0,1,5
13163,1,2,46284,46284,46286,0,2,0
13164,1,1,46285,46286,46287,1,2,0
13165,2,2,46287,46287,46289,0,2,0
13166,3,1,46290,46290,46291,0,1,1
13167,2,2,46292,46292,46294,0,2,1
13168,3,1,46295,46295,46296,0,1,1
13169,4,3,46299,46299,46302,0,3,3
13170,4,1,46303,46303,46304,0,1,1
13171,3,3,46306,46306,46309,0,3,2
13172,3,2,46309,46309,46311,0,2,0
13173,3,2,46312,46312,46314,0,2,1
13174,4,1,46316,46316,46317,0,1,2
13175,2,2,46318,46318,46320,0,2,1
13176,6,2,46324,46324,46326,0,2,4
13177,5,3,46329,46329,46332,0,3,3
13178,6,1,46335,46335,46336,0,1,3
13179,1,2,46336,46336,46338,0,2,0
13180,3,1,46339,46339,46340,0,1,1
13181,3,2,46342,46342,46344,0,2,2
13182,5,1,46347,46347,46348,0,1,3
13183,3,2,46350,46350,46352,0,2,2
13184,1,2,46351,46352,46354,1,3,0
13185,5,3,46356,46356,46359,0,3,2
13186,2,2,46358,46359,46361,1,3,0
13187,1,2,46359,46361,46363,2,4,0
13188,4,3,46363,46363,46366,0,3,0
13189,4,3,46367,46367,46370,0,3,1
13190,2,2,46369,46370,46372,1,3,0
13191,2,1,46371,46372,46373,1,2,0
13192,3,3,46374,46374,46377,0,3,1
13193,1,1,46375,46377,46378,2,3,0
13194,3,3,46378,46378,46381,0,3,0
13195,1,2,46379,46381,46383,2,4,0
13196,2,3,46381,46383,46386,2,5,0
13197,5,3,46386,46386,46389,0,3,0
13198,3,3,46389,46389,46392,0,3,0
13199,2,2,46391,46392,46394,1,3,0
13200,6,3,46397,46397,46400,0,3,3
13201,3,1,46400,46400,46401,0,1,0
13202,5,2,46405,46405,46407,0,2,4
13203,4,2,46409,46409,46411,0,2,2
13204,2,3,46411,46411,46414,0,3,0
13205,5,3,46416,46416,46419,0,3,2
13206,6,2,46422,46422,46424,0,2,3
13207,1,1,46423,46424,46425,1,2,0
13208,5,2,46428,46428,46430,0,2,3
13209,2,3,46430,46430,46433,0,3,0
13210,5,2,46435,46435,46437,0,2,2
13211,1,1,46436,46437,46438,1,2,0
13212,5,2,46441,46441,46443,0,2,3
13213,2,2,46443,46443,46445,0,2,0
13214,4,1,46447,46447,46448,0,1,2
13215,4,3,46451,46451,46454,0,3,3
13216,1,3,46452,46454,46457,2,5,0
13217,1,1,46453,46457,46458,4,5,0
13218,3,2,46456,46458,46460,2,4,0
13219,1,1,46457,46460,46461,3,4,0
13220,1,1,46458,46461,46462,3,4,0
13221,5,2,46463,46463,46465,0,2,1
13222,4,2,46467,46467,46469,0,2,2
13223,1,1,46468,46469,46470,1,2,0
13224,3,1,46471,46471,46472,0,1,1
13225,2,3,46473,46473,46476,0,3,1
13226,5,1,46478,46478,46479,0,1,2
13227,5,3,46483,46483,46486,0,3,4
13228,2,3,46485,46486,46489,1,4,0
13229,6,1,46491,46491,46492,0,1,2
13230,5,3,46496,46496,46499,0,3,4
13231,6,2,46502,46502,46504,0,2,3
13232,2,1,46504,46504,46505,0,1,0
13233,2,1,46506,46506,46507,0,1,1
13234,3,2,46509,46509,46511,0,2,2
13235,2,3,46511,46511,46514,0,3,0
13236,1,3,46512,46514,46517,2,5,0
13237,3,3,46515,46517,46520,2,5,0
13238,6,1,46521,46521,46522,0,1,1
13239,5,3,46526,46526,46529,0,3,4
13240,3,1,46529,46529,46530,0,1,0
13241,4,2,46533,46533,46535,0,2,3
13242,2,1,46535,46535,46536,0,1,0
13243,4,1,46539,46539,46540,0,1,3
13244,3,2,46542,46542,46544,0,2,2
13245,1,3,46543,46544,46547,1,4,0
13246,1,2,46544,46547,46549,3,5,0
13247,6,1,46550,46550,46551,0,1,1
13248,1,3,46551,46551,46554,0,3,0
13249,3,2,46554,46554,46556,0,2,0
13250,3,3,46557,46557,46560,0,3,1
13251,3,1,46560,46560,46561,0,1,0
13252,2,2,46562,46562,46564,0,2,1
13253,4,1,46566,46566,46567,0,1,2
13254,2,2,46568,46568,46570,0,2,1
13255,4,3,46572,46572,46575,0,3,2
13256,3,2,46575,46575,46577,0,2,0
13257,2,2,46577,46577,46579,0,2,0
13258,1,3,46578,46579,46582,1,4,0
13259,5,3,46583,46583,46586,0,3,1
13260,2,3,46585,46586,46589,1,4,0
13261,5,3,46590,46590,46593,0,3,1
13262,4,3,46594,46594,46597,0,3,1
13263,5,1,46599,46599,46600,0,1,2
13264,4,2,46603,46603,46605,0,2,3
13265,4,2,46607,46607,46609,0,2,2
13266,1,3,46608,46609,46612,1,4,0
13267,1,2,46609,46612,46614,3,5,0
13268,2,1,46611,46614,46615,3,4,0
13269,4,2,46615,46615,46617,0,2,0
13270,4,3,46619,46619,46622,0,3,2
13271,3,3,46622,46622,46625,0,3,0
13272,2,2,46624,46625,46627,1,3,0
13273,4,2,46628,46628,46630,0,2,1
13274,4,2,46632,46632,46634,0,2,2
13275,3,3,46635,46635,46638,0,3,1
13276,3,2,46638,46638,46640,0,2,0
13277,4,3,46642,46642,46645,0,3,2
13278,4,2,46646,46646,46648,0,2,1
13279,6,1,46652,46652,46653,0,1,4
13280,2,2,46654,46654,46656,0,2,1
13281,2,2,46656,46656,46658,0,2,0
13282,1,2,46657,46658,46660,1,3,0
13283,3,2,46660,46660,46662,0,2,0
13284,2,3,46662,46662,46665,0,3,0
13285,3,1,46665,46665,46666,0,1,0
13286,6,1,46671,46671,46672,0,1,5
13287,1,2,46672,46672,46674,0,2,0
13288,6,1,46678,46678,46679,0,1,4
13289,4,3,46682,46682,46685,0,3,3
13290,2,3,46684,46685,46688,1,4,0
13291,6,2,46690,46690,46692,0,2,2
13292,3,2,46693,46693,46695,0,2,1
13293,6,1,46699,46699,46700,0,1,4
13294,3,2,46702,46702,46704,0,2,2
13295,5,3,46707,46707,46710,0,3,3
13296,1,2,46708,46710,46712,2,4,0
13297,4,2,46712,46712,46714,0,2,0
13298,4,2,46716,46716,46718,0,2,2
13299,6,1,46722,46722,46723,0,1,4
13300,6,3,46728,46728,46731,0,3,5
13301,5,3,46733,46733,46736,0,3,2
13302,2,3,46735,46736,46739,1,4,0
13303,6,1,46741,46741,46742,0,1,2
13304,4,2,46745,46745,46747,0,2,3
13305,3,1,46748,46748,46749,0,1,1
13306,2,1,46750,46750,46751,0,1,1
13307,6,3,46756,46756,46759,0,3,5
13308,2,2,46758,46759,46761,1,3,0
13309,1,3,46759,46761,46764,2,5,0
13310,3,1,46762,46764,46765,2,3,0
13311,3,1,46765,46765,46766,0,1,0
13312,6,2,46771,46771,46773,0,2,5
13313,3,1,46774,46774,46775,0,1,1
13314,1,3,46775,46775,46778,0,3,0
13315,4,3,46779,46779,46782,0,3,1
13316,3,1,46782,46782,46783,0,1,0
13317,3,3,46785,46785,46788,0,3,2
13318,5,1,46790,46790,46791,0,1,2
13319,2,1,46792,46792,46793,0,1,1
13320,4,3,46796,46796,46799,0,3,3
13321,6,3,46802,46802,46805,0,3,3
13322,3,3,46805,46805,46808,0,3,0
13323,4,3,46809,46809,46812,0,3,1
13324,5,1,46814,46814,46815,0,1,2
13325,6,1,46820,46820,46821,0,1,5
13326,2,3,46822,46822,46825,0,3,1
13327,5,2,46827,46827,46829,0,2,2
13328,5,2,46832,46832,46834,0,2,3
13329,5,3,46837,46837,46840,0,3,3
13330,4,1,46841,46841,46842,0,1,1
13331,4,1,46845,46845,46846,0,1,3
13332,2,1,46847,46847,46848,0,1,1
13333,4,3,46851,46851,46854,0,3,3
13334,1,3,46852,46854,46857,2,5,0
13335,5,2,46857,46857,46859,0,2,0
13336,3,3,46860,46860,46863,0,3,1
13337,2,1,46862,46863,46864,1,2,0
13338,1,1,46863,46864,46865,1,2,0
13339,6,2,46869,46869,46871,0,2,4
13340,4,3,46873,46873,46876,0,3,2
13341,3,2,46876,46876,46878,0,2,0
13342,6,2,46882,46882,46884,0,2,4
13343,2,2,46884,46884,46886,0,2,0
13344,5,1,46889,46889,46890,0,1,3
13345,6,3,46895,46895,46898,0,3,5
13346,3,3,46898,46898,46901,0,3,0
13347,2,3,46900,46901,46904,1,4,0
13348,2,3,46902,46904,46907,2,5,0
13349,5,1,46907,46907,46908,0,1,0
13350,6,1,46913,46913,46914,0,1,5
13351,5,1,46918,46918,46919,0,1,4
13352,2,3,46920,46920,46923,0,3,1
13353,3,2,46923,46923,46925,0,2,0
13354,3,2,46926,46926,46928,0,2,1
13355,2,1,46928,46928,46929,0,1,0
13356,1,2,46929,46929,46931,0,2,0
13357,3,3,46932,46932,46935,0,3,1
13358,2,3,46934,46935,46938,1,4,0
13359,1,2,46935,46938,46940,3,5,0
13360,3,3,46938,46940,46943,2,5,0
13361,5,2,46943,46943,46945,0,2,0
13362,3,3,46946,46946,46949,0,3,1
13363,1,1,46947,46949,46950,2,3,0
13364,6,3,46953,46953,46956,0,3,3
13365,6,2,46959,46959,46961,0,2,3
13366,4,2,46963,46963,46965,0,2,2
13367,3,1,46966,46966,46967,0,1,1
13368,6,3,46972,46972,46975,0,3,5
13369,1,1,46973,46975,46976,2,3,0
13370,4,2,46977,46977,46979,0,2,1
13371,4,3,46981,46981,46984,0,3,2
13372,1,1,46982,46984,46985,2,3,0
13373,4,2,46986,46986,46988,0,2,1
13374,1,1,46987,46988,46989,1,2,0
13375,5,3,46992,46992,46995,0,3,3
13376,4,3,46996,46996,46999,0,3,1
13377,2,1,46998,46999,47000,1,2,0
13378,1,1,46999,47000,47001,1,2,0
13379,5,2,47004,47004,47006,0,2,3
13380,2,1,47006,47006,47007,0,1,0
13381,1,2,47007,47007,47009,0,2,0
13382,1,1,47008,47009,47010,1,2,0
13383,5,2,47013,47013,47015,0,2,3
13384,6,3,47019,47019,47022,0,3,4
13385,5,3,47024,47024,47027,0,3,2
13386,3,2,47027,47027,47029,0,2,0
13387,6,3,47033,47033,47036,0,3,4
13388,1,1,47034,47036,47037,2,3,0
13389,3,3,47037,47037,47040,0,3,0
13390,1,1,47038,47040,47041,2,3,0
13391,2,3,47040,47041,47044,1,4,0
13392,4,1,47044,47044,47045,0,1,0
13393,6,1,47050,47050,47051,0,1,5
13394,1,3,47051,47051,47054,0,3,0
13395,1,3,47052,47054,47057,2,5,0
13396,6,1,47058,47058,47059,0,1,1
13397,2,3,47060,47060,47063,0,3,1
13398,5,3,47065,47065,47068,0,3,2
13399,5,1,47070,47070,47071,0,1,2
13400,5,2,47075,47075,47077,0,2,4
13401,6,2,47081,47081,47083,0,2,4
13402,4,1,47085,47085,47086,0,1,2
13403,1,3,47086,47086,47089,0,3,0
13404,2,2,47088,47089,47091,1,3,0
13405,4,1,47092,47092,47093,0,1,1
13406,5,2,47097,47097,47099,0,2,4
13407,1,2,47098,47099,47101,1,3,0
13408,2,2,47100,47101,47103,1,3,0
13409,4,2,47104,47104,47106,0,2,1
13410,1,1,47105,47106,47107,1,2,0
13411,2,3,47107,47107,47110,0,3,0
13412,6,2,47113,47113,47115,0,2,3
13413,4,1,47117,47117,47118,0,1,2
13414,4,2,47121,47121,47123,0,2,3
13415,5,1,47126,47126,47127,0,1,3
13416,2,1,47128,47128,47129,0,1,1
13417,6,1,47134,47134,47135,0,1,5
13418,1,3,47135,47135,47138,0,3,0
13419,5,1,47140,47140,47141,0,1,2
13420,5,2,47145,47145,47147,0,2,4
13421,3,2,47148,47148,47150,0,2,1
13422,6,1,47154,47154,47155,0,1,4
13423,5,3,47159,47159,47162,0,3,4
13424,4,2,47163,47163,47165,0,2,1
13425,1,1,47164,47165,47166,1,2,0
13426,2,3,47166,47166,47169,0,3,0
13427,2,1,47168,47169,47170,1,2,0
13428,1,1,47169,47170,47171,1,2,0
13429,2,3,47171,47171,47174,0,3,0
13430,6,1,47177,47177,47178,0,1,3
13431,3,2,47180,47180,47182,0,2,2
13432,4,1,47184,47184,47185,0,1,2
13433,1,2,47185,47185,47187,0,2,0
13434,4,3,47189,47189,47192,0,3,2
13435,6,3,47195,47195,47198,0,3,3
13436,2,1,47197,47198,47199,1,2,0
13437,2,1,47199,47199,47200,0,1,0
13438,5,2,47204,47204,47206,0,2,4
13439,5,3,47209,47209,47212,0,3,3
13440,6,3,47215,47215,47218,0,3,3
13441,5,1,47220,47220,47221,0,1,2
13442,5,1,47225,47225,47226,0,1,4
13443,6,1,47231,47231,47232,0,1,5
13444,2,3,47233,47233,47236,0,3,1
13445,1,3,47234,47236,47239,2,5,0
13446,6,1,47240,47240,47241,0,1,1
13447,4,3,47244,47244,47247,0,3,3
13448,1,3,47245,47247,47250,2,5,0
13449,6,2,47251,47251,47253,0,2,1
13450,1,3,47252,47253,47256,1,4,0
13451,4,3,47256,47256,47259,0,3,0
13452,3,2,47259,47259,47261,0,2,0
13453,6,2,47265,47265,47267,0,2,4
13454,1,1,47266,47267,47268,1,2,0
13455,6,2,47272,47272,47274,0,2,4
13456,5,2,47277,47277,47279,0,2,3
13457,5,3,47282,47282,47285,0,3,3
13458,4,3,47286,47286,47289,0,3,1
13459,2,1,47288,47289,47290,1,2,0
13460,1,1,47289,47290,47291,1,2,0
13461,6,1,47295,47295,47296,0,1,4
13462,3,2,47298,47298,47300,0,2,2
13463,6,1,47304,47304,47305,0,1,4
13464,6,3,47310,47310,47313,0,3,5
13465,4,1,47314,47314,47315,0,1,1
13466,2,1,47316,47316,47317,0,1,1
13467,5,3,47321,47321,47324,0,3,4
13468,6,2,47327,47327,47329,0,2,3
13469,3,2,47330,47330,47332,0,2,1
13470,5,2,47335,47335,47337,0,2,3
13471,2,2,47337,47337,47339,0,2,0
13472,3,1,47340,47340,47341,0,1,1
13473,5,3,47345,47345,47348,0,3,4
13474,5,3,47350,47350,47353,0,3,2
13475,6,1,47356,47356,47357,0,1,3
13476,5,2,47361,47361,47363,0,2,4
13477,6,1,47367,47367,47368,0,1,4
13478,2,2,47369,47369,47371,0,2,1
13479,5,3,47374,47374,47377,0,3,3
13480,1,2,47375,47377,47379,2,4,0
13481,6,2,47381,47381,47383,0,2,2
13482,6,2,47387,47387,47389,0,2,4
13483,2,2,47389,47389,47391,0,2,0
13484,4,2,47393,47393,47395,0,2,2
13485,3,3,47396,47396,47399,0,3,1
13486,2,2,47398,47399,47401,1,3,0
13487,5,3,47403,47403,47406,0,3,2
13488,2,2,47405,47406,47408,1,3,0
13489,3,1,47408,47408,47409,0,1,0
13490,6,2,47414,47414,47416,0,2,5
13491,4,2,47418,47418,47420,0,2,2
13492,5,3,47423,47423,47426,0,3,3
13493,1,1,47424,47426,47427,2,3,0
13494,1,3,47425,47427,47430,2,5,0
13495,2,3,47427,47430,47433,3,6,0
13496,5,1,47432,47433,47434,1,2,0
13497,2,2,47434,47434,47436,0,2,0
13498,1,2,47435,47436,47438,1,3,0
13499,1,1,47436,47438,47439,2,3,0
13500,4,2,47440,47440,47442,0,2,1
13501,5,3,47445,47445,47448,0,3,3
13502,4,1,47449,47449,47450,0,1,1
13503,2,3,47451,47451,47454,0,3,1
13504,2,3,47453,47454,47457,1,4,0
13505,6,1,47459,47459,47460,0,1,2
13506,6,3,47465,47465,47468,0,3,5
13507,6,2,47471,47471,47473,0,2,3
13508,6,1,47477,47477,47478,0,1,4
13509,5,2,47482,47482,47484,0,2,4
13510,2,1,47484,47484,47485,0,1,0
13511,2,1,47486,47486,47487,0,1,1
13512,1,1,47487,47487,47488,0,1,0
13513,5,2,47492,47492,47494,0,2,4
13514,4,2,47496,47496,47498,0,2,2
13515,6,2,47502,47502,47504,0,2,4
13516,6,2,47508,47508,47510,0,2,4
13517,4,1,47512,47512,47513,0,1,2
13518,3,3,47515,47515,47518,0,3,2
13519,6,2,47521,47521,47523,0,2,3
13520,3,2,47524,47524,47526,0,2,1
13521,4,2,47528,47528,47530,0,2,2
13522,6,1,47534,47534,47535,0,1,4
13523,6,1,47540,47540,47541,0,1,5
13524,2,3,47542,47542,47545,0,3,1
13525,3,2,47545,47545,47547,0,2,0
13526,3,3,47548,47548,47551,0,3,1
13527,6,3,47554,47554,47557,0,3,3
13528,1,2,47555,47557,47559,2,4,0
13529,3,2,47558,47559,47561,1,3,0
13530,6,2,47564,47564,47566,0,2,3
13531,5,1,47569,47569,47570,0,1,3
13532,1,2,47570,47570,47572,0,2,0
13533,2,1,47572,47572,47573,0,1,0
13534,5,1,47577,47577,47578,0,1,4
13535,2,3,47579,47579,47582,0,3,1
13536,6,1,47585,47585,47586,0,1,3
13537,3,3,47588,47588,47591,0,3,2
13538,6,1,47594,47594,47595,0,1,3
13539,5,3,47599,47599,47602,0,3,4
13540,3,1,47602,47602,47603,0,1,0
13541,6,1,47608,47608,47609,0,1,5
13542,5,2,47613,47613,47615,0,2,4
13543,4,3,47617,47617,47620,0,3,2
13544,2,3,47619,47620,47623,1,4,0
13545,1,1,47620,47623,47624,3,4,0
13546,3,2,47623,47624,47626,1,3,0
13547,6,3,47629,47629,47632,0,3,3
13548,6,2,47635,47635,47637,0,2,3
13549,6,3,47641,47641,47644,0,3,4
13550,1,1,47642,47644,47645,2,3,0
13551,3,1,47645,47645,47646,0,1,0
13552,1,2,47646,47646,47648,0,2,0
13553,2,3,47648,47648,47651,0,3,0
13554,5,3,47653,47653,47656,0,3,2
13555,3,2,47656,47656,47658,0,2,0
13556,1,2,47657,47658,47660,1,3,0
13557,1,2,47658,47660,47662,2,4,0
13558,3,3,47661,47662,47665,1,4,0
13559,5,1,47666,47666,47667,0,1,1
13560,3,1,47669,47669,47670,0,1,2
13561,1,2,47670,47670,47672,0,2,0
13562,2,3,47672,47672,47675,0,3,0
13563,1,3,47673,47675,47678,2,5,0
13564,2,1,47675,47678,47679,3,4,0
13565,4,3,47679,47679,47682,0,3,0
13566,5,2,47684,47684,47686,0,2,2
13567,4,3,47688,47688,47691,0,3,2
13568,3,2,47691,47691,47693,0,2,0
13569,4,2,47695,47695,47697,0,2,2
13570,5,2,47700,47700,47702,0,2,3
13571,1,2,47701,47702,47704,1,3,0
13572,4,3,47705,47705,47708,0,3,1
13573,1,1,47706,47708,47709,2,3,0
13574,2,3,47708,47709,47712,1,4,0
13575,3,1,47711,47712,47713,1,2,0
13576,1,1,47712,47713,47714,1,2,0
13577,5,3,47717,47717,47720,0,3,3
13578,1,1,47718,47720,47721,2,3,0
13579,2,2,47720,47721,47723,1,3,0
13580,6,2,47726,47726,47728,0,2,3
13581,6,2,47732,47732,47734,0,2,4
13582,1,2,47733,47734,47736,1,3,0
13583,6,3,47739,47739,47742,0,3,3
13584,6,2,47745,47745,47747,0,2,3
13585,4,3,47749,47749,47752,0,3,2
13586,2,2,47751,47752,47754,1,3,0
13587,2,2,47753,47754,47756,1,3,0
13588,2,3,47755,47756,47759,1,4,0
13589,1,2,47756,47759,47761,3,5,0
13590,6,2,47762,47762,47764,0,2,1
13591,1,1,47763,47764,47765,1,2,0
13592,2,2,47765,47765,47767,0,2,0
13593,2,3,47767,47767,47770,0,3,0
13594,4,3,47771,47771,47774,0,3,1
13595,5,2,47776,47776,47778,0,2,2
13596,2,1,47778,47778,47779,0,1,0
13597,5,3,47783,47783,47786,0,3,4
13598,4,2,47787,47787,47789,0,2,1
13599,2,1,47789,47789,47790,0,1,0
13600,4,2,47793,47793,47795,0,2,3
13601,2,2,47795,47795,47797,0,2,0
13602,1,1,47796,47797,47798,1,2,0
13603,6,1,47802,47802,47803,0,1,4
13604,5,3,47807,47807,47810,0,3,4
13605,4,2,47811,47811,47813,0,2,1
13606,3,1,47814,47814,47815,0,1,1
13607,1,3,47815,47815,47818,0,3,0
13608,4,2,47819,47819,47821,0,2,1
13609,4,1,47823,47823,47824,0,1,2
13610,2,1,47825,47825,47826,0,1,1
13611,3,2,47828,47828,47830,0,2,2
13612,5,1,47833,47833,47834,0,1,3
13613,1,2,47834,47834,47836,0,2,0
13614,6,3,47840,47840,47843,0,3,4
13615,5,3,47845,47845,47848,0,3,2
13616,2,3,47847,47848,47851,1,4,0
13617,1,2,47848,47851,47853,3,5,0
13618,6,3,47854,47854,47857,0,3,1
13619,3,2,47857,47857,47859,0,2,0
13620,2,1,47859,47859,47860,0,1,0
13621,1,3,47860,47860,47863,0,3,0
13622,1,1,47861,47863,47864,2,3,0
13623,3,1,47864,47864,47865,0,1,0
13624,4,2,47868,47868,47870,0,2,3
13625,2,1,47870,47870,47871,0,1,0
13626,4,2,47874,47874,47876,0,2,3
13627,1,3,47875,47876,47879,1,4,0
13628,5,1,47880,47880,47881,0,1,1
13629,5,2,47885,47885,47887,0,2,4
13630,6,1,47891,47891,47892,0,1,4
13631,4,1,47895,47895,47896,0,1,3
13632,3,2,47898,47898,47900,0,2,2
13633,2,3,47900,47900,47903,0,3,0
13634,4,1,47904,47904,47905,0,1,1
13635,3,3,47907,47907,47910,0,3,2
13636,1,1,47908,47910,47911,2,3,0
13637,4,3,47912,47912,47915,0,3,1
13638,1,3,47913,47915,47918,2,5,0
13639,6,2,47919,47919,47921,0,2,1
13640,2,2,47921,47921,47923,0,2,0
13641,2,2,47923,47923,47925,0,2,0
13642,6,1,47929,47929,47930,0,1,4
13643,3,1,47932,47932,47933,0,1,2
13644,5,3,47937,47937,47940,0,3,4
13645,2,3,47939,47940,47943,1,4,0
13646,5,2,47944,47944,47946,0,2,1
13647,2,2,47946,47946,47948,0,2,0
13648,1,1,47947,47948,47949,1,2,0
13649,5,2,47952,47952,47954,0,2,3
13650,1,2,47953,47954,47956,1,3,0
13651,6,1,47959,47959,47960,0,1,3
13652,3,2,47962,47962,47964,0,2,2
13653,5,3,47967,47967,47970,0,3,3
13654,4,3,47971,47971,47974,0,3,1
13655,4,3,47975,47975,47978,0,3,1
13656,2,2,47977,47978,47980,1,3,0
13657,4,1,47981,47981,47982,0,1,1
13658,1,3,47982,47982,47985,0,3,0
13659,6,1,47988,47988,47989,0,1,3
13660,2,2,47990,47990,47992,0,2,1
13661,1,2,47991,47992,47994,1,3,0
13662,6,2,47997,47997,47999,0,2,3
13663,4,3,48001,48001,48004,0,3,2
13664,5,3,48006,48006,48009,0,3,2
13665,5,2,48011,48011,48013,0,2,2
13666,3,2,48014,48014,48016,0,2,1
13667,4,2,48018,48018,48020,0,2,2
13668,2,2,48020,48020,48022,0,2,0
13669,3,2,48023,48023,48025,0,2,1
13670,5,3,48028,48028,48031,0,3,3
13671,2,2,48030,48031,48033,1,3,0
13672,2,2,48032,48033,48035,1,3,0
13673,1,3,48033,48035,48038,2,5,0
13674,3,3,48036,48038,48041,2,5,0
13675,4,2,48040,48041,48043,1,3,0
13676,4,1,48044,48044,48045,0,1,1
13677,6,1,48050,48050,48051,0,1,5
13678,5,3,48055,48055,48058,0,3,4
13679,6,1,48061,48061,48062,0,1,3
13680,1,3,48062,48062,48065,0,3,0
13681,2,1,48064,48065,48066,1,2,0
13682,1,2,48065,48066,48068,1,3,0
13683,4,1,48069,48069,48070,0,1,1
13684,2,3,48071,48071,48074,0,3,1
13685,4,3,48075,48075,48078,0,3,1
13686,1,1,48076,48078,48079,2,3,0
13687,2,2,48078,48079,48081,1,3,0
13688,5,1,48083,48083,48084,0,1,2
13689,1,1,48084,48084,48085,0,1,0
13690,4,2,48088,48088,48090,0,2,3
13691,1,3,48089,48090,48093,1,4,0
13692,1,3,48090,48093,48096,3,6,0
13693,6,1,48096,48096,48097,0,1,0
13694,5,1,48101,48101,48102,0,1,4
13695,3,2,48104,48104,48106,0,2,2
13696,3,2,48107,48107,48109,0,2,1
13697,2,2,48109,48109,48111,0,2,0
13698,2,1,48111,48111,48112,0,1,0
13699,1,1,48112,48112,48113,0,1,0
13700,5,2,48117,48117,48119,0,2,4
13701,1,1,48118,48119,48120,1,2,0
13702,4,2,48122,48122,48124,0,2,2
13703,6,1,48128,48128,48129,0,1,4
13704,4,2,48132,48132,48134,0,2,3
13705,2,1,48134,48134,48135,0,1,0
13706,1,1,48135,48135,48136,0,1,0
13707,2,3,48137,48137,48140,0,3,1
13708,3,2,48140,48140,48142,0,2,0
13709,6,1,48146,48146,48147,0,1,4
13710,4,3,48150,48150,48153,0,3,3
13711,6,2,48156,48156,48158,0,2,3
13712,5,2,48161,48161,48163,0,2,3
13713,3,2,48164,48164,48166,0,2,1
13714,3,1,48167,48167,48168,0,1,1
13715,4,1,48171,48171,48172,0,1,3
13716,6,1,48177,48177,48178,0,1,5
13717,3,2,48180,48180,48182,0,2,2
13718,5,1,48185,48185,48186,0,1,3
13719,5,1,48190,48190,48191,0,1,4
13720,6,2,48196,48196,48198,0,2,5
13721,6,1,48202,48202,48203,0,1,4
13722,2,3,48204,48204,48207,0,3,1
13723,4,2,48208,48208,48210,0,2,1
13724,5,3,48213,48213,48216,0,3,3
13725,6,1,48219,48219,48220,0,1,3
13726,1,3,48220,48220,48223,0,3,0
13727,1,2,48221,48223,48225,2,4,0
13728,1,2,48222,48225,48227,3,5,0
13729,4,2,48226,48227,48229,1,3,0
13730,6,3,48232,48232,48235,0,3,3
13731,1,1,48233,48235,48236,2,3,0
13732,4,1,48237,48237,48238,0,1,1
13733,6,1,48243,48243,48244,0,1,5
13734,3,2,48246,48246,48248,0,2,2
13735,1,2,48247,48248,48250,1,3,0
13736,1,3,48248,48250,48253,2,5,0
13737,5,3,48253,48253,48256,0,3,0
13738,4,1,48257,48257,48258,0,1,1
13739,5,2,48262,48262,48264,0,2,4
13740,3,1,48265,48265,48266,0,1,1
13741,1,1,48266,48266,48267,0,1,0
13742,2,2,48268,48268,48270,0,2,1
13743,6,3,48274,48274,48277,0,3,4
13744,5,1,48279,48279,48280,0,1,2
13745,1,1,48280,48280,48281,0,1,0
13746,2,1,48282,48282,48283,0,1,1
13747,5,2,48287,48287,48289,0,2,4
13748,2,2,48289,48289,48291,0,2,0
13749,5,1,48294,48294,48295,0,1,3
13750,3,1,48297,48297,48298,0,1,2
13751,2,3,48299,48299,48302,0,3,1
13752,3,1,48302,48302,48303,0,1,0
13753,1,3,48303,48303,48306,0,3,0
13754,3,3,48306,48306,48309,0,3,0
13755,6,2,48312,48312,48314,0,2,3
13756,2,2,48314,48314,48316,0,2,0
13757,4,1,48318,48318,48319,0,1,2
13758,5,2,48323,48323,48325,0,2,4
13759,6,1,48329,48329,48330,0,1,4
13760,2,3,48331,48331,48334,0,3,1
13761,1,3,48332,48334,48337,2,5,0
13762,2,3,48334,48337,48340,3,6,0
13763,4,1,48338,48340,48341,2,3,0
13764,2,3,48340,48341,48344,1,4,0
13765,2,3,48342,48344,48347,2,5,0
13766,1,2,48343,48347,48349,4,6,0
13767,4,1,48347,48349,48350,2,3,0
13768,3,1,48350,48350,48351,0,1,0
13769,2,3,48352,48352,48355,0,3,1
13770,4,2,48356,48356,48358,0,2,1
13771,4,3,48360,48360,48363,0,3,2
13772,1,1,48361,48363,48364,2,3,0
13773,1,2,48362,48364,48366,2,4,0
13774,6,2,48368,48368,48370,0,2,2
13775,6,3,48374,48374,48377,0,3,4
13776,1,2,48375,48377,48379,2,4,0
13777,1,3,48376,48379,48382,3,6,0
13778,3,2,48379,48382,48384,3,5,0
13779,1,3,48380,48384,48387,4,7,0
13780,4,1,48384,48387,48388,3,4,0
13781,2,1,48386,48388,48389,2,3,0
13782,1,1,48387,48389,48390,2,3,0
13783,3,2,48390,48390,48392,0,2,0
13784,2,1,48392,48392,48393,0,1,0
13785,2,2,48394,48394,48396,0,2,1
13786,3,2,48397,48397,48399,0,2,1
13787,2,1,48399,48399,48400,0,1,0
13788,4,2,48403,48403,48405,0,2,3
13789,6,3,48409,48409,48412,0,3,4
13790,2,1,48411,48412,48413,1,2,0
13791,2,3,48413,48413,48416,0,3,0
13792,4,1,48417,48417,48418,0,1,1
13793,6,1,48423,48423,48424,0,1,5
13794,3,2,48426,48426,48428,0,2,2
13795,3,2,48429,48429,48431,0,2,1
13796,2,3,48431,48431,48434,0,3,0
13797,6,1,48437,48437,48438,0,1,3
13798,3,3,48440,48440,48443,0,3,2
13799,3,1,48443,48443,48444,0,1,0
13800,1,1,48444,48444,48445,0,1,0
13801,2,2,48446,48446,48448,0,2,1
13802,2,3,48448,48448,48451,0,3,0
13803,6,1,48454,48454,48455,0,1,3
13804,5,3,48459,48459,48462,0,3,4
13805,4,3,48463,48463,48466,0,3,1
13806,6,1,48469,48469,48470,0,1,3
13807,2,2,48471,48471,48473,0,2,1
13808,5,3,48476,48476,48479,0,3,3
13809,1,2,48477,48479,48481,2,4,0
13810,1,1,48478,48481,48482,3,4,0
13811,6,1,48484,48484,48485,0,1,2
13812,4,2,48488,48488,48490,0,2,3
13813,3,2,48491,48491,48493,0,2,1
13814,5,1,48496,48496,48497,0,1,3
13815,2,2,48498,48498,48500,0,2,1
13816,2,1,48500,48500,48501,0,1,0
13817,5,3,48505,48505,48508,0,3,4
13818,1,2,48506,48508,48510,2,4,0
13819,6,1,48512,48512,48513,0,1,2
13820,2,1,48514,48514,48515,0,1,1
13821,1,1,48515,48515,48516,0,1,0
13822,4,3,48519,48519,48522,0,3,3
13823,4,3,48523,48523,48526,0,3,1
13824,4,1,48527,48527,48528,0,1,1
13825,5,1,48532,48532,48533,0,1,4
13826,3,2,48535,48535,48537,0,2,2
13827,3,2,48538,48538,48540,0,2,1
13828,4,1,48542,48542,48543,0,1,2
13829,6,2,48548,48548,48550,0,2,5
13830,6,2,48554,48554,48556,0,2,4
13831,2,2,48556,48556,48558,0,2,0
13832,6,1,48562,48562,48563,0,1,4
13833,1,1,48563,48563,48564,0,1,0
13834,4,3,48567,48567,48570,0,3,3
13835,5,2,48572,48572,48574,0,2,2
13836,4,2,48576,48576,48578,0,2,2
13837,5,3,48581,48581,48584,0,3,3
13838,6,2,48587,48587,48589,0,2,3
13839,5,2,48592,48592,48594,0,2,3
13840,5,2,48597,48597,48599,0,2,3
13841,1,1,48598,48599,48600,1,2,0
13842,6,1,48604,48604,48605,0,1,4
13843,5,1,48609,48609,48610,0,1,4
13844,4,3,48613,48613,48616,0,3,3
13845,1,2,48614,48616,48618,2,4,0
13846,5,2,48619,48619,48621,0,2,1
13847,2,3,48621,48621,48624,0,3,0
13848,1,2,48622,48624,48626,2,4,0
13849,1,2,48623,48626,48628,3,5,0
13850,3,3,48626,48628,48631,2,5,0
13851,1,3,48627,48631,48634,4,7,0
13852,6,2,48633,48634,48636,1,3,0
13853,1,1,48634,48636,48637,2,3,0
13854,2,1,48636,48637,48638,1,2,0
13855,1,3,48637,48638,48641,1,4,0
13856,5,3,48642,48642,48645,0,3,1
13857,3,3,48645,48645,48648,0,3,0
13858,3,2,48648,48648,48650,0,2,0
13859,1,1,48649,48650,48651,1,2,0
13860,4,3,48653,48653,48656,0,3,2
13861,4,3,48657,48657,48660,0,3,1
13862,5,2,48662,48662,48664,0,2,2
13863,4,2,48666,48666,48668,0,2,2
13864,6,3,48672,48672,48675,0,3,4
13865,3,3,48675,48675,48678,0,3,0
13866,1,2,48676,48678,48680,2,4,0
13867,6,3,48682,48682,48685,0,3,2
13868,2,2,48684,48685,48687,1,3,0
13869,3,3,48687,48687,48690,0,3,0
13870,6,3,48693,48693,48696,0,3,3
13871,1,3,48694,48696,48699,2,5,0
13872,6,2,48700,48700,48702,0,2,1
13873,5,1,48705,48705,48706,0,1,3
13874,1,2,48706,48706,48708,0,2,0
13875,2,1,48708,48708,48709,0,1,0
13876,5,2,48713,48713,48715,0,2,4
13877,3,3,48716,48716,48719,0,3,1
13878,1,1,48717,48719,48720,2,3,0
13879,5,3,48722,48722,48725,0,3,2
13880,4,3,48726,48726,48729,0,3,1
13881,5,1,48731,48731,48732,0,1,2
13882,2,3,48733,48733,48736,0,3,1
13883,3,2,48736,48736,48738,0,2,0
13884,5,1,48741,48741,48742,0,1,3
13885,5,2,48746,48746,48748,0,2,4
13886,1,3,48747,48748,48751,1,4,0
13887,3,3,48750,48751,48754,1,4,0
13888,4,1,48754,48754,48755,0,1,0
13889,3,2,48757,48757,48759,0,2,2
13890,1,3,48758,48759,48762,1,4,0
13891,5,2,48763,48763,48765,0,2,1
13892,1,3,48764,48765,48768,1,4,0
13893,2,2,48766,48768,48770,2,4,0
13894,2,1,48768,48770,48771,2,3,0
13895,6,1,48774,48774,48775,0,1,3
13896,2,2,48776,48776,48778,0,2,1
13897,5,1,48781,48781,48782,0,1,3
13898,6,3,48787,48787,48790,0,3,5
13899,5,1,48792,48792,48793,0,1,2
13900,5,3,48797,48797,48800,0,3,4
13901,6,3,48803,48803,48806,0,3,3
13902,2,1,48805,48806,48807,1,2,0
13903,1,1,48806,48807,48808,1,2,0
13904,6,3,48812,48812,48815,0,3,4
13905,5,2,48817,48817,48819,0,2,2
13906,5,3,48822,48822,48825,0,3,3
13907,3,2,48825,48825,48827,0,2,0
13908,1,2,48826,48827,48829,1,3,0
13909,1,3,48827,48829,48832,2,5,0
13910,6,3,48833,48833,48836,0,3,1
13911,6,3,48839,48839,48842,0,3,3
13912,6,3,48845,48845,48848,0,3,3
13913,5,1,48850,48850,48851,0,1,2
13914,1,2,48851,48851,48853,0,2,0
13915,5,3,48856,48856,48859,0,3,3
13916,3,2,48859,48859,48861,0,2,0
13917,3,3,48862,48862,48865,0,3,1
13918,1,2,48863,48865,48867,2,4,0
13919,6,2,48869,48869,48871,0,2,2
13920,6,1,48875,48875,48876,0,1,4
13921,1,2,48876,48876,48878,0,2,0
13922,5,3,48881,48881,48884,0,3,3
13923,1,1,48882,48884,48885,2,3,0
13924,4,2,48886,48886,48888,0,2,1
13925,6,3,48892,48892,48895,0,3,4
13926,4,1,48896,48896,48897,0,1,1
13927,6,1,48902,48902,48903,0,1,5
13928,6,2,48908,48908,48910,0,2,5
13929,5,3,48913,48913,48916,0,3,3
13930,3,3,48916,48916,48919,0,3,0
13931,1,1,48917,48919,48920,2,3,0
13932,3,1,48920,48920,48921,0,1,0
13933,2,3,48922,48922,48925,0,3,1
13934,5,1,48927,48927,48928,0,1,2
13935,1,3,48928,48928,48931,0,3,0
13936,6,2,48934,48934,48936,0,2,3
13937,6,3,48940,48940,48943,0,3,4
13938,4,2,48944,48944,48946,0,2,1
13939,6,2,48950,48950,48952,0,2,4
13940,1,2,48951,48952,48954,1,3,0
13941,2,1,48953,48954,48955,1,2,0
13942,1,2,48954,48955,48957,1,3,0
13943,4,1,48958,48958,48959,0,1,1
13944,3,2,48961,48961,48963,0,2,2
13945,2,3,48963,48963,48966,0,3,0
13946,1,2,48964,48966,48968,2,4,0
13947,6,2,48970,48970,48972,0,2,2
13948,3,2,48973,48973,48975,0,2,1
13949,2,2,48975,48975,48977,0,2,0
13950,3,3,48978,48978,48981,0,3,1
13951,1,3,48979,48981,48984,2,5,0
13952,1,2,48980,48984,48986,4,6,0
13953,5,2,48985,48986,48988,1,3,0
13954,1,2,48986,48988,48990,2,4,0
13955,1,1,48987,48990,48991,3,4,0
13956,3,1,48990,48991,48992,1,2,0
13957,2,3,48992,48992,48995,0,3,0
13958,2,3,48994,48995,48998,1,4,0
13959,1,2,48995,48998,49000,3,5,0
13960,4,1,48999,49000,49001,1,2,0
13961,3,3,49002,49002,49005,0,3,1
13962,4,3,49006,49006,49009,0,3,1
13963,3,2,49009,49009,49011,0,2,0
13964,5,1,49014,49014,49015,0,1,3
13965,2,2,49016,49016,49018,0,2,1
13966,3,3,49019,49019,49022,0,3,1
13967,2,3,49021,49022,49025,1,4,0
13968,1,1,49022,49025,49026,3,4,0
13969,5,3,49027,49027,49030,0,3,1
13970,2,3,49029,49030,49033,1,4,0
13971,6,1,49035,49035,49036,0,1,2
13972,4,2,49039,49039,49041,0,2,3
13973,4,1,49043,49043,49044,0,1,2
13974,6,2,49049,49049,49051,0,2,5
13975,6,2,49055,49055,49057,0,2,4
13976,2,2,49057,49057,49059,0,2,0
13977,2,3,49059,49059,49062,0,3,0
13978,1,1,49060,49062,49063,2,3,0
13979,5,1,49065,49065,49066,0,1,2
13980,5,1,49070,49070,49071,0,1,4
13981,4,1,49074,49074,49075,0,1,3
13982,4,2,49078,49078,49080,0,2,3
13983,3,2,49081,49081,49083,0,2,1
13984,6,2,49087,49087,49089,0,2,4
13985,2,3,49089,49089,49092,0,3,0
13986,4,1,49093,49093,49094,0,1,1
13987,4,2,49097,49097,49099,0,2,3
13988,6,2,49103,49103,49105,0,2,4
13989,1,1,49104,49105,49106,1,2,0
13990,1,3,49105,49106,49109,1,4,0
13991,3,2,49108,49109,49111,1,3,0
13992,1,1,49109,49111,49112,2,3,0
13993,4,2,49113,49113,49115,0,2,1
13994,2,1,49115,49115,49116,0,1,0
13995,2,3,49117,49117,49120,0,3,1
13996,4,2,49121,49121,49123,0,2,1
13997,2,3,49123,49123,49126,0,3,0
13998,2,2,49125,49126,49128,1,3,0
13999,3,3,49128,49128,49131,0,3,0
14000,1,3,49129,49131,49134,2,5,0
14001,5,3,49134,49134,49137,0,3,0
14002,6,2,49140,49140,49142,0,2,3
14003,3,3,49143,49143,49146,0,3,1
14004,5,2,49148,49148,49150,0,2,2
14005,3,2,49151,49151,49153,0,2,1
14006,3,2,49154,49154,49156,0,2,1
14007,6,1,49160,49160,49161,0,1,4
14008,6,3,49166,49166,49169,0,3,5
14009,1,1,49167,49169,49170,2,3,0
14010,6,2,49173,49173,49175,0,2,3
14011,4,2,49177,49177,49179,0,2,2
14012,3,3,49180,49180,49183,0,3,1
14013,5,1,49185,49185,49186,0,1,2
14014,5,1,49190,49190,49191,0,1,4
14015,3,2,49193,49193,49195,0,2,2
14016,5,1,49198,49198,49199,0,1,3
14017,5,2,49203,49203,49205,0,2,4
14018,4,1,49207,49207,49208,0,1,2
14019,5,2,49212,49212,49214,0,2,4
14020,5,1,49217,49217,49218,0,1,3
14021,5,3,49222,49222,49225,0,3,4
14022,3,1,49225,49225,49226,0,1,0
14023,2,2,49227,49227,49229,0,2,1
14024,5,1,49232,49232,49233,0,1,3
14025,5,1,49237,49237,49238,0,1,4
14026,6,1,49243,49243,49244,0,1,5
14027,3,3,49246,49246,49249,0,3,2
14028,6,1,49252,49252,49253,0,1,3
14029,6,1,49258,49258,49259,0,1,5
14030,1,1,49259,49259,49260,0,1,0
14031,2,3,49261,49261,49264,0,3,1
14032,3,1,49264,49264,49265,0,1,0
14033,2,1,49266,49266,49267,0,1,1
14034,6,3,49272,49272,49275,0,3,5
14035,4,2,49276,49276,49278,0,2,1
14036,6,1,49282,49282,49283,0,1,4
14037,2,2,49284,49284,49286,0,2,1
14038,5,2,49289,49289,49291,0,2,3
14039,3,1,49292,49292,49293,0,1,1
14040,1,1,49293,49293,49294,0,1,0
14041,6,2,49299,49299,49301,0,2,5
14042,2,1,49301,49301,49302,0,1,0
14043,6,2,49307,49307,49309,0,2,5
14044,3,1,49310,49310,49311,0,1,1
14045,5,2,49315,49315,49317,0,2,4
14046,1,3,49316,49317,49320,1,4,0
14047,6,3,49322,49322,49325,0,3,2
14048,5,1,49327,49327,49328,0,1,2
14049,3,3,49330,49330,49333,0,3,2
14050,1,1,49331,49333,49334,2,3,0
14051,2,2,49333,49334,49336,1,3,0
14052,5,3,49338,49338,49341,0,3,2
14053,5,1,49343,49343,49344,0,1,2
14054,6,1,49349,49349,49350,0,1,5
14055,2,3,49351,49351,49354,0,3,1
14056,5,2,49356,49356,49358,0,2,2
14057,2,1,49358,49358,49359,0,1,0
14058,3,3,49361,49361,49364,0,3,2
14059,6,1,49367,49367,49368,0,1,3
14060,5,3,49372,49372,49375,0,3,4
14061,6,1,49378,49378,49379,0,1,3
14062,5,2,49383,49383,49385,0,2,4
14063,6,1,49389,49389,49390,0,1,4
14064,1,2,49390,49390,49392,0,2,0
14065,6,1,49396,49396,49397,0,1,4
14066,6,3,49402,49402,49405,0,3,5
14067,2,2,49404,49405,49407,1,3,0
14068,5,2,49409,49409,49411,0,2,2
14069,5,3,49414,49414,49417,0,3,3
14070,6,3,49420,49420,49423,0,3,3
14071,2,1,49422,49423,49424,1,2,0
14072,5,2,49427,49427,49429,0,2,3
14073,3,1,49430,49430,49431,0,1,1
14074,2,2,49432,49432,49434,0,2,1
14075,2,2,49434,49434,49436,0,2,0
14076,2,3,49436,49436,49439,0,3,0
14077,5,1,49441,49441,49442,0,1,2
14078,2,2,49443,49443,49445,0,2,1
14079,5,1,49448,49448,49449,0,1,3
14080,6,3,49454,49454,49457,0,3,5
14081,1,2,49455,49457,49459,2,4,0
14082,2,3,49457,49459,49462,2,5,0
14083,3,3,49460,49462,49465,2,5,0
14084,2,3,49462,49465,49468,3,6,0
14085,4,1,49466,49468,49469,2,3,0
14086,2,1,49468,49469,49470,1,2,0
14087,1,3,49469,49470,49473,1,4,0
14088,3,1,49472,49473,49474,1,2,0
14089,6,2,49478,49478,49480,0,2,4
14090,2,2,49480,49480,49482,0,2,0
14091,5,1,49485,49485,49486,0,1,3
14092,1,1,49486,49486,49487,0,1,0
14093,2,3,49488,49488,49491,0,3,1
14094,1,2,49489,49491,49493,2,4,0
14095,5,3,49494,49494,49497,0,3,1
14096,4,3,49498,49498,49501,0,3,1
14097,1,1,49499,49501,49502,2,3,0
14098,5,2,49504,49504,49506,0,2,2
14099,4,1,49508,49508,49509,0,1,2
14100,6,2,49514,49514,49516,0,2,5
14101,5,3,49519,49519,49522,0,3,3
14102,6,3,49525,49525,49528,0,3,3
14103,4,2,49529,49529,49531,0,2,1
14104,2,2,49531,49531,49533,0,2,0
14105,6,2,49537,49537,49539,0,2,4
14106,3,2,49540,49540,49542,0,2,1
14107,6,1,49546,49546,49547,0,1,4
14108,3,3,49549,49549,49552,0,3,2
14109,5,2,49554,49554,49556,0,2,2
14110,1,2,49555,49556,49558,1,3,0
14111,6,2,49561,49561,49563,0,2,3
14112,4,1,49565,49565,49566,0,1,2
14113,1,2,49566,49566,49568,0,2,0
14114,4,1,49570,49570,49571,0,1,2
14115,6,2,49576,49576,49578,0,2,5
14116,1,3,49577,49578,49581,1,4,0
14117,2,3,49579,49581,49584,2,5,0
14118,1,3,49580,49584,49587,4,7,0
14119,4,2,49584,49587,49589,3,5,0
14120,4,2,49588,49589,49591,1,3,0
14121,5,1,49593,49593,49594,0,1,2
14122,2,1,49595,49595,49596,0,1,1
14123,5,3,49600,49600,49603,0,3,4
14124,6,1,49606,49606,49607,0,1,3
14125,5,1,49611,49611,49612,0,1,4
14126,2,1,49613,49613,49614,0,1,1
14127,1,3,49614,49614,49617,0,3,0
14128,5,2,49619,49619,49621,0,2,2
14129,1,2,49620,49621,49623,1,3,0
14130,1,2,49621,49623,49625,2,4,0
14131,5,1,49626,49626,49627,0,1,1
14132,3,3,49629,49629,49632,0,3,2
14133,6,2,49635,49635,49637,0,2,3
14134,1,3,49636,49637,49640,1,4,0
14135,4,3,49640,49640,49643,0,3,0
14136,4,1,49644,49644,49645,0,1,1
14137,6,2,49650,49650,49652,0,2,5
14138,1,1,49651,49652,49653,1,2,0
14139,2,1,49653,49653,49654,0,1,0
14140,3,1,49656,49656,49657,0,1,2
14141,1,1,49657,49657,49658,0,1,0
14142,2,2,49659,49659,49661,0,2,1
14143,2,3,49661,49661,49664,0,3,0
14144,4,1,49665,49665,49666,0,1,1
14145,5,3,49670,49670,49673,0,3,4
14146,3,2,49673,49673,49675,0,2,0
14147,5,2,49678,49678,49680,0,2,3
14148,3,1,49681,49681,49682,0,1,1
14149,6,1,49687,49687,49688,0,1,5
14150,5,1,49692,49692,49693,0,1,4
14151,1,3,49693,49693,49696,0,3,0
14152,6,1,49699,49699,49700,0,1,3
14153,1,2,49700,49700,49702,0,2,0
14154,5,1,49705,49705,49706,0,1,3
14155,5,3,49710,49710,49713,0,3,4
14156,5,1,49715,49715,49716,0,1,2
14157,2,1,49717,49717,49718,0,1,1
14158,6,1,49723,49723,49724,0,1,5
14159,6,2,49729,49729,49731,0,2,5
14160,6,1,49735,49735,49736,0,1,4
14161,5,3,49740,49740,49743,0,3,4
14162,2,3,49742,49743,49746,1,4,0
14163,4,3,49746,49746,49749,0,3,0
14164,3,1,49749,49749,49750,0,1,0
14165,6,3,49755,49755,49758,0,3,5
14166,2,1,49757,49758,49759,1,2,0
14167,5,3,49762,49762,49765,0,3,3
14168,3,2,49765,49765,49767,0,2,0
14169,2,1,49767,49767,49768,0,1,0
14170,5,2,49772,49772,49774,0,2,4
14171,4,3,49776,49776,49779,0,3,2
14172,1,1,49777,49779,49780,2,3,0
14173,3,3,49780,49780,49783,0,3,0
14174,2,1,49782,49783,49784,1,2,0
14175,1,3,49783,49784,49787,1,4,0
14176,5,3,49788,49788,49791,0,3,1
14177,3,3,49791,49791,49794,0,3,0
14178,6,1,49797,49797,49798,0,1,3
14179,4,1,49801,49801,49802,0,1,3
14180,5,1,49806,49806,49807,0,1,4
14181,5,3,49811,49811,49814,0,3,4
14182,6,2,49817,49817,49819,0,2,3
14183,4,3,49821,49821,49824,0,3,2
14184,6,3,49827,49827,49830,0,3,3
14185,6,2,49833,49833,49835,0,2,3
14186,4,2,49837,49837,49839,0,2,2
14187,4,3,49841,49841,49844,0,3,2
14188,6,3,49847,49847,49850,0,3,3
14189,1,3,49848,49850,49853,2,5,0
14190,3,3,49851,49853,49856,2,5,0
14191,3,3,49854,49856,49859,2,5,0
14192,3,1,49857,49859,49860,2,3,0
14193,1,3,49858,49860,49863,2,5,0
14194,3,1,49861,49863,49864,2,3,0
14195,5,2,49866,49866,49868,0,2,2
14196,3,1,49869,49869,49870,0,1,1
14197,5,1,49874,49874,49875,0,1,4
14198,4,2,49878,49878,49880,0,2,3
14199,6,3,49884,49884,49887,0,3,4
14200,2,1,49886,49887,49888,1,2,0
14201,6,1,49892,49892,49893,0,1,4
14202,5,1,49897,49897,49898,0,1,4
14203,6,3,49903,49903,49906,0,3,5
14204,4,1,49907,49907,49908,0,1,1
14205,2,2,49909,49909,49911,0,2,1
14206,2,3,49911,49911,49914,0,3,0
14207,6,1,49917,49917,49918,0,1,3
14208,4,1,49921,49921,49922,0,1,3
14209,6,2,49927,49927,49929,0,2,5
14210,5,2,49932,49932,49934,0,2,3
14211,4,2,49936,49936,49938,0,2,2
14212,3,1,49939,49939,49940,0,1,1
14213,6,3,49945,49945,49948,0,3,5
14214,2,3,49947,49948,49951,1,4,0
14215,4,3,49951,49951,49954,0,3,0
14216,6,3,49957,49957,49960,0,3,3
14217,4,1,49961,49961,49962,0,1,1
14218,6,2,49967,49967,49969,0,2,5
14219,4,3,49971,49971,49974,0,3,2
14220,6,3,49977,49977,49980,0,3,3
14221,2,1,49979,49980,49981,1,2,0
14222,6,1,49985,49985,49986,0,1,4
14223,3,1,49988,49988,49989,0,1,2
14224,5,2,49993,49993,49995,0,2,4
14225,5,2,49998,49998,50000,0,2,3
14226,1,2,49999,50000,50002,1,3,0
14227,6,3,50005,50005,50008,0,3,3
14228,4,2,50009,50009,50011,0,2,1
14229,3,1,50012,50012,50013,0,1,1
14230,4,2,50016,50016,50018,0,2,3
14231,2,3,50018,50018,50021,0,3,0
14232,6,1,50024,50024,50025,0,1,3
14233,2,3,50026,50026,50029,0,3,1
14234,1,2,50027,50029,50031,2,4,0
14235,5,3,50032,50032,50035,0,3,1
14236,2,3,50034,50035,50038,1,4,0
14237,4,2,50038,50038,50040,0,2,0
14238,4,2,50042,50042,50044,0,2,2
14239,3,1,50045,50045,50046,0,1,1
14240,3,2,50048,50048,50050,0,2,2
14241,3,2,50051,50051,50053,0,2,1
14242,2,2,50053,50053,50055,0,2,0
14243,2,3,50055,50055,50058,0,3,0
14244,2,1,50057,50058,50059,1,2,0
14245,4,1,50061,50061,50062,0,1,2
14246,5,3,50066,50066,50069,0,3,4
14247,2,3,50068,50069,50072,1,4,0
14248,5,3,50073,50073,50076,0,3,1
14249,1,2,50074,50076,50078,2,4,0
14250,5,1,50079,50079,50080,0,1,1
14251,2,2,50081,50081,50083,0,2,1
14252,1,3,50082,50083,50086,1,4,0
14253,2,2,50084,50086,50088,2,4,0
14254,2,1,50086,50088,50089,2,3,0
14255,3,1,50089,50089,50090,0,1,0
14256,5,2,50094,50094,50096,0,2,4
14257,6,3,50100,50100,50103,0,3,4
14258,3,2,50103,50103,50105,0,2,0
14259,3,3,50106,50106,50109,0,3,1
14260,2,1,50108,50109,50110,1,2,0
14261,5,1,50113,50113,50114,0,1,3
14262,3,2,50116,50116,50118,0,2,2
14263,6,3,50122,50122,50125,0,3,4
14264,5,3,50127,50127,50130,0,3,2
14265,2,2,50129,50130,50132,1,3,0
14266,4,1,50133,50133,50134,0,1,1
14267,4,2,50137,50137,50139,0,2,3
14268,6,2,50143,50143,50145,0,2,4
14269,3,1,50146,50146,50147,0,1,1
14270,1,1,50147,50147,50148,0,1,0
14271,6,1,50153,50153,50154,0,1,5
14272,3,2,50156,50156,50158,0,2,2
14273,5,3,50161,50161,50164,0,3,3
14274,1,3,50162,50164,50167,2,5,0
14275,2,2,50164,50167,50169,3,5,0
14276,4,3,50168,50169,50172,1,4,0
14277,5,1,50173,50173,50174,0,1,1
14278,4,2,50177,50177,50179,0,2,3
14279,5,1,50182,50182,50183,0,1,3
14280,5,3,50187,50187,50190,0,3,4
14281,6,1,50193,50193,50194,0,1,3
14282,4,2,50197,50197,50199,0,2,3
14283,1,2,50198,50199,50201,1,3,0
14284,5,2,50203,50203,50205,0,2,2
14285,3,1,50206,50206,50207,0,1,1
14286,2,3,50208,50208,50211,0,3,1
14287,4,3,50212,50212,50215,0,3,1
14288,3,3,50215,50215,50218,0,3,0
14289,2,3,50217,50218,50221,1,4,0
14290,1,3,50218,50221,50224,3,6,0
14291,3,1,50221,50224,50225,3,4,0
14292,5,3,50226,50226,50229,0,3,1
14293,1,3,50227,50229,50232,2,5,0
14294,2,3,50229,50232,50235,3,6,0
14295,3,1,50232,50235,50236,3,4,0
14296,1,1,50233,50236,50237,3,4,0
14297,4,1,50237,50237,50238,0,1,0
14298,3,3,50240,50240,50243,0,3,2
14299,2,1,50242,50243,50244,1,2,0
14300,5,1,50247,50247,50248,0,1,3
14301,3,2,50250,50250,50252,0,2,2
14302,4,2,50254,50254,50256,0,2,2
14303,2,1,50256,50256,50257,0,1,0
14304,2,2,50258,50258,50260,0,2,1
14305,3,1,50261,50261,50262,0,1,1
14306,2,2,50263,50263,50265,0,2,1
14307,3,2,50266,50266,50268,0,2,1
14308,2,2,50268,50268,50270,0,2,0
14309,6,1,50274,50274,50275,0,1,4
14310,2,2,50276,50276,50278,0,2,1
14311,4,2,50280,50280,50282,0,2,2
14312,1,2,50281,50282,50284,1,3,0
14313,3,1,50284,50284,50285,0,1,0
14314,3,1,50287,50287,50288,0,1,2
14315,6,1,50293,50293,50294,0,1,5
14316,3,2,50296,50296,50298,0,2,2
14317,6,3,50302,50302,50305,0,3,4
14318,5,3,50307,50307,50310,0,3,2
14319,4,3,50311,50311,50314,0,3,1
14320,5,1,50316,50316,50317,0,1,2
14321,1,1,50317,50317,50318,0,1,0
14322,6,3,50323,50323,50326,0,3,5
14323,1,2,50324,50326,50328,2,4,0
14324,1,3,50325,50328,50331,3,6,0
14325,5,1,50330,50331,50332,1,2,0
14326,6,3,50336,50336,50339,0,3,4
14327,3,2,50339,50339,50341,0,2,0
14328,2,1,50341,50341,50342,0,1,0
14329,6,2,50347,50347,50349,0,2,5
14330,4,1,50351,50351,50352,0,1,2
14331,1,1,50352,50352,50353,0,1,0
14332,6,1,50358,50358,50359,0,1,5
14333,3,3,50361,50361,50364,0,3,2
14334,1,3,50362,50364,50367,2,5,0
14335,4,3,50366,50367,50370,1,4,0
14336,2,3,50368,50370,50373,2,5,0
14337,4,3,50372,50373,50376,1,4,0
14338,6,2,50378,50378,50380,0,2,2
14339,5,2,50383,50383,50385,0,2,3
14340,6,2,50389,50389,50391,0,2,4
14341,2,3,50391,50391,50394,0,3,0
14342,1,3,50392,50394,50397,2,5,0
14343,5,3,50397,50397,50400,0,3,0
14344,2,1,50399,50400,50401,1,2,0
14345,1,2,50400,50401,50403,1,3,0
14346,4,3,50404,50404,50407,0,3,1
14347,5,1,50409,50409,50410,0,1,2
14348,3,3,50412,50412,50415,0,3,2
14349,6,1,50418,50418,50419,0,1,3
14350,2,3,50420,50420,50423,0,3,1
14351,1,1,50421,50423,50424,2,3,0
14352,3,3,50424,50424,50427,0,3,0
14353,3,2,50427,50427,50429,0,2,0
14354,2,3,50429,50429,50432,0,3,0
14355,1,1,50430,50432,50433,2,3,0
14356,5,1,50435,50435,50436,0,1,2
14357,2,3,50437,50437,50440,0,3,1
14358,6,3,50443,50443,50446,0,3,3
14359,4,2,50447,50447,50449,0,2,1
14360,6,3,50453,50453,50456,0,3,4
14361,4,3,50457,50457,50460,0,3,1
14362,1,2,50458,50460,50462,2,4,0
14363,4,1,50462,50462,50463,0,1,0
14364,4,3,50466,50466,50469,0,3,3
14365,6,1,50472,50472,50473,0,1,3
14366,3,2,50475,50475,50477,0,2,2
14367,5,3,50480,50480,50483,0,3,3
14368,6,3,50486,50486,50489,0,3,3
14369,3,3,50489,50489,50492,0,3,0
14370,6,1,50495,50495,50496,0,1,3
14371,2,1,50497,50497,50498,0,1,1
14372,5,2,50502,50502,50504,0,2,4
14373,1,1,50503,50504,50505,1,2,0
14374,2,3,50505,50505,50508,0,3,0
14375,5,2,50510,50510,50512,0,2,2
14376,4,1,50514,50514,50515,0,1,2
14377,1,3,50515,50515,50518,0,3,0
14378,1,3,50516,50518,50521,2,5,0
14379,4,3,50520,50521,50524,1,4,0
14380,5,1,50525,50525,50526,0,1,1
14381,1,3,50526,50526,50529,0,3,0
14382,6,3,50532,50532,50535,0,3,3
14383,2,2,50534,50535,50537,1,3,0
14384,5,2,50539,50539,50541,0,2,2
14385,6,2,50545,50545,50547,0,2,4
14386,2,2,50547,50547,50549,0,2,0
14387,4,3,50551,50551,50554,0,3,2
14388,5,1,50556,50556,50557,0,1,2
14389,2,1,50558,50558,50559,0,1,1
14390,5,3,50563,50563,50566,0,3,4
14391,1,1,50564,50566,50567,2,3,0
14392,5,1,50569,50569,50570,0,1,2
14393,5,2,50574,50574,50576,0,2,4
14394,1,3,50575,50576,50579,1,4,0
14395,5,3,50580,50580,50583,0,3,1
14396,4,1,50584,50584,50585,0,1,1
14397,3,2,50587,50587,50589,0,2,2
14398,1,1,50588,50589,50590,1,2,0
14399,4,1,50592,50592,50593,0,1,2
14400,3,2,50595,50595,50597,0,2,2
14401,4,1,50599,50599,50600,0,1,2
14402,4,2,50603,50603,50605,0,2,3
14403,1,3,50604,50605,50608,1,4,0
14404,4,2,50608,50608,50610,0,2,0
14405,6,1,50614,50614,50615,0,1,4
14406,6,2,50620,50620,50622,0,2,5
14407,1,1,50621,50622,50623,1,2,0
14408,1,1,50622,50623,50624,1,2,0
14409,3,2,50625,50625,50627,0,2,1
14410,3,2,50628,50628,50630,0,2,1
14411,6,1,50634,50634,50635,0,1,4
14412,4,2,50638,50638,50640,0,2,3
14413,2,3,50640,50640,50643,0,3,0
14414,1,3,50641,50643,50646,2,5,0
14415,5,3,50646,50646,50649,0,3,0
14416,5,1,50651,50651,50652,0,1,2
14417,3,2,50654,50654,50656,0,2,2
14418,1,3,50655,50656,50659,1,4,0
14419,4,2,50659,50659,50661,0,2,0
14420,4,3,50663,50663,50666,0,3,2
14421,5,2,50668,50668,50670,0,2,2
14422,3,2,50671,50671,50673,0,2,1
14423,5,2,50676,50676,50678,0,2,3
14424,5,3,50681,50681,50684,0,3,3
14425,6,1,50687,50687,50688,0,1,3
14426,1,2,50688,50688,50690,0,2,0
14427,5,1,50693,50693,50694,0,1,3
14428,2,1,50695,50695,50696,0,1,1
14429,5,1,50700,50700,50701,0,1,4
14430,2,3,50702,50702,50705,0,3,1
14431,1,3,50703,50705,50708,2,5,0
14432,3,2,50706,50708,50710,2,4,0
14433,1,3,50707,50710,50713,3,6,0
14434,6,3,50713,50713,50716,0,3,0
14435,3,2,50716,50716,50718,0,2,0
14436,6,1,50722,50722,50723,0,1,4
14437,4,1,50726,50726,50727,0,1,3
14438,4,3,50730,50730,50733,0,3,3
14439,5,1,50735,50735,50736,0,1,2
14440,5,3,50740,50740,50743,0,3,4
14441,2,2,50742,50743,50745,1,3,0
14442,6,2,50748,50748,50750,0,2,3
14443,6,2,50754,50754,50756,0,2,4
14444,3,2,50757,50757,50759,0,2,1
14445,6,3,50763,50763,50766,0,3,4
14446,1,3,50764,50766,50769,2,5,0
14447,3,2,50767,50769,50771,2,4,0
14448,3,1,50770,50771,50772,1,2,0
14449,5,1,50775,50775,50776,0,1,3
14450,1,2,50776,50776,50778,0,2,0
14451,1,3,50777,50778,50781,1,4,0
14452,1,2,50778,50781,50783,3,5,0
14453,3,3,50781,50783,50786,2,5,0
14454,5,2,50786,50786,50788,0,2,0
14455,2,2,50788,50788,50790,0,2,0
14456,3,3,50791,50791,50794,0,3,1
14457,6,1,50797,50797,50798,0,1,3
14458,6,3,50803,50803,50806,0,3,5
14459,4,2,50807,50807,50809,0,2,1
14460,5,2,50812,50812,50814,0,2,3
14461,2,1,50814,50814,50815,0,1,0
14462,5,1,50819,50819,50820,0,1,4
14463,1,1,50820,50820,50821,0,1,0
14464,5,1,50825,50825,50826,0,1,4
14465,1,2,50826,50826,50828,0,2,0
14466,3,2,50829,50829,50831,0,2,1
14467,1,2,50830,50831,50833,1,3,0
14468,4,3,50834,50834,50837,0,3,1
14469,2,3,50836,50837,50840,1,4,0
14470,5,3,50841,50841,50844,0,3,1
14471,1,2,50842,50844,50846,2,4,0
14472,6,2,50848,50848,50850,0,2,2
14473,2,1,50850,50850,50851,0,1,0
14474,4,2,50854,50854,50856,0,2,3
14475,5,2,50859,50859,50861,0,2,3
14476,3,3,50862,50862,50865,0,3,1
14477,5,1,50867,50867,50868,0,1,2
14478,2,1,50869,50869,50870,0,1,1
14479,2,1,50871,50871,50872,0,1,1
14480,4,2,50875,50875,50877,0,2,3
14481,6,3,50881,50881,50884,0,3,4
14482,3,1,50884,50884,50885,0,1,0
14483,4,1,50888,50888,50889,0,1,3
14484,1,2,50889,50889,50891,0,2,0
14485,4,3,50893,50893,50896,0,3,2
14486,5,1,50898,50898,50899,0,1,2
14487,5,3,50903,50903,50906,0,3,4
14488,5,2,50908,50908,50910,0,2,2
14489,2,3,50910,50910,50913,0,3,0
14490,2,1,50912,50913,50914,1,2,0
14491,2,2,50914,50914,50916,0,2,0
14492,3,3,50917,50917,50920,0,3,1
14493,5,2,50922,50922,50924,0,2,2
14494,5,1,50927,50927,50928,0,1,3
14495,3,2,50930,50930,50932,0,2,2
14496,6,2,50936,50936,50938,0,2,4
14497,6,3,50942,50942,50945,0,3,4
14498,1,3,50943,50945,50948,2,5,0
14499,6,1,50949,50949,50950,0,1,1
14500,2,3,50951,50951,50954,0,3,1
14501,1,2,50952,50954,50956,2,4,0
14502,5,1,50957,50957,50958,0,1,1
14503,3,2,50960,50960,50962,0,2,2
14504,1,2,50961,50962,50964,1,3,0
14505,2,3,50963,50964,50967,1,4,0
14506,5,1,50968,50968,50969,0,1,1
14507,5,3,50973,50973,50976,0,3,4
14508,2,1,50975,50976,50977,1,2,0
14509,4,2,50979,50979,50981,0,2,2
14510,1,3,50980,50981,50984,1,4,0
14511,3,2,50983,50984,50986,1,3,0
14512,6,3,50989,50989,50992,0,3,3
14513,5,1,50994,50994,50995,0,1,2
14514,2,2,50996,50996,50998,0,2,1
14515,4,1,51000,51000,51001,0,1,2
14516,4,2,51004,51004,51006,0,2,3
14517,5,3,51009,51009,51012,0,3,3
14518,1,1,51010,51012,51013,2,3,0
14519,5,1,51015,51015,51016,0,1,2
14520,5,1,51020,51020,51021,0,1,4
14521,1,3,51021,51021,51024,0,3,0
14522,4,3,51025,51025,51028,0,3,1
14523,2,1,51027,51028,51029,1,2,0
14524,3,1,51030,51030,51031,0,1,1
14525,3,1,51033,51033,51034,0,1,2
14526,3,2,51036,51036,51038,0,2,2
14527,1,1,51037,51038,51039,1,2,0
14528,3,3,51040,51040,51043,0,3,1
14529,4,2,51044,51044,51046,0,2,1
14530,3,3,51047,51047,51050,0,3,1
14531,3,1,51050,51050,51051,0,1,0
14532,2,1,51052,51052,51053,0,1,1
14533,6,2,51058,51058,51060,0,2,5
14534,5,2,51063,51063,51065,0,2,3
14535,4,1,51067,51067,51068,0,1,2
14536,4,2,51071,51071,51073,0,2,3
14537,2,1,51073,51073,51074,0,1,0
14538,6,2,51079,51079,51081,0,2,5
14539,1,3,51080,51081,51084,1,4,0
14540,2,3,51082,51084,51087,2,5,0
14541,2,1,51084,51087,51088,3,4,0
14542,6,2,51090,51090,51092,0,2,2
14543,4,1,51094,51094,51095,0,1,2
14544,5,3,51099,51099,51102,0,3,4
14545,2,2,51101,51102,51104,1,3,0
14546,5,3,51106,51106,51109,0,3,2
14547,6,3,51112,51112,51115,0,3,3
14548,6,2,51118,51118,51120,0,2,3
14549,2,2,51120,51120,51122,0,2,0
14550,6,1,51126,51126,51127,0,1,4
14551,1,2,51127,51127,51129,0,2,0
14552,4,2,51131,51131,51133,0,2,2
14553,2,2,51133,51133,51135,0,2,0
14554,3,1,51136,51136,51137,0,1,1
14555,1,1,51137,51137,51138,0,1,0
14556,3,1,51140,51140,51141,0,1,2
14557,4,1,51144,51144,51145,0,1,3
14558,5,3,51149,51149,51152,0,3,4
14559,6,2,51155,51155,51157,0,2,3
14560,5,3,51160,51160,51163,0,3,3
14561,5,3,51165,51165,51168,0,3,2
14562,3,2,51168,51168,51170,0,2,0
14563,2,2,51170,51170,51172,0,2,0
14564,2,2,51172,51172,51174,0,2,0
14565,2,1,51174,51174,51175,0,1,0
14566,6,2,51180,51180,51182,0,2,5
14567,3,2,51183,51183,51185,0,2,1
14568,4,1,51187,51187,51188,0,1,2
14569,5,2,51192,51192,51194,0,2,4
14570,4,3,51196,51196,51199,0,3,2
14571,3,2,51199,51199,51201,0,2,0
14572,3,3,51202,51202,51205,0,3,1
14573,3,2,51205,51205,51207,0,2,0
14574,3,3,51208,51208,51211,0,3,1
14575,1,3,51209,51211,51214,2,5,0
14576,6,3,51215,51215,51218,0,3,1
14577,2,1,51217,51218,51219,1,2,0
14578,3,1,51220,51220,51221,0,1,1
14579,4,2,51224,51224,51226,0,2,3
14580,2,3,51226,51226,51229,0,3,0
14581,5,2,51231,51231,51233,0,2,2
14582,6,1,51237,51237,51238,0,1,4
14583,3,2,51240,51240,51242,0,2,2
14584,4,2,51244,51244,51246,0,2,2
14585,6,3,51250,51250,51253,0,3,4
14586,3,3,51253,51253,51256,0,3,0
14587,5,1,51258,51258,51259,0,1,2
14588,1,3,51259,51259,51262,0,3,0
14589,2,1,51261,51262,51263,1,2,0
14590,5,1,51266,51266,51267,0,1,3
14591,4,1,51270,51270,51271,0,1,3
14592,4,2,51274,51274,51276,0,2,3
14593,4,2,51278,51278,51280,0,2,2
14594,5,2,51283,51283,51285,0,2,3
14595,2,3,51285,51285,51288,0,3,0
14596,3,2,51288,51288,51290,0,2,0
14597,3,2,51291,51291,51293,0,2,1
14598,4,2,51295,51295,51297,0,2,2
14599,2,1,51297,51297,51298,0,1,0
14600,1,1,51298,51298,51299,0,1,0
14601,2,2,51300,51300,51302,0,2,1
14602,2,1,51302,51302,51303,0,1,0
14603,5,3,51307,51307,51310,0,3,4
14604,5,3,51312,51312,51315,0,3,2
14605,2,1,51314,51315,51316,1,2,0
14606,4,1,51318,51318,51319,0,1,2
14607,4,3,51322,51322,51325,0,3,3
14608,5,3,51327,51327,51330,0,3,2
14609,2,3,51329,51330,51333,1,4,0
14610,2,2,51331,51333,51335,2,4,0
14611,5,1,51336,51336,51337,0,1,1
14612,2,2,51338,51338,51340,0,2,1
14613,4,3,51342,51342,51345,0,3,2
14614,6,2,51348,51348,51350,0,2,3
14615,3,3,51351,51351,51354,0,3,1
14616,4,3,51355,51355,51358,0,3,1
14617,5,1,51360,51360,51361,0,1,2
14618,1,1,51361,51361,51362,0,1,0
14619,5,3,51366,51366,51369,0,3,4
14620,3,3,51369,51369,51372,0,3,0
14621,3,1,51372,51372,51373,0,1,0
14622,5,2,51377,51377,51379,0,2,4
14623,2,3,51379,51379,51382,0,3,0
14624,5,3,51384,51384,51387,0,3,2
14625,5,2,51389,51389,51391,0,2,2
14626,4,2,51393,51393,51395,0,2,2
14627,5,1,51398,51398,51399,0,1,3
14628,6,2,51404,51404,51406,0,2,5
14629,2,3,51406,51406,51409,0,3,0
14630,4,1,51410,51410,51411,0,1,1
14631,1,3,51411,51411,51414,0,3,0
14632,6,1,51417,51417,51418,0,1,3
14633,1,2,51418,51418,51420,0,2,0
14634,4,3,51422,51422,51425,0,3,2
14635,1,1,51423,51425,51426,2,3,0
14636,3,3,51426,51426,51429,0,3,0
14637,3,3,51429,51429,51432,0,3,0
14638,4,3,51433,51433,51436,0,3,1
14639,6,3,51439,51439,51442,0,3,3
14640,6,3,51445,51445,51448,0,3,3
14641,3,1,51448,51448,51449,0,1,0
14642,1,1,51449,51449,51450,0,1,0
14643,1,3,51450,51450,51453,0,3,0
14644,4,3,51454,51454,51457,0,3,1
14645,1,3,51455,51457,51460,2,5,0
14646,3,3,51458,51460,51463,2,5,0
14647,4,2,51462,51463,51465,1,3,0
14648,6,3,51468,51468,51471,0,3,3
14649,3,3,51471,51471,51474,0,3,0
14650,2,1,51473,51474,51475,1,2,0
14651,2,1,51475,51475,51476,0,1,0
14652,5,2,51480,51480,51482,0,2,4
14653,6,1,51486,51486,51487,0,1,4
14654,2,2,51488,51488,51490,0,2,1
14655,3,2,51491,51491,51493,0,2,1
14656,4,3,51495,51495,51498,0,3,2
14657,4,3,51499,51499,51502,0,3,1
14658,3,2,51502,51502,51504,0,2,0
14659,3,2,51505,51505,51507,0,2,1
14660,4,3,51509,51509,51512,0,3,2
14661,6,3,51515,51515,51518,0,3,3
14662,5,1,51520,51520,51521,0,1,2
14663,6,3,51526,51526,51529,0,3,5
14664,2,1,51528,51529,51530,1,2,0
14665,5,3,51533,51533,51536,0,3,3
14666,6,1,51539,51539,51540,0,1,3
14667,4,1,51543,51543,51544,0,1,3
14668,3,1,51546,51546,51547,0,1,2
14669,5,3,51551,51551,51554,0,3,4
14670,4,3,51555,51555,51558,0,3,1
14671,6,3,51561,51561,51564,0,3,3
14672,2,2,51563,51564,51566,1,3,0
14673,3,1,51566,51566,51567,0,1,0
14674,3,2,51569,51569,51571,0,2,2
14675,4,1,51573,51573,51574,0,1,2
14676,5,1,51578,51578,51579,0,1,4
14677,5,3,51583,51583,51586,0,3,4
14678,6,3,51589,51589,51592,0,3,3
14679,5,3,51594,51594,51597,0,3,2
14680,5,3,51599,51599,51602,0,3,2
14681,1,3,51600,51602,51605,2,5,0
14682,4,3,51604,51605,51608,1,4,0
14683,1,3,51605,51608,51611,3,6,0
14684,1,1,51606,51611,51612,5,6,0
14685,3,2,51609,51612,51614,3,5,0
14686,3,3,51612,51614,51617,2,5,0
14687,6,2,51618,51618,51620,0,2,1
14688,6,2,51624,51624,51626,0,2,4
14689,4,1,51628,51628,51629,0,1,2
14690,5,2,51633,51633,51635,0,2,4
14691,2,3,51635,51635,51638,0,3,0
14692,3,3,51638,51638,51641,0,3,0
14693,6,2,51644,51644,51646,0,2,3
14694,4,3,51648,51648,51651,0,3,2
14695,6,2,51654,51654,51656,0,2,3
14696,3,3,51657,51657,51660,0,3,1
14697,4,3,51661,51661,51664,0,3,1
14698,4,1,51665,51665,51666,0,1,1
14699,5,1,51670,51670,51671,0,1,4
14700,3,1,51673,51673,51674,0,1,2
14701,5,1,51678,51678,51679,0,1,4
14702,4,1,51682,51682,51683,0,1,3
14703,2,1,51684,51684,51685,0,1,1
14704,4,1,51688,51688,51689,0,1,3
14705,3,2,51691,51691,51693,0,2,2
14706,2,3,51693,51693,51696,0,3,0
14707,6,3,51699,51699,51702,0,3,3
14708,3,2,51702,51702,51704,0,2,0
14709,1,1,51703,51704,51705,1,2,0
14710,4,2,51707,51707,51709,0,2,2
14711,5,1,51712,51712,51713,0,1,3
14712,1,3,51713,51713,51716,0,3,0
14713,3,2,51716,51716,51718,0,2,0
14714,6,3,51722,51722,51725,0,3,4
14715,2,1,51724,51725,51726,1,2,0
14716,1,2,51725,51726,51728,1,3,0
14717,5,3,51730,51730,51733,0,3,2
14718,4,3,51734,51734,51737,0,3,1
14719,5,2,51739,51739,51741,0,2,2
14720,6,1,51745,51745,51746,0,1,4
14721,4,2,51749,51749,51751,0,2,3
14722,4,3,51753,51753,51756,0,3,2
14723,3,1,51756,51756,51757,0,1,0
14724,1,3,51757,51757,51760,0,3,0
14725,2,2,51759,51760,51762,1,3,0
14726,4,2,51763,51763,51765,0,2,1
14727,4,2,51767,51767,51769,0,2,2
14728,2,2,51769,51769,51771,0,2,0
14729,5,2,51774,51774,51776,0,2,3
14730,4,1,51778,51778,51779,0,1,2
14731,5,1,51783,51783,51784,0,1,4
14732,1,1,51784,51784,51785,0,1,0
14733,5,2,51789,51789,51791,0,2,4
14734,3,1,51792,51792,51793,0,1,1
14735,1,2,51793,51793,51795,0,2,0
14736,6,2,51799,51799,51801,0,2,4
14737,4,3,51803,51803,51806,0,3,2
14738,1,1,51804,51806,51807,2,3,0
14739,1,1,51805,51807,51808,2,3,0
14740,3,3,51808,51808,51811,0,3,0
14741,4,1,51812,51812,51813,0,1,1
14742,4,3,51816,51816,51819,0,3,3
14743,5,1,51821,51821,51822,0,1,2
14744,4,2,51825,51825,51827,0,2,3
14745,5,2,51830,51830,51832,0,2,3
14746,3,1,51833,51833,51834,0,1,1
14747,1,2,51834,51834,51836,0,2,0
14748,2,2,51836,51836,51838,0,2,0
14749,2,2,51838,51838,51840,0,2,0
14750,5,2,51843,51843,51845,0,2,3
14751,5,2,51848,51848,51850,0,2,3
14752,2,1,51850,51850,51851,0,1,0
14753,5,2,51855,51855,51857,0,2,4
14754,6,2,51861,51861,51863,0,2,4
14755,5,3,51866,51866,51869,0,3,3
14756,5,2,51871,51871,51873,0,2,2
14757,2,1,51873,51873,51874,0,1,0
14758,4,1,51877,51877,51878,0,1,3
14759,3,1,51880,51880,51881,0,1,2
14760,5,2,51885,51885,51887,0,2,4
14761,3,1,51888,51888,51889,0,1,1
14762,3,3,51891,51891,51894,0,3,2
14763,2,3,51893,51894,51897,1,4,0
14764,2,3,51895,51897,51900,2,5,0
14765,4,1,51899,51900,51901,1,2,0
14766,3,3,51902,51902,51905,0,3,1
14767,4,2,51906,51906,51908,0,2,1
14768,3,1,51909,51909,51910,0,1,1
14769,2,2,51911,51911,51913,0,2,1
14770,3,3,51914,51914,51917,0,3,1
14771,6,1,51920,51920,51921,0,1,3
14772,4,3,51924,51924,51927,0,3,3
14773,5,2,51929,51929,51931,0,2,2
14774,5,2,51934,51934,51936,0,2,3
14775,2,3,51936,51936,51939,0,3,0
14776,6,3,51942,51942,51945,0,3,3
14777,1,3,51943,51945,51948,2,5,0
14778,3,1,51946,51948,51949,2,3,0
14779,2,1,51948,51949,51950,1,2,0
14780,2,2,51950,51950,51952,0,2,0
14781,6,2,51956,51956,51958,0,2,4
14782,6,3,51962,51962,51965,0,3,4
14783,2,3,51964,51965,51968,1,4,0
14784,4,3,51968,51968,51971,0,3,0
14785,5,3,51973,51973,51976,0,3,2
14786,1,3,51974,51976,51979,2,5,0
14787,4,3,51978,51979,51982,1,4,0
14788,4,1,51982,51982,51983,0,1,0
14789,5,3,51987,51987,51990,0,3,4
14790,5,1,51992,51992,51993,0,1,2
14791,6,2,51998,51998,52000,0,2,5
14792,2,3,52000,52000,52003,0,3,0
14793,1,2,52001,52003,52005,2,4,0
14794,4,3,52005,52005,52008,0,3,0
14795,5,1,52010,52010,52011,0,1,2
14796,1,2,52011,52011,52013,0,2,0
14797,2,1,52013,52013,52014,0,1,0
14798,4,1,52017,52017,52018,0,1,3
14799,6,2,52023,52023,52025,0,2,5
14800,1,2,52024,52025,52027,1,3,0
14801,4,2,52028,52028,52030,0,2,1
14802,6,1,52034,52034,52035,0,1,4
14803,3,2,52037,52037,52039,0,2,2
14804,3,2,52040,52040,52042,0,2,1
14805,6,1,52046,52046,52047,0,1,4
14806,2,2,52048,52048,52050,0,2,1
14807,1,2,52049,52050,52052,1,3,0
14808,2,2,52051,52052,52054,1,3,0
14809,2,2,52053,52054,52056,1,3,0
14810,6,3,52059,52059,52062,0,3,3
14811,6,3,52065,52065,52068,0,3,3
14812,3,3,52068,52068,52071,0,3,0
14813,5,1,52073,52073,52074,0,1,2
14814,1,1,52074,52074,52075,0,1,0
14815,3,1,52077,52077,52078,0,1,2
14816,2,2,52079,52079,52081,0,2,1
14817,2,3,52081,52081,52084,0,3,0
14818,3,2,52084,52084,52086,0,2,0
14819,3,3,52087,52087,52090,0,3,1
14820,2,2,52089,52090,52092,1,3,0
14821,4,2,52093,52093,52095,0,2,1
14822,1,1,52094,52095,52096,1,2,0
14823,2,2,52096,52096,52098,0,2,0
14824,3,1,52099,52099,52100,0,1,1
14825,2,1,52101,52101,52102,0,1,1
14826,2,1,52103,52103,52104,0,1,1
14827,1,3,52104,52104,52107,0,3,0
14828,2,1,52106,52107,52108,1,2,0
14829,5,2,52111,52111,52113,0,2,3
14830,5,2,52116,52116,52118,0,2,3
14831,2,1,52118,52118,52119,0,1,0
14832,5,1,52123,52123,52124,0,1,4
14833,5,2,52128,52128,52130,0,2,4
14834,1,2,52129,52130,52132,1,3,0
14835,4,2,52133,52133,52135,0,2,1
14836,6,1,52139,52139,52140,0,1,4
14837,3,3,52142,52142,52145,0,3,2
14838,4,3,52146,52146,52149,0,3,1
14839,6,2,52152,52152,52154,0,2,3
14840,1,3,52153,52154,52157,1,4,0
14841,5,3,52158,52158,52161,0,3,1
14842,2,2,52160,52161,52163,1,3,0
14843,6,1,52166,52166,52167,0,1,3
14844,1,1,52167,52167,52168,0,1,0
14845,6,2,52173,52173,52175,0,2,5
14846,4,3,52177,52177,52180,0,3,2
14847,5,2,52182,52182,52184,0,2,2
14848,1,3,52183,52184,52187,1,4,0
14849,1,2,52184,52187,52189,3,5,0
14850,4,2,52188,52189,52191,1,3,0
14851,1,1,52189,52191,52192,2,3,0
14852,1,2,52190,52192,52194,2,4,0
14853,5,2,52195,52195,52197,0,2,1
14854,4,2,52199,52199,52201,0,2,2
14855,4,1,52203,52203,52204,0,1,2
14856,2,3,52205,52205,52208,0,3,1
14857,6,2,52211,52211,52213,0,2,3
14858,4,1,52215,52215,52216,0,1,2
14859,4,2,52219,52219,52221,0,2,3
14860,6,2,52225,52225,52227,0,2,4
14861,1,1,52226,52227,52228,1,2,0
14862,4,2,52230,52230,52232,0,2,2
14863,3,2,52233,52233,52235,0,2,1
14864,3,2,52236,52236,52238,0,2,1
14865,5,2,52241,52241,52243,0,2,3
14866,5,1,52246,52246,52247,0,1,3
14867,2,3,52248,52248,52251,0,3,1
14868,4,2,52252,52252,52254,0,2,1
14869,1,3,52253,52254,52257,1,4,0
14870,5,1,52258,52258,52259,0,1,1
14871,5,3,52263,52263,52266,0,3,4
14872,1,3,52264,52266,52269,2,5,0
14873,1,2,52265,52269,52271,4,6,0
14874,3,3,52268,52271,52274,3,6,0
14875,1,3,52269,52274,52277,5,8,0
14876,4,1,52273,52277,52278,4,5,0
14877,6,2,52279,52279,52281,0,2,1
14878,6,1,52285,52285,52286,0,1,4
14879,6,3,52291,52291,52294,0,3,5
14880,2,1,52293,52294,52295,1,2,0
14881,1,1,52294,52295,52296,1,2,0
14882,1,2,52295,52296,52298,1,3,0
14883,4,2,52299,52299,52301,0,2,1
14884,1,2,52300,52301,52303,1,3,0
14885,5,1,52305,52305,52306,0,1,2
14886,2,2,52307,52307,52309,0,2,1
14887,6,1,52313,52313,52314,0,1,4
14888,2,2,52315,52315,52317,0,2,1
14889,1,1,52316,52317,52318,1,2,0
14890,1,2,52317,52318,52320,1,3,0
14891,1,3,52318,52320,52323,2,5,0
14892,2,2,52320,52323,52325,3,5,0
14893,1,2,52321,52325,52327,4,6,0
14894,6,1,52327,52327,52328,0,1,0
14895,1,2,52328,52328,52330,0,2,0
14896,2,3,52330,52330,52333,0,3,0
14897,6,2,52336,52336,52338,0,2,3
14898,6,2,52342,52342,52344,0,2,4
14899,3,1,52345,52345,52346,0,1,1
14900,4,3,52349,52349,52352,0,3,3
14901,6,1,52355,52355,52356,0,1,3
14902,2,2,52357,52357,52359,0,2,1
14903,4,2,52361,52361,52363,0,2,2
14904,3,1,52364,52364,52365,0,1,1
14905,4,1,52368,52368,52369,0,1,3
14906,5,2,52373,52373,52375,0,2,4
14907,1,2,52374,52375,52377,1,3,0
14908,4,1,52378,52378,52379,0,1,1
14909,1,2,52379,52379,52381,0,2,0
14910,3,1,52382,52382,52383,0,1,1
14911,5,2,52387,52387,52389,0,2,4
14912,3,3,52390,52390,52393,0,3,1
14913,5,3,52395,52395,52398,0,3,2
14914,1,1,52396,52398,52399,2,3,0
14915,4,3,52400,52400,52403,0,3,1
14916,6,3,52406,52406,52409,0,3,3
14917,4,3,52410,52410,52413,0,3,1
14918,4,3,52414,52414,52417,0,3,1
14919,3,1,52417,52417,52418,0,1,0
14920,1,3,52418,52418,52421,0,3,0
14921,6,1,52424,52424,52425,0,1,3
14922,5,1,52429,52429,52430,0,1,4
14923,2,2,52431,52431,52433,0,2,1
14924,5,3,52436,52436,52439,0,3,3
14925,6,2,52442,52442,52444,0,2,3
14926,3,2,52445,52445,52447,0,2,1
14927,5,3,52450,52450,52453,0,3,3
14928,3,1,52453,52453,52454,0,1,0
14929,3,1,52456,52456,52457,0,1,2
14930,6,3,52462,52462,52465,0,3,5
14931,3,3,52465,52465,52468,0,3,0
14932,4,3,52469,52469,52472,0,3,1
14933,5,1,52474,52474,52475,0,1,2
14934,1,3,52475,52475,52478,0,3,0
14935,4,2,52479,52479,52481,0,2,1
14936,5,1,52484,52484,52485,0,1,3
14937,4,1,52488,52488,52489,0,1,3
14938,2,2,52490,52490,52492,0,2,1
14939,6,3,52496,52496,52499,0,3,4
14940,1,3,52497,52499,52502,2,5,0
14941,6,1,52503,52503,52504,0,1,1
14942,1,2,52504,52504,52506,0,2,0
14943,6,1,52510,52510,52511,0,1,4
14944,4,1,52514,52514,52515,0,1,3
14945,1,2,52515,52515,52517,0,2,0
14946,3,2,52518,52518,52520,0,2,1
14947,3,2,52521,52521,52523,0,2,1
14948,6,2,52527,52527,52529,0,2,4
14949,1,2,52528,52529,52531,1,3,0
14950,2,1,52530,52531,52532,1,2,0
14951,2,2,52532,52532,52534,0,2,0
14952,1,2,52533,52534,52536,1,3,0
14953,2,1,52535,52536,52537,1,2,0
14954,2,1,52537,52537,52538,0,1,0
14955,3,3,52540,52540,52543,0,3,2
14956,5,3,52545,52545,52548,0,3,2
14957,2,1,52547,52548,52549,1,2,0
14958,4,2,52551,52551,52553,0,2,2
14959,3,2,52554,52554,52556,0,2,1
14960,6,2,52560,52560,52562,0,2,4
14961,1,2,52561,52562,52564,1,3,0
14962,6,1,52567,52567,52568,0,1,3
14963,4,3,52571,52571,52574,0,3,3
14964,4,3,52575,52575,52578,0,3,1
14965,5,3,52580,52580,52583,0,3,2
14966,1,2,52581,52583,52585,2,4,0
14967,3,1,52584,52585,52586,1,2,0
14968,2,3,52586,52586,52589,0,3,0
14969,5,3,52591,52591,52594,0,3,2
14970,3,3,52594,52594,52597,0,3,0
14971,4,3,52598,52598,52601,0,3,1
14972,6,3,52604,52604,52607,0,3,3
14973,2,1,52606,52607,52608,1,2,0
14974,1,1,52607,52608,52609,1,2,0
14975,2,2,52609,52609,52611,0,2,0
14976,6,2,52615,52615,52617,0,2,4
14977,2,1,52617,52617,52618,0,1,0
14978,2,2,52619,52619,52621,0,2,1
14979,3,1,52622,52622,52623,0,1,1
14980,4,2,52626,52626,52628,0,2,3
14981,3,3,52629,52629,52632,0,3,1
14982,4,3,52633,52633,52636,0,3,1
14983,2,3,52635,52636,52639,1,4,0
14984,4,2,52639,52639,52641,0,2,0
14985,3,3,52642,52642,52645,0,3,1
14986,2,3,52644,52645,52648,1,4,0
14987,4,3,52648,52648,52651,0,3,0
14988,3,3,52651,52651,52654,0,3,0
14989,1,3,52652,52654,52657,2,5,0
14990,6,2,52658,52658,52660,0,2,1
14991,2,2,52660,52660,52662,0,2,0
14992,6,3,52666,52666,52669,0,3,4
14993,1,1,52667,52669,52670,2,3,0
14994,6,3,52673,52673,52676,0,3,3
14995,1,2,52674,52676,52678,2,4,0
14996,1,1,52675,52678,52679,3,4,0
14997,6,2,52681,52681,52683,0,2,2
14998,4,1,52685,52685,52686,0,1,2
14999,5,2,52690,52690,52692,0,2,4
15000,3,1,52693,52693,52694,0,1,1
15001,2,1,52695,52695,52696,0,1,1
15002,2,2,52697,52697,52699,0,2,1
15003,1,2,52698,52699,52701,1,3,0
15004,2,3,52700,52701,52704,1,4,0
15005,1,1,52701,52704,52705,3,4,0
15006,6,2,52707,52707,52709,0,2,2
15007,6,2,52713,52713,52715,0,2,4
15008,2,1,52715,52715,52716,0,1,0
15009,4,2,52719,52719,52721,0,2,3
15010,5,1,52724,52724,52725,0,1,3
15011,3,2,52727,52727,52729,0,2,2
15012,3,3,52730,52730,52733,0,3,1
15013,2,1,52732,52733,52734,1,2,0
15014,5,2,52737,52737,52739,0,2,3
15015,5,1,52742,52742,52743,0,1,3
15016,6,3,52748,52748,52751,0,3,5
15017,5,3,52753,52753,52756,0,3,2
15018,2,2,52755,52756,52758,1,3,0
15019,6,3,52761,52761,52764,0,3,3
15020,5,1,52766,52766,52767,0,1,2
15021,3,2,52769,52769,52771,0,2,2
15022,3,3,52772,52772,52775,0,3,1
15023,1,1,52773,52775,52776,2,3,0
15024,4,2,52777,52777,52779,0,2,1
15025,3,1,52780,52780,52781,0,1,1
15026,3,3,52783,52783,52786,0,3,2
15027,5,3,52788,52788,52791,0,3,2
15028,5,1,52793,52793,52794,0,1,2
15029,1,3,52794,52794,52797,0,3,0
15030,3,3,52797,52797,52800,0,3,0
15031,4,3,52801,52801,52804,0,3,1
15032,2,1,52803,52804,52805,1,2,0
15033,1,1,52804,52805,52806,1,2,0
15034,2,1,52806,52806,52807,0,1,0
15035,1,3,52807,52807,52810,0,3,0
15036,4,2,52811,52811,52813,0,2,1
15037,2,1,52813,52813,52814,0,1,0
15038,4,1,52817,52817,52818,0,1,3
15039,4,3,52821,52821,52824,0,3,3
15040,2,2,52823,52824,52826,1,3,0
15041,4,2,52827,52827,52829,0,2,1
15042,1,1,52828,52829,52830,1,2,0
15043,5,3,52833,52833,52836,0,3,3
15044,4,1,52837,52837,52838,0,1,1
15045,5,2,52842,52842,52844,0,2,4
15046,5,3,52847,52847,52850,0,3,3
15047,4,2,52851,52851,52853,0,2,1
15048,5,2,52856,52856,52858,0,2,3
15049,2,1,52858,52858,52859,0,1,0
15050,6,3,52864,52864,52867,0,3,5
15051,2,1,52866,52867,52868,1,2,0
15052,1,2,52867,52868,52870,1,3,0
15053,3,1,52870,52870,52871,0,1,0
15054,3,3,52873,52873,52876,0,3,2
15055,1,2,52874,52876,52878,2,4,0
15056,1,2,52875,52878,52880,3,5,0
15057,5,3,52880,52880,52883,0,3,0
15058,3,2,52883,52883,52885,0,2,0
15059,6,2,52889,52889,52891,0,2,4
15060,6,2,52895,52895,52897,0,2,4
15061,4,2,52899,52899,52901,0,2,2
15062,6,2,52905,52905,52907,0,2,4
15063,4,2,52909,52909,52911,0,2,2
15064,6,1,52915,52915,52916,0,1,4
15065,5,3,52920,52920,52923,0,3,4
15066,4,2,52924,52924,52926,0,2,1
15067,4,2,52928,52928,52930,0,2,2
15068,4,2,52932,52932,52934,0,2,2
15069,2,1,52934,52934,52935,0,1,0
15070,3,1,52937,52937,52938,0,1,2
15071,1,1,52938,52938,52939,0,1,0
15072,6,3,52944,52944,52947,0,3,5
15073,2,2,52946,52947,52949,1,3,0
15074,3,3,52949,52949,52952,0,3,0
15075,4,2,52953,52953,52955,0,2,1
15076,5,3,52958,52958,52961,0,3,3
15077,1,1,52959,52961,52962,2,3,0
15078,4,2,52963,52963,52965,0,2,1
15079,3,3,52966,52966,52969,0,3,1
15080,4,3,52970,52970,52973,0,3,1
15081,3,3,52973,52973,52976,0,3,0
15082,2,1,52975,52976,52977,1,2,0
15083,2,1,52977,52977,52978,0,1,0
15084,1,3,52978,52978,52981,0,3,0
15085,6,2,52984,52984,52986,0,2,3
15086,3,2,52987,52987,52989,0,2,1
15087,2,1,52989,52989,52990,0,1,0
15088,3,3,52992,52992,52995,0,3,2
15089,4,3,52996,52996,52999,0,3,1
15090,2,1,52998,52999,53000,1,2,0
15091,2,1,53000,53000,53001,0,1,0
15092,6,1,53006,53006,53007,0,1,5
15093,3,1,53009,53009,53010,0,1,2
15094,4,1,53013,53013,53014,0,1,3
15095,6,3,53019,53019,53022,0,3,5
15096,1,3,53020,53022,53025,2,5,0
15097,5,2,53025,53025,53027,0,2,0
15098,6,2,53031,53031,53033,0,2,4
15099,5,3,53036,53036,53039,0,3,3
15100,2,2,53038,53039,53041,1,3,0
15101,5,1,53043,53043,53044,0,1,2
15102,6,2,53049,53049,53051,0,2,5
15103,6,3,53055,53055,53058,0,3,4
15104,6,3,53061,53061,53064,0,3,3
15105,4,3,53065,53065,53068,0,3,1
15106,6,1,53071,53071,53072,0,1,3
15107,1,1,53072,53072,53073,0,1,0
15108,3,2,53075,53075,53077,0,2,2
15109,2,2,53077,53077,53079,0,2,0
15110,5,2,53082,53082,53084,0,2,3
15111,1,1,53083,53084,53085,1,2,0
15112,2,1,53085,53085,53086,0,1,0
15113,6,3,53091,53091,53094,0,3,5
15114,6,2,53097,53097,53099,0,2,3
15115,1,3,53098,53099,53102,1,4,0
15116,1,1,53099,53102,53103,3,4,0
15117,1,3,53100,53103,53106,3,6,0
15118,4,3,53104,53106,53109,2,5,0
15119,3,1,53107,53109,53110,2,3,0
15120,6,2,53113,53113,53115,0,2,3
15121,5,2,53118,53118,53120,0,2,3
15122,3,2,53121,53121,53123,0,2,1
15123,2,1,53123,53123,53124,0,1,0
15124,6,1,53129,53129,53130,0,1,5
15125,1,3,53130,53130,53133,0,3,0
15126,2,2,53132,53133,53135,1,3,0
15127,4,3,53136,53136,53139,0,3,1
15128,3,1,53139,53139,53140,0,1,0
15129,3,3,53142,53142,53145,0,3,2
15130,1,2,53143,53145,53147,2,4,0
15131,1,3,53144,53147,53150,3,6,0
15132,5,3,53149,53150,53153,1,4,0
15133,6,1,53155,53155,53156,0,1,2
15134,6,2,53161,53161,53163,0,2,5
15135,4,1,53165,53165,53166,0,1,2
15136,2,3,53167,53167,53170,0,3,1
15137,1,1,53168,53170,53171,2,3,0
15138,6,2,53174,53174,53176,0,2,3
15139,4,3,53178,53178,53181,0,3,2
15140,4,1,53182,53182,53183,0,1,1
15141,3,3,53185,53185,53188,0,3,2
15142,2,1,53187,53188,53189,1,2,0
15143,4,2,53191,53191,53193,0,2,2
15144,1,3,53192,53193,53196,1,4,0
15145,1,3,53193,53196,53199,3,6,0
15146,3,2,53196,53199,53201,3,5,0
15147,3,1,53199,53201,53202,2,3,0
15148,6,2,53205,53205,53207,0,2,3
15149,4,2,53209,53209,53211,0,2,2
15150,2,3,53211,53211,53214,0,3,0
15151,3,3,53214,53214,53217,0,3,0
15152,6,2,53220,53220,53222,0,2,3
15153,5,2,53225,53225,53227,0,2,3
15154,6,2,53231,53231,53233,0,2,4
15155,6,1,53237,53237,53238,0,1,4
15156,2,2,53239,53239,53241,0,2,1
15157,1,1,53240,53241,53242,1,2,0
15158,1,3,53241,53242,53245,1,4,0
15159,4,3,53245,53245,53248,0,3,0
15160,5,1,53250,53250,53251,0,1,2
15161,2,3,53252,53252,53255,0,3,1
15162,2,2,53254,53255,53257,1,3,0
15163,2,3,53256,53257,53260,1,4,0
15164,3,2,53259,53260,53262,1,3,0
15165,2,2,53261,53262,53264,1,3,0
15166,4,3,53265,53265,53268,0,3,1
15167,5,3,53270,53270,53273,0,3,2
15168,5,3,53275,53275,53278,0,3,2
15169,6,1,53281,53281,53282,0,1,3
15170,3,3,53284,53284,53287,0,3,2
15171,5,3,53289,53289,53292,0,3,2
15172,1,3,53290,53292,53295,2,5,0
15173,1,3,53291,53295,53298,4,7,0
15174,2,2,53293,53298,53300,5,7,0
15175,2,3,53295,53300,53303,5,8,0
15176,4,3,53299,53303,53306,4,7,0
15177,4,1,53303,53306,53307,3,4,0
15178,4,2,53307,53307,53309,0,2,0
15179,2,1,53309,53309,53310,0,1,0
15180,2,3,53311,53311,53314,0,3,1
15181,4,3,53315,53315,53318,0,3,1
15182,3,1,53318,53318,53319,0,1,0
15183,6,3,53324,53324,53327,0,3,5
15184,6,3,53330,53330,53333,0,3,3
15185,3,1,53333,53333,53334,0,1,0
15186,6,2,53339,53339,53341,0,2,5
15187,3,1,53342,53342,53343,0,1,1
15188,5,2,53347,53347,53349,0,2,4
15189,4,1,53351,53351,53352,0,1,2
15190,6,1,53357,53357,53358,0,1,5
15191,1,3,53358,53358,53361,0,3,0
15192,3,2,53361,53361,53363,0,2,0
15193,5,2,53366,53366,53368,0,2,3
15194,5,2,53371,53371,53373,0,2,3
15195,2,1,53373,53373,53374,0,1,0
15196,4,2,53377,53377,53379,0,2,3
15197,4,2,53381,53381,53383,0,2,2
15198,3,1,53384,53384,53385,0,1,1
15199,4,2,53388,53388,53390,0,2,3
15200,6,3,53394,53394,53397,0,3,4
15201,2,1,53396,53397,53398,1,2,0
15202,2,1,53398,53398,53399,0,1,0
15203,5,2,53403,53403,53405,0,2,4
15204,4,3,53407,53407,53410,0,3,2
15205,1,3,53408,53410,53413,2,5,0
15206,5,1,53413,53413,53414,0,1,0
15207,3,2,53416,53416,53418,0,2,2
15208,2,3,53418,53418,53421,0,3,0
15209,5,1,53423,53423,53424,0,1,2
15210,6,2,53429,53429,53431,0,2,5
15211,6,1,53435,53435,53436,0,1,4
15212,1,3,53436,53436,53439,0,3,0
15213,2,1,53438,53439,53440,1,2,0
15214,3,2,53441,53441,53443,0,2,1
15215,5,3,53446,53446,53449,0,3,3
15216,5,1,53451,53451,53452,0,1,2
15217,4,1,53455,53455,53456,0,1,3
15218,2,1,53457,53457,53458,0,1,1
15219,5,1,53462,53462,53463,0,1,4
15220,6,1,53468,53468,53469,0,1,5
15221,5,1,53473,53473,53474,0,1,4
15222,3,1,53476,53476,53477,0,1,2
15223,1,1,53477,53477,53478,0,1,0
15224,4,1,53481,53481,53482,0,1,3
15225,6,1,53487,53487,53488,0,1,5
15226,2,3,53489,53489,53492,0,3,1
15227,4,1,53493,53493,53494,0,1,1
15228,1,2,53494,53494,53496,0,2,0
15229,1,2,53495,53496,53498,1,3,0
15230,1,3,53496,53498,53501,2,5,0
15231,3,1,53499,53501,53502,2,3,0
15232,6,3,53505,53505,53508,0,3,3
15233,4,1,53509,53509,53510,0,1,1
15234,4,2,53513,53513,53515,0,2,3
15235,3,2,53516,53516,53518,0,2,1
15236,3,3,53519,53519,53522,0,3,1
15237,3,1,53522,53522,53523,0,1,0
15238,2,3,53524,53524,53527,0,3,1
15239,4,3,53528,53528,53531,0,3,1
15240,3,1,53531,53531,53532,0,1,0
15241,6,1,53537,53537,53538,0,1,5
15242,3,3,53540,53540,53543,0,3,2
15243,6,2,53546,53546,53548,0,2,3
15244,6,3,53552,53552,53555,0,3,4
15245,4,2,53556,53556,53558,0,2,1
15246,4,1,53560,53560,53561,0,1,2
15247,3,3,53563,53563,53566,0,3,2
15248,1,3,53564,53566,53569,2,5,0
15249,3,2,53567,53569,53571,2,4,0
15250,1,3,53568,53571,53574,3,6,0
15251,5,1,53573,53574,53575,1,2,0
15252,1,3,53574,53575,53578,1,4,0
15253,3,3,53577,53578,53581,1,4,0
15254,3,1,53580,53581,53582,1,2,0
15255,2,1,53582,53582,53583,0,1,0
15256,3,3,53585,53585,53588,0,3,2
15257,4,1,53589,53589,53590,0,1,1
15258,5,3,53594,53594,53597,0,3,4
15259,3,3,53597,53597,53600,0,3,0
15260,2,1,53599,53600,53601,1,2,0
15261,2,2,53601,53601,53603,0,2,0
15262,1,2,53602,53603,53605,1,3,0
15263,4,1,53606,53606,53607,0,1,1
15264,3,1,53609,53609,53610,0,1,2
15265,1,1,53610,53610,53611,0,1,0
15266,3,2,53613,53613,53615,0,2,2
15267,3,1,53616,53616,53617,0,1,1
15268,3,1,53619,53619,53620,0,1,2
15269,4,2,53623,53623,53625,0,2,3
15270,3,2,53626,53626,53628,0,2,1
15271,1,2,53627,53628,53630,1,3,0
15272,3,3,53630,53630,53633,0,3,0
15273,5,1,53635,53635,53636,0,1,2
15274,2,2,53637,53637,53639,0,2,1
15275,2,1,53639,53639,53640,0,1,0
15276,5,1,53644,53644,53645,0,1,4
15277,3,3,53647,53647,53650,0,3,2
15278,5,2,53652,53652,53654,0,2,2
15279,2,3,53654,53654,53657,0,3,0
15280,2,2,53656,53657,53659,1,3,0
15281,1,2,53657,53659,53661,2,4,0
15282,4,2,53661,53661,53663,0,2,0
15283,5,1,53666,53666,53667,0,1,3
15284,1,3,53667,53667,53670,0,3,0
15285,1,2,53668,53670,53672,2,4,0
15286,5,3,53673,53673,53676,0,3,1
15287,3,1,53676,53676,53677,0,1,0
15288,2,1,53678,53678,53679,0,1,1
15289,2,3,53680,53680,53683,0,3,1
15290,4,2,53684,53684,53686,0,2,1
15291,3,1,53687,53687,53688,0,1,1
15292,4,1,53691,53691,53692,0,1,3
15293,6,1,53697,53697,53698,0,1,5
15294,4,2,53701,53701,53703,0,2,3
15295,1,2,53702,53703,53705,1,3,0
15296,6,1,53708,53708,53709,0,1,3
15297,2,1,53710,53710,53711,0,1,1
15298,6,3,53716,53716,53719,0,3,5
15299,4,3,53720,53720,53723,0,3,1
15300,2,3,53722,53723,53726,1,4,0
15301,1,1,53723,53726,53727,3,4,0
15302,2,3,53725,53727,53730,2,5,0
15303,2,3,53727,53730,53733,3,6,0
15304,5,3,53732,53733,53736,1,4,0
15305,6,3,53738,53738,53741,0,3,2
15306,3,3,53741,53741,53744,0,3,0
15307,3,1,53744,53744,53745,0,1,0
15308,2,1,53746,53746,53747,0,1,1
15309,2,1,53748,53748,53749,0,1,1
15310,1,1,53749,53749,53750,0,1,0
15311,6,3,53755,53755,53758,0,3,5
15312,4,2,53759,53759,53761,0,2,1
15313,3,1,53762,53762,53763,0,1,1
15314,1,2,53763,53763,53765,0,2,0
15315,5,3,53768,53768,53771,0,3,3
15316,4,2,53772,53772,53774,0,2,1
15317,3,3,53775,53775,53778,0,3,1
15318,6,3,53781,53781,53784,0,3,3
15319,5,3,53786,53786,53789,0,3,2
15320,5,1,53791,53791,53792,0,1,2
15321,6,1,53797,53797,53798,0,1,5
15322,1,2,53798,53798,53800,0,2,0
15323,3,3,53801,53801,53804,0,3,1
15324,1,1,53802,53804,53805,2,3,0
15325,2,1,53804,53805,53806,1,2,0
15326,3,3,53807,53807,53810,0,3,1
15327,3,2,53810,53810,53812,0,2,0
15328,6,2,53816,53816,53818,0,2,4
15329,5,1,53821,53821,53822,0,1,3
15330,2,2,53823,53823,53825,0,2,1
15331,1,1,53824,53825,53826,1,2,0
15332,1,1,53825,53826,53827,1,2,0
15333,5,2,53830,53830,53832,0,2,3
15334,6,3,53836,53836,53839,0,3,4
15335,2,1,53838,53839,53840,1,2,0
15336,1,2,53839,53840,53842,1,3,0
15337,6,2,53845,53845,53847,0,2,3
15338,4,2,53849,53849,53851,0,2,2
15339,2,3,53851,53851,53854,0,3,0
15340,5,2,53856,53856,53858,0,2,2
15341,5,2,53861,53861,53863,0,2,3
15342,4,1,53865,53865,53866,0,1,2
15343,1,1,53866,53866,53867,0,1,0
15344,4,2,53870,53870,53872,0,2,3
15345,1,1,53871,53872,53873,1,2,0
15346,2,2,53873,53873,53875,0,2,0
15347,4,3,53877,53877,53880,0,3,2
15348,2,2,53879,53880,53882,1,3,0
15349,2,2,53881,53882,53884,1,3,0
15350,6,3,53887,53887,53890,0,3,3
15351,5,3,53892,53892,53895,0,3,2
15352,4,3,53896,53896,53899,0,3,1
15353,3,3,53899,53899,53902,0,3,0
15354,6,1,53905,53905,53906,0,1,3
15355,5,1,53910,53910,53911,0,1,4
15356,3,2,53913,53913,53915,0,2,2
15357,4,1,53917,53917,53918,0,1,2
15358,1,3,53918,53918,53921,0,3,0
15359,2,1,53920,53921,53922,1,2,0
15360,4,2,53924,53924,53926,0,2,2
15361,1,3,53925,53926,53929,1,4,0
15362,4,3,53929,53929,53932,0,3,0
15363,2,3,53931,53932,53935,1,4,0
15364,4,1,53935,53935,53936,0,1,0
15365,3,3,53938,53938,53941,0,3,2
15366,1,2,53939,53941,53943,2,4,0
15367,3,2,53942,53943,53945,1,3,0
15368,4,2,53946,53946,53948,0,2,1
15369,6,3,53952,53952,53955,0,3,4
15370,2,1,53954,53955,53956,1,2,0
15371,2,3,53956,53956,53959,0,3,0
15372,1,2,53957,53959,53961,2,4,0
15373,1,3,53958,53961,53964,3,6,0
15374,5,2,53963,53964,53966,1,3,0
15375,6,3,53969,53969,53972,0,3,3
15376,4,2,53973,53973,53975,0,2,1
15377,2,2,53975,53975,53977,0,2,0
15378,5,3,53980,53980,53983,0,3,3
15379,6,2,53986,53986,53988,0,2,3
15380,1,1,53987,53988,53989,1,2,0
15381,6,3,53993,53993,53996,0,3,4
15382,6,1,53999,53999,54000,0,1,3
15383,5,1,54004,54004,54005,0,1,4
15384,1,3,54005,54005,54008,0,3,0
15385,4,3,54009,54009,54012,0,3,1
15386,4,2,54013,54013,54015,0,2,1
15387,3,3,54016,54016,54019,0,3,1
15388,4,1,54020,54020,54021,0,1,1
15389,3,2,54023,54023,54025,0,2,2
15390,4,1,54027,54027,54028,0,1,2
15391,6,1,54033,54033,54034,0,1,5
15392,4,2,54037,54037,54039,0,2,3
15393,3,2,54040,54040,54042,0,2,1
15394,1,2,54041,54042,54044,1,3,0
15395,5,2,54046,54046,54048,0,2,2
15396,3,1,54049,54049,54050,0,1,1
15397,1,2,54050,54050,54052,0,2,0
15398,6,3,54056,54056,54059,0,3,4
15399,6,1,54062,54062,54063,0,1,3
15400,5,2,54067,54067,54069,0,2,4
15401,4,1,54071,54071,54072,0,1,2
15402,6,3,54077,54077,54080,0,3,5
15403,6,3,54083,54083,54086,0,3,3
15404,1,3,54084,54086,54089,2,5,0
15405,5,3,54089,54089,54092,0,3,0
15406,6,2,54095,54095,54097,0,2,3
15407,1,2,54096,54097,54099,1,3,0
15408,6,2,54102,54102,54104,0,2,3
15409,4,3,54106,54106,54109,0,3,2
15410,5,3,54111,54111,54114,0,3,2
15411,6,2,54117,54117,54119,0,2,3
15412,3,1,54120,54120,54121,0,1,1
15413,3,2,54123,54123,54125,0,2,2
15414,1,3,54124,54125,54128,1,4,0
15415,1,2,54125,54128,54130,3,5,0
15416,5,2,54130,54130,54132,0,2,0
15417,3,1,54133,54133,54134,0,1,1
15418,5,3,54138,54138,54141,0,3,4
15419,3,2,54141,54141,54143,0,2,0
15420,4,3,54145,54145,54148,0,3,2
15421,4,3,54149,54149,54152,0,3,1
15422,3,3,54152,54152,54155,0,3,0
15423,5,1,54157,54157,54158,0,1,2
15424,3,3,54160,54160,54163,0,3,2
15425,4,3,54164,54164,54167,0,3,1
15426,2,2,54166,54167,54169,1,3,0
15427,5,2,54171,54171,54173,0,2,2
15428,3,1,54174,54174,54175,0,1,1
15429,6,2,54180,54180,54182,0,2,5
15430,4,1,54184,54184,54185,0,1,2
15431,4,1,54188,54188,54189,0,1,3
15432,5,2,54193,54193,54195,0,2,4
15433,5,2,54198,54198,54200,0,2,3
15434,2,3,54200,54200,54203,0,3,0
15435,6,3,54206,54206,54209,0,3,3
15436,4,1,54210,54210,54211,0,1,1
15437,6,3,54216,54216,54219,0,3,5
15438,6,2,54222,54222,54224,0,2,3
15439,3,3,54225,54225,54228,0,3,1
15440,6,2,54231,54231,54233,0,2,3
15441,5,1,54236,54236,54237,0,1,3
15442,3,2,54239,54239,54241,0,2,2
15443,3,2,54242,54242,54244,0,2,1
15444,6,2,54248,54248,54250,0,2,4
15445,2,1,54250,54250,54251,0,1,0
15446,4,1,54254,54254,54255,0,1,3
15447,3,1,54257,54257,54258,0,1,2
15448,6,3,54263,54263,54266,0,3,5
15449,6,1,54269,54269,54270,0,1,3
15450,5,2,54274,54274,54276,0,2,4
15451,4,2,54278,54278,54280,0,2,2
15452,5,2,54283,54283,54285,0,2,3
15453,3,2,54286,54286,54288,0,2,1
15454,4,2,54290,54290,54292,0,2,2
15455,1,3,54291,54292,54295,1,4,0
15456,2,3,54293,54295,54298,2,5,0
15457,5,1,54298,54298,54299,0,1,0
15458,2,2,54300,54300,54302,0,2,1
15459,5,2,54305,54305,54307,0,2,3
15460,5,2,54310,54310,54312,0,2,3
15461,2,1,54312,54312,54313,0,1,0
15462,6,1,54318,54318,54319,0,1,5
15463,4,2,54322,54322,54324,0,2,3
15464,5,1,54327,54327,54328,0,1,3
15465,6,2,54333,54333,54335,0,2,5
15466,4,1,54337,54337,54338,0,1,2
15467,3,3,54340,54340,54343,0,3,2
15468,1,1,54341,54343,54344,2,3,0
15469,2,1,54343,54344,54345,1,2,0
15470,6,2,54349,54349,54351,0,2,4
15471,4,1,54353,54353,54354,0,1,2
15472,5,3,54358,54358,54361,0,3,4
15473,4,2,54362,54362,54364,0,2,1
15474,6,3,54368,54368,54371,0,3,4
15475,1,3,54369,54371,54374,2,5,0
15476,4,1,54373,54374,54375,1,2,0
15477,5,2,54378,54378,54380,0,2,3
15478,5,1,54383,54383,54384,0,1,3
15479,4,1,54387,54387,54388,0,1,3
15480,6,1,54393,54393,54394,0,1,5
15481,5,2,54398,54398,54400,0,2,4
15482,5,3,54403,54403,54406,0,3,3
15483,3,3,54406,54406,54409,0,3,0
15484,5,3,54411,54411,54414,0,3,2
15485,5,1,54416,54416,54417,0,1,2
15486,5,3,54421,54421,54424,0,3,4
15487,2,2,54423,54424,54426,1,3,0
15488,1,1,54424,54426,54427,2,3,0
15489,2,3,54426,54427,54430,1,4,0
15490,2,1,54428,54430,54431,2,3,0
15491,5,1,54433,54433,54434,0,1,2
15492,1,1,54434,54434,54435,0,1,0
15493,6,1,54440,54440,54441,0,1,5
15494,6,1,54446,54446,54447,0,1,5
15495,5,1,54451,54451,54452,0,1,4
15496,6,3,54457,54457,54460,0,3,5
15497,6,1,54463,54463,54464,0,1,3
15498,3,1,54466,54466,54467,0,1,2
15499,4,2,54470,54470,54472,0,2,3
15500,4,1,54474,54474,54475,0,1,2
15501,6,1,54480,54480,54481,0,1,5
15502,5,3,54485,54485,54488,0,3,4
15503,1,2,54486,54488,54490,2,4,0
15504,3,3,54489,54490,54493,1,4,0
15505,1,2,54490,54493,54495,3,5,0
15506,5,3,54495,54495,54498,0,3,0
15507,2,2,54497,54498,54500,1,3,0
15508,5,2,54502,54502,54504,0,2,2
15509,6,2,54508,54508,54510,0,2,4
15510,5,1,54513,54513,54514,0,1,3
15511,4,1,54517,54517,54518,0,1,3
15512,4,1,54521,54521,54522,0,1,3
15513,5,3,54526,54526,54529,0,3,4
15514,2,1,54528,54529,54530,1,2,0
15515,2,3,54530,54530,54533,0,3,0
15516,3,3,54533,54533,54536,0,3,0
15517,3,2,54536,54536,54538,0,2,0
15518,4,2,54540,54540,54542,0,2,2
15519,6,2,54546,54546,54548,0,2,4
15520,5,2,54551,54551,54553,0,2,3
15521,3,2,54554,54554,54556,0,2,1
15522,4,3,54558,54558,54561,0,3,2
15523,3,2,54561,54561,54563,0,2,0
15524,2,1,54563,54563,54564,0,1,0
15525,2,1,54565,54565,54566,0,1,1
15526,2,2,54567,54567,54569,0,2,1
15527,2,3,54569,54569,54572,0,3,0
15528,1,3,54570,54572,54575,2,5,0
15529,6,2,54576,54576,54578,0,2,1
15530,3,3,54579,54579,54582,0,3,1
15531,3,2,54582,54582,54584,0,2,0
15532,5,3,54587,54587,54590,0,3,3
15533,2,2,54589,54590,54592,1,3,0
15534,4,2,54593,54593,54595,0,2,1
15535,5,2,54598,54598,54600,0,2,3
15536,5,3,54603,54603,54606,0,3,3
15537,6,3,54609,54609,54612,0,3,3
15538,1,1,54610,54612,54613,2,3,0
15539,1,2,54611,54613,54615,2,4,0
15540,2,1,54613,54615,54616,2,3,0
15541,5,2,54618,54618,54620,0,2,2
15542,2,1,54620,54620,54621,0,1,0
15543,4,3,54624,54624,54627,0,3,3
15544,2,1,54626,54627,54628,1,2,0
15545,2,2,54628,54628,54630,0,2,0
15546,5,3,54633,54633,54636,0,3,3
15547,1,3,54634,54636,54639,2,5,0
15548,5,1,54639,54639,54640,0,1,0
15549,4,1,54643,54643,54644,0,1,3
15550,1,2,54644,54644,54646,0,2,0
15551,6,2,54650,54650,54652,0,2,4
15552,3,2,54653,54653,54655,0,2,1
15553,5,3,54658,54658,54661,0,3,3
15554,5,2,54663,54663,54665,0,2,2
15555,6,3,54669,54669,54672,0,3,4
15556,3,3,54672,54672,54675,0,3,0
15557,2,1,54674,54675,54676,1,2,0
15558,5,3,54679,54679,54682,0,3,3
15559,3,2,54682,54682,54684,0,2,0
15560,1,2,54683,54684,54686,1,3,0
15561,3,2,54686,54686,54688,0,2,0
15562,6,3,54692,54692,54695,0,3,4
15563,3,3,54695,54695,54698,0,3,0
15564,4,2,54699,54699,54701,0,2,1
15565,2,2,54701,54701,54703,0,2,0
15566,2,3,54703,54703,54706,0,3,0
15567,3,1,54706,54706,54707,0,1,0
15568,4,2,54710,54710,54712,0,2,3
15569,4,3,54714,54714,54717,0,3,2
15570,2,1,54716,54717,54718,1,2,0
15571,6,3,54722,54722,54725,0,3,4
15572,4,3,54726,54726,54729,0,3,1
15573,2,3,54728,54729,54732,1,4,0
15574,1,3,54729,54732,54735,3,6,0
15575,3,3,54732,54735,54738,3,6,0
15576,2,2,54734,54738,54740,4,6,0
15577,5,2,54739,54740,54742,1,3,0
15578,3,1,54742,54742,54743,0,1,0
15579,3,3,54745,54745,54748,0,3,2
15580,5,1,54750,54750,54751,0,1,2
15581,4,1,54754,54754,54755,0,1,3
15582,2,1,54756,54756,54757,0,1,1
15583,2,1,54758,54758,54759,0,1,1
15584,6,3,54764,54764,54767,0,3,5
15585,1,1,54765,54767,54768,2,3,0
15586,6,3,54771,54771,54774,0,3,3
15587,6,3,54777,54777,54780,0,3,3
15588,1,1,54778,54780,54781,2,3,0
15589,3,1,54781,54781,54782,0,1,0
15590,2,1,54783,54783,54784,0,1,1
15591,5,1,54788,54788,54789,0,1,4
15592,3,2,54791,54791,54793,0,2,2
15593,3,2,54794,54794,54796,0,2,1
15594,5,2,54799,54799,54801,0,2,3
15595,6,1,54805,54805,54806,0,1,4
15596,1,3,54806,54806,54809,0,3,0
15597,1,1,54807,54809,54810,2,3,0
15598,6,3,54813,54813,54816,0,3,3
15599,5,2,54818,54818,54820,0,2,2
15600,6,1,54824,54824,54825,0,1,4
15601,5,3,54829,54829,54832,0,3,4
15602,1,1,54830,54832,54833,2,3,0
15603,3,3,54833,54833,54836,0,3,0
15604,1,1,54834,54836,54837,2,3,0
15605,4,3,54838,54838,54841,0,3,1
15606,5,2,54843,54843,54845,0,2,2
15607,5,2,54848,54848,54850,0,2,3
15608,3,2,54851,54851,54853,0,2,1
15609,2,1,54853,54853,54854,0,1,0
15610,4,2,54857,54857,54859,0,2,3
15611,5,3,54862,54862,54865,0,3,3
15612,4,1,54866,54866,54867,0,1,1
15613,3,1,54869,54869,54870,0,1,2
15614,6,1,54875,54875,54876,0,1,5
15615,3,1,54878,54878,54879,0,1,2
15616,2,1,54880,54880,54881,0,1,1
15617,2,3,54882,54882,54885,0,3,1
15618,6,2,54888,54888,54890,0,2,3
15619,2,2,54890,54890,54892,0,2,0
15620,4,3,54894,54894,54897,0,3,2
15621,6,1,54900,54900,54901,0,1,3
15622,3,2,54903,54903,54905,0,2,2
15623,1,3,54904,54905,54908,1,4,0
15624,5,3,54909,54909,54912,0,3,1
15625,1,3,54910,54912,54915,2,5,0
15626,2,2,54912,54915,54917,3,5,0
15627,4,3,54916,54917,54920,1,4,0
15628,3,1,54919,54920,54921,1,2,0
15629,2,2,54921,54921,54923,0,2,0
15630,6,3,54927,54927,54930,0,3,4
15631,1,1,54928,54930,54931,2,3,0
15632,6,2,54934,54934,54936,0,2,3
15633,3,2,54937,54937,54939,0,2,1
15634,4,3,54941,54941,54944,0,3,2
15635,2,1,54943,54944,54945,1,2,0
15636,2,3,54945,54945,54948,0,3,0
15637,1,2,54946,54948,54950,2,4,0
15638,2,1,54948,54950,54951,2,3,0
15639,2,3,54950,54951,54954,1,4,0
15640,3,3,54953,54954,54957,1,4,0
15641,5,3,54958,54958,54961,0,3,1
15642,6,2,54964,54964,54966,0,2,3
15643,6,1,54970,54970,54971,0,1,4
15644,2,3,54972,54972,54975,0,3,1
15645,6,3,54978,54978,54981,0,3,3
15646,2,1,54980,54981,54982,1,2,0
15647,3,3,54983,54983,54986,0,3,1
15648,5,2,54988,54988,54990,0,2,2
15649,2,3,54990,54990,54993,0,3,0
15650,3,3,54993,54993,54996,0,3,0
15651,1,3,54994,54996,54999,2,5,0
15652,1,3,54995,54999,55002,4,7,0
15653,6,3,55001,55002,55005,1,4,0
15654,4,2,55005,55005,55007,0,2,0
15655,3,1,55008,55008,55009,0,1,1
15656,1,3,55009,55009,55012,0,3,0
15657,6,3,55015,55015,55018,0,3,3
15658,1,1,55016,55018,55019,2,3,0
15659,1,1,55017,55019,55020,2,3,0
15660,5,1,55022,55022,55023,0,1,2
15661,4,1,55026,55026,55027,0,1,3
15662,1,3,55027,55027,55030,0,3,0
15663,6,3,55033,55033,55036,0,3,3
15664,5,3,55038,55038,55041,0,3,2
15665,4,3,55042,55042,55045,0,3,1
15666,5,2,55047,55047,55049,0,2,2
15667,6,1,55053,55053,55054,0,1,4
15668,1,2,55054,55054,55056,0,2,0
15669,5,2,55059,55059,55061,0,2,3
15670,2,3,55061,55061,55064,0,3,0
15671,4,3,55065,55065,55068,0,3,1
15672,3,1,55068,55068,55069,0,1,0
15673,4,2,55072,55072,55074,0,2,3
15674,4,3,55076,55076,55079,0,3,2
15675,6,1,55082,55082,55083,0,1,3
15676,5,1,55087,55087,55088,0,1,4
15677,6,3,55093,55093,55096,0,3,5
15678,1,3,55094,55096,55099,2,5,0
15679,3,1,55097,55099,55100,2,3,0
15680,1,1,55098,55100,55101,2,3,0
15681,4,3,55102,55102,55105,0,3,1
15682,5,1,55107,55107,55108,0,1,2
15683,1,2,55108,55108,55110,0,2,0
15684,3,1,55111,55111,55112,0,1,1
15685,3,2,55114,55114,55116,0,2,2
15686,1,2,55115,55116,55118,1,3,0
15687,6,1,55121,55121,55122,0,1,3
15688,6,1,55127,55127,55128,0,1,5
15689,2,2,55129,55129,55131,0,2,1
15690,4,1,55133,55133,55134,0,1,2
15691,2,3,55135,55135,55138,0,3,1
15692,1,3,55136,55138,55141,2,5,0
15693,5,2,55141,55141,55143,0,2,0
15694,4,3,55145,55145,55148,0,3,2
15695,6,1,55151,55151,55152,0,1,3
15696,2,2,55153,55153,55155,0,2,1
15697,4,2,55157,55157,55159,0,2,2
15698,1,3,55158,55159,55162,1,4,0
15699,2,2,55160,55162,55164,2,4,0
15700,2,2,55162,55164,55166,2,4,0
15701,6,3,55168,55168,55171,0,3,2
15702,3,2,55171,55171,55173,0,2,0
15703,6,1,55177,55177,55178,0,1,4
15704,4,3,55181,55181,55184,0,3,3
15705,4,2,55185,55185,55187,0,2,1
15706,1,3,55186,55187,55190,1,4,0
15707,6,2,55192,55192,55194,0,2,2
15708,5,3,55197,55197,55200,0,3,3
15709,2,1,55199,55200,55201,1,2,0
15710,4,1,55203,55203,55204,0,1,2
15711,6,1,55209,55209,55210,0,1,5
15712,1,2,55210,55210,55212,0,2,0
15713,2,1,55212,55212,55213,0,1,0
15714,5,1,55217,55217,55218,0,1,4
15715,1,2,55218,55218,55220,0,2,0
15716,1,3,55219,55220,55223,1,4,0
15717,6,2,55225,55225,55227,0,2,2
15718,6,3,55231,55231,55234,0,3,4
15719,6,2,55237,55237,55239,0,2,3
15720,5,3,55242,55242,55245,0,3,3
15721,5,2,55247,55247,55249,0,2,2
15722,6,1,55253,55253,55254,0,1,4
15723,4,1,55257,55257,55258,0,1,3
15724,1,2,55258,55258,55260,0,2,0
15725,3,3,55261,55261,55264,0,3,1
15726,4,1,55265,55265,55266,0,1,1
15727,4,1,55269,55269,55270,0,1,3
15728,6,2,55275,55275,55277,0,2,5
15729,5,2,55280,55280,55282,0,2,3
15730,6,2,55286,55286,55288,0,2,4
15731,4,2,55290,55290,55292,0,2,2
15732,5,3,55295,55295,55298,0,3,3
15733,6,2,55301,55301,55303,0,2,3
15734,1,1,55302,55303,55304,1,2,0
15735,4,1,55306,55306,55307,0,1,2
15736,6,1,55312,55312,55313,0,1,5
15737,3,1,55315,55315,55316,0,1,2
15738,4,2,55319,55319,55321,0,2,3
15739,1,1,55320,55321,55322,1,2,0
15740,2,3,55322,55322,55325,0,3,0
15741,4,2,55326,55326,55328,0,2,1
15742,2,3,55328,55328,55331,0,3,0
15743,1,1,55329,55331,55332,2,3,0
15744,6,2,55335,55335,55337,0,2,3
15745,5,3,55340,55340,55343,0,3,3
15746,3,1,55343,55343,55344,0,1,0
15747,5,2,55348,55348,55350,0,2,4
15748,4,1,55352,55352,55353,0,1,2
15749,2,1,55354,55354,55355,0,1,1
15750,1,3,55355,55355,55358,0,3,0
15751,1,3,55356,55358,55361,2,5,0
15752,1,2,55357,55361,55363,4,6,0
15753,2,1,55359,55363,55364,4,5,0
15754,4,1,55363,55364,55365,1,2,0
15755,3,1,55366,55366,55367,0,1,1
15756,2,2,55368,55368,55370,0,2,1
15757,1,1,55369,55370,55371,1,2,0
15758,5,3,55374,55374,55377,0,3,3
15759,2,3,55376,55377,55380,1,4,0
15760,4,1,55380,55380,55381,0,1,0
15761,6,3,55386,55386,55389,0,3,5
15762,3,2,55389,55389,55391,0,2,0
15763,4,3,55393,55393,55396,0,3,2
15764,4,1,55397,55397,55398,0,1,1
15765,3,2,55400,55400,55402,0,2,2
15766,4,2,55404,55404,55406,0,2,2
15767,4,1,55408,55408,55409,0,1,2
15768,5,2,55413,55413,55415,0,2,4
15769,4,3,55417,55417,55420,0,3,2
15770,4,1,55421,55421,55422,0,1,1
15771,5,3,55426,55426,55429,0,3,4
15772,4,3,55430,55430,55433,0,3,1
15773,6,2,55436,55436,55438,0,2,3
15774,6,1,55442,55442,55443,0,1,4
15775,4,1,55446,55446,55447,0,1,3
15776,4,3,55450,55450,55453,0,3,3
15777,6,2,55456,55456,55458,0,2,3
15778,5,1,55461,55461,55462,0,1,3
15779,6,1,55467,55467,55468,0,1,5
15780,5,1,55472,55472,55473,0,1,4
15781,3,2,55475,55475,55477,0,2,2
15782,2,3,55477,55477,55480,0,3,0
15783,1,1,55478,55480,55481,2,3,0
15784,4,3,55482,55482,55485,0,3,1
15785,4,2,55486,55486,55488,0,2,1
15786,1,3,55487,55488,55491,1,4,0
15787,5,1,55492,55492,55493,0,1,1
15788,6,3,55498,55498,55501,0,3,5
15789,4,3,55502,55502,55505,0,3,1
15790,1,3,55503,55505,55508,2,5,0
15791,1,3,55504,55508,55511,4,7,0
15792,5,3,55509,55511,55514,2,5,0
15793,1,1,55510,55514,55515,4,5,0
15794,5,2,55515,55515,55517,0,2,0
15795,2,2,55517,55517,55519,0,2,0
15796,2,2,55519,55519,55521,0,2,0
15797,2,2,55521,55521,55523,0,2,0
15798,6,1,55527,55527,55528,0,1,4
15799,1,1,55528,55528,55529,0,1,0
15800,1,3,55529,55529,55532,0,3,0
15801,5,1,55534,55534,55535,0,1,2
15802,5,1,55539,55539,55540,0,1,4
15803,3,1,55542,55542,55543,0,1,2
15804,4,2,55546,55546,55548,0,2,3
15805,1,1,55547,55548,55549,1,2,0
15806,6,2,55553,55553,55555,0,2,4
15807,2,2,55555,55555,55557,0,2,0
15808,1,3,55556,55557,55560,1,4,0
15809,4,2,55560,55560,55562,0,2,0
15810,2,3,55562,55562,55565,0,3,0
15811,5,3,55567,55567,55570,0,3,2
15812,2,3,55569,55570,55573,1,4,0
15813,6,3,55575,55575,55578,0,3,2
15814,5,2,55580,55580,55582,0,2,2
15815,6,1,55586,55586,55587,0,1,4
15816,6,1,55592,55592,55593,0,1,5
15817,1,3,55593,55593,55596,0,3,0
15818,1,1,55594,55596,55597,2,3,0
15819,3,3,55597,55597,55600,0,3,0
15820,2,1,55599,55600,55601,1,2,0
15821,3,1,55602,55602,55603,0,1,1
15822,4,2,55606,55606,55608,0,2,3
15823,2,1,55608,55608,55609,0,1,0
15824,6,2,55614,55614,55616,0,2,5
15825,3,2,55617,55617,55619,0,2,1
15826,6,1,55623,55623,55624,0,1,4
15827,6,2,55629,55629,55631,0,2,5
15828,6,1,55635,55635,55636,0,1,4
15829,5,3,55640,55640,55643,0,3,4
15830,1,3,55641,55643,55646,2,5,0
15831,3,3,55644,55646,55649,2,5,0
15832,2,1,55646,55649,55650,3,4,0
15833,3,3,55649,55650,55653,1,4,0
15834,6,2,55655,55655,55657,0,2,2
15835,4,2,55659,55659,55661,0,2,2
15836,2,3,55661,55661,55664,0,3,0
15837,4,2,55665,55665,55667,0,2,1
15838,4,2,55669,55669,55671,0,2,2
15839,5,3,55674,55674,55677,0,3,3
15840,3,3,55677,55677,55680,0,3,0
15841,3,1,55680,55680,55681,0,1,0
15842,4,3,55684,55684,55687,0,3,3
15843,5,2,55689,55689,55691,0,2,2
15844,6,3,55695,55695,55698,0,3,4
15845,5,2,55700,55700,55702,0,2,2
15846,2,2,55702,55702,55704,0,2,0
15847,6,3,55708,55708,55711,0,3,4
15848,1,2,55709,55711,55713,2,4,0
15849,3,1,55712,55713,55714,1,2,0
15850,2,1,55714,55714,55715,0,1,0
15851,3,1,55717,55717,55718,0,1,2
15852,5,1,55722,55722,55723,0,1,4
15853,4,1,55726,55726,55727,0,1,3
15854,2,1,55728,55728,55729,0,1,1
15855,2,3,55730,55730,55733,0,3,1
15856,1,1,55731,55733,55734,2,3,0
15857,2,2,55733,55734,55736,1,3,0
15858,1,1,55734,55736,55737,2,3,0
15859,4,1,55738,55738,55739,0,1,1
15860,6,1,55744,55744,55745,0,1,5
15861,2,1,55746,55746,55747,0,1,1
15862,1,2,55747,55747,55749,0,2,0
15863,4,1,55751,55751,55752,0,1,2
15864,6,2,55757,55757,55759,0,2,5
15865,2,2,55759,55759,55761,0,2,0
15866,3,3,55762,55762,55765,0,3,1
15867,5,3,55767,55767,55770,0,3,2
15868,5,1,55772,55772,55773,0,1,2
15869,4,3,55776,55776,55779,0,3,3
15870,1,1,55777,55779,55780,2,3,0
15871,1,3,55778,55780,55783,2,5,0
15872,5,2,55783,55783,55785,0,2,0
15873,2,3,55785,55785,55788,0,3,0
15874,3,1,55788,55788,55789,0,1,0
15875,6,2,55794,55794,55796,0,2,5
15876,4,3,55798,55798,55801,0,3,2
15877,6,1,55804,55804,55805,0,1,3
15878,2,3,55806,55806,55809,0,3,1
15879,5,1,55811,55811,55812,0,1,2
15880,5,2,55816,55816,55818,0,2,4
15881,5,2,55821,55821,55823,0,2,3
15882,4,3,55825,55825,55828,0,3,2
15883,3,2,55828,55828,55830,0,2,0
15884,5,1,55833,55833,55834,0,1,3
15885,2,2,55835,55835,55837,0,2,1
15886,3,3,55838,55838,55841,0,3,1
15887,4,3,55842,55842,55845,0,3,1
15888,1,1,55843,55845,55846,2,3,0
15889,1,2,55844,55846,55848,2,4,0
15890,1,1,55845,55848,55849,3,4,0
15891,2,1,55847,55849,55850,2,3,0
15892,3,3,55850,55850,55853,0,3,0
15893,4,1,55854,55854,55855,0,1,1
15894,3,3,55857,55857,55860,0,3,2
15895,5,2,55862,55862,55864,0,2,2
15896,1,1,55863,55864,55865,1,2,0
15897,6,2,55869,55869,55871,0,2,4
15898,1,1,55870,55871,55872,1,2,0
15899,5,2,55875,55875,55877,0,2,3
15900,6,2,55881,55881,55883,0,2,4
15901,6,2,55887,55887,55889,0,2,4
15902,6,3,55893,55893,55896,0,3,4
15903,5,2,55898,55898,55900,0,2,2
15904,4,2,55902,55902,55904,0,2,2
15905,1,1,55903,55904,55905,1,2,0
15906,2,1,55905,55905,55906,0,1,0
15907,6,2,55911,55911,55913,0,2,5
15908,2,3,55913,55913,55916,0,3,0
15909,4,2,55917,55917,55919,0,2,1
15910,5,1,55922,55922,55923,0,1,3
15911,3,2,55925,55925,55927,0,2,2
15912,3,3,55928,55928,55931,0,3,1
15913,1,1,55929,55931,55932,2,3,0
15914,1,2,55930,55932,55934,2,4,0
15915,1,2,55931,55934,55936,3,5,0
15916,4,2,55935,55936,55938,1,3,0
15917,3,3,55938,55938,55941,0,3,0
15918,3,1,55941,55941,55942,0,1,0
15919,6,2,55947,55947,55949,0,2,5
15920,5,2,55952,55952,55954,0,2,3
15921,6,1,55958,55958,55959,0,1,4
15922,3,2,55961,55961,55963,0,2,2
15923,3,2,55964,55964,55966,0,2,1
15924,1,1,55965,55966,55967,1,2,0
15925,2,2,55967,55967,55969,0,2,0
15926,6,1,55973,55973,55974,0,1,4
15927,3,1,55976,55976,55977,0,1,2
15928,2,1,55978,55978,55979,0,1,1
15929,1,2,55979,55979,55981,0,2,0
15930,6,1,55985,55985,55986,0,1,4
15931,1,1,55986,55986,55987,0,1,0
15932,5,1,55991,55991,55992,0,1,4
15933,2,3,55993,55993,55996,0,3,1
15934,2,3,55995,55996,55999,1,4,0
15935,5,3,56000,56000,56003,0,3,1
15936,5,3,56005,56005,56008,0,3,2
15937,5,1,56010,56010,56011,0,1,2
15938,6,2,56016,56016,56018,0,2,5
15939,6,3,56022,56022,56025,0,3,4
15940,2,1,56024,56025,56026,1,2,0
15941,1,3,56025,56026,56029,1,4,0
15942,1,2,56026,56029,56031,3,5,0
15943,5,1,56031,56031,56032,0,1,0
15944,1,1,56032,56032,56033,0,1,0
15945,3,1,56035,56035,56036,0,1,2
15946,2,2,56037,56037,56039,0,2,1
15947,4,1,56041,56041,56042,0,1,2
15948,2,2,56043,56043,56045,0,2,1
15949,3,3,56046,56046,56049,0,3,1
15950,4,1,56050,56050,56051,0,1,1
15951,4,2,56054,56054,56056,0,2,3
15952,3,3,56057,56057,56060,0,3,1
15953,5,3,56062,56062,56065,0,3,2
15954,1,1,56063,56065,56066,2,3,0
15955,4,2,56067,56067,56069,0,2,1
15956,4,1,56071,56071,56072,0,1,2
15957,4,1,56075,56075,56076,0,1,3
15958,2,1,56077,56077,56078,0,1,1
15959,5,1,56082,56082,56083,0,1,4
15960,3,2,56085,56085,56087,0,2,2
15961,4,1,56089,56089,56090,0,1,2
15962,2,3,56091,56091,56094,0,3,1
15963,4,2,56095,56095,56097,0,2,1
15964,5,1,56100,56100,56101,0,1,3
15965,2,2,56102,56102,56104,0,2,1
15966,3,3,56105,56105,56108,0,3,1
15967,3,2,56108,56108,56110,0,2,0
15968,1,2,56109,56110,56112,1,3,0
15969,1,3,56110,56112,56115,2,5,0
15970,6,1,56116,56116,56117,0,1,1
15971,4,2,56120,56120,56122,0,2,3
15972,5,3,56125,56125,56128,0,3,3
15973,6,1,56131,56131,56132,0,1,3
15974,1,2,56132,56132,56134,0,2,0
15975,4,3,56136,56136,56139,0,3,2
15976,5,2,56141,56141,56143,0,2,2
15977,1,2,56142,56143,56145,1,3,0
15978,4,1,56146,56146,56147,0,1,1
15979,2,1,56148,56148,56149,0,1,1
15980,1,1,56149,56149,56150,0,1,0
15981,6,2,56155,56155,56157,0,2,5
15982,6,1,56161,56161,56162,0,1,4
15983,6,1,56167,56167,56168,0,1,5
15984,2,2,56169,56169,56171,0,2,1
15985,5,1,56174,56174,56175,0,1,3
15986,1,1,56175,56175,56176,0,1,0
15987,6,2,56181,56181,56183,0,2,5
15988,2,2,56183,56183,56185,0,2,0
15989,1,3,56184,56185,56188,1,4,0
15990,6,3,56190,56190,56193,0,3,2
15991,6,3,56196,56196,56199,0,3,3
15992,1,2,56197,56199,56201,2,4,0
15993,4,3,56201,56201,56204,0,3,0
15994,5,3,56206,56206,56209,0,3,2
15995,6,2,56212,56212,56214,0,2,3
15996,2,2,56214,56214,56216,0,2,0
15997,2,1,56216,56216,56217,0,1,0
15998,3,3,56219,56219,56222,0,3,2
15999,3,2,56222,56222,56224,0,2,0
16000,3,1,56225,56225,56226,0,1,1
16001,2,2,56227,56227,56229,0,2,1
16002,3,1,56230,56230,56231,0,1,1
16003,1,2,56231,56231,56233,0,2,0
16004,6,3,56237,56237,56240,0,3,4
16005,1,1,56238,56240,56241,2,3,0
16006,6,2,56244,56244,56246,0,2,3
16007,6,2,56250,56250,56252,0,2,4
16008,3,1,56253,56253,56254,0,1,1
16009,5,1,56258,56258,56259,0,1,4
16010,2,2,56260,56260,56262,0,2,1
16011,3,3,56263,56263,56266,0,3,1
16012,6,1,56269,56269,56270,0,1,3
16013,3,1,56272,56272,56273,0,1,2
16014,1,3,56273,56273,56276,0,3,0
16015,1,3,56274,56276,56279,2,5,0
16016,6,3,56280,56280,56283,0,3,1
16017,5,2,56285,56285,56287,0,2,2
16018,3,3,56288,56288,56291,0,3,1
16019,1,3,56289,56291,56294,2,5,0
16020,4,3,56293,56294,56297,1,4,0
16021,1,2,56294,56297,56299,3,5,0
16022,1,3,56295,56299,56302,4,7,0
16023,5,1,56300,56302,56303,2,3,0
16024,1,2,56301,56303,56305,2,4,0
16025,4,2,56305,56305,56307,0,2,0
16026,1,1,56306,56307,56308,1,2,0
16027,5,3,56311,56311,56314,0,3,3
16028,4,1,56315,56315,56316,0,1,1
16029,2,3,56317,56317,56320,0,3,1
16030,1,1,56318,56320,56321,2,3,0
16031,3,2,56321,56321,56323,0,2,0
16032,2,1,56323,56323,56324,0,1,0
16033,3,2,56326,56326,56328,0,2,2
16034,1,2,56327,56328,56330,1,3,0
16035,2,3,56329,56330,56333,1,4,0
16036,4,1,56333,56333,56334,0,1,0
16037,3,2,56336,56336,56338,0,2,2
16038,3,3,56339,56339,56342,0,3,1
16039,1,2,56340,56342,56344,2,4,0
16040,3,1,56343,56344,56345,1,2,0
16041,1,3,56344,56345,56348,1,4,0
16042,4,3,56348,56348,56351,0,3,0
16043,6,1,56354,56354,56355,0,1,3
16044,1,3,56355,56355,56358,0,3,0
16045,2,1,56357,56358,56359,1,2,0
16046,3,3,56360,56360,56363,0,3,1
16047,4,3,56364,56364,56367,0,3,1
16048,6,3,56370,56370,56373,0,3,3
16049,3,3,56373,56373,56376,0,3,0
16050,3,2,56376,56376,56378,0,2,0
16051,5,2,56381,56381,56383,0,2,3
16052,2,3,56383,56383,56386,0,3,0
16053,1,1,56384,56386,56387,2,3,0
16054,4,2,56388,56388,56390,0,2,1
16055,2,2,56390,56390,56392,0,2,0
16056,1,2,56391,56392,56394,1,3,0
16057,6,1,56397,56397,56398,0,1,3
16058,1,3,56398,56398,56401,0,3,0
16059,6,2,56404,56404,56406,0,2,3
16060,6,1,56410,56410,56411,0,1,4
16061,5,3,56415,56415,56418,0,3,4
16062,5,2,56420,56420,56422,0,2,2
16063,2,2,56422,56422,56424,0,2,0
16064,4,3,56426,56426,56429,0,3,2
16065,1,1,56427,56429,56430,2,3,0
16066,5,1,56432,56432,56433,0,1,2
16067,5,2,56437,56437,56439,0,2,4
16068,1,2,56438,56439,56441,1,3,0
16069,3,2,56441,56441,56443,0,2,0
16070,3,2,56444,56444,56446,0,2,1
16071,4,3,56448,56448,56451,0,3,2
16072,4,1,56452,56452,56453,0,1,1
16073,2,1,56454,56454,56455,0,1,1
16074,6,2,56460,56460,56462,0,2,5
16075,5,1,56465,56465,56466,0,1,3
16076,5,2,56470,56470,56472,0,2,4
16077,3,3,56473,56473,56476,0,3,1
16078,4,3,56477,56477,56480,0,3,1
16079,2,2,56479,56480,56482,1,3,0
16080,4,3,56483,56483,56486,0,3,1
16081,2,1,56485,56486,56487,1,2,0
16082,1,2,56486,56487,56489,1,3,0
16083,4,3,56490,56490,56493,0,3,1
16084,4,1,56494,56494,56495,0,1,1
16085,2,3,56496,56496,56499,0,3,1
16086,2,1,56498,56499,56500,1,2,0
16087,3,1,56501,56501,56502,0,1,1
16088,5,3,56506,56506,56509,0,3,4
16089,6,1,56512,56512,56513,0,1,3
16090,1,3,56513,56513,56516,0,3,0
16091,3,1,56516,56516,56517,0,1,0
16092,6,2,56522,56522,56524,0,2,5
16093,5,3,56527,56527,56530,0,3,3
16094,5,1,56532,56532,56533,0,1,2
16095,2,3,56534,56534,56537,0,3,1
16096,4,3,56538,56538,56541,0,3,1
16097,5,3,56543,56543,56546,0,3,2
16098,6,1,56549,56549,56550,0,1,3
16099,5,2,56554,56554,56556,0,2,4
16100,5,1,56559,56559,56560,0,1,3
16101,3,3,56562,56562,56565,0,3,2
16102,4,3,56566,56566,56569,0,3,1
16103,6,1,56572,56572,56573,0,1,3
16104,6,1,56578,56578,56579,0,1,5
16105,3,1,56581,56581,56582,0,1,2
16106,3,1,56584,56584,56585,0,1,2
16107,5,1,56589,56589,56590,0,1,4
16108,2,2,56591,56591,56593,0,2,1
16109,1,1,56592,56593,56594,1,2,0
16110,6,2,56598,56598,56600,0,2,4
16111,6,1,56604,56604,56605,0,1,4
16112,6,1,56610,56610,56611,0,1,5
16113,2,2,56612,56612,56614,0,2,1
16114,3,2,56615,56615,56617,0,2,1
16115,5,1,56620,56620,56621,0,1,3
16116,1,1,56621,56621,56622,0,1,0
16117,4,2,56625,56625,56627,0,2,3
16118,1,3,56626,56627,56630,1,4,0
16119,1,2,56627,56630,56632,3,5,0
16120,5,3,56632,56632,56635,0,3,0
16121,2,3,56634,56635,56638,1,4,0
16122,6,3,56640,56640,56643,0,3,2
16123,2,1,56642,56643,56644,1,2,0
16124,4,1,56646,56646,56647,0,1,2
16125,3,1,56649,56649,56650,0,1,2
16126,2,1,56651,56651,56652,0,1,1
16127,1,2,56652,56652,56654,0,2,0
16128,1,2,56653,56654,56656,1,3,0
16129,1,3,56654,56656,56659,2,5,0
16130,2,3,56656,56659,56662,3,6,0
16131,2,1,56658,56662,56663,4,5,0
16132,2,1,56660,56663,56664,3,4,0
16133,6,1,56666,56666,56667,0,1,2
16134,4,3,56670,56670,56673,0,3,3
16135,5,3,56675,56675,56678,0,3,2
16136,3,3,56678,56678,56681,0,3,0
16137,5,2,56683,56683,56685,0,2,2
16138,6,2,56689,56689,56691,0,2,4
16139,6,3,56695,56695,56698,0,3,4
16140,2,3,56697,56698,56701,1,4,0
16141,1,2,56698,56701,56703,3,5,0
16142,2,3,56700,56703,56706,3,6,0
16143,4,1,56704,56706,56707,2,3,0
16144,2,2,56706,56707,56709,1,3,0
16145,3,3,56709,56709,56712,0,3,0
16146,4,1,56713,56713,56714,0,1,1
16147,4,3,56717,56717,56720,0,3,3
16148,3,2,56720,56720,56722,0,2,0
16149,6,2,56726,56726,56728,0,2,4
16150,3,2,56729,56729,56731,0,2,1
16151,1,1,56730,56731,56732,1,2,0
16152,2,3,56732,56732,56735,0,3,0
16153,2,2,56734,56735,56737,1,3,0
16154,1,3,56735,56737,56740,2,5,0
16155,5,2,56740,56740,56742,0,2,0
16156,3,1,56743,56743,56744,0,1,1
16157,1,2,56744,56744,56746,0,2,0
16158,5,3,56749,56749,56752,0,3,3
16159,6,2,56755,56755,56757,0,2,3
16160,5,2,56760,56760,56762,0,2,3
16161,5,1,56765,56765,56766,0,1,3
16162,3,3,56768,56768,56771,0,3,2
16163,5,2,56773,56773,56775,0,2,2
16164,3,2,56776,56776,56778,0,2,1
16165,2,2,56778,56778,56780,0,2,0
16166,6,3,56784,56784,56787,0,3,4
16167,2,2,56786,56787,56789,1,3,0
16168,2,3,56788,56789,56792,1,4,0
16169,6,1,56794,56794,56795,0,1,2
16170,3,1,56797,56797,56798,0,1,2
16171,1,2,56798,56798,56800,0,2,0
16172,1,1,56799,56800,56801,1,2,0
16173,2,3,56801,56801,56804,0,3,0
16174,5,1,56806,56806,56807,0,1,2
16175,6,1,56812,56812,56813,0,1,5
16176,2,2,56814,56814,56816,0,2,1
16177,5,2,56819,56819,56821,0,2,3
16178,2,1,56821,56821,56822,0,1,0
16179,3,2,56824,56824,56826,0,2,2
16180,3,2,56827,56827,56829,0,2,1
16181,2,3,56829,56829,56832,0,3,0
16182,3,1,56832,56832,56833,0,1,0
16183,2,1,56834,56834,56835,0,1,1
16184,6,3,56840,56840,56843,0,3,5
16185,1,2,56841,56843,56845,2,4,0
16186,5,2,56846,56846,56848,0,2,1
16187,3,3,56849,56849,56852,0,3,1
16188,6,1,56855,56855,56856,0,1,3
16189,3,2,56858,56858,56860,0,2,2
16190,2,2,56860,56860,56862,0,2,0
16191,3,1,56863,56863,56864,0,1,1
16192,6,1,56869,56869,56870,0,1,5
16193,4,3,56873,56873,56876,0,3,3
16194,3,1,56876,56876,56877,0,1,0
16195,3,1,56879,56879,56880,0,1,2
16196,6,1,56885,56885,56886,0,1,5
16197,2,1,56887,56887,56888,0,1,1
16198,4,1,56891,56891,56892,0,1,3
16199,4,3,56895,56895,56898,0,3,3
16200,2,3,56897,56898,56901,1,4,0
16201,6,1,56903,56903,56904,0,1,2
16202,4,2,56907,56907,56909,0,2,3
16203,4,2,56911,56911,56913,0,2,2
16204,3,2,56914,56914,56916,0,2,1
16205,1,3,56915,56916,56919,1,4,0
16206,6,3,56921,56921,56924,0,3,2
16207,2,2,56923,56924,56926,1,3,0
16208,1,1,56924,56926,56927,2,3,0
16209,3,3,56927,56927,56930,0,3,0
16210,2,2,56929,56930,56932,1,3,0
16211,5,1,56934,56934,56935,0,1,2
16212,1,2,56935,56935,56937,0,2,0
16213,1,2,56936,56937,56939,1,3,0
16214,6,1,56942,56942,56943,0,1,3
16215,3,1,56945,56945,56946,0,1,2
16216,3,2,56948,56948,56950,0,2,2
16217,6,3,56954,56954,56957,0,3,4
16218,1,2,56955,56957,56959,2,4,0
16219,3,1,56958,56959,56960,1,2,0
16220,5,2,56963,56963,56965,0,2,3
16221,3,2,56966,56966,56968,0,2,1
16222,4,1,56970,56970,56971,0,1,2
16223,3,3,56973,56973,56976,0,3,2
16224,1,1,56974,56976,56977,2,3,0
16225,1,2,56975,56977,56979,2,4,0
16226,1,1,56976,56979,56980,3,4,0
16227,6,3,56982,56982,56985,0,3,2
16228,6,2,56988,56988,56990,0,2,3
16229,3,2,56991,56991,56993,0,2,1
16230,4,3,56995,56995,56998,0,3,2
16231,2,2,56997,56998,57000,1,3,0
16232,6,3,57003,57003,57006,0,3,3
16233,3,3,57006,57006,57009,0,3,0
16234,3,3,57009,57009,57012,0,3,0
16235,1,3,57010,57012,57015,2,5,0
16236,1,2,57011,57015,57017,4,6,0
16237,6,3,57017,57017,57020,0,3,0
16238,3,1,57020,57020,57021,0,1,0
16239,3,3,57023,57023,57026,0,3,2
16240,4,1,57027,57027,57028,0,1,1
16241,2,1,57029,57029,57030,0,1,1
16242,3,1,57032,57032,57033,0,1,2
16243,4,3,57036,57036,57039,0,3,3
16244,6,3,57042,57042,57045,0,3,3
16245,3,2,57045,57045,57047,0,2,0
16246,3,2,57048,57048,57050,0,2,1
16247,5,2,57053,57053,57055,0,2,3
16248,6,2,57059,57059,57061,0,2,4
16249,2,1,57061,57061,57062,0,1,0
16250,6,3,57067,57067,57070,0,3,5
16251,5,1,57072,57072,57073,0,1,2
16252,2,3,57074,57074,57077,0,3,1
16253,4,3,57078,57078,57081,0,3,1
16254,3,3,57081,57081,57084,0,3,0
16255,3,1,57084,57084,57085,0,1,0
16256,4,3,57088,57088,57091,0,3,3
16257,2,1,57090,57091,57092,1,2,0
16258,6,2,57096,57096,57098,0,2,4
16259,6,1,57102,57102,57103,0,1,4
16260,6,3,57108,57108,57111,0,3,5
16261,3,3,57111,57111,57114,0,3,0
16262,5,1,57116,57116,57117,0,1,2
16263,5,1,57121,57121,57122,0,1,4
16264,4,2,57125,57125,57127,0,2,3
16265,5,3,57130,57130,57133,0,3,3
16266,6,1,57136,57136,57137,0,1,3
16267,6,1,57142,57142,57143,0,1,5
16268,2,1,57144,57144,57145,0,1,1
16269,6,1,57150,57150,57151,0,1,5
16270,5,2,57155,57155,57157,0,2,4
16271,6,2,57161,57161,57163,0,2,4
16272,2,2,57163,57163,57165,0,2,0
16273,6,2,57169,57169,57171,0,2,4
16274,1,1,57170,57171,57172,1,2,0
16275,6,2,57176,57176,57178,0,2,4
16276,3,3,57179,57179,57182,0,3,1
16277,4,1,57183,57183,57184,0,1,1
16278,5,2,57188,57188,57190,0,2,4
16279,2,1,57190,57190,57191,0,1,0
16280,2,2,57192,57192,57194,0,2,1
16281,4,1,57196,57196,57197,0,1,2
16282,4,3,57200,57200,57203,0,3,3
16283,3,1,57203,57203,57204,0,1,0
16284,1,2,57204,57204,57206,0,2,0
16285,2,2,57206,57206,57208,0,2,0
16286,1,2,57207,57208,57210,1,3,0
16287,5,2,57212,57212,57214,0,2,2
16288,2,3,57214,57214,57217,0,3,0
16289,5,2,57219,57219,57221,0,2,2
16290,6,3,57225,57225,57228,0,3,4
16291,1,3,57226,57228,57231,2,5,0
16292,4,1,57230,57231,57232,1,2,0
16293,3,2,57233,57233,57235,0,2,1
16294,2,2,57235,57235,57237,0,2,0
16295,6,3,57241,57241,57244,0,3,4
16296,6,1,57247,57247,57248,0,1,3
16297,6,3,57253,57253,57256,0,3,5
16298,2,1,57255,57256,57257,1,2,0
16299,6,1,57261,57261,57262,0,1,4
16300,4,2,57265,57265,57267,0,2,3
16301,2,3,57267,57267,57270,0,3,0
16302,3,1,57270,57270,57271,0,1,0
16303,1,3,57271,57271,57274,0,3,0
16304,2,1,57273,57274,57275,1,2,0
16305,4,2,57277,57277,57279,0,2,2
16306,2,3,57279,57279,57282,0,3,0
16307,3,2,57282,57282,57284,0,2,0
16308,1,3,57283,57284,57287,1,4,0
16309,1,2,57284,57287,57289,3,5,0
16310,2,1,57286,57289,57290,3,4,0
16311,2,2,57288,57290,57292,2,4,0
16312,5,3,57293,57293,57296,0,3,1
16313,5,3,57298,57298,57301,0,3,2
16314,5,1,57303,57303,57304,0,1,2
16315,6,2,57309,57309,57311,0,2,5
16316,6,1,57315,57315,57316,0,1,4
16317,5,3,57320,57320,57323,0,3,4
16318,3,1,57323,57323,57324,0,1,0
16319,3,1,57326,57326,57327,0,1,2
16320,2,1,57328,57328,57329,0,1,1
16321,1,1,57329,57329,57330,0,1,0
16322,3,2,57332,57332,57334,0,2,2
16323,6,1,57338,57338,57339,0,1,4
16324,3,2,57341,57341,57343,0,2,2
16325,6,1,57347,57347,57348,0,1,4
16326,5,3,57352,57352,57355,0,3,4
16327,2,1,57354,57355,57356,1,2,0
16328,2,1,57356,57356,57357,0,1,0
16329,4,3,57360,57360,57363,0,3,3
16330,2,1,57362,57363,57364,1,2,0
16331,5,1,57367,57367,57368,0,1,3
16332,4,2,57371,57371,57373,0,2,3
16333,5,1,57376,57376,57377,0,1,3
16334,1,2,57377,57377,57379,0,2,0
16335,3,1,57380,57380,57381,0,1,1
16336,1,2,57381,57381,57383,0,2,0
16337,5,3,57386,57386,57389,0,3,3
16338,1,1,57387,57389,57390,2,3,0
16339,5,3,57392,57392,57395,0,3,2
16340,6,1,57398,57398,57399,0,1,3
16341,1,3,57399,57399,57402,0,3,0
16342,1,1,57400,57402,57403,2,3,0
16343,5,2,57405,57405,57407,0,2,2
16344,6,1,57411,57411,57412,0,1,4
16345,2,3,57413,57413,57416,0,3,1
16346,5,3,57418,57418,57421,0,3,2
16347,3,2,57421,57421,57423,0,2,0
16348,6,1,57427,57427,57428,0,1,4
16349,3,2,57430,57430,57432,0,2,2
16350,3,1,57433,57433,57434,0,1,1
16351,1,1,57434,57434,57435,0,1,0
16352,4,3,57438,57438,57441,0,3,3
16353,3,1,57441,57441,57442,0,1,0
16354,1,1,57442,57442,57443,0,1,0
16355,5,3,57447,57447,57450,0,3,4
16356,1,2,57448,57450,57452,2,4,0
16357,1,1,57449,57452,57453,3,4,0
16358,3,2,57452,57453,57455,1,3,0
16359,5,1,57457,57457,57458,0,1,2
16360,4,3,57461,57461,57464,0,3,3
16361,6,2,57467,57467,57469,0,2,3
16362,3,2,57470,57470,57472,0,2,1
16363,6,3,57476,57476,57479,0,3,4
16364,4,2,57480,57480,57482,0,2,1
16365,6,3,57486,57486,57489,0,3,4
16366,2,2,57488,57489,57491,1,3,0
16367,6,2,57494,57494,57496,0,2,3
16368,2,1,57496,57496,57497,0,1,0
16369,3,3,57499,57499,57502,0,3,2
16370,6,2,57505,57505,57507,0,2,3
16371,5,2,57510,57510,57512,0,2,3
16372,5,1,57515,57515,57516,0,1,3
16373,3,2,57518,57518,57520,0,2,2
16374,3,3,57521,57521,57524,0,3,1
16375,1,2,57522,57524,57526,2,4,0
16376,4,3,57526,57526,57529,0,3,0
16377,4,3,57530,57530,57533,0,3,1
16378,1,2,57531,57533,57535,2,4,0
16379,1,1,57532,57535,57536,3,4,0
16380,6,3,57538,57538,57541,0,3,2
16381,4,2,57542,57542,57544,0,2,1
16382,2,3,57544,57544,57547,0,3,0
16383,4,3,57548,57548,57551,0,3,1
16384,6,2,57554,57554,57556,0,2,3
16385,3,3,57557,57557,57560,0,3,1
16386,4,2,57561,57561,57563,0,2,1
16387,4,1,57565,57565,57566,0,1,2
16388,1,3,57566,57566,57569,0,3,0
16389,5,1,57571,57571,57572,0,1,2
16390,5,1,57576,57576,57577,0,1,4
16391,3,3,57579,57579,57582,0,3,2
16392,1,3,57580,57582,57585,2,5,0
16393,1,3,57581,57585,57588,4,7,0
16394,5,1,57586,57588,57589,2,3,0
16395,1,3,57587,57589,57592,2,5,0
16396,5,3,57592,57592,57595,0,3,0
16397,1,2,57593,57595,57597,2,4,0
16398,4,3,57597,57597,57600,0,3,0
16399,6,1,57603,57603,57604,0,1,3
16400,3,1,57606,57606,57607,0,1,2
16401,4,2,57610,57610,57612,0,2,3
16402,4,3,57614,57614,57617,0,3,2
16403,2,3,57616,57617,57620,1,4,0
16404,1,3,57617,57620,57623,3,6,0
16405,1,1,57618,57623,57624,5,6,0
16406,6,3,57624,57624,57627,0,3,0
16407,2,1,57626,57627,57628,1,2,0
16408,1,2,57627,57628,57630,1,3,0
16409,3,1,57630,57630,57631,0,1,0
16410,4,2,57634,57634,57636,0,2,3
16411,2,2,57636,57636,57638,0,2,0
16412,4,3,57640,57640,57643,0,3,2
16413,3,3,57643,57643,57646,0,3,0
16414,1,2,57644,57646,57648,2,4,0
16415,3,3,57647,57648,57651,1,4,0
16416,2,1,57649,57651,57652,2,3,0
16417,1,3,57650,57652,57655,2,5,0
16418,5,1,57655,57655,57656,0,1,0
16419,2,3,57657,57657,57660,0,3,1
16420,5,3,57662,57662,57665,0,3,2
16421,3,1,57665,57665,57666,0,1,0
16422,5,3,57670,57670,57673,0,3,4
16423,1,3,57671,57673,57676,2,5,0
16424,2,2,57673,57676,57678,3,5,0
16425,3,2,57676,57678,57680,2,4,0
16426,1,2,57677,57680,57682,3,5,0
16427,3,2,57680,57682,57684,2,4,0
16428,1,2,57681,57684,57686,3,5,0
16429,3,3,57684,57686,57689,2,5,0
16430,5,2,57689,57689,57691,0,2,0
16431,2,2,57691,57691,57693,0,2,0
16432,4,3,57695,57695,57698,0,3,2
16433,4,1,57699,57699,57700,0,1,1
16434,5,3,57704,57704,57707,0,3,4
16435,5,1,57709,57709,57710,0,1,2
16436,2,1,57711,57711,57712,0,1,1
16437,2,3,57713,57713,57716,0,3,1
16438,1,3,57714,57716,57719,2,5,0
16439,6,3,57720,57720,57723,0,3,1
16440,3,1,57723,57723,57724,0,1,0
16441,6,3,57729,57729,57732,0,3,5
16442,3,2,57732,57732,57734,0,2,0
16443,5,3,57737,57737,57740,0,3,3
16444,4,2,57741,57741,57743,0,2,1
16445,3,2,57744,57744,57746,0,2,1
16446,4,1,57748,57748,57749,0,1,2
16447,4,2,57752,57752,57754,0,2,3
16448,2,2,57754,57754,57756,0,2,0
16449,6,1,57760,57760,57761,0,1,4
16450,4,2,57764,57764,57766,0,2,3
16451,5,3,57769,57769,57772,0,3,3
16452,1,3,57770,57772,57775,2,5,0
16453,5,2,57775,57775,57777,0,2,0
16454,5,3,57780,57780,57783,0,3,3
16455,1,2,57781,57783,57785,2,4,0
16456,5,1,57786,57786,57787,0,1,1
16457,2,3,57788,57788,57791,0,3,1
16458,4,3,57792,57792,57795,0,3,1
16459,2,2,57794,57795,57797,1,3,0
16460,1,1,57795,57797,57798,2,3,0
16461,4,3,57799,57799,57802,0,3,1
16462,3,3,57802,57802,57805,0,3,0
16463,6,1,57808,57808,57809,0,1,3
16464,3,2,57811,57811,57813,0,2,2
16465,6,2,57817,57817,57819,0,2,4
16466,1,2,57818,57819,57821,1,3,0
16467,6,1,57824,57824,57825,0,1,3
16468,1,1,57825,57825,57826,0,1,0
16469,3,3,57828,57828,57831,0,3,2
16470,6,1,57834,57834,57835,0,1,3
16471,6,1,57840,57840,57841,0,1,5
16472,3,2,57843,57843,57845,0,2,2
16473,4,2,57847,57847,57849,0,2,2
16474,5,1,57852,57852,57853,0,1,3
16475,1,2,57853,57853,57855,0,2,0
16476,4,2,57857,57857,57859,0,2,2
16477,1,2,57858,57859,57861,1,3,0
16478,2,1,57860,57861,57862,1,2,0
16479,2,1,57862,57862,57863,0,1,0
16480,2,3,57864,57864,57867,0,3,1
16481,1,2,57865,57867,57869,2,4,0
16482,3,2,57868,57869,57871,1,3,0
16483,4,1,57872,57872,57873,0,1,1
16484,5,2,57877,57877,57879,0,2,4
16485,5,3,57882,57882,57885,0,3,3
16486,3,2,57885,57885,57887,0,2,0
16487,2,1,57887,57887,57888,0,1,0
16488,3,3,57890,57890,57893,0,3,2
16489,1,2,57891,57893,57895,2,4,0
16490,2,3,57893,57895,57898,2,5,0
16491,6,3,57899,57899,57902,0,3,1
16492,4,2,57903,57903,57905,0,2,1
16493,6,2,57909,57909,57911,0,2,4
16494,4,1,57913,57913,57914,0,1,2
16495,3,3,57916,57916,57919,0,3,2
16496,3,2,57919,57919,57921,0,2,0
16497,1,2,57920,57921,57923,1,3,0
16498,6,1,57926,57926,57927,0,1,3
16499,4,1,57930,57930,57931,0,1,3
16500,5,3,57935,57935,57938,0,3,4
16501,1,1,57936,57938,57939,2,3,0
16502,5,3,57941,57941,57944,0,3,2
16503,3,3,57944,57944,57947,0,3,0
16504,4,3,57948,57948,57951,0,3,1
16505,4,1,57952,57952,57953,0,1,1
16506,2,2,57954,57954,57956,0,2,1
16507,4,1,57958,57958,57959,0,1,2
16508,3,3,57961,57961,57964,0,3,2
16509,6,2,57967,57967,57969,0,2,3
16510,4,1,57971,57971,57972,0,1,2
16511,1,3,57972,57972,57975,0,3,0
16512,3,1,57975,57975,57976,0,1,0
16513,3,2,57978,57978,57980,0,2,2
16514,3,1,57981,57981,57982,0,1,1
16515,6,3,57987,57987,57990,0,3,5
16516,6,3,57993,57993,57996,0,3,3
16517,1,1,57994,57996,57997,2,3,0
16518,4,1,57998,57998,57999,0,1,1
16519,3,2,58001,58001,58003,0,2,2
16520,3,3,58004,58004,58007,0,3,1
16521,3,3,58007,58007,58010,0,3,0
16522,4,2,58011,58011,58013,0,2,1
16523,4,2,58015,58015,58017,0,2,2
16524,6,3,58021,58021,58024,0,3,4
16525,2,3,58023,58024,58027,1,4,0
16526,1,1,58024,58027,58028,3,4,0
16527,6,2,58030,58030,58032,0,2,2
16528,5,2,58035,58035,58037,0,2,3
16529,4,1,58039,58039,58040,0,1,2
16530,6,3,58045,58045,58048,0,3,5
16531,6,3,58051,58051,58054,0,3,3
16532,3,3,58054,58054,58057,0,3,0
16533,3,3,58057,58057,58060,0,3,0
16534,1,1,58058,58060,58061,2,3,0
16535,2,2,58060,58061,58063,1,3,0
16536,1,2,58061,58063,58065,2,4,0
16537,6,3,58067,58067,58070,0,3,2
16538,4,1,58071,58071,58072,0,1,1
16539,6,1,58077,58077,58078,0,1,5
16540,3,3,58080,58080,58083,0,3,2
16541,5,1,58085,58085,58086,0,1,2
16542,3,2,58088,58088,58090,0,2,2
16543,5,3,58093,58093,58096,0,3,3
16544,3,2,58096,58096,58098,0,2,0
16545,1,2,58097,58098,58100,1,3,0
16546,4,2,58101,58101,58103,0,2,1
16547,3,2,58104,58104,58106,0,2,1
16548,4,3,58108,58108,58111,0,3,2
16549,6,3,58114,58114,58117,0,3,3
16550,3,1,58117,58117,58118,0,1,0
16551,5,2,58122,58122,58124,0,2,4
16552,6,1,58128,58128,58129,0,1,4
16553,5,3,58133,58133,58136,0,3,4
16554,5,3,58138,58138,58141,0,3,2
16555,5,3,58143,58143,58146,0,3,2
16556,1,1,58144,58146,58147,2,3,0
16557,4,1,58148,58148,58149,0,1,1
16558,6,2,58154,58154,58156,0,2,5
16559,5,1,58159,58159,58160,0,1,3
16560,4,1,58163,58163,58164,0,1,3
16561,6,1,58169,58169,58170,0,1,5
16562,6,1,58175,58175,58176,0,1,5
16563,6,1,58181,58181,58182,0,1,5
16564,6,2,58187,58187,58189,0,2,5
16565,5,3,58192,58192,58195,0,3,3
16566,6,3,58198,58198,58201,0,3,3
16567,2,3,58200,58201,58204,1,4,0
16568,5,3,58205,58205,58208,0,3,1
16569,1,2,58206,58208,58210,2,4,0
16570,6,1,58212,58212,58213,0,1,2
16571,5,1,58217,58217,58218,0,1,4
16572,1,3,58218,58218,58221,0,3,0
16573,2,2,58220,58221,58223,1,3,0
16574,5,2,58225,58225,58227,0,2,2
16575,3,3,58228,58228,58231,0,3,1
16576,1,1,58229,58231,58232,2,3,0
16577,6,1,58235,58235,58236,0,1,3
16578,1,3,58236,58236,58239,0,3,0
16579,4,1,58240,58240,58241,0,1,1
16580,1,2,58241,58241,58243,0,2,0
16581,3,3,58244,58244,58247,0,3,1
16582,6,3,58250,58250,58253,0,3,3
16583,2,3,58252,58253,58256,1,4,0
16584,5,1,58257,58257,58258,0,1,1
16585,2,3,58259,58259,58262,0,3,1
16586,2,1,58261,58262,58263,1,2,0
16587,6,3,58267,58267,58270,0,3,4
16588,5,3,58272,58272,58275,0,3,2
16589,6,3,58278,58278,58281,0,3,3
16590,1,2,58279,58281,58283,2,4,0
16591,2,1,58281,58283,58284,2,3,0
16592,6,1,58287,58287,58288,0,1,3
16593,5,3,58292,58292,58295,0,3,4
16594,4,2,58296,58296,58298,0,2,1
16595,1,2,58297,58298,58300,1,3,0
16596,5,1,58302,58302,58303,0,1,2
16597,2,3,58304,58304,58307,0,3,1
16598,4,3,58308,58308,58311,0,3,1
16599,4,2,58312,58312,58314,0,2,1
16600,3,3,58315,58315,58318,0,3,1
16601,4,3,58319,58319,58322,0,3,1
16602,1,3,58320,58322,58325,2,5,0
16603,3,1,58323,58325,58326,2,3,0
16604,5,1,58328,58328,58329,0,1,2
16605,2,2,58330,58330,58332,0,2,1
16606,6,2,58336,58336,58338,0,2,4
16607,1,3,58337,58338,58341,1,4,0
16608,2,1,58339,58341,58342,2,3,0
16609,6,1,58345,58345,58346,0,1,3
16610,3,2,58348,58348,58350,0,2,2
16611,1,1,58349,58350,58351,1,2,0
16612,2,2,58351,58351,58353,0,2,0
16613,2,3,58353,58353,58356,0,3,0
16614,1,1,58354,58356,58357,2,3,0
16615,1,1,58355,58357,58358,2,3,0
16616,1,2,58356,58358,58360,2,4,0
16617,2,1,58358,58360,58361,2,3,0
16618,5,1,58363,58363,58364,0,1,2
16619,3,3,58366,58366,58369,0,3,2
16620,1,2,58367,58369,58371,2,4,0
16621,1,2,58368,58371,58373,3,5,0
16622,1,1,58369,58373,58374,4,5,0
16623,3,3,58372,58374,58377,2,5,0
16624,6,1,58378,58378,58379,0,1,1
16625,1,1,58379,58379,58380,0,1,0
16626,2,3,58381,58381,58384,0,3,1
16627,2,1,58383,58384,58385,1,2,0
16628,1,2,58384,58385,58387,1,3,0
16629,4,1,58388,58388,58389,0,1,1
16630,2,2,58390,58390,58392,0,2,1
16631,3,1,58393,58393,58394,0,1,1
16632,2,3,58395,58395,58398,0,3,1
16633,3,2,58398,58398,58400,0,2,0
16634,5,3,58403,58403,58406,0,3,3
16635,2,2,58405,58406,58408,1,3,0
16636,1,2,58406,58408,58410,2,4,0
16637,5,3,58411,58411,58414,0,3,1
16638,1,2,58412,58414,58416,2,4,0
16639,3,3,58415,58416,58419,1,4,0
16640,5,1,58420,58420,58421,0,1,1
16641,6,3,58426,58426,58429,0,3,5
16642,5,2,58431,58431,58433,0,2,2
16643,2,2,58433,58433,58435,0,2,0
16644,2,3,58435,58435,58438,0,3,0
16645,6,3,58441,58441,58444,0,3,3
16646,5,3,58446,58446,58449,0,3,2
16647,4,1,58450,58450,58451,0,1,1
16648,3,1,58453,58453,58454,0,1,2
16649,4,3,58457,58457,58460,0,3,3
16650,2,3,58459,58460,58463,1,4,0
16651,6,2,58465,58465,58467,0,2,2
16652,1,2,58466,58467,58469,1,3,0
16653,2,1,58468,58469,58470,1,2,0
16654,2,2,58470,58470,58472,0,2,0
16655,3,1,58473,58473,58474,0,1,1
16656,4,2,58477,58477,58479,0,2,3
16657,5,2,58482,58482,58484,0,2,3
16658,1,2,58483,58484,58486,1,3,0
16659,1,2,58484,58486,58488,2,4,0
16660,2,1,58486,58488,58489,2,3,0
16661,6,2,58492,58492,58494,0,2,3
16662,5,1,58497,58497,58498,0,1,3
16663,5,3,58502,58502,58505,0,3,4
16664,2,3,58504,58505,58508,1,4,0
16665,1,2,58505,58508,58510,3,5,0
16666,5,1,58510,58510,58511,0,1,0
16667,6,1,58516,58516,58517,0,1,5
16668,4,2,58520,58520,58522,0,2,3
16669,4,3,58524,58524,58527,0,3,2
16670,5,2,58529,58529,58531,0,2,2
16671,4,2,58533,58533,58535,0,2,2
16672,2,1,58535,58535,58536,0,1,0
16673,1,1,58536,58536,58537,0,1,0
16674,1,2,58537,58537,58539,0,2,0
16675,6,2,58543,58543,58545,0,2,4
16676,5,1,58548,58548,58549,0,1,3
16677,5,2,58553,58553,58555,0,2,4
16678,4,3,58557,58557,58560,0,3,2
16679,4,1,58561,58561,58562,0,1,1
16680,1,1,58562,58562,58563,0,1,0
16681,2,1,58564,58564,58565,0,1,1
16682,2,3,58566,58566,58569,0,3,1
16683,6,3,58572,58572,58575,0,3,3
16684,4,3,58576,58576,58579,0,3,1
16685,3,3,58579,58579,58582,0,3,0
16686,4,1,58583,58583,58584,0,1,1
16687,1,2,58584,58584,58586,0,2,0
16688,4,3,58588,58588,58591,0,3,2
16689,3,3,58591,58591,58594,0,3,0
16690,4,1,58595,58595,58596,0,1,1
16691,5,2,58600,58600,58602,0,2,4
16692,6,3,58606,58606,58609,0,3,4
16693,3,1,58609,58609,58610,0,1,0
16694,6,2,58615,58615,58617,0,2,5
16695,4,2,58619,58619,58621,0,2,2
16696,1,1,58620,58621,58622,1,2,0
16697,4,3,58624,58624,58627,0,3,2
16698,1,1,58625,58627,58628,2,3,0
16699,4,3,58629,58629,58632,0,3,1
16700,6,2,58635,58635,58637,0,2,3
16701,1,2,58636,58637,58639,1,3,0
16702,3,3,58639,58639,58642,0,3,0
16703,5,3,58644,58644,58647,0,3,2
16704,6,1,58650,58650,58651,0,1,3
16705,5,1,58655,58655,58656,0,1,4
16706,6,2,58661,58661,58663,0,2,5
16707,4,2,58665,58665,58667,0,2,2
16708,4,2,58669,58669,58671,0,2,2
16709,1,1,58670,58671,58672,1,2,0
16710,5,1,58675,58675,58676,0,1,3
16711,6,1,58681,58681,58682,0,1,5
16712,3,2,58684,58684,58686,0,2,2
16713,5,1,58689,58689,58690,0,1,3
16714,5,1,58694,58694,58695,0,1,4
16715,2,1,58696,58696,58697,0,1,1
16716,6,1,58702,58702,58703,0,1,5
16717,3,3,58705,58705,58708,0,3,2
16718,1,3,58706,58708,58711,2,5,0
16719,1,3,58707,58711,58714,4,7,0
16720,4,2,58711,58714,58716,3,5,0
16721,1,1,58712,58716,58717,4,5,0
16722,3,3,58715,58717,58720,2,5,0
16723,1,3,58716,58720,58723,4,7,0
16724,3,1,58719,58723,58724,4,5,0
16725,4,3,58723,58724,58727,1,4,0
16726,2,1,58725,58727,58728,2,3,0
16727,5,1,58730,58730,58731,0,1,2
16728,5,2,58735,58735,58737,0,2,4
16729,5,2,58740,58740,58742,0,2,3
16730,4,3,58744,58744,58747,0,3,2
16731,3,2,58747,58747,58749,0,2,0
16732,3,2,58750,58750,58752,0,2,1
16733,6,3,58756,58756,58759,0,3,4
16734,1,3,58757,58759,58762,2,5,0
16735,4,2,58761,58762,58764,1,3,0
16736,5,1,58766,58766,58767,0,1,2
16737,2,3,58768,58768,58771,0,3,1
16738,2,2,58770,58771,58773,1,3,0
16739,5,3,58775,58775,58778,0,3,2
16740,4,3,58779,58779,58782,0,3,1
16741,5,2,58784,58784,58786,0,2,2
16742,4,1,58788,58788,58789,0,1,2
16743,4,1,58792,58792,58793,0,1,3
16744,6,2,58798,58798,58800,0,2,5
16745,2,2,58800,58800,58802,0,2,0
16746,6,2,58806,58806,58808,0,2,4
16747,3,2,58809,58809,58811,0,2,1
16748,6,1,58815,58815,58816,0,1,4
16749,5,3,58820,58820,58823,0,3,4
16750,1,1,58821,58823,58824,2,3,0
16751,2,1,58823,58824,58825,1,2,0
16752,2,3,58825,58825,58828,0,3,0
16753,4,1,58829,58829,58830,0,1,1
16754,6,2,58835,58835,58837,0,2,5
16755,3,1,58838,58838,58839,0,1,1
16756,5,1,58843,58843,58844,0,1,4
16757,4,3,58847,58847,58850,0,3,3
16758,4,2,58851,58851,58853,0,2,1
16759,3,1,58854,58854,58855,0,1,1
16760,2,3,58856,58856,58859,0,3,1
16761,1,3,58857,58859,58862,2,5,0
16762,4,3,58861,58862,58865,1,4,0
16763,1,3,58862,58865,58868,3,6,0
16764,5,3,58867,58868,58871,1,4,0
16765,5,2,58872,58872,58874,0,2,1
16766,2,3,58874,58874,58877,0,3,0
16767,1,1,58875,58877,58878,2,3,0
16768,6,1,58881,58881,58882,0,1,3
16769,6,2,58887,58887,58889,0,2,5
16770,5,1,58892,58892,58893,0,1,3
16771,6,2,58898,58898,58900,0,2,5
16772,1,1,58899,58900,58901,1,2,0
16773,5,2,58904,58904,58906,0,2,3
16774,2,2,58906,58906,58908,0,2,0
16775,4,1,58910,58910,58911,0,1,2
16776,3,2,58913,58913,58915,0,2,2
16777,2,2,58915,58915,58917,0,2,0
16778,3,2,58918,58918,58920,0,2,1
16779,2,3,58920,58920,58923,0,3,0
16780,4,3,58924,58924,58927,0,3,1
16781,2,3,58926,58927,58930,1,4,0
16782,3,1,58929,58930,58931,1,2,0
16783,3,1,58932,58932,58933,0,1,1
16784,5,3,58937,58937,58940,0,3,4
16785,4,3,58941,58941,58944,0,3,1
16786,5,3,58946,58946,58949,0,3,2
16787,5,3,58951,58951,58954,0,3,2
16788,6,1,58957,58957,58958,0,1,3
16789,4,1,58961,58961,58962,0,1,3
16790,2,3,58963,58963,58966,0,3,1
16791,2,2,58965,58966,58968,1,3,0
16792,2,1,58967,58968,58969,1,2,0
16793,1,2,58968,58969,58971,1,3,0
16794,3,2,58971,58971,58973,0,2,0
16795,1,1,58972,58973,58974,1,2,0
16796,2,3,58974,58974,58977,0,3,0
16797,4,1,58978,58978,58979,0,1,1
16798,2,3,58980,58980,58983,0,3,1
16799,2,3,58982,58983,58986,1,4,0
16800,6,2,58988,58988,58990,0,2,2
16801,2,1,58990,58990,58991,0,1,0
16802,3,3,58993,58993,58996,0,3,2
16803,3,2,58996,58996,58998,0,2,0
16804,4,3,59000,59000,59003,0,3,2
16805,3,1,59003,59003,59004,0,1,0
16806,1,2,59004,59004,59006,0,2,0
16807,1,3,59005,59006,59009,1,4,0
16808,1,2,59006,59009,59011,3,5,0
16809,1,1,59007,59011,59012,4,5,0
16810,5,3,59012,59012,59015,0,3,0
16811,4,2,59016,59016,59018,0,2,1
16812,1,3,59017,59018,59021,1,4,0
16813,3,1,59020,59021,59022,1,2,0
16814,4,2,59024,59024,59026,0,2,2
16815,3,1,59027,59027,59028,0,1,1
16816,4,2,59031,59031,59033,0,2,3
16817,3,1,59034,59034,59035,0,1,1
16818,5,1,59039,59039,59040,0,1,4
16819,5,2,59044,59044,59046,0,2,4
16820,6,3,59050,59050,59053,0,3,4
16821,2,1,59052,59053,59054,1,2,0
16822,3,2,59055,59055,59057,0,2,1
16823,1,1,59056,59057,59058,1,2,0
16824,4,2,59060,59060,59062,0,2,2
16825,1,2,59061,59062,59064,1,3,0
16826,1,2,59062,59064,59066,2,4,0
16827,3,2,59065,59066,59068,1,3,0
16828,3,2,59068,59068,59070,0,2,0
16829,5,3,59073,59073,59076,0,3,3
16830,2,2,59075,59076,59078,1,3,0
16831,2,1,59077,59078,59079,1,2,0
16832,6,2,59083,59083,59085,0,2,4
16833,2,2,59085,59085,59087,0,2,0
16834,3,3,59088,59088,59091,0,3,1
16835,4,2,59092,59092,59094,0,2,1
16836,3,1,59095,59095,59096,0,1,1
16837,4,3,59099,59099,59102,0,3,3
16838,1,3,59100,59102,59105,2,5,0
16839,3,3,59103,59105,59108,2,5,0
16840,4,3,59107,59108,59111,1,4,0
16841,6,2,59113,59113,59115,0,2,2
16842,6,1,59119,59119,59120,0,1,4
16843,4,1,59123,59123,59124,0,1,3
16844,6,3,59129,59129,59132,0,3,5
16845,6,3,59135,59135,59138,0,3,3
16846,2,1,59137,59138,59139,1,2,0
16847,5,3,59142,59142,59145,0,3,3
16848,4,2,59146,59146,59148,0,2,1
16849,4,3,59150,59150,59153,0,3,2
16850,4,2,59154,59154,59156,0,2,1
16851,5,1,59159,59159,59160,0,1,3
16852,6,2,59165,59165,59167,0,2,5
16853,5,3,59170,59170,59173,0,3,3
16854,6,1,59176,59176,59177,0,1,3
16855,6,2,59182,59182,59184,0,2,5
16856,6,1,59188,59188,59189,0,1,4
16857,5,3,59193,59193,59196,0,3,4
16858,6,3,59199,59199,59202,0,3,3
16859,1,2,59200,59202,59204,2,4,0
16860,5,1,59205,59205,59206,0,1,1
16861,6,3,59211,59211,59214,0,3,5
16862,5,1,59216,59216,59217,0,1,2
16863,6,3,59222,59222,59225,0,3,5
16864,4,3,59226,59226,59229,0,3,1
16865,2,1,59228,59229,59230,1,2,0
16866,4,1,59232,59232,59233,0,1,2
16867,3,2,59235,59235,59237,0,2,2
16868,5,3,59240,59240,59243,0,3,3
16869,2,2,59242,59243,59245,1,3,0
16870,5,1,59247,59247,59248,0,1,2
16871,4,2,59251,59251,59253,0,2,3
16872,1,3,59252,59253,59256,1,4,0
16873,3,3,59255,59256,59259,1,4,0
16874,2,3,59257,59259,59262,2,5,0
16875,3,2,59260,59262,59264,2,4,0
16876,4,2,59264,59264,59266,0,2,0
16877,6,2,59270,59270,59272,0,2,4
16878,2,2,59272,59272,59274,0,2,0
16879,4,3,59276,59276,59279,0,3,2
16880,3,3,59279,59279,59282,0,3,0
16881,3,1,59282,59282,59283,0,1,0
16882,6,3,59288,59288,59291,0,3,5
16883,3,2,59291,59291,59293,0,2,0
16884,3,3,59294,59294,59297,0,3,1
16885,2,1,59296,59297,59298,1,2,0
16886,3,1,59299,59299,59300,0,1,1
16887,4,1,59303,59303,59304,0,1,3
16888,3,2,59306,59306,59308,0,2,2
16889,6,3,59312,59312,59315,0,3,4
16890,4,3,59316,59316,59319,0,3,1
16891,6,2,59322,59322,59324,0,2,3
16892,2,1,59324,59324,59325,0,1,0
16893,6,3,59330,59330,59333,0,3,5
16894,3,3,59333,59333,59336,0,3,0
16895,1,2,59334,59336,59338,2,4,0
16896,1,3,59335,59338,59341,3,6,0
16897,1,1,59336,59341,59342,5,6,0
16898,4,2,59340,59342,59344,2,4,0
16899,2,2,59342,59344,59346,2,4,0
16900,1,3,59343,59346,59349,3,6,0
16901,6,1,59349,59349,59350,0,1,0
16902,2,1,59351,59351,59352,0,1,1
16903,6,3,59357,59357,59360,0,3,5
16904,1,3,59358,59360,59363,2,5,0
16905,4,1,59362,59363,59364,1,2,0
16906,3,1,59365,59365,59366,0,1,1
16907,4,2,59369,59369,59371,0,2,3
16908,6,3,59375,59375,59378,0,3,4
16909,2,1,59377,59378,59379,1,2,0
16910,1,1,59378,59379,59380,1,2,0
16911,1,1,59379,59380,59381,1,2,0
16912,4,3,59383,59383,59386,0,3,2
16913,1,3,59384,59386,59389,2,5,0
16914,5,2,59389,59389,59391,0,2,0
16915,3,1,59392,59392,59393,0,1,1
16916,5,1,59397,59397,59398,0,1,4
16917,1,3,59398,59398,59401,0,3,0
16918,3,2,59401,59401,59403,0,2,0
16919,6,3,59407,59407,59410,0,3,4
16920,3,1,59410,59410,59411,0,1,0
16921,2,1,59412,59412,59413,0,1,1
16922,3,2,59415,59415,59417,0,2,2
16923,4,1,59419,59419,59420,0,1,2
16924,6,1,59425,59425,59426,0,1,5
16925,5,2,59430,59430,59432,0,2,4
16926,3,3,59433,59433,59436,0,3,1
16927,5,2,59438,59438,59440,0,2,2
16928,1,2,59439,59440,59442,1,3,0
16929,3,2,59442,59442,59444,0,2,0
16930,2,1,59444,59444,59445,0,1,0
16931,2,1,59446,59446,59447,0,1,1
16932,6,3,59452,59452,59455,0,3,5
16933,3,2,59455,59455,59457,0,2,0
16934,4,2,59459,59459,59461,0,2,2
16935,5,3,59464,59464,59467,0,3,3
16936,2,3,59466,59467,59470,1,4,0
16937,3,2,59469,59470,59472,1,3,0
16938,6,2,59475,59475,59477,0,2,3
16939,2,2,59477,59477,59479,0,2,0
16940,1,2,59478,59479,59481,1,3,0
16941,3,3,59481,59481,59484,0,3,0
16942,5,2,59486,59486,59488,0,2,2
16943,2,2,59488,59488,59490,0,2,0
16944,2,1,59490,59490,59491,0,1,0
16945,4,1,59494,59494,59495,0,1,3
16946,1,3,59495,59495,59498,0,3,0
16947,6,3,59501,59501,59504,0,3,3
16948,5,2,59506,59506,59508,0,2,2
16949,6,1,59512,59512,59513,0,1,4
16950,5,2,59517,59517,59519,0,2,4
16951,5,1,59522,59522,59523,0,1,3
16952,1,3,59523,59523,59526,0,3,0
16953,4,3,59527,59527,59530,0,3,1
16954,2,1,59529,59530,59531,1,2,0
16955,4,1,59533,59533,59534,0,1,2
16956,1,1,59534,59534,59535,0,1,0
16957,5,3,59539,59539,59542,0,3,4
16958,1,2,59540,59542,59544,2,4,0
16959,3,3,59543,59544,59547,1,4,0
16960,1,3,59544,59547,59550,3,6,0
16961,6,2,59550,59550,59552,0,2,0
16962,6,3,59556,59556,59559,0,3,4
16963,4,3,59560,59560,59563,0,3,1
16964,6,1,59566,59566,59567,0,1,3
16965,3,1,59569,59569,59570,0,1,2
16966,6,1,59575,59575,59576,0,1,5
16967,6,2,59581,59581,59583,0,2,5
16968,2,1,59583,59583,59584,0,1,0
16969,5,1,59588,59588,59589,0,1,4
16970,1,1,59589,59589,59590,0,1,0
16971,6,1,59595,59595,59596,0,1,5
16972,3,1,59598,59598,59599,0,1,2
16973,3,2,59601,59601,59603,0,2,2
16974,6,3,59607,59607,59610,0,3,4
16975,5,2,59612,59612,59614,0,2,2
16976,1,2,59613,59614,59616,1,3,0
16977,6,2,59619,59619,59621,0,2,3
16978,3,1,59622,59622,59623,0,1,1
16979,3,1,59625,59625,59626,0,1,2
16980,4,2,59629,59629,59631,0,2,3
16981,3,2,59632,59632,59634,0,2,1
16982,4,2,59636,59636,59638,0,2,2
16983,6,3,59642,59642,59645,0,3,4
16984,5,3,59647,59647,59650,0,3,2
16985,3,2,59650,59650,59652,0,2,0
16986,5,3,59655,59655,59658,0,3,3
16987,4,2,59659,59659,59661,0,2,1
16988,1,3,59660,59661,59664,1,4,0
16989,5,3,59665,59665,59668,0,3,1
16990,6,3,59671,59671,59674,0,3,3
16991,6,2,59677,59677,59679,0,2,3
16992,5,3,59682,59682,59685,0,3,3
16993,6,2,59688,59688,59690,0,2,3
16994,4,1,59692,59692,59693,0,1,2
16995,1,1,59693,59693,59694,0,1,0
16996,1,1,59694,59694,59695,0,1,0
16997,2,2,59696,59696,59698,0,2,1
16998,5,2,59701,59701,59703,0,2,3
16999,4,2,59705,59705,59707,0,2,2
17000,6,2,59711,59711,59713,0,2,4
17001,6,3,59717,59717,59720,0,3,4
17002,3,3,59720,59720,59723,0,3,0
17003,3,2,59723,59723,59725,0,2,0
17004,1,2,59724,59725,59727,1,3,0
17005,6,1,59730,59730,59731,0,1,3
17006,4,2,59734,59734,59736,0,2,3
17007,3,2,59737,59737,59739,0,2,1
17008,3,1,59740,59740,59741,0,1,1
17009,3,3,59743,59743,59746,0,3,2
17010,5,1,59748,59748,59749,0,1,2
17011,6,2,59754,59754,59756,0,2,5
17012,2,1,59756,59756,59757,0,1,0
17013,4,2,59760,59760,59762,0,2,3
17014,3,2,59763,59763,59765,0,2,1
17015,4,2,59767,59767,59769,0,2,2
17016,1,1,59768,59769,59770,1,2,0
17017,6,1,59774,59774,59775,0,1,4
17018,3,1,59777,59777,59778,0,1,2
17019,3,2,59780,59780,59782,0,2,2
17020,4,2,59784,59784,59786,0,2,2
17021,2,2,59786,59786,59788,0,2,0
17022,4,3,59790,59790,59793,0,3,2
17023,1,3,59791,59793,59796,2,5,0
17024,5,1,59796,59796,59797,0,1,0
17025,5,1,59801,59801,59802,0,1,4
17026,2,3,59803,59803,59806,0,3,1
17027,1,3,59804,59806,59809,2,5,0
17028,6,2,59810,59810,59812,0,2,1
17029,3,1,59813,59813,59814,0,1,1
17030,2,1,59815,59815,59816,0,1,1
17031,4,3,59819,59819,59822,0,3,3
17032,5,1,59824,59824,59825,0,1,2
17033,5,1,59829,59829,59830,0,1,4
17034,3,3,59832,59832,59835,0,3,2
17035,2,2,59834,59835,59837,1,3,0
17036,4,1,59838,59838,59839,0,1,1
17037,6,2,59844,59844,59846,0,2,5
17038,2,2,59846,59846,59848,0,2,0
17039,2,1,59848,59848,59849,0,1,0
17040,2,2,59850,59850,59852,0,2,1
17041,2,2,59852,59852,59854,0,2,0
17042,4,2,59856,59856,59858,0,2,2
17043,5,2,59861,59861,59863,0,2,3
17044,6,1,59867,59867,59868,0,1,4
17045,4,2,59871,59871,59873,0,2,3
17046,4,2,59875,59875,59877,0,2,2
17047,1,1,59876,59877,59878,1,2,0
17048,5,3,59881,59881,59884,0,3,3
17049,1,2,59882,59884,59886,2,4,0
17050,6,1,59888,59888,59889,0,1,2
17051,5,1,59893,59893,59894,0,1,4
17052,4,2,59897,59897,59899,0,2,3
17053,2,2,59899,59899,59901,0,2,0
17054,5,1,59904,59904,59905,0,1,3
17055,4,2,59908,59908,59910,0,2,3
17056,3,2,59911,59911,59913,0,2,1
17057,2,2,59913,59913,59915,0,2,0
17058,2,2,59915,59915,59917,0,2,0
17059,6,3,59921,59921,59924,0,3,4
17060,5,2,59926,59926,59928,0,2,2
17061,6,3,59932,59932,59935,0,3,4
17062,5,2,59937,59937,59939,0,2,2
17063,6,1,59943,59943,59944,0,1,4
17064,6,3,59949,59949,59952,0,3,5
17065,1,3,59950,59952,59955,2,5,0
17066,2,2,59952,59955,59957,3,5,0
17067,4,2,59956,59957,59959,1,3,0
17068,3,1,59959,59959,59960,0,1,0
17069,5,2,59964,59964,59966,0,2,4
17070,2,2,59966,59966,59968,0,2,0
17071,6,1,59972,59972,59973,0,1,4
17072,3,2,59975,59975,59977,0,2,2
17073,4,1,59979,59979,59980,0,1,2
17074,6,1,59985,59985,59986,0,1,5
17075,2,1,59987,59987,59988,0,1,1
17076,4,1,59991,59991,59992,0,1,3
17077,6,3,59997,59997,60000,0,3,5
17078,6,3,60003,60003,60006,0,3,3
17079,6,3,60009,60009,60012,0,3,3
17080,6,2,60015,60015,60017,0,2,3
17081,4,3,60019,60019,60022,0,3,2
17082,1,3,60020,60022,60025,2,5,0
17083,6,3,60026,60026,60029,0,3,1
17084,1,2,60027,60029,60031,2,4,0
17085,1,3,60028,60031,60034,3,6,0
17086,5,1,60033,60034,60035,1,2,0
17087,3,3,60036,60036,60039,0,3,1
17088,3,1,60039,60039,60040,0,1,0
17089,5,2,60044,60044,60046,0,2,4
17090,5,2,60049,60049,60051,0,2,3
17091,6,1,60055,60055,60056,0,1,4
17092,3,3,60058,60058,60061,0,3,2
17093,2,2,60060,60061,60063,1,3,0
17094,2,1,60062,60063,60064,1,2,0
17095,5,1,60067,60067,60068,0,1,3
17096,1,2,60068,60068,60070,0,2,0
17097,2,2,60070,60070,60072,0,2,0
17098,1,3,60071,60072,60075,1,4,0
17099,6,2,60077,60077,60079,0,2,2
17100,5,1,60082,60082,60083,0,1,3
17101,5,1,60087,60087,60088,0,1,4
17102,6,2,60093,60093,60095,0,2,5
17103,2,3,60095,60095,60098,0,3,0
17104,1,1,60096,60098,60099,2,3,0
17105,4,1,60100,60100,60101,0,1,1
17106,5,2,60105,60105,60107,0,2,4
17107,3,2,60108,60108,60110,0,2,1
17108,6,1,60114,60114,60115,0,1,4
17109,6,3,60120,60120,60123,0,3,5
17110,1,3,60121,60123,60126,2,5,0
17111,6,1,60127,60127,60128,0,1,1
17112,4,3,60131,60131,60134,0,3,3
17113,3,1,60134,60134,60135,0,1,0
17114,4,2,60138,60138,60140,0,2,3
17115,6,2,60144,60144,60146,0,2,4
17116,2,3,60146,60146,60149,0,3,0
17117,1,1,60147,60149,60150,2,3,0
17118,6,3,60153,60153,60156,0,3,3
17119,2,1,60155,60156,60157,1,2,0
17120,4,3,60159,60159,60162,0,3,2
17121,3,3,60162,60162,60165,0,3,0
17122,1,2,60163,60165,60167,2,4,0
17123,4,1,60167,60167,60168,0,1,0
17124,1,3,60168,60168,60171,0,3,0
17125,1,1,60169,60171,60172,2,3,0
17126,1,2,60170,60172,60174,2,4,0
17127,1,1,60171,60174,60175,3,4,0
17128,3,1,60174,60175,60176,1,2,0
17129,4,3,60178,60178,60181,0,3,2
17130,3,2,60181,60181,60183,0,2,0
17131,4,3,60185,60185,60188,0,3,2
17132,4,1,60189,60189,60190,0,1,1
17133,1,1,60190,60190,60191,0,1,0
17134,6,2,60196,60196,60198,0,2,5
17135,2,3,60198,60198,60201,0,3,0
17136,3,3,60201,60201,60204,0,3,0
17137,5,1,60206,60206,60207,0,1,2
17138,3,1,60209,60209,60210,0,1,2
17139,6,1,60215,60215,60216,0,1,5
17140,5,2,60220,60220,60222,0,2,4
17141,5,2,60225,60225,60227,0,2,3
17142,1,1,60226,60227,60228,1,2,0
17143,4,1,60230,60230,60231,0,1,2
17144,3,2,60233,60233,60235,0,2,2
17145,4,2,60237,60237,60239,0,2,2
17146,3,1,60240,60240,60241,0,1,1
17147,3,3,60243,60243,60246,0,3,2
17148,6,1,60249,60249,60250,0,1,3
17149,5,2,60254,60254,60256,0,2,4
17150,4,2,60258,60258,60260,0,2,2
17151,2,3,60260,60260,60263,0,3,0
17152,5,2,60265,60265,60267,0,2,2
17153,4,3,60269,60269,60272,0,3,2
17154,5,1,60274,60274,60275,0,1,2
17155,5,1,60279,60279,60280,0,1,4
17156,6,2,60285,60285,60287,0,2,5
17157,2,1,60287,60287,60288,0,1,0
17158,2,1,60289,60289,60290,0,1,1
17159,4,2,60293,60293,60295,0,2,3
17160,2,1,60295,60295,60296,0,1,0
17161,4,3,60299,60299,60302,0,3,3
17162,2,3,60301,60302,60305,1,4,0
17163,4,1,60305,60305,60306,0,1,0
17164,3,3,60308,60308,60311,0,3,2
17165,6,1,60314,60314,60315,0,1,3
17166,4,2,60318,60318,60320,0,2,3
17167,2,3,60320,60320,60323,0,3,0
17168,2,3,60322,60323,60326,1,4,0
17169,4,3,60326,60326,60329,0,3,0
17170,3,1,60329,60329,60330,0,1,0
17171,6,3,60335,60335,60338,0,3,5
17172,3,3,60338,60338,60341,0,3,0
17173,4,1,60342,60342,60343,0,1,1
17174,3,3,60345,60345,60348,0,3,2
17175,6,1,60351,60351,60352,0,1,3
17176,6,1,60357,60357,60358,0,1,5
17177,1,1,60358,60358,60359,0,1,0
17178,3,1,60361,60361,60362,0,1,2
17179,2,2,60363,60363,60365,0,2,1
17180,1,2,60364,60365,60367,1,3,0
17181,1,3,60365,60367,60370,2,5,0
17182,3,3,60368,60370,60373,2,5,0
17183,2,1,60370,60373,60374,3,4,0
17184,4,2,60374,60374,60376,0,2,0
17185,2,2,60376,60376,60378,0,2,0
17186,3,3,60379,60379,60382,0,3,1
17187,2,3,60381,60382,60385,1,4,0
17188,1,2,60382,60385,60387,3,5,0
17189,2,3,60384,60387,60390,3,6,0
17190,3,1,60387,60390,60391,3,4,0
17191,4,1,60391,60391,60392,0,1,0
17192,2,1,60393,60393,60394,0,1,1
17193,6,3,60399,60399,60402,0,3,5
17194,5,1,60404,60404,60405,0,1,2
17195,6,3,60410,60410,60413,0,3,5
17196,3,3,60413,60413,60416,0,3,0
17197,4,1,60417,60417,60418,0,1,1
17198,5,2,60422,60422,60424,0,2,4
17199,3,1,60425,60425,60426,0,1,1
17200,6,3,60431,60431,60434,0,3,5
17201,1,2,60432,60434,60436,2,4,0
17202,3,1,60435,60436,60437,1,2,0
17203,4,2,60439,60439,60441,0,2,2
17204,4,1,60443,60443,60444,0,1,2
17205,3,2,60446,60446,60448,0,2,2
17206,1,3,60447,60448,60451,1,4,0
17207,6,3,60453,60453,60456,0,3,2
17208,2,3,60455,60456,60459,1,4,0
17209,4,1,60459,60459,60460,0,1,0
17210,5,2,60464,60464,60466,0,2,4
17211,3,2,60467,60467,60469,0,2,1
17212,6,2,60473,60473,60475,0,2,4
17213,1,3,60474,60475,60478,1,4,0
17214,5,2,60479,60479,60481,0,2,1
17215,4,1,60483,60483,60484,0,1,2
17216,4,2,60487,60487,60489,0,2,3
17217,3,1,60490,60490,60491,0,1,1
17218,4,2,60494,60494,60496,0,2,3
17219,2,1,60496,60496,60497,0,1,0
17220,1,3,60497,60497,60500,0,3,0
17221,5,1,60502,60502,60503,0,1,2
17222,6,2,60508,60508,60510,0,2,5
17223,6,3,60514,60514,60517,0,3,4
17224,2,1,60516,60517,60518,1,2,0
17225,1,2,60517,60518,60520,1,3,0
17226,3,3,60520,60520,60523,0,3,0
17227,4,3,60524,60524,60527,0,3,1
17228,4,2,60528,60528,60530,0,2,1
17229,6,2,60534,60534,60536,0,2,4
17230,3,3,60537,60537,60540,0,3,1
17231,4,2,60541,60541,60543,0,2,1
17232,3,2,60544,60544,60546,0,2,1
17233,4,3,60548,60548,60551,0,3,2
17234,6,2,60554,60554,60556,0,2,3
17235,4,1,60558,60558,60559,0,1,2
17236,1,3,60559,60559,60562,0,3,0
17237,1,3,60560,60562,60565,2,5,0
17238,3,2,60563,60565,60567,2,4,0
17239,3,2,60566,60567,60569,1,3,0
17240,4,1,60570,60570,60571,0,1,1
17241,6,3,60576,60576,60579,0,3,5
17242,4,1,60580,60580,60581,0,1,1
17243,1,1,60581,60581,60582,0,1,0
17244,2,1,60583,60583,60584,0,1,1
17245,1,3,60584,60584,60587,0,3,0
17246,5,2,60589,60589,60591,0,2,2
17247,2,2,60591,60591,60593,0,2,0
17248,5,2,60596,60596,60598,0,2,3
17249,4,2,60600,60600,60602,0,2,2
17250,2,3,60602,60602,60605,0,3,0
17251,2,3,60604,60605,60608,1,4,0
17252,5,3,60609,60609,60612,0,3,1
17253,6,1,60615,60615,60616,0,1,3
17254,2,3,60617,60617,60620,0,3,1
17255,4,2,60621,60621,60623,0,2,1
17256,5,3,60626,60626,60629,0,3,3
17257,3,1,60629,60629,60630,0,1,0
17258,6,1,60635,60635,60636,0,1,5
17259,4,2,60639,60639,60641,0,2,3
17260,2,2,60641,60641,60643,0,2,0
17261,1,3,60642,60643,60646,1,4,0
17262,3,1,60645,60646,60647,1,2,0
17263,3,2,60648,60648,60650,0,2,1
17264,3,2,60651,60651,60653,0,2,1
17265,5,3,60656,60656,60659,0,3,3
17266,1,1,60657,60659,60660,2,3,0
17267,5,1,60662,60662,60663,0,1,2
17268,4,2,60666,60666,60668,0,2,3
17269,4,2,60670,60670,60672,0,2,2
17270,2,3,60672,60672,60675,0,3,0
17271,5,1,60677,60677,60678,0,1,2
17272,3,1,60680,60680,60681,0,1,2
17273,3,2,60683,60683,60685,0,2,2
17274,5,3,60688,60688,60691,0,3,3
17275,4,2,60692,60692,60694,0,2,1
17276,5,3,60697,60697,60700,0,3,3
17277,3,1,60700,60700,60701,0,1,0
17278,2,1,60702,60702,60703,0,1,1
17279,2,3,60704,60704,60707,0,3,1
17280,4,3,60708,60708,60711,0,3,1
17281,3,2,60711,60711,60713,0,2,0
17282,3,1,60714,60714,60715,0,1,1
17283,5,2,60719,60719,60721,0,2,4
17284,1,1,60720,60721,60722,1,2,0
17285,6,1,60726,60726,60727,0,1,4
17286,5,2,60731,60731,60733,0,2,4
17287,5,3,60736,60736,60739,0,3,3
17288,6,1,60742,60742,60743,0,1,3
17289,4,2,60746,60746,60748,0,2,3
17290,3,3,60749,60749,60752,0,3,1
17291,3,1,60752,60752,60753,0,1,0
17292,5,3,60757,60757,60760,0,3,4
17293,6,3,60763,60763,60766,0,3,3
17294,3,2,60766,60766,60768,0,2,0
17295,4,3,60770,60770,60773,0,3,2
17296,2,2,60772,60773,60775,1,3,0
17297,2,1,60774,60775,60776,1,2,0
17298,2,2,60776,60776,60778,0,2,0
17299,4,3,60780,60780,60783,0,3,2
17300,5,1,60785,60785,60786,0,1,2
17301,1,1,60786,60786,60787,0,1,0
17302,1,1,60787,60787,60788,0,1,0
17303,3,1,60790,60790,60791,0,1,2
17304,2,1,60792,60792,60793,0,1,1
17305,4,3,60796,60796,60799,0,3,3
17306,3,3,60799,60799,60802,0,3,0
17307,4,1,60803,60803,60804,0,1,1
17308,4,1,60807,60807,60808,0,1,3
17309,1,2,60808,60808,60810,0,2,0
17310,3,3,60811,60811,60814,0,3,1
17311,2,1,60813,60814,60815,1,2,0
17312,3,2,60816,60816,60818,0,2,1
17313,2,1,60818,60818,60819,0,1,0
17314,1,1,60819,60819,60820,0,1,0
17315,3,2,60822,60822,60824,0,2,2
17316,1,2,60823,60824,60826,1,3,0
17317,2,2,60825,60826,60828,1,3,0
17318,1,2,60826,60828,60830,2,4,0
17319,5,3,60831,60831,60834,0,3,1
17320,6,3,60837,60837,60840,0,3,3
17321,3,2,60840,60840,60842,0,2,0
17322,2,1,60842,60842,60843,0,1,0
17323,4,2,60846,60846,60848,0,2,3
17324,2,1,60848,60848,60849,0,1,0
17325,2,3,60850,60850,60853,0,3,1
17326,3,1,60853,60853,60854,0,1,0
17327,4,2,60857,60857,60859,0,2,3
17328,3,3,60860,60860,60863,0,3,1
17329,6,2,60866,60866,60868,0,2,3
17330,2,1,60868,60868,60869,0,1,0
17331,5,3,60873,60873,60876,0,3,4
17332,3,2,60876,60876,60878,0,2,0
17333,5,1,60881,60881,60882,0,1,3
17334,1,1,60882,60882,60883,0,1,0
17335,3,1,60885,60885,60886,0,1,2
17336,5,3,60890,60890,60893,0,3,4
17337,2,2,60892,60893,60895,1,3,0
17338,3,2,60895,60895,60897,0,2,0
17339,5,1,60900,60900,60901,0,1,3
17340,1,3,60901,60901,60904,0,3,0
17341,5,2,60906,60906,60908,0,2,2
17342,5,2,60911,60911,60913,0,2,3
17343,5,2,60916,60916,60918,0,2,3
17344,3,3,60919,60919,60922,0,3,1
17345,1,1,60920,60922,60923,2,3,0
17346,4,1,60924,60924,60925,0,1,1
17347,5,2,60929,60929,60931,0,2,4
17348,2,2,60931,60931,60933,0,2,0
17349,5,2,60936,60936,60938,0,2,3
17350,5,1,60941,60941,60942,0,1,3
17351,6,1,60947,60947,60948,0,1,5
17352,4,3,60951,60951,60954,0,3,3
17353,3,3,60954,60954,60957,0,3,0
17354,2,2,60956,60957,60959,1,3,0
17355,5,2,60961,60961,60963,0,2,2
17356,5,3,60966,60966,60969,0,3,3
17357,4,3,60970,60970,60973,0,3,1
17358,4,3,60974,60974,60977,0,3,1
17359,1,2,60975,60977,60979,2,4,0
17360,5,1,60980,60980,60981,0,1,1
17361,6,1,60986,60986,60987,0,1,5
17362,4,2,60990,60990,60992,0,2,3
17363,3,2,60993,60993,60995,0,2,1
17364,2,1,60995,60995,60996,0,1,0
17365,4,2,60999,60999,61001,0,2,3
17366,4,1,61003,61003,61004,0,1,2
17367,6,1,61009,61009,61010,0,1,5
17368,4,1,61013,61013,61014,0,1,3
17369,1,2,61014,61014,61016,0,2,0
17370,4,3,61018,61018,61021,0,3,2
17371,1,1,61019,61021,61022,2,3,0
17372,5,1,61024,61024,61025,0,1,2
17373,3,1,61027,61027,61028,0,1,2
17374,1,1,61028,61028,61029,0,1,0
17375,1,2,61029,61029,61031,0,2,0
17376,5,2,61034,61034,61036,0,2,3
17377,5,2,61039,61039,61041,0,2,3
17378,4,1,61043,61043,61044,0,1,2
17379,4,1,61047,61047,61048,0,1,3
17380,5,1,61052,61052,61053,0,1,4
17381,2,1,61054,61054,61055,0,1,1
17382,6,1,61060,61060,61061,0,1,5
17383,2,3,61062,61062,61065,0,3,1
17384,3,2,61065,61065,61067,0,2,0
17385,4,2,61069,61069,61071,0,2,2
17386,5,1,61074,61074,61075,0,1,3
17387,6,3,61080,61080,61083,0,3,5
17388,5,3,61085,61085,61088,0,3,2
17389,3,1,61088,61088,61089,0,1,0
17390,3,1,61091,61091,61092,0,1,2
17391,6,3,61097,61097,61100,0,3,5
17392,6,2,61103,61103,61105,0,2,3
17393,3,2,61106,61106,61108,0,2,1
17394,3,2,61109,61109,61111,0,2,1
17395,2,3,61111,61111,61114,0,3,0
17396,1,3,61112,61114,61117,2,5,0
17397,3,3,61115,61117,61120,2,5,0
17398,6,1,61121,61121,61122,0,1,1
17399,4,3,61125,61125,61128,0,3,3
17400,6,1,61131,61131,61132,0,1,3
17401,2,2,61133,61133,61135,0,2,1
17402,2,2,61135,61135,61137,0,2,0
17403,3,1,61138,61138,61139,0,1,1
17404,3,2,61141,61141,61143,0,2,2
17405,3,1,61144,61144,61145,0,1,1
17406,6,3,61150,61150,61153,0,3,5
17407,3,3,61153,61153,61156,0,3,0
17408,4,2,61157,61157,61159,0,2,1
17409,5,2,61162,61162,61164,0,2,3
17410,2,1,61164,61164,61165,0,1,0
17411,3,2,61167,61167,61169,0,2,2
17412,6,1,61173,61173,61174,0,1,4
17413,2,3,61175,61175,61178,0,3,1
17414,1,2,61176,61178,61180,2,4,0
17415,3,3,61179,61180,61183,1,4,0
17416,1,3,61180,61183,61186,3,6,0
17417,6,3,61186,61186,61189,0,3,0
17418,5,2,61191,61191,61193,0,2,2
17419,1,2,61192,61193,61195,1,3,0
17420,1,2,61193,61195,61197,2,4,0
17421,4,2,61197,61197,61199,0,2,0
17422,6,2,61203,61203,61205,0,2,4
17423,5,2,61208,61208,61210,0,2,3
17424,6,3,61214,61214,61217,0,3,4
17425,6,2,61220,61220,61222,0,2,3
17426,1,3,61221,61222,61225,1,4,0
17427,6,1,61227,61227,61228,0,1,2
17428,1,3,61228,61228,61231,0,3,0
17429,3,3,61231,61231,61234,0,3,0
17430,3,1,61234,61234,61235,0,1,0
17431,2,2,61236,61236,61238,0,2,1
17432,2,3,61238,61238,61241,0,3,0
17433,2,3,61240,61241,61244,1,4,0
17434,1,2,61241,61244,61246,3,5,0
17435,4,3,61245,61246,61249,1,4,0
17436,6,1,61251,61251,61252,0,1,2
17437,4,3,61255,61255,61258,0,3,3
17438,4,3,61259,61259,61262,0,3,1
17439,2,2,61261,61262,61264,1,3,0
17440,2,3,61263,61264,61267,1,4,0
17441,5,2,61268,61268,61270,0,2,1
17442,1,3,61269,61270,61273,1,4,0
17443,5,3,61274,61274,61277,0,3,1
17444,6,2,61280,61280,61282,0,2,3
17445,3,3,61283,61283,61286,0,3,1
17446,3,3,61286,61286,61289,0,3,0
17447,6,1,61292,61292,61293,0,1,3
17448,5,3,61297,61297,61300,0,3,4
17449,4,2,61301,61301,61303,0,2,1
17450,4,2,61305,61305,61307,0,2,2
17451,6,2,61311,61311,61313,0,2,4
17452,1,3,61312,61313,61316,1,4,0
17453,2,3,61314,61316,61319,2,5,0
17454,1,1,61315,61319,61320,4,5,0
17455,1,2,61316,61320,61322,4,6,0
17456,2,2,61318,61322,61324,4,6,0
17457,5,3,61323,61324,61327,1,4,0
17458,1,1,61324,61327,61328,3,4,0
17459,2,3,61326,61328,61331,2,5,0
17460,4,1,61330,61331,61332,1,2,0
17461,3,3,61333,61333,61336,0,3,1
17462,3,2,61336,61336,61338,0,2,0
17463,4,2,61340,61340,61342,0,2,2
17464,4,3,61344,61344,61347,0,3,2
17465,1,2,61345,61347,61349,2,4,0
17466,6,2,61351,61351,61353,0,2,2
17467,5,2,61356,61356,61358,0,2,3
17468,5,1,61361,61361,61362,0,1,3
17469,4,1,61365,61365,61366,0,1,3
17470,6,2,61371,61371,61373,0,2,5
17471,5,1,61376,61376,61377,0,1,3
17472,1,2,61377,61377,61379,0,2,0
17473,5,3,61382,61382,61385,0,3,3
17474,2,2,61384,61385,61387,1,3,0
17475,4,2,61388,61388,61390,0,2,1
17476,1,3,61389,61390,61393,1,4,0
17477,3,3,61392,61393,61396,1,4,0
17478,6,1,61398,61398,61399,0,1,2
17479,3,3,61401,61401,61404,0,3,2
17480,1,1,61402,61404,61405,2,3,0
17481,6,2,61408,61408,61410,0,2,3
17482,6,1,61414,61414,61415,0,1,4
17483,1,3,61415,61415,61418,0,3,0
17484,3,1,61418,61418,61419,0,1,0
17485,5,1,61423,61423,61424,0,1,4
17486,3,3,61426,61426,61429,0,3,2
17487,5,3,61431,61431,61434,0,3,2
17488,4,3,61435,61435,61438,0,3,1
17489,5,1,61440,61440,61441,0,1,2
17490,3,3,61443,61443,61446,0,3,2
17491,1,1,61444,61446,61447,2,3,0
17492,4,2,61448,61448,61450,0,2,1
17493,6,3,61454,61454,61457,0,3,4
17494,3,1,61457,61457,61458,0,1,0
17495,4,1,61461,61461,61462,0,1,3
17496,2,1,61463,61463,61464,0,1,1
17497,2,1,61465,61465,61466,0,1,1
17498,5,3,61470,61470,61473,0,3,4
17499,1,1,61471,61473,61474,2,3,0
17500,3,2,61474,61474,61476,0,2,0
17501,6,2,61480,61480,61482,0,2,4
17502,4,1,61484,61484,61485,0,1,2
17503,3,2,61487,61487,61489,0,2,2
17504,6,2,61493,61493,61495,0,2,4
17505,2,3,61495,61495,61498,0,3,0
17506,3,3,61498,61498,61501,0,3,0
17507,2,3,61500,61501,61504,1,4,0
17508,4,1,61504,61504,61505,0,1,0
17509,6,3,61510,61510,61513,0,3,5
17510,1,3,61511,61513,61516,2,5,0
17511,1,1,61512,61516,61517,4,5,0
17512,4,3,61516,61517,61520,1,4,0
17513,3,1,61519,61520,61521,1,2,0
17514,5,1,61524,61524,61525,0,1,3
17515,1,1,61525,61525,61526,0,1,0
17516,4,3,61529,61529,61532,0,3,3
17517,1,1,61530,61532,61533,2,3,0
17518,1,1,61531,61533,61534,2,3,0
17519,6,2,61537,61537,61539,0,2,3
17520,4,3,61541,61541,61544,0,3,2
17521,6,2,61547,61547,61549,0,2,3
17522,2,2,61549,61549,61551,0,2,0
17523,5,3,61554,61554,61557,0,3,3
17524,6,3,61560,61560,61563,0,3,3
17525,1,1,61561,61563,61564,2,3,0
17526,6,2,61567,61567,61569,0,2,3
17527,6,2,61573,61573,61575,0,2,4
17528,4,3,61577,61577,61580,0,3,2
17529,6,1,61583,61583,61584,0,1,3
17530,2,2,61585,61585,61587,0,2,1
17531,1,2,61586,61587,61589,1,3,0
17532,1,1,61587,61589,61590,2,3,0
17533,3,1,61590,61590,61591,0,1,0
17534,2,2,61592,61592,61594,0,2,1
17535,2,2,61594,61594,61596,0,2,0
17536,6,1,61600,61600,61601,0,1,4
17537,3,3,61603,61603,61606,0,3,2
17538,6,3,61609,61609,61612,0,3,3
17539,3,3,61612,61612,61615,0,3,0
17540,2,2,61614,61615,61617,1,3,0
17541,2,2,61616,61617,61619,1,3,0
17542,1,3,61617,61619,61622,2,5,0
17543,5,3,61622,61622,61625,0,3,0
17544,1,2,61623,61625,61627,2,4,0
17545,4,2,61627,61627,61629,0,2,0
17546,1,2,61628,61629,61631,1,3,0
17547,2,2,61630,61631,61633,1,3,0
17548,5,1,61635,61635,61636,0,1,2
17549,2,1,61637,61637,61638,0,1,1
17550,3,1,61640,61640,61641,0,1,2
17551,1,2,61641,61641,61643,0,2,0
17552,4,1,61645,61645,61646,0,1,2
17553,3,3,61648,61648,61651,0,3,2
17554,2,1,61650,61651,61652,1,2,0
17555,2,3,61652,61652,61655,0,3,0
17556,3,2,61655,61655,61657,0,2,0
17557,4,1,61659,61659,61660,0,1,2
17558,3,2,61662,61662,61664,0,2,2
17559,6,2,61668,61668,61670,0,2,4
17560,1,2,61669,61670,61672,1,3,0
17561,4,3,61673,61673,61676,0,3,1
17562,2,1,61675,61676,61677,1,2,0
17563,2,2,61677,61677,61679,0,2,0
17564,2,3,61679,61679,61682,0,3,0
17565,3,3,61682,61682,61685,0,3,0
17566,5,2,61687,61687,61689,0,2,2
17567,4,3,61691,61691,61694,0,3,2
17568,4,1,61695,61695,61696,0,1,1
17569,3,2,61698,61698,61700,0,2,2
17570,3,1,61701,61701,61702,0,1,1
17571,6,2,61707,61707,61709,0,2,5
17572,4,3,61711,61711,61714,0,3,2
17573,4,3,61715,61715,61718,0,3,1
17574,4,3,61719,61719,61722,0,3,1
17575,3,3,61722,61722,61725,0,3,0
17576,1,2,61723,61725,61727,2,4,0
17577,3,2,61726,61727,61729,1,3,0
17578,1,3,61727,61729,61732,2,5,0
17579,6,3,61733,61733,61736,0,3,1
17580,1,2,61734,61736,61738,2,4,0
17581,3,3,61737,61738,61741,1,4,0
17582,1,3,61738,61741,61744,3,6,0
17583,2,1,61740,61744,61745,4,5,0
17584,5,1,61745,61745,61746,0,1,0
17585,2,3,61747,61747,61750,0,3,1
17586,4,2,61751,61751,61753,0,2,1
17587,3,2,61754,61754,61756,0,2,1
17588,5,1,61759,61759,61760,0,1,3
17589,2,2,61761,61761,61763,0,2,1
17590,4,1,61765,61765,61766,0,1,2
17591,4,1,61769,61769,61770,0,1,3
17592,2,1,61771,61771,61772,0,1,1
17593,2,2,61773,61773,61775,0,2,1
17594,1,3,61774,61775,61778,1,4,0
17595,5,2,61779,61779,61781,0,2,1
17596,5,3,61784,61784,61787,0,3,3
17597,4,1,61788,61788,61789,0,1,1
17598,6,3,61794,61794,61797,0,3,5
17599,2,2,61796,61797,61799,1,3,0
17600,2,3,61798,61799,61802,1,4,0
17601,4,1,61802,61802,61803,0,1,0
17602,5,2,61807,61807,61809,0,2,4
17603,1,1,61808,61809,61810,1,2,0
17604,6,1,61814,61814,61815,0,1,4
17605,2,2,61816,61816,61818,0,2,1
17606,4,1,61820,61820,61821,0,1,2
17607,3,1,61823,61823,61824,0,1,2
17608,6,1,61829,61829,61830,0,1,5
17609,2,2,61831,61831,61833,0,2,1
17610,1,1,61832,61833,61834,1,2,0
17611,3,1,61835,61835,61836,0,1,1
17612,4,2,61839,61839,61841,0,2,3
17613,3,2,61842,61842,61844,0,2,1
17614,1,1,61843,61844,61845,1,2,0
17615,3,2,61846,61846,61848,0,2,1
17616,2,2,61848,61848,61850,0,2,0
17617,3,3,61851,61851,61854,0,3,1
17618,3,3,61854,61854,61857,0,3,0
17619,4,1,61858,61858,61859,0,1,1
17620,4,3,61862,61862,61865,0,3,3
17621,4,1,61866,61866,61867,0,1,1
17622,5,3,61871,61871,61874,0,3,4
17623,1,1,61872,61874,61875,2,3,0
17624,2,3,61874,61875,61878,1,4,0
17625,5,2,61879,61879,61881,0,2,1
17626,2,1,61881,61881,61882,0,1,0
17627,6,3,61887,61887,61890,0,3,5
17628,1,1,61888,61890,61891,2,3,0
17629,5,3,61893,61893,61896,0,3,2
17630,5,1,61898,61898,61899,0,1,2
17631,1,3,61899,61899,61902,0,3,0
17632,5,1,61904,61904,61905,0,1,2
17633,3,1,61907,61907,61908,0,1,2
17634,3,2,61910,61910,61912,0,2,2
17635,1,3,61911,61912,61915,1,4,0
17636,6,2,61917,61917,61919,0,2,2
17637,6,1,61923,61923,61924,0,1,4
17638,4,2,61927,61927,61929,0,2,3
17639,2,1,61929,61929,61930,0,1,0
17640,5,1,61934,61934,61935,0,1,4
17641,3,2,61937,61937,61939,0,2,2
17642,6,1,61943,61943,61944,0,1,4
17643,2,1,61945,61945,61946,0,1,1
17644,5,2,61950,61950,61952,0,2,4
17645,2,1,61952,61952,61953,0,1,0
17646,3,2,61955,61955,61957,0,2,2
17647,2,1,61957,61957,61958,0,1,0
17648,4,3,61961,61961,61964,0,3,3
17649,5,3,61966,61966,61969,0,3,2
17650,3,3,61969,61969,61972,0,3,0
17651,2,1,61971,61972,61973,1,2,0
17652,1,2,61972,61973,61975,1,3,0
17653,4,1,61976,61976,61977,0,1,1
17654,6,2,61982,61982,61984,0,2,5
17655,5,1,61987,61987,61988,0,1,3
17656,3,1,61990,61990,61991,0,1,2
17657,6,3,61996,61996,61999,0,3,5
17658,3,3,61999,61999,62002,0,3,0
17659,3,1,62002,62002,62003,0,1,0
17660,1,2,62003,62003,62005,0,2,0
17661,5,3,62008,62008,62011,0,3,3
17662,6,2,62014,62014,62016,0,2,3
17663,6,2,62020,62020,62022,0,2,4
17664,3,3,62023,62023,62026,0,3,1
17665,3,1,62026,62026,62027,0,1,0
17666,5,3,62031,62031,62034,0,3,4
17667,1,2,62032,62034,62036,2,4,0
17668,4,1,62036,62036,62037,0,1,0
17669,6,3,62042,62042,62045,0,3,5
17670,2,3,62044,62045,62048,1,4,0
17671,2,1,62046,62048,62049,2,3,0
17672,1,1,62047,62049,62050,2,3,0
17673,4,2,62051,62051,62053,0,2,1
17674,2,2,62053,62053,62055,0,2,0
17675,4,1,62057,62057,62058,0,1,2
17676,1,3,62058,62058,62061,0,3,0
17677,2,2,62060,62061,62063,1,3,0
17678,1,3,62061,62063,62066,2,5,0
17679,4,3,62065,62066,62069,1,4,0
17680,1,1,62066,62069,62070,3,4,0
17681,5,2,62071,62071,62073,0,2,1
17682,3,1,62074,62074,62075,0,1,1
17683,6,1,62080,62080,62081,0,1,5
17684,6,1,62086,62086,62087,0,1,5
17685,4,3,62090,62090,62093,0,3,3
17686,4,1,62094,62094,62095,0,1,1
17687,5,2,62099,62099,62101,0,2,4
17688,2,1,62101,62101,62102,0,1,0
17689,2,1,62103,62103,62104,0,1,1
17690,4,2,62107,62107,62109,0,2,3
17691,6,2,62113,62113,62115,0,2,4
17692,1,3,62114,62115,62118,1,4,0
17693,5,2,62119,62119,62121,0,2,1
17694,4,3,62123,62123,62126,0,3,2
17695,1,3,62124,62126,62129,2,5,0
17696,2,2,62126,62129,62131,3,5,0
17697,2,2,62128,62131,62133,3,5,0
17698,5,3,62133,62133,62136,0,3,0
17699,6,1,62139,62139,62140,0,1,3
17700,4,1,62143,62143,62144,0,1,3
17701,6,2,62149,62149,62151,0,2,5
17702,5,2,62154,62154,62156,0,2,3
17703,1,2,62155,62156,62158,1,3,0
17704,6,1,62161,62161,62162,0,1,3
17705,5,2,62166,62166,62168,0,2,4
17706,4,3,62170,62170,62173,0,3,2
17707,1,2,62171,62173,62175,2,4,0
17708,5,1,62176,62176,62177,0,1,1
17709,4,3,62180,62180,62183,0,3,3
17710,5,2,62185,62185,62187,0,2,2
17711,2,2,62187,62187,62189,0,2,0
17712,6,1,62193,62193,62194,0,1,4
17713,2,3,62195,62195,62198,0,3,1
17714,6,2,62201,62201,62203,0,2,3
17715,4,3,62205,62205,62208,0,3,2
17716,5,3,62210,62210,62213,0,3,2
17717,6,1,62216,62216,62217,0,1,3
17718,3,1,62219,62219,62220,0,1,2
17719,5,3,62224,62224,62227,0,3,4
17720,5,3,62229,62229,62232,0,3,2
17721,5,1,62234,62234,62235,0,1,2
17722,6,2,62240,62240,62242,0,2,5
17723,5,2,62245,62245,62247,0,2,3
17724,1,3,62246,62247,62250,1,4,0
17725,2,1,62248,62250,62251,2,3,0
17726,4,1,62252,62252,62253,0,1,1
17727,6,2,62258,62258,62260,0,2,5
17728,5,2,62263,62263,62265,0,2,3
17729,2,3,62265,62265,62268,0,3,0
17730,5,2,62270,62270,62272,0,2,2
17731,2,1,62272,62272,62273,0,1,0
17732,3,1,62275,62275,62276,0,1,2
17733,5,1,62280,62280,62281,0,1,4
17734,2,1,62282,62282,62283,0,1,1
17735,4,3,62286,62286,62289,0,3,3
17736,2,1,62288,62289,62290,1,2,0
17737,2,1,62290,62290,62291,0,1,0
17738,4,3,62294,62294,62297,0,3,3
17739,2,3,62296,62297,62300,1,4,0
17740,5,1,62301,62301,62302,0,1,1
17741,4,2,62305,62305,62307,0,2,3
17742,5,3,62310,62310,62313,0,3,3
17743,4,1,62314,62314,62315,0,1,1
17744,5,1,62319,62319,62320,0,1,4
17745,1,3,62320,62320,62323,0,3,0
17746,3,1,62323,62323,62324,0,1,0
17747,3,2,62326,62326,62328,0,2,2
17748,3,2,62329,62329,62331,0,2,1
17749,1,2,62330,62331,62333,1,3,0
17750,4,2,62334,62334,62336,0,2,1
17751,1,3,62335,62336,62339,1,4,0
17752,1,1,62336,62339,62340,3,4,0
17753,5,2,62341,62341,62343,0,2,1
17754,5,3,62346,62346,62349,0,3,3
17755,5,1,62351,62351,62352,0,1,2
17756,3,2,62354,62354,62356,0,2,2
17757,2,2,62356,62356,62358,0,2,0
17758,4,2,62360,62360,62362,0,2,2
17759,5,3,62365,62365,62368,0,3,3
17760,2,3,62367,62368,62371,1,4,0
17761,1,2,62368,62371,62373,3,5,0
17762,3,2,62371,62373,62375,2,4,0
17763,6,2,62377,62377,62379,0,2,2
17764,6,2,62383,62383,62385,0,2,4
17765,5,2,62388,62388,62390,0,2,3
17766,2,1,62390,62390,62391,0,1,0
17767,4,3,62394,62394,62397,0,3,3
17768,6,3,62400,62400,62403,0,3,3
17769,2,3,62402,62403,62406,1,4,0
17770,4,3,62406,62406,62409,0,3,0
17771,3,1,62409,62409,62410,0,1,0
17772,4,1,62413,62413,62414,0,1,3
17773,1,3,62414,62414,62417,0,3,0
17774,5,3,62419,62419,62422,0,3,2
17775,4,1,62423,62423,62424,0,1,1
17776,1,2,62424,62424,62426,0,2,0
17777,6,1,62430,62430,62431,0,1,4
17778,5,3,62435,62435,62438,0,3,4
17779,2,2,62437,62438,62440,1,3,0
17780,4,3,62441,62441,62444,0,3,1
17781,2,2,62443,62444,62446,1,3,0
17782,6,1,62449,62449,62450,0,1,3
17783,6,2,62455,62455,62457,0,2,5
17784,3,1,62458,62458,62459,0,1,1
17785,3,3,62461,62461,62464,0,3,2
17786,3,2,62464,62464,62466,0,2,0
17787,3,1,62467,62467,62468,0,1,1
17788,1,3,62468,62468,62471,0,3,0
17789,3,3,62471,62471,62474,0,3,0
17790,1,2,62472,62474,62476,2,4,0
17791,6,3,62478,62478,62481,0,3,2
17792,5,2,62483,62483,62485,0,2,2
17793,6,3,62489,62489,62492,0,3,4
17794,2,3,62491,62492,62495,1,4,0
17795,3,2,62494,62495,62497,1,3,0
17796,1,1,62495,62497,62498,2,3,0
17797,3,2,62498,62498,62500,0,2,0
17798,3,3,62501,62501,62504,0,3,1
17799,4,2,62505,62505,62507,0,2,1
17800,2,3,62507,62507,62510,0,3,0
17801,6,1,62513,62513,62514,0,1,3
17802,4,3,62517,62517,62520,0,3,3
17803,1,3,62518,62520,62523,2,5,0
17804,1,1,62519,62523,62524,4,5,0
17805,1,2,62520,62524,62526,4,6,0
17806,6,1,62526,62526,62527,0,1,0
17807,1,2,62527,62527,62529,0,2,0
17808,5,2,62532,62532,62534,0,2,3
17809,5,2,62537,62537,62539,0,2,3
17810,2,1,62539,62539,62540,0,1,0
17811,4,1,62543,62543,62544,0,1,3
17812,4,3,62547,62547,62550,0,3,3
17813,1,1,62548,62550,62551,2,3,0
17814,6,1,62554,62554,62555,0,1,3
17815,3,2,62557,62557,62559,0,2,2
17816,2,2,62559,62559,62561,0,2,0
17817,1,3,62560,62561,62564,1,4,0
17818,1,3,62561,62564,62567,3,6,0
17819,6,2,62567,62567,62569,0,2,0
17820,5,2,62572,62572,62574,0,2,3
17821,2,1,62574,62574,62575,0,1,0
17822,6,3,62580,62580,62583,0,3,5
17823,4,3,62584,62584,62587,0,3,1
17824,4,2,62588,62588,62590,0,2,1
17825,2,1,62590,62590,62591,0,1,0
17826,1,3,62591,62591,62594,0,3,0
17827,6,1,62597,62597,62598,0,1,3
17828,2,2,62599,62599,62601,0,2,1
17829,1,2,62600,62601,62603,1,3,0
17830,2,2,62602,62603,62605,1,3,0
17831,6,1,62608,62608,62609,0,1,3
17832,6,3,62614,62614,62617,0,3,5
17833,5,1,62619,62619,62620,0,1,2
17834,6,2,62625,62625,62627,0,2,5
17835,4,3,62629,62629,62632,0,3,2
17836,3,2,62632,62632,62634,0,2,0
17837,4,2,62636,62636,62638,0,2,2
17838,6,1,62642,62642,62643,0,1,4
17839,1,2,62643,62643,62645,0,2,0
17840,6,2,62649,62649,62651,0,2,4
17841,2,1,62651,62651,62652,0,1,0
17842,1,1,62652,62652,62653,0,1,0
17843,4,3,62656,62656,62659,0,3,3
17844,1,3,62657,62659,62662,2,5,0
17845,4,2,62661,62662,62664,1,3,0
17846,4,2,62665,62665,62667,0,2,1
17847,1,1,62666,62667,62668,1,2,0
17848,2,2,62668,62668,62670,0,2,0
17849,5,2,62673,62673,62675,0,2,3
17850,3,3,62676,62676,62679,0,3,1
17851,5,3,62681,62681,62684,0,3,2
17852,4,2,62685,62685,62687,0,2,1
17853,6,3,62691,62691,62694,0,3,4
17854,2,1,62693,62694,62695,1,2,0
17855,1,2,62694,62695,62697,1,3,0
17856,3,1,62697,62697,62698,0,1,0
17857,2,3,62699,62699,62702,0,3,1
17858,1,2,62700,62702,62704,2,4,0
17859,1,1,62701,62704,62705,3,4,0
17860,1,3,62702,62705,62708,3,6,0
17861,6,3,62708,62708,62711,0,3,0
17862,1,1,62709,62711,62712,2,3,0
17863,2,2,62711,62712,62714,1,3,0
17864,3,2,62714,62714,62716,0,2,0
17865,1,3,62715,62716,62719,1,4,0
17866,4,3,62719,62719,62722,0,3,0
17867,3,3,62722,62722,62725,0,3,0
17868,4,3,62726,62726,62729,0,3,1
17869,6,3,62732,62732,62735,0,3,3
17870,6,1,62738,62738,62739,0,1,3
17871,3,3,62741,62741,62744,0,3,2
17872,6,1,62747,62747,62748,0,1,3
17873,1,1,62748,62748,62749,0,1,0
17874,3,3,62751,62751,62754,0,3,2
17875,6,1,62757,62757,62758,0,1,3
17876,4,3,62761,62761,62764,0,3,3
17877,6,2,62767,62767,62769,0,2,3
17878,5,2,62772,62772,62774,0,2,3
17879,4,2,62776,62776,62778,0,2,2
17880,5,1,62781,62781,62782,0,1,3
17881,2,1,62783,62783,62784,0,1,1
17882,2,2,62785,62785,62787,0,2,1
17883,3,3,62788,62788,62791,0,3,1
17884,6,1,62794,62794,62795,0,1,3
17885,6,2,62800,62800,62802,0,2,5
17886,3,3,62803,62803,62806,0,3,1
17887,4,1,62807,62807,62808,0,1,1
17888,5,1,62812,62812,62813,0,1,4
17889,3,3,62815,62815,62818,0,3,2
17890,5,1,62820,62820,62821,0,1,2
17891,3,3,62823,62823,62826,0,3,2
17892,1,1,62824,62826,62827,2,3,0
17893,3,2,62827,62827,62829,0,2,0
17894,2,2,62829,62829,62831,0,2,0
17895,1,2,62830,62831,62833,1,3,0
17896,4,1,62834,62834,62835,0,1,1
17897,2,3,62836,62836,62839,0,3,1
17898,4,3,62840,62840,62843,0,3,1
17899,4,3,62844,62844,62847,0,3,1
17900,2,1,62846,62847,62848,1,2,0
17901,5,2,62851,62851,62853,0,2,3
17902,4,3,62855,62855,62858,0,3,2
17903,5,1,62860,62860,62861,0,1,2
17904,4,2,62864,62864,62866,0,2,3
17905,6,3,62870,62870,62873,0,3,4
17906,3,1,62873,62873,62874,0,1,0
17907,3,2,62876,62876,62878,0,2,2
17908,6,3,62882,62882,62885,0,3,4
17909,6,2,62888,62888,62890,0,2,3
17910,1,2,62889,62890,62892,1,3,0
17911,2,3,62891,62892,62895,1,4,0
17912,1,2,62892,62895,62897,3,5,0
17913,5,3,62897,62897,62900,0,3,0
17914,5,3,62902,62902,62905,0,3,2
17915,4,3,62906,62906,62909,0,3,1
17916,3,2,62909,62909,62911,0,2,0
17917,3,1,62912,62912,62913,0,1,1
17918,1,1,62913,62913,62914,0,1,0
17919,6,2,62919,62919,62921,0,2,5
17920,4,3,62923,62923,62926,0,3,2
17921,3,2,62926,62926,62928,0,2,0
17922,3,3,62929,62929,62932,0,3,1
17923,3,1,62932,62932,62933,0,1,0
17924,1,2,62933,62933,62935,0,2,0
17925,4,1,62937,62937,62938,0,1,2
17926,3,1,62940,62940,62941,0,1,2
17927,1,2,62941,62941,62943,0,2,0
17928,6,2,62947,62947,62949,0,2,4
17929,4,2,62951,62951,62953,0,2,2
17930,5,2,62956,62956,62958,0,2,3
17931,2,1,62958,62958,62959,0,1,0
17932,5,3,62963,62963,62966,0,3,4
17933,5,3,62968,62968,62971,0,3,2
17934,2,2,62970,62971,62973,1,3,0
17935,3,1,62973,62973,62974,0,1,0
17936,5,3,62978,62978,62981,0,3,4
17937,2,3,62980,62981,62984,1,4,0
17938,4,2,62984,62984,62986,0,2,0
17939,2,2,62986,62986,62988,0,2,0
17940,6,1,62992,62992,62993,0,1,4
17941,6,2,62998,62998,63000,0,2,5
17942,1,1,62999,63000,63001,1,2,0
17943,1,1,63000,63001,63002,1,2,0
17944,5,2,63005,63005,63007,0,2,3
17945,4,3,63009,63009,63012,0,3,2
17946,6,2,63015,63015,63017,0,2,3
17947,4,1,63019,63019,63020,0,1,2
17948,6,1,63025,63025,63026,0,1,5
17949,5,3,63030,63030,63033,0,3,4
17950,6,3,63036,63036,63039,0,3,3
17951,1,3,63037,63039,63042,2,5,0
17952,1,2,63038,63042,63044,4,6,0
17953,1,1,63039,63044,63045,5,6,0
17954,5,2,63044,63045,63047,1,3,0
17955,3,2,63047,63047,63049,0,2,0
17956,1,2,63048,63049,63051,1,3,0
17957,2,2,63050,63051,63053,1,3,0
17958,1,1,63051,63053,63054,2,3,0
17959,3,2,63054,63054,63056,0,2,0
17960,1,1,63055,63056,63057,1,2,0
17961,3,2,63058,63058,63060,0,2,1
17962,1,3,63059,63060,63063,1,4,0
17963,6,2,63065,63065,63067,0,2,2
17964,1,3,63066,63067,63070,1,4,0
17965,4,1,63070,63070,63071,0,1,0
17966,2,2,63072,63072,63074,0,2,1
17967,1,3,63073,63074,63077,1,4,0
17968,1,2,63074,63077,63079,3,5,0
17969,5,2,63079,63079,63081,0,2,0
17970,6,3,63085,63085,63088,0,3,4
17971,6,3,63091,63091,63094,0,3,3
17972,6,1,63097,63097,63098,0,1,3
17973,1,1,63098,63098,63099,0,1,0
17974,1,2,63099,63099,63101,0,2,0
17975,6,3,63105,63105,63108,0,3,4
17976,6,3,63111,63111,63114,0,3,3
17977,1,3,63112,63114,63117,2,5,0
17978,2,1,63114,63117,63118,3,4,0
17979,3,3,63117,63118,63121,1,4,0
17980,2,2,63119,63121,63123,2,4,0
17981,4,1,63123,63123,63124,0,1,0
17982,6,1,63129,63129,63130,0,1,5
17983,5,2,63134,63134,63136,0,2,4
17984,5,2,63139,63139,63141,0,2,3
17985,3,1,63142,63142,63143,0,1,1
17986,3,3,63145,63145,63148,0,3,2
17987,4,2,63149,63149,63151,0,2,1
17988,5,3,63154,63154,63157,0,3,3
17989,1,2,63155,63157,63159,2,4,0
17990,5,1,63160,63160,63161,0,1,1
17991,1,1,63161,63161,63162,0,1,0
17992,6,3,63167,63167,63170,0,3,5
17993,1,3,63168,63170,63173,2,5,0
17994,1,3,63169,63173,63176,4,7,0
17995,2,1,63171,63176,63177,5,6,0
17996,2,2,63173,63177,63179,4,6,0
17997,6,1,63179,63179,63180,0,1,0
17998,2,1,63181,63181,63182,0,1,1
17999,2,1,63183,63183,63184,0,1,1
18000,5,2,63188,63188,63190,0,2,4
18001,2,1,63190,63190,63191,0,1,0
18002,4,2,63194,63194,63196,0,2,3
18003,2,2,63196,63196,63198,0,2,0
18004,4,2,63200,63200,63202,0,2,2
18005,5,1,63205,63205,63206,0,1,3
18006,3,1,63208,63208,63209,0,1,2
18007,3,1,63211,63211,63212,0,1,2
18008,5,3,63216,63216,63219,0,3,4
18009,5,2,63221,63221,63223,0,2,2
18010,2,1,63223,63223,63224,0,1,0
18011,3,1,63226,63226,63227,0,1,2
18012,2,3,63228,63228,63231,0,3,1
18013,5,2,63233,63233,63235,0,2,2
18014,4,1,63237,63237,63238,0,1,2
18015,1,1,63238,63238,63239,0,1,0
18016,5,1,63243,63243,63244,0,1,4
18017,1,1,63244,63244,63245,0,1,0
18018,1,2,63245,63245,63247,0,2,0
18019,2,2,63247,63247,63249,0,2,0
18020,3,1,63250,63250,63251,0,1,1
18021,2,1,63252,63252,63253,0,1,1
18022,4,1,63256,63256,63257,0,1,3
18023,5,3,63261,63261,63264,0,3,4
18024,2,1,63263,63264,63265,1,2,0
18025,4,2,63267,63267,63269,0,2,2
18026,5,1,63272,63272,63273,0,1,3
18027,5,2,63277,63277,63279,0,2,4
18028,3,2,63280,63280,63282,0,2,1
18029,2,3,63282,63282,63285,0,3,0
18030,1,3,63283,63285,63288,2,5,0
18031,1,2,63284,63288,63290,4,6,0
18032,2,1,63286,63290,63291,4,5,0
18033,2,3,63288,63291,63294,3,6,0
18034,6,2,63294,63294,63296,0,2,0
18035,6,2,63300,63300,63302,0,2,4
18036,6,3,63306,63306,63309,0,3,4
18037,2,3,63308,63309,63312,1,4,0
18038,5,1,63313,63313,63314,0,1,1
18039,5,2,63318,63318,63320,0,2,4
18040,1,1,63319,63320,63321,1,2,0
18041,5,3,63324,63324,63327,0,3,3
18042,1,1,63325,63327,63328,2,3,0
18043,4,2,63329,63329,63331,0,2,1
18044,2,3,63331,63331,63334,0,3,0
18045,1,1,63332,63334,63335,2,3,0
18046,4,1,63336,63336,63337,0,1,1
18047,6,2,63342,63342,63344,0,2,5
18048,6,3,63348,63348,63351,0,3,4
18049,2,2,63350,63351,63353,1,3,0
18050,6,2,63356,63356,63358,0,2,3
18051,4,1,63360,63360,63361,0,1,2
18052,4,1,63364,63364,63365,0,1,3
18053,4,1,63368,63368,63369,0,1,3
18054,6,2,63374,63374,63376,0,2,5
18055,6,3,63380,63380,63383,0,3,4
18056,1,3,63381,63383,63386,2,5,0
18057,5,3,63386,63386,63389,0,3,0
18058,4,2,63390,63390,63392,0,2,1
18059,1,3,63391,63392,63395,1,4,0
18060,2,2,63393,63395,63397,2,4,0
18061,4,2,63397,63397,63399,0,2,0
18062,6,1,63403,63403,63404,0,1,4
18063,2,2,63405,63405,63407,0,2,1
18064,4,2,63409,63409,63411,0,2,2
18065,1,1,63410,63411,63412,1,2,0
18066,2,1,63412,63412,63413,0,1,0
18067,4,1,63416,63416,63417,0,1,3
18068,1,1,63417,63417,63418,0,1,0
18069,1,2,63418,63418,63420,0,2,0
18070,5,3,63423,63423,63426,0,3,3
18071,1,2,63424,63426,63428,2,4,0
18072,6,2,63430,63430,63432,0,2,2
18073,3,2,63433,63433,63435,0,2,1
18074,3,2,63436,63436,63438,0,2,1
18075,1,2,63437,63438,63440,1,3,0
18076,3,1,63440,63440,63441,0,1,0
18077,5,1,63445,63445,63446,0,1,4
18078,3,2,63448,63448,63450,0,2,2
18079,1,3,63449,63450,63453,1,4,0
18080,2,2,63451,63453,63455,2,4,0
18081,4,3,63455,63455,63458,0,3,0
18082,4,1,63459,63459,63460,0,1,1
18083,6,3,63465,63465,63468,0,3,5
18084,5,1,63470,63470,63471,0,1,2
18085,6,1,63476,63476,63477,0,1,5
18086,3,2,63479,63479,63481,0,2,2
18087,3,3,63482,63482,63485,0,3,1
18088,4,1,63486,63486,63487,0,1,1
18089,2,1,63488,63488,63489,0,1,1
18090,4,1,63492,63492,63493,0,1,3
18091,3,2,63495,63495,63497,0,2,2
18092,1,1,63496,63497,63498,1,2,0
18093,3,3,63499,63499,63502,0,3,1
18094,3,1,63502,63502,63503,0,1,0
18095,1,2,63503,63503,63505,0,2,0
18096,5,3,63508,63508,63511,0,3,3
18097,3,2,63511,63511,63513,0,2,0
18098,2,2,63513,63513,63515,0,2,0
18099,6,1,63519,63519,63520,0,1,4
18100,5,1,63524,63524,63525,0,1,4
18101,4,1,63528,63528,63529,0,1,3
18102,2,3,63530,63530,63533,0,3,1
18103,5,1,63535,63535,63536,0,1,2
18104,5,1,63540,63540,63541,0,1,4
18105,2,3,63542,63542,63545,0,3,1
18106,6,2,63548,63548,63550,0,2,3
18107,1,1,63549,63550,63551,1,2,0
18108,6,3,63555,63555,63558,0,3,4
18109,3,3,63558,63558,63561,0,3,0
18110,1,1,63559,63561,63562,2,3,0
18111,1,3,63560,63562,63565,2,5,0
18112,1,1,63561,63565,63566,4,5,0
18113,3,2,63564,63566,63568,2,4,0
18114,2,2,63566,63568,63570,2,4,0
18115,5,1,63571,63571,63572,0,1,1
18116,3,3,63574,63574,63577,0,3,2
18117,6,2,63580,63580,63582,0,2,3
18118,6,2,63586,63586,63588,0,2,4
18119,4,2,63590,63590,63592,0,2,2
18120,4,2,63594,63594,63596,0,2,2
18121,6,3,63600,63600,63603,0,3,4
18122,1,2,63601,63603,63605,2,4,0
18123,2,2,63603,63605,63607,2,4,0
18124,4,2,63607,63607,63609,0,2,0
18125,3,1,63610,63610,63611,0,1,1
18126,5,3,63615,63615,63618,0,3,4
18127,3,2,63618,63618,63620,0,2,0
18128,2,2,63620,63620,63622,0,2,0
18129,5,3,63625,63625,63628,0,3,3
18130,1,3,63626,63628,63631,2,5,0
18131,6,2,63632,63632,63634,0,2,1
18132,3,1,63635,63635,63636,0,1,1
18133,1,2,63636,63636,63638,0,2,0
18134,6,3,63642,63642,63645,0,3,4
18135,1,2,63643,63645,63647,2,4,0
18136,5,2,63648,63648,63650,0,2,1
18137,5,2,63653,63653,63655,0,2,3
18138,1,3,63654,63655,63658,1,4,0
18139,5,3,63659,63659,63662,0,3,1
18140,5,1,63664,63664,63665,0,1,2
18141,2,2,63666,63666,63668,0,2,1
18142,1,2,63667,63668,63670,1,3,0
18143,3,3,63670,63670,63673,0,3,0
18144,3,2,63673,63673,63675,0,2,0
18145,3,1,63676,63676,63677,0,1,1
18146,5,1,63681,63681,63682,0,1,4
18147,4,1,63685,63685,63686,0,1,3
18148,4,2,63689,63689,63691,0,2,3
18149,6,3,63695,63695,63698,0,3,4
18150,1,1,63696,63698,63699,2,3,0
18151,3,2,63699,63699,63701,0,2,0
18152,3,1,63702,63702,63703,0,1,1
18153,2,2,63704,63704,63706,0,2,1
18154,3,3,63707,63707,63710,0,3,1
18155,2,3,63709,63710,63713,1,4,0
18156,2,3,63711,63713,63716,2,5,0
18157,1,3,63712,63716,63719,4,7,0
18158,3,2,63715,63719,63721,4,6,0
18159,6,3,63721,63721,63724,0,3,0
18160,3,2,63724,63724,63726,0,2,0
18161,4,1,63728,63728,63729,0,1,2
18162,3,3,63731,63731,63734,0,3,2
18163,6,2,63737,63737,63739,0,2,3
18164,3,3,63740,63740,63743,0,3,1
18165,6,1,63746,63746,63747,0,1,3
18166,3,2,63749,63749,63751,0,2,2
18167,3,3,63752,63752,63755,0,3,1
18168,2,1,63754,63755,63756,1,2,0
18169,6,2,63760,63760,63762,0,2,4
18170,3,2,63763,63763,63765,0,2,1
18171,2,3,63765,63765,63768,0,3,0
18172,4,2,63769,63769,63771,0,2,1
18173,3,2,63772,63772,63774,0,2,1
18174,5,3,63777,63777,63780,0,3,3
18175,6,1,63783,63783,63784,0,1,3
18176,6,3,63789,63789,63792,0,3,5
18177,6,3,63795,63795,63798,0,3,3
18178,1,3,63796,63798,63801,2,5,0
18179,4,1,63800,63801,63802,1,2,0
18180,3,3,63803,63803,63806,0,3,1
18181,3,3,63806,63806,63809,0,3,0
18182,2,3,63808,63809,63812,1,4,0
18183,3,1,63811,63812,63813,1,2,0
18184,5,3,63816,63816,63819,0,3,3
18185,1,2,63817,63819,63821,2,4,0
18186,3,2,63820,63821,63823,1,3,0
18187,6,1,63826,63826,63827,0,1,3
18188,2,3,63828,63828,63831,0,3,1
18189,2,1,63830,63831,63832,1,2,0
18190,5,3,63835,63835,63838,0,3,3
18191,3,3,63838,63838,63841,0,3,0
18192,6,2,63844,63844,63846,0,2,3
18193,3,1,63847,63847,63848,0,1,1
18194,1,2,63848,63848,63850,0,2,0
18195,1,2,63849,63850,63852,1,3,0
18196,3,1,63852,63852,63853,0,1,0
18197,6,1,63858,63858,63859,0,1,5
18198,3,3,63861,63861,63864,0,3,2
18199,3,3,63864,63864,63867,0,3,0
18200,6,2,63870,63870,63872,0,2,3
18201,5,2,63875,63875,63877,0,2,3
18202,2,3,63877,63877,63880,0,3,0
18203,5,2,63882,63882,63884,0,2,2
18204,2,3,63884,63884,63887,0,3,0
18205,6,1,63890,63890,63891,0,1,3
18206,2,2,63892,63892,63894,0,2,1
18207,4,2,63896,63896,63898,0,2,2
18208,4,1,63900,63900,63901,0,1,2
18209,4,2,63904,63904,63906,0,2,3
18210,2,1,63906,63906,63907,0,1,0
18211,2,1,63908,63908,63909,0,1,1
18212,2,1,63910,63910,63911,0,1,1
18213,6,1,63916,63916,63917,0,1,5
18214,6,2,63922,63922,63924,0,2,5
18215,3,3,63925,63925,63928,0,3,1
18216,1,1,63926,63928,63929,2,3,0
18217,5,1,63931,63931,63932,0,1,2
18218,3,2,63934,63934,63936,0,2,2
18219,4,1,63938,63938,63939,0,1,2
18220,2,2,63940,63940,63942,0,2,1
18221,5,1,63945,63945,63946,0,1,3
18222,2,2,63947,63947,63949,0,2,1
18223,5,1,63952,63952,63953,0,1,3
18224,3,3,63955,63955,63958,0,3,2
18225,2,1,63957,63958,63959,1,2,0
18226,3,3,63960,63960,63963,0,3,1
18227,4,2,63964,63964,63966,0,2,1
18228,6,1,63970,63970,63971,0,1,4
18229,3,2,63973,63973,63975,0,2,2
18230,3,3,63976,63976,63979,0,3,1
18231,3,1,63979,63979,63980,0,1,0
18232,1,2,63980,63980,63982,0,2,0
18233,6,3,63986,63986,63989,0,3,4
18234,1,2,63987,63989,63991,2,4,0
18235,4,3,63991,63991,63994,0,3,0
18236,3,1,63994,63994,63995,0,1,0
18237,6,2,64000,64000,64002,0,2,5
18238,1,2,64001,64002,64004,1,3,0
18239,3,3,64004,64004,64007,0,3,0
18240,2,1,64006,64007,64008,1,2,0
18241,5,2,64011,64011,64013,0,2,3
18242,2,3,64013,64013,64016,0,3,0
18243,1,2,64014,64016,64018,2,4,0
18244,2,3,64016,64018,64021,2,5,0
18245,3,1,64019,64021,64022,2,3,0
18246,5,3,64024,64024,64027,0,3,2
18247,1,3,64025,64027,64030,2,5,0
18248,3,1,64028,64030,64031,2,3,0
18249,1,3,64029,64031,64034,2,5,0
18250,2,1,64031,64034,64035,3,4,0
18251,5,1,64036,64036,64037,0,1,1
18252,1,2,64037,64037,64039,0,2,0
18253,4,1,64041,64041,64042,0,1,2
18254,5,1,64046,64046,64047,0,1,4
18255,2,1,64048,64048,64049,0,1,1
18256,5,3,64053,64053,64056,0,3,4
18257,6,1,64059,64059,64060,0,1,3
18258,6,2,64065,64065,64067,0,2,5
18259,4,3,64069,64069,64072,0,3,2
18260,5,1,64074,64074,64075,0,1,2
18261,6,1,64080,64080,64081,0,1,5
18262,5,3,64085,64085,64088,0,3,4
18263,5,2,64090,64090,64092,0,2,2
18264,2,3,64092,64092,64095,0,3,0
18265,3,2,64095,64095,64097,0,2,0
18266,4,1,64099,64099,64100,0,1,2
18267,5,2,64104,64104,64106,0,2,4
18268,4,3,64108,64108,64111,0,3,2
18269,2,2,64110,64111,64113,1,3,0
18270,5,3,64115,64115,64118,0,3,2
18271,6,2,64121,64121,64123,0,2,3
18272,6,2,64127,64127,64129,0,2,4
18273,2,1,64129,64129,64130,0,1,0
18274,2,3,64131,64131,64134,0,3,1
18275,5,2,64136,64136,64138,0,2,2
18276,5,2,64141,64141,64143,0,2,3
18277,4,1,64145,64145,64146,0,1,2
18278,1,1,64146,64146,64147,0,1,0
18279,5,2,64151,64151,64153,0,2,4
18280,2,3,64153,64153,64156,0,3,0
18281,3,3,64156,64156,64159,0,3,0
18282,6,1,64162,64162,64163,0,1,3
18283,6,3,64168,64168,64171,0,3,5
18284,6,2,64174,64174,64176,0,2,3
18285,1,3,64175,64176,64179,1,4,0
18286,3,3,64178,64179,64182,1,4,0
18287,1,3,64179,64182,64185,3,6,0
18288,5,2,64184,64185,64187,1,3,0
18289,6,2,64190,64190,64192,0,2,3
18290,6,1,64196,64196,64197,0,1,4
18291,3,3,64199,64199,64202,0,3,2
18292,3,2,64202,64202,64204,0,2,0
18293,2,2,64204,64204,64206,0,2,0
18294,3,2,64207,64207,64209,0,2,1
18295,6,2,64213,64213,64215,0,2,4
18296,5,3,64218,64218,64221,0,3,3
18297,4,3,64222,64222,64225,0,3,1
18298,4,1,64226,64226,64227,0,1,1
18299,3,2,64229,64229,64231,0,2,2
18300,6,1,64235,64235,64236,0,1,4
18301,6,2,64241,64241,64243,0,2,5
18302,4,3,64245,64245,64248,0,3,2
18303,5,3,64250,64250,64253,0,3,2
18304,6,3,64256,64256,64259,0,3,3
18305,1,2,64257,64259,64261,2,4,0
18306,6,1,64263,64263,64264,0,1,2
18307,4,1,64267,64267,64268,0,1,3
18308,5,1,64272,64272,64273,0,1,4
18309,3,2,64275,64275,64277,0,2,2
18310,2,2,64277,64277,64279,0,2,0
18311,6,2,64283,64283,64285,0,2,4
18312,3,2,64286,64286,64288,0,2,1
18313,5,3,64291,64291,64294,0,3,3
18314,6,2,64297,64297,64299,0,2,3
18315,1,1,64298,64299,64300,1,2,0
18316,2,2,64300,64300,64302,0,2,0
18317,2,3,64302,64302,64305,0,3,0
18318,4,2,64306,64306,64308,0,2,1
18319,2,3,64308,64308,64311,0,3,0
18320,1,3,64309,64311,64314,2,5,0
18321,2,2,64311,64314,64316,3,5,0
18322,1,2,64312,64316,64318,4,6,0
18323,2,2,64314,64318,64320,4,6,0
18324,5,3,64319,64320,64323,1,4,0
18325,6,2,64325,64325,64327,0,2,2
18326,6,3,64331,64331,64334,0,3,4
18327,1,1,64332,64334,64335,2,3,0
18328,5,3,64337,64337,64340,0,3,2
18329,2,2,64339,64340,64342,1,3,0
18330,5,3,64344,64344,64347,0,3,2
18331,2,1,64346,64347,64348,1,2,0
18332,2,2,64348,64348,64350,0,2,0
18333,4,2,64352,64352,64354,0,2,2
18334,2,3,64354,64354,64357,0,3,0
18335,2,1,64356,64357,64358,1,2,0
18336,3,1,64359,64359,64360,0,1,1
18337,5,3,64364,64364,64367,0,3,4
18338,4,3,64368,64368,64371,0,3,1
18339,2,3,64370,64371,64374,1,4,0
18340,6,2,64376,64376,64378,0,2,2
18341,2,3,64378,64378,64381,0,3,0
18342,5,2,64383,64383,64385,0,2,2
18343,3,3,64386,64386,64389,0,3,1
18344,1,2,64387,64389,64391,2,4,0
18345,4,2,64391,64391,64393,0,2,0
18346,5,3,64396,64396,64399,0,3,3
18347,5,3,64401,64401,64404,0,3,2
18348,3,1,64404,64404,64405,0,1,0
18349,4,3,64408,64408,64411,0,3,3
18350,5,3,64413,64413,64416,0,3,2
18351,5,3,64418,64418,64421,0,3,2
18352,2,3,64420,64421,64424,1,4,0
18353,3,1,64423,64424,64425,1,2,0
18354,5,2,64428,64428,64430,0,2,3
18355,5,2,64433,64433,64435,0,2,3
18356,5,1,64438,64438,64439,0,1,3
18357,1,1,64439,64439,64440,0,1,0
18358,1,3,64440,64440,64443,0,3,0
18359,1,2,64441,64443,64445,2,4,0
18360,4,1,64445,64445,64446,0,1,0
18361,2,2,64447,64447,64449,0,2,1
18362,2,1,64449,64449,64450,0,1,0
18363,6,1,64455,64455,64456,0,1,5
18364,2,2,64457,64457,64459,0,2,1
18365,5,2,64462,64462,64464,0,2,3
18366,5,2,64467,64467,64469,0,2,3
18367,3,3,64470,64470,64473,0,3,1
18368,6,1,64476,64476,64477,0,1,3
18369,4,3,64480,64480,64483,0,3,3
18370,3,1,64483,64483,64484,0,1,0
18371,6,2,64489,64489,64491,0,2,5
18372,1,1,64490,64491,64492,1,2,0
18373,6,2,64496,64496,64498,0,2,4
18374,5,2,64501,64501,64503,0,2,3
18375,5,1,64506,64506,64507,0,1,3
18376,4,2,64510,64510,64512,0,2,3
18377,3,3,64513,64513,64516,0,3,1
18378,1,1,64514,64516,64517,2,3,0
18379,6,2,64520,64520,64522,0,2,3
18380,1,3,64521,64522,64525,1,4,0
18381,5,2,64526,64526,64528,0,2,1
18382,6,1,64532,64532,64533,0,1,4
18383,1,2,64533,64533,64535,0,2,0
18384,3,1,64536,64536,64537,0,1,1
18385,2,3,64538,64538,64541,0,3,1
18386,4,3,64542,64542,64545,0,3,1
18387,4,1,64546,64546,64547,0,1,1
18388,3,3,64549,64549,64552,0,3,2
18389,1,3,64550,64552,64555,2,5,0
18390,6,1,64556,64556,64557,0,1,1
18391,2,2,64558,64558,64560,0,2,1
18392,2,2,64560,64560,64562,0,2,0
18393,6,1,64566,64566,64567,0,1,4
18394,4,1,64570,64570,64571,0,1,3
18395,6,3,64576,64576,64579,0,3,5
18396,5,2,64581,64581,64583,0,2,2
18397,3,2,64584,64584,64586,0,2,1
18398,6,2,64590,64590,64592,0,2,4
18399,1,3,64591,64592,64595,1,4,0
18400,4,1,64595,64595,64596,0,1,0
18401,3,3,64598,64598,64601,0,3,2
18402,5,2,64603,64603,64605,0,2,2
18403,5,2,64608,64608,64610,0,2,3
18404,1,3,64609,64610,64613,1,4,0
18405,5,2,64614,64614,64616,0,2,1
18406,5,2,64619,64619,64621,0,2,3
18407,4,3,64623,64623,64626,0,3,2
18408,2,3,64625,64626,64629,1,4,0
18409,2,3,64627,64629,64632,2,5,0
18410,4,2,64631,64632,64634,1,3,0
18411,4,3,64635,64635,64638,0,3,1
18412,4,2,64639,64639,64641,0,2,1
18413,4,2,64643,64643,64645,0,2,2
18414,6,1,64649,64649,64650,0,1,4
18415,6,3,64655,64655,64658,0,3,5
18416,1,3,64656,64658,64661,2,5,0
18417,6,1,64662,64662,64663,0,1,1
18418,2,1,64664,64664,64665,0,1,1
18419,1,1,64665,64665,64666,0,1,0
18420,6,2,64671,64671,64673,0,2,5
18421,6,1,64677,64677,64678,0,1,4
18422,2,1,64679,64679,64680,0,1,1
18423,6,3,64685,64685,64688,0,3,5
18424,1,3,64686,64688,64691,2,5,0
18425,5,3,64691,64691,64694,0,3,0
18426,6,2,64697,64697,64699,0,2,3
18427,5,3,64702,64702,64705,0,3,3
18428,5,1,64707,64707,64708,0,1,2
18429,2,1,64709,64709,64710,0,1,1
18430,5,3,64714,64714,64717,0,3,4
18431,4,2,64718,64718,64720,0,2,1
18432,1,3,64719,64720,64723,1,4,0
18433,3,3,64722,64723,64726,1,4,0
18434,1,2,64723,64726,64728,3,5,0
18435,2,3,64725,64728,64731,3,6,0
18436,3,1,64728,64731,64732,3,4,0
18437,3,3,64731,64732,64735,1,4,0
18438,5,2,64736,64736,64738,0,2,1
18439,2,3,64738,64738,64741,0,3,0
18440,1,3,64739,64741,64744,2,5,0
18441,5,3,64744,64744,64747,0,3,0
18442,2,1,64746,64747,64748,1,2,0
18443,2,2,64748,64748,64750,0,2,0
18444,4,3,64752,64752,64755,0,3,2
18445,1,2,64753,64755,64757,2,4,0
18446,2,3,64755,64757,64760,2,5,0
18447,3,3,64758,64760,64763,2,5,0
18448,1,1,64759,64763,64764,4,5,0
18449,2,2,64761,64764,64766,3,5,0
18450,4,3,64765,64766,64769,1,4,0
18451,6,3,64771,64771,64774,0,3,2
18452,3,3,64774,64774,64777,0,3,0
18453,5,2,64779,64779,64781,0,2,2
18454,1,3,64780,64781,64784,1,4,0
18455,1,3,64781,64784,64787,3,6,0
18456,5,3,64786,64787,64790,1,4,0
18457,3,3,64789,64790,64793,1,4,0
18458,2,1,64791,64793,64794,2,3,0
18459,4,2,64795,64795,64797,0,2,1
18460,4,2,64799,64799,64801,0,2,2
18461,3,2,64802,64802,64804,0,2,1
18462,6,1,64808,64808,64809,0,1,4
18463,2,2,64810,64810,64812,0,2,1
18464,5,2,64815,64815,64817,0,2,3
18465,2,2,64817,64817,64819,0,2,0
18466,4,3,64821,64821,64824,0,3,2
18467,5,2,64826,64826,64828,0,2,2
18468,4,2,64830,64830,64832,0,2,2
18469,3,2,64833,64833,64835,0,2,1
18470,5,3,64838,64838,64841,0,3,3
18471,6,2,64844,64844,64846,0,2,3
18472,6,2,64850,64850,64852,0,2,4
18473,4,1,64854,64854,64855,0,1,2
18474,2,1,64856,64856,64857,0,1,1
18475,1,2,64857,64857,64859,0,2,0
18476,3,3,64860,64860,64863,0,3,1
18477,4,1,64864,64864,64865,0,1,1
18478,1,2,64865,64865,64867,0,2,0
18479,4,2,64869,64869,64871,0,2,2
18480,5,3,64874,64874,64877,0,3,3
18481,2,3,64876,64877,64880,1,4,0
18482,5,3,64881,64881,64884,0,3,1
18483,3,3,64884,64884,64887,0,3,0
18484,1,1,64885,64887,64888,2,3,0
18485,6,2,64891,64891,64893,0,2,3
18486,6,3,64897,64897,64900,0,3,4
18487,5,3,64902,64902,64905,0,3,2
18488,3,3,64905,64905,64908,0,3,0
18489,4,1,64909,64909,64910,0,1,1
18490,6,2,64915,64915,64917,0,2,5
18491,5,1,64920,64920,64921,0,1,3
18492,6,2,64926,64926,64928,0,2,5
18493,5,1,64931,64931,64932,0,1,3
18494,2,1,64933,64933,64934,0,1,1
18495,4,3,64937,64937,64940,0,3,3
18496,3,1,64940,64940,64941,0,1,0
18497,4,3,64944,64944,64947,0,3,3
18498,3,1,64947,64947,64948,0,1,0
18499,5,3,64952,64952,64955,0,3,4
18500,2,2,64954,64955,64957,1,3,0
18501,2,3,64956,64957,64960,1,4,0
18502,6,1,64962,64962,64963,0,1,2
18503,2,2,64964,64964,64966,0,2,1
18504,1,1,64965,64966,64967,1,2,0
18505,1,2,64966,64967,64969,1,3,0
18506,5,1,64971,64971,64972,0,1,2
18507,6,2,64977,64977,64979,0,2,5
18508,5,3,64982,64982,64985,0,3,3
18509,5,2,64987,64987,64989,0,2,2
18510,3,3,64990,64990,64993,0,3,1
18511,2,1,64992,64993,64994,1,2,0
18512,5,1,64997,64997,64998,0,1,3
18513,6,1,65003,65003,65004,0,1,5
18514,3,2,65006,65006,65008,0,2,2
18515,1,1,65007,65008,65009,1,2,0
18516,3,1,65010,65010,65011,0,1,1
18517,3,2,65013,65013,65015,0,2,2
18518,4,1,65017,65017,65018,0,1,2
18519,4,1,65021,65021,65022,0,1,3
18520,5,2,65026,65026,65028,0,2,4
18521,2,3,65028,65028,65031,0,3,0
18522,6,1,65034,65034,65035,0,1,3
18523,4,1,65038,65038,65039,0,1,3
18524,6,2,65044,65044,65046,0,2,5
18525,6,3,65050,65050,65053,0,3,4
18526,6,2,65056,65056,65058,0,2,3
18527,3,2,65059,65059,65061,0,2,1
18528,6,3,65065,65065,65068,0,3,4
18529,4,3,65069,65069,65072,0,3,1
18530,5,1,65074,65074,65075,0,1,2
18531,3,2,65077,65077,65079,0,2,2
18532,1,2,65078,65079,65081,1,3,0
18533,4,1,65082,65082,65083,0,1,1
18534,4,1,65086,65086,65087,0,1,3
18535,4,3,65090,65090,65093,0,3,3
18536,1,3,65091,65093,65096,2,5,0
18537,6,1,65097,65097,65098,0,1,1
18538,1,3,65098,65098,65101,0,3,0
18539,5,3,65103,65103,65106,0,3,2
18540,6,1,65109,65109,65110,0,1,3
18541,5,2,65114,65114,65116,0,2,4
18542,3,1,65117,65117,65118,0,1,1
18543,4,1,65121,65121,65122,0,1,3
18544,6,3,65127,65127,65130,0,3,5
18545,6,1,65133,65133,65134,0,1,3
18546,4,1,65137,65137,65138,0,1,3
18547,2,3,65139,65139,65142,0,3,1
18548,6,1,65145,65145,65146,0,1,3
18549,4,3,65149,65149,65152,0,3,3
18550,3,3,65152,65152,65155,0,3,0
18551,3,1,65155,65155,65156,0,1,0
18552,3,1,65158,65158,65159,0,1,2
18553,5,1,65163,65163,65164,0,1,4
18554,5,2,65168,65168,65170,0,2,4
18555,4,2,65172,65172,65174,0,2,2
18556,3,2,65175,65175,65177,0,2,1
18557,4,2,65179,65179,65181,0,2,2
18558,3,1,65182,65182,65183,0,1,1
18559,4,3,65186,65186,65189,0,3,3
18560,6,1,65192,65192,65193,0,1,3
18561,6,2,65198,65198,65200,0,2,5
18562,1,2,65199,65200,65202,1,3,0
18563,6,2,65205,65205,65207,0,2,3
18564,4,1,65209,65209,65210,0,1,2
18565,3,2,65212,65212,65214,0,2,2
18566,4,2,65216,65216,65218,0,2,2
18567,5,1,65221,65221,65222,0,1,3
18568,3,3,65224,65224,65227,0,3,2
18569,5,1,65229,65229,65230,0,1,2
18570,2,2,65231,65231,65233,0,2,1
18571,5,2,65236,65236,65238,0,2,3
18572,1,1,65237,65238,65239,1,2,0
18573,5,3,65242,65242,65245,0,3,3
18574,2,3,65244,65245,65248,1,4,0
18575,2,1,65246,65248,65249,2,3,0
18576,4,3,65250,65250,65253,0,3,1
18577,1,1,65251,65253,65254,2,3,0
18578,4,1,65255,65255,65256,0,1,1
18579,6,2,65261,65261,65263,0,2,5
18580,3,1,65264,65264,65265,0,1,1
18581,5,3,65269,65269,65272,0,3,4
18582,1,2,65270,65272,65274,2,4,0
18583,2,3,65272,65274,65277,2,5,0
18584,1,3,65273,65277,65280,4,7,0
18585,5,2,65278,65280,65282,2,4,0
18586,6,3,65284,65284,65287,0,3,2
18587,4,2,65288,65288,65290,0,2,1
18588,4,1,65292,65292,65293,0,1,2
18589,3,3,65295,65295,65298,0,3,2
18590,6,1,65301,65301,65302,0,1,3
18591,6,2,65307,65307,65309,0,2,5
18592,5,2,65312,65312,65314,0,2,3
18593,2,2,65314,65314,65316,0,2,0
18594,3,3,65317,65317,65320,0,3,1
18595,6,2,65323,65323,65325,0,2,3
18596,4,3,65327,65327,65330,0,3,2
18597,5,1,65332,65332,65333,0,1,2
18598,2,2,65334,65334,65336,0,2,1
18599,6,1,65340,65340,65341,0,1,4
18600,3,1,65343,65343,65344,0,1,2
18601,3,1,65346,65346,65347,0,1,2
18602,1,3,65347,65347,65350,0,3,0
18603,5,2,65352,65352,65354,0,2,2
18604,1,3,65353,65354,65357,1,4,0
18605,2,2,65355,65357,65359,2,4,0
18606,6,1,65361,65361,65362,0,1,2
18607,3,2,65364,65364,65366,0,2,2
18608,4,1,65368,65368,65369,0,1,2
18609,6,3,65374,65374,65377,0,3,5
18610,5,3,65379,65379,65382,0,3,2
18611,4,1,65383,65383,65384,0,1,1
18612,3,1,65386,65386,65387,0,1,2
18613,6,2,65392,65392,65394,0,2,5
18614,1,1,65393,65394,65395,1,2,0
18615,3,3,65396,65396,65399,0,3,1
18616,5,2,65401,65401,65403,0,2,2
18617,2,2,65403,65403,65405,0,2,0
18618,6,3,65409,65409,65412,0,3,4
18619,3,1,65412,65412,65413,0,1,0
18620,2,2,65414,65414,65416,0,2,1
18621,1,1,65415,65416,65417,1,2,0
18622,4,3,65419,65419,65422,0,3,2
18623,6,3,65425,65425,65428,0,3,3
18624,1,3,65426,65428,65431,2,5,0
18625,4,1,65430,65431,65432,1,2,0
18626,5,3,65435,65435,65438,0,3,3
18627,5,1,65440,65440,65441,0,1,2
18628,3,3,65443,65443,65446,0,3,2
18629,4,2,65447,65447,65449,0,2,1
18630,4,2,65451,65451,65453,0,2,2
18631,1,3,65452,65453,65456,1,4,0
18632,1,1,65453,65456,65457,3,4,0
18633,5,3,65458,65458,65461,0,3,1
18634,6,3,65464,65464,65467,0,3,3
18635,5,2,65469,65469,65471,0,2,2
18636,5,1,65474,65474,65475,0,1,3
18637,5,1,65479,65479,65480,0,1,4
18638,4,2,65483,65483,65485,0,2,3
18639,2,1,65485,65485,65486,0,1,0
18640,1,1,65486,65486,65487,0,1,0
18641,4,1,65490,65490,65491,0,1,3
18642,6,1,65496,65496,65497,0,1,5
18643,1,3,65497,65497,65500,0,3,0
18644,5,2,65502,65502,65504,0,2,2
18645,4,3,65506,65506,65509,0,3,2
18646,5,2,65511,65511,65513,0,2,2
18647,6,2,65517,65517,65519,0,2,4
18648,3,1,65520,65520,65521,0,1,1
18649,2,1,65522,65522,65523,0,1,1
18650,5,1,65527,65527,65528,0,1,4
18651,2,3,65529,65529,65532,0,3,1
18652,5,2,65534,65534,65536,0,2,2
18653,4,1,65538,65538,65539,0,1,2
18654,1,2,65539,65539,65541,0,2,0
18655,2,1,65541,65541,65542,0,1,0
18656,6,2,65547,65547,65549,0,2,5
18657,2,3,65549,65549,65552,0,3,0
18658,4,2,65553,65553,65555,0,2,1
18659,5,1,65558,65558,65559,0,1,3
18660,4,1,65562,65562,65563,0,1,3
18661,1,2,65563,65563,65565,0,2,0
18662,1,1,65564,65565,65566,1,2,0
18663,1,3,65565,65566,65569,1,4,0
18664,2,3,65567,65569,65572,2,5,0
18665,1,3,65568,65572,65575,4,7,0
18666,6,3,65574,65575,65578,1,4,0
18667,3,2,65577,65578,65580,1,3,0
18668,1,2,65578,65580,65582,2,4,0
18669,6,2,65584,65584,65586,0,2,2
18670,4,3,65588,65588,65591,0,3,2
18671,6,2,65594,65594,65596,0,2,3
18672,6,2,65600,65600,65602,0,2,4
18673,3,2,65603,65603,65605,0,2,1
18674,2,1,65605,65605,65606,0,1,0
18675,6,2,65611,65611,65613,0,2,5
18676,3,3,65614,65614,65617,0,3,1
18677,1,2,65615,65617,65619,2,4,0
18678,3,2,65618,65619,65621,1,3,0
18679,5,2,65623,65623,65625,0,2,2
18680,1,3,65624,65625,65628,1,4,0
18681,2,3,65626,65628,65631,2,5,0
18682,3,2,65629,65631,65633,2,4,0
18683,5,1,65634,65634,65635,0,1,1
18684,4,2,65638,65638,65640,0,2,3
18685,1,2,65639,65640,65642,1,3,0
18686,1,1,65640,65642,65643,2,3,0
18687,6,2,65646,65646,65648,0,2,3
18688,3,1,65649,65649,65650,0,1,1
18689,6,1,65655,65655,65656,0,1,5
18690,6,3,65661,65661,65664,0,3,5
18691,3,3,65664,65664,65667,0,3,0
18692,3,2,65667,65667,65669,0,2,0
18693,5,3,65672,65672,65675,0,3,3
18694,4,2,65676,65676,65678,0,2,1
18695,3,3,65679,65679,65682,0,3,1
18696,4,1,65683,65683,65684,0,1,1
18697,2,2,65685,65685,65687,0,2,1
18698,6,2,65691,65691,65693,0,2,4
18699,5,2,65696,65696,65698,0,2,3
18700,6,2,65702,65702,65704,0,2,4
18701,4,3,65706,65706,65709,0,3,2
18702,2,1,65708,65709,65710,1,2,0
18703,2,2,65710,65710,65712,0,2,0
18704,3,1,65713,65713,65714,0,1,1
18705,2,2,65715,65715,65717,0,2,1
18706,2,1,65717,65717,65718,0,1,0
18707,2,1,65719,65719,65720,0,1,1
18708,1,2,65720,65720,65722,0,2,0
18709,2,3,65722,65722,65725,0,3,0
18710,3,2,65725,65725,65727,0,2,0
18711,3,2,65728,65728,65730,0,2,1
18712,3,3,65731,65731,65734,0,3,1
18713,5,3,65736,65736,65739,0,3,2
18714,3,1,65739,65739,65740,0,1,0
18715,4,1,65743,65743,65744,0,1,3
18716,6,3,65749,65749,65752,0,3,5
18717,3,2,65752,65752,65754,0,2,0
18718,5,1,65757,65757,65758,0,1,3
18719,5,3,65762,65762,65765,0,3,4
18720,4,1,65766,65766,65767,0,1,1
18721,5,3,65771,65771,65774,0,3,4
18722,1,3,65772,65774,65777,2,5,0
18723,3,2,65775,65777,65779,2,4,0
18724,6,1,65781,65781,65782,0,1,2
18725,4,2,65785,65785,65787,0,2,3
18726,1,3,65786,65787,65790,1,4,0
18727,2,3,65788,65790,65793,2,5,0
18728,4,1,65792,65793,65794,1,2,0
18729,4,1,65796,65796,65797,0,1,2
18730,5,1,65801,65801,65802,0,1,4
18731,3,2,65804,65804,65806,0,2,2
18732,6,3,65810,65810,65813,0,3,4
18733,3,2,65813,65813,65815,0,2,0
18734,1,1,65814,65815,65816,1,2,0
18735,4,3,65818,65818,65821,0,3,2
18736,1,2,65819,65821,65823,2,4,0
18737,2,1,65821,65823,65824,2,3,0
18738,5,1,65826,65826,65827,0,1,2
18739,3,2,65829,65829,65831,0,2,2
18740,3,3,65832,65832,65835,0,3,1
18741,6,2,65838,65838,65840,0,2,3
18742,4,1,65842,65842,65843,0,1,2
18743,3,3,65845,65845,65848,0,3,2
18744,1,2,65846,65848,65850,2,4,0
18745,3,2,65849,65850,65852,1,3,0
18746,1,3,65850,65852,65855,2,5,0
18747,3,2,65853,65855,65857,2,4,0
18748,4,1,65857,65857,65858,0,1,0
18749,3,2,65860,65860,65862,0,2,2
18750,2,2,65862,65862,65864,0,2,0
18751,6,1,65868,65868,65869,0,1,4
18752,5,1,65873,65873,65874,0,1,4
18753,4,3,65877,65877,65880,0,3,3
18754,3,1,65880,65880,65881,0,1,0
18755,3,2,65883,65883,65885,0,2,2
18756,2,3,65885,65885,65888,0,3,0
18757,4,1,65889,65889,65890,0,1,1
18758,5,2,65894,65894,65896,0,2,4
18759,2,3,65896,65896,65899,0,3,0
18760,4,3,65900,65900,65903,0,3,1
18761,1,2,65901,65903,65905,2,4,0
18762,3,2,65904,65905,65907,1,3,0
18763,2,2,65906,65907,65909,1,3,0
18764,1,1,65907,65909,65910,2,3,0
18765,3,1,65910,65910,65911,0,1,0
18766,3,3,65913,65913,65916,0,3,2
18767,5,2,65918,65918,65920,0,2,2
18768,2,1,65920,65920,65921,0,1,0
18769,3,3,65923,65923,65926,0,3,2
18770,2,1,65925,65926,65927,1,2,0
18771,1,3,65926,65927,65930,1,4,0
18772,1,2,65927,65930,65932,3,5,0
18773,2,2,65929,65932,65934,3,5,0
18774,1,2,65930,65934,65936,4,6,0
18775,2,2,65932,65936,65938,4,6,0
18776,4,3,65936,65938,65941,2,5,0
18777,5,3,65941,65941,65944,0,3,0
18778,1,1,65942,65944,65945,2,3,0
18779,3,2,65945,65945,65947,0,2,0
18780,3,2,65948,65948,65950,0,2,1
18781,1,1,65949,65950,65951,1,2,0
18782,3,2,65952,65952,65954,0,2,1
18783,5,3,65957,65957,65960,0,3,3
18784,5,2,65962,65962,65964,0,2,2
18785,1,2,65963,65964,65966,1,3,0
18786,4,1,65967,65967,65968,0,1,1
18787,5,3,65972,65972,65975,0,3,4
18788,4,1,65976,65976,65977,0,1,1
18789,2,2,65978,65978,65980,0,2,1
18790,3,2,65981,65981,65983,0,2,1
18791,6,1,65987,65987,65988,0,1,4
18792,1,2,65988,65988,65990,0,2,0
18793,1,1,65989,65990,65991,1,2,0
18794,6,3,65995,65995,65998,0,3,4
18795,3,1,65998,65998,65999,0,1,0
18796,1,1,65999,65999,66000,0,1,0
18797,4,2,66003,66003,66005,0,2,3
18798,4,2,66007,66007,66009,0,2,2
18799,6,1,66013,66013,66014,0,1,4
18800,6,3,66019,66019,66022,0,3,5
18801,3,3,66022,66022,66025,0,3,0
18802,4,1,66026,66026,66027,0,1,1
18803,2,3,66028,66028,66031,0,3,1
18804,4,1,66032,66032,66033,0,1,1
18805,1,2,66033,66033,66035,0,2,0
18806,6,2,66039,66039,66041,0,2,4
18807,4,2,66043,66043,66045,0,2,2
18808,3,2,66046,66046,66048,0,2,1
18809,2,1,66048,66048,66049,0,1,0
18810,6,1,66054,66054,66055,0,1,5
18811,1,1,66055,66055,66056,0,1,0
18812,5,1,66060,66060,66061,0,1,4
18813,5,1,66065,66065,66066,0,1,4
18814,6,2,66071,66071,66073,0,2,5
18815,4,1,66075,66075,66076,0,1,2
18816,1,2,66076,66076,66078,0,2,0
18817,6,3,66082,66082,66085,0,3,4
18818,6,2,66088,66088,66090,0,2,3
18819,3,1,66091,66091,66092,0,1,1
18820,5,1,66096,66096,66097,0,1,4
18821,6,3,66102,66102,66105,0,3,5
18822,6,3,66108,66108,66111,0,3,3
18823,5,2,66113,66113,66115,0,2,2
18824,6,2,66119,66119,66121,0,2,4
18825,4,2,66123,66123,66125,0,2,2
18826,1,3,66124,66125,66128,1,4,0
18827,1,2,66125,66128,66130,3,5,0
18828,5,2,66130,66130,66132,0,2,0
18829,1,3,66131,66132,66135,1,4,0
18830,5,2,66136,66136,66138,0,2,1
18831,1,1,66137,66138,66139,1,2,0
18832,1,2,66138,66139,66141,1,3,0
18833,3,3,66141,66141,66144,0,3,0
18834,6,1,66147,66147,66148,0,1,3
18835,6,3,66153,66153,66156,0,3,5
18836,4,1,66157,66157,66158,0,1,1
18837,1,3,66158,66158,66161,0,3,0
18838,3,2,66161,66161,66163,0,2,0
18839,2,3,66163,66163,66166,0,3,0
18840,2,3,66165,66166,66169,1,4,0
18841,2,2,66167,66169,66171,2,4,0
18842,5,1,66172,66172,66173,0,1,1
18843,2,3,66174,66174,66177,0,3,1
18844,5,3,66179,66179,66182,0,3,2
18845,6,3,66185,66185,66188,0,3,3
18846,6,3,66191,66191,66194,0,3,3
18847,2,2,66193,66194,66196,1,3,0
18848,1,3,66194,66196,66199,2,5,0
18849,3,2,66197,66199,66201,2,4,0
18850,2,2,66199,66201,66203,2,4,0
18851,4,1,66203,66203,66204,0,1,0
18852,3,2,66206,66206,66208,0,2,2
18853,4,2,66210,66210,66212,0,2,2
18854,2,3,66212,66212,66215,0,3,0
18855,1,3,66213,66215,66218,2,5,0
18856,2,3,66215,66218,66221,3,6,0
18857,2,2,66217,66221,66223,4,6,0
18858,1,2,66218,66223,66225,5,7,0
18859,4,3,66222,66225,66228,3,6,0
18860,1,1,66223,66228,66229,5,6,0
18861,3,1,66226,66229,66230,3,4,0
18862,3,2,66229,66230,66232,1,3,0
18863,6,2,66235,66235,66237,0,2,3
18864,6,2,66241,66241,66243,0,2,4
18865,5,3,66246,66246,66249,0,3,3
18866,2,1,66248,66249,66250,1,2,0
18867,6,3,66254,66254,66257,0,3,4
18868,5,1,66259,66259,66260,0,1,2
18869,4,1,66263,66263,66264,0,1,3
18870,3,1,66266,66266,66267,0,1,2
18871,2,2,66268,66268,66270,0,2,1
18872,6,2,66274,66274,66276,0,2,4
18873,6,3,66280,66280,66283,0,3,4
18874,6,2,66286,66286,66288,0,2,3
18875,5,1,66291,66291,66292,0,1,3
18876,1,2,66292,66292,66294,0,2,0
18877,6,3,66298,66298,66301,0,3,4
18878,4,2,66302,66302,66304,0,2,1
18879,3,3,66305,66305,66308,0,3,1
18880,1,2,66306,66308,66310,2,4,0
18881,5,2,66311,66311,66313,0,2,1
18882,4,3,66315,66315,66318,0,3,2
18883,3,1,66318,66318,66319,0,1,0
18884,6,3,66324,66324,66327,0,3,5
18885,3,1,66327,66327,66328,0,1,0
18886,3,2,66330,66330,66332,0,2,2
18887,4,3,66334,66334,66337,0,3,2
18888,1,2,66335,66337,66339,2,4,0
18889,6,1,66341,66341,66342,0,1,2
18890,2,3,66343,66343,66346,0,3,1
18891,3,3,66346,66346,66349,0,3,0
18892,2,1,66348,66349,66350,1,2,0
18893,5,2,66353,66353,66355,0,2,3
18894,6,1,66359,66359,66360,0,1,4
18895,5,1,66364,66364,66365,0,1,4
18896,2,3,66366,66366,66369,0,3,1
18897,4,1,66370,66370,66371,0,1,1
18898,1,1,66371,66371,66372,0,1,0
18899,2,3,66373,66373,66376,0,3,1
18900,1,2,66374,66376,66378,2,4,0
18901,4,3,66378,66378,66381,0,3,0
18902,5,3,66383,66383,66386,0,3,2
18903,3,2,66386,66386,66388,0,2,0
18904,4,1,66390,66390,66391,0,1,2
18905,5,1,66395,66395,66396,0,1,4
18906,5,2,66400,66400,66402,0,2,4
18907,1,2,66401,66402,66404,1,3,0
18908,6,1,66407,66407,66408,0,1,3
18909,4,1,66411,66411,66412,0,1,3
18910,1,3,66412,66412,66415,0,3,0
18911,1,3,66413,66415,66418,2,5,0
18912,6,3,66419,66419,66422,0,3,1
18913,3,3,66422,66422,66425,0,3,0
18914,2,2,66424,66425,66427,1,3,0
18915,5,2,66429,66429,66431,0,2,2
18916,4,3,66433,66433,66436,0,3,2
18917,4,3,66437,66437,66440,0,3,1
18918,3,2,66440,66440,66442,0,2,0
18919,2,3,66442,66442,66445,0,3,0
18920,6,3,66448,66448,66451,0,3,3
18921,1,2,66449,66451,66453,2,4,0
18922,3,1,66452,66453,66454,1,2,0
18923,2,3,66454,66454,66457,0,3,0
18924,2,1,66456,66457,66458,1,2,0
18925,6,2,66462,66462,66464,0,2,4
18926,3,2,66465,66465,66467,0,2,1
18927,1,3,66466,66467,66470,1,4,0
18928,3,1,66469,66470,66471,1,2,0
18929,3,1,66472,66472,66473,0,1,1
18930,1,3,66473,66473,66476,0,3,0
18931,1,2,66474,66476,66478,2,4,0
18932,4,3,66478,66478,66481,0,3,0
18933,6,3,66484,66484,66487,0,3,3
18934,4,3,66488,66488,66491,0,3,1
18935,1,1,66489,66491,66492,2,3,0
18936,5,3,66494,66494,66497,0,3,2
18937,1,3,66495,66497,66500,2,5,0
18938,1,3,66496,66500,66503,4,7,0
18939,2,3,66498,66503,66506,5,8,0
18940,4,3,66502,66506,66509,4,7,0
18941,2,2,66504,66509,66511,5,7,0
18942,4,3,66508,66511,66514,3,6,0
18943,3,3,66511,66514,66517,3,6,0
18944,6,3,66517,66517,66520,0,3,0
18945,5,3,66522,66522,66525,0,3,2
18946,5,2,66527,66527,66529,0,2,2
18947,6,1,66533,66533,66534,0,1,4
18948,6,2,66539,66539,66541,0,2,5
18949,3,2,66542,66542,66544,0,2,1
18950,4,1,66546,66546,66547,0,1,2
18951,5,2,66551,66551,66553,0,2,4
18952,6,1,66557,66557,66558,0,1,4
18953,3,1,66560,66560,66561,0,1,2
18954,1,3,66561,66561,66564,0,3,0
18955,5,3,66566,66566,66569,0,3,2
18956,5,2,66571,66571,66573,0,2,2
18957,4,2,66575,66575,66577,0,2,2
18958,6,1,66581,66581,66582,0,1,4
18959,5,2,66586,66586,66588,0,2,4
18960,2,1,66588,66588,66589,0,1,0
18961,6,1,66594,66594,66595,0,1,5
18962,6,3,66600,66600,66603,0,3,5
18963,2,2,66602,66603,66605,1,3,0
18964,3,3,66605,66605,66608,0,3,0
18965,2,1,66607,66608,66609,1,2,0
18966,4,1,66611,66611,66612,0,1,2
18967,4,2,66615,66615,66617,0,2,3
18968,2,2,66617,66617,66619,0,2,0
18969,1,3,66618,66619,66622,1,4,0
18970,2,2,66620,66622,66624,2,4,0
18971,2,1,66622,66624,66625,2,3,0
18972,1,1,66623,66625,66626,2,3,0
18973,6,2,66629,66629,66631,0,2,3
18974,1,1,66630,66631,66632,1,2,0
18975,3,1,66633,66633,66634,0,1,1
18976,5,3,66638,66638,66641,0,3,4
18977,2,3,66640,66641,66644,1,4,0
18978,5,3,66645,66645,66648,0,3,1
18979,4,3,66649,66649,66652,0,3,1
18980,4,2,66653,66653,66655,0,2,1
18981,4,1,66657,66657,66658,0,1,2
18982,4,3,66661,66661,66664,0,3,3
18983,3,2,66664,66664,66666,0,2,0
18984,1,3,66665,66666,66669,1,4,0
18985,1,2,66666,66669,66671,3,5,0
18986,6,2,66672,66672,66674,0,2,1
18987,3,3,66675,66675,66678,0,3,1
18988,4,2,66679,66679,66681,0,2,1
18989,6,3,66685,66685,66688,0,3,4
18990,1,1,66686,66688,66689,2,3,0
18991,1,1,66687,66689,66690,2,3,0
18992,5,2,66692,66692,66694,0,2,2
18993,6,1,66698,66698,66699,0,1,4
18994,5,1,66703,66703,66704,0,1,4
18995,1,2,66704,66704,66706,0,2,0
18996,3,1,66707,66707,66708,0,1,1
18997,1,3,66708,66708,66711,0,3,0
18998,6,3,66714,66714,66717,0,3,3
18999,2,3,66716,66717,66720,1,4,0
19000,6,2,66722,66722,66724,0,2,2
19001,4,3,66726,66726,66729,0,3,2
19002,6,2,66732,66732,66734,0,2,3
19003,1,1,66733,66734,66735,1,2,0
19004,2,3,66735,66735,66738,0,3,0
19005,2,1,66737,66738,66739,1,2,0
19006,5,2,66742,66742,66744,0,2,3
19007,2,1,66744,66744,66745,0,1,0
19008,5,1,66749,66749,66750,0,1,4
19009,4,3,66753,66753,66756,0,3,3
19010,4,2,66757,66757,66759,0,2,1
19011,6,2,66763,66763,66765,0,2,4
19012,2,3,66765,66765,66768,0,3,0
19013,2,1,66767,66768,66769,1,2,0
19014,2,3,66769,66769,66772,0,3,0
19015,4,2,66773,66773,66775,0,2,1
19016,4,1,66777,66777,66778,0,1,2
19017,4,1,66781,66781,66782,0,1,3
19018,1,3,66782,66782,66785,0,3,0
19019,5,1,66787,66787,66788,0,1,2
19020,2,3,66789,66789,66792,0,3,1
19021,4,3,66793,66793,66796,0,3,1
19022,6,2,66799,66799,66801,0,2,3
19023,5,2,66804,66804,66806,0,2,3
19024,1,2,66805,66806,66808,1,3,0
19025,1,3,66806,66808,66811,2,5,0
19026,1,2,66807,66811,66813,4,6,0
19027,4,1,66811,66813,66814,2,3,0
19028,2,3,66813,66814,66817,1,4,0
19029,2,2,66815,66817,66819,2,4,0
19030,5,2,66820,66820,66822,0,2,1
19031,3,2,66823,66823,66825,0,2,1
19032,4,1,66827,66827,66828,0,1,2
19033,6,2,66833,66833,66835,0,2,5
19034,2,3,66835,66835,66838,0,3,0
19035,1,2,66836,66838,66840,2,4,0
19036,5,1,66841,66841,66842,0,1,1
19037,1,1,66842,66842,66843,0,1,0
19038,4,3,66846,66846,66849,0,3,3
19039,4,1,66850,66850,66851,0,1,1
19040,5,2,66855,66855,66857,0,2,4
19041,1,3,66856,66857,66860,1,4,0
19042,1,3,66857,66860,66863,3,6,0
19043,3,2,66860,66863,66865,3,5,0
19044,1,2,66861,66865,66867,4,6,0
19045,3,1,66864,66867,66868,3,4,0
19046,3,1,66867,66868,66869,1,2,0
19047,5,3,66872,66872,66875,0,3,3
19048,2,3,66874,66875,66878,1,4,0
19049,6,3,66880,66880,66883,0,3,2
19050,5,3,66885,66885,66888,0,3,2
19051,3,2,66888,66888,66890,0,2,0
19052,5,3,66893,66893,66896,0,3,3
19053,6,1,66899,66899,66900,0,1,3
19054,1,3,66900,66900,66903,0,3,0
19055,3,1,66903,66903,66904,0,1,0
19056,6,2,66909,66909,66911,0,2,5
19057,1,3,66910,66911,66914,1,4,0
19058,6,1,66916,66916,66917,0,1,2
19059,2,1,66918,66918,66919,0,1,1
19060,6,3,66924,66924,66927,0,3,5
19061,4,1,66928,66928,66929,0,1,1
19062,3,3,66931,66931,66934,0,3,2
19063,2,3,66933,66934,66937,1,4,0
19064,5,3,66938,66938,66941,0,3,1
19065,4,3,66942,66942,66945,0,3,1
19066,3,1,66945,66945,66946,0,1,0
19067,3,2,66948,66948,66950,0,2,2
19068,6,2,66954,66954,66956,0,2,4
19069,1,2,66955,66956,66958,1,3,0
19070,1,1,66956,66958,66959,2,3,0
19071,2,3,66958,66959,66962,1,4,0
19072,5,3,66963,66963,66966,0,3,1
19073,4,3,66967,66967,66970,0,3,1
19074,1,2,66968,66970,66972,2,4,0
19075,3,2,66971,66972,66974,1,3,0
19076,6,1,66977,66977,66978,0,1,3
19077,5,3,66982,66982,66985,0,3,4
19078,3,2,66985,66985,66987,0,2,0
19079,6,1,66991,66991,66992,0,1,4
19080,5,2,66996,66996,66998,0,2,4
19081,1,1,66997,66998,66999,1,2,0
19082,4,3,67001,67001,67004,0,3,2
19083,6,2,67007,67007,67009,0,2,3
19084,6,3,67013,67013,67016,0,3,4
19085,6,3,67019,67019,67022,0,3,3
19086,2,1,67021,67022,67023,1,2,0
19087,5,3,67026,67026,67029,0,3,3
19088,2,1,67028,67029,67030,1,2,0
19089,4,3,67032,67032,67035,0,3,2
19090,4,1,67036,67036,67037,0,1,1
19091,2,2,67038,67038,67040,0,2,1
19092,4,1,67042,67042,67043,0,1,2
19093,5,3,67047,67047,67050,0,3,4
19094,4,2,67051,67051,67053,0,2,1
19095,6,3,67057,67057,67060,0,3,4
19096,2,2,67059,67060,67062,1,3,0
19097,3,2,67062,67062,67064,0,2,0
19098,6,3,67068,67068,67071,0,3,4
19099,1,1,67069,67071,67072,2,3,0
19100,6,3,67075,67075,67078,0,3,3
19101,2,1,67077,67078,67079,1,2,0
19102,2,2,67079,67079,67081,0,2,0
19103,3,2,67082,67082,67084,0,2,1
19104,3,3,67085,67085,67088,0,3,1
19105,3,3,67088,67088,67091,0,3,0
19106,2,3,67090,67091,67094,1,4,0
19107,4,3,67094,67094,67097,0,3,0
19108,5,1,67099,67099,67100,0,1,2
19109,1,3,67100,67100,67103,0,3,0
19110,4,2,67104,67104,67106,0,2,1
19111,1,2,67105,67106,67108,1,3,0
19112,2,2,67107,67108,67110,1,3,0
19113,3,3,67110,67110,67113,0,3,0
19114,3,2,67113,67113,67115,0,2,0
19115,5,2,67118,67118,67120,0,2,3
19116,4,3,67122,67122,67125,0,3,2
19117,3,2,67125,67125,67127,0,2,0
19118,4,1,67129,67129,67130,0,1,2
19119,6,3,67135,67135,67138,0,3,5
19120,5,3,67140,67140,67143,0,3,2
19121,4,2,67144,67144,67146,0,2,1
19122,1,2,67145,67146,67148,1,3,0
19123,2,2,67147,67148,67150,1,3,0
19124,3,3,67150,67150,67153,0,3,0
19125,2,3,67152,67153,67156,1,4,0
19126,5,1,67157,67157,67158,0,1,1
19127,4,1,67161,67161,67162,0,1,3
19128,1,2,67162,67162,67164,0,2,0
19129,6,1,67168,67168,67169,0,1,4
19130,3,1,67171,67171,67172,0,1,2
19131,3,3,67174,67174,67177,0,3,2
19132,2,2,67176,67177,67179,1,3,0
19133,4,1,67180,67180,67181,0,1,1
19134,4,2,67184,67184,67186,0,2,3
19135,4,1,67188,67188,67189,0,1,2
19136,5,1,67193,67193,67194,0,1,4
19137,1,1,67194,67194,67195,0,1,0
19138,4,3,67198,67198,67201,0,3,3
19139,6,2,67204,67204,67206,0,2,3
19140,5,1,67209,67209,67210,0,1,3
19141,6,2,67215,67215,67217,0,2,5
19142,3,2,67218,67218,67220,0,2,1
19143,3,3,67221,67221,67224,0,3,1
19144,3,3,67224,67224,67227,0,3,0
19145,2,3,67226,67227,67230,1,4,0
19146,6,3,67232,67232,67235,0,3,2
19147,4,2,67236,67236,67238,0,2,1
19148,6,2,67242,67242,67244,0,2,4
19149,1,2,67243,67244,67246,1,3,0
19150,3,2,67246,67246,67248,0,2,0
19151,2,2,67248,67248,67250,0,2,0
19152,6,1,67254,67254,67255,0,1,4
19153,6,3,67260,67260,67263,0,3,5
19154,2,2,67262,67263,67265,1,3,0
19155,2,1,67264,67265,67266,1,2,0
19156,2,1,67266,67266,67267,0,1,0
19157,5,3,67271,67271,67274,0,3,4
19158,2,2,67273,67274,67276,1,3,0
19159,5,1,67278,67278,67279,0,1,2
19160,1,2,67279,67279,67281,0,2,0
19161,1,2,67280,67281,67283,1,3,0
19162,6,1,67286,67286,67287,0,1,3
19163,2,1,67288,67288,67289,0,1,1
19164,2,1,67290,67290,67291,0,1,1
19165,5,1,67295,67295,67296,0,1,4
19166,4,1,67299,67299,67300,0,1,3
19167,2,2,67301,67301,67303,0,2,1
19168,4,2,67305,67305,67307,0,2,2
19169,2,2,67307,67307,67309,0,2,0
19170,1,1,67308,67309,67310,1,2,0
19171,2,3,67310,67310,67313,0,3,0
19172,3,3,67313,67313,67316,0,3,0
19173,3,1,67316,67316,67317,0,1,0
19174,3,3,67319,67319,67322,0,3,2
19175,2,3,67321,67322,67325,1,4,0
19176,1,1,67322,67325,67326,3,4,0
19177,1,1,67323,67326,67327,3,4,0
19178,4,1,67327,67327,67328,0,1,0
19179,2,2,67329,67329,67331,0,2,1
19180,2,1,67331,67331,67332,0,1,0
19181,4,1,67335,67335,67336,0,1,3
19182,1,3,67336,67336,67339,0,3,0
19183,5,2,67341,67341,67343,0,2,2
19184,4,3,67345,67345,67348,0,3,2
19185,4,3,67349,67349,67352,0,3,1
19186,2,2,67351,67352,67354,1,3,0
19187,1,2,67352,67354,67356,2,4,0
19188,4,1,67356,67356,67357,0,1,0
19189,2,2,67358,67358,67360,0,2,1
19190,2,3,67360,67360,67363,0,3,0
19191,2,2,67362,67363,67365,1,3,0
19192,3,3,67365,67365,67368,0,3,0
19193,3,2,67368,67368,67370,0,2,0
19194,4,3,67372,67372,67375,0,3,2
19195,4,3,67376,67376,67379,0,3,1
19196,1,2,67377,67379,67381,2,4,0
19197,5,2,67382,67382,67384,0,2,1
19198,5,1,67387,67387,67388,0,1,3
19199,6,2,67393,67393,67395,0,2,5
19200,1,1,67394,67395,67396,1,2,0
19201,5,2,67399,67399,67401,0,2,3
19202,4,2,67403,67403,67405,0,2,2
19203,5,3,67408,67408,67411,0,3,3
19204,6,3,67414,67414,67417,0,3,3
19205,1,3,67415,67417,67420,2,5,0
19206,3,1,67418,67420,67421,2,3,0
19207,2,3,67420,67421,67424,1,4,0
19208,4,2,67424,67424,67426,0,2,0
19209,1,3,67425,67426,67429,1,4,0
19210,5,3,67430,67430,67433,0,3,1
19211,4,2,67434,67434,67436,0,2,1
19212,1,1,67435,67436,67437,1,2,0
19213,6,2,67441,67441,67443,0,2,4
19214,5,3,67446,67446,67449,0,3,3
19215,1,3,67447,67449,67452,2,5,0
19216,6,1,67453,67453,67454,0,1,1
19217,6,2,67459,67459,67461,0,2,5
19218,2,3,67461,67461,67464,0,3,0
19219,6,3,67467,67467,67470,0,3,3
19220,4,2,67471,67471,67473,0,2,1
19221,2,3,67473,67473,67476,0,3,0
19222,1,3,67474,67476,67479,2,5,0
19223,6,1,67480,67480,67481,0,1,1
19224,4,1,67484,67484,67485,0,1,3
19225,1,1,67485,67485,67486,0,1,0
19226,1,3,67486,67486,67489,0,3,0
19227,5,3,67491,67491,67494,0,3,2
19228,6,3,67497,67497,67500,0,3,3
19229,1,3,67498,67500,67503,2,5,0
19230,3,1,67501,67503,67504,2,3,0
19231,5,1,67506,67506,67507,0,1,2
19232,5,1,67511,67511,67512,0,1,4
19233,1,3,67512,67512,67515,0,3,0
19234,6,2,67518,67518,67520,0,2,3
19235,6,3,67524,67524,67527,0,3,4
19236,6,1,67530,67530,67531,0,1,3
19237,1,2,67531,67531,67533,0,2,0
19238,3,3,67534,67534,67537,0,3,1
19239,3,3,67537,67537,67540,0,3,0
19240,2,2,67539,67540,67542,1,3,0
19241,6,3,67545,67545,67548,0,3,3
19242,3,1,67548,67548,67549,0,1,0
19243,1,1,67549,67549,67550,0,1,0
19244,6,1,67555,67555,67556,0,1,5
19245,5,2,67560,67560,67562,0,2,4
19246,5,3,67565,67565,67568,0,3,3
19247,1,3,67566,67568,67571,2,5,0
19248,4,2,67570,67571,67573,1,3,0
19249,6,3,67576,67576,67579,0,3,3
19250,3,2,67579,67579,67581,0,2,0
19251,3,1,67582,67582,67583,0,1,1
19252,4,2,67586,67586,67588,0,2,3
19253,3,3,67589,67589,67592,0,3,1
19254,3,2,67592,67592,67594,0,2,0
19255,4,2,67596,67596,67598,0,2,2
19256,2,3,67598,67598,67601,0,3,0
19257,1,3,67599,67601,67604,2,5,0
19258,1,3,67600,67604,67607,4,7,0
19259,1,2,67601,67607,67609,6,8,0
19260,6,2,67607,67609,67611,2,4,0
19261,2,2,67609,67611,67613,2,4,0
19262,2,1,67611,67613,67614,2,3,0
19263,5,3,67616,67616,67619,0,3,2
19264,4,1,67620,67620,67621,0,1,1
19265,5,2,67625,67625,67627,0,2,4
19266,3,2,67628,67628,67630,0,2,1
19267,6,3,67634,67634,67637,0,3,4
19268,1,2,67635,67637,67639,2,4,0
19269,1,3,67636,67639,67642,3,6,0
19270,2,3,67638,67642,67645,4,7,0
19271,2,3,67640,67645,67648,5,8,0
19272,4,3,67644,67648,67651,4,7,0
19273,3,3,67647,67651,67654,4,7,0
19274,1,3,67648,67654,67657,6,9,0
19275,1,2,67649,67657,67659,8,10,0
19276,3,3,67652,67659,67662,7,10,0
19277,5,3,67657,67662,67665,5,8,0
19278,6,1,67663,67665,67666,2,3,0
19279,3,3,67666,67666,67669,0,3,0
19280,3,1,67669,67669,67670,0,1,0
19281,3,3,67672,67672,67675,0,3,2
19282,2,3,67674,67675,67678,1,4,0
19283,6,3,67680,67680,67683,0,3,2
19284,6,1,67686,67686,67687,0,1,3
19285,4,1,67690,67690,67691,0,1,3
19286,5,2,67695,67695,67697,0,2,4
19287,5,3,67700,67700,67703,0,3,3
19288,5,2,67705,67705,67707,0,2,2
19289,4,3,67709,67709,67712,0,3,2
19290,5,1,67714,67714,67715,0,1,2
19291,5,1,67719,67719,67720,0,1,4
19292,1,1,67720,67720,67721,0,1,0
19293,3,3,67723,67723,67726,0,3,2
19294,3,3,67726,67726,67729,0,3,0
19295,2,2,67728,67729,67731,1,3,0
19296,4,3,67732,67732,67735,0,3,1
19297,5,2,67737,67737,67739,0,2,2
19298,5,2,67742,67742,67744,0,2,3
19299,6,2,67748,67748,67750,0,2,4
19300,3,1,67751,67751,67752,0,1,1
19301,6,2,67757,67757,67759,0,2,5
19302,3,3,67760,67760,67763,0,3,1
19303,3,3,67763,67763,67766,0,3,0
19304,2,1,67765,67766,67767,1,2,0
19305,1,3,67766,67767,67770,1,4,0
19306,4,3,67770,67770,67773,0,3,0
19307,2,3,67772,67773,67776,1,4,0
19308,2,3,67774,67776,67779,2,5,0
19309,6,2,67780,67780,67782,0,2,1
19310,6,1,67786,67786,67787,0,1,4
19311,3,2,67789,67789,67791,0,2,2
19312,1,3,67790,67791,67794,1,4,0
19313,5,1,67795,67795,67796,0,1,1
19314,3,2,67798,67798,67800,0,2,2
19315,1,1,67799,67800,67801,1,2,0
19316,4,2,67803,67803,67805,0,2,2
19317,5,2,67808,67808,67810,0,2,3
19318,6,1,67814,67814,67815,0,1,4
19319,2,1,67816,67816,67817,0,1,1
19320,6,3,67822,67822,67825,0,3,5
19321,6,2,67828,67828,67830,0,2,3
19322,6,3,67834,67834,67837,0,3,4
19323,1,1,67835,67837,67838,2,3,0
19324,4,3,67839,67839,67842,0,3,1
19325,6,2,67845,67845,67847,0,2,3
19326,5,2,67850,67850,67852,0,2,3
19327,5,2,67855,67855,67857,0,2,3
19328,5,3,67860,67860,67863,0,3,3
19329,2,3,67862,67863,67866,1,4,0
19330,3,2,67865,67866,67868,1,3,0
19331,1,3,67866,67868,67871,2,5,0
19332,4,2,67870,67871,67873,1,3,0
19333,2,2,67872,67873,67875,1,3,0
19334,1,1,67873,67875,67876,2,3,0
19335,6,1,67879,67879,67880,0,1,3
19336,1,1,67880,67880,67881,0,1,0
19337,5,3,67885,67885,67888,0,3,4
19338,6,1,67891,67891,67892,0,1,3
19339,1,3,67892,67892,67895,0,3,0
19340,5,2,67897,67897,67899,0,2,2
19341,6,3,67903,67903,67906,0,3,4
19342,6,3,67909,67909,67912,0,3,3
19343,4,2,67913,67913,67915,0,2,1
19344,6,1,67919,67919,67920,0,1,4
19345,4,2,67923,67923,67925,0,2,3
19346,3,2,67926,67926,67928,0,2,1
19347,4,2,67930,67930,67932,0,2,2
19348,4,2,67934,67934,67936,0,2,2
19349,6,2,67940,67940,67942,0,2,4
19350,5,2,67945,67945,67947,0,2,3
19351,2,2,67947,67947,67949,0,2,0
19352,4,3,67951,67951,67954,0,3,2
19353,3,2,67954,67954,67956,0,2,0
19354,5,1,67959,67959,67960,0,1,3
19355,3,2,67962,67962,67964,0,2,2
19356,5,1,67967,67967,67968,0,1,3
19357,4,3,67971,67971,67974,0,3,3
19358,2,3,67973,67974,67977,1,4,0
19359,3,3,67976,67977,67980,1,4,0
19360,5,1,67981,67981,67982,0,1,1
19361,4,2,67985,67985,67987,0,2,3
19362,4,3,67989,67989,67992,0,3,2
19363,6,1,67995,67995,67996,0,1,3
19364,2,3,67997,67997,68000,0,3,1
19365,3,1,68000,68000,68001,0,1,0
19366,4,3,68004,68004,68007,0,3,3
19367,4,2,68008,68008,68010,0,2,1
19368,4,2,68012,68012,68014,0,2,2
19369,5,2,68017,68017,68019,0,2,3
19370,3,3,68020,68020,68023,0,3,1
19371,4,3,68024,68024,68027,0,3,1
19372,6,1,68030,68030,68031,0,1,3
19373,6,3,68036,68036,68039,0,3,5
19374,3,1,68039,68039,68040,0,1,0
19375,3,2,68042,68042,68044,0,2,2
19376,5,2,68047,68047,68049,0,2,3
19377,2,2,68049,68049,68051,0,2,0
19378,3,3,68052,68052,68055,0,3,1
19379,2,1,68054,68055,68056,1,2,0
19380,5,3,68059,68059,68062,0,3,3
19381,5,1,68064,68064,68065,0,1,2
19382,6,1,68070,68070,68071,0,1,5
19383,2,2,68072,68072,68074,0,2,1
19384,1,1,68073,68074,68075,1,2,0
19385,6,3,68079,68079,68082,0,3,4
19386,2,1,68081,68082,68083,1,2,0
19387,5,2,68086,68086,68088,0,2,3
19388,4,2,68090,68090,68092,0,2,2
19389,1,3,68091,68092,68095,1,4,0
19390,2,3,68093,68095,68098,2,5,0
19391,3,1,68096,68098,68099,2,3,0
19392,5,2,68101,68101,68103,0,2,2
19393,6,3,68107,68107,68110,0,3,4
19394,4,1,68111,68111,68112,0,1,1
19395,4,3,68115,68115,68118,0,3,3
19396,2,2,68117,68118,68120,1,3,0
19397,4,1,68121,68121,68122,0,1,1
19398,6,3,68127,68127,68130,0,3,5
19399,4,2,68131,68131,68133,0,2,1
19400,5,3,68136,68136,68139,0,3,3
19401,4,3,68140,68140,68143,0,3,1
19402,2,3,68142,68143,68146,1,4,0
19403,6,2,68148,68148,68150,0,2,2
19404,6,3,68154,68154,68157,0,3,4
19405,4,2,68158,68158,68160,0,2,1
19406,1,2,68159,68160,68162,1,3,0
19407,5,3,68164,68164,68167,0,3,2
19408,5,1,68169,68169,68170,0,1,2
19409,3,3,68172,68172,68175,0,3,2
19410,3,2,68175,68175,68177,0,2,0
19411,3,2,68178,68178,68180,0,2,1
19412,4,1,68182,68182,68183,0,1,2
19413,2,1,68184,68184,68185,0,1,1
19414,4,1,68188,68188,68189,0,1,3
19415,1,3,68189,68189,68192,0,3,0
19416,2,3,68191,68192,68195,1,4,0
19417,5,1,68196,68196,68197,0,1,1
19418,3,1,68199,68199,68200,0,1,2
19419,4,1,68203,68203,68204,0,1,3
19420,3,1,68206,68206,68207,0,1,2
19421,5,1,68211,68211,68212,0,1,4
19422,3,1,68214,68214,68215,0,1,2
19423,6,1,68220,68220,68221,0,1,5
19424,2,1,68222,68222,68223,0,1,1
19425,2,1,68224,68224,68225,0,1,1
19426,5,3,68229,68229,68232,0,3,4
19427,3,1,68232,68232,68233,0,1,0
19428,5,1,68237,68237,68238,0,1,4
19429,3,3,68240,68240,68243,0,3,2
19430,4,2,68244,68244,68246,0,2,1
19431,6,2,68250,68250,68252,0,2,4
19432,3,2,68253,68253,68255,0,2,1
19433,4,3,68257,68257,68260,0,3,2
19434,3,3,68260,68260,68263,0,3,0
19435,4,3,68264,68264,68267,0,3,1
19436,5,1,68269,68269,68270,0,1,2
19437,3,2,68272,68272,68274,0,2,2
19438,4,3,68276,68276,68279,0,3,2
19439,1,1,68277,68279,68280,2,3,0
19440,4,2,68281,68281,68283,0,2,1
19441,2,1,68283,68283,68284,0,1,0
19442,3,2,68286,68286,68288,0,2,2
19443,2,3,68288,68288,68291,0,3,0
19444,5,3,68293,68293,68296,0,3,2
19445,6,2,68299,68299,68301,0,2,3
19446,3,1,68302,68302,68303,0,1,1
19447,4,1,68306,68306,68307,0,1,3
19448,1,1,68307,68307,68308,0,1,0
19449,3,3,68310,68310,68313,0,3,2
19450,1,1,68311,68313,68314,2,3,0
19451,3,1,68314,68314,68315,0,1,0
19452,3,1,68317,68317,68318,0,1,2
19453,5,3,68322,68322,68325,0,3,4
19454,6,3,68328,68328,68331,0,3,3
19455,4,2,68332,68332,68334,0,2,1
19456,6,1,68338,68338,68339,0,1,4
19457,4,2,68342,68342,68344,0,2,3
19458,2,1,68344,68344,68345,0,1,0
19459,3,1,68347,68347,68348,0,1,2
19460,2,2,68349,68349,68351,0,2,1
19461,6,1,68355,68355,68356,0,1,4
19462,5,1,68360,68360,68361,0,1,4
19463,6,3,68366,68366,68369,0,3,5
19464,5,3,68371,68371,68374,0,3,2
19465,1,1,68372,68374,68375,2,3,0
19466,6,3,68378,68378,68381,0,3,3
19467,6,1,68384,68384,68385,0,1,3
19468,6,3,68390,68390,68393,0,3,5
19469,5,2,68395,68395,68397,0,2,2
19470,4,1,68399,68399,68400,0,1,2
19471,4,3,68403,68403,68406,0,3,3
19472,6,1,68409,68409,68410,0,1,3
19473,1,1,68410,68410,68411,0,1,0
19474,3,3,68413,68413,68416,0,3,2
19475,6,1,68419,68419,68420,0,1,3
19476,3,3,68422,68422,68425,0,3,2
19477,3,3,68425,68425,68428,0,3,0
19478,6,3,68431,68431,68434,0,3,3
19479,2,1,68433,68434,68435,1,2,0
19480,1,2,68434,68435,68437,1,3,0
19481,1,3,68435,68437,68440,2,5,0
19482,6,2,68441,68441,68443,0,2,1
19483,5,2,68446,68446,68448,0,2,3
19484,5,2,68451,68451,68453,0,2,3
19485,5,1,68456,68456,68457,0,1,3
19486,4,2,68460,68460,68462,0,2,3
19487,5,1,68465,68465,68466,0,1,3
19488,6,2,68471,68471,68473,0,2,5
19489,6,1,68477,68477,68478,0,1,4
19490,5,2,68482,68482,68484,0,2,4
19491,4,3,68486,68486,68489,0,3,2
19492,3,1,68489,68489,68490,0,1,0
19493,3,2,68492,68492,68494,0,2,2
19494,3,1,68495,68495,68496,0,1,1
19495,1,1,68496,68496,68497,0,1,0
19496,2,2,68498,68498,68500,0,2,1
19497,6,2,68504,68504,68506,0,2,4
19498,6,1,68510,68510,68511,0,1,4
19499,1,2,68511,68511,68513,0,2,0
19500,5,3,68516,68516,68519,0,3,3
19501,2,3,68518,68519,68522,1,4,0
19502,2,2,68520,68522,68524,2,4,0
19503,6,2,68526,68526,68528,0,2,2
19504,1,1,68527,68528,68529,1,2,0
19505,2,3,68529,68529,68532,0,3,0
19506,5,1,68534,68534,68535,0,1,2
19507,6,1,68540,68540,68541,0,1,5
19508,6,3,68546,68546,68549,0,3,5
19509,3,3,68549,68549,68552,0,3,0
19510,4,1,68553,68553,68554,0,1,1
19511,6,3,68559,68559,68562,0,3,5
19512,1,1,68560,68562,68563,2,3,0
19513,5,2,68565,68565,68567,0,2,2
19514,2,2,68567,68567,68569,0,2,0
19515,2,1,68569,68569,68570,0,1,0
19516,5,3,68574,68574,68577,0,3,4
19517,6,1,68580,68580,68581,0,1,3
19518,3,1,68583,68583,68584,0,1,2
19519,5,1,68588,68588,68589,0,1,4
19520,5,2,68593,68593,68595,0,2,4
19521,3,2,68596,68596,68598,0,2,1
19522,3,2,68599,68599,68601,0,2,1
19523,2,2,68601,68601,68603,0,2,0
19524,4,2,68605,68605,68607,0,2,2
19525,4,2,68609,68609,68611,0,2,2
19526,5,3,68614,68614,68617,0,3,3
19527,5,2,68619,68619,68621,0,2,2
19528,2,3,68621,68621,68624,0,3,0
19529,3,2,68624,68624,68626,0,2,0
19530,1,3,68625,68626,68629,1,4,0
19531,3,3,68628,68629,68632,1,4,0
19532,5,1,68633,68633,68634,0,1,1
19533,3,2,68636,68636,68638,0,2,2
19534,1,2,68637,68638,68640,1,3,0
19535,1,3,68638,68640,68643,2,5,0
19536,1,2,68639,68643,68645,4,6,0
19537,4,1,68643,68645,68646,2,3,0
19538,3,2,68646,68646,68648,0,2,0
19539,1,1,68647,68648,68649,1,2,0
19540,1,1,68648,68649,68650,1,2,0
19541,1,1,68649,68650,68651,1,2,0
19542,2,1,68651,68651,68652,0,1,0
19543,6,3,68657,68657,68660,0,3,5
19544,1,2,68658,68660,68662,2,4,0
19545,4,2,68662,68662,68664,0,2,0
19546,3,2,68665,68665,68667,0,2,1
19547,3,2,68668,68668,68670,0,2,1
19548,6,3,68674,68674,68677,0,3,4
19549,4,3,68678,68678,68681,0,3,1
19550,4,1,68682,68682,68683,0,1,1
19551,6,2,68688,68688,68690,0,2,5
19552,6,2,68694,68694,68696,0,2,4
19553,2,3,68696,68696,68699,0,3,0
19554,2,2,68698,68699,68701,1,3,0
19555,6,1,68704,68704,68705,0,1,3
19556,6,2,68710,68710,68712,0,2,5
19557,6,1,68716,68716,68717,0,1,4
19558,2,2,68718,68718,68720,0,2,1
19559,6,3,68724,68724,68727,0,3,4
19560,3,2,68727,68727,68729,0,2,0
19561,1,1,68728,68729,68730,1,2,0
19562,5,1,68733,68733,68734,0,1,3
19563,3,3,68736,68736,68739,0,3,2
19564,2,2,68738,68739,68741,1,3,0
19565,5,3,68743,68743,68746,0,3,2
19566,3,1,68746,68746,68747,0,1,0
19567,6,1,68752,68752,68753,0,1,5
19568,6,2,68758,68758,68760,0,2,5
19569,2,1,68760,68760,68761,0,1,0
19570,4,2,68764,68764,68766,0,2,3
19571,4,3,68768,68768,68771,0,3,2
19572,6,1,68774,68774,68775,0,1,3
19573,1,2,68775,68775,68777,0,2,0
19574,2,1,68777,68777,68778,0,1,0
19575,6,2,68783,68783,68785,0,2,5
19576,2,2,68785,68785,68787,0,2,0
19577,3,3,68788,68788,68791,0,3,1
19578,1,2,68789,68791,68793,2,4,0
19579,2,3,68791,68793,68796,2,5,0
19580,5,3,68796,68796,68799,0,3,0
19581,3,3,68799,68799,68802,0,3,0
19582,5,2,68804,68804,68806,0,2,2
19583,3,3,68807,68807,68810,0,3,1
19584,2,1,68809,68810,68811,1,2,0
19585,6,2,68815,68815,68817,0,2,4
19586,1,2,68816,68817,68819,1,3,0
19587,6,2,68822,68822,68824,0,2,3
19588,2,2,68824,68824,68826,0,2,0
19589,4,3,68828,68828,68831,0,3,2
19590,2,3,68830,68831,68834,1,4,0
19591,4,2,68834,68834,68836,0,2,0
19592,6,3,68840,68840,68843,0,3,4
19593,4,1,68844,68844,68845,0,1,1
19594,6,1,68850,68850,68851,0,1,5
19595,6,2,68856,68856,68858,0,2,5
19596,2,3,68858,68858,68861,0,3,0
19597,6,2,68864,68864,68866,0,2,3
19598,4,3,68868,68868,68871,0,3,2
19599,1,3,68869,68871,68874,2,5,0
19600,5,1,68874,68874,68875,0,1,0
19601,2,2,68876,68876,68878,0,2,1
19602,2,1,68878,68878,68879,0,1,0
19603,5,1,68883,68883,68884,0,1,4
19604,2,2,68885,68885,68887,0,2,1
19605,2,1,68887,68887,68888,0,1,0
19606,6,2,68893,68893,68895,0,2,5
19607,3,3,68896,68896,68899,0,3,1
19608,1,3,68897,68899,68902,2,5,0
19609,3,1,68900,68902,68903,2,3,0
19610,1,2,68901,68903,68905,2,4,0
19611,4,3,68905,68905,68908,0,3,0
19612,6,2,68911,68911,68913,0,2,3
19613,6,3,68917,68917,68920,0,3,4
19614,6,1,68923,68923,68924,0,1,3
19615,1,1,68924,68924,68925,0,1,0
19616,2,2,68926,68926,68928,0,2,1
19617,4,1,68930,68930,68931,0,1,2
19618,2,2,68932,68932,68934,0,2,1
19619,3,1,68935,68935,68936,0,1,1
19620,4,3,68939,68939,68942,0,3,3
19621,1,1,68940,68942,68943,2,3,0
19622,1,1,68941,68943,68944,2,3,0
19623,1,1,68942,68944,68945,2,3,0
19624,1,3,68943,68945,68948,2,5,0
19625,4,1,68947,68948,68949,1,2,0
19626,5,2,68952,68952,68954,0,2,3
19627,5,2,68957,68957,68959,0,2,3
19628,2,3,68959,68959,68962,0,3,0
19629,2,1,68961,68962,68963,1,2,0
19630,4,2,68965,68965,68967,0,2,2
19631,1,1,68966,68967,68968,1,2,0
19632,4,3,68970,68970,68973,0,3,2
19633,2,1,68972,68973,68974,1,2,0
19634,4,2,68976,68976,68978,0,2,2
19635,4,1,68980,68980,68981,0,1,2
19636,3,2,68983,68983,68985,0,2,2
19637,4,3,68987,68987,68990,0,3,2
19638,5,2,68992,68992,68994,0,2,2
19639,5,2,68997,68997,68999,0,2,3
19640,4,2,69001,69001,69003,0,2,2
19641,4,3,69005,69005,69008,0,3,2
19642,4,1,69009,69009,69010,0,1,1
19643,2,1,69011,69011,69012,0,1,1
19644,3,3,69014,69014,69017,0,3,2
19645,5,2,69019,69019,69021,0,2,2
19646,5,2,69024,69024,69026,0,2,3
19647,2,1,69026,69026,69027,0,1,0
19648,6,2,69032,69032,69034,0,2,5
19649,4,3,69036,69036,69039,0,3,2
19650,1,1,69037,69039,69040,2,3,0
19651,2,2,69039,69040,69042,1,3,0
19652,5,1,69044,69044,69045,0,1,2
19653,5,1,69049,69049,69050,0,1,4
19654,1,1,69050,69050,69051,0,1,0
19655,1,1,69051,69051,69052,0,1,0
19656,6,3,69057,69057,69060,0,3,5
19657,4,2,69061,69061,69063,0,2,1
19658,6,2,69067,69067,69069,0,2,4
19659,3,3,69070,69070,69073,0,3,1
19660,3,3,69073,69073,69076,0,3,0
19661,1,1,69074,69076,69077,2,3,0
19662,5,1,69079,69079,69080,0,1,2
19663,6,3,69085,69085,69088,0,3,5
19664,5,1,69090,69090,69091,0,1,2
19665,5,1,69095,69095,69096,0,1,4
19666,6,3,69101,69101,69104,0,3,5
19667,6,3,69107,69107,69110,0,3,3
19668,2,3,69109,69110,69113,1,4,0
19669,4,2,69113,69113,69115,0,2,0
19670,3,3,69116,69116,69119,0,3,1
19671,4,2,69120,69120,69122,0,2,1
19672,5,3,69125,69125,69128,0,3,3
19673,6,1,69131,69131,69132,0,1,3
19674,6,3,69137,69137,69140,0,3,5
19675,3,2,69140,69140,69142,0,2,0
19676,3,3,69143,69143,69146,0,3,1
19677,4,2,69147,69147,69149,0,2,1
19678,2,3,69149,69149,69152,0,3,0
19679,3,2,69152,69152,69154,0,2,0
19680,1,2,69153,69154,69156,1,3,0
19681,5,1,69158,69158,69159,0,1,2
19682,6,3,69164,69164,69167,0,3,5
19683,3,2,69167,69167,69169,0,2,0
19684,4,3,69171,69171,69174,0,3,2
19685,5,2,69176,69176,69178,0,2,2
19686,4,3,69180,69180,69183,0,3,2
19687,3,3,69183,69183,69186,0,3,0
19688,5,1,69188,69188,69189,0,1,2
19689,3,1,69191,69191,69192,0,1,2
19690,3,2,69194,69194,69196,0,2,2
19691,4,1,69198,69198,69199,0,1,2
19692,1,3,69199,69199,69202,0,3,0
19693,4,2,69203,69203,69205,0,2,1
19694,6,3,69209,69209,69212,0,3,4
19695,5,1,69214,69214,69215,0,1,2
19696,3,2,69217,69217,69219,0,2,2
19697,2,2,69219,69219,69221,0,2,0
19698,5,3,69224,69224,69227,0,3,3
19699,4,1,69228,69228,69229,0,1,1
19700,3,1,69231,69231,69232,0,1,2
19701,6,1,69237,69237,69238,0,1,5
19702,5,1,69242,69242,69243,0,1,4
19703,5,1,69247,69247,69248,0,1,4
19704,5,2,69252,69252,69254,0,2,4
19705,4,2,69256,69256,69258,0,2,2
19706,2,1,69258,69258,69259,0,1,0
19707,5,3,69263,69263,69266,0,3,4
19708,6,3,69269,69269,69272,0,3,3
19709,3,3,69272,69272,69275,0,3,0
19710,2,1,69274,69275,69276,1,2,0
19711,3,2,69277,69277,69279,0,2,1
19712,3,2,69280,69280,69282,0,2,1
19713,1,3,69281,69282,69285,1,4,0
19714,2,1,69283,69285,69286,2,3,0
19715,2,2,69285,69286,69288,1,3,0
19716,6,2,69291,69291,69293,0,2,3
19717,3,2,69294,69294,69296,0,2,1
19718,4,2,69298,69298,69300,0,2,2
19719,5,3,69303,69303,69306,0,3,3
19720,3,2,69306,69306,69308,0,2,0
19721,4,3,69310,69310,69313,0,3,2
19722,3,3,69313,69313,69316,0,3,0
19723,5,2,69318,69318,69320,0,2,2
19724,2,2,69320,69320,69322,0,2,0
19725,2,2,69322,69322,69324,0,2,0
19726,2,1,69324,69324,69325,0,1,0
19727,3,3,69327,69327,69330,0,3,2
19728,1,3,69328,69330,69333,2,5,0
19729,1,1,69329,69333,69334,4,5,0
19730,6,3,69335,69335,69338,0,3,1
19731,4,2,69339,69339,69341,0,2,1
19732,3,2,69342,69342,69344,0,2,1
19733,6,1,69348,69348,69349,0,1,4
19734,4,1,69352,69352,69353,0,1,3
19735,2,3,69354,69354,69357,0,3,1
19736,2,2,69356,69357,69359,1,3,0
19737,4,2,69360,69360,69362,0,2,1
19738,3,3,69363,69363,69366,0,3,1
19739,6,1,69369,69369,69370,0,1,3
19740,3,3,69372,69372,69375,0,3,2
19741,4,3,69376,69376,69379,0,3,1
19742,2,1,69378,69379,69380,1,2,0
19743,5,1,69383,69383,69384,0,1,3
19744,1,2,69384,69384,69386,0,2,0
19745,1,1,69385,69386,69387,1,2,0
19746,2,3,69387,69387,69390,0,3,0
19747,4,1,69391,69391,69392,0,1,1
19748,5,2,69396,69396,69398,0,2,4
19749,5,3,69401,69401,69404,0,3,3
19750,2,3,69403,69404,69407,1,4,0
19751,1,3,69404,69407,69410,3,6,0
19752,3,2,69407,69410,69412,3,5,0
19753,1,2,69408,69412,69414,4,6,0
19754,6,3,69414,69414,69417,0,3,0
19755,6,1,69420,69420,69421,0,1,3
19756,3,1,69423,69423,69424,0,1,2
19757,5,2,69428,69428,69430,0,2,4
19758,6,1,69434,69434,69435,0,1,4
19759,3,1,69437,69437,69438,0,1,2
19760,2,3,69439,69439,69442,0,3,1
19761,6,2,69445,69445,69447,0,2,3
19762,5,2,69450,69450,69452,0,2,3
19763,3,2,69453,69453,69455,0,2,1
19764,6,1,69459,69459,69460,0,1,4
19765,5,3,69464,69464,69467,0,3,4
19766,6,1,69470,69470,69471,0,1,3
19767,5,2,69475,69475,69477,0,2,4
19768,4,2,69479,69479,69481,0,2,2
19769,6,1,69485,69485,69486,0,1,4
19770,2,3,69487,69487,69490,0,3,1
19771,5,3,69492,69492,69495,0,3,2
19772,5,2,69497,69497,69499,0,2,2
19773,1,1,69498,69499,69500,1,2,0
19774,2,3,69500,69500,69503,0,3,0
19775,4,2,69504,69504,69506,0,2,1
19776,1,3,69505,69506,69509,1,4,0
19777,6,2,69511,69511,69513,0,2,2
19778,6,1,69517,69517,69518,0,1,4
19779,2,2,69519,69519,69521,0,2,1
19780,4,1,69523,69523,69524,0,1,2
19781,2,3,69525,69525,69528,0,3,1
19782,5,2,69530,69530,69532,0,2,2
19783,1,3,69531,69532,69535,1,4,0
19784,5,1,69536,69536,69537,0,1,1
19785,5,1,69541,69541,69542,0,1,4
19786,3,2,69544,69544,69546,0,2,2
19787,6,2,69550,69550,69552,0,2,4
19788,4,2,69554,69554,69556,0,2,2
19789,1,3,69555,69556,69559,1,4,0
19790,4,2,69559,69559,69561,0,2,0
19791,2,2,69561,69561,69563,0,2,0
19792,5,3,69566,69566,69569,0,3,3
19793,3,2,69569,69569,69571,0,2,0
19794,3,2,69572,69572,69574,0,2,1
19795,2,3,69574,69574,69577,0,3,0
19796,2,2,69576,69577,69579,1,3,0
19797,6,2,69582,69582,69584,0,2,3
19798,1,1,69583,69584,69585,1,2,0
19799,3,3,69586,69586,69589,0,3,1
19800,5,1,69591,69591,69592,0,1,2
19801,3,2,69594,69594,69596,0,2,2
19802,6,3,69600,69600,69603,0,3,4
19803,1,1,69601,69603,69604,2,3,0
19804,6,1,69607,69607,69608,0,1,3
19805,3,1,69610,69610,69611,0,1,2
19806,1,1,69611,69611,69612,0,1,0
19807,3,3,69614,69614,69617,0,3,2
19808,5,2,69619,69619,69621,0,2,2
19809,5,3,69624,69624,69627,0,3,3
19810,4,2,69628,69628,69630,0,2,1
19811,1,1,69629,69630,69631,1,2,0
19812,4,1,69633,69633,69634,0,1,2
19813,1,2,69634,69634,69636,0,2,0
19814,2,2,69636,69636,69638,0,2,0
19815,4,3,69640,69640,69643,0,3,2
19816,4,2,69644,69644,69646,0,2,1
19817,6,3,69650,69650,69653,0,3,4
19818,1,2,69651,69653,69655,2,4,0
19819,2,1,69653,69655,69656,2,3,0
19820,5,3,69658,69658,69661,0,3,2
19821,5,1,69663,69663,69664,0,1,2
19822,2,1,69665,69665,69666,0,1,1
19823,1,3,69666,69666,69669,0,3,0
19824,3,2,69669,69669,69671,0,2,0
19825,6,3,69675,69675,69678,0,3,4
19826,5,3,69680,69680,69683,0,3,2
19827,5,1,69685,69685,69686,0,1,2
19828,2,3,69687,69687,69690,0,3,1
19829,4,2,69691,69691,69693,0,2,1
19830,1,2,69692,69693,69695,1,3,0
19831,4,1,69696,69696,69697,0,1,1
19832,6,3,69702,69702,69705,0,3,5
19833,2,3,69704,69705,69708,1,4,0
19834,2,3,69706,69708,69711,2,5,0
19835,5,1,69711,69711,69712,0,1,0
19836,6,1,69717,69717,69718,0,1,5
19837,5,3,69722,69722,69725,0,3,4
19838,3,1,69725,69725,69726,0,1,0
19839,1,2,69726,69726,69728,0,2,0
19840,5,1,69731,69731,69732,0,1,3
19841,2,3,69733,69733,69736,0,3,1
19842,3,2,69736,69736,69738,0,2,0
19843,1,3,69737,69738,69741,1,4,0
19844,5,2,69742,69742,69744,0,2,1
19845,6,1,69748,69748,69749,0,1,4
19846,6,3,69754,69754,69757,0,3,5
19847,6,3,69760,69760,69763,0,3,3
19848,4,1,69764,69764,69765,0,1,1
19849,1,1,69765,69765,69766,0,1,0
19850,5,3,69770,69770,69773,0,3,4
19851,2,1,69772,69773,69774,1,2,0
19852,6,3,69778,69778,69781,0,3,4
19853,1,1,69779,69781,69782,2,3,0
19854,4,1,69783,69783,69784,0,1,1
19855,3,2,69786,69786,69788,0,2,2
19856,3,3,69789,69789,69792,0,3,1
19857,4,1,69793,69793,69794,0,1,1
19858,1,2,69794,69794,69796,0,2,0
19859,5,1,69799,69799,69800,0,1,3
19860,3,3,69802,69802,69805,0,3,2
19861,3,1,69805,69805,69806,0,1,0
19862,6,1,69811,69811,69812,0,1,5
19863,1,3,69812,69812,69815,0,3,0
19864,3,1,69815,69815,69816,0,1,0
19865,4,3,69819,69819,69822,0,3,3
19866,6,1,69825,69825,69826,0,1,3
19867,5,1,69830,69830,69831,0,1,4
19868,2,2,69832,69832,69834,0,2,1
19869,2,2,69834,69834,69836,0,2,0
19870,1,1,69835,69836,69837,1,2,0
19871,3,2,69838,69838,69840,0,2,1
19872,5,2,69843,69843,69845,0,2,3
19873,6,2,69849,69849,69851,0,2,4
19874,6,1,69855,69855,69856,0,1,4
19875,3,3,69858,69858,69861,0,3,2
19876,2,2,69860,69861,69863,1,3,0
19877,6,3,69866,69866,69869,0,3,3
19878,2,1,69868,69869,69870,1,2,0
19879,4,3,69872,69872,69875,0,3,2
19880,3,1,69875,69875,69876,0,1,0
19881,5,1,69880,69880,69881,0,1,4
19882,2,2,69882,69882,69884,0,2,1
19883,1,2,69883,69884,69886,1,3,0
19884,6,2,69889,69889,69891,0,2,3
19885,1,2,69890,69891,69893,1,3,0
19886,3,1,69893,69893,69894,0,1,0
19887,1,3,69894,69894,69897,0,3,0
19888,4,1,69898,69898,69899,0,1,1
19889,6,3,69904,69904,69907,0,3,5
19890,5,3,69909,69909,69912,0,3,2
19891,5,3,69914,69914,69917,0,3,2
19892,2,3,69916,69917,69920,1,4,0
19893,1,3,69917,69920,69923,3,6,0
19894,1,1,69918,69923,69924,5,6,0
19895,2,2,69920,69924,69926,4,6,0
19896,6,2,69926,69926,69928,0,2,0
19897,2,2,69928,69928,69930,0,2,0
19898,4,3,69932,69932,69935,0,3,2
19899,4,2,69936,69936,69938,0,2,1
19900,1,1,69937,69938,69939,1,2,0
19901,5,1,69942,69942,69943,0,1,3
19902,1,1,69943,69943,69944,0,1,0
19903,5,2,69948,69948,69950,0,2,4
19904,3,2,69951,69951,69953,0,2,1
19905,5,3,69956,69956,69959,0,3,3
19906,1,2,69957,69959,69961,2,4,0
19907,5,1,69962,69962,69963,0,1,1
19908,5,3,69967,69967,69970,0,3,4
19909,5,3,69972,69972,69975,0,3,2
19910,5,2,69977,69977,69979,0,2,2
19911,5,1,69982,69982,69983,0,1,3
19912,5,2,69987,69987,69989,0,2,4
19913,4,1,69991,69991,69992,0,1,2
19914,3,3,69994,69994,69997,0,3,2
19915,3,1,69997,69997,69998,0,1,0
19916,1,1,69998,69998,69999,0,1,0
19917,6,1,70004,70004,70005,0,1,5
19918,2,1,70006,70006,70007,0,1,1
19919,6,2,70012,70012,70014,0,2,5
19920,2,1,70014,70014,70015,0,1,0
19921,5,3,70019,70019,70022,0,3,4
19922,1,3,70020,70022,70025,2,5,0
19923,1,1,70021,70025,70026,4,5,0
19924,6,3,70027,70027,70030,0,3,1
19925,4,1,70031,70031,70032,0,1,1
19926,4,3,70035,70035,70038,0,3,3
19927,6,1,70041,70041,70042,0,1,3
19928,2,2,70043,70043,70045,0,2,1
19929,4,3,70047,70047,70050,0,3,2
19930,2,3,70049,70050,70053,1,4,0
19931,1,2,70050,70053,70055,3,5,0
19932,4,1,70054,70055,70056,1,2,0
19933,5,3,70059,70059,70062,0,3,3
19934,5,1,70064,70064,70065,0,1,2
19935,2,3,70066,70066,70069,0,3,1
19936,4,1,70070,70070,70071,0,1,1
19937,3,3,70073,70073,70076,0,3,2
19938,6,3,70079,70079,70082,0,3,3
19939,5,2,70084,70084,70086,0,2,2
19940,2,1,70086,70086,70087,0,1,0
19941,1,1,70087,70087,70088,0,1,0
19942,2,2,70089,70089,70091,0,2,1
19943,2,1,70091,70091,70092,0,1,0
19944,3,1,70094,70094,70095,0,1,2
19945,2,1,70096,70096,70097,0,1,1
19946,3,2,70099,70099,70101,0,2,2
19947,3,1,70102,70102,70103,0,1,1
19948,6,1,70108,70108,70109,0,1,5
19949,3,3,70111,70111,70114,0,3,2
19950,4,1,70115,70115,70116,0,1,1
19951,1,3,70116,70116,70119,0,3,0
19952,1,3,70117,70119,70122,2,5,0
19953,6,2,70123,70123,70125,0,2,1
19954,1,1,70124,70125,70126,1,2,0
19955,6,3,70130,70130,70133,0,3,4
19956,5,1,70135,70135,70136,0,1,2
19957,4,1,70139,70139,70140,0,1,3
19958,3,3,70142,70142,70145,0,3,2
19959,6,3,70148,70148,70151,0,3,3
19960,1,2,70149,70151,70153,2,4,0
19961,5,3,70154,70154,70157,0,3,1
19962,2,3,70156,70157,70160,1,4,0
19963,5,3,70161,70161,70164,0,3,1
19964,2,1,70163,70164,70165,1,2,0
19965,5,2,70168,70168,70170,0,2,3
19966,5,2,70173,70173,70175,0,2,3
19967,6,3,70179,70179,70182,0,3,4
19968,4,1,70183,70183,70184,0,1,1
19969,2,2,70185,70185,70187,0,2,1
19970,5,3,70190,70190,70193,0,3,3
19971,2,1,70192,70193,70194,1,2,0
19972,4,3,70196,70196,70199,0,3,2
19973,6,3,70202,70202,70205,0,3,3
19974,1,1,70203,70205,70206,2,3,0
19975,3,2,70206,70206,70208,0,2,0
19976,2,2,70208,70208,70210,0,2,0
19977,5,2,70213,70213,70215,0,2,3
19978,3,1,70216,70216,70217,0,1,1
19979,4,3,70220,70220,70223,0,3,3
19980,6,1,70226,70226,70227,0,1,3
19981,3,3,70229,70229,70232,0,3,2
19982,2,2,70231,70232,70234,1,3,0
19983,5,2,70236,70236,70238,0,2,2
19984,5,1,70241,70241,70242,0,1,3
19985,3,2,70244,70244,70246,0,2,2
19986,2,3,70246,70246,70249,0,3,0
19987,2,1,70248,70249,70250,1,2,0
19988,4,2,70252,70252,70254,0,2,2
19989,5,1,70257,70257,70258,0,1,3
19990,2,1,70259,70259,70260,0,1,1
19991,4,1,70263,70263,70264,0,1,3
19992,2,1,70265,70265,70266,0,1,1
19993,1,1,70266,70266,70267,0,1,0
19994,5,1,70271,70271,70272,0,1,4
19995,6,2,70277,70277,70279,0,2,5
19996,1,1,70278,70279,70280,1,2,0
19997,6,2,70284,70284,70286,0,2,4
19998,5,1,70289,70289,70290,0,1,3
19999,6,3,70295,70295,70298,0,3,5
20000,5,2,70300,70300,70302,0,2,2
20001,2,3,70302,70302,70305,0,3,0
20002,3,1,70305,70305,70306,0,1,0
20003,1,1,70306,70306,70307,0,1,0
20004,1,1,70307,70307,70308,0,1,0
20005,4,2,70311,70311,70313,0,2,3
20006,4,2,70315,70315,70317,0,2,2
20007,3,1,70318,70318,70319,0,1,1
20008,6,1,70324,70324,70325,0,1,5
20009,2,2,70326,70326,70328,0,2,1
20010,4,2,70330,70330,70332,0,2,2
20011,2,2,70332,70332,70334,0,2,0
20012,3,1,70335,70335,70336,0,1,1
20013,4,3,70339,70339,70342,0,3,3
20014,6,1,70345,70345,70346,0,1,3
20015,3,2,70348,70348,70350,0,2,2
20016,1,3,70349,70350,70353,1,4,0
20017,2,1,70351,70353,70354,2,3,0
20018,4,3,70355,70355,70358,0,3,1
20019,5,2,70360,70360,70362,0,2,2
20020,2,1,70362,70362,70363,0,1,0
20021,3,2,70365,70365,70367,0,2,2
20022,5,3,70370,70370,70373,0,3,3
20023,4,3,70374,70374,70377,0,3,1
20024,5,3,70379,70379,70382,0,3,2
20025,3,3,70382,70382,70385,0,3,0
20026,5,1,70387,70387,70388,0,1,2
20027,3,2,70390,70390,70392,0,2,2
20028,4,2,70394,70394,70396,0,2,2
20029,6,3,70400,70400,70403,0,3,4
20030,5,1,70405,70405,70406,0,1,2
20031,2,2,70407,70407,70409,0,2,1
20032,2,3,70409,70409,70412,0,3,0
20033,3,2,70412,70412,70414,0,2,0
20034,6,2,70418,70418,70420,0,2,4
20035,5,2,70423,70423,70425,0,2,3
20036,4,3,70427,70427,70430,0,3,2
20037,3,2,70430,70430,70432,0,2,0
20038,4,2,70434,70434,70436,0,2,2
20039,5,2,70439,70439,70441,0,2,3
20040,1,1,70440,70441,70442,1,2,0
20041,2,2,70442,70442,70444,0,2,0
20042,3,3,70445,70445,70448,0,3,1
20043,1,2,70446,70448,70450,2,4,0
20044,5,2,70451,70451,70453,0,2,1
20045,2,3,70453,70453,70456,0,3,0
20046,6,2,70459,70459,70461,0,2,3
20047,2,3,70461,70461,70464,0,3,0
20048,3,3,70464,70464,70467,0,3,0
20049,2,1,70466,70467,70468,1,2,0
20050,1,3,70467,70468,70471,1,4,0
20051,1,3,70468,70471,70474,3,6,0
20052,6,3,70474,70474,70477,0,3,0
20053,3,3,70477,70477,70480,0,3,0
20054,1,1,70478,70480,70481,2,3,0
20055,3,1,70481,70481,70482,0,1,0
20056,3,3,70484,70484,70487,0,3,2
20057,2,3,70486,70487,70490,1,4,0
20058,1,3,70487,70490,70493,3,6,0
20059,5,3,70492,70493,70496,1,4,0
20060,2,2,70494,70496,70498,2,4,0
20061,2,1,70496,70498,70499,2,3,0
20062,3,2,70499,70499,70501,0,2,0
20063,5,2,70504,70504,70506,0,2,3
20064,4,2,70508,70508,70510,0,2,2
20065,1,3,70509,70510,70513,1,4,0
20066,2,3,70511,70513,70516,2,5,0
20067,5,3,70516,70516,70519,0,3,0
20068,1,2,70517,70519,70521,2,4,0
20069,4,2,70521,70521,70523,0,2,0
20070,5,1,70526,70526,70527,0,1,3
20071,1,1,70527,70527,70528,0,1,0
20072,3,1,70530,70530,70531,0,1,2
20073,2,3,70532,70532,70535,0,3,1
20074,3,1,70535,70535,70536,0,1,0
20075,6,2,70541,70541,70543,0,2,5
20076,1,2,70542,70543,70545,1,3,0
20077,4,3,70546,70546,70549,0,3,1
20078,5,2,70551,70551,70553,0,2,2
20079,6,1,70557,70557,70558,0,1,4
20080,6,3,70563,70563,70566,0,3,5
20081,6,2,70569,70569,70571,0,2,3
20082,5,3,70574,70574,70577,0,3,3
20083,1,3,70575,70577,70580,2,5,0
20084,6,2,70581,70581,70583,0,2,1
20085,3,3,70584,70584,70587,0,3,1
20086,6,3,70590,70590,70593,0,3,3
20087,4,2,70594,70594,70596,0,2,1
20088,4,1,70598,70598,70599,0,1,2
20089,5,1,70603,70603,70604,0,1,4
20090,6,2,70609,70609,70611,0,2,5
20091,6,1,70615,70615,70616,0,1,4
20092,4,3,70619,70619,70622,0,3,3
20093,6,1,70625,70625,70626,0,1,3
20094,6,3,70631,70631,70634,0,3,5
20095,5,1,70636,70636,70637,0,1,2
20096,4,3,70640,70640,70643,0,3,3
20097,4,2,70644,70644,70646,0,2,1
20098,3,1,70647,70647,70648,0,1,1
20099,6,3,70653,70653,70656,0,3,5
20100,3,3,70656,70656,70659,0,3,0
20101,5,2,70661,70661,70663,0,2,2
20102,2,1,70663,70663,70664,0,1,0
20103,4,1,70667,70667,70668,0,1,3
20104,5,3,70672,70672,70675,0,3,4
20105,5,2,70677,70677,70679,0,2,2
20106,4,1,70681,70681,70682,0,1,2
20107,3,3,70684,70684,70687,0,3,2
20108,3,2,70687,70687,70689,0,2,0
20109,5,3,70692,70692,70695,0,3,3
20110,5,2,70697,70697,70699,0,2,2
20111,4,3,70701,70701,70704,0,3,2
20112,5,2,70706,70706,70708,0,2,2
20113,2,3,70708,70708,70711,0,3,0
20114,3,1,70711,70711,70712,0,1,0
20115,4,3,70715,70715,70718,0,3,3
20116,1,3,70716,70718,70721,2,5,0
20117,5,2,70721,70721,70723,0,2,0
20118,2,1,70723,70723,70724,0,1,0
20119,1,1,70724,70724,70725,0,1,0
20120,1,2,70725,70725,70727,0,2,0
20121,1,3,70726,70727,70730,1,4,0
20122,4,1,70730,70730,70731,0,1,0
20123,6,3,70736,70736,70739,0,3,5
20124,2,3,70738,70739,70742,1,4,0
20125,2,2,70740,70742,70744,2,4,0
20126,1,3,70741,70744,70747,3,6,0
20127,2,3,70743,70747,70750,4,7,0
20128,5,1,70748,70750,70751,2,3,0
20129,3,2,70751,70751,70753,0,2,0
20130,6,2,70757,70757,70759,0,2,4
20131,2,2,70759,70759,70761,0,2,0
20132,2,2,70761,70761,70763,0,2,0
20133,4,2,70765,70765,70767,0,2,2
20134,2,1,70767,70767,70768,0,1,0
20135,1,1,70768,70768,70769,0,1,0
20136,4,1,70772,70772,70773,0,1,3
20137,2,1,70774,70774,70775,0,1,1
20138,2,3,70776,70776,70779,0,3,1
20139,3,2,70779,70779,70781,0,2,0
20140,2,1,70781,70781,70782,0,1,0
20141,6,2,70787,70787,70789,0,2,5
20142,4,1,70791,70791,70792,0,1,2
20143,5,1,70796,70796,70797,0,1,4
20144,2,3,70798,70798,70801,0,3,1
20145,3,1,70801,70801,70802,0,1,0
20146,3,1,70804,70804,70805,0,1,2
20147,3,3,70807,70807,70810,0,3,2
20148,3,2,70810,70810,70812,0,2,0
20149,1,3,70811,70812,70815,1,4,0
20150,5,1,70816,70816,70817,0,1,1
20151,4,1,70820,70820,70821,0,1,3
20152,2,1,70822,70822,70823,0,1,1
20153,5,1,70827,70827,70828,0,1,4
20154,5,3,70832,70832,70835,0,3,4
20155,6,1,70838,70838,70839,0,1,3
20156,1,1,70839,70839,70840,0,1,0
20157,2,3,70841,70841,70844,0,3,1
20158,3,2,70844,70844,70846,0,2,0
20159,6,1,70850,70850,70851,0,1,4
20160,5,1,70855,70855,70856,0,1,4
20161,1,1,70856,70856,70857,0,1,0
20162,3,2,70859,70859,70861,0,2,2
20163,4,1,70863,70863,70864,0,1,2
20164,2,3,70865,70865,70868,0,3,1
20165,3,2,70868,70868,70870,0,2,0
20166,4,1,70872,70872,70873,0,1,2
20167,2,2,70874,70874,70876,0,2,1
20168,1,1,70875,70876,70877,1,2,0
20169,1,1,70876,70877,70878,1,2,0
20170,3,3,70879,70879,70882,0,3,1
20171,4,1,70883,70883,70884,0,1,1
20172,4,3,70887,70887,70890,0,3,3
20173,3,1,70890,70890,70891,0,1,0
20174,2,1,70892,70892,70893,0,1,1
20175,4,3,70896,70896,70899,0,3,3
20176,5,2,70901,70901,70903,0,2,2
20177,4,3,70905,70905,70908,0,3,2
20178,2,2,70907,70908,70910,1,3,0
20179,2,2,70909,70910,70912,1,3,0
20180,3,2,70912,70912,70914,0,2,0
20181,4,2,70916,70916,70918,0,2,2
20182,1,1,70917,70918,70919,1,2,0
20183,1,3,70918,70919,70922,1,4,0
20184,6,3,70924,70924,70927,0,3,2
20185,2,3,70926,70927,70930,1,4,0
20186,2,3,70928,70930,70933,2,5,0
20187,3,3,70931,70933,70936,2,5,0
20188,4,3,70935,70936,70939,1,4,0
20189,2,1,70937,70939,70940,2,3,0
20190,5,1,70942,70942,70943,0,1,2
20191,5,3,70947,70947,70950,0,3,4
20192,3,1,70950,70950,70951,0,1,0
20193,6,1,70956,70956,70957,0,1,5
20194,4,3,70960,70960,70963,0,3,3
20195,2,1,70962,70963,70964,1,2,0
20196,1,2,70963,70964,70966,1,3,0
20197,2,2,70965,70966,70968,1,3,0
20198,5,2,70970,70970,70972,0,2,2
20199,2,1,70972,70972,70973,0,1,0
20200,2,2,70974,70974,70976,0,2,1
20201,5,1,70979,70979,70980,0,1,3
20202,5,3,70984,70984,70987,0,3,4
20203,3,3,70987,70987,70990,0,3,0
20204,3,1,70990,70990,70991,0,1,0
20205,5,1,70995,70995,70996,0,1,4
20206,6,1,71001,71001,71002,0,1,5
20207,3,2,71004,71004,71006,0,2,2
20208,1,1,71005,71006,71007,1,2,0
20209,3,3,71008,71008,71011,0,3,1
20210,2,2,71010,71011,71013,1,3,0
20211,3,2,71013,71013,71015,0,2,0
20212,1,3,71014,71015,71018,1,4,0
20213,5,3,71019,71019,71022,0,3,1
20214,4,2,71023,71023,71025,0,2,1
20215,2,3,71025,71025,71028,0,3,0
20216,2,2,71027,71028,71030,1,3,0
20217,5,1,71032,71032,71033,0,1,2
20218,1,3,71033,71033,71036,0,3,0
20219,3,1,71036,71036,71037,0,1,0
20220,5,2,71041,71041,71043,0,2,4
20221,4,2,71045,71045,71047,0,2,2
20222,5,1,71050,71050,71051,0,1,3
20223,5,1,71055,71055,71056,0,1,4
20224,5,2,71060,71060,71062,0,2,4
20225,1,2,71061,71062,71064,1,3,0
20226,5,3,71066,71066,71069,0,3,2
20227,2,1,71068,71069,71070,1,2,0
20228,3,2,71071,71071,71073,0,2,1
20229,6,3,71077,71077,71080,0,3,4
20230,5,2,71082,71082,71084,0,2,2
20231,2,3,71084,71084,71087,0,3,0
20232,5,2,71089,71089,71091,0,2,2
20233,6,1,71095,71095,71096,0,1,4
20234,4,1,71099,71099,71100,0,1,3
20235,2,1,71101,71101,71102,0,1,1
20236,2,2,71103,71103,71105,0,2,1
20237,5,1,71108,71108,71109,0,1,3
20238,3,2,71111,71111,71113,0,2,2
20239,2,3,71113,71113,71116,0,3,0
20240,3,2,71116,71116,71118,0,2,0
20241,3,2,71119,71119,71121,0,2,1
20242,6,2,71125,71125,71127,0,2,4
20243,5,3,71130,71130,71133,0,3,3
20244,5,2,71135,71135,71137,0,2,2
20245,4,3,71139,71139,71142,0,3,2
20246,4,1,71143,71143,71144,0,1,1
20247,2,2,71145,71145,71147,0,2,1
20248,3,3,71148,71148,71151,0,3,1
20249,5,1,71153,71153,71154,0,1,2
20250,5,2,71158,71158,71160,0,2,4
20251,1,3,71159,71160,71163,1,4,0
20252,2,2,71161,71163,71165,2,4,0
20253,6,1,71167,71167,71168,0,1,2
20254,2,3,71169,71169,71172,0,3,1
20255,5,1,71174,71174,71175,0,1,2
20256,4,2,71178,71178,71180,0,2,3
20257,2,1,71180,71180,71181,0,1,0
20258,6,1,71186,71186,71187,0,1,5
20259,1,1,71187,71187,71188,0,1,0
20260,6,3,71193,71193,71196,0,3,5
20261,4,1,71197,71197,71198,0,1,1
20262,5,1,71202,71202,71203,0,1,4
20263,2,1,71204,71204,71205,0,1,1
20264,6,2,71210,71210,71212,0,2,5
20265,3,3,71213,71213,71216,0,3,1
20266,3,2,71216,71216,71218,0,2,0
20267,4,2,71220,71220,71222,0,2,2
20268,3,2,71223,71223,71225,0,2,1
20269,3,2,71226,71226,71228,0,2,1
20270,6,1,71232,71232,71233,0,1,4
20271,6,1,71238,71238,71239,0,1,5
20272,5,1,71243,71243,71244,0,1,4
20273,5,3,71248,71248,71251,0,3,4
20274,5,2,71253,71253,71255,0,2,2
20275,5,3,71258,71258,71261,0,3,3
20276,4,1,71262,71262,71263,0,1,1
20277,3,3,71265,71265,71268,0,3,2
20278,5,2,71270,71270,71272,0,2,2
20279,4,2,71274,71274,71276,0,2,2
20280,6,2,71280,71280,71282,0,2,4
20281,3,2,71283,71283,71285,0,2,1
20282,2,1,71285,71285,71286,0,1,0
20283,3,1,71288,71288,71289,0,1,2
20284,3,2,71291,71291,71293,0,2,2
20285,3,2,71294,71294,71296,0,2,1
20286,2,3,71296,71296,71299,0,3,0
20287,2,2,71298,71299,71301,1,3,0
20288,2,2,71300,71301,71303,1,3,0
20289,6,2,71306,71306,71308,0,2,3
20290,2,1,71308,71308,71309,0,1,0
20291,1,2,71309,71309,71311,0,2,0
20292,6,3,71315,71315,71318,0,3,4
20293,5,3,71320,71320,71323,0,3,2
20294,4,2,71324,71324,71326,0,2,1
20295,4,2,71328,71328,71330,0,2,2
20296,2,3,71330,71330,71333,0,3,0
20297,2,3,71332,71333,71336,1,4,0
20298,6,2,71338,71338,71340,0,2,2
20299,2,2,71340,71340,71342,0,2,0
20300,2,2,71342,71342,71344,0,2,0
20301,1,1,71343,71344,71345,1,2,0
20302,3,1,71346,71346,71347,0,1,1
20303,1,3,71347,71347,71350,0,3,0
20304,4,2,71351,71351,71353,0,2,1
20305,2,1,71353,71353,71354,0,1,0
20306,3,1,71356,71356,71357,0,1,2
20307,6,2,71362,71362,71364,0,2,5
20308,2,2,71364,71364,71366,0,2,0
20309,5,2,71369,71369,71371,0,2,3
20310,3,1,71372,71372,71373,0,1,1
20311,5,2,71377,71377,71379,0,2,4
20312,1,1,71378,71379,71380,1,2,0
20313,2,3,71380,71380,71383,0,3,0
20314,1,1,71381,71383,71384,2,3,0
20315,3,3,71384,71384,71387,0,3,0
20316,5,2,71389,71389,71391,0,2,2
20317,2,3,71391,71391,71394,0,3,0
20318,1,2,71392,71394,71396,2,4,0
20319,1,2,71393,71396,71398,3,5,0
20320,5,3,71398,71398,71401,0,3,0
20321,6,2,71404,71404,71406,0,2,3
20322,3,2,71407,71407,71409,0,2,1
20323,2,1,71409,71409,71410,0,1,0
20324,5,1,71414,71414,71415,0,1,4
20325,4,3,71418,71418,71421,0,3,3
20326,2,2,71420,71421,71423,1,3,0
20327,3,1,71423,71423,71424,0,1,0
20328,4,1,71427,71427,71428,0,1,3
20329,2,2,71429,71429,71431,0,2,1
20330,4,3,71433,71433,71436,0,3,2
20331,4,1,71437,71437,71438,0,1,1
20332,4,3,71441,71441,71444,0,3,3
20333,6,2,71447,71447,71449,0,2,3
20334,6,1,71453,71453,71454,0,1,4
20335,4,2,71457,71457,71459,0,2,3
20336,4,1,71461,71461,71462,0,1,2
20337,5,2,71466,71466,71468,0,2,4
20338,4,1,71470,71470,71471,0,1,2
20339,1,1,71471,71471,71472,0,1,0
20340,4,2,71475,71475,71477,0,2,3
20341,5,1,71480,71480,71481,0,1,3
20342,2,2,71482,71482,71484,0,2,1
20343,6,2,71488,71488,71490,0,2,4
20344,3,3,71491,71491,71494,0,3,1
20345,6,2,71497,71497,71499,0,2,3
20346,1,1,71498,71499,71500,1,2,0
20347,6,3,71504,71504,71507,0,3,4
20348,2,2,71506,71507,71509,1,3,0
20349,1,1,71507,71509,71510,2,3,0
20350,3,1,71510,71510,71511,0,1,0
20351,3,1,71513,71513,71514,0,1,2
20352,2,2,71515,71515,71517,0,2,1
20353,6,1,71521,71521,71522,0,1,4
20354,2,1,71523,71523,71524,0,1,1
20355,6,3,71529,71529,71532,0,3,5
20356,6,1,71535,71535,71536,0,1,3
20357,5,1,71540,71540,71541,0,1,4
20358,5,1,71545,71545,71546,0,1,4
20359,1,1,71546,71546,71547,0,1,0
20360,1,1,71547,71547,71548,0,1,0
20361,2,1,71549,71549,71550,0,1,1
20362,1,3,71550,71550,71553,0,3,0
20363,1,3,71551,71553,71556,2,5,0
20364,2,1,71553,71556,71557,3,4,0
20365,2,1,71555,71557,71558,2,3,0
20366,2,3,71557,71558,71561,1,4,0
20367,6,3,71563,71563,71566,0,3,2
20368,3,3,71566,71566,71569,0,3,0
20369,2,3,71568,71569,71572,1,4,0
20370,5,3,71573,71573,71576,0,3,1
20371,6,2,71579,71579,71581,0,2,3
20372,5,3,71584,71584,71587,0,3,3
20373,3,1,71587,71587,71588,0,1,0
20374,1,1,71588,71588,71589,0,1,0
20375,5,1,71593,71593,71594,0,1,4
20376,4,2,71597,71597,71599,0,2,3
20377,6,2,71603,71603,71605,0,2,4
20378,6,2,71609,71609,71611,0,2,4
20379,6,3,71615,71615,71618,0,3,4
20380,1,1,71616,71618,71619,2,3,0
20381,3,1,71619,71619,71620,0,1,0
20382,3,2,71622,71622,71624,0,2,2
20383,4,3,71626,71626,71629,0,3,2
20384,1,2,71627,71629,71631,2,4,0
20385,5,1,71632,71632,71633,0,1,1
20386,4,1,71636,71636,71637,0,1,3
20387,4,1,71640,71640,71641,0,1,3
20388,3,1,71643,71643,71644,0,1,2
20389,6,3,71649,71649,71652,0,3,5
20390,2,1,71651,71652,71653,1,2,0
20391,3,1,71654,71654,71655,0,1,1
20392,6,3,71660,71660,71663,0,3,5
20393,1,2,71661,71663,71665,2,4,0
20394,4,3,71665,71665,71668,0,3,0
20395,6,1,71671,71671,71672,0,1,3
20396,2,3,71673,71673,71676,0,3,1
20397,6,3,71679,71679,71682,0,3,3
20398,4,1,71683,71683,71684,0,1,1
20399,3,2,71686,71686,71688,0,2,2
20400,5,3,71691,71691,71694,0,3,3
20401,3,3,71694,71694,71697,0,3,0
20402,3,2,71697,71697,71699,0,2,0
20403,6,1,71703,71703,71704,0,1,4
20404,2,2,71705,71705,71707,0,2,1
20405,1,3,71706,71707,71710,1,4,0
20406,1,3,71707,71710,71713,3,6,0
20407,2,1,71709,71713,71714,4,5,0
20408,3,1,71712,71714,71715,2,3,0
20409,3,1,71715,71715,71716,0,1,0
20410,2,1,71717,71717,71718,0,1,1
20411,6,1,71723,71723,71724,0,1,5
20412,4,3,71727,71727,71730,0,3,3
20413,1,1,71728,71730,71731,2,3,0
20414,5,1,71733,71733,71734,0,1,2
20415,5,1,71738,71738,71739,0,1,4
20416,4,1,71742,71742,71743,0,1,3
20417,3,2,71745,71745,71747,0,2,2
20418,3,3,71748,71748,71751,0,3,1
20419,5,3,71753,71753,71756,0,3,2
20420,3,3,71756,71756,71759,0,3,0
20421,6,3,71762,71762,71765,0,3,3
20422,6,3,71768,71768,71771,0,3,3
20423,5,3,71773,71773,71776,0,3,2
20424,5,1,71778,71778,71779,0,1,2
20425,3,2,71781,71781,71783,0,2,2
20426,1,3,71782,71783,71786,1,4,0
20427,5,2,71787,71787,71789,0,2,1
20428,5,1,71792,71792,71793,0,1,3
20429,2,1,71794,71794,71795,0,1,1
20430,4,1,71798,71798,71799,0,1,3
20431,3,3,71801,71801,71804,0,3,2
20432,2,3,71803,71804,71807,1,4,0
20433,5,1,71808,71808,71809,0,1,1
20434,5,1,71813,71813,71814,0,1,4
20435,1,1,71814,71814,71815,0,1,0
20436,3,3,71817,71817,71820,0,3,2
20437,5,1,71822,71822,71823,0,1,2
20438,2,2,71824,71824,71826,0,2,1
20439,2,3,71826,71826,71829,0,3,0
20440,2,1,71828,71829,71830,1,2,0
20441,1,1,71829,71830,71831,1,2,0
20442,6,2,71835,71835,71837,0,2,4
20443,1,3,71836,71837,71840,1,4,0
20444,1,2,71837,71840,71842,3,5,0
20445,6,2,71843,71843,71845,0,2,1
20446,6,1,71849,71849,71850,0,1,4
20447,2,3,71851,71851,71854,0,3,1
20448,5,1,71856,71856,71857,0,1,2
20449,4,3,71860,71860,71863,0,3,3
20450,3,2,71863,71863,71865,0,2,0
20451,1,3,71864,71865,71868,1,4,0
20452,5,3,71869,71869,71872,0,3,1
20453,4,2,71873,71873,71875,0,2,1
20454,4,1,71877,71877,71878,0,1,2
20455,2,2,71879,71879,71881,0,2,1
20456,1,1,71880,71881,71882,1,2,0
20457,3,2,71883,71883,71885,0,2,1
20458,2,2,71885,71885,71887,0,2,0
20459,3,2,71888,71888,71890,0,2,1
20460,2,1,71890,71890,71891,0,1,0
20461,5,1,71895,71895,71896,0,1,4
20462,5,3,71900,71900,71903,0,3,4
20463,3,3,71903,71903,71906,0,3,0
20464,3,2,71906,71906,71908,0,2,0
20465,6,3,71912,71912,71915,0,3,4
20466,4,2,71916,71916,71918,0,2,1
20467,2,2,71918,71918,71920,0,2,0
20468,2,1,71920,71920,71921,0,1,0
20469,1,3,71921,71921,71924,0,3,0
20470,6,2,71927,71927,71929,0,2,3
20471,4,3,71931,71931,71934,0,3,2
20472,6,1,71937,71937,71938,0,1,3
20473,5,2,71942,71942,71944,0,2,4
20474,4,3,71946,71946,71949,0,3,2
20475,4,3,71950,71950,71953,0,3,1
20476,4,2,71954,71954,71956,0,2,1
20477,5,1,71959,71959,71960,0,1,3
20478,1,2,71960,71960,71962,0,2,0
20479,4,2,71964,71964,71966,0,2,2
20480,2,2,71966,71966,71968,0,2,0
20481,4,3,71970,71970,71973,0,3,2
20482,2,2,71972,71973,71975,1,3,0
20483,5,3,71977,71977,71980,0,3,2
20484,6,1,71983,71983,71984,0,1,3
20485,6,2,71989,71989,71991,0,2,5
20486,6,2,71995,71995,71997,0,2,4
20487,6,1,72001,72001,72002,0,1,4
20488,4,2,72005,72005,72007,0,2,3
20489,5,2,72010,72010,72012,0,2,3
20490,6,1,72016,72016,72017,0,1,4
20491,4,3,72020,72020,72023,0,3,3
20492,6,3,72026,72026,72029,0,3,3
20493,2,2,72028,72029,72031,1,3,0
20494,6,2,72034,72034,72036,0,2,3
20495,5,3,72039,72039,72042,0,3,3
20496,1,2,72040,72042,72044,2,4,0
20497,6,3,72046,72046,72049,0,3,2
20498,1,3,72047,72049,72052,2,5,0
20499,6,1,72053,72053,72054,0,1,1
20500,4,2,72057,72057,72059,0,2,3
20501,6,3,72063,72063,72066,0,3,4
20502,1,3,72064,72066,72069,2,5,0
20503,6,1,72070,72070,72071,0,1,1
20504,2,3,72072,72072,72075,0,3,1
20505,4,1,72076,72076,72077,0,1,1
20506,4,3,72080,72080,72083,0,3,3
20507,6,2,72086,72086,72088,0,2,3
20508,2,1,72088,72088,72089,0,1,0
20509,5,1,72093,72093,72094,0,1,4
20510,2,2,72095,72095,72097,0,2,1
20511,6,1,72101,72101,72102,0,1,4
20512,3,2,72104,72104,72106,0,2,2
20513,5,1,72109,72109,72110,0,1,3
20514,5,1,72114,72114,72115,0,1,4
20515,4,2,72118,72118,72120,0,2,3
20516,6,1,72124,72124,72125,0,1,4
20517,3,1,72127,72127,72128,0,1,2
20518,4,3,72131,72131,72134,0,3,3
20519,5,3,72136,72136,72139,0,3,2
20520,2,1,72138,72139,72140,1,2,0
20521,5,1,72143,72143,72144,0,1,3
20522,5,3,72148,72148,72151,0,3,4
20523,2,1,72150,72151,72152,1,2,0
20524,3,3,72153,72153,72156,0,3,1
20525,2,3,72155,72156,72159,1,4,0
20526,3,3,72158,72159,72162,1,4,0
20527,6,3,72164,72164,72167,0,3,2
20528,6,2,72170,72170,72172,0,2,3
20529,1,2,72171,72172,72174,1,3,0
20530,2,2,72173,72174,72176,1,3,0
20531,6,3,72179,72179,72182,0,3,3
20532,6,2,72185,72185,72187,0,2,3
20533,1,2,72186,72187,72189,1,3,0
20534,5,1,72191,72191,72192,0,1,2
20535,4,1,72195,72195,72196,0,1,3
20536,4,1,72199,72199,72200,0,1,3
20537,5,2,72204,72204,72206,0,2,4
20538,5,3,72209,72209,72212,0,3,3
20539,6,1,72215,72215,72216,0,1,3
20540,3,3,72218,72218,72221,0,3,2
20541,2,1,72220,72221,72222,1,2,0
20542,4,1,72224,72224,72225,0,1,2
20543,3,2,72227,72227,72229,0,2,2
20544,4,2,72231,72231,72233,0,2,2
20545,1,1,72232,72233,72234,1,2,0
20546,2,1,72234,72234,72235,0,1,0
20547,4,3,72238,72238,72241,0,3,3
20548,5,1,72243,72243,72244,0,1,2
20549,4,1,72247,72247,72248,0,1,3
20550,2,3,72249,72249,72252,0,3,1
20551,6,1,72255,72255,72256,0,1,3
20552,5,2,72260,72260,72262,0,2,4
20553,1,2,72261,72262,72264,1,3,0
20554,3,3,72264,72264,72267,0,3,0
20555,6,3,72270,72270,72273,0,3,3
20556,5,2,72275,72275,72277,0,2,2
20557,3,3,72278,72278,72281,0,3,1
20558,5,1,72283,72283,72284,0,1,2
20559,4,3,72287,72287,72290,0,3,3
20560,2,2,72289,72290,72292,1,3,0
20561,6,1,72295,72295,72296,0,1,3
20562,5,3,72300,72300,72303,0,3,4
20563,5,2,72305,72305,72307,0,2,2
20564,5,1,72310,72310,72311,0,1,3
20565,4,1,72314,72314,72315,0,1,3
20566,5,3,72319,72319,72322,0,3,4
20567,5,3,72324,72324,72327,0,3,2
20568,1,1,72325,72327,72328,2,3,0
20569,1,2,72326,72328,72330,2,4,0
20570,6,3,72332,72332,72335,0,3,2
20571,5,3,72337,72337,72340,0,3,2
20572,4,1,72341,72341,72342,0,1,1
20573,5,2,72346,72346,72348,0,2,4
20574,5,3,72351,72351,72354,0,3,3
20575,6,1,72357,72357,72358,0,1,3
20576,5,3,72362,72362,72365,0,3,4
20577,3,1,72365,72365,72366,0,1,0
20578,3,1,72368,72368,72369,0,1,2
20579,4,3,72372,72372,72375,0,3,3
20580,5,3,72377,72377,72380,0,3,2
20581,3,3,72380,72380,72383,0,3,0
20582,6,3,72386,72386,72389,0,3,3
20583,4,2,72390,72390,72392,0,2,1
20584,6,2,72396,72396,72398,0,2,4
20585,2,2,72398,72398,72400,0,2,0
20586,2,3,72400,72400,72403,0,3,0
20587,1,1,72401,72403,72404,2,3,0
20588,4,1,72405,72405,72406,0,1,1
20589,6,3,72411,72411,72414,0,3,5
20590,4,2,72415,72415,72417,0,2,1
20591,6,2,72421,72421,72423,0,2,4
20592,6,1,72427,72427,72428,0,1,4
20593,2,3,72429,72429,72432,0,3,1
20594,2,2,72431,72432,72434,1,3,0
20595,3,1,72434,72434,72435,0,1,0
20596,2,2,72436,72436,72438,0,2,1
20597,1,3,72437,72438,72441,1,4,0
20598,2,1,72439,72441,72442,2,3,0
20599,2,2,72441,72442,72444,1,3,0
20600,6,2,72447,72447,72449,0,2,3
20601,3,2,72450,72450,72452,0,2,1
20602,5,2,72455,72455,72457,0,2,3
20603,6,2,72461,72461,72463,0,2,4
20604,2,2,72463,72463,72465,0,2,0
20605,4,1,72467,72467,72468,0,1,2
20606,5,1,72472,72472,72473,0,1,4
20607,3,3,72475,72475,72478,0,3,2
20608,5,2,72480,72480,72482,0,2,2
20609,3,3,72483,72483,72486,0,3,1
20610,1,1,72484,72486,72487,2,3,0
20611,3,3,72487,72487,72490,0,3,0
20612,4,3,72491,72491,72494,0,3,1
20613,5,3,72496,72496,72499,0,3,2
20614,3,2,72499,72499,72501,0,2,0
20615,3,3,72502,72502,72505,0,3,1
20616,6,1,72508,72508,72509,0,1,3
20617,6,2,72514,72514,72516,0,2,5
20618,3,3,72517,72517,72520,0,3,1
20619,5,3,72522,72522,72525,0,3,2
20620,6,3,72528,72528,72531,0,3,3
20621,2,3,72530,72531,72534,1,4,0
20622,1,3,72531,72534,72537,3,6,0
20623,5,2,72536,72537,72539,1,3,0
20624,3,2,72539,72539,72541,0,2,0
20625,3,2,72542,72542,72544,0,2,1
20626,2,2,72544,72544,72546,0,2,0
20627,4,1,72548,72548,72549,0,1,2
20628,4,3,72552,72552,72555,0,3,3
20629,4,2,72556,72556,72558,0,2,1
20630,3,1,72559,72559,72560,0,1,1
20631,5,3,72564,72564,72567,0,3,4
20632,4,3,72568,72568,72571,0,3,1
20633,3,3,72571,72571,72574,0,3,0
20634,2,1,72573,72574,72575,1,2,0
20635,4,3,72577,72577,72580,0,3,2
20636,3,1,72580,72580,72581,0,1,0
20637,2,2,72582,72582,72584,0,2,1
20638,5,2,72587,72587,72589,0,2,3
20639,4,2,72591,72591,72593,0,2,2
20640,3,1,72594,72594,72595,0,1,1
20641,3,1,72597,72597,72598,0,1,2
20642,4,3,72601,72601,72604,0,3,3
20643,6,3,72607,72607,72610,0,3,3
20644,1,1,72608,72610,72611,2,3,0
20645,4,3,72612,72612,72615,0,3,1
20646,5,2,72617,72617,72619,0,2,2
20647,3,1,72620,72620,72621,0,1,1
20648,5,3,72625,72625,72628,0,3,4
20649,2,2,72627,72628,72630,1,3,0
20650,1,3,72628,72630,72633,2,5,0
20651,1,1,72629,72633,72634,4,5,0
20652,1,3,72630,72634,72637,4,7,0
20653,3,2,72633,72637,72639,4,6,0
20654,5,2,72638,72639,72641,1,3,0
20655,2,3,72640,72641,72644,1,4,0
20656,5,1,72645,72645,72646,0,1,1
20657,6,2,72651,72651,72653,0,2,5
20658,1,1,72652,72653,72654,1,2,0
20659,1,1,72653,72654,72655,1,2,0
20660,2,2,72655,72655,72657,0,2,0
20661,1,2,72656,72657,72659,1,3,0
20662,6,2,72662,72662,72664,0,2,3
20663,6,2,72668,72668,72670,0,2,4
20664,6,2,72674,72674,72676,0,2,4
20665,3,3,72677,72677,72680,0,3,1
20666,2,3,72679,72680,72683,1,4,0
20667,3,2,72682,72683,72685,1,3,0
20668,4,3,72686,72686,72689,0,3,1
20669,1,1,72687,72689,72690,2,3,0
20670,6,3,72693,72693,72696,0,3,3
20671,3,1,72696,72696,72697,0,1,0
20672,3,2,72699,72699,72701,0,2,2
20673,5,1,72704,72704,72705,0,1,3
20674,2,2,72706,72706,72708,0,2,1
20675,5,2,72711,72711,72713,0,2,3
20676,4,3,72715,72715,72718,0,3,2
20677,2,1,72717,72718,72719,1,2,0
20678,3,2,72720,72720,72722,0,2,1
20679,1,1,72721,72722,72723,1,2,0
20680,3,3,72724,72724,72727,0,3,1
20681,6,2,72730,72730,72732,0,2,3
20682,4,1,72734,72734,72735,0,1,2
20683,2,2,72736,72736,72738,0,2,1
20684,5,2,72741,72741,72743,0,2,3
20685,3,2,72744,72744,72746,0,2,1
20686,5,3,72749,72749,72752,0,3,3
20687,2,1,72751,72752,72753,1,2,0
20688,5,3,72756,72756,72759,0,3,3
20689,1,2,72757,72759,72761,2,4,0
20690,5,2,72762,72762,72764,0,2,1
20691,3,1,72765,72765,72766,0,1,1
20692,1,2,72766,72766,72768,0,2,0
20693,4,3,72770,72770,72773,0,3,2
20694,1,2,72771,72773,72775,2,4,0
20695,3,1,72774,72775,72776,1,2,0
20696,5,2,72779,72779,72781,0,2,3
20697,6,2,72785,72785,72787,0,2,4
20698,1,3,72786,72787,72790,1,4,0
20699,2,1,72788,72790,72791,2,3,0
20700,6,1,72794,72794,72795,0,1,3
20701,6,1,72800,72800,72801,0,1,5
20702,1,1,72801,72801,72802,0,1,0
20703,6,2,72807,72807,72809,0,2,5
20704,1,3,72808,72809,72812,1,4,0
20705,4,2,72812,72812,72814,0,2,0
20706,6,3,72818,72818,72821,0,3,4
20707,4,1,72822,72822,72823,0,1,1
20708,1,1,72823,72823,72824,0,1,0
20709,3,2,72826,72826,72828,0,2,2
20710,1,1,72827,72828,72829,1,2,0
20711,6,3,72833,72833,72836,0,3,4
20712,3,1,72836,72836,72837,0,1,0
20713,2,3,72838,72838,72841,0,3,1
20714,1,1,72839,72841,72842,2,3,0
20715,6,1,72845,72845,72846,0,1,3
20716,2,2,72847,72847,72849,0,2,1
20717,4,1,72851,72851,72852,0,1,2
20718,3,2,72854,72854,72856,0,2,2
20719,1,3,72855,72856,72859,1,4,0
20720,6,3,72861,72861,72864,0,3,2
20721,1,1,72862,72864,72865,2,3,0
20722,6,2,72868,72868,72870,0,2,3
20723,3,3,72871,72871,72874,0,3,1
20724,5,3,72876,72876,72879,0,3,2
20725,4,2,72880,72880,72882,0,2,1
20726,3,3,72883,72883,72886,0,3,1
20727,2,2,72885,72886,72888,1,3,0
20728,6,2,72891,72891,72893,0,2,3
20729,5,2,72896,72896,72898,0,2,3
20730,3,1,72899,72899,72900,0,1,1
20731,2,2,72901,72901,72903,0,2,1
20732,3,2,72904,72904,72906,0,2,1
20733,6,1,72910,72910,72911,0,1,4
20734,5,3,72915,72915,72918,0,3,4
20735,2,2,72917,72918,72920,1,3,0
20736,2,1,72919,72920,72921,1,2,0
20737,3,2,72922,72922,72924,0,2,1
20738,4,1,72926,72926,72927,0,1,2
20739,6,1,72932,72932,72933,0,1,5
20740,6,3,72938,72938,72941,0,3,5
20741,5,1,72943,72943,72944,0,1,2
20742,4,3,72947,72947,72950,0,3,3
20743,4,1,72951,72951,72952,0,1,1
20744,1,3,72952,72952,72955,0,3,0
20745,3,1,72955,72955,72956,0,1,0
20746,1,2,72956,72956,72958,0,2,0
20747,3,2,72959,72959,72961,0,2,1
20748,5,3,72964,72964,72967,0,3,3
20749,4,1,72968,72968,72969,0,1,1
20750,2,2,72970,72970,72972,0,2,1
20751,6,3,72976,72976,72979,0,3,4
20752,6,3,72982,72982,72985,0,3,3
20753,2,3,72984,72985,72988,1,4,0
20754,2,3,72986,72988,72991,2,5,0
20755,4,3,72990,72991,72994,1,4,0
20756,1,1,72991,72994,72995,3,4,0
20757,6,2,72997,72997,72999,0,2,2
20758,2,2,72999,72999,73001,0,2,0
20759,1,1,73000,73001,73002,1,2,0
20760,2,3,73002,73002,73005,0,3,0
20761,6,2,73008,73008,73010,0,2,3
20762,1,2,73009,73010,73012,1,3,0
20763,1,3,73010,73012,73015,2,5,0
20764,3,2,73013,73015,73017,2,4,0
20765,2,3,73015,73017,73020,2,5,0
20766,5,1,73020,73020,73021,0,1,0
20767,6,3,73026,73026,73029,0,3,5
20768,6,3,73032,73032,73035,0,3,3
20769,3,1,73035,73035,73036,0,1,0
20770,6,1,73041,73041,73042,0,1,5
20771,1,2,73042,73042,73044,0,2,0
20772,4,3,73046,73046,73049,0,3,2
20773,3,3,73049,73049,73052,0,3,0
20774,5,2,73054,73054,73056,0,2,2
20775,6,1,73060,73060,73061,0,1,4
20776,2,3,73062,73062,73065,0,3,1
20777,3,2,73065,73065,73067,0,2,0
20778,2,3,73067,73067,73070,0,3,0
20779,5,1,73072,73072,73073,0,1,2
20780,4,1,73076,73076,73077,0,1,3
20781,4,3,73080,73080,73083,0,3,3
20782,3,2,73083,73083,73085,0,2,0
20783,5,2,73088,73088,73090,0,2,3
20784,6,3,73094,73094,73097,0,3,4
20785,5,3,73099,73099,73102,0,3,2
20786,6,1,73105,73105,73106,0,1,3
20787,3,3,73108,73108,73111,0,3,2
20788,3,1,73111,73111,73112,0,1,0
20789,2,1,73113,73113,73114,0,1,1
20790,3,2,73116,73116,73118,0,2,2
20791,2,3,73118,73118,73121,0,3,0
20792,1,1,73119,73121,73122,2,3,0
20793,4,2,73123,73123,73125,0,2,1
20794,6,3,73129,73129,73132,0,3,4
20795,5,2,73134,73134,73136,0,2,2
20796,5,2,73139,73139,73141,0,2,3
20797,3,2,73142,73142,73144,0,2,1
20798,4,1,73146,73146,73147,0,1,2
20799,1,1,73147,73147,73148,0,1,0
20800,2,2,73149,73149,73151,0,2,1
20801,6,2,73155,73155,73157,0,2,4
20802,3,3,73158,73158,73161,0,3,1
20803,3,3,73161,73161,73164,0,3,0
20804,3,1,73164,73164,73165,0,1,0
20805,6,2,73170,73170,73172,0,2,5
20806,2,3,73172,73172,73175,0,3,0
20807,4,2,73176,73176,73178,0,2,1
20808,6,3,73182,73182,73185,0,3,4
20809,1,3,73183,73185,73188,2,5,0
20810,3,1,73186,73188,73189,2,3,0
20811,4,3,73190,73190,73193,0,3,1
20812,1,1,73191,73193,73194,2,3,0
20813,5,3,73196,73196,73199,0,3,2
20814,1,2,73197,73199,73201,2,4,0
20815,2,3,73199,73201,73204,2,5,0
20816,4,3,73203,73204,73207,1,4,0
20817,3,1,73206,73207,73208,1,2,0
20818,4,3,73210,73210,73213,0,3,2
20819,6,1,73216,73216,73217,0,1,3
20820,4,2,73220,73220,73222,0,2,3
20821,1,2,73221,73222,73224,1,3,0
20822,2,3,73223,73224,73227,1,4,0
20823,3,2,73226,73227,73229,1,3,0
20824,4,3,73230,73230,73233,0,3,1
20825,5,1,73235,73235,73236,0,1,2
20826,3,1,73238,73238,73239,0,1,2
20827,4,1,73242,73242,73243,0,1,3
20828,2,2,73244,73244,73246,0,2,1
20829,2,2,73246,73246,73248,0,2,0
20830,1,1,73247,73248,73249,1,2,0
20831,4,3,73251,73251,73254,0,3,2
20832,5,2,73256,73256,73258,0,2,2
20833,4,2,73260,73260,73262,0,2,2
20834,6,3,73266,73266,73269,0,3,4
20835,1,2,73267,73269,73271,2,4,0
20836,4,3,73271,73271,73274,0,3,0
20837,3,1,73274,73274,73275,0,1,0
20838,2,3,73276,73276,73279,0,3,1
20839,5,2,73281,73281,73283,0,2,2
20840,5,2,73286,73286,73288,0,2,3
20841,1,3,73287,73288,73291,1,4,0
20842,3,2,73290,73291,73293,1,3,0
20843,3,2,73293,73293,73295,0,2,0
20844,3,1,73296,73296,73297,0,1,1
20845,4,3,73300,73300,73303,0,3,3
20846,3,3,73303,73303,73306,0,3,0
20847,1,2,73304,73306,73308,2,4,0
20848,3,1,73307,73308,73309,1,2,0
20849,5,3,73312,73312,73315,0,3,3
20850,6,1,73318,73318,73319,0,1,3
20851,5,1,73323,73323,73324,0,1,4
20852,5,1,73328,73328,73329,0,1,4
20853,3,3,73331,73331,73334,0,3,2
20854,1,3,73332,73334,73337,2,5,0
20855,4,2,73336,73337,73339,1,3,0
20856,3,1,73339,73339,73340,0,1,0
20857,5,3,73344,73344,73347,0,3,4
20858,5,3,73349,73349,73352,0,3,2
20859,3,1,73352,73352,73353,0,1,0
20860,5,3,73357,73357,73360,0,3,4
20861,1,1,73358,73360,73361,2,3,0
20862,5,1,73363,73363,73364,0,1,2
20863,4,1,73367,73367,73368,0,1,3
20864,1,1,73368,73368,73369,0,1,0
20865,1,2,73369,73369,73371,0,2,0
20866,1,3,73370,73371,73374,1,4,0
20867,1,2,73371,73374,73376,3,5,0
20868,5,3,73376,73376,73379,0,3,0
20869,2,2,73378,73379,73381,1,3,0
20870,1,1,73379,73381,73382,2,3,0
20871,3,1,73382,73382,73383,0,1,0
20872,1,1,73383,73383,73384,0,1,0
20873,2,3,73385,73385,73388,0,3,1
20874,5,1,73390,73390,73391,0,1,2
20875,5,1,73395,73395,73396,0,1,4
20876,6,1,73401,73401,73402,0,1,5
20877,1,2,73402,73402,73404,0,2,0
20878,6,2,73408,73408,73410,0,2,4
20879,1,3,73409,73410,73413,1,4,0
20880,6,2,73415,73415,73417,0,2,2
20881,2,3,73417,73417,73420,0,3,0
20882,4,3,73421,73421,73424,0,3,1
20883,1,3,73422,73424,73427,2,5,0
20884,3,3,73425,73427,73430,2,5,0
20885,3,1,73428,73430,73431,2,3,0
20886,5,3,73433,73433,73436,0,3,2
20887,6,2,73439,73439,73441,0,2,3
20888,1,2,73440,73441,73443,1,3,0
20889,2,3,73442,73443,73446,1,4,0
20890,1,1,73443,73446,73447,3,4,0
20891,4,3,73447,73447,73450,0,3,0
20892,1,1,73448,73450,73451,2,3,0
20893,1,1,73449,73451,73452,2,3,0
20894,5,1,73454,73454,73455,0,1,2
20895,4,3,73458,73458,73461,0,3,3
20896,6,1,73464,73464,73465,0,1,3
20897,1,1,73465,73465,73466,0,1,0
20898,5,3,73470,73470,73473,0,3,4
20899,5,3,73475,73475,73478,0,3,2
20900,5,1,73480,73480,73481,0,1,2
20901,4,1,73484,73484,73485,0,1,3
20902,3,2,73487,73487,73489,0,2,2
20903,6,3,73493,73493,73496,0,3,4
20904,1,2,73494,73496,73498,2,4,0
20905,3,1,73497,73498,73499,1,2,0
20906,2,2,73499,73499,73501,0,2,0
20907,6,1,73505,73505,73506,0,1,4
20908,2,3,73507,73507,73510,0,3,1
20909,4,1,73511,73511,73512,0,1,1
20910,4,3,73515,73515,73518,0,3,3
20911,5,2,73520,73520,73522,0,2,2
20912,6,1,73526,73526,73527,0,1,4
20913,2,1,73528,73528,73529,0,1,1
20914,5,2,73533,73533,73535,0,2,4
20915,2,3,73535,73535,73538,0,3,0
20916,1,1,73536,73538,73539,2,3,0
20917,4,2,73540,73540,73542,0,2,1
20918,3,1,73543,73543,73544,0,1,1
20919,1,2,73544,73544,73546,0,2,0
20920,2,3,73546,73546,73549,0,3,0
20921,3,3,73549,73549,73552,0,3,0
20922,4,3,73553,73553,73556,0,3,1
20923,1,3,73554,73556,73559,2,5,0
20924,6,3,73560,73560,73563,0,3,1
20925,1,2,73561,73563,73565,2,4,0
20926,6,3,73567,73567,73570,0,3,2
20927,3,1,73570,73570,73571,0,1,0
20928,6,3,73576,73576,73579,0,3,5
20929,6,3,73582,73582,73585,0,3,3
20930,6,3,73588,73588,73591,0,3,3
20931,6,2,73594,73594,73596,0,2,3
20932,1,1,73595,73596,73597,1,2,0
20933,3,2,73598,73598,73600,0,2,1
20934,5,1,73603,73603,73604,0,1,3
20935,5,3,73608,73608,73611,0,3,4
20936,3,2,73611,73611,73613,0,2,0
20937,6,1,73617,73617,73618,0,1,4
20938,3,1,73620,73620,73621,0,1,2
20939,6,1,73626,73626,73627,0,1,5
20940,3,2,73629,73629,73631,0,2,2
20941,6,2,73635,73635,73637,0,2,4
20942,3,1,73638,73638,73639,0,1,1
20943,6,1,73644,73644,73645,0,1,5
20944,2,1,73646,73646,73647,0,1,1
20945,1,3,73647,73647,73650,0,3,0
20946,5,1,73652,73652,73653,0,1,2
20947,4,2,73656,73656,73658,0,2,3
20948,2,1,73658,73658,73659,0,1,0
20949,3,1,73661,73661,73662,0,1,2
20950,3,1,73664,73664,73665,0,1,2
20951,6,1,73670,73670,73671,0,1,5
20952,6,2,73676,73676,73678,0,2,5
20953,2,3,73678,73678,73681,0,3,0
20954,2,1,73680,73681,73682,1,2,0
20955,2,3,73682,73682,73685,0,3,0
20956,1,3,73683,73685,73688,2,5,0
20957,2,1,73685,73688,73689,3,4,0
20958,4,2,73689,73689,73691,0,2,0
20959,3,2,73692,73692,73694,0,2,1
20960,3,2,73695,73695,73697,0,2,1
20961,4,2,73699,73699,73701,0,2,2
20962,4,2,73703,73703,73705,0,2,2
20963,6,3,73709,73709,73712,0,3,4
20964,5,2,73714,73714,73716,0,2,2
20965,2,3,73716,73716,73719,0,3,0
20966,6,1,73722,73722,73723,0,1,3
20967,5,2,73727,73727,73729,0,2,4
20968,3,2,73730,73730,73732,0,2,1
20969,2,1,73732,73732,73733,0,1,0
20970,3,2,73735,73735,73737,0,2,2
20971,4,2,73739,73739,73741,0,2,2
20972,3,2,73742,73742,73744,0,2,1
20973,4,3,73746,73746,73749,0,3,2
20974,6,2,73752,73752,73754,0,2,3
20975,2,1,73754,73754,73755,0,1,0
20976,1,3,73755,73755,73758,0,3,0
20977,1,2,73756,73758,73760,2,4,0
20978,1,1,73757,73760,73761,3,4,0
20979,2,2,73759,73761,73763,2,4,0
20980,3,3,73762,73763,73766,1,4,0
20981,2,1,73764,73766,73767,2,3,0
20982,1,2,73765,73767,73769,2,4,0
20983,4,1,73769,73769,73770,0,1,0
20984,2,1,73771,73771,73772,0,1,1
20985,3,3,73774,73774,73777,0,3,2
20986,5,1,73779,73779,73780,0,1,2
20987,4,1,73783,73783,73784,0,1,3
20988,2,3,73785,73785,73788,0,3,1
20989,3,1,73788,73788,73789,0,1,0
20990,6,3,73794,73794,73797,0,3,5
20991,2,3,73796,73797,73800,1,4,0
20992,5,3,73801,73801,73804,0,3,1
20993,2,3,73803,73804,73807,1,4,0
20994,3,3,73806,73807,73810,1,4,0
20995,3,2,73809,73810,73812,1,3,0
20996,4,2,73813,73813,73815,0,2,1
20997,4,1,73817,73817,73818,0,1,2
20998,5,2,73822,73822,73824,0,2,4
20999,6,3,73828,73828,73831,0,3,4
21000,4,1,73832,73832,73833,0,1,1
21001,5,3,73837,73837,73840,0,3,4
21002,6,1,73843,73843,73844,0,1,3
21003,4,1,73847,73847,73848,0,1,3
21004,6,1,73853,73853,73854,0,1,5
21005,2,1,73855,73855,73856,0,1,1
21006,6,1,73861,73861,73862,0,1,5
21007,5,1,73866,73866,73867,0,1,4
21008,1,2,73867,73867,73869,0,2,0
21009,3,3,73870,73870,73873,0,3,1
21010,6,1,73876,73876,73877,0,1,3
21011,2,2,73878,73878,73880,0,2,1
21012,2,3,73880,73880,73883,0,3,0
21013,5,3,73885,73885,73888,0,3,2
21014,6,2,73891,73891,73893,0,2,3
21015,5,2,73896,73896,73898,0,2,3
21016,4,2,73900,73900,73902,0,2,2
21017,2,3,73902,73902,73905,0,3,0
21018,1,1,73903,73905,73906,2,3,0
21019,1,1,73904,73906,73907,2,3,0
21020,3,1,73907,73907,73908,0,1,0
21021,1,2,73908,73908,73910,0,2,0
21022,4,1,73912,73912,73913,0,1,2
21023,3,3,73915,73915,73918,0,3,2
21024,4,1,73919,73919,73920,0,1,1
21025,4,2,73923,73923,73925,0,2,3
21026,6,1,73929,73929,73930,0,1,4
21027,3,3,73932,73932,73935,0,3,2
21028,2,3,73934,73935,73938,1,4,0
21029,6,2,73940,73940,73942,0,2,2
21030,4,2,73944,73944,73946,0,2,2
21031,2,3,73946,73946,73949,0,3,0
21032,6,1,73952,73952,73953,0,1,3
21033,4,2,73956,73956,73958,0,2,3
21034,5,3,73961,73961,73964,0,3,3
21035,3,2,73964,73964,73966,0,2,0
21036,1,3,73965,73966,73969,1,4,0
21037,5,3,73970,73970,73973,0,3,1
21038,3,1,73973,73973,73974,0,1,0
21039,4,3,73977,73977,73980,0,3,3
21040,6,2,73983,73983,73985,0,2,3
21041,2,3,73985,73985,73988,0,3,0
21042,3,3,73988,73988,73991,0,3,0
21043,2,1,73990,73991,73992,1,2,0
21044,6,2,73996,73996,73998,0,2,4
21045,2,3,73998,73998,74001,0,3,0
21046,2,2,74000,74001,74003,1,3,0
21047,5,2,74005,74005,74007,0,2,2
21048,3,3,74008,74008,74011,0,3,1
21049,1,1,74009,74011,74012,2,3,0
21050,2,3,74011,74012,74015,1,4,0
21051,5,3,74016,74016,74019,0,3,1
21052,3,3,74019,74019,74022,0,3,0
21053,1,3,74020,74022,74025,2,5,0
21054,3,2,74023,74025,74027,2,4,0
21055,5,3,74028,74028,74031,0,3,1
21056,4,3,74032,74032,74035,0,3,1
21057,6,1,74038,74038,74039,0,1,3
21058,6,2,74044,74044,74046,0,2,5
21059,5,2,74049,74049,74051,0,2,3
21060,1,1,74050,74051,74052,1,2,0
21061,2,2,74052,74052,74054,0,2,0
21062,2,1,74054,74054,74055,0,1,0
21063,1,3,74055,74055,74058,0,3,0
21064,6,1,74061,74061,74062,0,1,3
21065,5,3,74066,74066,74069,0,3,4
21066,2,3,74068,74069,74072,1,4,0
21067,5,2,74073,74073,74075,0,2,1
21068,6,1,74079,74079,74080,0,1,4
21069,1,3,74080,74080,74083,0,3,0
21070,5,3,74085,74085,74088,0,3,2
21071,1,3,74086,74088,74091,2,5,0
21072,6,2,74092,74092,74094,0,2,1
21073,4,2,74096,74096,74098,0,2,2
21074,2,3,74098,74098,74101,0,3,0
21075,6,2,74104,74104,74106,0,2,3
21076,4,2,74108,74108,74110,0,2,2
21077,4,3,74112,74112,74115,0,3,2
21078,3,1,74115,74115,74116,0,1,0
21079,5,2,74120,74120,74122,0,2,4
21080,4,1,74124,74124,74125,0,1,2
21081,4,3,74128,74128,74131,0,3,3
21082,1,2,74129,74131,74133,2,4,0
21083,1,3,74130,74133,74136,3,6,0
21084,6,1,74136,74136,74137,0,1,0
21085,6,2,74142,74142,74144,0,2,5
21086,5,3,74147,74147,74150,0,3,3
21087,6,3,74153,74153,74156,0,3,3
21088,5,1,74158,74158,74159,0,1,2
21089,1,3,74159,74159,74162,0,3,0
21090,6,3,74165,74165,74168,0,3,3
21091,3,2,74168,74168,74170,0,2,0
21092,2,3,74170,74170,74173,0,3,0
21093,4,3,74174,74174,74177,0,3,1
21094,1,1,74175,74177,74178,2,3,0
21095,3,2,74178,74178,74180,0,2,0
21096,2,3,74180,74180,74183,0,3,0
21097,3,3,74183,74183,74186,0,3,0
21098,6,3,74189,74189,74192,0,3,3
21099,6,1,74195,74195,74196,0,1,3
21100,5,1,74200,74200,74201,0,1,4
21101,4,2,74204,74204,74206,0,2,3
21102,2,1,74206,74206,74207,0,1,0
21103,1,3,74207,74207,74210,0,3,0
21104,6,3,74213,74213,74216,0,3,3
21105,3,2,74216,74216,74218,0,2,0
21106,6,2,74222,74222,74224,0,2,4
21107,1,1,74223,74224,74225,1,2,0
21108,4,2,74227,74227,74229,0,2,2
21109,5,3,74232,74232,74235,0,3,3
21110,5,1,74237,74237,74238,0,1,2
21111,2,2,74239,74239,74241,0,2,1
21112,6,1,74245,74245,74246,0,1,4
21113,2,2,74247,74247,74249,0,2,1
21114,5,1,74252,74252,74253,0,1,3
21115,2,2,74254,74254,74256,0,2,1
21116,5,1,74259,74259,74260,0,1,3
21117,1,3,74260,74260,74263,0,3,0
21118,5,2,74265,74265,74267,0,2,2
21119,6,1,74271,74271,74272,0,1,4
21120,4,1,74275,74275,74276,0,1,3
21121,2,3,74277,74277,74280,0,3,1
21122,6,3,74283,74283,74286,0,3,3
21123,1,1,74284,74286,74287,2,3,0
21124,3,1,74287,74287,74288,0,1,0
21125,3,1,74290,74290,74291,0,1,2
21126,2,3,74292,74292,74295,0,3,1
21127,2,1,74294,74295,74296,1,2,0
21128,4,3,74298,74298,74301,0,3,2
21129,1,3,74299,74301,74304,2,5,0
21130,6,1,74305,74305,74306,0,1,1
21131,6,1,74311,74311,74312,0,1,5
21132,5,3,74316,74316,74319,0,3,4
21133,1,1,74317,74319,74320,2,3,0
21134,3,2,74320,74320,74322,0,2,0
21135,1,2,74321,74322,74324,1,3,0
21136,2,1,74323,74324,74325,1,2,0
21137,5,3,74328,74328,74331,0,3,3
21138,2,1,74330,74331,74332,1,2,0
21139,4,3,74334,74334,74337,0,3,2
21140,3,2,74337,74337,74339,0,2,0
21141,2,2,74339,74339,74341,0,2,0
21142,6,1,74345,74345,74346,0,1,4
21143,4,2,74349,74349,74351,0,2,3
21144,1,1,74350,74351,74352,1,2,0
21145,4,3,74354,74354,74357,0,3,2
21146,2,2,74356,74357,74359,1,3,0
21147,6,1,74362,74362,74363,0,1,3
21148,4,2,74366,74366,74368,0,2,3
21149,2,1,74368,74368,74369,0,1,0
21150,6,3,74374,74374,74377,0,3,5
21151,5,3,74379,74379,74382,0,3,2
21152,6,2,74385,74385,74387,0,2,3
21153,1,2,74386,74387,74389,1,3,0
21154,4,2,74390,74390,74392,0,2,1
21155,5,2,74395,74395,74397,0,2,3
21156,4,3,74399,74399,74402,0,3,2
21157,3,2,74402,74402,74404,0,2,0
21158,5,2,74407,74407,74409,0,2,3
21159,4,3,74411,74411,74414,0,3,2
21160,1,2,74412,74414,74416,2,4,0
21161,6,2,74418,74418,74420,0,2,2
21162,1,1,74419,74420,74421,1,2,0
21163,1,3,74420,74421,74424,1,4,0
21164,3,3,74423,74424,74427,1,4,0
21165,4,1,74427,74427,74428,0,1,0
21166,2,3,74429,74429,74432,0,3,1
21167,3,3,74432,74432,74435,0,3,0
21168,4,1,74436,74436,74437,0,1,1
21169,2,3,74438,74438,74441,0,3,1
21170,4,3,74442,74442,74445,0,3,1
21171,5,1,74447,74447,74448,0,1,2
21172,1,2,74448,74448,74450,0,2,0
21173,2,2,74450,74450,74452,0,2,0
21174,3,2,74453,74453,74455,0,2,1
21175,1,2,74454,74455,74457,1,3,0
21176,4,1,74458,74458,74459,0,1,1
21177,1,1,74459,74459,74460,0,1,0
21178,4,2,74463,74463,74465,0,2,3
21179,1,2,74464,74465,74467,1,3,0
21180,5,3,74469,74469,74472,0,3,2
21181,4,3,74473,74473,74476,0,3,1
21182,4,2,74477,74477,74479,0,2,1
21183,4,3,74481,74481,74484,0,3,2
21184,4,1,74485,74485,74486,0,1,1
21185,6,1,74491,74491,74492,0,1,5
21186,6,1,74497,74497,74498,0,1,5
21187,6,1,74503,74503,74504,0,1,5
21188,6,1,74509,74509,74510,0,1,5
21189,3,1,74512,74512,74513,0,1,2
21190,2,2,74514,74514,74516,0,2,1
21191,6,3,74520,74520,74523,0,3,4
21192,6,2,74526,74526,74528,0,2,3
21193,5,1,74531,74531,74532,0,1,3
21194,1,2,74532,74532,74534,0,2,0
21195,1,3,74533,74534,74537,1,4,0
21196,6,1,74539,74539,74540,0,1,2
21197,6,1,74545,74545,74546,0,1,5
21198,3,1,74548,74548,74549,0,1,2
21199,2,3,74550,74550,74553,0,3,1
21200,5,1,74555,74555,74556,0,1,2
21201,4,3,74559,74559,74562,0,3,3
21202,5,2,74564,74564,74566,0,2,2
21203,3,1,74567,74567,74568,0,1,1
21204,2,3,74569,74569,74572,0,3,1
21205,5,1,74574,74574,74575,0,1,2
21206,3,2,74577,74577,74579,0,2,2
21207,4,3,74581,74581,74584,0,3,2
21208,1,3,74582,74584,74587,2,5,0
21209,3,3,74585,74587,74590,2,5,0
21210,5,2,74590,74590,74592,0,2,0
21211,5,2,74595,74595,74597,0,2,3
21212,3,1,74598,74598,74599,0,1,1
21213,3,2,74601,74601,74603,0,2,2
21214,6,3,74607,74607,74610,0,3,4
21215,1,2,74608,74610,74612,2,4,0
21216,4,3,74612,74612,74615,0,3,0
21217,3,2,74615,74615,74617,0,2,0
21218,5,3,74620,74620,74623,0,3,3
21219,5,3,74625,74625,74628,0,3,2
21220,4,2,74629,74629,74631,0,2,1
21221,5,3,74634,74634,74637,0,3,3
21222,2,3,74636,74637,74640,1,4,0
21223,2,1,74638,74640,74641,2,3,0
21224,2,3,74640,74641,74644,1,4,0
21225,4,3,74644,74644,74647,0,3,0
21226,6,2,74650,74650,74652,0,2,3
21227,1,2,74651,74652,74654,1,3,0
21228,2,1,74653,74654,74655,1,2,0
21229,3,3,74656,74656,74659,0,3,1
21230,1,2,74657,74659,74661,2,4,0
21231,1,2,74658,74661,74663,3,5,0
21232,6,1,74664,74664,74665,0,1,1
21233,2,1,74666,74666,74667,0,1,1
21234,6,3,74672,74672,74675,0,3,5
21235,5,1,74677,74677,74678,0,1,2
21236,5,2,74682,74682,74684,0,2,4
21237,2,3,74684,74684,74687,0,3,0
21238,6,2,74690,74690,74692,0,2,3
21239,2,2,74692,74692,74694,0,2,0
21240,2,1,74694,74694,74695,0,1,0
21241,3,2,74697,74697,74699,0,2,2
21242,4,2,74701,74701,74703,0,2,2
21243,2,2,74703,74703,74705,0,2,0
21244,2,1,74705,74705,74706,0,1,0
21245,1,3,74706,74706,74709,0,3,0
21246,1,2,74707,74709,74711,2,4,0
21247,2,3,74709,74711,74714,2,5,0
21248,4,1,74713,74714,74715,1,2,0
21249,2,3,74715,74715,74718,0,3,0
21250,4,2,74719,74719,74721,0,2,1
21251,6,3,74725,74725,74728,0,3,4
21252,2,1,74727,74728,74729,1,2,0
21253,5,3,74732,74732,74735,0,3,3
21254,2,3,74734,74735,74738,1,4,0
21255,6,1,74740,74740,74741,0,1,2
21256,6,1,74746,74746,74747,0,1,5
21257,2,2,74748,74748,74750,0,2,1
21258,1,2,74749,74750,74752,1,3,0
21259,3,1,74752,74752,74753,0,1,0
21260,6,3,74758,74758,74761,0,3,5
21261,3,2,74761,74761,74763,0,2,0
21262,4,1,74765,74765,74766,0,1,2
21263,1,2,74766,74766,74768,0,2,0
21264,6,3,74772,74772,74775,0,3,4
21265,3,2,74775,74775,74777,0,2,0
21266,6,3,74781,74781,74784,0,3,4
21267,5,3,74786,74786,74789,0,3,2
21268,6,2,74792,74792,74794,0,2,3
21269,6,1,74798,74798,74799,0,1,4
21270,5,2,74803,74803,74805,0,2,4
21271,5,2,74808,74808,74810,0,2,3
21272,5,1,74813,74813,74814,0,1,3
21273,6,3,74819,74819,74822,0,3,5
21274,6,3,74825,74825,74828,0,3,3
21275,6,1,74831,74831,74832,0,1,3
21276,5,2,74836,74836,74838,0,2,4
21277,1,1,74837,74838,74839,1,2,0
21278,1,3,74838,74839,74842,1,4,0
21279,2,2,74840,74842,74844,2,4,0
21280,5,2,74845,74845,74847,0,2,1
21281,1,1,74846,74847,74848,1,2,0
21282,3,3,74849,74849,74852,0,3,1
21283,2,3,74851,74852,74855,1,4,0
21284,4,1,74855,74855,74856,0,1,0
21285,4,3,74859,74859,74862,0,3,3
21286,4,2,74863,74863,74865,0,2,1
21287,2,2,74865,74865,74867,0,2,0
21288,3,2,74868,74868,74870,0,2,1
21289,6,1,74874,74874,74875,0,1,4
21290,6,2,74880,74880,74882,0,2,5
21291,3,2,74883,74883,74885,0,2,1
21292,4,2,74887,74887,74889,0,2,2
21293,3,3,74890,74890,74893,0,3,1
21294,6,2,74896,74896,74898,0,2,3
21295,2,3,74898,74898,74901,0,3,0
21296,2,2,74900,74901,74903,1,3,0
21297,2,1,74902,74903,74904,1,2,0
21298,5,1,74907,74907,74908,0,1,3
21299,5,2,74912,74912,74914,0,2,4
21300,1,2,74913,74914,74916,1,3,0
21301,1,1,74914,74916,74917,2,3,0
21302,3,2,74917,74917,74919,0,2,0
21303,3,2,74920,74920,74922,0,2,1
21304,5,1,74925,74925,74926,0,1,3
21305,5,1,74930,74930,74931,0,1,4
21306,5,3,74935,74935,74938,0,3,4
21307,4,2,74939,74939,74941,0,2,1
21308,6,2,74945,74945,74947,0,2,4
21309,5,3,74950,74950,74953,0,3,3
21310,6,3,74956,74956,74959,0,3,3
21311,5,1,74961,74961,74962,0,1,2
21312,2,1,74963,74963,74964,0,1,1
21313,3,2,74966,74966,74968,0,2,2
21314,5,3,74971,74971,74974,0,3,3
21315,1,2,74972,74974,74976,2,4,0
21316,2,2,74974,74976,74978,2,4,0
21317,2,1,74976,74978,74979,2,3,0
21318,1,1,74977,74979,74980,2,3,0
21319,5,3,74982,74982,74985,0,3,2
21320,4,1,74986,74986,74987,0,1,1
21321,2,3,74988,74988,74991,0,3,1
21322,1,1,74989,74991,74992,2,3,0
21323,1,1,74990,74992,74993,2,3,0
21324,2,2,74992,74993,74995,1,3,0
21325,1,2,74993,74995,74997,2,4,0
21326,3,3,74996,74997,75000,1,4,0
21327,3,1,74999,75000,75001,1,2,0
21328,3,1,75002,75002,75003,0,1,1
21329,5,1,75007,75007,75008,0,1,4
21330,4,3,75011,75011,75014,0,3,3
21331,1,3,75012,75014,75017,2,5,0
21332,4,1,75016,75017,75018,1,2,0
21333,3,1,75019,75019,75020,0,1,1
21334,4,1,75023,75023,75024,0,1,3
21335,6,3,75029,75029,75032,0,3,5
21336,2,1,75031,75032,75033,1,2,0
21337,5,3,75036,75036,75039,0,3,3
21338,3,3,75039,75039,75042,0,3,0
21339,3,2,75042,75042,75044,0,2,0
21340,5,1,75047,75047,75048,0,1,3
21341,6,1,75053,75053,75054,0,1,5
21342,1,1,75054,75054,75055,0,1,0
21343,5,2,75059,75059,75061,0,2,4
21344,1,3,75060,75061,75064,1,4,0
21345,6,3,75066,75066,75069,0,3,2
21346,4,3,75070,75070,75073,0,3,1
21347,1,2,75071,75073,75075,2,4,0
21348,5,1,75076,75076,75077,0,1,1
21349,1,1,75077,75077,75078,0,1,0
21350,2,3,75079,75079,75082,0,3,1
21351,2,2,75081,75082,75084,1,3,0
21352,2,1,75083,75084,75085,1,2,0
21353,4,1,75087,75087,75088,0,1,2
21354,3,1,75090,75090,75091,0,1,2
21355,1,2,75091,75091,75093,0,2,0
21356,2,3,75093,75093,75096,0,3,0
21357,2,2,75095,75096,75098,1,3,0
21358,5,1,75100,75100,75101,0,1,2
21359,2,2,75102,75102,75104,0,2,1
21360,4,2,75106,75106,75108,0,2,2
21361,5,3,75111,75111,75114,0,3,3
21362,2,1,75113,75114,75115,1,2,0
21363,4,3,75117,75117,75120,0,3,2
21364,2,2,75119,75120,75122,1,3,0
21365,4,1,75123,75123,75124,0,1,1
21366,1,2,75124,75124,75126,0,2,0
21367,2,1,75126,75126,75127,0,1,0
21368,1,1,75127,75127,75128,0,1,0
21369,1,1,75128,75128,75129,0,1,0
21370,5,2,75133,75133,75135,0,2,4
21371,5,3,75138,75138,75141,0,3,3
21372,1,2,75139,75141,75143,2,4,0
21373,6,3,75145,75145,75148,0,3,2
21374,5,3,75150,75150,75153,0,3,2
21375,5,1,75155,75155,75156,0,1,2
21376,3,3,75158,75158,75161,0,3,2
21377,1,3,75159,75161,75164,2,5,0
21378,5,3,75164,75164,75167,0,3,0
21379,3,1,75167,75167,75168,0,1,0
21380,3,1,75170,75170,75171,0,1,2
21381,3,2,75173,75173,75175,0,2,2
21382,3,2,75176,75176,75178,0,2,1
21383,4,3,75180,75180,75183,0,3,2
21384,6,1,75186,75186,75187,0,1,3
21385,3,2,75189,75189,75191,0,2,2
21386,3,3,75192,75192,75195,0,3,1
21387,4,2,75196,75196,75198,0,2,1
21388,6,3,75202,75202,75205,0,3,4
21389,4,2,75206,75206,75208,0,2,1
21390,5,2,75211,75211,75213,0,2,3
21391,3,3,75214,75214,75217,0,3,1
21392,2,2,75216,75217,75219,1,3,0
21393,1,2,75217,75219,75221,2,4,0
21394,6,3,75223,75223,75226,0,3,2
21395,5,2,75228,75228,75230,0,2,2
21396,6,1,75234,75234,75235,0,1,4
21397,5,1,75239,75239,75240,0,1,4
21398,1,2,75240,75240,75242,0,2,0
21399,6,1,75246,75246,75247,0,1,4
21400,3,3,75249,75249,75252,0,3,2
21401,1,3,75250,75252,75255,2,5,0
21402,4,3,75254,75255,75258,1,4,0
21403,3,1,75257,75258,75259,1,2,0
21404,1,3,75258,75259,75262,1,4,0
21405,1,3,75259,75262,75265,3,6,0
21406,6,2,75265,75265,75267,0,2,0
21407,3,1,75268,75268,75269,0,1,1
21408,4,1,75272,75272,75273,0,1,3
21409,5,1,75277,75277,75278,0,1,4
21410,2,3,75279,75279,75282,0,3,1
21411,3,1,75282,75282,75283,0,1,0
21412,2,1,75284,75284,75285,0,1,1
21413,3,1,75287,75287,75288,0,1,2
21414,3,2,75290,75290,75292,0,2,2
21415,1,1,75291,75292,75293,1,2,0
21416,2,2,75293,75293,75295,0,2,0
21417,4,1,75297,75297,75298,0,1,2
21418,6,2,75303,75303,75305,0,2,5
21419,1,3,75304,75305,75308,1,4,0
21420,1,2,75305,75308,75310,3,5,0
21421,2,1,75307,75310,75311,3,4,0
21422,4,3,75311,75311,75314,0,3,0
21423,4,3,75315,75315,75318,0,3,1
21424,3,3,75318,75318,75321,0,3,0
21425,2,1,75320,75321,75322,1,2,0
21426,3,3,75323,75323,75326,0,3,1
21427,3,1,75326,75326,75327,0,1,0
21428,2,2,75328,75328,75330,0,2,1
21429,2,2,75330,75330,75332,0,2,0
21430,1,3,75331,75332,75335,1,4,0
21431,4,1,75335,75335,75336,0,1,0
21432,1,1,75336,75336,75337,0,1,0
21433,2,2,75338,75338,75340,0,2,1
21434,5,3,75343,75343,75346,0,3,3
21435,4,1,75347,75347,75348,0,1,1
21436,4,1,75351,75351,75352,0,1,3
21437,2,3,75353,75353,75356,0,3,1
21438,2,1,75355,75356,75357,1,2,0
21439,1,1,75356,75357,75358,1,2,0
21440,3,1,75359,75359,75360,0,1,1
21441,5,3,75364,75364,75367,0,3,4
21442,5,3,75369,75369,75372,0,3,2
21443,6,3,75375,75375,75378,0,3,3
21444,5,2,75380,75380,75382,0,2,2
21445,1,3,75381,75382,75385,1,4,0
21446,2,1,75383,75385,75386,2,3,0
21447,4,1,75387,75387,75388,0,1,1
21448,5,3,75392,75392,75395,0,3,4
21449,2,2,75394,75395,75397,1,3,0
21450,4,2,75398,75398,75400,0,2,1
21451,5,3,75403,75403,75406,0,3,3
21452,5,3,75408,75408,75411,0,3,2
21453,1,2,75409,75411,75413,2,4,0
21454,5,1,75414,75414,75415,0,1,1
21455,1,1,75415,75415,75416,0,1,0
21456,3,3,75418,75418,75421,0,3,2
21457,3,3,75421,75421,75424,0,3,0
21458,5,2,75426,75426,75428,0,2,2
21459,5,3,75431,75431,75434,0,3,3
21460,1,2,75432,75434,75436,2,4,0
21461,5,3,75437,75437,75440,0,3,1
21462,4,2,75441,75441,75443,0,2,1
21463,6,1,75447,75447,75448,0,1,4
21464,4,3,75451,75451,75454,0,3,3
21465,6,1,75457,75457,75458,0,1,3
21466,1,1,75458,75458,75459,0,1,0
21467,4,3,75462,75462,75465,0,3,3
21468,6,2,75468,75468,75470,0,2,3
21469,4,3,75472,75472,75475,0,3,2
21470,1,3,75473,75475,75478,2,5,0
21471,5,2,75478,75478,75480,0,2,0
21472,4,2,75482,75482,75484,0,2,2
21473,1,2,75483,75484,75486,1,3,0
21474,2,2,75485,75486,75488,1,3,0
21475,2,2,75487,75488,75490,1,3,0
21476,1,1,75488,75490,75491,2,3,0
21477,3,3,75491,75491,75494,0,3,0
21478,5,2,75496,75496,75498,0,2,2
21479,5,2,75501,75501,75503,0,2,3
21480,1,2,75502,75503,75505,1,3,0
21481,5,3,75507,75507,75510,0,3,2
21482,5,3,75512,75512,75515,0,3,2
21483,6,1,75518,75518,75519,0,1,3
21484,4,1,75522,75522,75523,0,1,3
21485,3,3,75525,75525,75528,0,3,2
21486,5,2,75530,75530,75532,0,2,2
21487,6,2,75536,75536,75538,0,2,4
21488,2,2,75538,75538,75540,0,2,0
21489,4,2,75542,75542,75544,0,2,2
21490,2,3,75544,75544,75547,0,3,0
21491,3,2,75547,75547,75549,0,2,0
21492,4,1,75551,75551,75552,0,1,2
21493,5,2,75556,75556,75558,0,2,4
21494,1,1,75557,75558,75559,1,2,0
21495,4,3,75561,75561,75564,0,3,2
21496,5,1,75566,75566,75567,0,1,2
21497,2,2,75568,75568,75570,0,2,1
21498,3,3,75571,75571,75574,0,3,1
21499,5,2,75576,75576,75578,0,2,2
21500,2,2,75578,75578,75580,0,2,0
21501,6,1,75584,75584,75585,0,1,4
21502,6,1,75590,75590,75591,0,1,5
21503,4,1,75594,75594,75595,0,1,3
21504,6,3,75600,75600,75603,0,3,5
21505,5,2,75605,75605,75607,0,2,2
21506,3,3,75608,75608,75611,0,3,1
21507,3,2,75611,75611,75613,0,2,0
21508,5,2,75616,75616,75618,0,2,3
21509,4,2,75620,75620,75622,0,2,2
21510,6,1,75626,75626,75627,0,1,4
21511,6,3,75632,75632,75635,0,3,5
21512,6,1,75638,75638,75639,0,1,3
21513,2,2,75640,75640,75642,0,2,1
21514,1,1,75641,75642,75643,1,2,0
21515,1,3,75642,75643,75646,1,4,0
21516,2,2,75644,75646,75648,2,4,0
21517,2,3,75646,75648,75651,2,5,0
21518,5,1,75651,75651,75652,0,1,0
21519,4,2,75655,75655,75657,0,2,3
21520,3,1,75658,75658,75659,0,1,1
21521,5,1,75663,75663,75664,0,1,4
21522,4,3,75667,75667,75670,0,3,3
21523,1,2,75668,75670,75672,2,4,0
21524,4,3,75672,75672,75675,0,3,0
21525,4,2,75676,75676,75678,0,2,1
21526,5,3,75681,75681,75684,0,3,3
21527,4,2,75685,75685,75687,0,2,1
21528,6,2,75691,75691,75693,0,2,4
21529,5,1,75696,75696,75697,0,1,3
21530,5,1,75701,75701,75702,0,1,4
21531,3,3,75704,75704,75707,0,3,2
21532,5,2,75709,75709,75711,0,2,2
21533,1,2,75710,75711,75713,1,3,0
21534,3,2,75713,75713,75715,0,2,0
21535,4,3,75717,75717,75720,0,3,2
21536,1,1,75718,75720,75721,2,3,0
21537,2,1,75720,75721,75722,1,2,0
21538,5,2,75725,75725,75727,0,2,3
21539,4,2,75729,75729,75731,0,2,2
21540,4,2,75733,75733,75735,0,2,2
21541,4,3,75737,75737,75740,0,3,2
21542,3,1,75740,75740,75741,0,1,0
21543,2,2,75742,75742,75744,0,2,1
21544,3,3,75745,75745,75748,0,3,1
21545,3,2,75748,75748,75750,0,2,0
21546,4,2,75752,75752,75754,0,2,2
21547,5,2,75757,75757,75759,0,2,3
21548,1,3,75758,75759,75762,1,4,0
21549,3,2,75761,75762,75764,1,3,0
21550,1,2,75762,75764,75766,2,4,0
21551,5,1,75767,75767,75768,0,1,1
21552,1,3,75768,75768,75771,0,3,0
21553,5,3,75773,75773,75776,0,3,2
21554,6,2,75779,75779,75781,0,2,3
21555,5,2,75784,75784,75786,0,2,3
21556,4,1,75788,75788,75789,0,1,2
21557,2,2,75790,75790,75792,0,2,1
21558,5,2,75795,75795,75797,0,2,3
21559,5,3,75800,75800,75803,0,3,3
21560,1,3,75801,75803,75806,2,5,0
21561,6,1,75807,75807,75808,0,1,1
21562,5,1,75812,75812,75813,0,1,4
21563,1,1,75813,75813,75814,0,1,0
21564,5,2,75818,75818,75820,0,2,4
21565,5,3,75823,75823,75826,0,3,3
21566,5,1,75828,75828,75829,0,1,2
21567,5,3,75833,75833,75836,0,3,4
21568,5,3,75838,75838,75841,0,3,2
21569,3,3,75841,75841,75844,0,3,0
21570,2,2,75843,75844,75846,1,3,0
21571,6,3,75849,75849,75852,0,3,3
21572,6,2,75855,75855,75857,0,2,3
21573,5,2,75860,75860,75862,0,2,3
21574,6,1,75866,75866,75867,0,1,4
21575,2,3,75868,75868,75871,0,3,1
21576,1,1,75869,75871,75872,2,3,0
21577,3,1,75872,75872,75873,0,1,0
21578,1,2,75873,75873,75875,0,2,0
21579,2,3,75875,75875,75878,0,3,0
21580,4,3,75879,75879,75882,0,3,1
21581,2,1,75881,75882,75883,1,2,0
21582,3,1,75884,75884,75885,0,1,1
21583,2,2,75886,75886,75888,0,2,1
21584,1,1,75887,75888,75889,1,2,0
21585,4,1,75891,75891,75892,0,1,2
21586,6,2,75897,75897,75899,0,2,5
21587,6,1,75903,75903,75904,0,1,4
21588,6,3,75909,75909,75912,0,3,5
21589,6,2,75915,75915,75917,0,2,3
21590,4,3,75919,75919,75922,0,3,2
21591,6,1,75925,75925,75926,0,1,3
21592,6,2,75931,75931,75933,0,2,5
21593,6,3,75937,75937,75940,0,3,4
21594,1,1,75938,75940,75941,2,3,0
21595,5,1,75943,75943,75944,0,1,2
21596,4,1,75947,75947,75948,0,1,3
21597,4,2,75951,75951,75953,0,2,3
21598,4,3,75955,75955,75958,0,3,2
21599,3,2,75958,75958,75960,0,2,0
21600,5,3,75963,75963,75966,0,3,3
21601,2,3,75965,75966,75969,1,4,0
21602,2,2,75967,75969,75971,2,4,0
21603,1,1,75968,75971,75972,3,4,0
21604,2,3,75970,75972,75975,2,5,0
21605,2,1,75972,75975,75976,3,4,0
21606,1,2,75973,75976,75978,3,5,0
21607,1,2,75974,75978,75980,4,6,0
21608,5,2,75979,75980,75982,1,3,0
21609,5,3,75984,75984,75987,0,3,2
21610,2,2,75986,75987,75989,1,3,0
21611,5,3,75991,75991,75994,0,3,2
21612,6,3,75997,75997,76000,0,3,3
21613,6,2,76003,76003,76005,0,2,3
21614,2,3,76005,76005,76008,0,3,0
21615,5,1,76010,76010,76011,0,1,2
21616,2,2,76012,76012,76014,0,2,1
21617,6,1,76018,76018,76019,0,1,4
21618,1,3,76019,76019,76022,0,3,0
21619,2,3,76021,76022,76025,1,4,0
21620,4,1,76025,76025,76026,0,1,0
21621,1,3,76026,76026,76029,0,3,0
21622,4,3,76030,76030,76033,0,3,1
21623,2,1,76032,76033,76034,1,2,0
21624,1,3,76033,76034,76037,1,4,0
21625,1,2,76034,76037,76039,3,5,0
21626,4,2,76038,76039,76041,1,3,0
21627,2,1,76040,76041,76042,1,2,0
21628,5,1,76045,76045,76046,0,1,3
21629,2,2,76047,76047,76049,0,2,1
21630,1,1,76048,76049,76050,1,2,0
21631,3,3,76051,76051,76054,0,3,1
21632,1,2,76052,76054,76056,2,4,0
21633,2,2,76054,76056,76058,2,4,0
21634,4,3,76058,76058,76061,0,3,0
21635,3,1,76061,76061,76062,0,1,0
21636,4,2,76065,76065,76067,0,2,3
21637,2,3,76067,76067,76070,0,3,0
21638,4,1,76071,76071,76072,0,1,1
21639,5,1,76076,76076,76077,0,1,4
21640,6,2,76082,76082,76084,0,2,5
21641,5,2,76087,76087,76089,0,2,3
21642,1,3,76088,76089,76092,1,4,0
21643,2,1,76090,76092,76093,2,3,0
21644,6,1,76096,76096,76097,0,1,3
21645,1,1,76097,76097,76098,0,1,0
21646,1,3,76098,76098,76101,0,3,0
21647,6,3,76104,76104,76107,0,3,3
21648,6,3,76110,76110,76113,0,3,3
21649,5,2,76115,76115,76117,0,2,2
21650,5,1,76120,76120,76121,0,1,3
21651,5,1,76125,76125,76126,0,1,4
21652,2,3,76127,76127,76130,0,3,1
21653,1,3,76128,76130,76133,2,5,0
21654,1,1,76129,76133,76134,4,5,0
21655,2,3,76131,76134,76137,3,6,0
21656,4,3,76135,76137,76140,2,5,0
21657,3,2,76138,76140,76142,2,4,0
21658,5,2,76143,76143,76145,0,2,1
21659,4,1,76147,76147,76148,0,1,2
21660,2,3,76149,76149,76152,0,3,1
21661,3,2,76152,76152,76154,0,2,0
21662,2,3,76154,76154,76157,0,3,0
21663,1,2,76155,76157,76159,2,4,0
21664,6,1,76161,76161,76162,0,1,2
21665,5,2,76166,76166,76168,0,2,4
21666,4,2,76170,76170,76172,0,2,2
21667,1,2,76171,76172,76174,1,3,0
21668,5,2,76176,76176,76178,0,2,2
21669,6,1,76182,76182,76183,0,1,4
21670,1,1,76183,76183,76184,0,1,0
21671,5,3,76188,76188,76191,0,3,4
21672,5,1,76193,76193,76194,0,1,2
21673,2,1,76195,76195,76196,0,1,1
21674,6,1,76201,76201,76202,0,1,5
21675,6,3,76207,76207,76210,0,3,5
21676,2,3,76209,76210,76213,1,4,0
21677,5,3,76214,76214,76217,0,3,1
21678,2,2,76216,76217,76219,1,3,0
21679,1,2,76217,76219,76221,2,4,0
21680,3,1,76220,76221,76222,1,2,0
21681,6,3,76226,76226,76229,0,3,4
21682,1,2,76227,76229,76231,2,4,0
21683,6,2,76233,76233,76235,0,2,2
21684,1,3,76234,76235,76238,1,4,0
21685,5,2,76239,76239,76241,0,2,1
21686,3,1,76242,76242,76243,0,1,1
21687,1,3,76243,76243,76246,0,3,0
21688,1,2,76244,76246,76248,2,4,0
21689,3,3,76247,76248,76251,1,4,0
21690,2,3,76249,76251,76254,2,5,0
21691,1,1,76250,76254,76255,4,5,0
21692,1,1,76251,76255,76256,4,5,0
21693,1,2,76252,76256,76258,4,6,0
21694,4,2,76256,76258,76260,2,4,0
21695,4,3,76260,76260,76263,0,3,0
21696,6,2,76266,76266,76268,0,2,3
21697,3,3,76269,76269,76272,0,3,1
21698,5,3,76274,76274,76277,0,3,2
21699,2,1,76276,76277,76278,1,2,0
21700,1,2,76277,76278,76280,1,3,0
21701,1,3,76278,76280,76283,2,5,0
21702,2,2,76280,76283,76285,3,5,0
21703,4,3,76284,76285,76288,1,4,0
21704,2,2,76286,76288,76290,2,4,0
21705,1,1,76287,76290,76291,3,4,0
21706,3,3,76290,76291,76294,1,4,0
21707,6,2,76296,76296,76298,0,2,2
21708,2,3,76298,76298,76301,0,3,0
21709,2,3,76300,76301,76304,1,4,0
21710,4,3,76304,76304,76307,0,3,0
21711,2,3,76306,76307,76310,1,4,0
21712,1,3,76307,76310,76313,3,6,0
21713,5,3,76312,76313,76316,1,4,0
21714,4,1,76316,76316,76317,0,1,0
21715,2,2,76318,76318,76320,0,2,1
21716,1,1,76319,76320,76321,1,2,0
21717,4,2,76323,76323,76325,0,2,2
21718,5,3,76328,76328,76331,0,3,3
21719,6,2,76334,76334,76336,0,2,3
21720,5,2,76339,76339,76341,0,2,3
21721,4,1,76343,76343,76344,0,1,2
21722,6,2,76349,76349,76351,0,2,5
21723,3,3,76352,76352,76355,0,3,1
21724,1,3,76353,76355,76358,2,5,0
21725,6,3,76359,76359,76362,0,3,1
21726,5,2,76364,76364,76366,0,2,2
21727,2,3,76366,76366,76369,0,3,0
21728,4,3,76370,76370,76373,0,3,1
21729,5,1,76375,76375,76376,0,1,2
21730,2,2,76377,76377,76379,0,2,1
21731,4,1,76381,76381,76382,0,1,2
21732,2,1,76383,76383,76384,0,1,1
21733,6,3,76389,76389,76392,0,3,5
21734,4,1,76393,76393,76394,0,1,1
21735,2,1,76395,76395,76396,0,1,1
21736,3,2,76398,76398,76400,0,2,2
21737,5,2,76403,76403,76405,0,2,3
21738,6,2,76409,76409,76411,0,2,4
21739,4,2,76413,76413,76415,0,2,2
21740,3,1,76416,76416,76417,0,1,1
21741,5,3,76421,76421,76424,0,3,4
21742,5,1,76426,76426,76427,0,1,2
21743,1,2,76427,76427,76429,0,2,0
21744,1,3,76428,76429,76432,1,4,0
21745,5,3,76433,76433,76436,0,3,1
21746,4,3,76437,76437,76440,0,3,1
21747,1,2,76438,76440,76442,2,4,0
21748,2,1,76440,76442,76443,2,3,0
21749,6,3,76446,76446,76449,0,3,3
21750,4,2,76450,76450,76452,0,2,1
21751,6,1,76456,76456,76457,0,1,4
21752,5,3,76461,76461,76464,0,3,4
21753,4,1,76465,76465,76466,0,1,1
21754,4,3,76469,76469,76472,0,3,3
21755,3,1,76472,76472,76473,0,1,0
21756,4,3,76476,76476,76479,0,3,3
21757,1,3,76477,76479,76482,2,5,0
21758,1,1,76478,76482,76483,4,5,0
21759,3,2,76481,76483,76485,2,4,0
21760,2,2,76483,76485,76487,2,4,0
21761,6,1,76489,76489,76490,0,1,2
21762,5,3,76494,76494,76497,0,3,4
21763,6,3,76500,76500,76503,0,3,3
21764,2,1,76502,76503,76504,1,2,0
21765,3,2,76505,76505,76507,0,2,1
21766,6,1,76511,76511,76512,0,1,4
21767,6,2,76517,76517,76519,0,2,5
21768,4,2,76521,76521,76523,0,2,2
21769,1,3,76522,76523,76526,1,4,0
21770,5,2,76527,76527,76529,0,2,1
21771,1,3,76528,76529,76532,1,4,0
21772,5,2,76533,76533,76535,0,2,1
21773,1,1,76534,76535,76536,1,2,0
21774,6,2,76540,76540,76542,0,2,4
21775,2,2,76542,76542,76544,0,2,0
21776,4,2,76546,76546,76548,0,2,2
21777,2,3,76548,76548,76551,0,3,0
21778,3,2,76551,76551,76553,0,2,0
21779,3,1,76554,76554,76555,0,1,1
21780,4,2,76558,76558,76560,0,2,3
21781,2,3,76560,76560,76563,0,3,0
21782,2,3,76562,76563,76566,1,4,0
21783,6,1,76568,76568,76569,0,1,2
21784,1,2,76569,76569,76571,0,2,0
21785,2,2,76571,76571,76573,0,2,0
21786,1,3,76572,76573,76576,1,4,0
21787,6,1,76578,76578,76579,0,1,2
21788,1,1,76579,76579,76580,0,1,0
21789,2,1,76581,76581,76582,0,1,1
21790,3,3,76584,76584,76587,0,3,2
21791,2,2,76586,76587,76589,1,3,0
21792,3,3,76589,76589,76592,0,3,0
21793,1,1,76590,76592,76593,2,3,0
21794,3,3,76593,76593,76596,0,3,0
21795,5,2,76598,76598,76600,0,2,2
21796,2,2,76600,76600,76602,0,2,0
21797,5,3,76605,76605,76608,0,3,3
21798,6,3,76611,76611,76614,0,3,3
21799,1,2,76612,76614,76616,2,4,0
21800,6,3,76618,76618,76621,0,3,2
21801,1,3,76619,76621,76624,2,5,0
21802,1,1,76620,76624,76625,4,5,0
21803,5,1,76625,76625,76626,0,1,0
21804,1,3,76626,76626,76629,0,3,0
21805,3,1,76629,76629,76630,0,1,0
21806,3,3,76632,76632,76635,0,3,2
21807,6,3,76638,76638,76641,0,3,3
21808,1,3,76639,76641,76644,2,5,0
21809,1,3,76640,76644,76647,4,7,0
21810,2,1,76642,76647,76648,5,6,0
21811,5,2,76647,76648,76650,1,3,0
21812,6,1,76653,76653,76654,0,1,3
21813,4,2,76657,76657,76659,0,2,3
21814,4,2,76661,76661,76663,0,2,2
21815,6,1,76667,76667,76668,0,1,4
21816,5,1,76672,76672,76673,0,1,4
21817,6,3,76678,76678,76681,0,3,5
21818,3,2,76681,76681,76683,0,2,0
21819,5,2,76686,76686,76688,0,2,3
21820,5,1,76691,76691,76692,0,1,3
21821,5,1,76696,76696,76697,0,1,4
21822,4,2,76700,76700,76702,0,2,3
21823,5,2,76705,76705,76707,0,2,3
21824,3,1,76708,76708,76709,0,1,1
21825,1,3,76709,76709,76712,0,3,0
21826,4,2,76713,76713,76715,0,2,1
21827,3,1,76716,76716,76717,0,1,1
21828,6,1,76722,76722,76723,0,1,5
21829,5,1,76727,76727,76728,0,1,4
21830,6,1,76733,76733,76734,0,1,5
21831,3,2,76736,76736,76738,0,2,2
21832,3,2,76739,76739,76741,0,2,1
21833,1,2,76740,76741,76743,1,3,0
21834,2,1,76742,76743,76744,1,2,0
21835,1,1,76743,76744,76745,1,2,0
21836,4,2,76747,76747,76749,0,2,2
21837,5,1,76752,76752,76753,0,1,3
21838,6,1,76758,76758,76759,0,1,5
21839,1,2,76759,76759,76761,0,2,0
21840,6,1,76765,76765,76766,0,1,4
21841,2,3,76767,76767,76770,0,3,1
21842,4,2,76771,76771,76773,0,2,1
21843,3,3,76774,76774,76777,0,3,1
21844,1,1,76775,76777,76778,2,3,0
21845,5,3,76780,76780,76783,0,3,2
21846,3,2,76783,76783,76785,0,2,0
21847,4,1,76787,76787,76788,0,1,2
21848,2,3,76789,76789,76792,0,3,1
21849,5,3,76794,76794,76797,0,3,2
21850,3,3,76797,76797,76800,0,3,0
21851,2,2,76799,76800,76802,1,3,0
21852,2,2,76801,76802,76804,1,3,0
21853,6,1,76807,76807,76808,0,1,3
21854,6,3,76813,76813,76816,0,3,5
21855,3,2,76816,76816,76818,0,2,0
21856,6,3,76822,76822,76825,0,3,4
21857,6,3,76828,76828,76831,0,3,3
21858,5,1,76833,76833,76834,0,1,2
21859,5,3,76838,76838,76841,0,3,4
21860,2,1,76840,76841,76842,1,2,0
21861,2,3,76842,76842,76845,0,3,0
21862,4,3,76846,76846,76849,0,3,1
21863,1,1,76847,76849,76850,2,3,0
21864,6,1,76853,76853,76854,0,1,3
21865,4,3,76857,76857,76860,0,3,3
21866,6,2,76863,76863,76865,0,2,3
21867,2,3,76865,76865,76868,0,3,0
21868,1,3,76866,76868,76871,2,5,0
21869,4,2,76870,76871,76873,1,3,0
21870,5,2,76875,76875,76877,0,2,2
21871,4,2,76879,76879,76881,0,2,2
21872,4,1,76883,76883,76884,0,1,2
21873,5,1,76888,76888,76889,0,1,4
21874,6,2,76894,76894,76896,0,2,5
21875,3,2,76897,76897,76899,0,2,1
21876,2,3,76899,76899,76902,0,3,0
21877,1,1,76900,76902,76903,2,3,0
21878,4,1,76904,76904,76905,0,1,1
21879,6,3,76910,76910,76913,0,3,5
21880,5,3,76915,76915,76918,0,3,2
21881,2,1,76917,76918,76919,1,2,0
21882,1,2,76918,76919,76921,1,3,0
21883,3,3,76921,76921,76924,0,3,0
21884,3,2,76924,76924,76926,0,2,0
21885,5,2,76929,76929,76931,0,2,3
21886,6,1,76935,76935,76936,0,1,4
21887,1,3,76936,76936,76939,0,3,0
21888,2,3,76938,76939,76942,1,4,0
21889,4,2,76942,76942,76944,0,2,0
21890,1,3,76943,76944,76947,1,4,0
21891,6,2,76949,76949,76951,0,2,2
21892,2,1,76951,76951,76952,0,1,0
21893,3,2,76954,76954,76956,0,2,2
21894,3,2,76957,76957,76959,0,2,1
21895,6,3,76963,76963,76966,0,3,4
21896,1,3,76964,76966,76969,2,5,0
21897,4,3,76968,76969,76972,1,4,0
21898,6,3,76974,76974,76977,0,3,2
21899,4,2,76978,76978,76980,0,2,1
21900,4,1,76982,76982,76983,0,1,2
21901,5,1,76987,76987,76988,0,1,4
21902,1,3,76988,76988,76991,0,3,0
21903,6,3,76994,76994,76997,0,3,3
21904,1,3,76995,76997,77000,2,5,0
21905,3,3,76998,77000,77003,2,5,0
21906,4,3,77002,77003,77006,1,4,0
21907,3,2,77005,77006,77008,1,3,0
21908,1,3,77006,77008,77011,2,5,0
21909,6,2,77012,77012,77014,0,2,1
21910,6,2,77018,77018,77020,0,2,4
21911,1,3,77019,77020,77023,1,4,0
21912,4,3,77023,77023,77026,0,3,0
21913,1,3,77024,77026,77029,2,5,0
21914,6,1,77030,77030,77031,0,1,1
21915,3,3,77033,77033,77036,0,3,2
21916,5,2,77038,77038,77040,0,2,2
21917,4,1,77042,77042,77043,0,1,2
21918,5,3,77047,77047,77050,0,3,4
21919,4,2,77051,77051,77053,0,2,1
21920,6,1,77057,77057,77058,0,1,4
21921,5,3,77062,77062,77065,0,3,4
21922,4,3,77066,77066,77069,0,3,1
21923,5,1,77071,77071,77072,0,1,2
21924,3,1,77074,77074,77075,0,1,2
21925,6,2,77080,77080,77082,0,2,5
21926,4,3,77084,77084,77087,0,3,2
21927,4,3,77088,77088,77091,0,3,1
21928,1,3,77089,77091,77094,2,5,0
21929,2,3,77091,77094,77097,3,6,0
21930,5,2,77096,77097,77099,1,3,0
21931,4,3,77100,77100,77103,0,3,1
21932,5,2,77105,77105,77107,0,2,2
21933,1,2,77106,77107,77109,1,3,0
21934,1,2,77107,77109,77111,2,4,0
21935,2,2,77109,77111,77113,2,4,0
21936,6,1,77115,77115,77116,0,1,2
21937,2,3,77117,77117,77120,0,3,1
21938,6,2,77123,77123,77125,0,2,3
21939,1,1,77124,77125,77126,1,2,0
21940,5,1,77129,77129,77130,0,1,3
21941,4,2,77133,77133,77135,0,2,3
21942,3,3,77136,77136,77139,0,3,1
21943,3,3,77139,77139,77142,0,3,0
21944,6,2,77145,77145,77147,0,2,3
21945,6,3,77151,77151,77154,0,3,4
21946,4,1,77155,77155,77156,0,1,1
21947,3,3,77158,77158,77161,0,3,2
21948,5,1,77163,77163,77164,0,1,2
21949,5,1,77168,77168,77169,0,1,4
21950,4,3,77172,77172,77175,0,3,3
21951,1,1,77173,77175,77176,2,3,0
21952,3,2,77176,77176,77178,0,2,0
21953,4,2,77180,77180,77182,0,2,2
21954,5,1,77185,77185,77186,0,1,3
21955,1,2,77186,77186,77188,0,2,0
21956,2,2,77188,77188,77190,0,2,0
21957,1,2,77189,77190,77192,1,3,0
21958,4,1,77193,77193,77194,0,1,1
21959,5,1,77198,77198,77199,0,1,4
21960,2,1,77200,77200,77201,0,1,1
21961,4,2,77204,77204,77206,0,2,3
21962,3,2,77207,77207,77209,0,2,1
21963,3,2,77210,77210,77212,0,2,1
21964,5,1,77215,77215,77216,0,1,3
21965,3,3,77218,77218,77221,0,3,2
21966,6,3,77224,77224,77227,0,3,3
21967,2,2,77226,77227,77229,1,3,0
21968,6,2,77232,77232,77234,0,2,3
21969,3,2,77235,77235,77237,0,2,1
21970,5,2,77240,77240,77242,0,2,3
21971,1,3,77241,77242,77245,1,4,0
21972,6,1,77247,77247,77248,0,1,2
21973,5,3,77252,77252,77255,0,3,4
21974,1,2,77253,77255,77257,2,4,0
21975,3,3,77256,77257,77260,1,4,0
21976,6,1,77262,77262,77263,0,1,2
21977,3,2,77265,77265,77267,0,2,2
21978,1,3,77266,77267,77270,1,4,0
21979,5,3,77271,77271,77274,0,3,1
21980,2,1,77273,77274,77275,1,2,0
21981,1,3,77274,77275,77278,1,4,0
21982,4,1,77278,77278,77279,0,1,0
21983,4,1,77282,77282,77283,0,1,3
21984,6,3,77288,77288,77291,0,3,5
21985,5,1,77293,77293,77294,0,1,2
21986,6,1,77299,77299,77300,0,1,5
21987,3,2,77302,77302,77304,0,2,2
21988,4,3,77306,77306,77309,0,3,2
21989,4,3,77310,77310,77313,0,3,1
21990,3,3,77313,77313,77316,0,3,0
21991,2,2,77315,77316,77318,1,3,0
21992,1,3,77316,77318,77321,2,5,0
21993,4,1,77320,77321,77322,1,2,0
21994,5,2,77325,77325,77327,0,2,3
21995,1,1,77326,77327,77328,1,2,0
21996,2,1,77328,77328,77329,0,1,0
21997,1,2,77329,77329,77331,0,2,0
21998,1,3,77330,77331,77334,1,4,0
21999,1,1,77331,77334,77335,3,4,0
22000,4,1,77335,77335,77336,0,1,0
22001,3,1,77338,77338,77339,0,1,2
22002,2,1,77340,77340,77341,0,1,1
22003,4,1,77344,77344,77345,0,1,3
22004,1,2,77345,77345,77347,0,2,0
22005,5,2,77350,77350,77352,0,2,3
22006,1,2,77351,77352,77354,1,3,0
22007,3,1,77354,77354,77355,0,1,0
22008,5,1,77359,77359,77360,0,1,4
22009,6,1,77365,77365,77366,0,1,5
22010,2,2,77367,77367,77369,0,2,1
22011,3,3,77370,77370,77373,0,3,1
22012,4,1,77374,77374,77375,0,1,1
22013,1,2,77375,77375,77377,0,2,0
22014,3,1,77378,77378,77379,0,1,1
22015,5,3,77383,77383,77386,0,3,4
22016,4,1,77387,77387,77388,0,1,1
22017,5,1,77392,77392,77393,0,1,4
22018,6,3,77398,77398,77401,0,3,5
22019,2,2,77400,77401,77403,1,3,0
22020,4,1,77404,77404,77405,0,1,1
22021,1,2,77405,77405,77407,0,2,0
22022,5,3,77410,77410,77413,0,3,3
22023,6,2,77416,77416,77418,0,2,3
22024,5,2,77421,77421,77423,0,2,3
22025,2,3,77423,77423,77426,0,3,0
22026,6,2,77429,77429,77431,0,2,3
22027,5,3,77434,77434,77437,0,3,3
22028,5,2,77439,77439,77441,0,2,2
22029,5,3,77444,77444,77447,0,3,3
22030,1,1,77445,77447,77448,2,3,0
22031,3,2,77448,77448,77450,0,2,0
22032,3,3,77451,77451,77454,0,3,1
22033,6,1,77457,77457,77458,0,1,3
22034,3,1,77460,77460,77461,0,1,2
22035,3,3,77463,77463,77466,0,3,2
22036,3,1,77466,77466,77467,0,1,0
22037,5,3,77471,77471,77474,0,3,4
22038,5,1,77476,77476,77477,0,1,2
22039,4,3,77480,77480,77483,0,3,3
22040,6,1,77486,77486,77487,0,1,3
22041,5,1,77491,77491,77492,0,1,4
22042,6,2,77497,77497,77499,0,2,5
22043,2,1,77499,77499,77500,0,1,0
22044,2,1,77501,77501,77502,0,1,1
22045,4,1,77505,77505,77506,0,1,3
22046,1,2,77506,77506,77508,0,2,0
22047,2,2,77508,77508,77510,0,2,0
22048,6,2,77514,77514,77516,0,2,4
22049,3,3,77517,77517,77520,0,3,1
22050,2,1,77519,77520,77521,1,2,0
22051,6,3,77525,77525,77528,0,3,4
22052,1,2,77526,77528,77530,2,4,0
22053,2,1,77528,77530,77531,2,3,0
22054,4,2,77532,77532,77534,0,2,1
22055,5,3,77537,77537,77540,0,3,3
22056,1,3,77538,77540,77543,2,5,0
22057,3,3,77541,77543,77546,2,5,0
22058,6,1,77547,77547,77548,0,1,1
22059,1,3,77548,77548,77551,0,3,0
22060,5,1,77553,77553,77554,0,1,2
22061,2,3,77555,77555,77558,0,3,1
22062,2,1,77557,77558,77559,1,2,0
22063,4,2,77561,77561,77563,0,2,2
22064,6,1,77567,77567,77568,0,1,4
22065,3,2,77570,77570,77572,0,2,2
22066,6,1,77576,77576,77577,0,1,4
22067,3,1,77579,77579,77580,0,1,2
22068,2,1,77581,77581,77582,0,1,1
22069,1,2,77582,77582,77584,0,2,0
22070,1,2,77583,77584,77586,1,3,0
22071,2,2,77585,77586,77588,1,3,0
22072,3,2,77588,77588,77590,0,2,0
22073,5,2,77593,77593,77595,0,2,3
22074,1,1,77594,77595,77596,1,2,0
22075,3,1,77597,77597,77598,0,1,1
22076,1,3,77598,77598,77601,0,3,0
22077,3,1,77601,77601,77602,0,1,0
22078,6,3,77607,77607,77610,0,3,5
22079,4,2,77611,77611,77613,0,2,1
22080,5,1,77616,77616,77617,0,1,3
22081,4,2,77620,77620,77622,0,2,3
22082,2,3,77622,77622,77625,0,3,0
22083,2,1,77624,77625,77626,1,2,0
22084,3,2,77627,77627,77629,0,2,1
22085,1,3,77628,77629,77632,1,4,0
22086,1,3,77629,77632,77635,3,6,0
22087,4,1,77633,77635,77636,2,3,0
22088,6,2,77639,77639,77641,0,2,3
22089,6,3,77645,77645,77648,0,3,4
22090,6,3,77651,77651,77654,0,3,3
22091,6,1,77657,77657,77658,0,1,3
22092,2,2,77659,77659,77661,0,2,1
22093,6,2,77665,77665,77667,0,2,4
22094,1,2,77666,77667,77669,1,3,0
22095,6,2,77672,77672,77674,0,2,3
22096,1,1,77673,77674,77675,1,2,0
22097,4,2,77677,77677,77679,0,2,2
22098,5,1,77682,77682,77683,0,1,3
22099,6,2,77688,77688,77690,0,2,5
22100,6,3,77694,77694,77697,0,3,4
22101,1,3,77695,77697,77700,2,5,0
22102,6,1,77701,77701,77702,0,1,1
22103,1,3,77702,77702,77705,0,3,0
22104,4,3,77706,77706,77709,0,3,1
22105,4,1,77710,77710,77711,0,1,1
22106,6,3,77716,77716,77719,0,3,5
22107,4,2,77720,77720,77722,0,2,1
22108,2,1,77722,77722,77723,0,1,0
22109,3,1,77725,77725,77726,0,1,2
22110,3,2,77728,77728,77730,0,2,2
22111,3,3,77731,77731,77734,0,3,1
22112,3,3,77734,77734,77737,0,3,0
22113,6,2,77740,77740,77742,0,2,3
22114,4,3,77744,77744,77747,0,3,2
22115,4,3,77748,77748,77751,0,3,1
22116,2,3,77750,77751,77754,1,4,0
22117,4,3,77754,77754,77757,0,3,0
22118,6,3,77760,77760,77763,0,3,3
22119,5,2,77765,77765,77767,0,2,2
22120,2,2,77767,77767,77769,0,2,0
22121,4,1,77771,77771,77772,0,1,2
22122,1,2,77772,77772,77774,0,2,0
22123,3,2,77775,77775,77777,0,2,1
22124,6,1,77781,77781,77782,0,1,4
22125,2,3,77783,77783,77786,0,3,1
22126,6,2,77789,77789,77791,0,2,3
22127,2,2,77791,77791,77793,0,2,0
22128,6,1,77797,77797,77798,0,1,4
22129,3,3,77800,77800,77803,0,3,2
22130,4,1,77804,77804,77805,0,1,1
22131,2,1,77806,77806,77807,0,1,1
22132,4,2,77810,77810,77812,0,2,3
22133,1,3,77811,77812,77815,1,4,0
22134,5,2,77816,77816,77818,0,2,1
22135,2,3,77818,77818,77821,0,3,0
22136,1,2,77819,77821,77823,2,4,0
22137,3,2,77822,77823,77825,1,3,0
22138,3,3,77825,77825,77828,0,3,0
22139,5,3,77830,77830,77833,0,3,2
22140,6,3,77836,77836,77839,0,3,3
22141,6,1,77842,77842,77843,0,1,3
22142,4,1,77846,77846,77847,0,1,3
22143,2,2,77848,77848,77850,0,2,1
22144,6,3,77854,77854,77857,0,3,4
22145,6,2,77860,77860,77862,0,2,3
22146,3,2,77863,77863,77865,0,2,1
22147,6,2,77869,77869,77871,0,2,4
22148,1,3,77870,77871,77874,1,4,0
22149,6,2,77876,77876,77878,0,2,2
22150,2,3,77878,77878,77881,0,3,0
22151,5,1,77883,77883,77884,0,1,2
22152,5,1,77888,77888,77889,0,1,4
22153,5,2,77893,77893,77895,0,2,4
22154,6,3,77899,77899,77902,0,3,4
22155,2,1,77901,77902,77903,1,2,0
22156,6,2,77907,77907,77909,0,2,4
22157,2,2,77909,77909,77911,0,2,0
22158,2,2,77911,77911,77913,0,2,0
22159,6,2,77917,77917,77919,0,2,4
22160,4,2,77921,77921,77923,0,2,2
22161,4,2,77925,77925,77927,0,2,2
22162,5,3,77930,77930,77933,0,3,3
22163,5,1,77935,77935,77936,0,1,2
22164,2,2,77937,77937,77939,0,2,1
22165,4,2,77941,77941,77943,0,2,2
22166,2,3,77943,77943,77946,0,3,0
22167,3,3,77946,77946,77949,0,3,0
22168,1,2,77947,77949,77951,2,4,0
22169,1,3,77948,77951,77954,3,6,0
22170,2,3,77950,77954,77957,4,7,0
22171,2,3,77952,77957,77960,5,8,0
22172,4,3,77956,77960,77963,4,7,0
22173,4,3,77960,77963,77966,3,6,0
22174,4,2,77964,77966,77968,2,4,0
22175,6,2,77970,77970,77972,0,2,2
22176,4,2,77974,77974,77976,0,2,2
22177,3,1,77977,77977,77978,0,1,1
22178,4,1,77981,77981,77982,0,1,3
22179,1,3,77982,77982,77985,0,3,0
22180,2,3,77984,77985,77988,1,4,0
22181,6,2,77990,77990,77992,0,2,2
22182,6,3,77996,77996,77999,0,3,4
22183,3,1,77999,77999,78000,0,1,0
22184,2,1,78001,78001,78002,0,1,1
22185,2,3,78003,78003,78006,0,3,1
22186,4,3,78007,78007,78010,0,3,1
22187,4,1,78011,78011,78012,0,1,1
22188,3,2,78014,78014,78016,0,2,2
22189,3,1,78017,78017,78018,0,1,1
22190,2,2,78019,78019,78021,0,2,1
22191,4,1,78023,78023,78024,0,1,2
22192,3,2,78026,78026,78028,0,2,2
22193,1,2,78027,78028,78030,1,3,0
22194,3,2,78030,78030,78032,0,2,0
22195,5,3,78035,78035,78038,0,3,3
22196,2,1,78037,78038,78039,1,2,0
22197,2,3,78039,78039,78042,0,3,0
22198,3,3,78042,78042,78045,0,3,0
22199,1,2,78043,78045,78047,2,4,0
22200,1,3,78044,78047,78050,3,6,0
22201,2,3,78046,78050,78053,4,7,0
22202,5,3,78051,78053,78056,2,5,0
22203,3,2,78054,78056,78058,2,4,0
22204,6,2,78060,78060,78062,0,2,2
22205,3,3,78063,78063,78066,0,3,1
22206,3,1,78066,78066,78067,0,1,0
22207,6,3,78072,78072,78075,0,3,5
22208,6,1,78078,78078,78079,0,1,3
22209,6,1,78084,78084,78085,0,1,5
22210,5,1,78089,78089,78090,0,1,4
22211,6,3,78095,78095,78098,0,3,5
22212,1,1,78096,78098,78099,2,3,0
22213,6,3,78102,78102,78105,0,3,3
22214,3,3,78105,78105,78108,0,3,0
22215,4,1,78109,78109,78110,0,1,1
22216,5,2,78114,78114,78116,0,2,4
22217,6,3,78120,78120,78123,0,3,4
22218,1,3,78121,78123,78126,2,5,0
22219,1,1,78122,78126,78127,4,5,0
22220,1,1,78123,78127,78128,4,5,0
22221,2,1,78125,78128,78129,3,4,0
22222,6,1,78131,78131,78132,0,1,2
22223,6,2,78137,78137,78139,0,2,5
22224,3,1,78140,78140,78141,0,1,1
22225,6,2,78146,78146,78148,0,2,5
22226,2,3,78148,78148,78151,0,3,0
22227,5,1,78153,78153,78154,0,1,2
22228,1,3,78154,78154,78157,0,3,0
22229,4,2,78158,78158,78160,0,2,1
22230,3,1,78161,78161,78162,0,1,1
22231,5,1,78166,78166,78167,0,1,4
22232,2,3,78168,78168,78171,0,3,1
22233,3,3,78171,78171,78174,0,3,0
22234,3,3,78174,78174,78177,0,3,0
22235,3,3,78177,78177,78180,0,3,0
22236,1,2,78178,78180,78182,2,4,0
22237,5,2,78183,78183,78185,0,2,1
22238,5,1,78188,78188,78189,0,1,3
22239,2,1,78190,78190,78191,0,1,1
22240,1,3,78191,78191,78194,0,3,0
22241,1,1,78192,78194,78195,2,3,0
22242,5,3,78197,78197,78200,0,3,2
22243,4,1,78201,78201,78202,0,1,1
22244,1,1,78202,78202,78203,0,1,0
22245,5,2,78207,78207,78209,0,2,4
22246,6,3,78213,78213,78216,0,3,4
22247,6,3,78219,78219,78222,0,3,3
22248,1,3,78220,78222,78225,2,5,0
22249,3,3,78223,78225,78228,2,5,0
22250,3,2,78226,78228,78230,2,4,0
22251,1,2,78227,78230,78232,3,5,0
22252,3,3,78230,78232,78235,2,5,0
22253,5,3,78235,78235,78238,0,3,0
22254,2,3,78237,78238,78241,1,4,0
22255,5,2,78242,78242,78244,0,2,1
22256,3,1,78245,78245,78246,0,1,1
22257,6,3,78251,78251,78254,0,3,5
22258,4,2,78255,78255,78257,0,2,1
22259,2,2,78257,78257,78259,0,2,0
22260,1,2,78258,78259,78261,1,3,0
22261,2,3,78260,78261,78264,1,4,0
22262,4,1,78264,78264,78265,0,1,0
22263,2,2,78266,78266,78268,0,2,1
22264,6,3,78272,78272,78275,0,3,4
22265,4,2,78276,78276,78278,0,2,1
22266,4,2,78280,78280,78282,0,2,2
22267,2,2,78282,78282,78284,0,2,0
22268,5,3,78287,78287,78290,0,3,3
22269,3,1,78290,78290,78291,0,1,0
22270,5,3,78295,78295,78298,0,3,4
22271,2,1,78297,78298,78299,1,2,0
22272,6,3,78303,78303,78306,0,3,4
22273,5,3,78308,78308,78311,0,3,2
22274,2,1,78310,78311,78312,1,2,0
22275,4,1,78314,78314,78315,0,1,2
22276,4,3,78318,78318,78321,0,3,3
22277,6,2,78324,78324,78326,0,2,3
22278,4,3,78328,78328,78331,0,3,2
22279,4,1,78332,78332,78333,0,1,1
22280,5,3,78337,78337,78340,0,3,4
22281,2,1,78339,78340,78341,1,2,0
22282,3,1,78342,78342,78343,0,1,1
22283,2,1,78344,78344,78345,0,1,1
22284,5,3,78349,78349,78352,0,3,4
22285,4,1,78353,78353,78354,0,1,1
22286,1,3,78354,78354,78357,0,3,0
22287,2,1,78356,78357,78358,1,2,0
22288,3,3,78359,78359,78362,0,3,1
22289,5,1,78364,78364,78365,0,1,2
22290,3,3,78367,78367,78370,0,3,2
22291,3,3,78370,78370,78373,0,3,0
22292,1,3,78371,78373,78376,2,5,0
22293,4,1,78375,78376,78377,1,2,0
22294,6,3,78381,78381,78384,0,3,4
22295,6,3,78387,78387,78390,0,3,3
22296,5,2,78392,78392,78394,0,2,2
22297,1,3,78393,78394,78397,1,4,0
22298,1,2,78394,78397,78399,3,5,0
22299,2,3,78396,78399,78402,3,6,0
22300,6,2,78402,78402,78404,0,2,0
22301,3,1,78405,78405,78406,0,1,1
22302,6,2,78411,78411,78413,0,2,5
22303,1,2,78412,78413,78415,1,3,0
22304,6,2,78418,78418,78420,0,2,3
22305,2,2,78420,78420,78422,0,2,0
22306,3,2,78423,78423,78425,0,2,1
22307,6,3,78429,78429,78432,0,3,4
22308,4,3,78433,78433,78436,0,3,1
22309,5,2,78438,78438,78440,0,2,2
22310,5,2,78443,78443,78445,0,2,3
22311,5,1,78448,78448,78449,0,1,3
22312,4,2,78452,78452,78454,0,2,3
22313,2,3,78454,78454,78457,0,3,0
22314,1,2,78455,78457,78459,2,4,0
22315,1,3,78456,78459,78462,3,6,0
22316,2,2,78458,78462,78464,4,6,0
22317,5,2,78463,78464,78466,1,3,0
22318,6,1,78469,78469,78470,0,1,3
22319,1,2,78470,78470,78472,0,2,0
22320,1,3,78471,78472,78475,1,4,0
22321,3,1,78474,78475,78476,1,2,0
22322,4,3,78478,78478,78481,0,3,2
22323,2,3,78480,78481,78484,1,4,0
22324,4,1,78484,78484,78485,0,1,0
22325,6,3,78490,78490,78493,0,3,5
22326,5,1,78495,78495,78496,0,1,2
22327,5,1,78500,78500,78501,0,1,4
22328,4,2,78504,78504,78506,0,2,3
22329,3,1,78507,78507,78508,0,1,1
22330,2,2,78509,78509,78511,0,2,1
22331,5,2,78514,78514,78516,0,2,3
22332,2,3,78516,78516,78519,0,3,0
22333,3,1,78519,78519,78520,0,1,0
22334,2,1,78521,78521,78522,0,1,1
22335,2,1,78523,78523,78524,0,1,1
22336,6,3,78529,78529,78532,0,3,5
22337,5,3,78534,78534,78537,0,3,2
22338,3,2,78537,78537,78539,0,2,0
22339,6,2,78543,78543,78545,0,2,4
22340,5,1,78548,78548,78549,0,1,3
22341,4,3,78552,78552,78555,0,3,3
22342,3,2,78555,78555,78557,0,2,0
22343,5,2,78560,78560,78562,0,2,3
22344,6,2,78566,78566,78568,0,2,4
22345,1,3,78567,78568,78571,1,4,0
22346,4,2,78571,78571,78573,0,2,0
22347,3,1,78574,78574,78575,0,1,1
22348,5,3,78579,78579,78582,0,3,4
22349,2,3,78581,78582,78585,1,4,0
22350,4,1,78585,78585,78586,0,1,0
22351,2,3,78587,78587,78590,0,3,1
22352,1,3,78588,78590,78593,2,5,0
22353,2,3,78590,78593,78596,3,6,0
22354,6,3,78596,78596,78599,0,3,0
22355,4,2,78600,78600,78602,0,2,1
22356,2,1,78602,78602,78603,0,1,0
22357,4,1,78606,78606,78607,0,1,3
22358,3,3,78609,78609,78612,0,3,2
22359,1,1,78610,78612,78613,2,3,0
22360,1,1,78611,78613,78614,2,3,0
22361,6,3,78617,78617,78620,0,3,3
22362,6,2,78623,78623,78625,0,2,3
22363,5,1,78628,78628,78629,0,1,3
22364,2,1,78630,78630,78631,0,1,1
22365,5,1,78635,78635,78636,0,1,4
22366,4,2,78639,78639,78641,0,2,3
22367,5,2,78644,78644,78646,0,2,3
22368,4,3,78648,78648,78651,0,3,2
22369,1,2,78649,78651,78653,2,4,0
22370,2,1,78651,78653,78654,2,3,0
22371,1,3,78652,78654,78657,2,5,0
22372,3,3,78655,78657,78660,2,5,0
22373,1,2,78656,78660,78662,4,6,0
22374,1,3,78657,78662,78665,5,8,0
22375,2,2,78659,78665,78667,6,8,0
22376,2,2,78661,78667,78669,6,8,0
22377,6,3,78667,78669,78672,2,5,0
22378,6,2,78673,78673,78675,0,2,1
22379,3,2,78676,78676,78678,0,2,1
22380,3,1,78679,78679,78680,0,1,1
22381,5,3,78684,78684,78687,0,3,4
22382,5,1,78689,78689,78690,0,1,2
22383,4,3,78693,78693,78696,0,3,3
22384,3,1,78696,78696,78697,0,1,0
22385,6,1,78702,78702,78703,0,1,5
22386,4,1,78706,78706,78707,0,1,3
22387,5,3,78711,78711,78714,0,3,4
22388,6,3,78717,78717,78720,0,3,3
22389,1,2,78718,78720,78722,2,4,0
22390,1,1,78719,78722,78723,3,4,0
22391,2,2,78721,78723,78725,2,4,0
22392,4,1,78725,78725,78726,0,1,0
22393,1,2,78726,78726,78728,0,2,0
22394,3,1,78729,78729,78730,0,1,1
22395,5,2,78734,78734,78736,0,2,4
22396,2,3,78736,78736,78739,0,3,0
22397,4,1,78740,78740,78741,0,1,1
22398,4,3,78744,78744,78747,0,3,3
22399,2,1,78746,78747,78748,1,2,0
22400,4,1,78750,78750,78751,0,1,2
22401,5,3,78755,78755,78758,0,3,4
22402,6,1,78761,78761,78762,0,1,3
22403,2,3,78763,78763,78766,0,3,1
22404,4,3,78767,78767,78770,0,3,1
22405,5,3,78772,78772,78775,0,3,2
22406,4,2,78776,78776,78778,0,2,1
22407,2,3,78778,78778,78781,0,3,0
22408,3,2,78781,78781,78783,0,2,0
22409,3,3,78784,78784,78787,0,3,1
22410,3,1,78787,78787,78788,0,1,0
22411,2,1,78789,78789,78790,0,1,1
22412,5,1,78794,78794,78795,0,1,4
22413,5,2,78799,78799,78801,0,2,4
22414,1,3,78800,78801,78804,1,4,0
22415,5,1,78805,78805,78806,0,1,1
22416,6,3,78811,78811,78814,0,3,5
22417,5,3,78816,78816,78819,0,3,2
22418,6,2,78822,78822,78824,0,2,3
22419,1,3,78823,78824,78827,1,4,0
22420,2,1,78825,78827,78828,2,3,0
22421,5,3,78830,78830,78833,0,3,2
22422,1,2,78831,78833,78835,2,4,0
22423,3,3,78834,78835,78838,1,4,0
22424,2,2,78836,78838,78840,2,4,0
22425,2,1,78838,78840,78841,2,3,0
22426,2,2,78840,78841,78843,1,3,0
22427,3,3,78843,78843,78846,0,3,0
22428,3,1,78846,78846,78847,0,1,0
22429,1,1,78847,78847,78848,0,1,0
22430,3,3,78850,78850,78853,0,3,2
22431,5,1,78855,78855,78856,0,1,2
22432,1,3,78856,78856,78859,0,3,0
22433,1,3,78857,78859,78862,2,5,0
22434,2,2,78859,78862,78864,3,5,0
22435,5,1,78864,78864,78865,0,1,0
22436,5,3,78869,78869,78872,0,3,4
22437,2,2,78871,78872,78874,1,3,0
22438,5,3,78876,78876,78879,0,3,2
22439,5,3,78881,78881,78884,0,3,2
22440,3,2,78884,78884,78886,0,2,0
22441,2,1,78886,78886,78887,0,1,0
22442,3,2,78889,78889,78891,0,2,2
22443,3,3,78892,78892,78895,0,3,1
22444,5,1,78897,78897,78898,0,1,2
22445,6,1,78903,78903,78904,0,1,5
22446,2,3,78905,78905,78908,0,3,1
22447,3,2,78908,78908,78910,0,2,0
22448,4,1,78912,78912,78913,0,1,2
22449,1,1,78913,78913,78914,0,1,0
22450,2,2,78915,78915,78917,0,2,1
22451,4,1,78919,78919,78920,0,1,2
22452,6,3,78925,78925,78928,0,3,5
22453,3,1,78928,78928,78929,0,1,0
22454,3,1,78931,78931,78932,0,1,2
22455,3,2,78934,78934,78936,0,2,2
22456,1,2,78935,78936,78938,1,3,0
22457,5,3,78940,78940,78943,0,3,2
22458,2,1,78942,78943,78944,1,2,0
22459,4,3,78946,78946,78949,0,3,2
22460,3,1,78949,78949,78950,0,1,0
22461,6,1,78955,78955,78956,0,1,5
22462,4,2,78959,78959,78961,0,2,3
22463,4,1,78963,78963,78964,0,1,2
22464,4,2,78967,78967,78969,0,2,3
22465,1,2,78968,78969,78971,1,3,0
22466,1,3,78969,78971,78974,2,5,0
22467,1,2,78970,78974,78976,4,6,0
22468,2,3,78972,78976,78979,4,7,0
22469,6,3,78978,78979,78982,1,4,0
22470,6,1,78984,78984,78985,0,1,2
22471,1,1,78985,78985,78986,0,1,0
22472,6,1,78991,78991,78992,0,1,5
22473,2,1,78993,78993,78994,0,1,1
22474,4,2,78997,78997,78999,0,2,3
22475,1,1,78998,78999,79000,1,2,0
22476,6,3,79004,79004,79007,0,3,4
22477,4,2,79008,79008,79010,0,2,1
22478,1,1,79009,79010,79011,1,2,0
22479,4,3,79013,79013,79016,0,3,2
22480,5,3,79018,79018,79021,0,3,2
22481,4,1,79022,79022,79023,0,1,1
22482,4,2,79026,79026,79028,0,2,3
22483,2,3,79028,79028,79031,0,3,0
22484,2,1,79030,79031,79032,1,2,0
22485,6,3,79036,79036,79039,0,3,4
22486,1,3,79037,79039,79042,2,5,0
22487,2,2,79039,79042,79044,3,5,0
22488,6,1,79045,79045,79046,0,1,1
22489,2,3,79047,79047,79050,0,3,1
22490,2,2,79049,79050,79052,1,3,0
22491,1,2,79050,79052,79054,2,4,0
22492,4,2,79054,79054,79056,0,2,0
22493,1,1,79055,79056,79057,1,2,0
22494,5,2,79060,79060,79062,0,2,3
22495,3,1,79063,79063,79064,0,1,1
22496,1,1,79064,79064,79065,0,1,0
22497,1,2,79065,79065,79067,0,2,0
22498,1,3,79066,79067,79070,1,4,0
22499,6,3,79072,79072,79075,0,3,2
22500,1,2,79073,79075,79077,2,4,0
22501,1,3,79074,79077,79080,3,6,0
22502,1,1,79075,79080,79081,5,6,0
22503,5,2,79080,79081,79083,1,3,0
22504,3,3,79083,79083,79086,0,3,0
22505,6,3,79089,79089,79092,0,3,3
22506,4,2,79093,79093,79095,0,2,1
22507,1,1,79094,79095,79096,1,2,0
22508,4,1,79098,79098,79099,0,1,2
22509,4,1,79102,79102,79103,0,1,3
22510,6,3,79108,79108,79111,0,3,5
22511,2,2,79110,79111,79113,1,3,0
22512,5,1,79115,79115,79116,0,1,2
22513,6,3,79121,79121,79124,0,3,5
22514,6,2,79127,79127,79129,0,2,3
22515,6,3,79133,79133,79136,0,3,4
22516,2,1,79135,79136,79137,1,2,0
22517,1,3,79136,79137,79140,1,4,0
22518,2,2,79138,79140,79142,2,4,0
22519,5,2,79143,79143,79145,0,2,1
22520,1,2,79144,79145,79147,1,3,0
22521,3,3,79147,79147,79150,0,3,0
22522,4,1,79151,79151,79152,0,1,1
22523,2,2,79153,79153,79155,0,2,1
22524,4,3,79157,79157,79160,0,3,2
22525,6,1,79163,79163,79164,0,1,3
22526,4,1,79167,79167,79168,0,1,3
22527,1,3,79168,79168,79171,0,3,0
22528,1,3,79169,79171,79174,2,5,0
22529,6,3,79175,79175,79178,0,3,1
22530,5,1,79180,79180,79181,0,1,2
22531,1,2,79181,79181,79183,0,2,0
22532,6,1,79187,79187,79188,0,1,4
22533,2,3,79189,79189,79192,0,3,1
22534,4,2,79193,79193,79195,0,2,1
22535,6,3,79199,79199,79202,0,3,4
22536,3,3,79202,79202,79205,0,3,0
22537,3,3,79205,79205,79208,0,3,0
22538,6,1,79211,79211,79212,0,1,3
22539,1,3,79212,79212,79215,0,3,0
22540,1,3,79213,79215,79218,2,5,0
22541,5,2,79218,79218,79220,0,2,0
22542,6,2,79224,79224,79226,0,2,4
22543,1,1,79225,79226,79227,1,2,0
22544,3,1,79228,79228,79229,0,1,1
22545,6,1,79234,79234,79235,0,1,5
22546,6,3,79240,79240,79243,0,3,5
22547,1,2,79241,79243,79245,2,4,0
22548,2,1,79243,79245,79246,2,3,0
22549,1,1,79244,79246,79247,2,3,0
22550,5,2,79249,79249,79251,0,2,2
22551,1,1,79250,79251,79252,1,2,0
22552,5,1,79255,79255,79256,0,1,3
22553,4,2,79259,79259,79261,0,2,3
22554,2,3,79261,79261,79264,0,3,0
22555,1,3,79262,79264,79267,2,5,0
22556,2,3,79264,79267,79270,3,6,0
22557,6,3,79270,79270,79273,0,3,0
22558,1,1,79271,79273,79274,2,3,0
22559,5,3,79276,79276,79279,0,3,2
22560,6,3,79282,79282,79285,0,3,3
22561,4,3,79286,79286,79289,0,3,1
22562,4,3,79290,79290,79293,0,3,1
22563,1,1,79291,79293,79294,2,3,0
22564,4,1,79295,79295,79296,0,1,1
22565,3,3,79298,79298,79301,0,3,2
22566,1,2,79299,79301,79303,2,4,0
22567,4,1,79303,79303,79304,0,1,0
22568,6,3,79309,79309,79312,0,3,5
22569,4,3,79313,79313,79316,0,3,1
22570,6,1,79319,79319,79320,0,1,3
22571,4,2,79323,79323,79325,0,2,3
22572,2,1,79325,79325,79326,0,1,0
22573,5,3,79330,79330,79333,0,3,4
22574,5,3,79335,79335,79338,0,3,2
22575,1,3,79336,79338,79341,2,5,0
22576,3,3,79339,79341,79344,2,5,0
22577,1,2,79340,79344,79346,4,6,0
22578,1,1,79341,79346,79347,5,6,0
22579,1,3,79342,79347,79350,5,8,0
22580,6,3,79348,79350,79353,2,5,0
22581,2,1,79350,79353,79354,3,4,0
22582,3,3,79353,79354,79357,1,4,0
22583,6,3,79359,79359,79362,0,3,2
22584,1,2,79360,79362,79364,2,4,0
22585,3,3,79363,79364,79367,1,4,0
22586,2,1,79365,79367,79368,2,3,0
22587,1,3,79366,79368,79371,2,5,0
22588,4,3,79370,79371,79374,1,4,0
22589,2,1,79372,79374,79375,2,3,0
22590,6,2,79378,79378,79380,0,2,3
22591,3,1,79381,79381,79382,0,1,1
22592,2,1,79383,79383,79384,0,1,1
22593,3,3,79386,79386,79389,0,3,2
22594,2,2,79388,79389,79391,1,3,0
22595,3,2,79391,79391,79393,0,2,0
22596,5,2,79396,79396,79398,0,2,3
22597,6,3,79402,79402,79405,0,3,4
22598,4,3,79406,79406,79409,0,3,1
22599,1,1,79407,79409,79410,2,3,0
22600,6,3,79413,79413,79416,0,3,3
22601,3,2,79416,79416,79418,0,2,0
22602,4,1,79420,79420,79421,0,1,2
22603,3,3,79423,79423,79426,0,3,2
22604,1,3,79424,79426,79429,2,5,0
22605,4,2,79428,79429,79431,1,3,0
22606,3,3,79431,79431,79434,0,3,0
22607,1,3,79432,79434,79437,2,5,0
22608,3,3,79435,79437,79440,2,5,0
22609,4,1,79439,79440,79441,1,2,0
22610,1,2,79440,79441,79443,1,3,0
22611,2,1,79442,79443,79444,1,2,0
22612,2,3,79444,79444,79447,0,3,0
22613,5,1,79449,79449,79450,0,1,2
22614,3,3,79452,79452,79455,0,3,2
22615,2,3,79454,79455,79458,1,4,0
22616,4,1,79458,79458,79459,0,1,0
22617,2,3,79460,79460,79463,0,3,1
22618,6,3,79466,79466,79469,0,3,3
22619,1,3,79467,79469,79472,2,5,0
22620,1,2,79468,79472,79474,4,6,0
22621,2,2,79470,79474,79476,4,6,0
22622,1,2,79471,79476,79478,5,7,0
22623,3,1,79474,79478,79479,4,5,0
22624,5,1,79479,79479,79480,0,1,0
22625,1,2,79480,79480,79482,0,2,0
22626,4,1,79484,79484,79485,0,1,2
22627,6,2,79490,79490,79492,0,2,5
22628,4,2,79494,79494,79496,0,2,2
22629,5,2,79499,79499,79501,0,2,3
22630,5,2,79504,79504,79506,0,2,3
22631,5,1,79509,79509,79510,0,1,3
22632,2,3,79511,79511,79514,0,3,1
22633,1,2,79512,79514,79516,2,4,0
22634,4,1,79516,79516,79517,0,1,0
22635,6,1,79522,79522,79523,0,1,5
22636,3,1,79525,79525,79526,0,1,2
22637,2,2,79527,79527,79529,0,2,1
22638,3,2,79530,79530,79532,0,2,1
22639,2,1,79532,79532,79533,0,1,0
22640,4,1,79536,79536,79537,0,1,3
22641,1,1,79537,79537,79538,0,1,0
22642,3,1,79540,79540,79541,0,1,2
22643,5,1,79545,79545,79546,0,1,4
22644,6,2,79551,79551,79553,0,2,5
22645,2,1,79553,79553,79554,0,1,0
22646,5,3,79558,79558,79561,0,3,4
22647,6,3,79564,79564,79567,0,3,3
22648,5,1,79569,79569,79570,0,1,2
22649,1,2,79570,79570,79572,0,2,0
22650,2,3,79572,79572,79575,0,3,0
22651,6,1,79578,79578,79579,0,1,3
22652,2,3,79580,79580,79583,0,3,1
22653,1,1,79581,79583,79584,2,3,0
22654,3,2,79584,79584,79586,0,2,0
22655,2,2,79586,79586,79588,0,2,0
22656,5,3,79591,79591,79594,0,3,3
22657,6,3,79597,79597,79600,0,3,3
22658,2,2,79599,79600,79602,1,3,0
22659,4,3,79603,79603,79606,0,3,1
22660,1,3,79604,79606,79609,2,5,0
22661,4,2,79608,79609,79611,1,3,0
22662,1,2,79609,79611,79613,2,4,0
22663,3,2,79612,79613,79615,1,3,0
22664,3,2,79615,79615,79617,0,2,0
22665,5,3,79620,79620,79623,0,3,3
22666,2,2,79622,79623,79625,1,3,0
22667,6,2,79628,79628,79630,0,2,3
22668,2,1,79630,79630,79631,0,1,0
22669,2,3,79632,79632,79635,0,3,1
22670,2,1,79634,79635,79636,1,2,0
22671,2,1,79636,79636,79637,0,1,0
22672,2,2,79638,79638,79640,0,2,1
22673,6,3,79644,79644,79647,0,3,4
22674,2,3,79646,79647,79650,1,4,0
22675,1,3,79647,79650,79653,3,6,0
22676,3,1,79650,79653,79654,3,4,0
22677,1,2,79651,79654,79656,3,5,0
22678,2,3,79653,79656,79659,3,6,0
22679,4,1,79657,79659,79660,2,3,0
22680,2,1,79659,79660,79661,1,2,0
22681,2,2,79661,79661,79663,0,2,0
22682,5,1,79666,79666,79667,0,1,3
22683,1,2,79667,79667,79669,0,2,0
22684,6,3,79673,79673,79676,0,3,4
22685,6,3,79679,79679,79682,0,3,3
22686,1,1,79680,79682,79683,2,3,0
22687,3,2,79683,79683,79685,0,2,0
22688,1,1,79684,79685,79686,1,2,0
22689,2,1,79686,79686,79687,0,1,0
22690,6,2,79692,79692,79694,0,2,5
22691,4,1,79696,79696,79697,0,1,2
22692,3,3,79699,79699,79702,0,3,2
22693,5,1,79704,79704,79705,0,1,2
22694,2,3,79706,79706,79709,0,3,1
22695,3,1,79709,79709,79710,0,1,0
22696,3,3,79712,79712,79715,0,3,2
22697,2,2,79714,79715,79717,1,3,0
22698,3,3,79717,79717,79720,0,3,0
22699,1,2,79718,79720,79722,2,4,0
22700,6,3,79724,79724,79727,0,3,2
22701,3,3,79727,79727,79730,0,3,0
22702,2,3,79729,79730,79733,1,4,0
22703,3,3,79732,79733,79736,1,4,0
22704,3,3,79735,79736,79739,1,4,0
22705,2,3,79737,79739,79742,2,5,0
22706,5,3,79742,79742,79745,0,3,0
22707,3,3,79745,79745,79748,0,3,0
22708,6,3,79751,79751,79754,0,3,3
22709,2,1,79753,79754,79755,1,2,0
22710,3,3,79756,79756,79759,0,3,1
22711,6,2,79762,79762,79764,0,2,3
22712,1,2,79763,79764,79766,1,3,0
22713,3,3,79766,79766,79769,0,3,0
22714,5,1,79771,79771,79772,0,1,2
22715,6,3,79777,79777,79780,0,3,5
22716,4,3,79781,79781,79784,0,3,1
22717,2,1,79783,79784,79785,1,2,0
22718,5,1,79788,79788,79789,0,1,3
22719,6,2,79794,79794,79796,0,2,5
22720,4,3,79798,79798,79801,0,3,2
22721,2,3,79800,79801,79804,1,4,0
22722,2,2,79802,79804,79806,2,4,0
22723,3,3,79805,79806,79809,1,4,0
22724,4,2,79809,79809,79811,0,2,0
22725,1,3,79810,79811,79814,1,4,0
22726,4,1,79814,79814,79815,0,1,0
22727,2,3,79816,79816,79819,0,3,1
22728,6,1,79822,79822,79823,0,1,3
22729,5,3,79827,79827,79830,0,3,4
22730,4,3,79831,79831,79834,0,3,1
22731,5,3,79836,79836,79839,0,3,2
22732,6,1,79842,79842,79843,0,1,3
22733,1,1,79843,79843,79844,0,1,0
22734,4,3,79847,79847,79850,0,3,3
22735,1,2,79848,79850,79852,2,4,0
22736,2,1,79850,79852,79853,2,3,0
22737,5,3,79855,79855,79858,0,3,2
22738,6,3,79861,79861,79864,0,3,3
22739,4,1,79865,79865,79866,0,1,1
22740,1,3,79866,79866,79869,0,3,0
22741,5,2,79871,79871,79873,0,2,2
22742,4,1,79875,79875,79876,0,1,2
22743,6,3,79881,79881,79884,0,3,5
22744,3,3,79884,79884,79887,0,3,0
22745,4,2,79888,79888,79890,0,2,1
22746,4,1,79892,79892,79893,0,1,2
22747,1,3,79893,79893,79896,0,3,0
22748,5,2,79898,79898,79900,0,2,2
22749,3,3,79901,79901,79904,0,3,1
22750,2,2,79903,79904,79906,1,3,0
22751,4,1,79907,79907,79908,0,1,1
22752,5,3,79912,79912,79915,0,3,4
22753,2,2,79914,79915,79917,1,3,0
22754,2,3,79916,79917,79920,1,4,0
22755,5,3,79921,79921,79924,0,3,1
22756,1,2,79922,79924,79926,2,4,0
22757,2,3,79924,79926,79929,2,5,0
22758,5,2,79929,79929,79931,0,2,0
22759,6,1,79935,79935,79936,0,1,4
22760,1,3,79936,79936,79939,0,3,0
22761,1,3,79937,79939,79942,2,5,0
22762,4,2,79941,79942,79944,1,3,0
22763,3,1,79944,79944,79945,0,1,0
22764,4,1,79948,79948,79949,0,1,3
22765,1,3,79949,79949,79952,0,3,0
22766,2,2,79951,79952,79954,1,3,0
22767,3,3,79954,79954,79957,0,3,0
22768,6,2,79960,79960,79962,0,2,3
22769,2,3,79962,79962,79965,0,3,0
22770,3,3,79965,79965,79968,0,3,0
22771,1,1,79966,79968,79969,2,3,0
22772,6,3,79972,79972,79975,0,3,3
22773,1,1,79973,79975,79976,2,3,0
22774,2,2,79975,79976,79978,1,3,0
22775,4,3,79979,79979,79982,0,3,1
22776,2,1,79981,79982,79983,1,2,0
22777,3,1,79984,79984,79985,0,1,1
22778,5,1,79989,79989,79990,0,1,4
22779,2,2,79991,79991,79993,0,2,1
22780,4,2,79995,79995,79997,0,2,2
22781,4,1,79999,79999,80000,0,1,2
22782,1,2,80000,80000,80002,0,2,0
22783,4,2,80004,80004,80006,0,2,2
22784,4,2,80008,80008,80010,0,2,2
22785,6,3,80014,80014,80017,0,3,4
22786,3,2,80017,80017,80019,0,2,0
22787,1,1,80018,80019,80020,1,2,0
22788,2,1,80020,80020,80021,0,1,0
22789,1,2,80021,80021,80023,0,2,0
22790,2,3,80023,80023,80026,0,3,0
22791,5,3,80028,80028,80031,0,3,2
22792,5,3,80033,80033,80036,0,3,2
22793,6,2,80039,80039,80041,0,2,3
22794,1,1,80040,80041,80042,1,2,0
22795,2,1,80042,80042,80043,0,1,0
22796,3,1,80045,80045,80046,0,1,2
22797,6,2,80051,80051,80053,0,2,5
22798,3,2,80054,80054,80056,0,2,1
22799,5,1,80059,80059,80060,0,1,3
22800,4,3,80063,80063,80066,0,3,3
22801,5,2,80068,80068,80070,0,2,2
22802,5,2,80073,80073,80075,0,2,3
22803,2,2,80075,80075,80077,0,2,0
22804,4,2,80079,80079,80081,0,2,2
22805,6,1,80085,80085,80086,0,1,4
22806,4,3,80089,80089,80092,0,3,3
22807,2,3,80091,80092,80095,1,4,0
22808,5,1,80096,80096,80097,0,1,1
22809,2,3,80098,80098,80101,0,3,1
22810,1,1,80099,80101,80102,2,3,0
22811,1,2,80100,80102,80104,2,4,0
22812,3,2,80103,80104,80106,1,3,0
22813,3,3,80106,80106,80109,0,3,0
22814,4,2,80110,80110,80112,0,2,1
22815,5,3,80115,80115,80118,0,3,3
22816,2,1,80117,80118,80119,1,2,0
22817,1,1,80118,80119,80120,1,2,0
22818,6,1,80124,80124,80125,0,1,4
22819,4,3,80128,80128,80131,0,3,3
22820,1,2,80129,80131,80133,2,4,0
22821,4,2,80133,80133,80135,0,2,0
22822,3,3,80136,80136,80139,0,3,1
22823,3,2,80139,80139,80141,0,2,0
22824,6,1,80145,80145,80146,0,1,4
22825,1,1,80146,80146,80147,0,1,0
22826,2,3,80148,80148,80151,0,3,1
22827,5,2,80153,80153,80155,0,2,2
22828,1,1,80154,80155,80156,1,2,0
22829,1,1,80155,80156,80157,1,2,0
22830,1,1,80156,80157,80158,1,2,0
22831,1,1,80157,80158,80159,1,2,0
22832,3,1,80160,80160,80161,0,1,1
22833,3,2,80163,80163,80165,0,2,2
22834,6,2,80169,80169,80171,0,2,4
22835,4,3,80173,80173,80176,0,3,2
22836,4,2,80177,80177,80179,0,2,1
22837,3,3,80180,80180,80183,0,3,1
22838,6,3,80186,80186,80189,0,3,3
22839,2,3,80188,80189,80192,1,4,0
22840,6,3,80194,80194,80197,0,3,2
22841,2,3,80196,80197,80200,1,4,0
22842,2,3,80198,80200,80203,2,5,0
22843,6,3,80204,80204,80207,0,3,1
22844,6,1,80210,80210,80211,0,1,3
22845,5,1,80215,80215,80216,0,1,4
22846,3,1,80218,80218,80219,0,1,2
22847,2,3,80220,80220,80223,0,3,1
22848,1,1,80221,80223,80224,2,3,0
22849,3,3,80224,80224,80227,0,3,0
22850,2,3,80226,80227,80230,1,4,0
22851,6,3,80232,80232,80235,0,3,2
22852,1,3,80233,80235,80238,2,5,0
22853,2,3,80235,80238,80241,3,6,0
22854,1,2,80236,80241,80243,5,7,0
22855,6,2,80242,80243,80245,1,3,0
22856,4,1,80246,80246,80247,0,1,1
22857,4,3,80250,80250,80253,0,3,3
22858,1,1,80251,80253,80254,2,3,0
22859,3,1,80254,80254,80255,0,1,0
22860,2,2,80256,80256,80258,0,2,1
22861,5,3,80261,80261,80264,0,3,3
22862,1,1,80262,80264,80265,2,3,0
22863,5,3,80267,80267,80270,0,3,2
22864,5,2,80272,80272,80274,0,2,2
22865,6,1,80278,80278,80279,0,1,4
22866,5,2,80283,80283,80285,0,2,4
22867,2,1,80285,80285,80286,0,1,0
22868,3,3,80288,80288,80291,0,3,2
22869,6,3,80294,80294,80297,0,3,3
22870,3,3,80297,80297,80300,0,3,0
22871,2,1,80299,80300,80301,1,2,0
22872,6,3,80305,80305,80308,0,3,4
22873,4,1,80309,80309,80310,0,1,1
22874,3,1,80312,80312,80313,0,1,2
22875,2,2,80314,80314,80316,0,2,1
22876,5,2,80319,80319,80321,0,2,3
22877,4,2,80323,80323,80325,0,2,2
22878,5,2,80328,80328,80330,0,2,3
22879,2,3,80330,80330,80333,0,3,0
22880,2,3,80332,80333,80336,1,4,0
22881,4,1,80336,80336,80337,0,1,0
22882,1,2,80337,80337,80339,0,2,0
22883,2,1,80339,80339,80340,0,1,0
22884,6,1,80345,80345,80346,0,1,5
22885,3,3,80348,80348,80351,0,3,2
22886,2,3,80350,80351,80354,1,4,0
22887,4,1,80354,80354,80355,0,1,0
22888,1,1,80355,80355,80356,0,1,0
22889,2,2,80357,80357,80359,0,2,1
22890,5,2,80362,80362,80364,0,2,3
22891,5,2,80367,80367,80369,0,2,3
22892,3,1,80370,80370,80371,0,1,1
22893,5,2,80375,80375,80377,0,2,4
22894,1,1,80376,80377,80378,1,2,0
22895,3,3,80379,80379,80382,0,3,1
22896,4,2,80383,80383,80385,0,2,1
22897,4,1,80387,80387,80388,0,1,2
22898,1,3,80388,80388,80391,0,3,0
22899,1,3,80389,80391,80394,2,5,0
22900,3,1,80392,80394,80395,2,3,0
22901,1,3,80393,80395,80398,2,5,0
22902,2,1,80395,80398,80399,3,4,0
22903,4,1,80399,80399,80400,0,1,0
22904,5,2,80404,80404,80406,0,2,4
22905,4,3,80408,80408,80411,0,3,2
22906,5,1,80413,80413,80414,0,1,2
22907,6,2,80419,80419,80421,0,2,5
22908,4,2,80423,80423,80425,0,2,2
22909,5,2,80428,80428,80430,0,2,3
22910,2,2,80430,80430,80432,0,2,0
22911,4,1,80434,80434,80435,0,1,2
22912,5,1,80439,80439,80440,0,1,4
22913,1,1,80440,80440,80441,0,1,0
22914,3,1,80443,80443,80444,0,1,2
22915,4,2,80447,80447,80449,0,2,3
22916,4,1,80451,80451,80452,0,1,2
22917,1,1,80452,80452,80453,0,1,0
22918,6,3,80458,80458,80461,0,3,5
22919,1,3,80459,80461,80464,2,5,0
22920,3,2,80462,80464,80466,2,4,0
22921,1,1,80463,80466,80467,3,4,0
22922,6,1,80469,80469,80470,0,1,2
22923,1,3,80470,80470,80473,0,3,0
22924,1,3,80471,80473,80476,2,5,0
22925,1,3,80472,80476,80479,4,7,0
22926,4,2,80476,80479,80481,3,5,0
22927,5,3,80481,80481,80484,0,3,0
22928,6,2,80487,80487,80489,0,2,3
22929,2,3,80489,80489,80492,0,3,0
22930,2,3,80491,80492,80495,1,4,0
22931,4,3,80495,80495,80498,0,3,0
22932,6,1,80501,80501,80502,0,1,3
22933,2,3,80503,80503,80506,0,3,1
22934,6,3,80509,80509,80512,0,3,3
22935,3,2,80512,80512,80514,0,2,0
22936,1,1,80513,80514,80515,1,2,0
22937,2,3,80515,80515,80518,0,3,0
22938,3,2,80518,80518,80520,0,2,0
22939,4,1,80522,80522,80523,0,1,2
22940,4,1,80526,80526,80527,0,1,3
22941,6,1,80532,80532,80533,0,1,5
22942,6,1,80538,80538,80539,0,1,5
22943,5,2,80543,80543,80545,0,2,4
22944,5,3,80548,80548,80551,0,3,3
22945,5,2,80553,80553,80555,0,2,2
22946,6,3,80559,80559,80562,0,3,4
22947,6,1,80565,80565,80566,0,1,3
22948,5,1,80570,80570,80571,0,1,4
22949,5,3,80575,80575,80578,0,3,4
22950,1,2,80576,80578,80580,2,4,0
22951,4,3,80580,80580,80583,0,3,0
22952,6,2,80586,80586,80588,0,2,3
22953,4,3,80590,80590,80593,0,3,2
22954,6,2,80596,80596,80598,0,2,3
22955,2,1,80598,80598,80599,0,1,0
22956,5,2,80603,80603,80605,0,2,4
22957,5,3,80608,80608,80611,0,3,3
22958,6,3,80614,80614,80617,0,3,3
22959,6,1,80620,80620,80621,0,1,3
22960,2,2,80622,80622,80624,0,2,1
22961,6,3,80628,80628,80631,0,3,4
22962,1,3,80629,80631,80634,2,5,0
22963,2,1,80631,80634,80635,3,4,0
22964,5,1,80636,80636,80637,0,1,1
22965,6,3,80642,80642,80645,0,3,5
22966,2,3,80644,80645,80648,1,4,0
22967,1,1,80645,80648,80649,3,4,0
22968,2,3,80647,80649,80652,2,5,0
22969,1,1,80648,80652,80653,4,5,0
22970,3,2,80651,80653,80655,2,4,0
22971,4,2,80655,80655,80657,0,2,0
22972,3,3,80658,80658,80661,0,3,1
22973,2,1,80660,80661,80662,1,2,0
22974,3,1,80663,80663,80664,0,1,1
22975,3,2,80666,80666,80668,0,2,2
22976,2,1,80668,80668,80669,0,1,0
22977,2,1,80670,80670,80671,0,1,1
22978,5,1,80675,80675,80676,0,1,4
22979,6,1,80681,80681,80682,0,1,5
22980,5,2,80686,80686,80688,0,2,4
22981,1,2,80687,80688,80690,1,3,0
22982,6,2,80693,80693,80695,0,2,3
22983,2,3,80695,80695,80698,0,3,0
22984,6,3,80701,80701,80704,0,3,3
22985,2,3,80703,80704,80707,1,4,0
22986,5,3,80708,80708,80711,0,3,1
22987,5,1,80713,80713,80714,0,1,2
22988,6,1,80719,80719,80720,0,1,5
22989,5,3,80724,80724,80727,0,3,4
22990,2,3,80726,80727,80730,1,4,0
22991,5,3,80731,80731,80734,0,3,1
22992,4,2,80735,80735,80737,0,2,1
22993,3,2,80738,80738,80740,0,2,1
22994,2,2,80740,80740,80742,0,2,0
22995,1,2,80741,80742,80744,1,3,0
22996,6,3,80747,80747,80750,0,3,3
22997,5,1,80752,80752,80753,0,1,2
22998,1,2,80753,80753,80755,0,2,0
22999,3,2,80756,80756,80758,0,2,1
23000,2,2,80758,80758,80760,0,2,0
23001,6,1,80764,80764,80765,0,1,4
23002,4,3,80768,80768,80771,0,3,3
23003,3,1,80771,80771,80772,0,1,0
23004,6,1,80777,80777,80778,0,1,5
23005,2,1,80779,80779,80780,0,1,1
23006,2,3,80781,80781,80784,0,3,1
23007,5,1,80786,80786,80787,0,1,2
23008,6,1,80792,80792,80793,0,1,5
23009,1,3,80793,80793,80796,0,3,0
23010,2,2,80795,80796,80798,1,3,0
23011,4,1,80799,80799,80800,0,1,1
23012,2,2,80801,80801,80803,0,2,1
23013,5,1,80806,80806,80807,0,1,3
23014,2,1,80808,80808,80809,0,1,1
23015,6,3,80814,80814,80817,0,3,5
23016,6,3,80820,80820,80823,0,3,3
23017,6,2,80826,80826,80828,0,2,3
23018,1,1,80827,80828,80829,1,2,0
23019,2,2,80829,80829,80831,0,2,0
23020,5,2,80834,80834,80836,0,2,3
23021,6,2,80840,80840,80842,0,2,4
23022,4,1,80844,80844,80845,0,1,2
23023,5,3,80849,80849,80852,0,3,4
23024,4,3,80853,80853,80856,0,3,1
23025,6,2,80859,80859,80861,0,2,3
23026,1,3,80860,80861,80864,1,4,0
23027,4,1,80864,80864,80865,0,1,0
23028,3,2,80867,80867,80869,0,2,2
23029,2,1,80869,80869,80870,0,1,0
23030,1,3,80870,80870,80873,0,3,0
23031,6,2,80876,80876,80878,0,2,3
23032,2,2,80878,80878,80880,0,2,0
23033,1,3,80879,80880,80883,1,4,0
23034,3,3,80882,80883,80886,1,4,0
23035,2,2,80884,80886,80888,2,4,0
23036,4,3,80888,80888,80891,0,3,0
23037,2,2,80890,80891,80893,1,3,0
23038,5,1,80895,80895,80896,0,1,2
23039,1,3,80896,80896,80899,0,3,0
23040,2,3,80898,80899,80902,1,4,0
23041,5,3,80903,80903,80906,0,3,1
23042,3,3,80906,80906,80909,0,3,0
23043,3,1,80909,80909,80910,0,1,0
23044,1,3,80910,80910,80913,0,3,0
23045,2,2,80912,80913,80915,1,3,0
23046,3,2,80915,80915,80917,0,2,0
23047,2,1,80917,80917,80918,0,1,0
23048,1,2,80918,80918,80920,0,2,0
23049,2,3,80920,80920,80923,0,3,0
23050,1,3,80921,80923,80926,2,5,0
23051,3,1,80924,80926,80927,2,3,0
23052,2,3,80926,80927,80930,1,4,0
23053,2,2,80928,80930,80932,2,4,0
23054,3,1,80931,80932,80933,1,2,0
23055,6,1,80937,80937,80938,0,1,4
23056,5,1,80942,80942,80943,0,1,4
23057,1,1,80943,80943,80944,0,1,0
23058,4,3,80947,80947,80950,0,3,3
23059,6,3,80953,80953,80956,0,3,3
23060,1,3,80954,80956,80959,2,5,0
23061,4,2,80958,80959,80961,1,3,0
23062,2,3,80960,80961,80964,1,4,0
23063,4,3,80964,80964,80967,0,3,0
23064,6,2,80970,80970,80972,0,2,3
23065,4,3,80974,80974,80977,0,3,2
23066,6,1,80980,80980,80981,0,1,3
23067,4,3,80984,80984,80987,0,3,3
23068,6,1,80990,80990,80991,0,1,3
23069,6,3,80996,80996,80999,0,3,5
23070,4,1,81000,81000,81001,0,1,1
23071,5,1,81005,81005,81006,0,1,4
23072,2,2,81007,81007,81009,0,2,1
23073,5,2,81012,81012,81014,0,2,3
23074,4,3,81016,81016,81019,0,3,2
23075,1,2,81017,81019,81021,2,4,0
23076,3,1,81020,81021,81022,1,2,0
23077,5,3,81025,81025,81028,0,3,3
23078,3,2,81028,81028,81030,0,2,0
23079,5,3,81033,81033,81036,0,3,3
23080,2,3,81035,81036,81039,1,4,0
23081,1,2,81036,81039,81041,3,5,0
23082,1,2,81037,81041,81043,4,6,0
23083,3,1,81040,81043,81044,3,4,0
23084,3,1,81043,81044,81045,1,2,0
23085,3,1,81046,81046,81047,0,1,1
23086,2,2,81048,81048,81050,0,2,1
23087,5,1,81053,81053,81054,0,1,3
23088,4,1,81057,81057,81058,0,1,3
23089,5,3,81062,81062,81065,0,3,4
23090,2,1,81064,81065,81066,1,2,0
23091,2,2,81066,81066,81068,0,2,0
23092,4,2,81070,81070,81072,0,2,2
23093,1,3,81071,81072,81075,1,4,0
23094,3,2,81074,81075,81077,1,3,0
23095,4,1,81078,81078,81079,0,1,1
23096,3,3,81081,81081,81084,0,3,2
23097,3,1,81084,81084,81085,0,1,0
23098,3,1,81087,81087,81088,0,1,2
23099,2,1,81089,81089,81090,0,1,1
23100,6,1,81095,81095,81096,0,1,5
23101,3,2,81098,81098,81100,0,2,2
23102,4,1,81102,81102,81103,0,1,2
23103,2,3,81104,81104,81107,0,3,1
23104,3,1,81107,81107,81108,0,1,0
23105,4,1,81111,81111,81112,0,1,3
23106,4,3,81115,81115,81118,0,3,3
23107,1,1,81116,81118,81119,2,3,0
23108,5,3,81121,81121,81124,0,3,2
23109,5,3,81126,81126,81129,0,3,2
23110,3,2,81129,81129,81131,0,2,0
23111,4,3,81133,81133,81136,0,3,2
23112,5,2,81138,81138,81140,0,2,2
23113,6,1,81144,81144,81145,0,1,4
23114,4,1,81148,81148,81149,0,1,3
23115,2,1,81150,81150,81151,0,1,1
23116,3,2,81153,81153,81155,0,2,2
23117,6,1,81159,81159,81160,0,1,4
23118,5,1,81164,81164,81165,0,1,4
23119,4,3,81168,81168,81171,0,3,3
23120,2,1,81170,81171,81172,1,2,0
23121,2,1,81172,81172,81173,0,1,0
23122,3,1,81175,81175,81176,0,1,2
23123,5,2,81180,81180,81182,0,2,4
23124,2,1,81182,81182,81183,0,1,0
23125,3,2,81185,81185,81187,0,2,2
23126,5,2,81190,81190,81192,0,2,3
23127,4,1,81194,81194,81195,0,1,2
23128,5,1,81199,81199,81200,0,1,4
23129,4,3,81203,81203,81206,0,3,3
23130,6,2,81209,81209,81211,0,2,3
23131,3,1,81212,81212,81213,0,1,1
23132,2,2,81214,81214,81216,0,2,1
23133,1,3,81215,81216,81219,1,4,0
23134,5,3,81220,81220,81223,0,3,1
23135,1,2,81221,81223,81225,2,4,0
23136,5,1,81226,81226,81227,0,1,1
23137,2,3,81228,81228,81231,0,3,1
23138,6,3,81234,81234,81237,0,3,3
23139,4,3,81238,81238,81241,0,3,1
23140,4,3,81242,81242,81245,0,3,1
23141,1,2,81243,81245,81247,2,4,0
23142,4,1,81247,81247,81248,0,1,0
23143,6,2,81253,81253,81255,0,2,5
23144,5,3,81258,81258,81261,0,3,3
23145,6,1,81264,81264,81265,0,1,3
23146,1,2,81265,81265,81267,0,2,0
23147,3,2,81268,81268,81270,0,2,1
23148,2,2,81270,81270,81272,0,2,0
23149,5,1,81275,81275,81276,0,1,3
23150,5,1,81280,81280,81281,0,1,4
23151,6,2,81286,81286,81288,0,2,5
23152,4,1,81290,81290,81291,0,1,2
23153,3,3,81293,81293,81296,0,3,2
23154,4,1,81297,81297,81298,0,1,1
23155,3,3,81300,81300,81303,0,3,2
23156,5,1,81305,81305,81306,0,1,2
23157,1,1,81306,81306,81307,0,1,0
23158,6,3,81312,81312,81315,0,3,5
23159,1,3,81313,81315,81318,2,5,0
23160,5,1,81318,81318,81319,0,1,0
23161,1,1,81319,81319,81320,0,1,0
23162,6,3,81325,81325,81328,0,3,5
23163,1,1,81326,81328,81329,2,3,0
23164,3,3,81329,81329,81332,0,3,0
23165,6,2,81335,81335,81337,0,2,3
23166,6,2,81341,81341,81343,0,2,4
23167,4,3,81345,81345,81348,0,3,2
23168,4,1,81349,81349,81350,0,1,1
23169,2,3,81351,81351,81354,0,3,1
23170,1,2,81352,81354,81356,2,4,0
23171,2,1,81354,81356,81357,2,3,0
23172,6,1,81360,81360,81361,0,1,3
23173,5,2,81365,81365,81367,0,2,4
23174,5,3,81370,81370,81373,0,3,3
23175,6,1,81376,81376,81377,0,1,3
23176,3,3,81379,81379,81382,0,3,2
23177,3,2,81382,81382,81384,0,2,0
23178,6,2,81388,81388,81390,0,2,4
23179,6,1,81394,81394,81395,0,1,4
23180,3,2,81397,81397,81399,0,2,2
23181,1,3,81398,81399,81402,1,4,0
23182,1,3,81399,81402,81405,3,6,0
23183,1,2,81400,81405,81407,5,7,0
23184,6,1,81406,81407,81408,1,2,0
23185,5,1,81411,81411,81412,0,1,3
23186,3,3,81414,81414,81417,0,3,2
23187,2,3,81416,81417,81420,1,4,0
23188,6,3,81422,81422,81425,0,3,2
23189,4,2,81426,81426,81428,0,2,1
23190,3,1,81429,81429,81430,0,1,1
23191,1,2,81430,81430,81432,0,2,0
23192,6,1,81436,81436,81437,0,1,4
23193,3,3,81439,81439,81442,0,3,2
23194,6,2,81445,81445,81447,0,2,3
23195,4,1,81449,81449,81450,0,1,2
23196,5,1,81454,81454,81455,0,1,4
23197,4,2,81458,81458,81460,0,2,3
23198,5,1,81463,81463,81464,0,1,3
23199,1,1,81464,81464,81465,0,1,0
23200,2,1,81466,81466,81467,0,1,1
23201,4,3,81470,81470,81473,0,3,3
23202,6,2,81476,81476,81478,0,2,3
23203,6,1,81482,81482,81483,0,1,4
23204,3,3,81485,81485,81488,0,3,2
23205,2,2,81487,81488,81490,1,3,0
23206,3,1,81490,81490,81491,0,1,0
23207,5,2,81495,81495,81497,0,2,4
23208,2,1,81497,81497,81498,0,1,0
23209,1,1,81498,81498,81499,0,1,0
23210,2,2,81500,81500,81502,0,2,1
23211,3,3,81503,81503,81506,0,3,1
23212,3,1,81506,81506,81507,0,1,0
23213,2,3,81508,81508,81511,0,3,1
23214,3,1,81511,81511,81512,0,1,0
23215,1,2,81512,81512,81514,0,2,0
23216,3,2,81515,81515,81517,0,2,1
23217,4,2,81519,81519,81521,0,2,2
23218,5,2,81524,81524,81526,0,2,3
23219,5,1,81529,81529,81530,0,1,3
23220,1,3,81530,81530,81533,0,3,0
23221,5,3,81535,81535,81538,0,3,2
23222,4,3,81539,81539,81542,0,3,1
23223,4,1,81543,81543,81544,0,1,1
23224,4,2,81547,81547,81549,0,2,3
23225,4,3,81551,81551,81554,0,3,2
23226,6,3,81557,81557,81560,0,3,3
23227,2,3,81559,81560,81563,1,4,0
23228,1,3,81560,81563,81566,3,6,0
23229,5,1,81565,81566,81567,1,2,0
23230,4,1,81569,81569,81570,0,1,2
23231,6,2,81575,81575,81577,0,2,5
23232,2,1,81577,81577,81578,0,1,0
23233,5,1,81582,81582,81583,0,1,4
23234,2,3,81584,81584,81587,0,3,1
23235,4,1,81588,81588,81589,0,1,1
23236,6,1,81594,81594,81595,0,1,5
23237,2,3,81596,81596,81599,0,3,1
23238,4,1,81600,81600,81601,0,1,1
23239,1,1,81601,81601,81602,0,1,0
23240,6,3,81607,81607,81610,0,3,5
23241,2,3,81609,81610,81613,1,4,0
23242,1,1,81610,81613,81614,3,4,0
23243,2,1,81612,81614,81615,2,3,0
23244,6,2,81618,81618,81620,0,2,3
23245,1,2,81619,81620,81622,1,3,0
23246,6,2,81625,81625,81627,0,2,3
23247,3,1,81628,81628,81629,0,1,1
23248,3,1,81631,81631,81632,0,1,2
23249,5,2,81636,81636,81638,0,2,4
23250,2,2,81638,81638,81640,0,2,0
23251,2,3,81640,81640,81643,0,3,0
23252,5,1,81645,81645,81646,0,1,2
23253,4,3,81649,81649,81652,0,3,3
23254,5,2,81654,81654,81656,0,2,2
23255,4,3,81658,81658,81661,0,3,2
23256,2,2,81660,81661,81663,1,3,0
23257,3,2,81663,81663,81665,0,2,0
23258,3,1,81666,81666,81667,0,1,1
23259,3,2,81669,81669,81671,0,2,2
23260,5,1,81674,81674,81675,0,1,3
23261,5,2,81679,81679,81681,0,2,4
23262,1,2,81680,81681,81683,1,3,0
23263,1,3,81681,81683,81686,2,5,0
23264,3,3,81684,81686,81689,2,5,0
23265,6,2,81690,81690,81692,0,2,1
23266,1,1,81691,81692,81693,1,2,0
23267,4,2,81695,81695,81697,0,2,2
23268,4,3,81699,81699,81702,0,3,2
23269,2,1,81701,81702,81703,1,2,0
23270,3,3,81704,81704,81707,0,3,1
23271,6,2,81710,81710,81712,0,2,3
23272,2,1,81712,81712,81713,0,1,0
23273,6,2,81718,81718,81720,0,2,5
23274,6,2,81724,81724,81726,0,2,4
23275,5,2,81729,81729,81731,0,2,3
23276,6,1,81735,81735,81736,0,1,4
23277,2,2,81737,81737,81739,0,2,1
23278,3,2,81740,81740,81742,0,2,1
23279,2,3,81742,81742,81745,0,3,0
23280,4,2,81746,81746,81748,0,2,1
23281,4,1,81750,81750,81751,0,1,2
23282,3,3,81753,81753,81756,0,3,2
23283,6,1,81759,81759,81760,0,1,3
23284,4,3,81763,81763,81766,0,3,3
23285,4,1,81767,81767,81768,0,1,1
23286,5,1,81772,81772,81773,0,1,4
23287,2,1,81774,81774,81775,0,1,1
23288,4,2,81778,81778,81780,0,2,3
23289,2,1,81780,81780,81781,0,1,0
23290,3,1,81783,81783,81784,0,1,2
23291,1,2,81784,81784,81786,0,2,0
23292,4,1,81788,81788,81789,0,1,2
23293,3,2,81791,81791,81793,0,2,2
23294,1,1,81792,81793,81794,1,2,0
23295,3,2,81795,81795,81797,0,2,1
23296,2,3,81797,81797,81800,0,3,0
23297,2,2,81799,81800,81802,1,3,0
23298,4,1,81803,81803,81804,0,1,1
23299,6,1,81809,81809,81810,0,1,5
23300,4,3,81813,81813,81816,0,3,3
23301,2,3,81815,81816,81819,1,4,0
23302,6,2,81821,81821,81823,0,2,2
23303,1,2,81822,81823,81825,1,3,0
23304,1,3,81823,81825,81828,2,5,0
23305,2,1,81825,81828,81829,3,4,0
23306,2,2,81827,81829,81831,2,4,0
23307,2,1,81829,81831,81832,2,3,0
23308,4,3,81833,81833,81836,0,3,1
23309,3,3,81836,81836,81839,0,3,0
23310,1,3,81837,81839,81842,2,5,0
23311,5,1,81842,81842,81843,0,1,0
23312,3,3,81845,81845,81848,0,3,2
23313,5,3,81850,81850,81853,0,3,2
23314,4,3,81854,81854,81857,0,3,1
23315,1,1,81855,81857,81858,2,3,0
23316,4,2,81859,81859,81861,0,2,1
23317,1,3,81860,81861,81864,1,4,0
23318,1,3,81861,81864,81867,3,6,0
23319,5,3,81866,81867,81870,1,4,0
23320,5,3,81871,81871,81874,0,3,1
23321,4,1,81875,81875,81876,0,1,1
23322,1,3,81876,81876,81879,0,3,0
23323,6,1,81882,81882,81883,0,1,3
23324,4,1,81886,81886,81887,0,1,3
23325,6,3,81892,81892,81895,0,3,5
23326,2,3,81894,81895,81898,1,4,0
23327,5,1,81899,81899,81900,0,1,1
23328,2,2,81901,81901,81903,0,2,1
23329,2,3,81903,81903,81906,0,3,0
23330,1,3,81904,81906,81909,2,5,0
23331,4,1,81908,81909,81910,1,2,0
23332,3,1,81911,81911,81912,0,1,1
23333,1,1,81912,81912,81913,0,1,0
23334,6,1,81918,81918,81919,0,1,5
23335,2,1,81920,81920,81921,0,1,1
23336,6,1,81926,81926,81927,0,1,5
23337,5,2,81931,81931,81933,0,2,4
23338,3,1,81934,81934,81935,0,1,1
23339,3,2,81937,81937,81939,0,2,2
23340,2,2,81939,81939,81941,0,2,0
23341,5,3,81944,81944,81947,0,3,3
23342,6,3,81950,81950,81953,0,3,3
23343,3,3,81953,81953,81956,0,3,0
23344,3,1,81956,81956,81957,0,1,0
23345,1,3,81957,81957,81960,0,3,0
23346,3,1,81960,81960,81961,0,1,0
23347,5,1,81965,81965,81966,0,1,4
23348,4,2,81969,81969,81971,0,2,3
23349,4,3,81973,81973,81976,0,3,2
23350,6,3,81979,81979,81982,0,3,3
23351,6,1,81985,81985,81986,0,1,3
23352,5,3,81990,81990,81993,0,3,4
23353,2,2,81992,81993,81995,1,3,0
23354,3,2,81995,81995,81997,0,2,0
23355,3,3,81998,81998,82001,0,3,1
23356,4,1,82002,82002,82003,0,1,1
23357,4,2,82006,82006,82008,0,2,3
23358,4,2,82010,82010,82012,0,2,2
23359,5,1,82015,82015,82016,0,1,3
23360,3,1,82018,82018,82019,0,1,2
23361,6,2,82024,82024,82026,0,2,5
23362,2,1,82026,82026,82027,0,1,0
23363,3,2,82029,82029,82031,0,2,2
23364,4,1,82033,82033,82034,0,1,2
23365,5,2,82038,82038,82040,0,2,4
23366,6,1,82044,82044,82045,0,1,4
23367,5,2,82049,82049,82051,0,2,4
23368,1,1,82050,82051,82052,1,2,0
23369,4,1,82054,82054,82055,0,1,2
23370,5,3,82059,82059,82062,0,3,4
23371,1,3,82060,82062,82065,2,5,0
23372,6,1,82066,82066,82067,0,1,1
23373,2,3,82068,82068,82071,0,3,1
23374,3,3,82071,82071,82074,0,3,0
23375,6,2,82077,82077,82079,0,2,3
23376,6,1,82083,82083,82084,0,1,4
23377,6,2,82089,82089,82091,0,2,5
23378,5,1,82094,82094,82095,0,1,3
23379,6,2,82100,82100,82102,0,2,5
23380,1,1,82101,82102,82103,1,2,0
23381,6,3,82107,82107,82110,0,3,4
23382,3,2,82110,82110,82112,0,2,0
23383,5,3,82115,82115,82118,0,3,3
23384,3,3,82118,82118,82121,0,3,0
23385,6,1,82124,82124,82125,0,1,3
23386,3,2,82127,82127,82129,0,2,2
23387,1,2,82128,82129,82131,1,3,0
23388,5,1,82133,82133,82134,0,1,2
23389,3,2,82136,82136,82138,0,2,2
23390,6,3,82142,82142,82145,0,3,4
23391,6,1,82148,82148,82149,0,1,3
23392,5,3,82153,82153,82156,0,3,4
23393,2,1,82155,82156,82157,1,2,0
23394,5,1,82160,82160,82161,0,1,3
23395,3,3,82163,82163,82166,0,3,2
23396,3,1,82166,82166,82167,0,1,0
23397,5,3,82171,82171,82174,0,3,4
23398,2,3,82173,82174,82177,1,4,0
23399,3,3,82176,82177,82180,1,4,0
23400,2,2,82178,82180,82182,2,4,0
23401,4,3,82182,82182,82185,0,3,0
23402,3,1,82185,82185,82186,0,1,0
23403,4,1,82189,82189,82190,0,1,3
23404,4,2,82193,82193,82195,0,2,3
23405,2,2,82195,82195,82197,0,2,0
23406,1,1,82196,82197,82198,1,2,0
23407,5,2,82201,82201,82203,0,2,3
23408,5,3,82206,82206,82209,0,3,3
23409,2,3,82208,82209,82212,1,4,0
23410,6,1,82214,82214,82215,0,1,2
23411,1,3,82215,82215,82218,0,3,0
23412,1,2,82216,82218,82220,2,4,0
23413,3,1,82219,82220,82221,1,2,0
23414,3,1,82222,82222,82223,0,1,1
23415,6,2,82228,82228,82230,0,2,5
23416,6,3,82234,82234,82237,0,3,4
23417,3,2,82237,82237,82239,0,2,0
23418,1,1,82238,82239,82240,1,2,0
23419,1,1,82239,82240,82241,1,2,0
23420,4,2,82243,82243,82245,0,2,2
23421,5,2,82248,82248,82250,0,2,3
23422,6,2,82254,82254,82256,0,2,4
23423,3,3,82257,82257,82260,0,3,1
23424,6,1,82263,82263,82264,0,1,3
23425,3,1,82266,82266,82267,0,1,2
23426,6,3,82272,82272,82275,0,3,5
23427,5,2,82277,82277,82279,0,2,2
23428,2,2,82279,82279,82281,0,2,0
23429,5,2,82284,82284,82286,0,2,3
23430,4,3,82288,82288,82291,0,3,2
23431,4,2,82292,82292,82294,0,2,1
23432,4,1,82296,82296,82297,0,1,2
23433,5,3,82301,82301,82304,0,3,4
23434,2,1,82303,82304,82305,1,2,0
23435,4,2,82307,82307,82309,0,2,2
23436,6,2,82313,82313,82315,0,2,4
23437,1,2,82314,82315,82317,1,3,0
23438,5,1,82319,82319,82320,0,1,2
23439,4,1,82323,82323,82324,0,1,3
23440,1,2,82324,82324,82326,0,2,0
23441,5,3,82329,82329,82332,0,3,3
23442,2,1,82331,82332,82333,1,2,0
23443,2,2,82333,82333,82335,0,2,0
23444,5,2,82338,82338,82340,0,2,3
23445,3,3,82341,82341,82344,0,3,1
23446,6,1,82347,82347,82348,0,1,3
23447,2,3,82349,82349,82352,0,3,1
23448,6,1,82355,82355,82356,0,1,3
23449,3,3,82358,82358,82361,0,3,2
23450,2,1,82360,82361,82362,1,2,0
23451,5,1,82365,82365,82366,0,1,3
23452,5,2,82370,82370,82372,0,2,4
23453,3,1,82373,82373,82374,0,1,1
23454,5,2,82378,82378,82380,0,2,4
23455,5,3,82383,82383,82386,0,3,3
23456,6,1,82389,82389,82390,0,1,3
23457,6,2,82395,82395,82397,0,2,5
23458,3,2,82398,82398,82400,0,2,1
23459,3,1,82401,82401,82402,0,1,1
23460,1,3,82402,82402,82405,0,3,0
23461,4,1,82406,82406,82407,0,1,1
23462,1,3,82407,82407,82410,0,3,0
23463,2,1,82409,82410,82411,1,2,0
23464,3,2,82412,82412,82414,0,2,1
23465,4,3,82416,82416,82419,0,3,2
23466,6,2,82422,82422,82424,0,2,3
23467,3,2,82425,82425,82427,0,2,1
23468,3,3,82428,82428,82431,0,3,1
23469,5,2,82433,82433,82435,0,2,2
23470,3,1,82436,82436,82437,0,1,1
23471,4,2,82440,82440,82442,0,2,3
23472,3,3,82443,82443,82446,0,3,1
23473,4,2,82447,82447,82449,0,2,1
23474,4,3,82451,82451,82454,0,3,2
23475,1,3,82452,82454,82457,2,5,0
23476,1,3,82453,82457,82460,4,7,0
23477,1,1,82454,82460,82461,6,7,0
23478,1,1,82455,82461,82462,6,7,0
23479,1,2,82456,82462,82464,6,8,0
23480,5,1,82461,82464,82465,3,4,0
23481,6,2,82467,82467,82469,0,2,2
23482,5,2,82472,82472,82474,0,2,3
23483,2,1,82474,82474,82475,0,1,0
23484,5,2,82479,82479,82481,0,2,4
23485,3,2,82482,82482,82484,0,2,1
23486,6,1,82488,82488,82489,0,1,4
23487,5,3,82493,82493,82496,0,3,4
23488,6,1,82499,82499,82500,0,1,3
23489,6,3,82505,82505,82508,0,3,5
23490,3,1,82508,82508,82509,0,1,0
23491,4,2,82512,82512,82514,0,2,3
23492,3,3,82515,82515,82518,0,3,1
23493,5,1,82520,82520,82521,0,1,2
23494,3,3,82523,82523,82526,0,3,2
23495,3,3,82526,82526,82529,0,3,0
23496,2,2,82528,82529,82531,1,3,0
23497,3,1,82531,82531,82532,0,1,0
23498,6,2,82537,82537,82539,0,2,5
23499,2,3,82539,82539,82542,0,3,0
23500,4,3,82543,82543,82546,0,3,1
23501,5,2,82548,82548,82550,0,2,2
23502,1,3,82549,82550,82553,1,4,0
23503,3,2,82552,82553,82555,1,3,0
23504,4,1,82556,82556,82557,0,1,1
23505,6,3,82562,82562,82565,0,3,5
23506,6,2,82568,82568,82570,0,2,3
23507,1,3,82569,82570,82573,1,4,0
23508,6,2,82575,82575,82577,0,2,2
23509,1,1,82576,82577,82578,1,2,0
23510,4,2,82580,82580,82582,0,2,2
23511,6,2,82586,82586,82588,0,2,4
23512,4,2,82590,82590,82592,0,2,2
23513,3,1,82593,82593,82594,0,1,1
23514,6,2,82599,82599,82601,0,2,5
23515,1,3,82600,82601,82604,1,4,0
23516,2,3,82602,82604,82607,2,5,0
23517,6,2,82608,82608,82610,0,2,1
23518,3,1,82611,82611,82612,0,1,1
23519,5,2,82616,82616,82618,0,2,4
23520,6,2,82622,82622,82624,0,2,4
23521,6,1,82628,82628,82629,0,1,4
23522,6,3,82634,82634,82637,0,3,5
23523,4,1,82638,82638,82639,0,1,1
23524,2,2,82640,82640,82642,0,2,1
23525,2,3,82642,82642,82645,0,3,0
23526,4,3,82646,82646,82649,0,3,1
23527,4,3,82650,82650,82653,0,3,1
23528,1,2,82651,82653,82655,2,4,0
23529,3,2,82654,82655,82657,1,3,0
23530,3,1,82657,82657,82658,0,1,0
23531,2,1,82659,82659,82660,0,1,1
23532,5,1,82664,82664,82665,0,1,4
23533,5,2,82669,82669,82671,0,2,4
23534,2,2,82671,82671,82673,0,2,0
23535,2,1,82673,82673,82674,0,1,0
23536,4,2,82677,82677,82679,0,2,3
23537,3,2,82680,82680,82682,0,2,1
23538,5,2,82685,82685,82687,0,2,3
23539,3,3,82688,82688,82691,0,3,1
23540,6,3,82694,82694,82697,0,3,3
23541,3,2,82697,82697,82699,0,2,0
23542,1,2,82698,82699,82701,1,3,0
23543,3,1,82701,82701,82702,0,1,0
23544,2,2,82703,82703,82705,0,2,1
23545,5,2,82708,82708,82710,0,2,3
23546,2,3,82710,82710,82713,0,3,0
23547,2,2,82712,82713,82715,1,3,0
23548,2,2,82714,82715,82717,1,3,0
23549,6,3,82720,82720,82723,0,3,3
23550,5,3,82725,82725,82728,0,3,2
23551,5,2,82730,82730,82732,0,2,2
23552,6,2,82736,82736,82738,0,2,4
23553,4,1,82740,82740,82741,0,1,2
23554,4,2,82744,82744,82746,0,2,3
23555,3,3,82747,82747,82750,0,3,1
23556,3,1,82750,82750,82751,0,1,0
23557,6,2,82756,82756,82758,0,2,5
23558,5,3,82761,82761,82764,0,3,3
23559,4,1,82765,82765,82766,0,1,1
23560,5,3,82770,82770,82773,0,3,4
23561,4,2,82774,82774,82776,0,2,1
23562,6,1,82780,82780,82781,0,1,4
23563,6,1,82786,82786,82787,0,1,5
23564,1,2,82787,82787,82789,0,2,0
23565,5,1,82792,82792,82793,0,1,3
23566,4,1,82796,82796,82797,0,1,3
23567,4,1,82800,82800,82801,0,1,3
23568,3,1,82803,82803,82804,0,1,2
23569,1,2,82804,82804,82806,0,2,0
23570,3,1,82807,82807,82808,0,1,1
23571,2,3,82809,82809,82812,0,3,1
23572,6,3,82815,82815,82818,0,3,3
23573,2,3,82817,82818,82821,1,4,0
23574,2,1,82819,82821,82822,2,3,0
23575,6,1,82825,82825,82826,0,1,3
23576,2,3,82827,82827,82830,0,3,1
23577,5,2,82832,82832,82834,0,2,2
23578,6,2,82838,82838,82840,0,2,4
23579,2,2,82840,82840,82842,0,2,0
23580,6,1,82846,82846,82847,0,1,4
23581,4,1,82850,82850,82851,0,1,3
23582,4,1,82854,82854,82855,0,1,3
23583,4,2,82858,82858,82860,0,2,3
23584,3,2,82861,82861,82863,0,2,1
23585,6,2,82867,82867,82869,0,2,4
23586,4,2,82871,82871,82873,0,2,2
23587,2,3,82873,82873,82876,0,3,0
23588,3,2,82876,82876,82878,0,2,0
23589,5,3,82881,82881,82884,0,3,3
23590,5,2,82886,82886,82888,0,2,2
23591,5,3,82891,82891,82894,0,3,3
23592,5,1,82896,82896,82897,0,1,2
23593,2,2,82898,82898,82900,0,2,1
23594,2,2,82900,82900,82902,0,2,0
23595,6,2,82906,82906,82908,0,2,4
23596,3,1,82909,82909,82910,0,1,1
23597,4,2,82913,82913,82915,0,2,3
23598,3,2,82916,82916,82918,0,2,1
23599,6,1,82922,82922,82923,0,1,4
23600,5,3,82927,82927,82930,0,3,4
23601,4,1,82931,82931,82932,0,1,1
23602,6,3,82937,82937,82940,0,3,5
23603,6,2,82943,82943,82945,0,2,3
23604,2,3,82945,82945,82948,0,3,0
23605,6,2,82951,82951,82953,0,2,3
23606,2,3,82953,82953,82956,0,3,0
23607,5,3,82958,82958,82961,0,3,2
23608,6,2,82964,82964,82966,0,2,3
23609,2,2,82966,82966,82968,0,2,0
23610,1,1,82967,82968,82969,1,2,0
23611,2,2,82969,82969,82971,0,2,0
23612,6,3,82975,82975,82978,0,3,4
23613,2,2,82977,82978,82980,1,3,0
23614,2,2,82979,82980,82982,1,3,0
23615,1,3,82980,82982,82985,2,5,0
23616,5,3,82985,82985,82988,0,3,0
23617,2,1,82987,82988,82989,1,2,0
23618,3,1,82990,82990,82991,0,1,1
23619,6,3,82996,82996,82999,0,3,5
23620,5,3,83001,83001,83004,0,3,2
23621,2,2,83003,83004,83006,1,3,0
23622,6,1,83009,83009,83010,0,1,3
23623,2,3,83011,83011,83014,0,3,1
23624,2,1,83013,83014,83015,1,2,0
23625,3,3,83016,83016,83019,0,3,1
23626,6,2,83022,83022,83024,0,2,3
23627,3,2,83025,83025,83027,0,2,1
23628,3,3,83028,83028,83031,0,3,1
23629,3,2,83031,83031,83033,0,2,0
23630,5,1,83036,83036,83037,0,1,3
23631,3,3,83039,83039,83042,0,3,2
23632,6,3,83045,83045,83048,0,3,3
23633,5,1,83050,83050,83051,0,1,2
23634,1,2,83051,83051,83053,0,2,0
23635,3,2,83054,83054,83056,0,2,1
23636,6,2,83060,83060,83062,0,2,4
23637,2,1,83062,83062,83063,0,1,0
23638,5,3,83067,83067,83070,0,3,4
23639,2,2,83069,83070,83072,1,3,0
23640,6,2,83075,83075,83077,0,2,3
23641,2,3,83077,83077,83080,0,3,0
23642,6,1,83083,83083,83084,0,1,3
23643,3,3,83086,83086,83089,0,3,2
23644,2,3,83088,83089,83092,1,4,0
23645,2,2,83090,83092,83094,2,4,0
23646,2,1,83092,83094,83095,2,3,0
23647,6,1,83098,83098,83099,0,1,3
23648,3,2,83101,83101,83103,0,2,2
23649,4,1,83105,83105,83106,0,1,2
23650,4,3,83109,83109,83112,0,3,3
23651,2,3,83111,83112,83115,1,4,0
23652,6,2,83117,83117,83119,0,2,2
23653,4,1,83121,83121,83122,0,1,2
23654,2,3,83123,83123,83126,0,3,1
23655,1,1,83124,83126,83127,2,3,0
23656,5,2,83129,83129,83131,0,2,2
23657,5,3,83134,83134,83137,0,3,3
23658,5,3,83139,83139,83142,0,3,2
23659,4,3,83143,83143,83146,0,3,1
23660,4,2,83147,83147,83149,0,2,1
23661,5,1,83152,83152,83153,0,1,3
23662,3,3,83155,83155,83158,0,3,2
23663,6,3,83161,83161,83164,0,3,3
23664,5,1,83166,83166,83167,0,1,2
23665,4,2,83170,83170,83172,0,2,3
23666,1,3,83171,83172,83175,1,4,0
23667,4,1,83175,83175,83176,0,1,0
23668,6,3,83181,83181,83184,0,3,5
23669,4,1,83185,83185,83186,0,1,1
23670,6,3,83191,83191,83194,0,3,5
23671,3,1,83194,83194,83195,0,1,0
23672,6,1,83200,83200,83201,0,1,5
23673,1,2,83201,83201,83203,0,2,0
23674,6,2,83207,83207,83209,0,2,4
23675,2,1,83209,83209,83210,0,1,0
23676,6,2,83215,83215,83217,0,2,5
23677,4,2,83219,83219,83221,0,2,2
23678,6,3,83225,83225,83228,0,3,4
23679,2,3,83227,83228,83231,1,4,0
23680,5,3,83232,83232,83235,0,3,1
23681,1,3,83233,83235,83238,2,5,0
23682,5,2,83238,83238,83240,0,2,0
23683,6,1,83244,83244,83245,0,1,4
23684,2,1,83246,83246,83247,0,1,1
23685,1,2,83247,83247,83249,0,2,0
23686,2,2,83249,83249,83251,0,2,0
23687,5,3,83254,83254,83257,0,3,3
23688,3,2,83257,83257,83259,0,2,0
23689,5,2,83262,83262,83264,0,2,3
23690,2,1,83264,83264,83265,0,1,0
23691,1,1,83265,83265,83266,0,1,0
23692,2,1,83267,83267,83268,0,1,1
23693,4,2,83271,83271,83273,0,2,3
23694,4,2,83275,83275,83277,0,2,2
23695,5,1,83280,83280,83281,0,1,3
23696,1,1,83281,83281,83282,0,1,0
23697,5,3,83286,83286,83289,0,3,4
23698,1,3,83287,83289,83292,2,5,0
23699,6,2,83293,83293,83295,0,2,1
23700,5,3,83298,83298,83301,0,3,3
23701,5,1,83303,83303,83304,0,1,2
23702,5,3,83308,83308,83311,0,3,4
23703,6,3,83314,83314,83317,0,3,3
23704,1,2,83315,83317,83319,2,4,0
23705,4,1,83319,83319,83320,0,1,0
23706,3,1,83322,83322,83323,0,1,2
23707,2,3,83324,83324,83327,0,3,1
23708,2,3,83326,83327,83330,1,4,0
23709,4,1,83330,83330,83331,0,1,0
23710,5,1,83335,83335,83336,0,1,4
23711,3,3,83338,83338,83341,0,3,2
23712,2,3,83340,83341,83344,1,4,0
23713,4,2,83344,83344,83346,0,2,0
23714,5,3,83349,83349,83352,0,3,3
23715,2,1,83351,83352,83353,1,2,0
23716,4,1,83355,83355,83356,0,1,2
23717,4,2,83359,83359,83361,0,2,3
23718,3,1,83362,83362,83363,0,1,1
23719,4,3,83366,83366,83369,0,3,3
23720,4,2,83370,83370,83372,0,2,1
23721,2,1,83372,83372,83373,0,1,0
23722,6,2,83378,83378,83380,0,2,5
23723,3,3,83381,83381,83384,0,3,1
23724,1,2,83382,83384,83386,2,4,0
23725,3,2,83385,83386,83388,1,3,0
23726,5,2,83390,83390,83392,0,2,2
23727,4,1,83394,83394,83395,0,1,2
23728,6,3,83400,83400,83403,0,3,5
23729,1,1,83401,83403,83404,2,3,0
23730,2,1,83403,83404,83405,1,2,0
23731,1,3,83404,83405,83408,1,4,0
23732,3,1,83407,83408,83409,1,2,0
23733,6,2,83413,83413,83415,0,2,4
23734,6,3,83419,83419,83422,0,3,4
23735,3,2,83422,83422,83424,0,2,0
23736,5,1,83427,83427,83428,0,1,3
23737,5,2,83432,83432,83434,0,2,4
23738,2,1,83434,83434,83435,0,1,0
23739,6,1,83440,83440,83441,0,1,5
23740,1,1,83441,83441,83442,0,1,0
23741,3,1,83444,83444,83445,0,1,2
23742,5,3,83449,83449,83452,0,3,4
23743,5,1,83454,83454,83455,0,1,2
23744,4,2,83458,83458,83460,0,2,3
23745,3,3,83461,83461,83464,0,3,1
23746,3,1,83464,83464,83465,0,1,0
23747,6,1,83470,83470,83471,0,1,5
23748,5,1,83475,83475,83476,0,1,4
23749,3,1,83478,83478,83479,0,1,2
23750,6,1,83484,83484,83485,0,1,5
23751,1,1,83485,83485,83486,0,1,0
23752,2,2,83487,83487,83489,0,2,1
23753,4,3,83491,83491,83494,0,3,2
23754,2,2,83493,83494,83496,1,3,0
23755,6,2,83499,83499,83501,0,2,3
23756,2,2,83501,83501,83503,0,2,0
23757,5,2,83506,83506,83508,0,2,3
23758,4,3,83510,83510,83513,0,3,2
23759,1,1,83511,83513,83514,2,3,0
23760,1,3,83512,83514,83517,2,5,0
23761,2,3,83514,83517,83520,3,6,0
23762,6,1,83520,83520,83521,0,1,0
23763,3,2,83523,83523,83525,0,2,2
23764,5,1,83528,83528,83529,0,1,3
23765,1,1,83529,83529,83530,0,1,0
23766,4,3,83533,83533,83536,0,3,3
23767,6,2,83539,83539,83541,0,2,3
23768,2,1,83541,83541,83542,0,1,0
23769,2,3,83543,83543,83546,0,3,1
23770,3,3,83546,83546,83549,0,3,0
23771,2,2,83548,83549,83551,1,3,0
23772,5,3,83553,83553,83556,0,3,2
23773,2,3,83555,83556,83559,1,4,0
23774,6,2,83561,83561,83563,0,2,2
23775,4,1,83565,83565,83566,0,1,2
23776,1,3,83566,83566,83569,0,3,0
23777,3,2,83569,83569,83571,0,2,0
23778,1,1,83570,83571,83572,1,2,0
23779,3,2,83573,83573,83575,0,2,1
23780,4,1,83577,83577,83578,0,1,2
23781,5,3,83582,83582,83585,0,3,4
23782,3,2,83585,83585,83587,0,2,0
23783,1,2,83586,83587,83589,1,3,0
23784,3,2,83589,83589,83591,0,2,0
23785,3,3,83592,83592,83595,0,3,1
23786,2,1,83594,83595,83596,1,2,0
23787,6,3,83600,83600,83603,0,3,4
23788,6,3,83606,83606,83609,0,3,3
23789,4,2,83610,83610,83612,0,2,1
23790,2,2,83612,83612,83614,0,2,0
23791,4,3,83616,83616,83619,0,3,2
23792,4,2,83620,83620,83622,0,2,1
23793,3,3,83623,83623,83626,0,3,1
23794,3,3,83626,83626,83629,0,3,0
23795,2,3,83628,83629,83632,1,4,0
23796,4,1,83632,83632,83633,0,1,0
23797,6,1,83638,83638,83639,0,1,5
23798,1,3,83639,83639,83642,0,3,0
23799,2,3,83641,83642,83645,1,4,0
23800,2,1,83643,83645,83646,2,3,0
23801,2,3,83645,83646,83649,1,4,0
23802,2,3,83647,83649,83652,2,5,0
23803,6,3,83653,83653,83656,0,3,1
23804,2,1,83655,83656,83657,1,2,0
23805,3,1,83658,83658,83659,0,1,1
23806,6,1,83664,83664,83665,0,1,5
23807,4,3,83668,83668,83671,0,3,3
23808,2,1,83670,83671,83672,1,2,0
23809,2,1,83672,83672,83673,0,1,0
23810,6,3,83678,83678,83681,0,3,5
23811,5,1,83683,83683,83684,0,1,2
23812,3,2,83686,83686,83688,0,2,2
23813,4,3,83690,83690,83693,0,3,2
23814,5,3,83695,83695,83698,0,3,2
23815,3,2,83698,83698,83700,0,2,0
23816,1,2,83699,83700,83702,1,3,0
23817,3,1,83702,83702,83703,0,1,0
23818,4,2,83706,83706,83708,0,2,3
23819,2,1,83708,83708,83709,0,1,0
23820,6,2,83714,83714,83716,0,2,5
23821,1,2,83715,83716,83718,1,3,0
23822,2,1,83717,83718,83719,1,2,0
23823,6,1,83723,83723,83724,0,1,4
23824,3,3,83726,83726,83729,0,3,2
23825,4,3,83730,83730,83733,0,3,1
23826,5,2,83735,83735,83737,0,2,2
23827,5,3,83740,83740,83743,0,3,3
23828,6,3,83746,83746,83749,0,3,3
23829,4,2,83750,83750,83752,0,2,1
23830,5,2,83755,83755,83757,0,2,3
23831,3,3,83758,83758,83761,0,3,1
23832,3,3,83761,83761,83764,0,3,0
23833,1,1,83762,83764,83765,2,3,0
23834,1,1,83763,83765,83766,2,3,0
23835,4,3,83767,83767,83770,0,3,1
23836,6,3,83773,83773,83776,0,3,3
23837,2,2,83775,83776,83778,1,3,0
23838,6,3,83781,83781,83784,0,3,3
23839,2,3,83783,83784,83787,1,4,0
23840,1,2,83784,83787,83789,3,5,0
23841,5,1,83789,83789,83790,0,1,0
23842,3,3,83792,83792,83795,0,3,2
23843,2,2,83794,83795,83797,1,3,0
23844,4,3,83798,83798,83801,0,3,1
23845,5,2,83803,83803,83805,0,2,2
23846,6,2,83809,83809,83811,0,2,4
23847,2,2,83811,83811,83813,0,2,0
23848,3,3,83814,83814,83817,0,3,1
23849,3,2,83817,83817,83819,0,2,0
23850,3,3,83820,83820,83823,0,3,1
23851,2,3,83822,83823,83826,1,4,0
23852,5,2,83827,83827,83829,0,2,1
23853,3,2,83830,83830,83832,0,2,1
23854,2,3,83832,83832,83835,0,3,0
23855,1,3,83833,83835,83838,2,5,0
23856,2,3,83835,83838,83841,3,6,0
23857,1,1,83836,83841,83842,5,6,0
23858,1,3,83837,83842,83845,5,8,0
23859,3,1,83840,83845,83846,5,6,0
23860,3,1,83843,83846,83847,3,4,0
23861,3,1,83846,83847,83848,1,2,0
23862,6,3,83852,83852,83855,0,3,4
23863,2,3,83854,83855,83858,1,4,0
23864,6,1,83860,83860,83861,0,1,2
23865,1,1,83861,83861,83862,0,1,0
23866,3,1,83864,83864,83865,0,1,2
23867,4,2,83868,83868,83870,0,2,3
23868,6,2,83874,83874,83876,0,2,4
23869,2,3,83876,83876,83879,0,3,0
23870,3,3,83879,83879,83882,0,3,0
23871,3,2,83882,83882,83884,0,2,0
23872,4,3,83886,83886,83889,0,3,2
23873,1,3,83887,83889,83892,2,5,0
23874,5,3,83892,83892,83895,0,3,0
23875,1,3,83893,83895,83898,2,5,0
23876,3,2,83896,83898,83900,2,4,0
23877,5,1,83901,83901,83902,0,1,1
23878,6,1,83907,83907,83908,0,1,5
23879,4,1,83911,83911,83912,0,1,3
23880,3,3,83914,83914,83917,0,3,2
23881,3,2,83917,83917,83919,0,2,0
23882,1,1,83918,83919,83920,1,2,0
23883,5,1,83923,83923,83924,0,1,3
23884,2,1,83925,83925,83926,0,1,1
23885,5,3,83930,83930,83933,0,3,4
23886,6,1,83936,83936,83937,0,1,3
23887,3,2,83939,83939,83941,0,2,2
23888,5,2,83944,83944,83946,0,2,3
23889,4,1,83948,83948,83949,0,1,2
23890,2,3,83950,83950,83953,0,3,1
23891,1,1,83951,83953,83954,2,3,0
23892,3,3,83954,83954,83957,0,3,0
23893,4,2,83958,83958,83960,0,2,1
23894,2,1,83960,83960,83961,0,1,0
23895,4,1,83964,83964,83965,0,1,3
23896,5,1,83969,83969,83970,0,1,4
23897,3,1,83972,83972,83973,0,1,2
23898,3,1,83975,83975,83976,0,1,2
23899,6,2,83981,83981,83983,0,2,5
23900,4,3,83985,83985,83988,0,3,2
23901,4,2,83989,83989,83991,0,2,1
23902,3,1,83992,83992,83993,0,1,1
23903,3,1,83995,83995,83996,0,1,2
23904,5,1,84000,84000,84001,0,1,4
23905,4,1,84004,84004,84005,0,1,3
23906,3,1,84007,84007,84008,0,1,2
23907,3,2,84010,84010,84012,0,2,2
23908,6,2,84016,84016,84018,0,2,4
23909,1,1,84017,84018,84019,1,2,0
23910,1,1,84018,84019,84020,1,2,0
23911,3,2,84021,84021,84023,0,2,1
23912,4,3,84025,84025,84028,0,3,2
23913,1,2,84026,84028,84030,2,4,0
23914,2,2,84028,84030,84032,2,4,0
23915,4,1,84032,84032,84033,0,1,0
23916,4,1,84036,84036,84037,0,1,3
23917,3,1,84039,84039,84040,0,1,2
23918,1,2,84040,84040,84042,0,2,0
23919,6,3,84046,84046,84049,0,3,4
23920,2,3,84048,84049,84052,1,4,0
23921,6,2,84054,84054,84056,0,2,2
23922,4,1,84058,84058,84059,0,1,2
23923,4,1,84062,84062,84063,0,1,3
23924,3,3,84065,84065,84068,0,3,2
23925,2,2,84067,84068,84070,1,3,0
23926,5,1,84072,84072,84073,0,1,2
23927,1,3,84073,84073,84076,0,3,0
23928,1,2,84074,84076,84078,2,4,0
23929,4,2,84078,84078,84080,0,2,0
23930,6,1,84084,84084,84085,0,1,4
23931,3,2,84087,84087,84089,0,2,2
23932,6,1,84093,84093,84094,0,1,4
23933,2,3,84095,84095,84098,0,3,1
23934,6,2,84101,84101,84103,0,2,3
23935,5,1,84106,84106,84107,0,1,3
23936,4,1,84110,84110,84111,0,1,3
23937,5,1,84115,84115,84116,0,1,4
23938,5,1,84120,84120,84121,0,1,4
23939,4,2,84124,84124,84126,0,2,3
23940,4,3,84128,84128,84131,0,3,2
23941,5,3,84133,84133,84136,0,3,2
23942,1,1,84134,84136,84137,2,3,0
23943,5,2,84139,84139,84141,0,2,2
23944,1,3,84140,84141,84144,1,4,0
23945,1,1,84141,84144,84145,3,4,0
23946,3,1,84144,84145,84146,1,2,0
23947,3,2,84147,84147,84149,0,2,1
23948,3,1,84150,84150,84151,0,1,1
23949,2,3,84152,84152,84155,0,3,1
23950,5,3,84157,84157,84160,0,3,2
23951,2,2,84159,84160,84162,1,3,0
23952,3,3,84162,84162,84165,0,3,0
23953,5,3,84167,84167,84170,0,3,2
23954,1,1,84168,84170,84171,2,3,0
23955,3,1,84171,84171,84172,0,1,0
23956,2,3,84173,84173,84176,0,3,1
23957,1,1,84174,84176,84177,2,3,0
23958,3,2,84177,84177,84179,0,2,0
23959,3,1,84180,84180,84181,0,1,1
23960,3,1,84183,84183,84184,0,1,2
23961,2,3,84185,84185,84188,0,3,1
23962,5,2,84190,84190,84192,0,2,2
23963,3,1,84193,84193,84194,0,1,1
23964,1,2,84194,84194,84196,0,2,0
23965,3,2,84197,84197,84199,0,2,1
23966,2,1,84199,84199,84200,0,1,0
23967,3,1,84202,84202,84203,0,1,2
23968,5,2,84207,84207,84209,0,2,4
23969,5,1,84212,84212,84213,0,1,3
23970,2,2,84214,84214,84216,0,2,1
23971,2,1,84216,84216,84217,0,1,0
23972,5,2,84221,84221,84223,0,2,4
23973,2,1,84223,84223,84224,0,1,0
23974,5,3,84228,84228,84231,0,3,4
23975,1,2,84229,84231,84233,2,4,0
23976,2,3,84231,84233,84236,2,5,0
23977,6,1,84237,84237,84238,0,1,1
23978,4,3,84241,84241,84244,0,3,3
23979,6,2,84247,84247,84249,0,2,3
23980,5,3,84252,84252,84255,0,3,3
23981,6,2,84258,84258,84260,0,2,3
23982,3,3,84261,84261,84264,0,3,1
23983,2,3,84263,84264,84267,1,4,0
23984,1,2,84264,84267,84269,3,5,0
23985,2,3,84266,84269,84272,3,6,0
23986,1,2,84267,84272,84274,5,7,0
23987,5,1,84272,84274,84275,2,3,0
23988,1,1,84273,84275,84276,2,3,0
23989,4,2,84277,84277,84279,0,2,1
23990,6,3,84283,84283,84286,0,3,4
23991,6,2,84289,84289,84291,0,2,3
23992,1,1,84290,84291,84292,1,2,0
23993,6,2,84296,84296,84298,0,2,4
23994,2,2,84298,84298,84300,0,2,0
23995,4,3,84302,84302,84305,0,3,2
23996,2,2,84304,84305,84307,1,3,0
23997,6,1,84310,84310,84311,0,1,3
23998,1,1,84311,84311,84312,0,1,0
23999,6,3,84317,84317,84320,0,3,5
24000,3,3,84320,84320,84323,0,3,0
24001,2,2,84322,84323,84325,1,3,0
24002,3,3,84325,84325,84328,0,3,0
24003,4,2,84329,84329,84331,0,2,1
24004,4,2,84333,84333,84335,0,2,2
24005,4,2,84337,84337,84339,0,2,2
24006,3,3,84340,84340,84343,0,3,1
24007,3,1,84343,84343,84344,0,1,0
24008,5,3,84348,84348,84351,0,3,4
24009,6,1,84354,84354,84355,0,1,3
24010,1,1,84355,84355,84356,0,1,0
24011,1,3,84356,84356,84359,0,3,0
24012,1,1,84357,84359,84360,2,3,0
24013,1,1,84358,84360,84361,2,3,0
24014,4,2,84362,84362,84364,0,2,1
24015,2,3,84364,84364,84367,0,3,0
24016,2,2,84366,84367,84369,1,3,0
24017,3,1,84369,84369,84370,0,1,0
24018,6,3,84375,84375,84378,0,3,5
24019,2,2,84377,84378,84380,1,3,0
24020,4,3,84381,84381,84384,0,3,1
24021,1,1,84382,84384,84385,2,3,0
24022,3,1,84385,84385,84386,0,1,0
24023,2,3,84387,84387,84390,0,3,1
24024,3,1,84390,84390,84391,0,1,0
24025,2,2,84392,84392,84394,0,2,1
24026,1,2,84393,84394,84396,1,3,0
24027,1,3,84394,84396,84399,2,5,0
24028,4,2,84398,84399,84401,1,3,0
24029,6,1,84404,84404,84405,0,1,3
24030,4,1,84408,84408,84409,0,1,3
24031,2,1,84410,84410,84411,0,1,1
24032,6,3,84416,84416,84419,0,3,5
24033,1,1,84417,84419,84420,2,3,0
24034,1,1,84418,84420,84421,2,3,0
24035,4,1,84422,84422,84423,0,1,1
24036,6,2,84428,84428,84430,0,2,5
24037,1,2,84429,84430,84432,1,3,0
24038,1,3,84430,84432,84435,2,5,0
24039,5,3,84435,84435,84438,0,3,0
24040,3,3,84438,84438,84441,0,3,0
24041,2,2,84440,84441,84443,1,3,0
24042,1,3,84441,84443,84446,2,5,0
24043,4,2,84445,84446,84448,1,3,0
24044,4,2,84449,84449,84451,0,2,1
24045,3,3,84452,84452,84455,0,3,1
24046,2,1,84454,84455,84456,1,2,0
24047,6,3,84460,84460,84463,0,3,4
24048,5,3,84465,84465,84468,0,3,2
24049,5,2,84470,84470,84472,0,2,2
24050,5,2,84475,84475,84477,0,2,3
24051,6,3,84481,84481,84484,0,3,4
24052,1,2,84482,84484,84486,2,4,0
24053,5,2,84487,84487,84489,0,2,1
24054,5,1,84492,84492,84493,0,1,3
24055,6,1,84498,84498,84499,0,1,5
24056,3,2,84501,84501,84503,0,2,2
24057,6,1,84507,84507,84508,0,1,4
24058,5,2,84512,84512,84514,0,2,4
24059,3,2,84515,84515,84517,0,2,1
24060,6,2,84521,84521,84523,0,2,4
24061,6,3,84527,84527,84530,0,3,4
24062,6,3,84533,84533,84536,0,3,3
24063,2,1,84535,84536,84537,1,2,0
24064,3,1,84538,84538,84539,0,1,1
24065,2,2,84540,84540,84542,0,2,1
24066,2,3,84542,84542,84545,0,3,0
24067,4,1,84546,84546,84547,0,1,1
24068,5,1,84551,84551,84552,0,1,4
24069,4,3,84555,84555,84558,0,3,3
24070,1,1,84556,84558,84559,2,3,0
24071,6,2,84562,84562,84564,0,2,3
24072,5,1,84567,84567,84568,0,1,3
24073,2,2,84569,84569,84571,0,2,1
24074,1,1,84570,84571,84572,1,2,0
24075,6,2,84576,84576,84578,0,2,4
24076,6,1,84582,84582,84583,0,1,4
24077,3,3,84585,84585,84588,0,3,2
24078,6,3,84591,84591,84594,0,3,3
24079,2,1,84593,84594,84595,1,2,0
24080,3,3,84596,84596,84599,0,3,1
24081,1,3,84597,84599,84602,2,5,0
24082,3,1,84600,84602,84603,2,3,0
24083,6,2,84606,84606,84608,0,2,3
24084,4,1,84610,84610,84611,0,1,2
24085,3,2,84613,84613,84615,0,2,2
24086,3,3,84616,84616,84619,0,3,1
24087,1,2,84617,84619,84621,2,4,0
24088,5,2,84622,84622,84624,0,2,1
24089,5,3,84627,84627,84630,0,3,3
24090,3,1,84630,84630,84631,0,1,0
24091,5,2,84635,84635,84637,0,2,4
24092,3,1,84638,84638,84639,0,1,1
24093,5,3,84643,84643,84646,0,3,4
24094,6,2,84649,84649,84651,0,2,3
24095,1,2,84650,84651,84653,1,3,0
24096,3,1,84653,84653,84654,0,1,0
24097,6,1,84659,84659,84660,0,1,5
24098,4,3,84663,84663,84666,0,3,3
24099,5,2,84668,84668,84670,0,2,2
24100,6,2,84674,84674,84676,0,2,4
24101,1,3,84675,84676,84679,1,4,0
24102,5,1,84680,84680,84681,0,1,1
24103,1,3,84681,84681,84684,0,3,0
24104,3,1,84684,84684,84685,0,1,0
24105,3,1,84687,84687,84688,0,1,2
24106,4,3,84691,84691,84694,0,3,3
24107,4,1,84695,84695,84696,0,1,1
24108,6,3,84701,84701,84704,0,3,5
24109,1,3,84702,84704,84707,2,5,0
24110,4,3,84706,84707,84710,1,4,0
24111,2,1,84708,84710,84711,2,3,0
24112,1,3,84709,84711,84714,2,5,0
24113,4,1,84713,84714,84715,1,2,0
24114,5,3,84718,84718,84721,0,3,3
24115,3,3,84721,84721,84724,0,3,0
24116,2,3,84723,84724,84727,1,4,0
24117,2,3,84725,84727,84730,2,5,0
24118,1,1,84726,84730,84731,4,5,0
24119,1,2,84727,84731,84733,4,6,0
24120,2,3,84729,84733,84736,4,7,0
24121,6,3,84735,84736,84739,1,4,0
24122,1,3,84736,84739,84742,3,6,0
24123,2,1,84738,84742,84743,4,5,0
24124,6,3,84744,84744,84747,0,3,1
24125,1,3,84745,84747,84750,2,5,0
24126,3,2,84748,84750,84752,2,4,0
24127,5,2,84753,84753,84755,0,2,1
24128,1,1,84754,84755,84756,1,2,0
24129,4,3,84758,84758,84761,0,3,2
24130,3,1,84761,84761,84762,0,1,0
24131,2,3,84763,84763,84766,0,3,1
24132,2,1,84765,84766,84767,1,2,0
24133,2,1,84767,84767,84768,0,1,0
24134,6,3,84773,84773,84776,0,3,5
24135,3,2,84776,84776,84778,0,2,0
24136,2,3,84778,84778,84781,0,3,0
24137,1,2,84779,84781,84783,2,4,0
24138,5,3,84784,84784,84787,0,3,1
24139,6,1,84790,84790,84791,0,1,3
24140,1,3,84791,84791,84794,0,3,0
24141,4,1,84795,84795,84796,0,1,1
24142,3,1,84798,84798,84799,0,1,2
24143,2,3,84800,84800,84803,0,3,1
24144,2,3,84802,84803,84806,1,4,0
24145,4,2,84806,84806,84808,0,2,0
24146,4,3,84810,84810,84813,0,3,2
24147,3,2,84813,84813,84815,0,2,0
24148,1,1,84814,84815,84816,1,2,0
24149,6,3,84820,84820,84823,0,3,4
24150,1,1,84821,84823,84824,2,3,0
24151,5,3,84826,84826,84829,0,3,2
24152,6,2,84832,84832,84834,0,2,3
24153,5,2,84837,84837,84839,0,2,3
24154,3,3,84840,84840,84843,0,3,1
24155,5,3,84845,84845,84848,0,3,2
24156,6,3,84851,84851,84854,0,3,3
24157,1,1,84852,84854,84855,2,3,0
24158,1,1,84853,84855,84856,2,3,0
24159,6,2,84859,84859,84861,0,2,3
24160,2,2,84861,84861,84863,0,2,0
24161,4,3,84865,84865,84868,0,3,2
24162,4,3,84869,84869,84872,0,3,1
24163,3,3,84872,84872,84875,0,3,0
24164,6,2,84878,84878,84880,0,2,3
24165,2,3,84880,84880,84883,0,3,0
24166,1,3,84881,84883,84886,2,5,0
24167,4,2,84885,84886,84888,1,3,0
24168,3,3,84888,84888,84891,0,3,0
24169,3,3,84891,84891,84894,0,3,0
24170,4,3,84895,84895,84898,0,3,1
24171,1,1,84896,84898,84899,2,3,0
24172,2,3,84898,84899,84902,1,4,0
24173,2,2,84900,84902,84904,2,4,0
24174,5,2,84905,84905,84907,0,2,1
24175,2,2,84907,84907,84909,0,2,0
24176,5,2,84912,84912,84914,0,2,3
24177,2,2,84914,84914,84916,0,2,0
24178,6,2,84920,84920,84922,0,2,4
24179,6,1,84926,84926,84927,0,1,4
24180,6,2,84932,84932,84934,0,2,5
24181,6,1,84938,84938,84939,0,1,4
24182,4,3,84942,84942,84945,0,3,3
24183,5,2,84947,84947,84949,0,2,2
24184,2,2,84949,84949,84951,0,2,0
24185,2,2,84951,84951,84953,0,2,0
24186,4,2,84955,84955,84957,0,2,2
24187,4,3,84959,84959,84962,0,3,2
24188,5,2,84964,84964,84966,0,2,2
24189,2,3,84966,84966,84969,0,3,0
24190,1,3,84967,84969,84972,2,5,0
24191,6,1,84973,84973,84974,0,1,1
24192,6,2,84979,84979,84981,0,2,5
24193,1,3,84980,84981,84984,1,4,0
24194,2,1,84982,84984,84985,2,3,0
24195,5,2,84987,84987,84989,0,2,2
24196,3,3,84990,84990,84993,0,3,1
24197,4,1,84994,84994,84995,0,1,1
24198,6,3,85000,85000,85003,0,3,5
24199,3,1,85003,85003,85004,0,1,0
24200,5,2,85008,85008,85010,0,2,4
24201,2,3,85010,85010,85013,0,3,0
24202,3,1,85013,85013,85014,0,1,0
24203,3,1,85016,85016,85017,0,1,2
24204,3,2,85019,85019,85021,0,2,2
24205,2,2,85021,85021,85023,0,2,0
24206,4,1,85025,85025,85026,0,1,2
24207,1,3,85026,85026,85029,0,3,0
24208,2,3,85028,85029,85032,1,4,0
24209,2,3,85030,85032,85035,2,5,0
24210,1,1,85031,85035,85036,4,5,0
24211,6,2,85037,85037,85039,0,2,1
24212,1,1,85038,85039,85040,1,2,0
24213,3,1,85041,85041,85042,0,1,1
24214,1,2,85042,85042,85044,0,2,0
24215,4,2,85046,85046,85048,0,2,2
24216,4,1,85050,85050,85051,0,1,2
24217,3,2,85053,85053,85055,0,2,2
24218,6,2,85059,85059,85061,0,2,4
24219,1,2,85060,85061,85063,1,3,0
24220,3,1,85063,85063,85064,0,1,0
24221,3,3,85066,85066,85069,0,3,2
24222,6,1,85072,85072,85073,0,1,3
24223,5,1,85077,85077,85078,0,1,4
24224,5,2,85082,85082,85084,0,2,4
24225,4,2,85086,85086,85088,0,2,2
24226,3,2,85089,85089,85091,0,2,1
24227,1,2,85090,85091,85093,1,3,0
24228,3,2,85093,85093,85095,0,2,0
24229,4,3,85097,85097,85100,0,3,2
24230,4,2,85101,85101,85103,0,2,1
24231,1,1,85102,85103,85104,1,2,0
24232,5,2,85107,85107,85109,0,2,3
24233,5,2,85112,85112,85114,0,2,3
24234,4,3,85116,85116,85119,0,3,2
24235,3,2,85119,85119,85121,0,2,0
24236,5,3,85124,85124,85127,0,3,3
24237,6,2,85130,85130,85132,0,2,3
24238,1,1,85131,85132,85133,1,2,0
24239,4,2,85135,85135,85137,0,2,2
24240,2,1,85137,85137,85138,0,1,0
24241,4,3,85141,85141,85144,0,3,3
24242,3,2,85144,85144,85146,0,2,0
24243,5,3,85149,85149,85152,0,3,3
24244,3,1,85152,85152,85153,0,1,0
24245,6,2,85158,85158,85160,0,2,5
24246,2,3,85160,85160,85163,0,3,0
24247,3,1,85163,85163,85164,0,1,0
24248,2,1,85165,85165,85166,0,1,1
24249,5,1,85170,85170,85171,0,1,4
24250,3,3,85173,85173,85176,0,3,2
24251,2,2,85175,85176,85178,1,3,0
24252,3,3,85178,85178,85181,0,3,0
24253,6,3,85184,85184,85187,0,3,3
24254,4,3,85188,85188,85191,0,3,1
24255,6,3,85194,85194,85197,0,3,3
24256,5,2,85199,85199,85201,0,2,2
24257,2,3,85201,85201,85204,0,3,0
24258,3,3,85204,85204,85207,0,3,0
24259,2,1,85206,85207,85208,1,2,0
24260,6,1,85212,85212,85213,0,1,4
24261,4,3,85216,85216,85219,0,3,3
24262,4,1,85220,85220,85221,0,1,1
24263,4,3,85224,85224,85227,0,3,3
24264,3,1,85227,85227,85228,0,1,0
24265,6,3,85233,85233,85236,0,3,5
24266,2,1,85235,85236,85237,1,2,0
24267,1,2,85236,85237,85239,1,3,0
24268,3,2,85239,85239,85241,0,2,0
24269,3,2,85242,85242,85244,0,2,1
24270,5,1,85247,85247,85248,0,1,3
24271,6,1,85253,85253,85254,0,1,5
24272,1,1,85254,85254,85255,0,1,0
24273,3,3,85257,85257,85260,0,3,2
24274,5,3,85262,85262,85265,0,3,2
24275,2,3,85264,85265,85268,1,4,0
24276,4,2,85268,85268,85270,0,2,0
24277,6,1,85274,85274,85275,0,1,4
24278,4,2,85278,85278,85280,0,2,3
24279,3,1,85281,85281,85282,0,1,1
24280,4,3,85285,85285,85288,0,3,3
24281,5,3,85290,85290,85293,0,3,2
24282,2,1,85292,85293,85294,1,2,0
24283,2,2,85294,85294,85296,0,2,0
24284,3,1,85297,85297,85298,0,1,1
24285,5,2,85302,85302,85304,0,2,4
24286,4,1,85306,85306,85307,0,1,2
24287,3,2,85309,85309,85311,0,2,2
24288,4,1,85313,85313,85314,0,1,2
24289,6,3,85319,85319,85322,0,3,5
24290,5,1,85324,85324,85325,0,1,2
24291,2,1,85326,85326,85327,0,1,1
24292,2,1,85328,85328,85329,0,1,1
24293,1,1,85329,85329,85330,0,1,0
24294,4,3,85333,85333,85336,0,3,3
24295,1,3,85334,85336,85339,2,5,0
24296,1,2,85335,85339,85341,4,6,0
24297,5,1,85340,85341,85342,1,2,0
24298,3,2,85343,85343,85345,0,2,1
24299,4,3,85347,85347,85350,0,3,2
24300,2,1,85349,85350,85351,1,2,0
24301,1,1,85350,85351,85352,1,2,0
24302,6,3,85356,85356,85359,0,3,4
24303,6,1,85362,85362,85363,0,1,3
24304,5,1,85367,85367,85368,0,1,4
24305,5,3,85372,85372,85375,0,3,4
24306,4,3,85376,85376,85379,0,3,1
24307,3,3,85379,85379,85382,0,3,0
24308,4,2,85383,85383,85385,0,2,1
24309,1,3,85384,85385,85388,1,4,0
24310,6,2,85390,85390,85392,0,2,2
24311,3,2,85393,85393,85395,0,2,1
24312,1,2,85394,85395,85397,1,3,0
24313,5,1,85399,85399,85400,0,1,2
24314,6,2,85405,85405,85407,0,2,5
24315,4,2,85409,85409,85411,0,2,2
24316,3,1,85412,85412,85413,0,1,1
24317,3,3,85415,85415,85418,0,3,2
24318,5,1,85420,85420,85421,0,1,2
24319,2,1,85422,85422,85423,0,1,1
24320,6,2,85428,85428,85430,0,2,5
24321,6,1,85434,85434,85435,0,1,4
24322,3,2,85437,85437,85439,0,2,2
24323,5,1,85442,85442,85443,0,1,3
24324,6,3,85448,85448,85451,0,3,5
24325,2,1,85450,85451,85452,1,2,0
24326,1,1,85451,85452,85453,1,2,0
24327,3,3,85454,85454,85457,0,3,1
24328,4,3,85458,85458,85461,0,3,1
24329,4,2,85462,85462,85464,0,2,1
24330,5,3,85467,85467,85470,0,3,3
24331,3,1,85470,85470,85471,0,1,0
24332,6,2,85476,85476,85478,0,2,5
24333,6,3,85482,85482,85485,0,3,4
24334,4,3,85486,85486,85489,0,3,1
24335,5,3,85491,85491,85494,0,3,2
24336,1,3,85492,85494,85497,2,5,0
24337,4,3,85496,85497,85500,1,4,0
24338,1,3,85497,85500,85503,3,6,0
24339,4,1,85501,85503,85504,2,3,0
24340,3,1,85504,85504,85505,0,1,0
24341,6,3,85510,85510,85513,0,3,5
24342,5,1,85515,85515,85516,0,1,2
24343,4,1,85519,85519,85520,0,1,3
24344,6,3,85525,85525,85528,0,3,5
24345,5,1,85530,85530,85531,0,1,2
24346,1,3,85531,85531,85534,0,3,0
24347,6,3,85537,85537,85540,0,3,3
24348,5,3,85542,85542,85545,0,3,2
24349,4,1,85546,85546,85547,0,1,1
24350,5,2,85551,85551,85553,0,2,4
24351,6,3,85557,85557,85560,0,3,4
24352,2,1,85559,85560,85561,1,2,0
24353,3,2,85562,85562,85564,0,2,1
24354,5,1,85567,85567,85568,0,1,3
24355,4,3,85571,85571,85574,0,3,3
24356,3,1,85574,85574,85575,0,1,0
24357,1,3,85575,85575,85578,0,3,0
24358,1,2,85576,85578,85580,2,4,0
24359,4,3,85580,85580,85583,0,3,0
24360,1,3,85581,85583,85586,2,5,0
24361,1,1,85582,85586,85587,4,5,0
24362,1,2,85583,85587,85589,4,6,0
24363,4,2,85587,85589,85591,2,4,0
24364,5,1,85592,85592,85593,0,1,1
24365,1,2,85593,85593,85595,0,2,0
24366,4,3,85597,85597,85600,0,3,2
24367,3,3,85600,85600,85603,0,3,0
24368,4,1,85604,85604,85605,0,1,1
24369,1,3,85605,85605,85608,0,3,0
24370,5,3,85610,85610,85613,0,3,2
24371,6,1,85616,85616,85617,0,1,3
24372,6,3,85622,85622,85625,0,3,5
24373,3,1,85625,85625,85626,0,1,0
24374,3,2,85628,85628,85630,0,2,2
24375,6,2,85634,85634,85636,0,2,4
24376,2,3,85636,85636,85639,0,3,0
24377,4,2,85640,85640,85642,0,2,1
24378,6,1,85646,85646,85647,0,1,4
24379,5,3,85651,85651,85654,0,3,4
24380,6,2,85657,85657,85659,0,2,3
24381,3,2,85660,85660,85662,0,2,1
24382,2,3,85662,85662,85665,0,3,0
24383,2,2,85664,85665,85667,1,3,0
24384,2,1,85666,85667,85668,1,2,0
24385,1,2,85667,85668,85670,1,3,0
24386,6,1,85673,85673,85674,0,1,3
24387,2,3,85675,85675,85678,0,3,1
24388,2,1,85677,85678,85679,1,2,0
24389,4,1,85681,85681,85682,0,1,2
24390,6,3,85687,85687,85690,0,3,5
24391,4,3,85691,85691,85694,0,3,1
24392,1,2,85692,85694,85696,2,4,0
24393,4,2,85696,85696,85698,0,2,0
24394,4,2,85700,85700,85702,0,2,2
24395,3,2,85703,85703,85705,0,2,1
24396,1,1,85704,85705,85706,1,2,0
24397,6,2,85710,85710,85712,0,2,4
24398,6,3,85716,85716,85719,0,3,4
24399,4,3,85720,85720,85723,0,3,1
24400,1,1,85721,85723,85724,2,3,0
24401,6,2,85727,85727,85729,0,2,3
24402,1,3,85728,85729,85732,1,4,0
24403,6,3,85734,85734,85737,0,3,2
24404,2,3,85736,85737,85740,1,4,0
24405,4,1,85740,85740,85741,0,1,0
24406,3,3,85743,85743,85746,0,3,2
24407,2,1,85745,85746,85747,1,2,0
24408,5,1,85750,85750,85751,0,1,3
24409,6,2,85756,85756,85758,0,2,5
24410,5,2,85761,85761,85763,0,2,3
24411,6,2,85767,85767,85769,0,2,4
24412,3,3,85770,85770,85773,0,3,1
24413,6,3,85776,85776,85779,0,3,3
24414,3,1,85779,85779,85780,0,1,0
24415,2,2,85781,85781,85783,0,2,1
24416,5,1,85786,85786,85787,0,1,3
24417,6,3,85792,85792,85795,0,3,5
24418,6,2,85798,85798,85800,0,2,3
24419,3,1,85801,85801,85802,0,1,1
24420,3,3,85804,85804,85807,0,3,2
24421,3,2,85807,85807,85809,0,2,0
24422,5,2,85812,85812,85814,0,2,3
24423,4,2,85816,85816,85818,0,2,2
24424,5,2,85821,85821,85823,0,2,3
24425,5,1,85826,85826,85827,0,1,3
24426,6,2,85832,85832,85834,0,2,5
24427,5,3,85837,85837,85840,0,3,3
24428,1,2,85838,85840,85842,2,4,0
24429,4,1,85842,85842,85843,0,1,0
24430,5,1,85847,85847,85848,0,1,4
24431,5,1,85852,85852,85853,0,1,4
24432,3,3,85855,85855,85858,0,3,2
24433,5,1,85860,85860,85861,0,1,2
24434,5,1,85865,85865,85866,0,1,4
24435,2,3,85867,85867,85870,0,3,1
24436,6,3,85873,85873,85876,0,3,3
24437,2,3,85875,85876,85879,1,4,0
24438,5,1,85880,85880,85881,0,1,1
24439,2,3,85882,85882,85885,0,3,1
24440,5,2,85887,85887,85889,0,2,2
24441,2,1,85889,85889,85890,0,1,0
24442,2,1,85891,85891,85892,0,1,1
24443,3,1,85894,85894,85895,0,1,2
24444,2,3,85896,85896,85899,0,3,1
24445,2,2,85898,85899,85901,1,3,0
24446,6,2,85904,85904,85906,0,2,3
24447,3,2,85907,85907,85909,0,2,1
24448,6,1,85913,85913,85914,0,1,4
24449,4,1,85917,85917,85918,0,1,3
24450,1,2,85918,85918,85920,0,2,0
24451,5,3,85923,85923,85926,0,3,3
24452,6,1,85929,85929,85930,0,1,3
24453,4,1,85933,85933,85934,0,1,3
24454,6,1,85939,85939,85940,0,1,5
24455,5,3,85944,85944,85947,0,3,4
24456,3,2,85947,85947,85949,0,2,0
24457,5,2,85952,85952,85954,0,2,3
24458,5,2,85957,85957,85959,0,2,3
24459,3,1,85960,85960,85961,0,1,1
24460,5,2,85965,85965,85967,0,2,4
24461,1,2,85966,85967,85969,1,3,0
24462,2,3,85968,85969,85972,1,4,0
24463,3,2,85971,85972,85974,1,3,0
24464,1,2,85972,85974,85976,2,4,0
24465,5,1,85977,85977,85978,0,1,1
24466,2,1,85979,85979,85980,0,1,1
24467,4,2,85983,85983,85985,0,2,3
24468,4,1,85987,85987,85988,0,1,2
24469,4,3,85991,85991,85994,0,3,3
24470,6,1,85997,85997,85998,0,1,3
24471,2,2,85999,85999,86001,0,2,1
24472,6,1,86005,86005,86006,0,1,4
24473,4,1,86009,86009,86010,0,1,3
24474,5,1,86014,86014,86015,0,1,4
24475,5,1,86019,86019,86020,0,1,4
24476,3,2,86022,86022,86024,0,2,2
24477,6,3,86028,86028,86031,0,3,4
24478,5,3,86033,86033,86036,0,3,2
24479,6,1,86039,86039,86040,0,1,3
24480,3,2,86042,86042,86044,0,2,2
24481,4,3,86046,86046,86049,0,3,2
24482,6,1,86052,86052,86053,0,1,3
24483,5,2,86057,86057,86059,0,2,4
24484,2,1,86059,86059,86060,0,1,0
24485,5,3,86064,86064,86067,0,3,4
24486,4,2,86068,86068,86070,0,2,1
24487,2,2,86070,86070,86072,0,2,0
24488,2,1,86072,86072,86073,0,1,0
24489,1,2,86073,86073,86075,0,2,0
24490,5,2,86078,86078,86080,0,2,3
24491,6,3,86084,86084,86087,0,3,4
24492,1,1,86085,86087,86088,2,3,0
24493,4,3,86089,86089,86092,0,3,1
24494,6,1,86095,86095,86096,0,1,3
24495,2,2,86097,86097,86099,0,2,1
24496,2,1,86099,86099,86100,0,1,0
24497,1,2,86100,86100,86102,0,2,0
24498,1,2,86101,86102,86104,1,3,0
24499,3,3,86104,86104,86107,0,3,0
24500,3,1,86107,86107,86108,0,1,0
24501,6,3,86113,86113,86116,0,3,5
24502,4,1,86117,86117,86118,0,1,1
24503,4,1,86121,86121,86122,0,1,3
24504,3,3,86124,86124,86127,0,3,2
24505,6,1,86130,86130,86131,0,1,3
24506,3,1,86133,86133,86134,0,1,2
24507,6,2,86139,86139,86141,0,2,5
24508,2,2,86141,86141,86143,0,2,0
24509,2,2,86143,86143,86145,0,2,0
24510,1,2,86144,86145,86147,1,3,0
24511,3,3,86147,86147,86150,0,3,0
24512,3,3,86150,86150,86153,0,3,0
24513,3,2,86153,86153,86155,0,2,0
24514,5,3,86158,86158,86161,0,3,3
24515,3,1,86161,86161,86162,0,1,0
24516,2,1,86163,86163,86164,0,1,1
24517,3,2,86166,86166,86168,0,2,2
24518,4,2,86170,86170,86172,0,2,2
24519,6,3,86176,86176,86179,0,3,4
24520,6,2,86182,86182,86184,0,2,3
24521,1,3,86183,86184,86187,1,4,0
24522,3,3,86186,86187,86190,1,4,0
24523,6,2,86192,86192,86194,0,2,2
24524,1,1,86193,86194,86195,1,2,0
24525,1,2,86194,86195,86197,1,3,0
24526,1,3,86195,86197,86200,2,5,0
24527,6,2,86201,86201,86203,0,2,1
24528,2,3,86203,86203,86206,0,3,0
24529,2,1,86205,86206,86207,1,2,0
24530,2,3,86207,86207,86210,0,3,0
24531,4,2,86211,86211,86213,0,2,1
24532,5,2,86216,86216,86218,0,2,3
24533,5,3,86221,86221,86224,0,3,3
24534,4,1,86225,86225,86226,0,1,1
24535,6,2,86231,86231,86233,0,2,5
24536,5,2,86236,86236,86238,0,2,3
24537,3,3,86239,86239,86242,0,3,1
24538,2,3,86241,86242,86245,1,4,0
24539,6,1,86247,86247,86248,0,1,2
24540,1,2,86248,86248,86250,0,2,0
24541,6,1,86254,86254,86255,0,1,4
24542,2,1,86256,86256,86257,0,1,1
24543,1,3,86257,86257,86260,0,3,0
24544,5,1,86262,86262,86263,0,1,2
24545,5,1,86267,86267,86268,0,1,4
24546,3,1,86270,86270,86271,0,1,2
24547,5,3,86275,86275,86278,0,3,4
24548,2,3,86277,86278,86281,1,4,0
24549,3,3,86280,86281,86284,1,4,0
24550,3,1,86283,86284,86285,1,2,0
24551,3,2,86286,86286,86288,0,2,1
24552,6,3,86292,86292,86295,0,3,4
24553,3,1,86295,86295,86296,0,1,0
24554,3,3,86298,86298,86301,0,3,2
24555,6,1,86304,86304,86305,0,1,3
24556,2,2,86306,86306,86308,0,2,1
24557,2,1,86308,86308,86309,0,1,0
24558,6,3,86314,86314,86317,0,3,5
24559,1,1,86315,86317,86318,2,3,0
24560,2,3,86317,86318,86321,1,4,0
24561,4,2,86321,86321,86323,0,2,0
24562,4,1,86325,86325,86326,0,1,2
24563,5,3,86330,86330,86333,0,3,4
24564,2,1,86332,86333,86334,1,2,0
24565,5,3,86337,86337,86340,0,3,3
24566,4,1,86341,86341,86342,0,1,1
24567,1,2,86342,86342,86344,0,2,0
24568,4,3,86346,86346,86349,0,3,2
24569,6,2,86352,86352,86354,0,2,3
24570,4,1,86356,86356,86357,0,1,2
24571,5,3,86361,86361,86364,0,3,4
24572,1,2,86362,86364,86366,2,4,0
24573,3,1,86365,86366,86367,1,2,0
24574,2,2,86367,86367,86369,0,2,0
24575,5,2,86372,86372,86374,0,2,3
24576,4,2,86376,86376,86378,0,2,2
24577,3,1,86379,86379,86380,0,1,1
24578,6,2,86385,86385,86387,0,2,5
24579,3,3,86388,86388,86391,0,3,1
24580,6,3,86394,86394,86397,0,3,3
24581,1,3,86395,86397,86400,2,5,0
24582,2,2,86397,86400,86402,3,5,0
24583,1,1,86398,86402,86403,4,5,0
24584,2,3,86400,86403,86406,3,6,0
24585,4,2,86404,86406,86408,2,4,0
24586,1,3,86405,86408,86411,3,6,0
24587,3,2,86408,86411,86413,3,5,0
24588,4,3,86412,86413,86416,1,4,0
24589,1,3,86413,86416,86419,3,6,0
24590,2,2,86415,86419,86421,4,6,0
24591,3,1,86418,86421,86422,3,4,0
24592,4,3,86422,86422,86425,0,3,0
24593,1,2,86423,86425,86427,2,4,0
24594,3,1,86426,86427,86428,1,2,0
24595,5,3,86431,86431,86434,0,3,3
24596,6,1,86437,86437,86438,0,1,3
24597,6,2,86443,86443,86445,0,2,5
24598,2,2,86445,86445,86447,0,2,0
24599,5,2,86450,86450,86452,0,2,3
24600,3,1,86453,86453,86454,0,1,1
24601,3,2,86456,86456,86458,0,2,2
24602,3,3,86459,86459,86462,0,3,1
24603,1,3,86460,86462,86465,2,5,0
24604,2,2,86462,86465,86467,3,5,0
24605,2,2,86464,86467,86469,3,5,0
24606,5,2,86469,86469,86471,0,2,0
24607,2,1,86471,86471,86472,0,1,0
24608,2,1,86473,86473,86474,0,1,1
24609,6,1,86479,86479,86480,0,1,5
24610,1,1,86480,86480,86481,0,1,0
24611,1,2,86481,86481,86483,0,2,0
24612,3,1,86484,86484,86485,0,1,1
24613,1,2,86485,86485,86487,0,2,0
24614,2,3,86487,86487,86490,0,3,0
24615,4,2,86491,86491,86493,0,2,1
24616,6,3,86497,86497,86500,0,3,4
24617,2,2,86499,86500,86502,1,3,0
24618,6,1,86505,86505,86506,0,1,3
24619,3,2,86508,86508,86510,0,2,2
24620,5,3,86513,86513,86516,0,3,3
24621,3,1,86516,86516,86517,0,1,0
24622,1,2,86517,86517,86519,0,2,0
24623,6,2,86523,86523,86525,0,2,4
24624,1,1,86524,86525,86526,1,2,0
24625,6,1,86530,86530,86531,0,1,4
24626,2,3,86532,86532,86535,0,3,1
24627,5,3,86537,86537,86540,0,3,2
24628,4,2,86541,86541,86543,0,2,1
24629,1,1,86542,86543,86544,1,2,0
24630,5,3,86547,86547,86550,0,3,3
24631,3,1,86550,86550,86551,0,1,0
24632,4,3,86554,86554,86557,0,3,3
24633,6,3,86560,86560,86563,0,3,3
24634,1,2,86561,86563,86565,2,4,0
24635,3,2,86564,86565,86567,1,3,0
24636,3,1,86567,86567,86568,0,1,0
24637,4,1,86571,86571,86572,0,1,3
24638,4,2,86575,86575,86577,0,2,3
24639,4,2,86579,86579,86581,0,2,2
24640,5,2,86584,86584,86586,0,2,3
24641,1,2,86585,86586,86588,1,3,0
24642,1,1,86586,86588,86589,2,3,0
24643,6,1,86592,86592,86593,0,1,3
24644,1,1,86593,86593,86594,0,1,0
24645,2,3,86595,86595,86598,0,3,1
24646,2,1,86597,86598,86599,1,2,0
24647,4,2,86601,86601,86603,0,2,2
24648,2,1,86603,86603,86604,0,1,0
24649,1,3,86604,86604,86607,0,3,0
24650,4,2,86608,86608,86610,0,2,1
24651,6,3,86614,86614,86617,0,3,4
24652,4,2,86618,86618,86620,0,2,1
24653,3,3,86621,86621,86624,0,3,1
24654,3,1,86624,86624,86625,0,1,0
24655,2,3,86626,86626,86629,0,3,1
24656,2,3,86628,86629,86632,1,4,0
24657,6,1,86634,86634,86635,0,1,2
24658,3,2,86637,86637,86639,0,2,2
24659,5,3,86642,86642,86645,0,3,3
24660,6,1,86648,86648,86649,0,1,3
24661,5,3,86653,86653,86656,0,3,4
24662,3,2,86656,86656,86658,0,2,0
24663,6,2,86662,86662,86664,0,2,4
24664,5,1,86667,86667,86668,0,1,3
24665,5,1,86672,86672,86673,0,1,4
24666,4,3,86676,86676,86679,0,3,3
24667,1,3,86677,86679,86682,2,5,0
24668,2,2,86679,86682,86684,3,5,0
24669,5,1,86684,86684,86685,0,1,0
24670,4,3,86688,86688,86691,0,3,3
24671,4,2,86692,86692,86694,0,2,1
24672,2,2,86694,86694,86696,0,2,0
24673,4,2,86698,86698,86700,0,2,2
24674,5,2,86703,86703,86705,0,2,3
24675,2,3,86705,86705,86708,0,3,0
24676,3,3,86708,86708,86711,0,3,0
24677,3,2,86711,86711,86713,0,2,0
24678,4,3,86715,86715,86718,0,3,2
24679,4,1,86719,86719,86720,0,1,1
24680,1,3,86720,86720,86723,0,3,0
24681,3,1,86723,86723,86724,0,1,0
24682,5,1,86728,86728,86729,0,1,4
24683,1,3,86729,86729,86732,0,3,0
24684,4,2,86733,86733,86735,0,2,1
24685,2,1,86735,86735,86736,0,1,0
24686,3,2,86738,86738,86740,0,2,2
24687,3,1,86741,86741,86742,0,1,1
24688,2,2,86743,86743,86745,0,2,1
24689,1,1,86744,86745,86746,1,2,0
24690,3,2,86747,86747,86749,0,2,1
24691,2,2,86749,86749,86751,0,2,0
24692,5,3,86754,86754,86757,0,3,3
24693,6,1,86760,86760,86761,0,1,3
24694,1,3,86761,86761,86764,0,3,0
24695,1,1,86762,86764,86765,2,3,0
24696,2,1,86764,86765,86766,1,2,0
24697,4,2,86768,86768,86770,0,2,2
24698,4,2,86772,86772,86774,0,2,2
24699,2,2,86774,86774,86776,0,2,0
24700,6,1,86780,86780,86781,0,1,4
24701,2,1,86782,86782,86783,0,1,1
24702,6,3,86788,86788,86791,0,3,5
24703,4,2,86792,86792,86794,0,2,1
24704,6,2,86798,86798,86800,0,2,4
24705,3,2,86801,86801,86803,0,2,1
24706,6,2,86807,86807,86809,0,2,4
24707,4,2,86811,86811,86813,0,2,2
24708,6,3,86817,86817,86820,0,3,4
24709,6,1,86823,86823,86824,0,1,3
24710,6,2,86829,86829,86831,0,2,5
24711,6,1,86835,86835,86836,0,1,4
24712,1,1,86836,86836,86837,0,1,0
24713,2,2,86838,86838,86840,0,2,1
24714,5,1,86843,86843,86844,0,1,3
24715,4,3,86847,86847,86850,0,3,3
24716,2,3,86849,86850,86853,1,4,0
24717,5,1,86854,86854,86855,0,1,1
24718,1,1,86855,86855,86856,0,1,0
24719,4,3,86859,86859,86862,0,3,3
24720,2,2,86861,86862,86864,1,3,0
24721,1,3,86862,86864,86867,2,5,0
24722,4,3,86866,86867,86870,1,4,0
24723,5,3,86871,86871,86874,0,3,1
24724,3,3,86874,86874,86877,0,3,0
24725,5,2,86879,86879,86881,0,2,2
24726,3,2,86882,86882,86884,0,2,1
24727,3,3,86885,86885,86888,0,3,1
24728,5,2,86890,86890,86892,0,2,2
24729,3,2,86893,86893,86895,0,2,1
24730,6,3,86899,86899,86902,0,3,4
24731,5,1,86904,86904,86905,0,1,2
24732,4,1,86908,86908,86909,0,1,3
24733,1,3,86909,86909,86912,0,3,0
24734,2,3,86911,86912,86915,1,4,0
24735,6,2,86917,86917,86919,0,2,2
24736,1,3,86918,86919,86922,1,4,0
24737,6,2,86924,86924,86926,0,2,2
24738,6,3,86930,86930,86933,0,3,4
24739,1,2,86931,86933,86935,2,4,0
24740,1,3,86932,86935,86938,3,6,0
24741,2,3,86934,86938,86941,4,7,0
24742,3,3,86937,86941,86944,4,7,0
24743,6,1,86943,86944,86945,1,2,0
24744,6,1,86949,86949,86950,0,1,4
24745,1,3,86950,86950,86953,0,3,0
24746,4,1,86954,86954,86955,0,1,1
24747,1,1,86955,86955,86956,0,1,0
24748,6,1,86961,86961,86962,0,1,5
24749,6,1,86967,86967,86968,0,1,5
24750,2,1,86969,86969,86970,0,1,1
24751,2,3,86971,86971,86974,0,3,1
24752,4,1,86975,86975,86976,0,1,1
24753,3,1,86978,86978,86979,0,1,2
24754,5,2,86983,86983,86985,0,2,4
24755,1,2,86984,86985,86987,1,3,0
24756,3,2,86987,86987,86989,0,2,0
24757,5,3,86992,86992,86995,0,3,3
24758,4,3,86996,86996,86999,0,3,1
24759,3,3,86999,86999,87002,0,3,0
24760,6,3,87005,87005,87008,0,3,3
24761,2,3,87007,87008,87011,1,4,0
24762,2,3,87009,87011,87014,2,5,0
24763,3,2,87012,87014,87016,2,4,0
24764,5,3,87017,87017,87020,0,3,1
24765,5,1,87022,87022,87023,0,1,2
24766,3,1,87025,87025,87026,0,1,2
24767,1,1,87026,87026,87027,0,1,0
24768,5,2,87031,87031,87033,0,2,4
24769,6,2,87037,87037,87039,0,2,4
24770,2,2,87039,87039,87041,0,2,0
24771,5,1,87044,87044,87045,0,1,3
24772,6,3,87050,87050,87053,0,3,5
24773,4,2,87054,87054,87056,0,2,1
24774,3,1,87057,87057,87058,0,1,1
24775,1,1,87058,87058,87059,0,1,0
24776,3,3,87061,87061,87064,0,3,2
24777,1,1,87062,87064,87065,2,3,0
24778,3,2,87065,87065,87067,0,2,0
24779,5,1,87070,87070,87071,0,1,3
24780,6,2,87076,87076,87078,0,2,5
24781,5,1,87081,87081,87082,0,1,3
24782,6,3,87087,87087,87090,0,3,5
24783,2,2,87089,87090,87092,1,3,0
24784,3,2,87092,87092,87094,0,2,0
24785,6,3,87098,87098,87101,0,3,4
24786,2,2,87100,87101,87103,1,3,0
24787,3,3,87103,87103,87106,0,3,0
24788,6,2,87109,87109,87111,0,2,3
24789,3,3,87112,87112,87115,0,3,1
24790,4,3,87116,87116,87119,0,3,1
24791,6,1,87122,87122,87123,0,1,3
24792,6,2,87128,87128,87130,0,2,5
24793,5,2,87133,87133,87135,0,2,3
24794,4,2,87137,87137,87139,0,2,2
24795,4,2,87141,87141,87143,0,2,2
24796,3,2,87144,87144,87146,0,2,1
24797,5,2,87149,87149,87151,0,2,3
24798,6,2,87155,87155,87157,0,2,4
24799,1,1,87156,87157,87158,1,2,0
24800,2,2,87158,87158,87160,0,2,0
24801,6,1,87164,87164,87165,0,1,4
24802,2,2,87166,87166,87168,0,2,1
24803,2,3,87168,87168,87171,0,3,0
24804,5,3,87173,87173,87176,0,3,2
24805,2,1,87175,87176,87177,1,2,0
24806,6,1,87181,87181,87182,0,1,4
24807,4,1,87185,87185,87186,0,1,3
24808,1,3,87186,87186,87189,0,3,0
24809,1,2,87187,87189,87191,2,4,0
24810,2,1,87189,87191,87192,2,3,0
24811,5,3,87194,87194,87197,0,3,2
24812,1,3,87195,87197,87200,2,5,0
24813,5,3,87200,87200,87203,0,3,0
24814,1,1,87201,87203,87204,2,3,0
24815,5,1,87206,87206,87207,0,1,2
24816,3,1,87209,87209,87210,0,1,2
24817,1,1,87210,87210,87211,0,1,0
24818,2,2,87212,87212,87214,0,2,1
24819,4,3,87216,87216,87219,0,3,2
24820,4,1,87220,87220,87221,0,1,1
24821,3,1,87223,87223,87224,0,1,2
24822,5,3,87228,87228,87231,0,3,4
24823,1,1,87229,87231,87232,2,3,0
24824,6,3,87235,87235,87238,0,3,3
24825,5,2,87240,87240,87242,0,2,2
24826,1,2,87241,87242,87244,1,3,0
24827,2,3,87243,87244,87247,1,4,0
24828,4,1,87247,87247,87248,0,1,0
24829,2,1,87249,87249,87250,0,1,1
24830,2,1,87251,87251,87252,0,1,1
24831,6,1,87257,87257,87258,0,1,5
24832,2,3,87259,87259,87262,0,3,1
24833,3,3,87262,87262,87265,0,3,0
24834,1,1,87263,87265,87266,2,3,0
24835,1,3,87264,87266,87269,2,5,0
24836,5,2,87269,87269,87271,0,2,0
24837,1,3,87270,87271,87274,1,4,0
24838,5,3,87275,87275,87278,0,3,1
24839,1,1,87276,87278,87279,2,3,0
24840,4,1,87280,87280,87281,0,1,1
24841,6,1,87286,87286,87287,0,1,5
24842,5,1,87291,87291,87292,0,1,4
24843,4,2,87295,87295,87297,0,2,3
24844,1,1,87296,87297,87298,1,2,0
24845,2,2,87298,87298,87300,0,2,0
24846,5,3,87303,87303,87306,0,3,3
24847,5,2,87308,87308,87310,0,2,2
24848,2,2,87310,87310,87312,0,2,0
24849,3,1,87313,87313,87314,0,1,1
24850,3,1,87316,87316,87317,0,1,2
24851,2,3,87318,87318,87321,0,3,1
24852,2,1,87320,87321,87322,1,2,0
24853,3,1,87323,87323,87324,0,1,1
24854,6,1,87329,87329,87330,0,1,5
24855,6,3,87335,87335,87338,0,3,5
24856,1,3,87336,87338,87341,2,5,0
24857,1,3,87337,87341,87344,4,7,0
24858,4,2,87341,87344,87346,3,5,0
24859,5,2,87346,87346,87348,0,2,0
24860,1,3,87347,87348,87351,1,4,0
24861,3,3,87350,87351,87354,1,4,0
24862,4,1,87354,87354,87355,0,1,0
24863,3,2,87357,87357,87359,0,2,2
24864,5,3,87362,87362,87365,0,3,3
24865,1,1,87363,87365,87366,2,3,0
24866,3,1,87366,87366,87367,0,1,0
24867,1,1,87367,87367,87368,0,1,0
24868,4,2,87371,87371,87373,0,2,3
24869,3,1,87374,87374,87375,0,1,1
24870,2,2,87376,87376,87378,0,2,1
24871,2,1,87378,87378,87379,0,1,0
24872,1,3,87379,87379,87382,0,3,0
24873,2,3,87381,87382,87385,1,4,0
24874,5,2,87386,87386,87388,0,2,1
24875,1,2,87387,87388,87390,1,3,0
24876,6,3,87393,87393,87396,0,3,3
24877,4,3,87397,87397,87400,0,3,1
24878,4,2,87401,87401,87403,0,2,1
24879,3,3,87404,87404,87407,0,3,1
24880,6,3,87410,87410,87413,0,3,3
24881,6,1,87416,87416,87417,0,1,3
24882,3,3,87419,87419,87422,0,3,2
24883,6,3,87425,87425,87428,0,3,3
24884,1,3,87426,87428,87431,2,5,0
24885,6,1,87432,87432,87433,0,1,1
24886,5,2,87437,87437,87439,0,2,4
24887,5,2,87442,87442,87444,0,2,3
24888,5,1,87447,87447,87448,0,1,3
24889,6,3,87453,87453,87456,0,3,5
24890,1,3,87454,87456,87459,2,5,0
24891,2,2,87456,87459,87461,3,5,0
24892,5,3,87461,87461,87464,0,3,0
24893,3,2,87464,87464,87466,0,2,0
24894,3,2,87467,87467,87469,0,2,1
24895,1,2,87468,87469,87471,1,3,0
24896,4,1,87472,87472,87473,0,1,1
24897,2,2,87474,87474,87476,0,2,1
24898,3,1,87477,87477,87478,0,1,1
24899,4,2,87481,87481,87483,0,2,3
24900,1,2,87482,87483,87485,1,3,0
24901,5,3,87487,87487,87490,0,3,2
24902,5,2,87492,87492,87494,0,2,2
24903,5,2,87497,87497,87499,0,2,3
24904,6,3,87503,87503,87506,0,3,4
24905,4,2,87507,87507,87509,0,2,1
24906,4,2,87511,87511,87513,0,2,2
24907,6,3,87517,87517,87520,0,3,4
24908,5,3,87522,87522,87525,0,3,2
24909,4,2,87526,87526,87528,0,2,1
24910,3,2,87529,87529,87531,0,2,1
24911,2,1,87531,87531,87532,0,1,0
24912,4,1,87535,87535,87536,0,1,3
24913,3,1,87538,87538,87539,0,1,2
24914,1,3,87539,87539,87542,0,3,0
24915,2,3,87541,87542,87545,1,4,0
24916,3,2,87544,87545,87547,1,3,0
24917,6,1,87550,87550,87551,0,1,3
24918,6,3,87556,87556,87559,0,3,5
24919,3,3,87559,87559,87562,0,3,0
24920,1,2,87560,87562,87564,2,4,0
24921,3,1,87563,87564,87565,1,2,0
24922,1,2,87564,87565,87567,1,3,0
24923,1,1,87565,87567,87568,2,3,0
24924,2,1,87567,87568,87569,1,2,0
24925,3,1,87570,87570,87571,0,1,1
24926,6,2,87576,87576,87578,0,2,5
24927,1,3,87577,87578,87581,1,4,0
24928,3,2,87580,87581,87583,1,3,0
24929,6,3,87586,87586,87589,0,3,3
24930,6,1,87592,87592,87593,0,1,3
24931,1,1,87593,87593,87594,0,1,0
24932,2,2,87595,87595,87597,0,2,1
24933,2,1,87597,87597,87598,0,1,0
24934,4,1,87601,87601,87602,0,1,3
24935,1,1,87602,87602,87603,0,1,0
24936,1,1,87603,87603,87604,0,1,0
24937,3,1,87606,87606,87607,0,1,2
24938,3,3,87609,87609,87612,0,3,2
24939,1,3,87610,87612,87615,2,5,0
24940,2,3,87612,87615,87618,3,6,0
24941,5,2,87617,87618,87620,1,3,0
24942,6,3,87623,87623,87626,0,3,3
24943,3,1,87626,87626,87627,0,1,0
24944,4,2,87630,87630,87632,0,2,3
24945,4,2,87634,87634,87636,0,2,2
24946,5,1,87639,87639,87640,0,1,3
24947,4,1,87643,87643,87644,0,1,3
24948,6,3,87649,87649,87652,0,3,5
24949,6,3,87655,87655,87658,0,3,3
24950,1,2,87656,87658,87660,2,4,0
24951,6,2,87662,87662,87664,0,2,2
24952,5,1,87667,87667,87668,0,1,3
24953,6,2,87673,87673,87675,0,2,5
24954,6,3,87679,87679,87682,0,3,4
24955,3,2,87682,87682,87684,0,2,0
24956,2,2,87684,87684,87686,0,2,0
24957,3,3,87687,87687,87690,0,3,1
24958,6,1,87693,87693,87694,0,1,3
24959,4,1,87697,87697,87698,0,1,3
24960,1,3,87698,87698,87701,0,3,0
24961,4,1,87702,87702,87703,0,1,1
24962,2,2,87704,87704,87706,0,2,1
24963,5,2,87709,87709,87711,0,2,3
24964,1,2,87710,87711,87713,1,3,0
24965,5,1,87715,87715,87716,0,1,2
24966,5,1,87720,87720,87721,0,1,4
24967,5,3,87725,87725,87728,0,3,4
24968,6,1,87731,87731,87732,0,1,3
24969,3,3,87734,87734,87737,0,3,2
24970,4,3,87738,87738,87741,0,3,1
24971,6,3,87744,87744,87747,0,3,3
24972,3,2,87747,87747,87749,0,2,0
24973,6,3,87753,87753,87756,0,3,4
24974,4,3,87757,87757,87760,0,3,1
24975,2,2,87759,87760,87762,1,3,0
24976,4,1,87763,87763,87764,0,1,1
24977,4,3,87767,87767,87770,0,3,3
24978,5,1,87772,87772,87773,0,1,2
24979,4,2,87776,87776,87778,0,2,3
24980,1,3,87777,87778,87781,1,4,0
24981,4,1,87781,87781,87782,0,1,0
24982,1,2,87782,87782,87784,0,2,0
24983,3,3,87785,87785,87788,0,3,1
24984,6,3,87791,87791,87794,0,3,3
24985,3,3,87794,87794,87797,0,3,0
24986,3,1,87797,87797,87798,0,1,0
24987,2,1,87799,87799,87800,0,1,1
24988,4,1,87803,87803,87804,0,1,3
24989,4,2,87807,87807,87809,0,2,3
24990,5,3,87812,87812,87815,0,3,3
24991,5,2,87817,87817,87819,0,2,2
24992,5,1,87822,87822,87823,0,1,3
24993,2,1,87824,87824,87825,0,1,1
24994,4,1,87828,87828,87829,0,1,3
24995,2,2,87830,87830,87832,0,2,1
24996,5,1,87835,87835,87836,0,1,3
24997,3,2,87838,87838,87840,0,2,2
24998,2,3,87840,87840,87843,0,3,0
24999,2,2,87842,87843,87845,1,3,0
25000,5,2,87847,87847,87849,0,2,2
25001,6,2,87853,87853,87855,0,2,4
25002,6,1,87859,87859,87860,0,1,4
25003,2,2,87861,87861,87863,0,2,1
25004,4,3,87865,87865,87868,0,3,2
25005,2,2,87867,87868,87870,1,3,0
25006,1,2,87868,87870,87872,2,4,0
25007,2,2,87870,87872,87874,2,4,0
25008,6,1,87876,87876,87877,0,1,2
25009,4,2,87880,87880,87882,0,2,3
25010,3,3,87883,87883,87886,0,3,1
25011,3,2,87886,87886,87888,0,2,0
25012,3,3,87889,87889,87892,0,3,1
25013,1,2,87890,87892,87894,2,4,0
25014,4,2,87894,87894,87896,0,2,0
25015,3,1,87897,87897,87898,0,1,1
25016,2,1,87899,87899,87900,0,1,1
25017,4,3,87903,87903,87906,0,3,3
25018,1,3,87904,87906,87909,2,5,0
25019,5,3,87909,87909,87912,0,3,0
25020,3,2,87912,87912,87914,0,2,0
25021,6,1,87918,87918,87919,0,1,4
25022,3,2,87921,87921,87923,0,2,2
25023,3,1,87924,87924,87925,0,1,1
25024,5,1,87929,87929,87930,0,1,4
25025,1,3,87930,87930,87933,0,3,0
25026,6,3,87936,87936,87939,0,3,3
25027,1,2,87937,87939,87941,2,4,0
25028,6,2,87943,87943,87945,0,2,2
25029,2,3,87945,87945,87948,0,3,0
25030,5,1,87950,87950,87951,0,1,2
25031,6,2,87956,87956,87958,0,2,5
25032,5,3,87961,87961,87964,0,3,3
25033,2,2,87963,87964,87966,1,3,0
25034,1,3,87964,87966,87969,2,5,0
25035,2,3,87966,87969,87972,3,6,0
25036,2,1,87968,87972,87973,4,5,0
25037,3,1,87971,87973,87974,2,3,0
25038,4,1,87975,87975,87976,0,1,1
25039,2,3,87977,87977,87980,0,3,1
25040,1,2,87978,87980,87982,2,4,0
25041,6,3,87984,87984,87987,0,3,2
25042,5,1,87989,87989,87990,0,1,2
25043,3,3,87992,87992,87995,0,3,2
25044,6,3,87998,87998,88001,0,3,3
25045,6,1,88004,88004,88005,0,1,3
25046,3,3,88007,88007,88010,0,3,2
25047,2,1,88009,88010,88011,1,2,0
25048,5,2,88014,88014,88016,0,2,3
25049,1,3,88015,88016,88019,1,4,0
25050,6,1,88021,88021,88022,0,1,2
25051,4,2,88025,88025,88027,0,2,3
25052,5,3,88030,88030,88033,0,3,3
25053,6,1,88036,88036,88037,0,1,3
25054,5,2,88041,88041,88043,0,2,4
25055,5,1,88046,88046,88047,0,1,3
25056,5,2,88051,88051,88053,0,2,4
25057,1,1,88052,88053,88054,1,2,0
25058,2,2,88054,88054,88056,0,2,0
25059,1,2,88055,88056,88058,1,3,0
25060,5,2,88060,88060,88062,0,2,2
25061,5,1,88065,88065,88066,0,1,3
25062,4,1,88069,88069,88070,0,1,3
25063,1,3,88070,88070,88073,0,3,0
25064,5,1,88075,88075,88076,0,1,2
25065,3,2,88078,88078,88080,0,2,2
25066,2,3,88080,88080,88083,0,3,0
25067,1,3,88081,88083,88086,2,5,0
25068,6,3,88087,88087,88090,0,3,1
25069,5,1,88092,88092,88093,0,1,2
25070,2,3,88094,88094,88097,0,3,1
25071,1,3,88095,88097,88100,2,5,0
25072,1,1,88096,88100,88101,4,5,0
25073,5,2,88101,88101,88103,0,2,0
25074,4,1,88105,88105,88106,0,1,2
25075,4,3,88109,88109,88112,0,3,3
25076,3,3,88112,88112,88115,0,3,0
25077,4,1,88116,88116,88117,0,1,1
25078,5,1,88121,88121,88122,0,1,4
25079,3,3,88124,88124,88127,0,3,2
25080,2,2,88126,88127,88129,1,3,0
25081,1,1,88127,88129,88130,2,3,0
25082,4,2,88131,88131,88133,0,2,1
25083,4,3,88135,88135,88138,0,3,2
25084,2,3,88137,88138,88141,1,4,0
25085,2,3,88139,88141,88144,2,5,0
25086,1,3,88140,88144,88147,4,7,0
25087,5,1,88145,88147,88148,2,3,0
25088,5,3,88150,88150,88153,0,3,2
25089,3,1,88153,88153,88154,0,1,0
25090,5,2,88158,88158,88160,0,2,4
25091,2,3,88160,88160,88163,0,3,0
25092,2,1,88162,88163,88164,1,2,0
25093,6,3,88168,88168,88171,0,3,4
25094,5,3,88173,88173,88176,0,3,2
25095,6,2,88179,88179,88181,0,2,3
25096,6,1,88185,88185,88186,0,1,4
25097,6,2,88191,88191,88193,0,2,5
25098,6,3,88197,88197,88200,0,3,4
25099,5,1,88202,88202,88203,0,1,2
25100,6,1,88208,88208,88209,0,1,5
25101,4,3,88212,88212,88215,0,3,3
25102,3,1,88215,88215,88216,0,1,0
25103,5,2,88220,88220,88222,0,2,4
25104,6,1,88226,88226,88227,0,1,4
25105,4,3,88230,88230,88233,0,3,3
25106,1,1,88231,88233,88234,2,3,0
25107,6,3,88237,88237,88240,0,3,3
25108,4,1,88241,88241,88242,0,1,1
25109,4,2,88245,88245,88247,0,2,3
25110,1,2,88246,88247,88249,1,3,0
25111,1,1,88247,88249,88250,2,3,0
25112,6,3,88253,88253,88256,0,3,3
25113,6,1,88259,88259,88260,0,1,3
25114,4,1,88263,88263,88264,0,1,3
25115,2,1,88265,88265,88266,0,1,1
25116,2,3,88267,88267,88270,0,3,1
25117,4,2,88271,88271,88273,0,2,1
25118,6,2,88277,88277,88279,0,2,4
25119,5,1,88282,88282,88283,0,1,3
25120,5,2,88287,88287,88289,0,2,4
25121,4,1,88291,88291,88292,0,1,2
25122,1,3,88292,88292,88295,0,3,0
25123,4,2,88296,88296,88298,0,2,1
25124,5,3,88301,88301,88304,0,3,3
25125,1,2,88302,88304,88306,2,4,0
25126,5,1,88307,88307,88308,0,1,1
25127,1,2,88308,88308,88310,0,2,0
25128,1,3,88309,88310,88313,1,4,0
25129,1,3,88310,88313,88316,3,6,0
25130,1,2,88311,88316,88318,5,7,0
25131,5,1,88316,88318,88319,2,3,0
25132,3,3,88319,88319,88322,0,3,0
25133,1,1,88320,88322,88323,2,3,0
25134,4,3,88324,88324,88327,0,3,1
25135,3,2,88327,88327,88329,0,2,0
25136,3,3,88330,88330,88333,0,3,1
25137,4,2,88334,88334,88336,0,2,1
25138,2,2,88336,88336,88338,0,2,0
25139,3,1,88339,88339,88340,0,1,1
25140,3,2,88342,88342,88344,0,2,2
25141,6,3,88348,88348,88351,0,3,4
25142,4,2,88352,88352,88354,0,2,1
25143,2,2,88354,88354,88356,0,2,0
25144,1,3,88355,88356,88359,1,4,0
25145,1,3,88356,88359,88362,3,6,0
25146,3,1,88359,88362,88363,3,4,0
25147,3,2,88362,88363,88365,1,3,0
25148,6,1,88368,88368,88369,0,1,3
25149,4,3,88372,88372,88375,0,3,3
25150,2,3,88374,88375,88378,1,4,0
25151,4,1,88378,88378,88379,0,1,0
25152,3,2,88381,88381,88383,0,2,2
25153,4,2,88385,88385,88387,0,2,2
25154,4,3,88389,88389,88392,0,3,2
25155,4,1,88393,88393,88394,0,1,1
25156,5,2,88398,88398,88400,0,2,4
25157,1,2,88399,88400,88402,1,3,0
25158,5,2,88404,88404,88406,0,2,2
25159,4,2,88408,88408,88410,0,2,2
25160,4,1,88412,88412,88413,0,1,2
25161,3,3,88415,88415,88418,0,3,2
25162,5,2,88420,88420,88422,0,2,2
25163,3,1,88423,88423,88424,0,1,1
25164,5,2,88428,88428,88430,0,2,4
25165,3,3,88431,88431,88434,0,3,1
25166,3,1,88434,88434,88435,0,1,0
25167,5,2,88439,88439,88441,0,2,4
25168,6,3,88445,88445,88448,0,3,4
25169,4,1,88449,88449,88450,0,1,1
25170,3,3,88452,88452,88455,0,3,2
25171,6,3,88458,88458,88461,0,3,3
25172,5,3,88463,88463,88466,0,3,2
25173,2,1,88465,88466,88467,1,2,0
25174,1,2,88466,88467,88469,1,3,0
25175,6,3,88472,88472,88475,0,3,3
25176,4,2,88476,88476,88478,0,2,1
25177,3,3,88479,88479,88482,0,3,1
25178,1,2,88480,88482,88484,2,4,0
25179,3,1,88483,88484,88485,1,2,0
25180,6,1,88489,88489,88490,0,1,4
25181,5,1,88494,88494,88495,0,1,4
25182,4,3,88498,88498,88501,0,3,3
25183,5,2,88503,88503,88505,0,2,2
25184,1,1,88504,88505,88506,1,2,0
25185,3,1,88507,88507,88508,0,1,1
25186,5,1,88512,88512,88513,0,1,4
25187,1,1,88513,88513,88514,0,1,0
25188,1,1,88514,88514,88515,0,1,0
25189,1,3,88515,88515,88518,0,3,0
25190,3,2,88518,88518,88520,0,2,0
25191,3,2,88521,88521,88523,0,2,1
25192,2,3,88523,88523,88526,0,3,0
25193,5,3,88528,88528,88531,0,3,2
25194,2,1,88530,88531,88532,1,2,0
25195,3,3,88533,88533,88536,0,3,1
25196,3,2,88536,88536,88538,0,2,0
25197,4,3,88540,88540,88543,0,3,2
25198,1,1,88541,88543,88544,2,3,0
25199,5,3,88546,88546,88549,0,3,2
25200,1,1,88547,88549,88550,2,3,0
25201,1,3,88548,88550,88553,2,5,0
25202,3,3,88551,88553,88556,2,5,0
25203,3,1,88554,88556,88557,2,3,0
25204,1,1,88555,88557,88558,2,3,0
25205,5,2,88560,88560,88562,0,2,2
25206,5,2,88565,88565,88567,0,2,3
25207,6,1,88571,88571,88572,0,1,4
25208,1,2,88572,88572,88574,0,2,0
25209,2,2,88574,88574,88576,0,2,0
25210,2,1,88576,88576,88577,0,1,0
25211,5,1,88581,88581,88582,0,1,4
25212,2,3,88583,88583,88586,0,3,1
25213,1,2,88584,88586,88588,2,4,0
25214,1,3,88585,88588,88591,3,6,0
25215,1,1,88586,88591,88592,5,6,0
25216,4,2,88590,88592,88594,2,4,0
25217,4,3,88594,88594,88597,0,3,0
25218,3,2,88597,88597,88599,0,2,0
25219,1,2,88598,88599,88601,1,3,0
25220,3,3,88601,88601,88604,0,3,0
25221,1,2,88602,88604,88606,2,4,0
25222,1,2,88603,88606,88608,3,5,0
25223,5,2,88608,88608,88610,0,2,0
25224,5,1,88613,88613,88614,0,1,3
25225,3,2,88616,88616,88618,0,2,2
25226,6,2,88622,88622,88624,0,2,4
25227,4,1,88626,88626,88627,0,1,2
25228,1,3,88627,88627,88630,0,3,0
25229,6,2,88633,88633,88635,0,2,3
25230,2,1,88635,88635,88636,0,1,0
25231,6,2,88641,88641,88643,0,2,5
25232,5,1,88646,88646,88647,0,1,3
25233,3,1,88649,88649,88650,0,1,2
25234,5,1,88654,88654,88655,0,1,4
25235,5,3,88659,88659,88662,0,3,4
25236,4,3,88663,88663,88666,0,3,1
25237,4,1,88667,88667,88668,0,1,1
25238,3,2,88670,88670,88672,0,2,2
25239,5,1,88675,88675,88676,0,1,3
25240,6,2,88681,88681,88683,0,2,5
25241,1,1,88682,88683,88684,1,2,0
25242,3,2,88685,88685,88687,0,2,1
25243,5,2,88690,88690,88692,0,2,3
25244,1,1,88691,88692,88693,1,2,0
25245,5,1,88696,88696,88697,0,1,3
25246,6,2,88702,88702,88704,0,2,5
25247,1,1,88703,88704,88705,1,2,0
25248,3,2,88706,88706,88708,0,2,1
25249,5,1,88711,88711,88712,0,1,3
25250,2,2,88713,88713,88715,0,2,1
25251,4,1,88717,88717,88718,0,1,2
25252,3,3,88720,88720,88723,0,3,2
25253,3,1,88723,88723,88724,0,1,0
25254,6,1,88729,88729,88730,0,1,5
25255,4,1,88733,88733,88734,0,1,3
25256,4,3,88737,88737,88740,0,3,3
25257,1,1,88738,88740,88741,2,3,0
25258,6,2,88744,88744,88746,0,2,3
25259,5,1,88749,88749,88750,0,1,3
25260,2,1,88751,88751,88752,0,1,1
25261,6,1,88757,88757,88758,0,1,5
25262,1,2,88758,88758,88760,0,2,0
25263,5,1,88763,88763,88764,0,1,3
25264,2,2,88765,88765,88767,0,2,1
25265,4,1,88769,88769,88770,0,1,2
25266,3,2,88772,88772,88774,0,2,2
25267,2,3,88774,88774,88777,0,3,0
25268,5,2,88779,88779,88781,0,2,2
25269,2,2,88781,88781,88783,0,2,0
25270,5,1,88786,88786,88787,0,1,3
25271,4,1,88790,88790,88791,0,1,3
25272,5,2,88795,88795,88797,0,2,4
25273,6,3,88801,88801,88804,0,3,4
25274,2,1,88803,88804,88805,1,2,0
25275,2,2,88805,88805,88807,0,2,0
25276,4,1,88809,88809,88810,0,1,2
25277,3,1,88812,88812,88813,0,1,2
25278,1,3,88813,88813,88816,0,3,0
25279,4,3,88817,88817,88820,0,3,1
25280,5,1,88822,88822,88823,0,1,2
25281,6,2,88828,88828,88830,0,2,5
25282,1,1,88829,88830,88831,1,2,0
25283,4,2,88833,88833,88835,0,2,2
25284,4,3,88837,88837,88840,0,3,2
25285,2,2,88839,88840,88842,1,3,0
25286,3,2,88842,88842,88844,0,2,0
25287,6,1,88848,88848,88849,0,1,4
25288,4,2,88852,88852,88854,0,2,3
25289,1,2,88853,88854,88856,1,3,0
25290,1,1,88854,88856,88857,2,3,0
25291,1,3,88855,88857,88860,2,5,0
25292,6,3,88861,88861,88864,0,3,1
25293,3,1,88864,88864,88865,0,1,0
25294,5,1,88869,88869,88870,0,1,4
25295,1,2,88870,88870,88872,0,2,0
25296,4,2,88874,88874,88876,0,2,2
25297,3,3,88877,88877,88880,0,3,1
25298,3,3,88880,88880,88883,0,3,0
25299,2,2,88882,88883,88885,1,3,0
25300,2,2,88884,88885,88887,1,3,0
25301,4,2,88888,88888,88890,0,2,1
25302,5,3,88893,88893,88896,0,3,3
25303,4,2,88897,88897,88899,0,2,1
25304,1,3,88898,88899,88902,1,4,0
25305,2,2,88900,88902,88904,2,4,0
25306,3,3,88903,88904,88907,1,4,0
25307,2,2,88905,88907,88909,2,4,0
25308,1,3,88906,88909,88912,3,6,0
25309,1,1,88907,88912,88913,5,6,0
25310,4,3,88911,88913,88916,2,5,0
25311,6,1,88917,88917,88918,0,1,1
25312,2,1,88919,88919,88920,0,1,1
25313,5,3,88924,88924,88927,0,3,4
25314,1,2,88925,88927,88929,2,4,0
25315,3,3,88928,88929,88932,1,4,0
25316,3,2,88931,88932,88934,1,3,0
25317,4,2,88935,88935,88937,0,2,1
25318,3,3,88938,88938,88941,0,3,1
25319,3,2,88941,88941,88943,0,2,0
25320,3,2,88944,88944,88946,0,2,1
25321,2,2,88946,88946,88948,0,2,0
25322,4,2,88950,88950,88952,0,2,2
25323,3,1,88953,88953,88954,0,1,1
25324,3,3,88956,88956,88959,0,3,2
25325,3,1,88959,88959,88960,0,1,0
25326,6,2,88965,88965,88967,0,2,5
25327,5,1,88970,88970,88971,0,1,3
25328,6,3,88976,88976,88979,0,3,5
25329,6,3,88982,88982,88985,0,3,3
25330,2,1,88984,88985,88986,1,2,0
25331,1,1,88985,88986,88987,1,2,0
25332,5,3,88990,88990,88993,0,3,3
25333,5,1,88995,88995,88996,0,1,2
25334,6,2,89001,89001,89003,0,2,5
25335,2,1,89003,89003,89004,0,1,0
25336,2,3,89005,89005,89008,0,3,1
25337,3,1,89008,89008,89009,0,1,0
25338,2,1,89010,89010,89011,0,1,1
25339,3,3,89013,89013,89016,0,3,2
25340,5,3,89018,89018,89021,0,3,2
25341,5,2,89023,89023,89025,0,2,2
25342,6,2,89029,89029,89031,0,2,4
25343,2,1,89031,89031,89032,0,1,0
25344,1,1,89032,89032,89033,0,1,0
25345,1,2,89033,89033,89035,0,2,0
25346,2,1,89035,89035,89036,0,1,0
25347,3,1,89038,89038,89039,0,1,2
25348,5,3,89043,89043,89046,0,3,4
25349,2,1,89045,89046,89047,1,2,0
25350,4,3,89049,89049,89052,0,3,2
25351,2,3,89051,89052,89055,1,4,0
25352,5,1,89056,89056,89057,0,1,1
25353,3,1,89059,89059,89060,0,1,2
25354,5,3,89064,89064,89067,0,3,4
25355,4,3,89068,89068,89071,0,3,1
25356,2,3,89070,89071,89074,1,4,0
25357,2,1,89072,89074,89075,2,3,0
25358,4,3,89076,89076,89079,0,3,1
25359,3,2,89079,89079,89081,0,2,0
25360,4,1,89083,89083,89084,0,1,2
25361,5,1,89088,89088,89089,0,1,4
25362,1,1,89089,89089,89090,0,1,0
25363,6,2,89095,89095,89097,0,2,5
25364,2,2,89097,89097,89099,0,2,0
25365,2,3,89099,89099,89102,0,3,0
25366,5,2,89104,89104,89106,0,2,2
25367,1,3,89105,89106,89109,1,4,0
25368,4,1,89109,89109,89110,0,1,0
25369,3,1,89112,89112,89113,0,1,2
25370,6,2,89118,89118,89120,0,2,5
25371,6,3,89124,89124,89127,0,3,4
25372,4,3,89128,89128,89131,0,3,1
25373,4,1,89132,89132,89133,0,1,1
25374,2,3,89134,89134,89137,0,3,1
25375,4,3,89138,89138,89141,0,3,1
25376,5,1,89143,89143,89144,0,1,2
25377,3,2,89146,89146,89148,0,2,2
25378,4,1,89150,89150,89151,0,1,2
25379,5,1,89155,89155,89156,0,1,4
25380,1,1,89156,89156,89157,0,1,0
25381,4,3,89160,89160,89163,0,3,3
25382,5,3,89165,89165,89168,0,3,2
25383,3,2,89168,89168,89170,0,2,0
25384,4,1,89172,89172,89173,0,1,2
25385,4,2,89176,89176,89178,0,2,3
25386,3,3,89179,89179,89182,0,3,1
25387,3,1,89182,89182,89183,0,1,0
25388,3,1,89185,89185,89186,0,1,2
25389,5,2,89190,89190,89192,0,2,4
25390,4,1,89194,89194,89195,0,1,2
25391,1,3,89195,89195,89198,0,3,0
25392,2,3,89197,89198,89201,1,4,0
25393,3,2,89200,89201,89203,1,3,0
25394,6,2,89206,89206,89208,0,2,3
25395,4,2,89210,89210,89212,0,2,2
25396,6,1,89216,89216,89217,0,1,4
25397,4,3,89220,89220,89223,0,3,3
25398,5,3,89225,89225,89228,0,3,2
25399,3,3,89228,89228,89231,0,3,0
25400,4,1,89232,89232,89233,0,1,1
25401,1,2,89233,89233,89235,0,2,0
25402,4,2,89237,89237,89239,0,2,2
25403,6,3,89243,89243,89246,0,3,4
25404,6,3,89249,89249,89252,0,3,3
25405,1,3,89250,89252,89255,2,5,0
25406,6,3,89256,89256,89259,0,3,1
25407,1,3,89257,89259,89262,2,5,0
25408,4,1,89261,89262,89263,1,2,0
25409,4,2,89265,89265,89267,0,2,2
25410,6,2,89271,89271,89273,0,2,4
25411,5,3,89276,89276,89279,0,3,3
25412,1,1,89277,89279,89280,2,3,0
25413,3,3,89280,89280,89283,0,3,0
25414,5,3,89285,89285,89288,0,3,2
25415,2,3,89287,89288,89291,1,4,0
25416,5,1,89292,89292,89293,0,1,1
25417,3,2,89295,89295,89297,0,2,2
25418,5,2,89300,89300,89302,0,2,3
25419,5,3,89305,89305,89308,0,3,3
25420,2,1,89307,89308,89309,1,2,0
25421,2,1,89309,89309,89310,0,1,0
25422,5,2,89314,89314,89316,0,2,4
25423,3,1,89317,89317,89318,0,1,1
25424,2,1,89319,89319,89320,0,1,1
25425,6,1,89325,89325,89326,0,1,5
25426,4,2,89329,89329,89331,0,2,3
25427,2,2,89331,89331,89333,0,2,0
25428,2,3,89333,89333,89336,0,3,0
25429,6,3,89339,89339,89342,0,3,3
25430,3,2,89342,89342,89344,0,2,0
25431,4,1,89346,89346,89347,0,1,2
25432,1,3,89347,89347,89350,0,3,0
25433,4,1,89351,89351,89352,0,1,1
25434,1,3,89352,89352,89355,0,3,0
25435,5,1,89357,89357,89358,0,1,2
25436,5,2,89362,89362,89364,0,2,4
25437,6,2,89368,89368,89370,0,2,4
25438,5,3,89373,89373,89376,0,3,3
25439,1,2,89374,89376,89378,2,4,0
25440,6,3,89380,89380,89383,0,3,2
25441,5,1,89385,89385,89386,0,1,2
25442,5,3,89390,89390,89393,0,3,4
25443,1,2,89391,89393,89395,2,4,0
25444,6,2,89397,89397,89399,0,2,2
25445,6,3,89403,89403,89406,0,3,4
25446,6,2,89409,89409,89411,0,2,3
25447,5,1,89414,89414,89415,0,1,3
25448,3,3,89417,89417,89420,0,3,2
25449,1,1,89418,89420,89421,2,3,0
25450,1,1,89419,89421,89422,2,3,0
25451,3,1,89422,89422,89423,0,1,0
25452,3,3,89425,89425,89428,0,3,2
25453,2,2,89427,89428,89430,1,3,0
25454,2,1,89429,89430,89431,1,2,0
25455,1,1,89430,89431,89432,1,2,0
25456,1,3,89431,89432,89435,1,4,0
25457,5,2,89436,89436,89438,0,2,1
25458,4,2,89440,89440,89442,0,2,2
25459,6,3,89446,89446,89449,0,3,4
25460,5,3,89451,89451,89454,0,3,2
25461,2,1,89453,89454,89455,1,2,0
25462,2,1,89455,89455,89456,0,1,0
25463,2,3,89457,89457,89460,0,3,1
25464,6,3,89463,89463,89466,0,3,3
25465,2,3,89465,89466,89469,1,4,0
25466,4,1,89469,89469,89470,0,1,0
25467,3,1,89472,89472,89473,0,1,2
25468,6,1,89478,89478,89479,0,1,5
25469,2,3,89480,89480,89483,0,3,1
25470,4,2,89484,89484,89486,0,2,1
25471,4,1,89488,89488,89489,0,1,2
25472,2,1,89490,89490,89491,0,1,1
25473,4,1,89494,89494,89495,0,1,3
25474,3,3,89497,89497,89500,0,3,2
25475,4,2,89501,89501,89503,0,2,1
25476,4,1,89505,89505,89506,0,1,2
25477,3,2,89508,89508,89510,0,2,2
25478,6,1,89514,89514,89515,0,1,4
25479,4,1,89518,89518,89519,0,1,3
25480,2,1,89520,89520,89521,0,1,1
25481,3,2,89523,89523,89525,0,2,2
25482,4,2,89527,89527,89529,0,2,2
25483,3,2,89530,89530,89532,0,2,1
25484,6,3,89536,89536,89539,0,3,4
25485,2,3,89538,89539,89542,1,4,0
25486,5,3,89543,89543,89546,0,3,1
25487,4,1,89547,89547,89548,0,1,1
25488,2,3,89549,89549,89552,0,3,1
25489,2,3,89551,89552,89555,1,4,0
25490,2,1,89553,89555,89556,2,3,0
25491,6,2,89559,89559,89561,0,2,3
25492,4,3,89563,89563,89566,0,3,2
25493,1,2,89564,89566,89568,2,4,0
25494,1,3,89565,89568,89571,3,6,0
25495,2,3,89567,89571,89574,4,7,0
25496,3,1,89570,89574,89575,4,5,0
25497,1,1,89571,89575,89576,4,5,0
25498,4,1,89575,89576,89577,1,2,0
25499,3,2,89578,89578,89580,0,2,1
25500,1,2,89579,89580,89582,1,3,0
25501,1,1,89580,89582,89583,2,3,0
25502,5,1,89585,89585,89586,0,1,2
25503,2,3,89587,89587,89590,0,3,1
25504,5,2,89592,89592,89594,0,2,2
25505,5,2,89597,89597,89599,0,2,3
25506,6,3,89603,89603,89606,0,3,4
25507,5,2,89608,89608,89610,0,2,2
25508,4,1,89612,89612,89613,0,1,2
25509,6,2,89618,89618,89620,0,2,5
25510,5,2,89623,89623,89625,0,2,3
25511,6,2,89629,89629,89631,0,2,4
25512,5,3,89634,89634,89637,0,3,3
25513,5,1,89639,89639,89640,0,1,2
25514,6,1,89645,89645,89646,0,1,5
25515,4,3,89649,89649,89652,0,3,3
25516,1,3,89650,89652,89655,2,5,0
25517,3,3,89653,89655,89658,2,5,0
25518,4,2,89657,89658,89660,1,3,0
25519,1,1,89658,89660,89661,2,3,0
25520,1,2,89659,89661,89663,2,4,0
25521,3,1,89662,89663,89664,1,2,0
25522,1,2,89663,89664,89666,1,3,0
25523,1,3,89664,89666,89669,2,5,0
25524,4,3,89668,89669,89672,1,4,0
25525,5,2,89673,89673,89675,0,2,1
25526,3,1,89676,89676,89677,0,1,1
25527,1,2,89677,89677,89679,0,2,0
25528,1,2,89678,89679,89681,1,3,0
25529,3,1,89681,89681,89682,0,1,0
25530,3,1,89684,89684,89685,0,1,2
25531,5,3,89689,89689,89692,0,3,4
25532,1,1,89690,89692,89693,2,3,0
25533,3,3,89693,89693,89696,0,3,0
25534,1,3,89694,89696,89699,2,5,0
25535,1,2,89695,89699,89701,4,6,0
25536,5,1,89700,89701,89702,1,2,0
25537,6,2,89706,89706,89708,0,2,4
25538,6,3,89712,89712,89715,0,3,4
25539,6,3,89718,89718,89721,0,3,3
25540,4,3,89722,89722,89725,0,3,1
25541,1,1,89723,89725,89726,2,3,0
25542,3,3,89726,89726,89729,0,3,0
25543,2,3,89728,89729,89732,1,4,0
25544,2,1,89730,89732,89733,2,3,0
25545,2,3,89732,89733,89736,1,4,0
25546,3,2,89735,89736,89738,1,3,0
25547,6,3,89741,89741,89744,0,3,3
25548,3,3,89744,89744,89747,0,3,0
25549,2,2,89746,89747,89749,1,3,0
25550,5,2,89751,89751,89753,0,2,2
25551,1,3,89752,89753,89756,1,4,0
25552,1,2,89753,89756,89758,3,5,0
25553,4,2,89757,89758,89760,1,3,0
25554,5,3,89762,89762,89765,0,3,2
25555,6,1,89768,89768,89769,0,1,3
25556,6,3,89774,89774,89777,0,3,5
25557,6,3,89780,89780,89783,0,3,3
25558,2,1,89782,89783,89784,1,2,0
25559,1,1,89783,89784,89785,1,2,0
25560,3,2,89786,89786,89788,0,2,1
25561,2,1,89788,89788,89789,0,1,0
25562,3,3,89791,89791,89794,0,3,2
25563,2,2,89793,89794,89796,1,3,0
25564,2,1,89795,89796,89797,1,2,0
25565,1,2,89796,89797,89799,1,3,0
25566,5,1,89801,89801,89802,0,1,2
25567,2,3,89803,89803,89806,0,3,1
25568,3,3,89806,89806,89809,0,3,0
25569,5,1,89811,89811,89812,0,1,2
25570,5,1,89816,89816,89817,0,1,4
25571,5,2,89821,89821,89823,0,2,4
25572,2,3,89823,89823,89826,0,3,0
25573,4,1,89827,89827,89828,0,1,1
25574,6,1,89833,89833,89834,0,1,5
25575,5,2,89838,89838,89840,0,2,4
25576,3,3,89841,89841,89844,0,3,1
25577,6,1,89847,89847,89848,0,1,3
25578,4,1,89851,89851,89852,0,1,3
25579,3,1,89854,89854,89855,0,1,2
25580,2,1,89856,89856,89857,0,1,1
25581,3,3,89859,89859,89862,0,3,2
25582,5,3,89864,89864,89867,0,3,2
25583,6,1,89870,89870,89871,0,1,3
25584,3,2,89873,89873,89875,0,2,2
25585,6,2,89879,89879,89881,0,2,4
25586,2,1,89881,89881,89882,0,1,0
25587,1,2,89882,89882,89884,0,2,0
25588,5,3,89887,89887,89890,0,3,3
25589,2,1,89889,89890,89891,1,2,0
25590,6,1,89895,89895,89896,0,1,4
25591,3,3,89898,89898,89901,0,3,2
25592,4,2,89902,89902,89904,0,2,1
25593,5,2,89907,89907,89909,0,2,3
25594,2,3,89909,89909,89912,0,3,0
25595,3,2,89912,89912,89914,0,2,0
25596,3,1,89915,89915,89916,0,1,1
25597,1,3,89916,89916,89919,0,3,0
25598,5,1,89921,89921,89922,0,1,2
25599,2,2,89923,89923,89925,0,2,1
25600,4,3,89927,89927,89930,0,3,2
25601,2,3,89929,89930,89933,1,4,0
25602,3,2,89932,89933,89935,1,3,0
25603,5,2,89937,89937,89939,0,2,2
25604,3,2,89940,89940,89942,0,2,1
25605,1,3,89941,89942,89945,1,4,0
25606,1,3,89942,89945,89948,3,6,0
25607,4,2,89946,89948,89950,2,4,0
25608,4,2,89950,89950,89952,0,2,0
25609,1,3,89951,89952,89955,1,4,0
25610,4,2,89955,89955,89957,0,2,0
25611,6,3,89961,89961,89964,0,3,4
25612,5,3,89966,89966,89969,0,3,2
25613,2,2,89968,89969,89971,1,3,0
25614,6,2,89974,89974,89976,0,2,3
25615,5,1,89979,89979,89980,0,1,3
25616,2,1,89981,89981,89982,0,1,1
25617,2,3,89983,89983,89986,0,3,1
25618,1,1,89984,89986,89987,2,3,0
25619,2,1,89986,89987,89988,1,2,0
25620,4,3,89990,89990,89993,0,3,2
25621,2,3,89992,89993,89996,1,4,0
25622,5,2,89997,89997,89999,0,2,1
25623,3,2,90000,90000,90002,0,2,1
25624,6,1,90006,90006,90007,0,1,4
25625,6,2,90012,90012,90014,0,2,5
25626,3,3,90015,90015,90018,0,3,1
25627,6,1,90021,90021,90022,0,1,3
25628,3,1,90024,90024,90025,0,1,2
25629,5,3,90029,90029,90032,0,3,4
25630,6,1,90035,90035,90036,0,1,3
25631,3,1,90038,90038,90039,0,1,2
25632,2,3,90040,90040,90043,0,3,1
25633,3,3,90043,90043,90046,0,3,0
25634,5,2,90048,90048,90050,0,2,2
25635,4,2,90052,90052,90054,0,2,2
25636,2,1,90054,90054,90055,0,1,0
25637,5,1,90059,90059,90060,0,1,4
25638,2,1,90061,90061,90062,0,1,1
25639,6,1,90067,90067,90068,0,1,5
25640,6,3,90073,90073,90076,0,3,5
25641,1,3,90074,90076,90079,2,5,0
25642,4,3,90078,90079,90082,1,4,0
25643,3,1,90081,90082,90083,1,2,0
25644,6,3,90087,90087,90090,0,3,4
25645,6,2,90093,90093,90095,0,2,3
25646,2,2,90095,90095,90097,0,2,0
25647,5,3,90100,90100,90103,0,3,3
25648,1,3,90101,90103,90106,2,5,0
25649,1,1,90102,90106,90107,4,5,0
25650,3,1,90105,90107,90108,2,3,0
25651,6,1,90111,90111,90112,0,1,3
25652,3,2,90114,90114,90116,0,2,2
25653,4,3,90118,90118,90121,0,3,2
25654,4,2,90122,90122,90124,0,2,1
25655,6,3,90128,90128,90131,0,3,4
25656,3,1,90131,90131,90132,0,1,0
25657,2,3,90133,90133,90136,0,3,1
25658,6,2,90139,90139,90141,0,2,3
25659,1,1,90140,90141,90142,1,2,0
25660,2,2,90142,90142,90144,0,2,0
25661,6,3,90148,90148,90151,0,3,4
25662,3,2,90151,90151,90153,0,2,0
25663,6,3,90157,90157,90160,0,3,4
25664,2,1,90159,90160,90161,1,2,0
25665,5,2,90164,90164,90166,0,2,3
25666,3,2,90167,90167,90169,0,2,1
25667,4,2,90171,90171,90173,0,2,2
25668,2,2,90173,90173,90175,0,2,0
25669,5,2,90178,90178,90180,0,2,3
25670,5,2,90183,90183,90185,0,2,3
25671,1,3,90184,90185,90188,1,4,0
25672,3,2,90187,90188,90190,1,3,0
25673,6,2,90193,90193,90195,0,2,3
25674,3,1,90196,90196,90197,0,1,1
25675,2,1,90198,90198,90199,0,1,1
25676,2,2,90200,90200,90202,0,2,1
25677,5,3,90205,90205,90208,0,3,3
25678,2,3,90207,90208,90211,1,4,0
25679,4,3,90211,90211,90214,0,3,0
25680,5,3,90216,90216,90219,0,3,2
25681,5,2,90221,90221,90223,0,2,2
25682,1,1,90222,90223,90224,1,2,0
25683,6,1,90228,90228,90229,0,1,4
25684,6,3,90234,90234,90237,0,3,5
25685,6,3,90240,90240,90243,0,3,3
25686,1,3,90241,90243,90246,2,5,0
25687,2,3,90243,90246,90249,3,6,0
25688,3,2,90246,90249,90251,3,5,0
25689,2,2,90248,90251,90253,3,5,0
25690,4,1,90252,90253,90254,1,2,0
25691,4,3,90256,90256,90259,0,3,2
25692,5,1,90261,90261,90262,0,1,2
25693,4,2,90265,90265,90267,0,2,3
25694,1,3,90266,90267,90270,1,4,0
25695,5,3,90271,90271,90274,0,3,1
25696,4,2,90275,90275,90277,0,2,1
25697,5,1,90280,90280,90281,0,1,3
25698,4,2,90284,90284,90286,0,2,3
25699,5,3,90289,90289,90292,0,3,3
25700,6,3,90295,90295,90298,0,3,3
25701,5,3,90300,90300,90303,0,3,2
25702,4,3,90304,90304,90307,0,3,1
25703,3,3,90307,90307,90310,0,3,0
25704,5,1,90312,90312,90313,0,1,2
25705,6,3,90318,90318,90321,0,3,5
25706,6,3,90324,90324,90327,0,3,3
25707,3,1,90327,90327,90328,0,1,0
25708,6,2,90333,90333,90335,0,2,5
25709,4,1,90337,90337,90338,0,1,2
25710,6,2,90343,90343,90345,0,2,5
25711,6,1,90349,90349,90350,0,1,4
25712,5,2,90354,90354,90356,0,2,4
25713,3,2,90357,90357,90359,0,2,1
25714,5,2,90362,90362,90364,0,2,3
25715,5,1,90367,90367,90368,0,1,3
25716,5,1,90372,90372,90373,0,1,4
25717,1,3,90373,90373,90376,0,3,0
25718,4,3,90377,90377,90380,0,3,1
25719,5,3,90382,90382,90385,0,3,2
25720,4,2,90386,90386,90388,0,2,1
25721,5,3,90391,90391,90394,0,3,3
25722,4,3,90395,90395,90398,0,3,1
25723,2,3,90397,90398,90401,1,4,0
25724,4,3,90401,90401,90404,0,3,0
25725,5,1,90406,90406,90407,0,1,2
25726,3,1,90409,90409,90410,0,1,2
25727,6,3,90415,90415,90418,0,3,5
25728,4,3,90419,90419,90422,0,3,1
25729,2,1,90421,90422,90423,1,2,0
25730,6,2,90427,90427,90429,0,2,4
25731,4,1,90431,90431,90432,0,1,2
25732,2,2,90433,90433,90435,0,2,1
25733,2,1,90435,90435,90436,0,1,0
25734,5,2,90440,90440,90442,0,2,4
25735,4,2,90444,90444,90446,0,2,2
25736,3,3,90447,90447,90450,0,3,1
25737,4,2,90451,90451,90453,0,2,1
25738,2,3,90453,90453,90456,0,3,0
25739,6,2,90459,90459,90461,0,2,3
25740,5,1,90464,90464,90465,0,1,3
25741,6,3,90470,90470,90473,0,3,5
25742,3,1,90473,90473,90474,0,1,0
25743,4,2,90477,90477,90479,0,2,3
25744,2,1,90479,90479,90480,0,1,0
25745,4,3,90483,90483,90486,0,3,3
25746,3,3,90486,90486,90489,0,3,0
25747,1,3,90487,90489,90492,2,5,0
25748,4,1,90491,90492,90493,1,2,0
25749,1,2,90492,90493,90495,1,3,0
25750,2,3,90494,90495,90498,1,4,0
25751,1,3,90495,90498,90501,3,6,0
25752,1,1,90496,90501,90502,5,6,0
25753,3,3,90499,90502,90505,3,6,0
25754,5,2,90504,90505,90507,1,3,0
25755,4,2,90508,90508,90510,0,2,1
25756,5,2,90513,90513,90515,0,2,3
25757,4,1,90517,90517,90518,0,1,2
25758,3,3,90520,90520,90523,0,3,2
25759,3,2,90523,90523,90525,0,2,0
25760,2,1,90525,90525,90526,0,1,0
25761,2,1,90527,90527,90528,0,1,1
25762,5,3,90532,90532,90535,0,3,4
25763,6,3,90538,90538,90541,0,3,3
25764,6,2,90544,90544,90546,0,2,3
25765,2,3,90546,90546,90549,0,3,0
25766,6,2,90552,90552,90554,0,2,3
25767,3,2,90555,90555,90557,0,2,1
25768,1,3,90556,90557,90560,1,4,0
25769,2,2,90558,90560,90562,2,4,0
25770,2,2,90560,90562,90564,2,4,0
25771,2,3,90562,90564,90567,2,5,0
25772,2,1,90564,90567,90568,3,4,0
25773,4,2,90568,90568,90570,0,2,0
25774,2,2,90570,90570,90572,0,2,0
25775,3,3,90573,90573,90576,0,3,1
25776,4,1,90577,90577,90578,0,1,1
25777,3,3,90580,90580,90583,0,3,2
25778,1,2,90581,90583,90585,2,4,0
25779,4,3,90585,90585,90588,0,3,0
25780,5,1,90590,90590,90591,0,1,2
25781,3,1,90593,90593,90594,0,1,2
25782,3,1,90596,90596,90597,0,1,2
25783,3,2,90599,90599,90601,0,2,2
25784,3,2,90602,90602,90604,0,2,1
25785,6,2,90608,90608,90610,0,2,4
25786,6,3,90614,90614,90617,0,3,4
25787,4,3,90618,90618,90621,0,3,1
25788,4,1,90622,90622,90623,0,1,1
25789,3,1,90625,90625,90626,0,1,2
25790,3,3,90628,90628,90631,0,3,2
25791,1,1,90629,90631,90632,2,3,0
25792,1,1,90630,90632,90633,2,3,0
25793,2,1,90632,90633,90634,1,2,0
25794,5,2,90637,90637,90639,0,2,3
25795,5,3,90642,90642,90645,0,3,3
25796,5,3,90647,90647,90650,0,3,2
25797,5,1,90652,90652,90653,0,1,2
25798,2,3,90654,90654,90657,0,3,1
25799,1,1,90655,90657,90658,2,3,0
25800,3,2,90658,90658,90660,0,2,0
25801,3,2,90661,90661,90663,0,2,1
25802,3,2,90664,90664,90666,0,2,1
25803,4,1,90668,90668,90669,0,1,2
25804,4,3,90672,90672,90675,0,3,3
25805,4,1,90676,90676,90677,0,1,1
25806,1,1,90677,90677,90678,0,1,0
25807,4,3,90681,90681,90684,0,3,3
25808,5,3,90686,90686,90689,0,3,2
25809,1,2,90687,90689,90691,2,4,0
25810,6,1,90693,90693,90694,0,1,2
25811,5,2,90698,90698,90700,0,2,4
25812,6,3,90704,90704,90707,0,3,4
25813,6,3,90710,90710,90713,0,3,3
25814,5,2,90715,90715,90717,0,2,2
25815,3,3,90718,90718,90721,0,3,1
25816,4,1,90722,90722,90723,0,1,1
25817,4,2,90726,90726,90728,0,2,3
25818,6,1,90732,90732,90733,0,1,4
25819,4,1,90736,90736,90737,0,1,3
25820,5,3,90741,90741,90744,0,3,4
25821,5,1,90746,90746,90747,0,1,2
25822,5,2,90751,90751,90753,0,2,4
25823,6,3,90757,90757,90760,0,3,4
25824,5,3,90762,90762,90765,0,3,2
25825,5,2,90767,90767,90769,0,2,2
25826,2,2,90769,90769,90771,0,2,0
25827,5,1,90774,90774,90775,0,1,3
25828,1,3,90775,90775,90778,0,3,0
25829,5,2,90780,90780,90782,0,2,2
25830,2,2,90782,90782,90784,0,2,0
25831,6,2,90788,90788,90790,0,2,4
25832,3,2,90791,90791,90793,0,2,1
25833,2,3,90793,90793,90796,0,3,0
25834,6,2,90799,90799,90801,0,2,3
25835,2,1,90801,90801,90802,0,1,0
25836,6,3,90807,90807,90810,0,3,5
25837,1,2,90808,90810,90812,2,4,0
25838,2,2,90810,90812,90814,2,4,0
25839,4,1,90814,90814,90815,0,1,0
25840,2,2,90816,90816,90818,0,2,1
25841,6,3,90822,90822,90825,0,3,4
25842,2,1,90824,90825,90826,1,2,0
25843,5,2,90829,90829,90831,0,2,3
25844,2,2,90831,90831,90833,0,2,0
25845,5,1,90836,90836,90837,0,1,3
25846,5,3,90841,90841,90844,0,3,4
25847,3,3,90844,90844,90847,0,3,0
25848,4,1,90848,90848,90849,0,1,1
25849,4,3,90852,90852,90855,0,3,3
25850,6,2,90858,90858,90860,0,2,3
25851,2,1,90860,90860,90861,0,1,0
25852,1,1,90861,90861,90862,0,1,0
25853,2,3,90863,90863,90866,0,3,1
25854,5,2,90868,90868,90870,0,2,2
25855,4,3,90872,90872,90875,0,3,2
25856,4,2,90876,90876,90878,0,2,1
25857,5,2,90881,90881,90883,0,2,3
25858,3,3,90884,90884,90887,0,3,1
25859,5,1,90889,90889,90890,0,1,2
25860,2,2,90891,90891,90893,0,2,1
25861,1,2,90892,90893,90895,1,3,0
25862,1,3,90893,90895,90898,2,5,0
25863,4,1,90897,90898,90899,1,2,0
25864,5,1,90902,90902,90903,0,1,3
25865,1,3,90903,90903,90906,0,3,0
25866,3,1,90906,90906,90907,0,1,0
25867,4,2,90910,90910,90912,0,2,3
25868,2,3,90912,90912,90915,0,3,0
25869,2,1,90914,90915,90916,1,2,0
25870,6,1,90920,90920,90921,0,1,4
25871,5,1,90925,90925,90926,0,1,4
25872,5,3,90930,90930,90933,0,3,4
25873,5,2,90935,90935,90937,0,2,2
25874,6,1,90941,90941,90942,0,1,4
25875,5,1,90946,90946,90947,0,1,4
25876,1,1,90947,90947,90948,0,1,0
25877,5,2,90952,90952,90954,0,2,4
25878,2,3,90954,90954,90957,0,3,0
25879,3,2,90957,90957,90959,0,2,0
25880,4,1,90961,90961,90962,0,1,2
25881,3,2,90964,90964,90966,0,2,2
25882,1,1,90965,90966,90967,1,2,0
25883,2,1,90967,90967,90968,0,1,0
25884,1,2,90968,90968,90970,0,2,0
25885,2,1,90970,90970,90971,0,1,0
25886,3,2,90973,90973,90975,0,2,2
25887,2,3,90975,90975,90978,0,3,0
25888,4,2,90979,90979,90981,0,2,1
25889,4,3,90983,90983,90986,0,3,2
25890,4,3,90987,90987,90990,0,3,1
25891,5,3,90992,90992,90995,0,3,2
25892,6,2,90998,90998,91000,0,2,3
25893,5,3,91003,91003,91006,0,3,3
25894,2,3,91005,91006,91009,1,4,0
25895,3,3,91008,91009,91012,1,4,0
25896,2,3,91010,91012,91015,2,5,0
25897,4,1,91014,91015,91016,1,2,0
25898,4,2,91018,91018,91020,0,2,2
25899,3,3,91021,91021,91024,0,3,1
25900,3,3,91024,91024,91027,0,3,0
25901,2,1,91026,91027,91028,1,2,0
25902,2,3,91028,91028,91031,0,3,0
25903,1,2,91029,91031,91033,2,4,0
25904,2,1,91031,91033,91034,2,3,0
25905,6,2,91037,91037,91039,0,2,3
25906,5,3,91042,91042,91045,0,3,3
25907,6,3,91048,91048,91051,0,3,3
25908,1,2,91049,91051,91053,2,4,0
25909,4,2,91053,91053,91055,0,2,0
25910,3,3,91056,91056,91059,0,3,1
25911,4,1,91060,91060,91061,0,1,1
25912,4,2,91064,91064,91066,0,2,3
25913,1,3,91065,91066,91069,1,4,0
25914,5,2,91070,91070,91072,0,2,1
25915,4,2,91074,91074,91076,0,2,2
25916,4,3,91078,91078,91081,0,3,2
25917,6,1,91084,91084,91085,0,1,3
25918,6,1,91090,91090,91091,0,1,5
25919,1,3,91091,91091,91094,0,3,0
25920,4,2,91095,91095,91097,0,2,1
25921,4,2,91099,91099,91101,0,2,2
25922,6,1,91105,91105,91106,0,1,4
25923,4,1,91109,91109,91110,0,1,3
25924,2,1,91111,91111,91112,0,1,1
25925,5,3,91116,91116,91119,0,3,4
25926,2,3,91118,91119,91122,1,4,0
25927,3,2,91121,91122,91124,1,3,0
25928,2,3,91123,91124,91127,1,4,0
25929,6,1,91129,91129,91130,0,1,2
25930,1,1,91130,91130,91131,0,1,0
25931,5,2,91135,91135,91137,0,2,4
25932,2,1,91137,91137,91138,0,1,0
25933,1,2,91138,91138,91140,0,2,0
25934,5,2,91143,91143,91145,0,2,3
25935,6,3,91149,91149,91152,0,3,4
25936,5,1,91154,91154,91155,0,1,2
25937,6,2,91160,91160,91162,0,2,5
25938,3,2,91163,91163,91165,0,2,1
25939,6,2,91169,91169,91171,0,2,4
25940,2,3,91171,91171,91174,0,3,0
25941,1,1,91172,91174,91175,2,3,0
25942,6,2,91178,91178,91180,0,2,3
25943,1,2,91179,91180,91182,1,3,0
25944,4,2,91183,91183,91185,0,2,1
25945,4,3,91187,91187,91190,0,3,2
25946,3,1,91190,91190,91191,0,1,0
25947,3,3,91193,91193,91196,0,3,2
25948,5,1,91198,91198,91199,0,1,2
25949,3,2,91201,91201,91203,0,2,2
25950,1,1,91202,91203,91204,1,2,0
25951,6,1,91208,91208,91209,0,1,4
25952,3,2,91211,91211,91213,0,2,2
25953,4,3,91215,91215,91218,0,3,2
25954,3,1,91218,91218,91219,0,1,0
25955,4,3,91222,91222,91225,0,3,3
25956,2,3,91224,91225,91228,1,4,0
25957,4,2,91228,91228,91230,0,2,0
25958,6,3,91234,91234,91237,0,3,4
25959,4,3,91238,91238,91241,0,3,1
25960,6,1,91244,91244,91245,0,1,3
25961,3,2,91247,91247,91249,0,2,2
25962,6,3,91253,91253,91256,0,3,4
25963,2,2,91255,91256,91258,1,3,0
25964,3,1,91258,91258,91259,0,1,0
25965,5,3,91263,91263,91266,0,3,4
25966,2,1,91265,91266,91267,1,2,0
25967,6,2,91271,91271,91273,0,2,4
25968,4,3,91275,91275,91278,0,3,2
25969,4,3,91279,91279,91282,0,3,1
25970,5,2,91284,91284,91286,0,2,2
25971,6,1,91290,91290,91291,0,1,4
25972,6,3,91296,91296,91299,0,3,5
25973,2,3,91298,91299,91302,1,4,0
25974,2,1,91300,91302,91303,2,3,0
25975,5,2,91305,91305,91307,0,2,2
25976,5,3,91310,91310,91313,0,3,3
25977,3,3,91313,91313,91316,0,3,0
25978,4,2,91317,91317,91319,0,2,1
25979,6,1,91323,91323,91324,0,1,4
25980,4,2,91327,91327,91329,0,2,3
25981,2,3,91329,91329,91332,0,3,0
25982,2,2,91331,91332,91334,1,3,0
25983,1,1,91332,91334,91335,2,3,0
25984,6,3,91338,91338,91341,0,3,3
25985,1,3,91339,91341,91344,2,5,0
25986,1,3,91340,91344,91347,4,7,0
25987,1,2,91341,91347,91349,6,8,0
25988,4,1,91345,91349,91350,4,5,0
25989,6,2,91351,91351,91353,0,2,1
25990,3,3,91354,91354,91357,0,3,1
25991,3,3,91357,91357,91360,0,3,0
25992,1,2,91358,91360,91362,2,4,0
25993,6,3,91364,91364,91367,0,3,2
25994,4,3,91368,91368,91371,0,3,1
25995,6,1,91374,91374,91375,0,1,3
25996,2,1,91376,91376,91377,0,1,1
25997,3,1,91379,91379,91380,0,1,2
25998,5,1,91384,91384,91385,0,1,4
25999,3,3,91387,91387,91390,0,3,2
26000,5,1,91392,91392,91393,0,1,2
26001,3,1,91395,91395,91396,0,1,2
26002,6,2,91401,91401,91403,0,2,5
26003,3,2,91404,91404,91406,0,2,1
26004,2,3,91406,91406,91409,0,3,0
26005,1,2,91407,91409,91411,2,4,0
26006,6,3,91413,91413,91416,0,3,2
26007,5,1,91418,91418,91419,0,1,2
26008,2,1,91420,91420,91421,0,1,1
26009,3,3,91423,91423,91426,0,3,2
26010,6,2,91429,91429,91431,0,2,3
26011,2,1,91431,91431,91432,0,1,0
26012,5,2,91436,91436,91438,0,2,4
26013,6,1,91442,91442,91443,0,1,4
26014,2,3,91444,91444,91447,0,3,1
26015,6,2,91450,91450,91452,0,2,3
26016,5,2,91455,91455,91457,0,2,3
26017,3,3,91458,91458,91461,0,3,1
26018,3,3,91461,91461,91464,0,3,0
26019,1,3,91462,91464,91467,2,5,0
26020,3,2,91465,91467,91469,2,4,0
26021,1,3,91466,91469,91472,3,6,0
26022,5,1,91471,91472,91473,1,2,0
26023,3,2,91474,91474,91476,0,2,1
26024,1,3,91475,91476,91479,1,4,0
26025,2,2,91477,91479,91481,2,4,0
26026,5,3,91482,91482,91485,0,3,1
26027,6,2,91488,91488,91490,0,2,3
26028,1,2,91489,91490,91492,1,3,0
26029,5,2,91494,91494,91496,0,2,2
26030,2,1,91496,91496,91497,0,1,0
26031,5,2,91501,91501,91503,0,2,4
26032,5,3,91506,91506,91509,0,3,3
26033,3,2,91509,91509,91511,0,2,0
26034,4,3,91513,91513,91516,0,3,2
26035,6,2,91519,91519,91521,0,2,3
26036,2,1,91521,91521,91522,0,1,0
26037,4,1,91525,91525,91526,0,1,3
26038,6,3,91531,91531,91534,0,3,5
26039,3,2,91534,91534,91536,0,2,0
26040,1,1,91535,91536,91537,1,2,0
26041,4,3,91539,91539,91542,0,3,2
26042,6,3,91545,91545,91548,0,3,3
26043,1,1,91546,91548,91549,2,3,0
26044,4,1,91550,91550,91551,0,1,1
26045,1,2,91551,91551,91553,0,2,0
26046,2,3,91553,91553,91556,0,3,0
26047,6,3,91559,91559,91562,0,3,3
26048,5,3,91564,91564,91567,0,3,2
26049,3,3,91567,91567,91570,0,3,0
26050,4,1,91571,91571,91572,0,1,1
26051,2,2,91573,91573,91575,0,2,1
26052,5,2,91578,91578,91580,0,2,3
26053,6,2,91584,91584,91586,0,2,4
26054,2,2,91586,91586,91588,0,2,0
26055,2,1,91588,91588,91589,0,1,0
26056,3,3,91591,91591,91594,0,3,2
26057,3,2,91594,91594,91596,0,2,0
26058,4,2,91598,91598,91600,0,2,2
26059,6,3,91604,91604,91607,0,3,4
26060,5,1,91609,91609,91610,0,1,2
26061,2,1,91611,91611,91612,0,1,1
26062,3,2,91614,91614,91616,0,2,2
26063,3,2,91617,91617,91619,0,2,1
26064,1,1,91618,91619,91620,1,2,0
26065,4,1,91622,91622,91623,0,1,2
26066,3,3,91625,91625,91628,0,3,2
26067,5,1,91630,91630,91631,0,1,2
26068,3,1,91633,91633,91634,0,1,2
26069,1,1,91634,91634,91635,0,1,0
26070,5,2,91639,91639,91641,0,2,4
26071,5,2,91644,91644,91646,0,2,3
26072,2,2,91646,91646,91648,0,2,0
26073,4,3,91650,91650,91653,0,3,2
26074,1,3,91651,91653,91656,2,5,0
26075,2,2,91653,91656,91658,3,5,0
26076,6,1,91659,91659,91660,0,1,1
26077,2,1,91661,91661,91662,0,1,1
26078,2,2,91663,91663,91665,0,2,1
26079,6,2,91669,91669,91671,0,2,4
26080,2,3,91671,91671,91674,0,3,0
26081,2,3,91673,91674,91677,1,4,0
26082,5,2,91678,91678,91680,0,2,1
26083,1,1,91679,91680,91681,1,2,0
26084,1,3,91680,91681,91684,1,4,0
26085,1,2,91681,91684,91686,3,5,0
26086,3,2,91684,91686,91688,2,4,0
26087,4,2,91688,91688,91690,0,2,0
26088,5,2,91693,91693,91695,0,2,3
26089,3,1,91696,91696,91697,0,1,1
26090,3,2,91699,91699,91701,0,2,2
26091,3,1,91702,91702,91703,0,1,1
26092,5,1,91707,91707,91708,0,1,4
26093,4,2,91711,91711,91713,0,2,3
26094,2,1,91713,91713,91714,0,1,0
26095,1,3,91714,91714,91717,0,3,0
26096,6,1,91720,91720,91721,0,1,3
26097,5,3,91725,91725,91728,0,3,4
26098,2,1,91727,91728,91729,1,2,0
26099,2,1,91729,91729,91730,0,1,0
26100,5,2,91734,91734,91736,0,2,4
26101,4,2,91738,91738,91740,0,2,2
26102,3,2,91741,91741,91743,0,2,1
26103,2,3,91743,91743,91746,0,3,0
26104,4,2,91747,91747,91749,0,2,1
26105,4,1,91751,91751,91752,0,1,2
26106,5,3,91756,91756,91759,0,3,4
26107,4,1,91760,91760,91761,0,1,1
26108,5,2,91765,91765,91767,0,2,4
26109,1,1,91766,91767,91768,1,2,0
26110,3,3,91769,91769,91772,0,3,1
26111,6,3,91775,91775,91778,0,3,3
26112,5,1,91780,91780,91781,0,1,2
26113,2,3,91782,91782,91785,0,3,1
26114,6,1,91788,91788,91789,0,1,3
26115,5,3,91793,91793,91796,0,3,4
26116,2,1,91795,91796,91797,1,2,0
26117,1,3,91796,91797,91800,1,4,0
26118,5,1,91801,91801,91802,0,1,1
26119,5,1,91806,91806,91807,0,1,4
26120,4,2,91810,91810,91812,0,2,3
26121,5,2,91815,91815,91817,0,2,3
26122,6,2,91821,91821,91823,0,2,4
26123,3,2,91824,91824,91826,0,2,1
26124,4,2,91828,91828,91830,0,2,2
26125,4,2,91832,91832,91834,0,2,2
26126,3,1,91835,91835,91836,0,1,1
26127,5,2,91840,91840,91842,0,2,4
26128,6,3,91846,91846,91849,0,3,4
26129,1,2,91847,91849,91851,2,4,0
26130,4,3,91851,91851,91854,0,3,0
26131,3,1,91854,91854,91855,0,1,0
26132,1,3,91855,91855,91858,0,3,0
26133,1,1,91856,91858,91859,2,3,0
26134,5,2,91861,91861,91863,0,2,2
26135,6,1,91867,91867,91868,0,1,4
26136,2,1,91869,91869,91870,0,1,1
26137,1,1,91870,91870,91871,0,1,0
26138,1,1,91871,91871,91872,0,1,0
26139,6,3,91877,91877,91880,0,3,5
26140,2,1,91879,91880,91881,1,2,0
26141,1,2,91880,91881,91883,1,3,0
26142,6,1,91886,91886,91887,0,1,3
26143,5,2,91891,91891,91893,0,2,4
26144,5,3,91896,91896,91899,0,3,3
26145,1,1,91897,91899,91900,2,3,0
26146,1,1,91898,91900,91901,2,3,0
26147,5,3,91903,91903,91906,0,3,2
26148,1,1,91904,91906,91907,2,3,0
26149,5,3,91909,91909,91912,0,3,2
26150,4,1,91913,91913,91914,0,1,1
26151,4,1,91917,91917,91918,0,1,3
26152,1,2,91918,91918,91920,0,2,0
26153,1,1,91919,91920,91921,1,2,0
26154,5,3,91924,91924,91927,0,3,3
26155,1,1,91925,91927,91928,2,3,0
26156,6,2,91931,91931,91933,0,2,3
26157,3,1,91934,91934,91935,0,1,1
26158,5,2,91939,91939,91941,0,2,4
26159,3,2,91942,91942,91944,0,2,1
26160,5,3,91947,91947,91950,0,3,3
26161,5,1,91952,91952,91953,0,1,2
26162,1,2,91953,91953,91955,0,2,0
26163,4,2,91957,91957,91959,0,2,2
26164,2,3,91959,91959,91962,0,3,0
26165,6,2,91965,91965,91967,0,2,3
26166,6,1,91971,91971,91972,0,1,4
26167,4,2,91975,91975,91977,0,2,3
26168,1,2,91976,91977,91979,1,3,0
26169,3,2,91979,91979,91981,0,2,0
26170,2,2,91981,91981,91983,0,2,0
26171,5,1,91986,91986,91987,0,1,3
26172,3,2,91989,91989,91991,0,2,2
26173,4,2,91993,91993,91995,0,2,2
26174,4,3,91997,91997,92000,0,3,2
26175,1,2,91998,92000,92002,2,4,0
26176,1,3,91999,92002,92005,3,6,0
26177,3,2,92002,92005,92007,3,5,0
26178,4,1,92006,92007,92008,1,2,0
26179,6,2,92012,92012,92014,0,2,4
26180,3,1,92015,92015,92016,0,1,1
26181,1,3,92016,92016,92019,0,3,0
26182,4,3,92020,92020,92023,0,3,1
26183,3,1,92023,92023,92024,0,1,0
26184,5,3,92028,92028,92031,0,3,4
26185,4,2,92032,92032,92034,0,2,1
26186,4,3,92036,92036,92039,0,3,2
26187,3,3,92039,92039,92042,0,3,0
26188,4,2,92043,92043,92045,0,2,1
26189,3,1,92046,92046,92047,0,1,1
26190,6,3,92052,92052,92055,0,3,5
26191,4,2,92056,92056,92058,0,2,1
26192,4,2,92060,92060,92062,0,2,2
26193,3,2,92063,92063,92065,0,2,1
26194,5,1,92068,92068,92069,0,1,3
26195,3,3,92071,92071,92074,0,3,2
26196,2,3,92073,92074,92077,1,4,0
26197,5,3,92078,92078,92081,0,3,1
26198,3,3,92081,92081,92084,0,3,0
26199,1,3,92082,92084,92087,2,5,0
26200,2,3,92084,92087,92090,3,6,0
26201,5,1,92089,92090,92091,1,2,0
26202,1,3,92090,92091,92094,1,4,0
26203,2,1,92092,92094,92095,2,3,0
26204,1,3,92093,92095,92098,2,5,0
26205,1,3,92094,92098,92101,4,7,0
26206,4,2,92098,92101,92103,3,5,0
26207,2,1,92100,92103,92104,3,4,0
26208,6,2,92106,92106,92108,0,2,2
26209,5,3,92111,92111,92114,0,3,3
26210,2,3,92113,92114,92117,1,4,0
26211,3,2,92116,92117,92119,1,3,0
26212,2,2,92118,92119,92121,1,3,0
26213,3,3,92121,92121,92124,0,3,0
26214,3,3,92124,92124,92127,0,3,0
26215,3,3,92127,92127,92130,0,3,0
26216,1,1,92128,92130,92131,2,3,0
26217,5,3,92133,92133,92136,0,3,2
26218,6,3,92139,92139,92142,0,3,3
26219,2,2,92141,92142,92144,1,3,0
26220,1,2,92142,92144,92146,2,4,0
26221,2,2,92144,92146,92148,2,4,0
26222,5,3,92149,92149,92152,0,3,1
26223,4,3,92153,92153,92156,0,3,1
26224,4,3,92157,92157,92160,0,3,1
26225,3,2,92160,92160,92162,0,2,0
26226,1,2,92161,92162,92164,1,3,0
26227,2,2,92163,92164,92166,1,3,0
26228,5,2,92168,92168,92170,0,2,2
26229,2,2,92170,92170,92172,0,2,0
26230,2,2,92172,92172,92174,0,2,0
26231,2,2,92174,92174,92176,0,2,0
26232,4,3,92178,92178,92181,0,3,2
26233,1,2,92179,92181,92183,2,4,0
26234,1,2,92180,92183,92185,3,5,0
26235,2,1,92182,92185,92186,3,4,0
26236,5,2,92187,92187,92189,0,2,1
26237,2,3,92189,92189,92192,0,3,0
26238,6,1,92195,92195,92196,0,1,3
26239,2,2,92197,92197,92199,0,2,1
26240,4,2,92201,92201,92203,0,2,2
26241,3,1,92204,92204,92205,0,1,1
26242,3,2,92207,92207,92209,0,2,2
26243,5,1,92212,92212,92213,0,1,3
26244,3,3,92215,92215,92218,0,3,2
26245,5,1,92220,92220,92221,0,1,2
26246,1,2,92221,92221,92223,0,2,0
26247,4,3,92225,92225,92228,0,3,2
26248,5,3,92230,92230,92233,0,3,2
26249,3,3,92233,92233,92236,0,3,0
26250,1,2,92234,92236,92238,2,4,0
26251,4,1,92238,92238,92239,0,1,0
26252,3,3,92241,92241,92244,0,3,2
26253,4,1,92245,92245,92246,0,1,1
26254,1,3,92246,92246,92249,0,3,0
26255,6,3,92252,92252,92255,0,3,3
26256,6,1,92258,92258,92259,0,1,3
26257,6,1,92264,92264,92265,0,1,5
26258,5,1,92269,92269,92270,0,1,4
26259,6,1,92275,92275,92276,0,1,5
26260,2,3,92277,92277,92280,0,3,1
26261,2,1,92279,92280,92281,1,2,0
26262,1,1,92280,92281,92282,1,2,0
26263,4,1,92284,92284,92285,0,1,2
26264,5,3,92289,92289,92292,0,3,4
26265,4,1,92293,92293,92294,0,1,1
26266,5,3,92298,92298,92301,0,3,4
26267,3,3,92301,92301,92304,0,3,0
26268,4,2,92305,92305,92307,0,2,1
26269,1,3,92306,92307,92310,1,4,0
26270,3,2,92309,92310,92312,1,3,0
26271,1,3,92310,92312,92315,2,5,0
26272,3,3,92313,92315,92318,2,5,0
26273,4,2,92317,92318,92320,1,3,0
26274,6,2,92323,92323,92325,0,2,3
26275,1,2,92324,92325,92327,1,3,0
26276,5,2,92329,92329,92331,0,2,2
26277,5,2,92334,92334,92336,0,2,3
26278,2,1,92336,92336,92337,0,1,0
26279,4,3,92340,92340,92343,0,3,3
26280,2,2,92342,92343,92345,1,3,0
26281,6,2,92348,92348,92350,0,2,3
26282,3,3,92351,92351,92354,0,3,1
26283,2,3,92353,92354,92357,1,4,0
26284,3,1,92356,92357,92358,1,2,0
26285,2,3,92358,92358,92361,0,3,0
26286,5,1,92363,92363,92364,0,1,2
26287,6,1,92369,92369,92370,0,1,5
26288,1,1,92370,92370,92371,0,1,0
26289,5,3,92375,92375,92378,0,3,4
26290,3,2,92378,92378,92380,0,2,0
26291,4,1,92382,92382,92383,0,1,2
26292,6,1,92388,92388,92389,0,1,5
26293,6,1,92394,92394,92395,0,1,5
26294,4,1,92398,92398,92399,0,1,3
26295,3,1,92401,92401,92402,0,1,2
26296,4,2,92405,92405,92407,0,2,3
26297,3,2,92408,92408,92410,0,2,1
26298,6,3,92414,92414,92417,0,3,4
26299,4,1,92418,92418,92419,0,1,1
26300,5,2,92423,92423,92425,0,2,4
26301,2,1,92425,92425,92426,0,1,0
26302,5,3,92430,92430,92433,0,3,4
26303,5,3,92435,92435,92438,0,3,2
26304,4,2,92439,92439,92441,0,2,1
26305,5,2,92444,92444,92446,0,2,3
26306,2,2,92446,92446,92448,0,2,0
26307,2,2,92448,92448,92450,0,2,0
26308,4,3,92452,92452,92455,0,3,2
26309,5,2,92457,92457,92459,0,2,2
26310,3,3,92460,92460,92463,0,3,1
26311,6,3,92466,92466,92469,0,3,3
26312,1,3,92467,92469,92472,2,5,0
26313,5,3,92472,92472,92475,0,3,0
26314,2,3,92474,92475,92478,1,4,0
26315,5,1,92479,92479,92480,0,1,1
26316,6,2,92485,92485,92487,0,2,5
26317,5,1,92490,92490,92491,0,1,3
26318,6,1,92496,92496,92497,0,1,5
26319,3,2,92499,92499,92501,0,2,2
26320,4,3,92503,92503,92506,0,3,2
26321,6,3,92509,92509,92512,0,3,3
26322,6,2,92515,92515,92517,0,2,3
26323,3,1,92518,92518,92519,0,1,1
26324,6,3,92524,92524,92527,0,3,5
26325,3,2,92527,92527,92529,0,2,0
26326,6,1,92533,92533,92534,0,1,4
26327,4,1,92537,92537,92538,0,1,3
26328,1,2,92538,92538,92540,0,2,0
26329,6,1,92544,92544,92545,0,1,4
26330,6,1,92550,92550,92551,0,1,5
26331,5,1,92555,92555,92556,0,1,4
26332,6,1,92561,92561,92562,0,1,5
26333,1,1,92562,92562,92563,0,1,0
26334,2,1,92564,92564,92565,0,1,1
26335,5,1,92569,92569,92570,0,1,4
26336,6,3,92575,92575,92578,0,3,5
26337,2,1,92577,92578,92579,1,2,0
26338,3,2,92580,92580,92582,0,2,1
26339,5,3,92585,92585,92588,0,3,3
26340,2,3,92587,92588,92591,1,4,0
26341,3,3,92590,92591,92594,1,4,0
26342,2,1,92592,92594,92595,2,3,0
26343,6,1,92598,92598,92599,0,1,3
26344,2,1,92600,92600,92601,0,1,1
26345,1,3,92601,92601,92604,0,3,0
26346,3,3,92604,92604,92607,0,3,0
26347,1,3,92605,92607,92610,2,5,0
26348,1,1,92606,92610,92611,4,5,0
26349,4,3,92610,92611,92614,1,4,0
26350,3,3,92613,92614,92617,1,4,0
26351,6,2,92619,92619,92621,0,2,2
26352,5,2,92624,92624,92626,0,2,3
26353,2,3,92626,92626,92629,0,3,0
26354,5,1,92631,92631,92632,0,1,2
26355,2,1,92633,92633,92634,0,1,1
26356,5,3,92638,92638,92641,0,3,4
26357,6,3,92644,92644,92647,0,3,3
26358,4,2,92648,92648,92650,0,2,1
26359,2,1,92650,92650,92651,0,1,0
26360,3,3,92653,92653,92656,0,3,2
26361,1,1,92654,92656,92657,2,3,0
26362,5,1,92659,92659,92660,0,1,2
26363,5,3,92664,92664,92667,0,3,4
26364,5,2,92669,92669,92671,0,2,2
26365,3,2,92672,92672,92674,0,2,1
26366,6,2,92678,92678,92680,0,2,4
26367,2,1,92680,92680,92681,0,1,0
26368,1,2,92681,92681,92683,0,2,0
26369,5,1,92686,92686,92687,0,1,3
26370,1,3,92687,92687,92690,0,3,0
26371,3,2,92690,92690,92692,0,2,0
26372,6,2,92696,92696,92698,0,2,4
26373,2,1,92698,92698,92699,0,1,0
26374,5,1,92703,92703,92704,0,1,4
26375,4,1,92707,92707,92708,0,1,3
26376,1,3,92708,92708,92711,0,3,0
26377,4,3,92712,92712,92715,0,3,1
26378,1,1,92713,92715,92716,2,3,0
26379,1,3,92714,92716,92719,2,5,0
26380,4,1,92718,92719,92720,1,2,0
26381,3,2,92721,92721,92723,0,2,1
26382,2,1,92723,92723,92724,0,1,0
26383,5,1,92728,92728,92729,0,1,4
26384,1,2,92729,92729,92731,0,2,0
26385,2,2,92731,92731,92733,0,2,0
26386,6,1,92737,92737,92738,0,1,4
26387,5,3,92742,92742,92745,0,3,4
26388,6,3,92748,92748,92751,0,3,3
26389,4,3,92752,92752,92755,0,3,1
26390,3,1,92755,92755,92756,0,1,0
26391,3,1,92758,92758,92759,0,1,2
26392,4,3,92762,92762,92765,0,3,3
26393,4,2,92766,92766,92768,0,2,1
26394,2,3,92768,92768,92771,0,3,0
26395,6,2,92774,92774,92776,0,2,3
26396,6,2,92780,92780,92782,0,2,4
26397,4,2,92784,92784,92786,0,2,2
26398,6,3,92790,92790,92793,0,3,4
26399,1,1,92791,92793,92794,2,3,0
26400,4,1,92795,92795,92796,0,1,1
26401,4,2,92799,92799,92801,0,2,3
26402,2,2,92801,92801,92803,0,2,0
26403,2,2,92803,92803,92805,0,2,0
26404,5,2,92808,92808,92810,0,2,3
26405,4,1,92812,92812,92813,0,1,2
26406,1,2,92813,92813,92815,0,2,0
26407,6,1,92819,92819,92820,0,1,4
26408,1,1,92820,92820,92821,0,1,0
26409,6,3,92826,92826,92829,0,3,5
26410,6,1,92832,92832,92833,0,1,3
26411,2,2,92834,92834,92836,0,2,1
26412,5,1,92839,92839,92840,0,1,3
26413,1,1,92840,92840,92841,0,1,0
26414,3,2,92843,92843,92845,0,2,2
26415,5,3,92848,92848,92851,0,3,3
26416,1,2,92849,92851,92853,2,4,0
26417,2,1,92851,92853,92854,2,3,0
26418,2,3,92853,92854,92857,1,4,0
26419,4,2,92857,92857,92859,0,2,0
26420,2,1,92859,92859,92860,0,1,0
26421,5,1,92864,92864,92865,0,1,4
26422,6,2,92870,92870,92872,0,2,5
26423,1,1,92871,92872,92873,1,2,0
26424,6,2,92877,92877,92879,0,2,4
26425,4,1,92881,92881,92882,0,1,2
26426,4,2,92885,92885,92887,0,2,3
26427,5,2,92890,92890,92892,0,2,3
26428,1,3,92891,92892,92895,1,4,0
26429,3,1,92894,92895,92896,1,2,0
26430,2,3,92896,92896,92899,0,3,0
26431,2,3,92898,92899,92902,1,4,0
26432,1,1,92899,92902,92903,3,4,0
26433,2,1,92901,92903,92904,2,3,0
26434,4,2,92905,92905,92907,0,2,1
26435,3,1,92908,92908,92909,0,1,1
26436,2,3,92910,92910,92913,0,3,1
26437,5,2,92915,92915,92917,0,2,2
26438,5,1,92920,92920,92921,0,1,3
26439,6,2,92926,92926,92928,0,2,5
26440,1,3,92927,92928,92931,1,4,0
26441,5,3,92932,92932,92935,0,3,1
26442,2,2,92934,92935,92937,1,3,0
26443,1,1,92935,92937,92938,2,3,0
26444,1,1,92936,92938,92939,2,3,0
26445,6,1,92942,92942,92943,0,1,3
26446,6,2,92948,92948,92950,0,2,5
26447,4,2,92952,92952,92954,0,2,2
26448,5,1,92957,92957,92958,0,1,3
26449,5,2,92962,92962,92964,0,2,4
26450,3,3,92965,92965,92968,0,3,1
26451,6,2,92971,92971,92973,0,2,3
26452,4,3,92975,92975,92978,0,3,2
26453,6,2,92981,92981,92983,0,2,3
26454,1,1,92982,92983,92984,1,2,0
26455,2,2,92984,92984,92986,0,2,0
26456,4,1,92988,92988,92989,0,1,2
26457,3,1,92991,92991,92992,0,1,2
26458,3,2,92994,92994,92996,0,2,2
26459,2,2,92996,92996,92998,0,2,0
26460,5,1,93001,93001,93002,0,1,3
26461,1,2,93002,93002,93004,0,2,0
26462,5,3,93007,93007,93010,0,3,3
26463,4,2,93011,93011,93013,0,2,1
26464,5,2,93016,93016,93018,0,2,3
26465,2,3,93018,93018,93021,0,3,0
26466,2,1,93020,93021,93022,1,2,0
26467,1,2,93021,93022,93024,1,3,0
26468,6,3,93027,93027,93030,0,3,3
26469,1,2,93028,93030,93032,2,4,0
26470,5,3,93033,93033,93036,0,3,1
26471,4,3,93037,93037,93040,0,3,1
26472,6,1,93043,93043,93044,0,1,3
26473,3,3,93046,93046,93049,0,3,2
26474,3,2,93049,93049,93051,0,2,0
26475,4,3,93053,93053,93056,0,3,2
26476,6,2,93059,93059,93061,0,2,3
26477,4,1,93063,93063,93064,0,1,2
26478,4,1,93067,93067,93068,0,1,3
26479,4,2,93071,93071,93073,0,2,3
26480,3,1,93074,93074,93075,0,1,1
26481,2,3,93076,93076,93079,0,3,1
26482,5,1,93081,93081,93082,0,1,2
26483,3,1,93084,93084,93085,0,1,2
26484,6,3,93090,93090,93093,0,3,5
26485,5,3,93095,93095,93098,0,3,2
26486,5,1,93100,93100,93101,0,1,2
26487,5,1,93105,93105,93106,0,1,4
26488,2,2,93107,93107,93109,0,2,1
26489,6,1,93113,93113,93114,0,1,4
26490,2,3,93115,93115,93118,0,3,1
26491,3,3,93118,93118,93121,0,3,0
26492,4,2,93122,93122,93124,0,2,1
26493,3,1,93125,93125,93126,0,1,1
26494,5,1,93130,93130,93131,0,1,4
26495,1,1,93131,93131,93132,0,1,0
26496,6,2,93137,93137,93139,0,2,5
26497,1,3,93138,93139,93142,1,4,0
26498,2,2,93140,93142,93144,2,4,0
26499,5,2,93145,93145,93147,0,2,1
26500,4,3,93149,93149,93152,0,3,2
26501,4,3,93153,93153,93156,0,3,1
26502,2,2,93155,93156,93158,1,3,0
26503,4,3,93159,93159,93162,0,3,1
26504,5,1,93164,93164,93165,0,1,2
26505,4,3,93168,93168,93171,0,3,3
26506,3,1,93171,93171,93172,0,1,0
26507,6,1,93177,93177,93178,0,1,5
26508,3,2,93180,93180,93182,0,2,2
26509,1,3,93181,93182,93185,1,4,0
26510,5,2,93186,93186,93188,0,2,1
26511,1,3,93187,93188,93191,1,4,0
26512,6,2,93193,93193,93195,0,2,2
26513,4,2,93197,93197,93199,0,2,2
26514,1,2,93198,93199,93201,1,3,0
26515,3,2,93201,93201,93203,0,2,0
26516,1,2,93202,93203,93205,1,3,0
26517,6,1,93208,93208,93209,0,1,3
26518,2,1,93210,93210,93211,0,1,1
26519,1,2,93211,93211,93213,0,2,0
26520,5,2,93216,93216,93218,0,2,3
26521,4,3,93220,93220,93223,0,3,2
26522,3,1,93223,93223,93224,0,1,0
26523,5,3,93228,93228,93231,0,3,4
26524,4,2,93232,93232,93234,0,2,1
26525,5,3,93237,93237,93240,0,3,3
26526,1,2,93238,93240,93242,2,4,0
26527,1,2,93239,93242,93244,3,5,0
26528,5,1,93244,93244,93245,0,1,0
26529,4,1,93248,93248,93249,0,1,3
26530,1,2,93249,93249,93251,0,2,0
26531,5,2,93254,93254,93256,0,2,3
26532,4,3,93258,93258,93261,0,3,2
26533,5,2,93263,93263,93265,0,2,2
26534,2,2,93265,93265,93267,0,2,0
26535,2,3,93267,93267,93270,0,3,0
26536,3,2,93270,93270,93272,0,2,0
26537,6,2,93276,93276,93278,0,2,4
26538,6,1,93282,93282,93283,0,1,4
26539,4,1,93286,93286,93287,0,1,3
26540,2,2,93288,93288,93290,0,2,1
26541,5,2,93293,93293,93295,0,2,3
26542,4,1,93297,93297,93298,0,1,2
26543,3,2,93300,93300,93302,0,2,2
26544,2,2,93302,93302,93304,0,2,0
26545,5,3,93307,93307,93310,0,3,3
26546,3,2,93310,93310,93312,0,2,0
26547,5,2,93315,93315,93317,0,2,3
26548,6,1,93321,93321,93322,0,1,4
26549,1,3,93322,93322,93325,0,3,0
26550,5,2,93327,93327,93329,0,2,2
26551,3,1,93330,93330,93331,0,1,1
26552,6,3,93336,93336,93339,0,3,5
26553,4,1,93340,93340,93341,0,1,1
26554,6,2,93346,93346,93348,0,2,5
26555,3,2,93349,93349,93351,0,2,1
26556,6,1,93355,93355,93356,0,1,4
26557,3,1,93358,93358,93359,0,1,2
26558,1,3,93359,93359,93362,0,3,0
26559,1,3,93360,93362,93365,2,5,0
26560,1,1,93361,93365,93366,4,5,0
26561,3,2,93364,93366,93368,2,4,0
26562,2,2,93366,93368,93370,2,4,0
26563,1,3,93367,93370,93373,3,6,0
26564,2,3,93369,93373,93376,4,7,0
26565,1,1,93370,93376,93377,6,7,0
26566,3,1,93373,93377,93378,4,5,0
26567,6,1,93379,93379,93380,0,1,1
26568,5,3,93384,93384,93387,0,3,4
26569,6,1,93390,93390,93391,0,1,3
26570,2,1,93392,93392,93393,0,1,1
26571,4,1,93396,93396,93397,0,1,3
26572,3,1,93399,93399,93400,0,1,2
26573,4,3,93403,93403,93406,0,3,3
26574,3,3,93406,93406,93409,0,3,0
26575,6,1,93412,93412,93413,0,1,3
26576,3,3,93415,93415,93418,0,3,2
26577,2,3,93417,93418,93421,1,4,0
26578,3,3,93420,93421,93424,1,4,0
26579,6,3,93426,93426,93429,0,3,2
26580,6,1,93432,93432,93433,0,1,3
26581,3,3,93435,93435,93438,0,3,2
26582,1,1,93436,93438,93439,2,3,0
26583,6,1,93442,93442,93443,0,1,3
26584,2,1,93444,93444,93445,0,1,1
26585,6,2,93450,93450,93452,0,2,5
26586,3,2,93453,93453,93455,0,2,1
26587,4,1,93457,93457,93458,0,1,2
26588,3,2,93460,93460,93462,0,2,2
26589,6,2,93466,93466,93468,0,2,4
26590,5,3,93471,93471,93474,0,3,3
26591,3,1,93474,93474,93475,0,1,0
26592,2,1,93476,93476,93477,0,1,1
26593,3,3,93479,93479,93482,0,3,2
26594,4,3,93483,93483,93486,0,3,1
26595,6,2,93489,93489,93491,0,2,3
26596,2,3,93491,93491,93494,0,3,0
26597,3,1,93494,93494,93495,0,1,0
26598,1,3,93495,93495,93498,0,3,0
26599,1,2,93496,93498,93500,2,4,0
26600,3,2,93499,93500,93502,1,3,0
26601,5,3,93504,93504,93507,0,3,2
26602,2,2,93506,93507,93509,1,3,0
26603,5,1,93511,93511,93512,0,1,2
26604,5,2,93516,93516,93518,0,2,4
26605,5,3,93521,93521,93524,0,3,3
26606,1,3,93522,93524,93527,2,5,0
26607,2,2,93524,93527,93529,3,5,0
26608,6,2,93530,93530,93532,0,2,1
26609,3,1,93533,93533,93534,0,1,1
26610,3,1,93536,93536,93537,0,1,2
26611,1,3,93537,93537,93540,0,3,0
26612,5,1,93542,93542,93543,0,1,2
26613,2,3,93544,93544,93547,0,3,1
26614,6,1,93550,93550,93551,0,1,3
26615,2,3,93552,93552,93555,0,3,1
26616,5,1,93557,93557,93558,0,1,2
26617,6,1,93563,93563,93564,0,1,5
26618,6,1,93569,93569,93570,0,1,5
26619,5,3,93574,93574,93577,0,3,4
26620,4,1,93578,93578,93579,0,1,1
26621,6,2,93584,93584,93586,0,2,5
26622,5,2,93589,93589,93591,0,2,3
26623,1,3,93590,93591,93594,1,4,0
26624,3,2,93593,93594,93596,1,3,0
26625,5,3,93598,93598,93601,0,3,2
26626,4,3,93602,93602,93605,0,3,1
26627,3,2,93605,93605,93607,0,2,0
26628,3,3,93608,93608,93611,0,3,1
26629,6,1,93614,93614,93615,0,1,3
26630,5,1,93619,93619,93620,0,1,4
26631,1,1,93620,93620,93621,0,1,0
26632,1,2,93621,93621,93623,0,2,0
26633,6,1,93627,93627,93628,0,1,4
26634,4,1,93631,93631,93632,0,1,3
26635,1,3,93632,93632,93635,0,3,0
26636,4,1,93636,93636,93637,0,1,1
26637,3,3,93639,93639,93642,0,3,2
26638,3,3,93642,93642,93645,0,3,0
26639,2,3,93644,93645,93648,1,4,0
26640,4,1,93648,93648,93649,0,1,0
26641,3,2,93651,93651,93653,0,2,2
26642,2,3,93653,93653,93656,0,3,0
26643,4,2,93657,93657,93659,0,2,1
26644,2,1,93659,93659,93660,0,1,0
26645,1,2,93660,93660,93662,0,2,0
26646,3,2,93663,93663,93665,0,2,1
26647,5,3,93668,93668,93671,0,3,3
26648,2,2,93670,93671,93673,1,3,0
26649,3,2,93673,93673,93675,0,2,0
26650,5,1,93678,93678,93679,0,1,3
26651,1,1,93679,93679,93680,0,1,0
26652,2,1,93681,93681,93682,0,1,1
26653,3,3,93684,93684,93687,0,3,2
26654,1,3,93685,93687,93690,2,5,0
26655,5,3,93690,93690,93693,0,3,0
26656,4,2,93694,93694,93696,0,2,1
26657,1,1,93695,93696,93697,1,2,0
26658,4,3,93699,93699,93702,0,3,2
26659,2,3,93701,93702,93705,1,4,0
26660,6,3,93707,93707,93710,0,3,2
26661,4,2,93711,93711,93713,0,2,1
26662,4,1,93715,93715,93716,0,1,2
26663,4,1,93719,93719,93720,0,1,3
26664,6,1,93725,93725,93726,0,1,5
26665,3,2,93728,93728,93730,0,2,2
26666,3,3,93731,93731,93734,0,3,1
26667,3,1,93734,93734,93735,0,1,0
26668,3,3,93737,93737,93740,0,3,2
26669,1,2,93738,93740,93742,2,4,0
26670,4,2,93742,93742,93744,0,2,0
26671,3,2,93745,93745,93747,0,2,1
26672,4,3,93749,93749,93752,0,3,2
26673,5,2,93754,93754,93756,0,2,2
26674,6,3,93760,93760,93763,0,3,4
26675,4,3,93764,93764,93767,0,3,1
26676,1,2,93765,93767,93769,2,4,0
26677,6,1,93771,93771,93772,0,1,2
26678,3,1,93774,93774,93775,0,1,2
26679,6,2,93780,93780,93782,0,2,5
26680,3,2,93783,93783,93785,0,2,1
26681,5,3,93788,93788,93791,0,3,3
26682,2,1,93790,93791,93792,1,2,0
26683,3,3,93793,93793,93796,0,3,1
26684,6,2,93799,93799,93801,0,2,3
26685,3,1,93802,93802,93803,0,1,1
26686,4,1,93806,93806,93807,0,1,3
26687,2,1,93808,93808,93809,0,1,1
26688,2,1,93810,93810,93811,0,1,1
26689,1,1,93811,93811,93812,0,1,0
26690,2,3,93813,93813,93816,0,3,1
26691,5,3,93818,93818,93821,0,3,2
26692,2,3,93820,93821,93824,1,4,0
26693,4,2,93824,93824,93826,0,2,0
26694,1,2,93825,93826,93828,1,3,0
26695,1,1,93826,93828,93829,2,3,0
26696,4,3,93830,93830,93833,0,3,1
26697,6,2,93836,93836,93838,0,2,3
26698,3,3,93839,93839,93842,0,3,1
26699,2,2,93841,93842,93844,1,3,0
26700,3,3,93844,93844,93847,0,3,0
26701,5,2,93849,93849,93851,0,2,2
26702,6,3,93855,93855,93858,0,3,4
26703,1,2,93856,93858,93860,2,4,0
26704,5,3,93861,93861,93864,0,3,1
26705,6,3,93867,93867,93870,0,3,3
26706,2,1,93869,93870,93871,1,2,0
26707,1,1,93870,93871,93872,1,2,0
26708,5,1,93875,93875,93876,0,1,3
26709,1,3,93876,93876,93879,0,3,0
26710,2,1,93878,93879,93880,1,2,0
26711,6,3,93884,93884,93887,0,3,4
26712,6,2,93890,93890,93892,0,2,3
26713,4,3,93894,93894,93897,0,3,2
26714,3,3,93897,93897,93900,0,3,0
26715,6,3,93903,93903,93906,0,3,3
26716,2,1,93905,93906,93907,1,2,0
26717,3,2,93908,93908,93910,0,2,1
26718,3,3,93911,93911,93914,0,3,1
26719,5,3,93916,93916,93919,0,3,2
26720,3,2,93919,93919,93921,0,2,0
26721,1,3,93920,93921,93924,1,4,0
26722,6,3,93926,93926,93929,0,3,2
26723,3,1,93929,93929,93930,0,1,0
26724,5,1,93934,93934,93935,0,1,4
26725,1,2,93935,93935,93937,0,2,0
26726,4,2,93939,93939,93941,0,2,2
26727,1,2,93940,93941,93943,1,3,0
26728,5,3,93945,93945,93948,0,3,2
26729,3,2,93948,93948,93950,0,2,0
26730,2,2,93950,93950,93952,0,2,0
26731,3,1,93953,93953,93954,0,1,1
26732,5,2,93958,93958,93960,0,2,4
26733,5,3,93963,93963,93966,0,3,3
26734,3,1,93966,93966,93967,0,1,0
26735,5,2,93971,93971,93973,0,2,4
26736,5,2,93976,93976,93978,0,2,3
26737,3,2,93979,93979,93981,0,2,1
26738,2,2,93981,93981,93983,0,2,0
26739,5,1,93986,93986,93987,0,1,3
26740,6,1,93992,93992,93993,0,1,5
26741,6,1,93998,93998,93999,0,1,5
26742,6,2,94004,94004,94006,0,2,5
26743,5,2,94009,94009,94011,0,2,3
26744,1,2,94010,94011,94013,1,3,0
26745,4,2,94014,94014,94016,0,2,1
26746,4,3,94018,94018,94021,0,3,2
26747,4,3,94022,94022,94025,0,3,1
26748,1,3,94023,94025,94028,2,5,0
26749,6,2,94029,94029,94031,0,2,1
26750,1,3,94030,94031,94034,1,4,0
26751,2,3,94032,94034,94037,2,5,0
26752,5,2,94037,94037,94039,0,2,0
26753,4,1,94041,94041,94042,0,1,2
26754,1,3,94042,94042,94045,0,3,0
26755,4,1,94046,94046,94047,0,1,1
26756,5,1,94051,94051,94052,0,1,4
26757,6,3,94057,94057,94060,0,3,5
26758,5,2,94062,94062,94064,0,2,2
26759,1,2,94063,94064,94066,1,3,0
26760,1,1,94064,94066,94067,2,3,0
26761,2,1,94066,94067,94068,1,2,0
26762,3,2,94069,94069,94071,0,2,1
26763,5,3,94074,94074,94077,0,3,3
26764,2,1,94076,94077,94078,1,2,0
26765,1,3,94077,94078,94081,1,4,0
26766,4,2,94081,94081,94083,0,2,0
26767,5,3,94086,94086,94089,0,3,3
26768,5,1,94091,94091,94092,0,1,2
26769,1,2,94092,94092,94094,0,2,0
26770,4,2,94096,94096,94098,0,2,2
26771,1,3,94097,94098,94101,1,4,0
26772,5,3,94102,94102,94105,0,3,1
26773,5,2,94107,94107,94109,0,2,2
26774,1,2,94108,94109,94111,1,3,0
26775,3,3,94111,94111,94114,0,3,0
26776,5,1,94116,94116,94117,0,1,2
26777,3,2,94119,94119,94121,0,2,2
26778,4,2,94123,94123,94125,0,2,2
26779,5,3,94128,94128,94131,0,3,3
26780,4,1,94132,94132,94133,0,1,1
26781,5,1,94137,94137,94138,0,1,4
26782,2,2,94139,94139,94141,0,2,1
26783,1,3,94140,94141,94144,1,4,0
26784,6,3,94146,94146,94149,0,3,2
26785,2,2,94148,94149,94151,1,3,0
26786,4,3,94152,94152,94155,0,3,1
26787,6,2,94158,94158,94160,0,2,3
26788,4,3,94162,94162,94165,0,3,2
26789,3,2,94165,94165,94167,0,2,0
26790,1,3,94166,94167,94170,1,4,0
26791,3,1,94169,94170,94171,1,2,0
26792,3,3,94172,94172,94175,0,3,1
26793,2,1,94174,94175,94176,1,2,0
26794,5,3,94179,94179,94182,0,3,3
26795,4,2,94183,94183,94185,0,2,1
26796,1,2,94184,94185,94187,1,3,0
26797,4,2,94188,94188,94190,0,2,1
26798,3,2,94191,94191,94193,0,2,1
26799,3,3,94194,94194,94197,0,3,1
26800,2,2,94196,94197,94199,1,3,0
26801,6,1,94202,94202,94203,0,1,3
26802,1,1,94203,94203,94204,0,1,0
26803,5,1,94208,94208,94209,0,1,4
26804,1,3,94209,94209,94212,0,3,0
26805,2,2,94211,94212,94214,1,3,0
26806,5,3,94216,94216,94219,0,3,2
26807,2,3,94218,94219,94222,1,4,0
26808,3,2,94221,94222,94224,1,3,0
26809,2,2,94223,94224,94226,1,3,0
26810,1,1,94224,94226,94227,2,3,0
26811,1,2,94225,94227,94229,2,4,0
26812,5,3,94230,94230,94233,0,3,1
26813,5,1,94235,94235,94236,0,1,2
26814,3,3,94238,94238,94241,0,3,2
26815,6,2,94244,94244,94246,0,2,3
26816,3,3,94247,94247,94250,0,3,1
26817,5,3,94252,94252,94255,0,3,2
26818,3,1,94255,94255,94256,0,1,0
26819,4,3,94259,94259,94262,0,3,3
26820,1,2,94260,94262,94264,2,4,0
26821,1,1,94261,94264,94265,3,4,0
26822,2,1,94263,94265,94266,2,3,0
26823,5,1,94268,94268,94269,0,1,2
26824,6,2,94274,94274,94276,0,2,5
26825,2,1,94276,94276,94277,0,1,0
26826,5,3,94281,94281,94284,0,3,4
26827,5,3,94286,94286,94289,0,3,2
26828,1,2,94287,94289,94291,2,4,0
26829,1,2,94288,94291,94293,3,5,0
26830,5,2,94293,94293,94295,0,2,0
26831,3,2,94296,94296,94298,0,2,1
26832,6,3,94302,94302,94305,0,3,4
26833,5,3,94307,94307,94310,0,3,2
26834,6,1,94313,94313,94314,0,1,3
26835,2,3,94315,94315,94318,0,3,1
26836,3,3,94318,94318,94321,0,3,0
26837,5,1,94323,94323,94324,0,1,2
26838,2,3,94325,94325,94328,0,3,1
26839,1,3,94326,94328,94331,2,5,0
26840,1,1,94327,94331,94332,4,5,0
26841,3,2,94330,94332,94334,2,4,0
26842,5,1,94335,94335,94336,0,1,1
26843,4,2,94339,94339,94341,0,2,3
26844,4,3,94343,94343,94346,0,3,2
26845,5,2,94348,94348,94350,0,2,2
26846,6,3,94354,94354,94357,0,3,4
26847,6,1,94360,94360,94361,0,1,3
26848,1,1,94361,94361,94362,0,1,0
26849,2,1,94363,94363,94364,0,1,1
26850,1,2,94364,94364,94366,0,2,0
26851,4,1,94368,94368,94369,0,1,2
26852,2,1,94370,94370,94371,0,1,1
26853,6,3,94376,94376,94379,0,3,5
26854,5,3,94381,94381,94384,0,3,2
26855,2,3,94383,94384,94387,1,4,0
26856,2,1,94385,94387,94388,2,3,0
26857,2,3,94387,94388,94391,1,4,0
26858,3,3,94390,94391,94394,1,4,0
26859,6,1,94396,94396,94397,0,1,2
26860,5,1,94401,94401,94402,0,1,4
26861,2,3,94403,94403,94406,0,3,1
26862,6,3,94409,94409,94412,0,3,3
26863,3,1,94412,94412,94413,0,1,0
26864,1,1,94413,94413,94414,0,1,0
26865,2,3,94415,94415,94418,0,3,1
26866,2,2,94417,94418,94420,1,3,0
26867,6,3,94423,94423,94426,0,3,3
26868,1,2,94424,94426,94428,2,4,0
26869,4,1,94428,94428,94429,0,1,0
26870,4,3,94432,94432,94435,0,3,3
26871,6,1,94438,94438,94439,0,1,3
26872,5,2,94443,94443,94445,0,2,4
26873,6,2,94449,94449,94451,0,2,4
26874,3,1,94452,94452,94453,0,1,1
26875,5,2,94457,94457,94459,0,2,4
26876,1,2,94458,94459,94461,1,3,0
26877,3,3,94461,94461,94464,0,3,0
26878,6,2,94467,94467,94469,0,2,3
26879,3,3,94470,94470,94473,0,3,1
26880,4,3,94474,94474,94477,0,3,1
26881,2,1,94476,94477,94478,1,2,0
26882,2,2,94478,94478,94480,0,2,0
26883,5,2,94483,94483,94485,0,2,3
26884,2,1,94485,94485,94486,0,1,0
26885,2,3,94487,94487,94490,0,3,1
26886,6,3,94493,94493,94496,0,3,3
26887,4,2,94497,94497,94499,0,2,1
26888,5,2,94502,94502,94504,0,2,3
26889,1,1,94503,94504,94505,1,2,0
26890,4,3,94507,94507,94510,0,3,2
26891,1,3,94508,94510,94513,2,5,0
26892,1,3,94509,94513,94516,4,7,0
26893,6,3,94515,94516,94519,1,4,0
26894,6,2,94521,94521,94523,0,2,2
26895,4,1,94525,94525,94526,0,1,2
26896,1,2,94526,94526,94528,0,2,0
26897,5,3,94531,94531,94534,0,3,3
26898,5,1,94536,94536,94537,0,1,2
26899,2,3,94538,94538,94541,0,3,1
26900,6,1,94544,94544,94545,0,1,3
26901,5,2,94549,94549,94551,0,2,4
26902,1,1,94550,94551,94552,1,2,0
26903,6,3,94556,94556,94559,0,3,4
26904,5,2,94561,94561,94563,0,2,2
26905,5,3,94566,94566,94569,0,3,3
26906,4,2,94570,94570,94572,0,2,1
26907,4,2,94574,94574,94576,0,2,2
26908,6,1,94580,94580,94581,0,1,4
26909,4,1,94584,94584,94585,0,1,3
26910,1,2,94585,94585,94587,0,2,0
26911,4,3,94589,94589,94592,0,3,2
26912,5,3,94594,94594,94597,0,3,2
26913,3,1,94597,94597,94598,0,1,0
26914,2,1,94599,94599,94600,0,1,1
26915,2,3,94601,94601,94604,0,3,1
26916,6,2,94607,94607,94609,0,2,3
26917,6,1,94613,94613,94614,0,1,4
26918,6,1,94619,94619,94620,0,1,5
26919,1,3,94620,94620,94623,0,3,0
26920,3,1,94623,94623,94624,0,1,0
26921,4,3,94627,94627,94630,0,3,3
26922,6,2,94633,94633,94635,0,2,3
26923,2,3,94635,94635,94638,0,3,0
26924,2,1,94637,94638,94639,1,2,0
26925,4,2,94641,94641,94643,0,2,2
26926,3,3,94644,94644,94647,0,3,1
26927,2,2,94646,94647,94649,1,3,0
26928,6,2,94652,94652,94654,0,2,3
26929,4,3,94656,94656,94659,0,3,2
26930,2,2,94658,94659,94661,1,3,0
26931,5,3,94663,94663,94666,0,3,2
26932,3,3,94666,94666,94669,0,3,0
26933,2,2,94668,94669,94671,1,3,0
26934,5,2,94673,94673,94675,0,2,2
26935,6,2,94679,94679,94681,0,2,4
26936,3,3,94682,94682,94685,0,3,1
26937,4,2,94686,94686,94688,0,2,1
26938,4,3,94690,94690,94693,0,3,2
26939,1,3,94691,94693,94696,2,5,0
26940,3,2,94694,94696,94698,2,4,0
26941,3,2,94697,94698,94700,1,3,0
26942,4,1,94701,94701,94702,0,1,1
26943,4,1,94705,94705,94706,0,1,3
26944,3,2,94708,94708,94710,0,2,2
26945,6,3,94714,94714,94717,0,3,4
26946,1,1,94715,94717,94718,2,3,0
26947,6,1,94721,94721,94722,0,1,3
26948,4,2,94725,94725,94727,0,2,3
26949,1,2,94726,94727,94729,1,3,0
26950,5,1,94731,94731,94732,0,1,2
26951,5,1,94736,94736,94737,0,1,4
26952,3,3,94739,94739,94742,0,3,2
26953,1,3,94740,94742,94745,2,5,0
26954,1,3,94741,94745,94748,4,7,0
26955,6,3,94747,94748,94751,1,4,0
26956,3,1,94750,94751,94752,1,2,0
26957,2,1,94752,94752,94753,0,1,0
26958,3,3,94755,94755,94758,0,3,2
26959,3,2,94758,94758,94760,0,2,0
26960,3,3,94761,94761,94764,0,3,1
26961,6,1,94767,94767,94768,0,1,3
26962,1,2,94768,94768,94770,0,2,0
26963,3,1,94771,94771,94772,0,1,1
26964,1,1,94772,94772,94773,0,1,0
26965,6,3,94778,94778,94781,0,3,5
26966,6,1,94784,94784,94785,0,1,3
26967,6,2,94790,94790,94792,0,2,5
26968,2,3,94792,94792,94795,0,3,0
26969,4,1,94796,94796,94797,0,1,1
26970,2,1,94798,94798,94799,0,1,1
26971,5,3,94803,94803,94806,0,3,4
26972,2,1,94805,94806,94807,1,2,0
26973,2,1,94807,94807,94808,0,1,0
26974,5,3,94812,94812,94815,0,3,4
26975,1,2,94813,94815,94817,2,4,0
26976,3,3,94816,94817,94820,1,4,0
26977,5,3,94821,94821,94824,0,3,1
26978,4,1,94825,94825,94826,0,1,1
26979,2,2,94827,94827,94829,0,2,1
26980,6,2,94833,94833,94835,0,2,4
26981,4,3,94837,94837,94840,0,3,2
26982,1,1,94838,94840,94841,2,3,0
26983,5,3,94843,94843,94846,0,3,2
26984,6,3,94849,94849,94852,0,3,3
26985,4,3,94853,94853,94856,0,3,1
26986,6,2,94859,94859,94861,0,2,3
26987,3,3,94862,94862,94865,0,3,1
26988,5,1,94867,94867,94868,0,1,2
26989,6,3,94873,94873,94876,0,3,5
26990,1,3,94874,94876,94879,2,5,0
26991,4,3,94878,94879,94882,1,4,0
26992,6,2,94884,94884,94886,0,2,2
26993,2,1,94886,94886,94887,0,1,0
26994,1,1,94887,94887,94888,0,1,0
26995,1,3,94888,94888,94891,0,3,0
26996,5,1,94893,94893,94894,0,1,2
26997,5,2,94898,94898,94900,0,2,4
26998,3,1,94901,94901,94902,0,1,1
26999,6,2,94907,94907,94909,0,2,5
27000,4,1,94911,94911,94912,0,1,2
27001,4,1,94915,94915,94916,0,1,3
27002,5,2,94920,94920,94922,0,2,4
27003,1,3,94921,94922,94925,1,4,0
27004,6,2,94927,94927,94929,0,2,2
27005,1,3,94928,94929,94932,1,4,0
27006,5,3,94933,94933,94936,0,3,1
27007,1,2,94934,94936,94938,2,4,0
27008,2,1,94936,94938,94939,2,3,0
27009,5,3,94941,94941,94944,0,3,2
27010,6,1,94947,94947,94948,0,1,3
27011,6,2,94953,94953,94955,0,2,5
27012,6,3,94959,94959,94962,0,3,4
27013,1,2,94960,94962,94964,2,4,0
27014,5,3,94965,94965,94968,0,3,1
27015,6,3,94971,94971,94974,0,3,3
27016,3,1,94974,94974,94975,0,1,0
27017,4,2,94978,94978,94980,0,2,3
27018,5,1,94983,94983,94984,0,1,3
27019,6,3,94989,94989,94992,0,3,5
27020,6,3,94995,94995,94998,0,3,3
27021,1,3,94996,94998,95001,2,5,0
27022,1,3,94997,95001,95004,4,7,0
27023,3,2,95000,95004,95006,4,6,0
27024,4,1,95004,95006,95007,2,3,0
27025,4,3,95008,95008,95011,0,3,1
27026,1,1,95009,95011,95012,2,3,0
27027,3,1,95012,95012,95013,0,1,0
27028,1,2,95013,95013,95015,0,2,0
27029,3,1,95016,95016,95017,0,1,1
27030,3,3,95019,95019,95022,0,3,2
27031,4,1,95023,95023,95024,0,1,1
27032,3,3,95026,95026,95029,0,3,2
27033,2,3,95028,95029,95032,1,4,0
27034,2,3,95030,95032,95035,2,5,0
27035,4,2,95034,95035,95037,1,3,0
27036,1,3,95035,95037,95040,2,5,0
27037,5,2,95040,95040,95042,0,2,0
27038,5,2,95045,95045,95047,0,2,3
27039,1,1,95046,95047,95048,1,2,0
27040,3,1,95049,95049,95050,0,1,1
27041,5,3,95054,95054,95057,0,3,4
27042,5,2,95059,95059,95061,0,2,2
27043,4,2,95063,95063,95065,0,2,2
27044,1,3,95064,95065,95068,1,4,0
27045,3,3,95067,95068,95071,1,4,0
27046,1,3,95068,95071,95074,3,6,0
27047,5,1,95073,95074,95075,1,2,0
27048,4,2,95077,95077,95079,0,2,2
27049,3,3,95080,95080,95083,0,3,1
27050,3,1,95083,95083,95084,0,1,0
27051,4,2,95087,95087,95089,0,2,3
27052,2,1,95089,95089,95090,0,1,0
27053,2,3,95091,95091,95094,0,3,1
27054,4,2,95095,95095,95097,0,2,1
27055,2,1,95097,95097,95098,0,1,0
27056,6,2,95103,95103,95105,0,2,5
27057,6,3,95109,95109,95112,0,3,4
27058,1,2,95110,95112,95114,2,4,0
27059,4,2,95114,95114,95116,0,2,0
27060,2,3,95116,95116,95119,0,3,0
27061,1,2,95117,95119,95121,2,4,0
27062,6,3,95123,95123,95126,0,3,2
27063,2,2,95125,95126,95128,1,3,0
27064,6,3,95131,95131,95134,0,3,3
27065,3,1,95134,95134,95135,0,1,0
27066,5,2,95139,95139,95141,0,2,4
27067,2,1,95141,95141,95142,0,1,0
27068,2,2,95143,95143,95145,0,2,1
27069,3,2,95146,95146,95148,0,2,1
27070,2,2,95148,95148,95150,0,2,0
27071,3,1,95151,95151,95152,0,1,1
27072,3,3,95154,95154,95157,0,3,2
27073,4,3,95158,95158,95161,0,3,1
27074,4,3,95162,95162,95165,0,3,1
27075,2,1,95164,95165,95166,1,2,0
27076,4,3,95168,95168,95171,0,3,2
27077,4,2,95172,95172,95174,0,2,1
27078,3,1,95175,95175,95176,0,1,1
27079,4,1,95179,95179,95180,0,1,3
27080,4,1,95183,95183,95184,0,1,3
27081,4,2,95187,95187,95189,0,2,3
27082,1,1,95188,95189,95190,1,2,0
27083,4,3,95192,95192,95195,0,3,2
27084,5,1,95197,95197,95198,0,1,2
27085,5,2,95202,95202,95204,0,2,4
27086,1,1,95203,95204,95205,1,2,0
27087,5,2,95208,95208,95210,0,2,3
27088,6,2,95214,95214,95216,0,2,4
27089,1,1,95215,95216,95217,1,2,0
27090,2,2,95217,95217,95219,0,2,0
27091,5,3,95222,95222,95225,0,3,3
27092,3,2,95225,95225,95227,0,2,0
27093,3,3,95228,95228,95231,0,3,1
27094,6,3,95234,95234,95237,0,3,3
27095,4,2,95238,95238,95240,0,2,1
27096,3,3,95241,95241,95244,0,3,1
27097,1,3,95242,95244,95247,2,5,0
27098,2,3,95244,95247,95250,3,6,0
27099,1,2,95245,95250,95252,5,7,0
27100,1,3,95246,95252,95255,6,9,0
27101,5,1,95251,95255,95256,4,5,0
27102,2,3,95253,95256,95259,3,6,0
27103,6,2,95259,95259,95261,0,2,0
27104,6,2,95265,95265,95267,0,2,4
27105,3,2,95268,95268,95270,0,2,1
27106,5,1,95273,95273,95274,0,1,3
27107,6,1,95279,95279,95280,0,1,5
27108,3,3,95282,95282,95285,0,3,2
27109,4,2,95286,95286,95288,0,2,1
27110,5,2,95291,95291,95293,0,2,3
27111,3,1,95294,95294,95295,0,1,1
27112,3,1,95297,95297,95298,0,1,2
27113,4,3,95301,95301,95304,0,3,3
27114,1,2,95302,95304,95306,2,4,0
27115,3,3,95305,95306,95309,1,4,0
27116,2,2,95307,95309,95311,2,4,0
27117,2,3,95309,95311,95314,2,5,0
27118,2,3,95311,95314,95317,3,6,0
27119,1,3,95312,95317,95320,5,8,0
27120,6,2,95318,95320,95322,2,4,0
27121,1,2,95319,95322,95324,3,5,0
27122,2,3,95321,95324,95327,3,6,0
27123,5,2,95326,95327,95329,1,3,0
27124,4,2,95330,95330,95332,0,2,1
27125,4,1,95334,95334,95335,0,1,2
27126,1,1,95335,95335,95336,0,1,0
27127,4,3,95339,95339,95342,0,3,3
27128,4,1,95343,95343,95344,0,1,1
27129,3,1,95346,95346,95347,0,1,2
27130,5,1,95351,95351,95352,0,1,4
27131,4,1,95355,95355,95356,0,1,3
27132,4,2,95359,95359,95361,0,2,3
27133,5,2,95364,95364,95366,0,2,3
27134,2,2,95366,95366,95368,0,2,0
27135,6,3,95372,95372,95375,0,3,4
27136,4,3,95376,95376,95379,0,3,1
27137,5,2,95381,95381,95383,0,2,2
27138,6,3,95387,95387,95390,0,3,4
27139,5,2,95392,95392,95394,0,2,2
27140,2,1,95394,95394,95395,0,1,0
27141,6,2,95400,95400,95402,0,2,5
27142,3,2,95403,95403,95405,0,2,1
27143,4,1,95407,95407,95408,0,1,2
27144,6,1,95413,95413,95414,0,1,5
27145,1,2,95414,95414,95416,0,2,0
27146,1,3,95415,95416,95419,1,4,0
27147,6,3,95421,95421,95424,0,3,2
27148,2,1,95423,95424,95425,1,2,0
27149,3,2,95426,95426,95428,0,2,1
27150,5,2,95431,95431,95433,0,2,3
27151,4,3,95435,95435,95438,0,3,2
27152,4,1,95439,95439,95440,0,1,1
27153,4,1,95443,95443,95444,0,1,3
27154,4,2,95447,95447,95449,0,2,3
27155,6,1,95453,95453,95454,0,1,4
27156,2,3,95455,95455,95458,0,3,1
27157,5,2,95460,95460,95462,0,2,2
27158,3,1,95463,95463,95464,0,1,1
27159,1,1,95464,95464,95465,0,1,0
27160,3,2,95467,95467,95469,0,2,2
27161,5,3,95472,95472,95475,0,3,3
27162,4,1,95476,95476,95477,0,1,1
27163,6,2,95482,95482,95484,0,2,5
27164,4,3,95486,95486,95489,0,3,2
27165,2,1,95488,95489,95490,1,2,0
27166,1,2,95489,95490,95492,1,3,0
27167,6,2,95495,95495,95497,0,2,3
27168,3,1,95498,95498,95499,0,1,1
27169,4,1,95502,95502,95503,0,1,3
27170,1,3,95503,95503,95506,0,3,0
27171,4,3,95507,95507,95510,0,3,1
27172,5,2,95512,95512,95514,0,2,2
27173,4,3,95516,95516,95519,0,3,2
27174,1,1,95517,95519,95520,2,3,0
27175,4,3,95521,95521,95524,0,3,1
27176,1,2,95522,95524,95526,2,4,0
27177,1,2,95523,95526,95528,3,5,0
27178,6,1,95529,95529,95530,0,1,1
27179,2,1,95531,95531,95532,0,1,1
27180,1,2,95532,95532,95534,0,2,0
27181,2,2,95534,95534,95536,0,2,0
27182,2,3,95536,95536,95539,0,3,0
27183,4,2,95540,95540,95542,0,2,1
27184,3,1,95543,95543,95544,0,1,1
27185,1,1,95544,95544,95545,0,1,0
27186,4,2,95548,95548,95550,0,2,3
27187,4,3,95552,95552,95555,0,3,2
27188,4,1,95556,95556,95557,0,1,1
27189,1,1,95557,95557,95558,0,1,0
27190,1,3,95558,95558,95561,0,3,0
27191,1,2,95559,95561,95563,2,4,0
27192,2,1,95561,95563,95564,2,3,0
27193,5,1,95566,95566,95567,0,1,2
27194,3,2,95569,95569,95571,0,2,2
27195,2,3,95571,95571,95574,0,3,0
27196,2,1,95573,95574,95575,1,2,0
27197,6,2,95579,95579,95581,0,2,4
27198,2,1,95581,95581,95582,0,1,0
27199,2,1,95583,95583,95584,0,1,1
27200,6,3,95589,95589,95592,0,3,5
27201,3,3,95592,95592,95595,0,3,0
27202,5,3,95597,95597,95600,0,3,2
27203,5,1,95602,95602,95603,0,1,2
27204,5,3,95607,95607,95610,0,3,4
27205,3,3,95610,95610,95613,0,3,0
27206,4,1,95614,95614,95615,0,1,1
27207,1,2,95615,95615,95617,0,2,0
27208,5,3,95620,95620,95623,0,3,3
27209,1,1,95621,95623,95624,2,3,0
27210,5,1,95626,95626,95627,0,1,2
27211,4,3,95630,95630,95633,0,3,3
27212,3,1,95633,95633,95634,0,1,0
27213,1,3,95634,95634,95637,0,3,0
27214,1,1,95635,95637,95638,2,3,0
27215,3,3,95638,95638,95641,0,3,0
27216,6,1,95644,95644,95645,0,1,3
27217,6,2,95650,95650,95652,0,2,5
27218,3,1,95653,95653,95654,0,1,1
27219,5,3,95658,95658,95661,0,3,4
27220,6,2,95664,95664,95666,0,2,3
27221,4,1,95668,95668,95669,0,1,2
27222,4,1,95672,95672,95673,0,1,3
27223,3,3,95675,95675,95678,0,3,2
27224,3,1,95678,95678,95679,0,1,0
27225,4,3,95682,95682,95685,0,3,3
27226,5,3,95687,95687,95690,0,3,2
27227,6,1,95693,95693,95694,0,1,3
27228,5,3,95698,95698,95701,0,3,4
27229,2,1,95700,95701,95702,1,2,0
27230,4,2,95704,95704,95706,0,2,2
27231,5,3,95709,95709,95712,0,3,3
27232,4,3,95713,95713,95716,0,3,1
27233,2,3,95715,95716,95719,1,4,0
27234,6,1,95721,95721,95722,0,1,2
27235,6,1,95727,95727,95728,0,1,5
27236,3,1,95730,95730,95731,0,1,2
27237,5,3,95735,95735,95738,0,3,4
27238,3,3,95738,95738,95741,0,3,0
27239,4,2,95742,95742,95744,0,2,1
27240,4,1,95746,95746,95747,0,1,2
27241,1,1,95747,95747,95748,0,1,0
27242,1,2,95748,95748,95750,0,2,0
27243,1,1,95749,95750,95751,1,2,0
27244,2,2,95751,95751,95753,0,2,0
27245,1,2,95752,95753,95755,1,3,0
27246,1,2,95753,95755,95757,2,4,0
27247,5,3,95758,95758,95761,0,3,1
27248,3,2,95761,95761,95763,0,2,0
27249,2,2,95763,95763,95765,0,2,0
27250,5,2,95768,95768,95770,0,2,3
27251,5,3,95773,95773,95776,0,3,3
27252,1,2,95774,95776,95778,2,4,0
27253,2,1,95776,95778,95779,2,3,0
27254,5,1,95781,95781,95782,0,1,2
27255,5,1,95786,95786,95787,0,1,4
27256,3,1,95789,95789,95790,0,1,2
27257,3,1,95792,95792,95793,0,1,2
27258,2,3,95794,95794,95797,0,3,1
27259,1,1,95795,95797,95798,2,3,0
27260,6,1,95801,95801,95802,0,1,3
27261,1,2,95802,95802,95804,0,2,0
27262,6,3,95808,95808,95811,0,3,4
27263,2,3,95810,95811,95814,1,4,0
27264,5,1,95815,95815,95816,0,1,1
27265,1,3,95816,95816,95819,0,3,0
27266,4,3,95820,95820,95823,0,3,1
27267,5,2,95825,95825,95827,0,2,2
27268,6,2,95831,95831,95833,0,2,4
27269,2,2,95833,95833,95835,0,2,0
27270,3,2,95836,95836,95838,0,2,1
27271,3,2,95839,95839,95841,0,2,1
27272,2,1,95841,95841,95842,0,1,0
27273,3,1,95844,95844,95845,0,1,2
27274,1,3,95845,95845,95848,0,3,0
27275,2,1,95847,95848,95849,1,2,0
27276,3,1,95850,95850,95851,0,1,1
27277,5,3,95855,95855,95858,0,3,4
27278,6,3,95861,95861,95864,0,3,3
27279,4,3,95865,95865,95868,0,3,1
27280,3,3,95868,95868,95871,0,3,0
27281,2,3,95870,95871,95874,1,4,0
27282,1,3,95871,95874,95877,3,6,0
27283,4,1,95875,95877,95878,2,3,0
27284,4,2,95879,95879,95881,0,2,1
27285,1,1,95880,95881,95882,1,2,0
27286,1,1,95881,95882,95883,1,2,0
27287,2,3,95883,95883,95886,0,3,0
27288,6,2,95889,95889,95891,0,2,3
27289,2,2,95891,95891,95893,0,2,0
27290,2,1,95893,95893,95894,0,1,0
27291,6,3,95899,95899,95902,0,3,5
27292,4,2,95903,95903,95905,0,2,1
27293,3,2,95906,95906,95908,0,2,1
27294,3,2,95909,95909,95911,0,2,1
27295,2,1,95911,95911,95912,0,1,0
27296,4,2,95915,95915,95917,0,2,3
27297,3,3,95918,95918,95921,0,3,1
27298,2,1,95920,95921,95922,1,2,0
27299,1,3,95921,95922,95925,1,4,0
27300,1,2,95922,95925,95927,3,5,0
27301,5,3,95927,95927,95930,0,3,0
27302,2,2,95929,95930,95932,1,3,0
27303,3,3,95932,95932,95935,0,3,0
27304,5,2,95937,95937,95939,0,2,2
27305,5,1,95942,95942,95943,0,1,3
27306,5,2,95947,95947,95949,0,2,4
27307,6,1,95953,95953,95954,0,1,4
27308,5,2,95958,95958,95960,0,2,4
27309,6,1,95964,95964,95965,0,1,4
27310,5,2,95969,95969,95971,0,2,4
27311,5,3,95974,95974,95977,0,3,3
27312,4,1,95978,95978,95979,0,1,1
27313,5,3,95983,95983,95986,0,3,4
27314,1,2,95984,95986,95988,2,4,0
27315,2,1,95986,95988,95989,2,3,0
27316,5,1,95991,95991,95992,0,1,2
27317,5,3,95996,95996,95999,0,3,4
27318,5,2,96001,96001,96003,0,2,2
27319,1,1,96002,96003,96004,1,2,0
27320,6,1,96008,96008,96009,0,1,4
27321,3,2,96011,96011,96013,0,2,2
27322,6,1,96017,96017,96018,0,1,4
27323,4,2,96021,96021,96023,0,2,3
27324,5,1,96026,96026,96027,0,1,3
27325,3,3,96029,96029,96032,0,3,2
27326,2,3,96031,96032,96035,1,4,0
27327,1,1,96032,96035,96036,3,4,0
27328,3,2,96035,96036,96038,1,3,0
27329,4,2,96039,96039,96041,0,2,1
27330,3,2,96042,96042,96044,0,2,1
27331,1,1,96043,96044,96045,1,2,0
27332,4,3,96047,96047,96050,0,3,2
27333,3,3,96050,96050,96053,0,3,0
27334,1,1,96051,96053,96054,2,3,0
27335,1,3,96052,96054,96057,2,5,0
27336,2,1,96054,96057,96058,3,4,0
27337,5,3,96059,96059,96062,0,3,1
27338,1,1,96060,96062,96063,2,3,0
27339,2,3,96062,96063,96066,1,4,0
27340,4,3,96066,96066,96069,0,3,0
27341,3,1,96069,96069,96070,0,1,0
27342,5,1,96074,96074,96075,0,1,4
27343,6,1,96080,96080,96081,0,1,5
27344,5,3,96085,96085,96088,0,3,4
27345,5,1,96090,96090,96091,0,1,2
27346,3,2,96093,96093,96095,0,2,2
27347,3,1,96096,96096,96097,0,1,1
27348,6,1,96102,96102,96103,0,1,5
27349,5,2,96107,96107,96109,0,2,4
27350,1,2,96108,96109,96111,1,3,0
27351,3,2,96111,96111,96113,0,2,0
27352,2,2,96113,96113,96115,0,2,0
27353,5,2,96118,96118,96120,0,2,3
27354,6,3,96124,96124,96127,0,3,4
27355,3,1,96127,96127,96128,0,1,0
27356,1,2,96128,96128,96130,0,2,0
27357,4,2,96132,96132,96134,0,2,2
27358,1,3,96133,96134,96137,1,4,0
27359,2,2,96135,96137,96139,2,4,0
27360,6,3,96141,96141,96144,0,3,2
27361,3,1,96144,96144,96145,0,1,0
27362,2,3,96146,96146,96149,0,3,1
27363,2,1,96148,96149,96150,1,2,0
27364,1,2,96149,96150,96152,1,3,0
27365,6,2,96155,96155,96157,0,2,3
27366,5,3,96160,96160,96163,0,3,3
27367,6,3,96166,96166,96169,0,3,3
27368,3,3,96169,96169,96172,0,3,0
27369,5,1,96174,96174,96175,0,1,2
27370,3,3,96177,96177,96180,0,3,2
27371,5,1,96182,96182,96183,0,1,2
27372,1,1,96183,96183,96184,0,1,0
27373,1,2,96184,96184,96186,0,2,0
27374,5,2,96189,96189,96191,0,2,3
27375,6,1,96195,96195,96196,0,1,4
27376,5,1,96200,96200,96201,0,1,4
27377,6,2,96206,96206,96208,0,2,5
27378,4,2,96210,96210,96212,0,2,2
27379,3,2,96213,96213,96215,0,2,1
27380,3,2,96216,96216,96218,0,2,1
27381,2,1,96218,96218,96219,0,1,0
27382,5,2,96223,96223,96225,0,2,4
27383,1,2,96224,96225,96227,1,3,0
27384,3,2,96227,96227,96229,0,2,0
27385,5,3,96232,96232,96235,0,3,3
27386,2,3,96234,96235,96238,1,4,0
27387,2,1,96236,96238,96239,2,3,0
27388,1,1,96237,96239,96240,2,3,0
27389,2,2,96239,96240,96242,1,3,0
27390,2,2,96241,96242,96244,1,3,0
27391,3,3,96244,96244,96247,0,3,0
27392,1,3,96245,96247,96250,2,5,0
27393,5,1,96250,96250,96251,0,1,0
27394,3,3,96253,96253,96256,0,3,2
27395,3,3,96256,96256,96259,0,3,0
27396,4,3,96260,96260,96263,0,3,1
27397,3,1,96263,96263,96264,0,1,0
27398,3,3,96266,96266,96269,0,3,2
27399,1,3,96267,96269,96272,2,5,0
27400,2,2,96269,96272,96274,3,5,0
27401,4,3,96273,96274,96277,1,4,0
27402,6,1,96279,96279,96280,0,1,2
27403,3,1,96282,96282,96283,0,1,2
27404,6,1,96288,96288,96289,0,1,5
27405,6,1,96294,96294,96295,0,1,5
27406,6,2,96300,96300,96302,0,2,5
27407,6,2,96306,96306,96308,0,2,4
27408,5,3,96311,96311,96314,0,3,3
27409,1,2,96312,96314,96316,2,4,0
27410,2,1,96314,96316,96317,2,3,0
27411,2,1,96316,96317,96318,1,2,0
27412,4,1,96320,96320,96321,0,1,2
27413,4,3,96324,96324,96327,0,3,3
27414,6,2,96330,96330,96332,0,2,3
27415,4,2,96334,96334,96336,0,2,2
27416,5,2,96339,96339,96341,0,2,3
27417,4,2,96343,96343,96345,0,2,2
27418,3,2,96346,96346,96348,0,2,1
27419,6,3,96352,96352,96355,0,3,4
27420,1,2,96353,96355,96357,2,4,0
27421,3,3,96356,96357,96360,1,4,0
27422,5,3,96361,96361,96364,0,3,1
27423,2,1,96363,96364,96365,1,2,0
27424,3,2,96366,96366,96368,0,2,1
27425,5,3,96371,96371,96374,0,3,3
27426,2,2,96373,96374,96376,1,3,0
27427,2,3,96375,96376,96379,1,4,0
27428,6,3,96381,96381,96384,0,3,2
27429,3,2,96384,96384,96386,0,2,0
27430,3,1,96387,96387,96388,0,1,1
27431,2,2,96389,96389,96391,0,2,1
27432,1,1,96390,96391,96392,1,2,0
27433,3,2,96393,96393,96395,0,2,1
27434,5,2,96398,96398,96400,0,2,3
27435,5,2,96403,96403,96405,0,2,3
27436,1,2,96404,96405,96407,1,3,0
27437,3,2,96407,96407,96409,0,2,0
27438,3,1,96410,96410,96411,0,1,1
27439,6,1,96416,96416,96417,0,1,5
27440,1,2,96417,96417,96419,0,2,0
27441,2,2,96419,96419,96421,0,2,0
27442,5,2,96424,96424,96426,0,2,3
27443,5,2,96429,96429,96431,0,2,3
27444,2,1,96431,96431,96432,0,1,0
27445,3,2,96434,96434,96436,0,2,2
27446,5,1,96439,96439,96440,0,1,3
27447,6,2,96445,96445,96447,0,2,5
27448,4,3,96449,96449,96452,0,3,2
27449,1,3,96450,96452,96455,2,5,0
27450,2,2,96452,96455,96457,3,5,0
27451,3,3,96455,96457,96460,2,5,0
27452,4,1,96459,96460,96461,1,2,0
27453,6,1,96465,96465,96466,0,1,4
27454,5,1,96470,96470,96471,0,1,4
27455,4,1,96474,96474,96475,0,1,3
27456,5,1,96479,96479,96480,0,1,4
27457,6,3,96485,96485,96488,0,3,5
27458,2,3,96487,96488,96491,1,4,0
27459,4,3,96491,96491,96494,0,3,0
27460,5,1,96496,96496,96497,0,1,2
27461,3,3,96499,96499,96502,0,3,2
27462,2,3,96501,96502,96505,1,4,0
27463,4,2,96505,96505,96507,0,2,0
27464,3,2,96508,96508,96510,0,2,1
27465,2,2,96510,96510,96512,0,2,0
27466,1,1,96511,96512,96513,1,2,0
27467,6,1,96517,96517,96518,0,1,4
27468,4,3,96521,96521,96524,0,3,3
27469,5,1,96526,96526,96527,0,1,2
27470,3,1,96529,96529,96530,0,1,2
27471,6,2,96535,96535,96537,0,2,5
27472,4,2,96539,96539,96541,0,2,2
27473,5,1,96544,96544,96545,0,1,3
27474,5,1,96549,96549,96550,0,1,4
27475,2,3,96551,96551,96554,0,3,1
27476,3,2,96554,96554,96556,0,2,0
27477,3,2,96557,96557,96559,0,2,1
27478,1,2,96558,96559,96561,1,3,0
27479,3,3,96561,96561,96564,0,3,0
27480,5,2,96566,96566,96568,0,2,2
27481,3,3,96569,96569,96572,0,3,1
27482,1,3,96570,96572,96575,2,5,0
27483,3,1,96573,96575,96576,2,3,0
27484,2,2,96575,96576,96578,1,3,0
27485,6,2,96581,96581,96583,0,2,3
27486,5,3,96586,96586,96589,0,3,3
27487,1,2,96587,96589,96591,2,4,0
27488,4,2,96591,96591,96593,0,2,0
27489,4,2,96595,96595,96597,0,2,2
27490,2,2,96597,96597,96599,0,2,0
27491,5,1,96602,96602,96603,0,1,3
27492,2,1,96604,96604,96605,0,1,1
27493,4,1,96608,96608,96609,0,1,3
27494,4,3,96612,96612,96615,0,3,3
27495,2,1,96614,96615,96616,1,2,0
27496,6,1,96620,96620,96621,0,1,4
27497,2,3,96622,96622,96625,0,3,1
27498,5,1,96627,96627,96628,0,1,2
27499,2,1,96629,96629,96630,0,1,1
27500,5,2,96634,96634,96636,0,2,4
27501,5,3,96639,96639,96642,0,3,3
27502,4,1,96643,96643,96644,0,1,1
27503,3,2,96646,96646,96648,0,2,2
27504,2,1,96648,96648,96649,0,1,0
27505,1,2,96649,96649,96651,0,2,0
27506,1,3,96650,96651,96654,1,4,0
27507,6,3,96656,96656,96659,0,3,2
27508,3,2,96659,96659,96661,0,2,0
27509,3,2,96662,96662,96664,0,2,1
27510,6,1,96668,96668,96669,0,1,4
27511,6,1,96674,96674,96675,0,1,5
27512,3,2,96677,96677,96679,0,2,2
27513,6,2,96683,96683,96685,0,2,4
27514,2,2,96685,96685,96687,0,2,0
27515,2,2,96687,96687,96689,0,2,0
27516,2,2,96689,96689,96691,0,2,0
27517,1,2,96690,96691,96693,1,3,0
27518,5,1,96695,96695,96696,0,1,2
27519,2,2,96697,96697,96699,0,2,1
27520,6,3,96703,96703,96706,0,3,4
27521,4,3,96707,96707,96710,0,3,1
27522,3,3,96710,96710,96713,0,3,0
27523,6,1,96716,96716,96717,0,1,3
27524,5,2,96721,96721,96723,0,2,4
27525,3,3,96724,96724,96727,0,3,1
27526,4,3,96728,96728,96731,0,3,1
27527,3,2,96731,96731,96733,0,2,0
27528,6,3,96737,96737,96740,0,3,4
27529,3,1,96740,96740,96741,0,1,0
27530,1,1,96741,96741,96742,0,1,0
27531,2,1,96743,96743,96744,0,1,1
27532,2,2,96745,96745,96747,0,2,1
27533,5,2,96750,96750,96752,0,2,3
27534,1,3,96751,96752,96755,1,4,0
27535,3,3,96754,96755,96758,1,4,0
27536,2,3,96756,96758,96761,2,5,0
27537,6,1,96762,96762,96763,0,1,1
27538,1,2,96763,96763,96765,0,2,0
27539,5,3,96768,96768,96771,0,3,3
27540,6,2,96774,96774,96776,0,2,3
27541,4,3,96778,96778,96781,0,3,2
27542,5,2,96783,96783,96785,0,2,2
27543,1,1,96784,96785,96786,1,2,0
27544,6,3,96790,96790,96793,0,3,4
27545,1,3,96791,96793,96796,2,5,0
27546,6,1,96797,96797,96798,0,1,1
27547,5,1,96802,96802,96803,0,1,4
27548,2,2,96804,96804,96806,0,2,1
27549,1,3,96805,96806,96809,1,4,0
27550,2,3,96807,96809,96812,2,5,0
27551,4,1,96811,96812,96813,1,2,0
27552,6,2,96817,96817,96819,0,2,4
27553,2,2,96819,96819,96821,0,2,0
27554,4,1,96823,96823,96824,0,1,2
27555,2,1,96825,96825,96826,0,1,1
27556,4,2,96829,96829,96831,0,2,3
27557,5,2,96834,96834,96836,0,2,3
27558,1,3,96835,96836,96839,1,4,0
27559,2,3,96837,96839,96842,2,5,0
27560,3,1,96840,96842,96843,2,3,0
27561,1,3,96841,96843,96846,2,5,0
27562,2,1,96843,96846,96847,3,4,0
27563,6,1,96849,96849,96850,0,1,2
27564,5,2,96854,96854,96856,0,2,4
27565,3,2,96857,96857,96859,0,2,1
27566,2,1,96859,96859,96860,0,1,0
27567,2,2,96861,96861,96863,0,2,1
27568,3,3,96864,96864,96867,0,3,1
27569,1,2,96865,96867,96869,2,4,0
27570,2,3,96867,96869,96872,2,5,0
27571,1,1,96868,96872,96873,4,5,0
27572,5,1,96873,96873,96874,0,1,0
27573,1,3,96874,96874,96877,0,3,0
27574,4,3,96878,96878,96881,0,3,1
27575,3,3,96881,96881,96884,0,3,0
27576,4,3,96885,96885,96888,0,3,1
27577,4,1,96889,96889,96890,0,1,1
27578,6,2,96895,96895,96897,0,2,5
27579,4,1,96899,96899,96900,0,1,2
27580,2,2,96901,96901,96903,0,2,1
27581,5,1,96906,96906,96907,0,1,3
27582,2,3,96908,96908,96911,0,3,1
27583,5,1,96913,96913,96914,0,1,2
27584,6,2,96919,96919,96921,0,2,5
27585,4,3,96923,96923,96926,0,3,2
27586,4,1,96927,96927,96928,0,1,1
27587,3,1,96930,96930,96931,0,1,2
27588,1,3,96931,96931,96934,0,3,0
27589,4,2,96935,96935,96937,0,2,1
27590,5,2,96940,96940,96942,0,2,3
27591,2,3,96942,96942,96945,0,3,0
27592,2,3,96944,96945,96948,1,4,0
27593,6,1,96950,96950,96951,0,1,2
27594,5,2,96955,96955,96957,0,2,4
27595,6,3,96961,96961,96964,0,3,4
27596,4,1,96965,96965,96966,0,1,1
27597,4,2,96969,96969,96971,0,2,3
27598,2,3,96971,96971,96974,0,3,0
27599,6,2,96977,96977,96979,0,2,3
27600,4,3,96981,96981,96984,0,3,2
27601,1,3,96982,96984,96987,2,5,0
27602,3,3,96985,96987,96990,2,5,0
27603,2,3,96987,96990,96993,3,6,0
27604,5,1,96992,96993,96994,1,2,0
27605,1,2,96993,96994,96996,1,3,0
27606,1,1,96994,96996,96997,2,3,0
27607,2,1,96996,96997,96998,1,2,0
27608,2,3,96998,96998,97001,0,3,0
27609,3,2,97001,97001,97003,0,2,0
27610,1,2,97002,97003,97005,1,3,0
27611,2,1,97004,97005,97006,1,2,0
27612,2,1,97006,97006,97007,0,1,0
27613,2,3,97008,97008,97011,0,3,1
27614,2,2,97010,97011,97013,1,3,0
27615,1,3,97011,97013,97016,2,5,0
27616,6,3,97017,97017,97020,0,3,1
27617,5,1,97022,97022,97023,0,1,2
27618,5,1,97027,97027,97028,0,1,4
27619,5,3,97032,97032,97035,0,3,4
27620,3,1,97035,97035,97036,0,1,0
27621,2,1,97037,97037,97038,0,1,1
27622,3,1,97040,97040,97041,0,1,2
27623,3,3,97043,97043,97046,0,3,2
27624,3,3,97046,97046,97049,0,3,0
27625,1,2,97047,97049,97051,2,4,0
27626,2,3,97049,97051,97054,2,5,0
27627,6,2,97055,97055,97057,0,2,1
27628,5,3,97060,97060,97063,0,3,3
27629,6,1,97066,97066,97067,0,1,3
27630,6,2,97072,97072,97074,0,2,5
27631,5,1,97077,97077,97078,0,1,3
27632,1,2,97078,97078,97080,0,2,0
27633,2,2,97080,97080,97082,0,2,0
27634,1,1,97081,97082,97083,1,2,0
27635,1,3,97082,97083,97086,1,4,0
27636,3,2,97085,97086,97088,1,3,0
27637,2,1,97087,97088,97089,1,2,0
27638,4,2,97091,97091,97093,0,2,2
27639,2,3,97093,97093,97096,0,3,0
27640,6,2,97099,97099,97101,0,2,3
27641,2,1,97101,97101,97102,0,1,0
27642,1,2,97102,97102,97104,0,2,0
27643,5,2,97107,97107,97109,0,2,3
27644,5,3,97112,97112,97115,0,3,3
27645,6,3,97118,97118,97121,0,3,3
27646,3,3,97121,97121,97124,0,3,0
27647,6,3,97127,97127,97130,0,3,3
27648,1,3,97128,97130,97133,2,5,0
27649,3,2,97131,97133,97135,2,4,0
27650,5,2,97136,97136,97138,0,2,1
27651,5,3,97141,97141,97144,0,3,3
27652,1,3,97142,97144,97147,2,5,0
27653,4,1,97146,97147,97148,1,2,0
27654,4,2,97150,97150,97152,0,2,2
27655,6,3,97156,97156,97159,0,3,4
27656,1,3,97157,97159,97162,2,5,0
27657,1,3,97158,97162,97165,4,7,0
27658,5,1,97163,97165,97166,2,3,0
27659,2,1,97165,97166,97167,1,2,0
27660,5,1,97170,97170,97171,0,1,3
27661,4,2,97174,97174,97176,0,2,3
27662,4,1,97178,97178,97179,0,1,2
27663,3,3,97181,97181,97184,0,3,2
27664,2,2,97183,97184,97186,1,3,0
27665,6,3,97189,97189,97192,0,3,3
27666,2,2,97191,97192,97194,1,3,0
27667,5,3,97196,97196,97199,0,3,2
27668,4,2,97200,97200,97202,0,2,1
27669,6,2,97206,97206,97208,0,2,4
27670,4,2,97210,97210,97212,0,2,2
27671,6,3,97216,97216,97219,0,3,4
27672,4,2,97220,97220,97222,0,2,1
27673,4,3,97224,97224,97227,0,3,2
27674,2,2,97226,97227,97229,1,3,0
27675,3,1,97229,97229,97230,0,1,0
27676,4,1,97233,97233,97234,0,1,3
27677,4,3,97237,97237,97240,0,3,3
27678,2,1,97239,97240,97241,1,2,0
27679,1,3,97240,97241,97244,1,4,0
27680,1,1,97241,97244,97245,3,4,0
27681,6,3,97247,97247,97250,0,3,2
27682,1,1,97248,97250,97251,2,3,0
27683,4,3,97252,97252,97255,0,3,1
27684,3,3,97255,97255,97258,0,3,0
27685,2,2,97257,97258,97260,1,3,0
27686,6,1,97263,97263,97264,0,1,3
27687,3,3,97266,97266,97269,0,3,2
27688,5,3,97271,97271,97274,0,3,2
27689,2,3,97273,97274,97277,1,4,0
27690,5,3,97278,97278,97281,0,3,1
27691,3,2,97281,97281,97283,0,2,0
27692,1,3,97282,97283,97286,1,4,0
27693,6,2,97288,97288,97290,0,2,2
27694,2,1,97290,97290,97291,0,1,0
27695,5,1,97295,97295,97296,0,1,4
27696,6,3,97301,97301,97304,0,3,5
27697,1,3,97302,97304,97307,2,5,0
27698,2,3,97304,97307,97310,3,6,0
27699,4,1,97308,97310,97311,2,3,0
27700,2,2,97310,97311,97313,1,3,0
27701,3,2,97313,97313,97315,0,2,0
27702,1,2,97314,97315,97317,1,3,0
27703,4,1,97318,97318,97319,0,1,1
27704,5,1,97323,97323,97324,0,1,4
27705,2,1,97325,97325,97326,0,1,1
27706,1,1,97326,97326,97327,0,1,0
27707,1,2,97327,97327,97329,0,2,0
27708,4,3,97331,97331,97334,0,3,2
27709,1,3,97332,97334,97337,2,5,0
27710,4,3,97336,97337,97340,1,4,0
27711,6,2,97342,97342,97344,0,2,2
27712,4,2,97346,97346,97348,0,2,2
27713,1,1,97347,97348,97349,1,2,0
27714,6,1,97353,97353,97354,0,1,4
27715,6,3,97359,97359,97362,0,3,5
27716,5,1,97364,97364,97365,0,1,2
27717,2,2,97366,97366,97368,0,2,1
27718,2,2,97368,97368,97370,0,2,0
27719,2,3,97370,97370,97373,0,3,0
27720,1,1,97371,97373,97374,2,3,0
27721,1,1,97372,97374,97375,2,3,0
27722,4,1,97376,97376,97377,0,1,1
27723,4,1,97380,97380,97381,0,1,3
27724,1,2,97381,97381,97383,0,2,0
27725,2,1,97383,97383,97384,0,1,0
27726,4,3,97387,97387,97390,0,3,3
27727,4,2,97391,97391,97393,0,2,1
27728,3,3,97394,97394,97397,0,3,1
27729,1,3,97395,97397,97400,2,5,0
27730,4,3,97399,97400,97403,1,4,0
27731,6,1,97405,97405,97406,0,1,2
27732,4,2,97409,97409,97411,0,2,3
27733,2,2,97411,97411,97413,0,2,0
27734,4,3,97415,97415,97418,0,3,2
27735,2,1,97417,97418,97419,1,2,0
27736,3,1,97420,97420,97421,0,1,1
27737,4,1,97424,97424,97425,0,1,3
27738,6,2,97430,97430,97432,0,2,5
27739,4,3,97434,97434,97437,0,3,2
27740,2,1,97436,97437,97438,1,2,0
27741,3,2,97439,97439,97441,0,2,1
27742,1,3,97440,97441,97444,1,4,0
27743,2,1,97442,97444,97445,2,3,0
27744,6,1,97448,97448,97449,0,1,3
27745,1,2,97449,97449,97451,0,2,0
27746,3,3,97452,97452,97455,0,3,1
27747,2,3,97454,97455,97458,1,4,0
27748,6,2,97460,97460,97462,0,2,2
27749,6,2,97466,97466,97468,0,2,4
27750,5,2,97471,97471,97473,0,2,3
27751,6,1,97477,97477,97478,0,1,4
27752,3,3,97480,97480,97483,0,3,2
27753,2,2,97482,97483,97485,1,3,0
27754,4,3,97486,97486,97489,0,3,1
27755,1,3,97487,97489,97492,2,5,0
27756,6,3,97493,97493,97496,0,3,1
27757,5,3,97498,97498,97501,0,3,2
27758,3,1,97501,97501,97502,0,1,0
27759,1,2,97502,97502,97504,0,2,0
27760,1,2,97503,97504,97506,1,3,0
27761,5,1,97508,97508,97509,0,1,2
27762,4,3,97512,97512,97515,0,3,3
27763,6,3,97518,97518,97521,0,3,3
27764,4,3,97522,97522,97525,0,3,1
27765,1,2,97523,97525,97527,2,4,0
27766,6,1,97529,97529,97530,0,1,2
27767,1,1,97530,97530,97531,0,1,0
27768,6,2,97536,97536,97538,0,2,5
27769,4,2,97540,97540,97542,0,2,2
27770,1,1,97541,97542,97543,1,2,0
27771,3,2,97544,97544,97546,0,2,1
27772,2,2,97546,97546,97548,0,2,0
27773,2,2,97548,97548,97550,0,2,0
27774,2,3,97550,97550,97553,0,3,0
27775,1,3,97551,97553,97556,2,5,0
27776,1,1,97552,97556,97557,4,5,0
27777,2,2,97554,97557,97559,3,5,0
27778,3,3,97557,97559,97562,2,5,0
27779,1,1,97558,97562,97563,4,5,0
27780,5,1,97563,97563,97564,0,1,0
27781,3,1,97566,97566,97567,0,1,2
27782,6,1,97572,97572,97573,0,1,5
27783,5,3,97577,97577,97580,0,3,4
27784,1,3,97578,97580,97583,2,5,0
27785,3,2,97581,97583,97585,2,4,0
27786,4,2,97585,97585,97587,0,2,0
27787,3,1,97588,97588,97589,0,1,1
27788,1,2,97589,97589,97591,0,2,0
27789,6,1,97595,97595,97596,0,1,4
27790,4,3,97599,97599,97602,0,3,3
27791,6,1,97605,97605,97606,0,1,3
27792,3,2,97608,97608,97610,0,2,2
27793,1,2,97609,97610,97612,1,3,0
27794,3,1,97612,97612,97613,0,1,0
27795,6,3,97618,97618,97621,0,3,5
27796,2,2,97620,97621,97623,1,3,0
27797,6,1,97626,97626,97627,0,1,3
27798,4,3,97630,97630,97633,0,3,3
27799,4,1,97634,97634,97635,0,1,1
27800,1,3,97635,97635,97638,0,3,0
27801,2,3,97637,97638,97641,1,4,0
27802,2,2,97639,97641,97643,2,4,0
27803,4,1,97643,97643,97644,0,1,0
27804,6,2,97649,97649,97651,0,2,5
27805,4,3,97653,97653,97656,0,3,2
27806,6,2,97659,97659,97661,0,2,3
27807,1,1,97660,97661,97662,1,2,0
27808,1,1,97661,97662,97663,1,2,0
27809,6,2,97667,97667,97669,0,2,4
27810,2,2,97669,97669,97671,0,2,0
27811,4,1,97673,97673,97674,0,1,2
27812,2,3,97675,97675,97678,0,3,1
27813,4,3,97679,97679,97682,0,3,1
27814,6,2,97685,97685,97687,0,2,3
27815,1,2,97686,97687,97689,1,3,0
27816,6,1,97692,97692,97693,0,1,3
27817,2,1,97694,97694,97695,0,1,1
27818,1,1,97695,97695,97696,0,1,0
27819,3,1,97698,97698,97699,0,1,2
27820,1,2,97699,97699,97701,0,2,0
27821,4,2,97703,97703,97705,0,2,2
27822,1,1,97704,97705,97706,1,2,0
27823,6,1,97710,97710,97711,0,1,4
27824,4,2,97714,97714,97716,0,2,3
27825,2,3,97716,97716,97719,0,3,0
27826,5,1,97721,97721,97722,0,1,2
27827,1,3,97722,97722,97725,0,3,0
27828,4,3,97726,97726,97729,0,3,1
27829,1,3,97727,97729,97732,2,5,0
27830,2,1,97729,97732,97733,3,4,0
27831,2,1,97731,97733,97734,2,3,0
27832,3,1,97734,97734,97735,0,1,0
27833,3,3,97737,97737,97740,0,3,2
27834,3,2,97740,97740,97742,0,2,0
27835,2,1,97742,97742,97743,0,1,0
27836,5,1,97747,97747,97748,0,1,4
27837,1,1,97748,97748,97749,0,1,0
27838,5,2,97753,97753,97755,0,2,4
27839,6,2,97759,97759,97761,0,2,4
27840,4,2,97763,97763,97765,0,2,2
27841,5,3,97768,97768,97771,0,3,3
27842,6,3,97774,97774,97777,0,3,3
27843,5,2,97779,97779,97781,0,2,2
27844,6,2,97785,97785,97787,0,2,4
27845,1,2,97786,97787,97789,1,3,0
27846,1,3,97787,97789,97792,2,5,0
27847,3,2,97790,97792,97794,2,4,0
27848,5,2,97795,97795,97797,0,2,1
27849,6,1,97801,97801,97802,0,1,4
27850,6,1,97807,97807,97808,0,1,5
27851,4,3,97811,97811,97814,0,3,3
27852,1,1,97812,97814,97815,2,3,0
27853,4,3,97816,97816,97819,0,3,1
27854,3,2,97819,97819,97821,0,2,0
27855,5,1,97824,97824,97825,0,1,3
27856,6,1,97830,97830,97831,0,1,5
27857,3,2,97833,97833,97835,0,2,2
27858,4,2,97837,97837,97839,0,2,2
27859,1,1,97838,97839,97840,1,2,0
27860,2,3,97840,97840,97843,0,3,0
27861,6,3,97846,97846,97849,0,3,3
27862,2,1,97848,97849,97850,1,2,0
27863,6,1,97854,97854,97855,0,1,4
27864,2,3,97856,97856,97859,0,3,1
27865,2,3,97858,97859,97862,1,4,0
27866,6,3,97864,97864,97867,0,3,2
27867,4,2,97868,97868,97870,0,2,1
27868,5,2,97873,97873,97875,0,2,3
27869,2,2,97875,97875,97877,0,2,0
27870,6,1,97881,97881,97882,0,1,4
27871,2,3,97883,97883,97886,0,3,1
27872,5,2,97888,97888,97890,0,2,2
27873,3,3,97891,97891,97894,0,3,1
27874,1,2,97892,97894,97896,2,4,0
27875,2,3,97894,97896,97899,2,5,0
27876,4,3,97898,97899,97902,1,4,0
27877,3,2,97901,97902,97904,1,3,0
27878,6,2,97907,97907,97909,0,2,3
27879,6,3,97913,97913,97916,0,3,4
27880,5,1,97918,97918,97919,0,1,2
27881,3,1,97921,97921,97922,0,1,2
27882,5,2,97926,97926,97928,0,2,4
27883,6,3,97932,97932,97935,0,3,4
27884,4,3,97936,97936,97939,0,3,1
27885,5,2,97941,97941,97943,0,2,2
27886,6,1,97947,97947,97948,0,1,4
27887,2,1,97949,97949,97950,0,1,1
27888,4,3,97953,97953,97956,0,3,3
27889,6,3,97959,97959,97962,0,3,3
27890,6,3,97965,97965,97968,0,3,3
27891,4,3,97969,97969,97972,0,3,1
27892,6,3,97975,97975,97978,0,3,3
27893,1,1,97976,97978,97979,2,3,0
27894,3,2,97979,97979,97981,0,2,0
27895,3,2,97982,97982,97984,0,2,1
27896,6,2,97988,97988,97990,0,2,4
27897,2,3,97990,97990,97993,0,3,0
27898,1,2,97991,97993,97995,2,4,0
27899,2,3,97993,97995,97998,2,5,0
27900,4,3,97997,97998,98001,1,4,0
27901,4,1,98001,98001,98002,0,1,0
27902,4,1,98005,98005,98006,0,1,3
27903,6,3,98011,98011,98014,0,3,5
27904,5,1,98016,98016,98017,0,1,2
27905,4,3,98020,98020,98023,0,3,3
27906,4,2,98024,98024,98026,0,2,1
27907,4,2,98028,98028,98030,0,2,2
27908,4,2,98032,98032,98034,0,2,2
27909,3,1,98035,98035,98036,0,1,1
27910,1,1,98036,98036,98037,0,1,0
27911,2,3,98038,98038,98041,0,3,1
27912,2,2,98040,98041,98043,1,3,0
27913,2,2,98042,98043,98045,1,3,0
27914,1,2,98043,98045,98047,2,4,0
27915,6,2,98049,98049,98051,0,2,2
27916,4,2,98053,98053,98055,0,2,2
27917,3,3,98056,98056,98059,0,3,1
27918,2,1,98058,98059,98060,1,2,0
27919,3,3,98061,98061,98064,0,3,1
27920,2,1,98063,98064,98065,1,2,0
27921,6,2,98069,98069,98071,0,2,4
27922,3,2,98072,98072,98074,0,2,1
27923,3,2,98075,98075,98077,0,2,1
27924,4,2,98079,98079,98081,0,2,2
27925,1,2,98080,98081,98083,1,3,0
27926,1,1,98081,98083,98084,2,3,0
27927,2,2,98083,98084,98086,1,3,0
27928,4,1,98087,98087,98088,0,1,1
27929,2,2,98089,98089,98091,0,2,1
27930,4,3,98093,98093,98096,0,3,2
27931,1,3,98094,98096,98099,2,5,0
27932,1,1,98095,98099,98100,4,5,0
27933,2,2,98097,98100,98102,3,5,0
27934,2,3,98099,98102,98105,3,6,0
27935,5,2,98104,98105,98107,1,3,0
27936,5,3,98109,98109,98112,0,3,2
27937,3,2,98112,98112,98114,0,2,0
27938,2,2,98114,98114,98116,0,2,0
27939,3,2,98117,98117,98119,0,2,1
27940,4,2,98121,98121,98123,0,2,2
27941,3,3,98124,98124,98127,0,3,1
27942,4,2,98128,98128,98130,0,2,1
27943,3,2,98131,98131,98133,0,2,1
27944,2,3,98133,98133,98136,0,3,0
27945,1,1,98134,98136,98137,2,3,0
27946,1,2,98135,98137,98139,2,4,0
27947,6,2,98141,98141,98143,0,2,2
27948,5,1,98146,98146,98147,0,1,3
27949,1,2,98147,98147,98149,0,2,0
27950,6,3,98153,98153,98156,0,3,4
27951,5,2,98158,98158,98160,0,2,2
27952,6,3,98164,98164,98167,0,3,4
27953,1,3,98165,98167,98170,2,5,0
27954,3,3,98168,98170,98173,2,5,0
27955,5,2,98173,98173,98175,0,2,0
27956,2,2,98175,98175,98177,0,2,0
27957,4,2,98179,98179,98181,0,2,2
27958,6,3,98185,98185,98188,0,3,4
27959,3,2,98188,98188,98190,0,2,0
27960,3,1,98191,98191,98192,0,1,1
27961,1,3,98192,98192,98195,0,3,0
27962,1,1,98193,98195,98196,2,3,0
27963,2,2,98195,98196,98198,1,3,0
27964,5,1,98200,98200,98201,0,1,2
27965,2,1,98202,98202,98203,0,1,1
27966,1,1,98203,98203,98204,0,1,0
27967,5,1,98208,98208,98209,0,1,4
27968,6,2,98214,98214,98216,0,2,5
27969,6,3,98220,98220,98223,0,3,4
27970,5,3,98225,98225,98228,0,3,2
27971,5,3,98230,98230,98233,0,3,2
27972,6,1,98236,98236,98237,0,1,3
27973,5,3,98241,98241,98244,0,3,4
27974,2,1,98243,98244,98245,1,2,0
27975,4,3,98247,98247,98250,0,3,2
27976,3,2,98250,98250,98252,0,2,0
27977,4,2,98254,98254,98256,0,2,2
27978,2,1,98256,98256,98257,0,1,0
27979,6,2,98262,98262,98264,0,2,5
27980,3,2,98265,98265,98267,0,2,1
27981,4,2,98269,98269,98271,0,2,2
27982,6,1,98275,98275,98276,0,1,4
27983,5,1,98280,98280,98281,0,1,4
27984,2,2,98282,98282,98284,0,2,1
27985,6,2,98288,98288,98290,0,2,4
27986,1,2,98289,98290,98292,1,3,0
27987,1,2,98290,98292,98294,2,4,0
27988,2,1,98292,98294,98295,2,3,0
27989,3,3,98295,98295,98298,0,3,0
27990,4,1,98299,98299,98300,0,1,1
27991,3,3,98302,98302,98305,0,3,2
27992,6,2,98308,98308,98310,0,2,3
27993,1,1,98309,98310,98311,1,2,0
27994,5,3,98314,98314,98317,0,3,3
27995,2,3,98316,98317,98320,1,4,0
27996,5,1,98321,98321,98322,0,1,1
27997,2,3,98323,98323,98326,0,3,1
27998,4,1,98327,98327,98328,0,1,1
27999,6,1,98333,98333,98334,0,1,5
28000,5,3,98338,98338,98341,0,3,4
28001,2,2,98340,98341,98343,1,3,0
28002,2,2,98342,98343,98345,1,3,0
28003,1,1,98343,98345,98346,2,3,0
28004,2,3,98345,98346,98349,1,4,0
28005,2,2,98347,98349,98351,2,4,0
28006,6,2,98353,98353,98355,0,2,2
28007,5,2,98358,98358,98360,0,2,3
28008,4,3,98362,98362,98365,0,3,2
28009,3,2,98365,98365,98367,0,2,0
28010,5,3,98370,98370,98373,0,3,3
28011,1,2,98371,98373,98375,2,4,0
28012,3,3,98374,98375,98378,1,4,0
28013,4,1,98378,98378,98379,0,1,0
28014,4,1,98382,98382,98383,0,1,3
28015,1,3,98383,98383,98386,0,3,0
28016,2,3,98385,98386,98389,1,4,0
28017,5,2,98390,98390,98392,0,2,1
28018,6,1,98396,98396,98397,0,1,4
28019,4,2,98400,98400,98402,0,2,3
28020,1,1,98401,98402,98403,1,2,0
28021,4,3,98405,98405,98408,0,3,2
28022,1,1,98406,98408,98409,2,3,0
28023,3,1,98409,98409,98410,0,1,0
28024,2,2,98411,98411,98413,0,2,1
28025,5,2,98416,98416,98418,0,2,3
28026,3,1,98419,98419,98420,0,1,1
28027,3,2,98422,98422,98424,0,2,2
28028,5,3,98427,98427,98430,0,3,3
28029,6,3,98433,98433,98436,0,3,3
28030,6,3,98439,98439,98442,0,3,3
28031,3,3,98442,98442,98445,0,3,0
28032,2,1,98444,98445,98446,1,2,0
28033,3,3,98447,98447,98450,0,3,1
28034,6,2,98453,98453,98455,0,2,3
28035,6,1,98459,98459,98460,0,1,4
28036,6,2,98465,98465,98467,0,2,5
28037,6,1,98471,98471,98472,0,1,4
28038,1,2,98472,98472,98474,0,2,0
28039,4,1,98476,98476,98477,0,1,2
28040,4,2,98480,98480,98482,0,2,3
28041,5,2,98485,98485,98487,0,2,3
28042,5,3,98490,98490,98493,0,3,3
28043,4,1,98494,98494,98495,0,1,1
28044,5,1,98499,98499,98500,0,1,4
28045,4,1,98503,98503,98504,0,1,3
28046,6,1,98509,98509,98510,0,1,5
28047,2,3,98511,98511,98514,0,3,1
28048,5,3,98516,98516,98519,0,3,2
28049,2,1,98518,98519,98520,1,2,0
28050,3,1,98521,98521,98522,0,1,1
28051,2,1,98523,98523,98524,0,1,1
28052,5,1,98528,98528,98529,0,1,4
28053,4,2,98532,98532,98534,0,2,3
28054,3,2,98535,98535,98537,0,2,1
28055,3,2,98538,98538,98540,0,2,1
28056,2,2,98540,98540,98542,0,2,0
28057,2,3,98542,98542,98545,0,3,0
28058,4,1,98546,98546,98547,0,1,1
28059,5,1,98551,98551,98552,0,1,4
28060,4,1,98555,98555,98556,0,1,3
28061,2,2,98557,98557,98559,0,2,1
28062,4,2,98561,98561,98563,0,2,2
28063,1,1,98562,98563,98564,1,2,0
28064,3,1,98565,98565,98566,0,1,1
28065,5,3,98570,98570,98573,0,3,4
28066,5,3,98575,98575,98578,0,3,2
28067,2,3,98577,98578,98581,1,4,0
28068,5,2,98582,98582,98584,0,2,1
28069,3,2,98585,98585,98587,0,2,1
28070,1,2,98586,98587,98589,1,3,0
28071,2,2,98588,98589,98591,1,3,0
28072,4,3,98592,98592,98595,0,3,1
28073,3,2,98595,98595,98597,0,2,0
28074,3,2,98598,98598,98600,0,2,1
28075,5,3,98603,98603,98606,0,3,3
28076,5,3,98608,98608,98611,0,3,2
28077,3,3,98611,98611,98614,0,3,0
28078,2,3,98613,98614,98617,1,4,0
28079,1,1,98614,98617,98618,3,4,0
28080,2,2,98616,98618,98620,2,4,0
28081,2,3,98618,98620,98623,2,5,0
28082,5,1,98623,98623,98624,0,1,0
28083,4,3,98627,98627,98630,0,3,3
28084,4,1,98631,98631,98632,0,1,1
28085,1,1,98632,98632,98633,0,1,0
28086,2,3,98634,98634,98637,0,3,1
28087,3,1,98637,98637,98638,0,1,0
28088,2,2,98639,98639,98641,0,2,1
28089,2,2,98641,98641,98643,0,2,0
28090,3,2,98644,98644,98646,0,2,1
28091,4,3,98648,98648,98651,0,3,2
28092,5,3,98653,98653,98656,0,3,2
28093,6,2,98659,98659,98661,0,2,3
28094,1,2,98660,98661,98663,1,3,0
28095,2,2,98662,98663,98665,1,3,0
28096,6,3,98668,98668,98671,0,3,3
28097,4,2,98672,98672,98674,0,2,1
28098,2,3,98674,98674,98677,0,3,0
28099,4,2,98678,98678,98680,0,2,1
28100,4,2,98682,98682,98684,0,2,2
28101,4,3,98686,98686,98689,0,3,2
28102,4,2,98690,98690,98692,0,2,1
28103,5,3,98695,98695,98698,0,3,3
28104,5,1,98700,98700,98701,0,1,2
28105,5,3,98705,98705,98708,0,3,4
28106,1,3,98706,98708,98711,2,5,0
28107,5,1,98711,98711,98712,0,1,0
28108,1,1,98712,98712,98713,0,1,0
28109,5,1,98717,98717,98718,0,1,4
28110,5,2,98722,98722,98724,0,2,4
28111,1,3,98723,98724,98727,1,4,0
28112,6,3,98729,98729,98732,0,3,2
28113,6,1,98735,98735,98736,0,1,3
28114,4,3,98739,98739,98742,0,3,3
28115,5,1,98744,98744,98745,0,1,2
28116,3,2,98747,98747,98749,0,2,2
28117,4,1,98751,98751,98752,0,1,2
28118,3,2,98754,98754,98756,0,2,2
28119,2,2,98756,98756,98758,0,2,0
28120,4,2,98760,98760,98762,0,2,2
28121,5,1,98765,98765,98766,0,1,3
28122,6,1,98771,98771,98772,0,1,5
28123,3,2,98774,98774,98776,0,2,2
28124,3,1,98777,98777,98778,0,1,1
28125,2,1,98779,98779,98780,0,1,1
28126,1,3,98780,98780,98783,0,3,0
28127,3,3,98783,98783,98786,0,3,0
28128,5,3,98788,98788,98791,0,3,2
28129,2,3,98790,98791,98794,1,4,0
28130,5,2,98795,98795,98797,0,2,1
28131,6,2,98801,98801,98803,0,2,4
28132,3,2,98804,98804,98806,0,2,1
28133,5,3,98809,98809,98812,0,3,3
28134,4,3,98813,98813,98816,0,3,1
28135,1,2,98814,98816,98818,2,4,0
28136,3,3,98817,98818,98821,1,4,0
28137,6,3,98823,98823,98826,0,3,2
28138,5,3,98828,98828,98831,0,3,2
28139,6,1,98834,98834,98835,0,1,3
28140,1,3,98835,98835,98838,0,3,0
28141,5,3,98840,98840,98843,0,3,2
28142,4,3,98844,98844,98847,0,3,1
28143,6,1,98850,98850,98851,0,1,3
28144,1,3,98851,98851,98854,0,3,0
28145,4,1,98855,98855,98856,0,1,1
28146,5,3,98860,98860,98863,0,3,4
28147,3,3,98863,98863,98866,0,3,0
28148,5,1,98868,98868,98869,0,1,2
28149,6,2,98874,98874,98876,0,2,5
28150,2,1,98876,98876,98877,0,1,0
28151,4,1,98880,98880,98881,0,1,3
28152,5,2,98885,98885,98887,0,2,4
28153,3,3,98888,98888,98891,0,3,1
28154,3,1,98891,98891,98892,0,1,0
28155,5,2,98896,98896,98898,0,2,4
28156,3,1,98899,98899,98900,0,1,1
28157,6,1,98905,98905,98906,0,1,5
28158,1,3,98906,98906,98909,0,3,0
28159,6,1,98912,98912,98913,0,1,3
28160,3,2,98915,98915,98917,0,2,2
28161,2,1,98917,98917,98918,0,1,0
28162,5,1,98922,98922,98923,0,1,4
28163,1,2,98923,98923,98925,0,2,0
28164,2,2,98925,98925,98927,0,2,0
28165,3,1,98928,98928,98929,0,1,1
28166,4,3,98932,98932,98935,0,3,3
28167,5,1,98937,98937,98938,0,1,2
28168,4,2,98941,98941,98943,0,2,3
28169,1,3,98942,98943,98946,1,4,0
28170,5,3,98947,98947,98950,0,3,1
28171,4,1,98951,98951,98952,0,1,1
28172,1,3,98952,98952,98955,0,3,0
28173,5,2,98957,98957,98959,0,2,2
28174,1,2,98958,98959,98961,1,3,0
28175,3,2,98961,98961,98963,0,2,0
28176,6,1,98967,98967,98968,0,1,4
28177,6,2,98973,98973,98975,0,2,5
28178,3,3,98976,98976,98979,0,3,1
28179,3,3,98979,98979,98982,0,3,0
28180,4,3,98983,98983,98986,0,3,1
28181,4,1,98987,98987,98988,0,1,1
28182,4,2,98991,98991,98993,0,2,3
28183,2,1,98993,98993,98994,0,1,0
28184,6,3,98999,98999,99002,0,3,5
28185,4,1,99003,99003,99004,0,1,1
28186,3,3,99006,99006,99009,0,3,2
28187,4,2,99010,99010,99012,0,2,1
28188,2,3,99012,99012,99015,0,3,0
28189,3,3,99015,99015,99018,0,3,0
28190,2,2,99017,99018,99020,1,3,0
28191,2,1,99019,99020,99021,1,2,0
28192,1,2,99020,99021,99023,1,3,0
28193,5,2,99025,99025,99027,0,2,2
28194,4,2,99029,99029,99031,0,2,2
28195,6,3,99035,99035,99038,0,3,4
28196,3,3,99038,99038,99041,0,3,0
28197,4,1,99042,99042,99043,0,1,1
28198,2,2,99044,99044,99046,0,2,1
28199,5,2,99049,99049,99051,0,2,3
28200,4,1,99053,99053,99054,0,1,2
28201,1,1,99054,99054,99055,0,1,0
28202,1,2,99055,99055,99057,0,2,0
28203,4,2,99059,99059,99061,0,2,2
28204,5,1,99064,99064,99065,0,1,3
28205,5,2,99069,99069,99071,0,2,4
28206,2,1,99071,99071,99072,0,1,0
28207,6,3,99077,99077,99080,0,3,5
28208,1,3,99078,99080,99083,2,5,0
28209,4,2,99082,99083,99085,1,3,0
28210,5,2,99087,99087,99089,0,2,2
28211,3,1,99090,99090,99091,0,1,1
28212,5,1,99095,99095,99096,0,1,4
28213,6,3,99101,99101,99104,0,3,5
28214,6,3,99107,99107,99110,0,3,3
28215,2,3,99109,99110,99113,1,4,0
28216,2,3,99111,99113,99116,2,5,0
28217,3,2,99114,99116,99118,2,4,0
28218,3,1,99117,99118,99119,1,2,0
28219,3,1,99120,99120,99121,0,1,1
28220,3,1,99123,99123,99124,0,1,2
28221,6,2,99129,99129,99131,0,2,5
28222,6,3,99135,99135,99138,0,3,4
28223,3,1,99138,99138,99139,0,1,0
28224,5,2,99143,99143,99145,0,2,4
28225,1,1,99144,99145,99146,1,2,0
28226,5,2,99149,99149,99151,0,2,3
28227,1,1,99150,99151,99152,1,2,0
28228,4,1,99154,99154,99155,0,1,2
28229,2,1,99156,99156,99157,0,1,1
28230,2,2,99158,99158,99160,0,2,1
28231,1,2,99159,99160,99162,1,3,0
28232,4,3,99163,99163,99166,0,3,1
28233,2,3,99165,99166,99169,1,4,0
28234,5,1,99170,99170,99171,0,1,1
28235,3,1,99173,99173,99174,0,1,2
28236,3,2,99176,99176,99178,0,2,2
28237,2,2,99178,99178,99180,0,2,0
28238,5,2,99183,99183,99185,0,2,3
28239,5,2,99188,99188,99190,0,2,3
28240,2,2,99190,99190,99192,0,2,0
28241,4,1,99194,99194,99195,0,1,2
28242,1,2,99195,99195,99197,0,2,0
28243,1,1,99196,99197,99198,1,2,0
28244,2,1,99198,99198,99199,0,1,0
28245,2,1,99200,99200,99201,0,1,1
28246,2,2,99202,99202,99204,0,2,1
28247,3,2,99205,99205,99207,0,2,1
28248,6,1,99211,99211,99212,0,1,4
28249,5,1,99216,99216,99217,0,1,4
28250,4,2,99220,99220,99222,0,2,3
28251,3,2,99223,99223,99225,0,2,1
28252,5,3,99228,99228,99231,0,3,3
28253,2,1,99230,99231,99232,1,2,0
28254,4,3,99234,99234,99237,0,3,2
28255,5,2,99239,99239,99241,0,2,2
28256,2,2,99241,99241,99243,0,2,0
28257,4,1,99245,99245,99246,0,1,2
28258,3,1,99248,99248,99249,0,1,2
28259,2,3,99250,99250,99253,0,3,1
28260,5,2,99255,99255,99257,0,2,2
28261,5,2,99260,99260,99262,0,2,3
28262,1,3,99261,99262,99265,1,4,0
28263,3,1,99264,99265,99266,1,2,0
28264,6,2,99270,99270,99272,0,2,4
28265,4,3,99274,99274,99277,0,3,2
28266,5,2,99279,99279,99281,0,2,2
28267,4,2,99283,99283,99285,0,2,2
28268,3,3,99286,99286,99289,0,3,1
28269,5,1,99291,99291,99292,0,1,2
28270,4,1,99295,99295,99296,0,1,3
28271,3,3,99298,99298,99301,0,3,2
28272,6,1,99304,99304,99305,0,1,3
28273,5,2,99309,99309,99311,0,2,4
28274,1,3,99310,99311,99314,1,4,0
28275,2,1,99312,99314,99315,2,3,0
28276,1,3,99313,99315,99318,2,5,0
28277,5,2,99318,99318,99320,0,2,0
28278,6,2,99324,99324,99326,0,2,4
28279,6,3,99330,99330,99333,0,3,4
28280,5,3,99335,99335,99338,0,3,2
28281,6,1,99341,99341,99342,0,1,3
28282,3,2,99344,99344,99346,0,2,2
28283,4,1,99348,99348,99349,0,1,2
28284,3,3,99351,99351,99354,0,3,2
28285,2,2,99353,99354,99356,1,3,0
28286,1,2,99354,99356,99358,2,4,0
28287,1,3,99355,99358,99361,3,6,0
28288,4,3,99359,99361,99364,2,5,0
28289,6,2,99365,99365,99367,0,2,1
28290,1,2,99366,99367,99369,1,3,0
28291,6,1,99372,99372,99373,0,1,3
28292,1,1,99373,99373,99374,0,1,0
28293,3,1,99376,99376,99377,0,1,2
28294,1,2,99377,99377,99379,0,2,0
28295,3,1,99380,99380,99381,0,1,1
28296,6,3,99386,99386,99389,0,3,5
28297,4,1,99390,99390,99391,0,1,1
28298,6,2,99396,99396,99398,0,2,5
28299,4,1,99400,99400,99401,0,1,2
28300,5,2,99405,99405,99407,0,2,4
28301,1,2,99406,99407,99409,1,3,0
28302,6,2,99412,99412,99414,0,2,3
28303,2,3,99414,99414,99417,0,3,0
28304,3,1,99417,99417,99418,0,1,0
28305,1,2,99418,99418,99420,0,2,0
28306,5,2,99423,99423,99425,0,2,3
28307,3,1,99426,99426,99427,0,1,1
28308,5,2,99431,99431,99433,0,2,4
28309,5,1,99436,99436,99437,0,1,3
28310,1,2,99437,99437,99439,0,2,0
28311,2,3,99439,99439,99442,0,3,0
28312,1,3,99440,99442,99445,2,5,0
28313,4,3,99444,99445,99448,1,4,0
28314,5,3,99449,99449,99452,0,3,1
28315,2,2,99451,99452,99454,1,3,0
28316,6,2,99457,99457,99459,0,2,3
28317,3,2,99460,99460,99462,0,2,1
28318,2,1,99462,99462,99463,0,1,0
28319,1,2,99463,99463,99465,0,2,0
28320,3,2,99466,99466,99468,0,2,1
28321,5,3,99471,99471,99474,0,3,3
28322,1,3,99472,99474,99477,2,5,0
28323,2,1,99474,99477,99478,3,4,0
28324,1,3,99475,99478,99481,3,6,0
28325,4,2,99479,99481,99483,2,4,0
28326,3,1,99482,99483,99484,1,2,0
28327,5,2,99487,99487,99489,0,2,3
28328,2,2,99489,99489,99491,0,2,0
28329,6,3,99495,99495,99498,0,3,4
28330,2,3,99497,99498,99501,1,4,0
28331,1,2,99498,99501,99503,3,5,0
28332,1,1,99499,99503,99504,4,5,0
28333,5,3,99504,99504,99507,0,3,0
28334,3,3,99507,99507,99510,0,3,0
28335,2,3,99509,99510,99513,1,4,0
28336,5,3,99514,99514,99517,0,3,1
28337,5,3,99519,99519,99522,0,3,2
28338,6,1,99525,99525,99526,0,1,3
28339,5,2,99530,99530,99532,0,2,4
28340,6,2,99536,99536,99538,0,2,4
28341,4,2,99540,99540,99542,0,2,2
28342,6,2,99546,99546,99548,0,2,4
28343,3,1,99549,99549,99550,0,1,1
28344,5,1,99554,99554,99555,0,1,4
28345,1,1,99555,99555,99556,0,1,0
28346,1,3,99556,99556,99559,0,3,0
28347,3,3,99559,99559,99562,0,3,0
28348,3,2,99562,99562,99564,0,2,0
28349,5,3,99567,99567,99570,0,3,3
28350,4,2,99571,99571,99573,0,2,1
28351,3,3,99574,99574,99577,0,3,1
28352,3,2,99577,99577,99579,0,2,0
28353,1,1,99578,99579,99580,1,2,0
28354,6,3,99584,99584,99587,0,3,4
28355,3,1,99587,99587,99588,0,1,0
28356,4,2,99591,99591,99593,0,2,3
28357,2,1,99593,99593,99594,0,1,0
28358,5,2,99598,99598,99600,0,2,4
28359,2,3,99600,99600,99603,0,3,0
28360,4,1,99604,99604,99605,0,1,1
28361,2,1,99606,99606,99607,0,1,1
28362,3,2,99609,99609,99611,0,2,2
28363,6,1,99615,99615,99616,0,1,4
28364,2,1,99617,99617,99618,0,1,1
28365,4,1,99621,99621,99622,0,1,3
28366,2,3,99623,99623,99626,0,3,1
28367,5,2,99628,99628,99630,0,2,2
28368,2,1,99630,99630,99631,0,1,0
28369,2,3,99632,99632,99635,0,3,1
28370,2,3,99634,99635,99638,1,4,0
28371,2,3,99636,99638,99641,2,5,0
28372,3,3,99639,99641,99644,2,5,0
28373,1,2,99640,99644,99646,4,6,0
28374,2,2,99642,99646,99648,4,6,0
28375,4,1,99646,99648,99649,2,3,0
28376,2,1,99648,99649,99650,1,2,0
28377,2,2,99650,99650,99652,0,2,0
28378,2,3,99652,99652,99655,0,3,0
28379,6,1,99658,99658,99659,0,1,3
28380,4,3,99662,99662,99665,0,3,3
28381,1,2,99663,99665,99667,2,4,0
28382,1,2,99664,99667,99669,3,5,0
28383,4,1,99668,99669,99670,1,2,0
28384,4,2,99672,99672,99674,0,2,2
28385,6,1,99678,99678,99679,0,1,4
28386,5,1,99683,99683,99684,0,1,4
28387,5,2,99688,99688,99690,0,2,4
28388,4,2,99692,99692,99694,0,2,2
28389,3,2,99695,99695,99697,0,2,1
28390,6,1,99701,99701,99702,0,1,4
28391,4,1,99705,99705,99706,0,1,3
28392,6,2,99711,99711,99713,0,2,5
28393,5,2,99716,99716,99718,0,2,3
28394,5,2,99721,99721,99723,0,2,3
28395,1,2,99722,99723,99725,1,3,0
28396,6,3,99728,99728,99731,0,3,3
28397,2,2,99730,99731,99733,1,3,0
28398,3,2,99733,99733,99735,0,2,0
28399,5,2,99738,99738,99740,0,2,3
28400,5,1,99743,99743,99744,0,1,3
28401,2,1,99745,99745,99746,0,1,1
28402,3,2,99748,99748,99750,0,2,2
28403,5,1,99753,99753,99754,0,1,3
28404,1,1,99754,99754,99755,0,1,0
28405,1,3,99755,99755,99758,0,3,0
28406,4,3,99759,99759,99762,0,3,1
28407,1,3,99760,99762,99765,2,5,0
28408,3,2,99763,99765,99767,2,4,0
28409,5,1,99768,99768,99769,0,1,1
28410,5,1,99773,99773,99774,0,1,4
28411,4,1,99777,99777,99778,0,1,3
28412,1,1,99778,99778,99779,0,1,0
28413,2,3,99780,99780,99783,0,3,1
28414,4,1,99784,99784,99785,0,1,1
28415,6,1,99790,99790,99791,0,1,5
28416,2,2,99792,99792,99794,0,2,1
28417,2,3,99794,99794,99797,0,3,0
28418,2,3,99796,99797,99800,1,4,0
28419,2,3,99798,99800,99803,2,5,0
28420,4,2,99802,99803,99805,1,3,0
28421,2,1,99804,99805,99806,1,2,0
28422,1,1,99805,99806,99807,1,2,0
28423,6,1,99811,99811,99812,0,1,4
28424,3,3,99814,99814,99817,0,3,2
28425,5,2,99819,99819,99821,0,2,2
28426,4,2,99823,99823,99825,0,2,2
28427,6,1,99829,99829,99830,0,1,4
28428,5,2,99834,99834,99836,0,2,4
28429,6,3,99840,99840,99843,0,3,4
28430,6,3,99846,99846,99849,0,3,3
28431,3,2,99849,99849,99851,0,2,0
28432,1,2,99850,99851,99853,1,3,0
28433,4,3,99854,99854,99857,0,3,1
28434,4,3,99858,99858,99861,0,3,1
28435,3,2,99861,99861,99863,0,2,0
28436,5,1,99866,99866,99867,0,1,3
28437,5,1,99871,99871,99872,0,1,4
28438,4,3,99875,99875,99878,0,3,3
28439,6,2,99881,99881,99883,0,2,3
28440,4,3,99885,99885,99888,0,3,2
28441,2,2,99887,99888,99890,1,3,0
28442,5,3,99892,99892,99895,0,3,2
28443,2,2,99894,99895,99897,1,3,0
28444,4,1,99898,99898,99899,0,1,1
28445,1,1,99899,99899,99900,0,1,0
28446,4,2,99903,99903,99905,0,2,3
28447,5,1,99908,99908,99909,0,1,3
28448,4,2,99912,99912,99914,0,2,3
28449,6,1,99918,99918,99919,0,1,4
28450,5,3,99923,99923,99926,0,3,4
28451,6,1,99929,99929,99930,0,1,3
28452,3,3,99932,99932,99935,0,3,2
28453,2,3,99934,99935,99938,1,4,0
28454,1,3,99935,99938,99941,3,6,0
28455,1,2,99936,99941,99943,5,7,0
28456,2,3,99938,99943,99946,5,8,0
28457,4,2,99942,99946,99948,4,6,0
28458,6,1,99948,99948,99949,0,1,0
28459,4,2,99952,99952,99954,0,2,3
28460,2,1,99954,99954,99955,0,1,0
28461,1,3,99955,99955,99958,0,3,0
28462,2,3,99957,99958,99961,1,4,0
28463,1,2,99958,99961,99963,3,5,0
28464,3,2,99961,99963,99965,2,4,0
28465,3,1,99964,99965,99966,1,2,0
28466,5,2,99969,99969,99971,0,2,3
28467,3,3,99972,99972,99975,0,3,1
28468,1,3,99973,99975,99978,2,5,0
28469,1,1,99974,99978,99979,4,5,0
28470,1,1,99975,99979,99980,4,5,0
28471,2,1,99977,99980,99981,3,4,0
28472,1,3,99978,99981,99984,3,6,0
28473,6,3,99984,99984,99987,0,3,0
28474,3,1,99987,99987,99988,0,1,0
28475,4,1,99991,99991,99992,0,1,3
28476,2,1,99993,99993,99994,0,1,1
28477,4,2,99997,99997,99999,0,2,3
28478,4,1,100001,100001,100002,0,1,2
28479,5,1,100006,100006,100007,0,1,4
28480,4,1,100010,100010,100011,0,1,3
28481,2,2,100012,100012,100014,0,2,1
28482,5,2,100017,100017,100019,0,2,3
28483,4,2,100021,100021,100023,0,2,2
28484,2,3,100023,100023,100026,0,3,0
28485,2,3,100025,100026,100029,1,4,0
28486,4,1,100029,100029,100030,0,1,0
28487,3,1,100032,100032,100033,0,1,2
28488,6,1,100038,100038,100039,0,1,5
28489,5,2,100043,100043,100045,0,2,4
28490,6,3,100049,100049,100052,0,3,4
28491,1,3,100050,100052,100055,2,5,0
28492,4,3,100054,100055,100058,1,4,0
28493,6,3,100060,100060,100063,0,3,2
28494,6,3,100066,100066,100069,0,3,3
28495,5,1,100071,100071,100072,0,1,2
28496,1,2,100072,100072,100074,0,2,0
28497,5,3,100077,100077,100080,0,3,3
28498,1,1,100078,100080,100081,2,3,0
28499,1,3,100079,100081,100084,2,5,0
28500,3,1,100082,100084,100085,2,3,0
28501,2,2,100084,100085,100087,1,3,0
28502,2,2,100086,100087,100089,1,3,0
28503,3,2,100089,100089,100091,0,2,0
28504,6,1,100095,100095,100096,0,1,4
28505,6,1,100101,100101,100102,0,1,5
28506,3,2,100104,100104,100106,0,2,2
28507,1,2,100105,100106,100108,1,3,0
28508,5,3,100110,100110,100113,0,3,2
28509,2,2,100112,100113,100115,1,3,0
28510,4,3,100116,100116,100119,0,3,1
28511,4,3,100120,100120,100123,0,3,1
28512,6,1,100126,100126,100127,0,1,3
28513,2,1,100128,100128,100129,0,1,1
28514,2,2,100130,100130,100132,0,2,1
28515,5,1,100135,100135,100136,0,1,3
28516,1,2,100136,100136,100138,0,2,0
28517,4,1,100140,100140,100141,0,1,2
28518,6,1,100146,100146,100147,0,1,5
28519,5,1,100151,100151,100152,0,1,4
28520,4,3,100155,100155,100158,0,3,3
28521,3,1,100158,100158,100159,0,1,0
28522,6,1,100164,100164,100165,0,1,5
28523,6,2,100170,100170,100172,0,2,5
28524,4,3,100174,100174,100177,0,3,2
28525,2,2,100176,100177,100179,1,3,0
28526,5,1,100181,100181,100182,0,1,2
28527,2,3,100183,100183,100186,0,3,1
28528,5,1,100188,100188,100189,0,1,2
28529,5,1,100193,100193,100194,0,1,4
28530,6,1,100199,100199,100200,0,1,5
28531,4,2,100203,100203,100205,0,2,3
28532,2,2,100205,100205,100207,0,2,0
28533,6,2,100211,100211,100213,0,2,4
28534,3,3,100214,100214,100217,0,3,1
28535,1,2,100215,100217,100219,2,4,0
28536,5,3,100220,100220,100223,0,3,1
28537,1,3,100221,100223,100226,2,5,0
28538,2,3,100223,100226,100229,3,6,0
28539,1,3,100224,100229,100232,5,8,0
28540,2,2,100226,100232,100234,6,8,0
28541,3,3,100229,100234,100237,5,8,0
28542,6,2,100235,100237,100239,2,4,0
28543,3,3,100238,100239,100242,1,4,0
28544,2,2,100240,100242,100244,2,4,0
28545,6,3,100246,100246,100249,0,3,2
28546,4,3,100250,100250,100253,0,3,1
28547,1,1,100251,100253,100254,2,3,0
28548,4,3,100255,100255,100258,0,3,1
28549,3,3,100258,100258,100261,0,3,0
28550,4,1,100262,100262,100263,0,1,1
28551,6,2,100268,100268,100270,0,2,5
28552,3,3,100271,100271,100274,0,3,1
28553,6,1,100277,100277,100278,0,1,3
28554,6,2,100283,100283,100285,0,2,5
28555,6,3,100289,100289,100292,0,3,4
28556,2,2,100291,100292,100294,1,3,0
28557,4,3,100295,100295,100298,0,3,1
28558,1,1,100296,100298,100299,2,3,0
28559,3,3,100299,100299,100302,0,3,0
28560,6,1,100305,100305,100306,0,1,3
28561,2,3,100307,100307,100310,0,3,1
28562,1,1,100308,100310,100311,2,3,0
28563,5,1,100313,100313,100314,0,1,2
28564,3,2,100316,100316,100318,0,2,2
28565,2,2,100318,100318,100320,0,2,0
28566,1,1,100319,100320,100321,1,2,0
28567,4,2,100323,100323,100325,0,2,2
28568,2,3,100325,100325,100328,0,3,0
28569,1,3,100326,100328,100331,2,5,0
28570,2,3,100328,100331,100334,3,6,0
28571,1,1,100329,100334,100335,5,6,0
28572,6,2,100335,100335,100337,0,2,0
28573,1,3,100336,100337,100340,1,4,0
28574,6,2,100342,100342,100344,0,2,2
28575,1,3,100343,100344,100347,1,4,0
28576,6,1,100349,100349,100350,0,1,2
28577,6,3,100355,100355,100358,0,3,5
28578,1,2,100356,100358,100360,2,4,0
28579,5,3,100361,100361,100364,0,3,1
28580,5,2,100366,100366,100368,0,2,2
28581,2,1,100368,100368,100369,0,1,0
28582,5,2,100373,100373,100375,0,2,4
28583,3,2,100376,100376,100378,0,2,1
28584,6,3,100382,100382,100385,0,3,4
28585,2,1,100384,100385,100386,1,2,0
28586,3,1,100387,100387,100388,0,1,1
28587,4,3,100391,100391,100394,0,3,3
28588,2,2,100393,100394,100396,1,3,0
28589,6,3,100399,100399,100402,0,3,3
28590,5,1,100404,100404,100405,0,1,2
28591,6,1,100410,100410,100411,0,1,5
28592,4,3,100414,100414,100417,0,3,3
28593,4,3,100418,100418,100421,0,3,1
28594,3,3,100421,100421,100424,0,3,0
28595,2,2,100423,100424,100426,1,3,0
28596,5,1,100428,100428,100429,0,1,2
28597,2,2,100430,100430,100432,0,2,1
28598,4,1,100434,100434,100435,0,1,2
28599,2,1,100436,100436,100437,0,1,1
28600,5,1,100441,100441,100442,0,1,4
28601,1,1,100442,100442,100443,0,1,0
28602,3,3,100445,100445,100448,0,3,2
28603,2,2,100447,100448,100450,1,3,0
28604,5,1,100452,100452,100453,0,1,2
28605,2,1,100454,100454,100455,0,1,1
28606,6,2,100460,100460,100462,0,2,5
28607,5,1,100465,100465,100466,0,1,3
28608,1,3,100466,100466,100469,0,3,0
28609,3,3,100469,100469,100472,0,3,0
28610,5,2,100474,100474,100476,0,2,2
28611,2,2,100476,100476,100478,0,2,0
28612,1,1,100477,100478,100479,1,2,0
28613,4,1,100481,100481,100482,0,1,2
28614,3,3,100484,100484,100487,0,3,2
28615,4,1,100488,100488,100489,0,1,1
28616,3,3,100491,100491,100494,0,3,2
28617,5,3,100496,100496,100499,0,3,2
28618,1,3,100497,100499,100502,2,5,0
28619,5,3,100502,100502,100505,0,3,0
28620,4,1,100506,100506,100507,0,1,1
28621,3,2,100509,100509,100511,0,2,2
28622,2,1,100511,100511,100512,0,1,0
28623,2,3,100513,100513,100516,0,3,1
28624,5,1,100518,100518,100519,0,1,2
28625,4,2,100522,100522,100524,0,2,3
28626,4,1,100526,100526,100527,0,1,2
28627,4,2,100530,100530,100532,0,2,3
28628,1,2,100531,100532,100534,1,3,0
28629,4,3,100535,100535,100538,0,3,1
28630,3,2,100538,100538,100540,0,2,0
28631,1,3,100539,100540,100543,1,4,0
28632,4,1,100543,100543,100544,0,1,0
28633,2,2,100545,100545,100547,0,2,1
28634,6,3,100551,100551,100554,0,3,4
28635,6,3,100557,100557,100560,0,3,3
28636,2,2,100559,100560,100562,1,3,0
28637,4,2,100563,100563,100565,0,2,1
28638,3,2,100566,100566,100568,0,2,1
28639,1,2,100567,100568,100570,1,3,0
28640,2,2,100569,100570,100572,1,3,0
28641,2,3,100571,100572,100575,1,4,0
28642,2,2,100573,100575,100577,2,4,0
28643,2,2,100575,100577,100579,2,4,0
28644,2,2,100577,100579,100581,2,4,0
28645,3,2,100580,100581,100583,1,3,0
28646,5,2,100585,100585,100587,0,2,2
28647,4,3,100589,100589,100592,0,3,2
28648,4,3,100593,100593,100596,0,3,1
28649,6,2,100599,100599,100601,0,2,3
28650,4,3,100603,100603,100606,0,3,2
28651,2,2,100605,100606,100608,1,3,0
28652,5,3,100610,100610,100613,0,3,2
28653,2,2,100612,100613,100615,1,3,0
28654,1,1,100613,100615,100616,2,3,0
28655,6,3,100619,100619,100622,0,3,3
28656,5,3,100624,100624,100627,0,3,2
28657,1,3,100625,100627,100630,2,5,0
28658,2,3,100627,100630,100633,3,6,0
28659,3,2,100630,100633,100635,3,5,0
28660,2,3,100632,100635,100638,3,6,0
28661,2,3,100634,100638,100641,4,7,0
28662,4,2,100638,100641,100643,3,5,0
28663,2,2,100640,100643,100645,3,5,0
28664,4,2,100644,100645,100647,1,3,0
28665,1,1,100645,100647,100648,2,3,0
28666,2,1,100647,100648,100649,1,2,0
28667,2,3,100649,100649,100652,0,3,0
28668,6,1,100655,100655,100656,0,1,3
28669,5,2,100660,100660,100662,0,2,4
28670,3,1,100663,100663,100664,0,1,1
28671,5,3,100668,100668,100671,0,3,4
28672,1,3,100669,100671,100674,2,5,0
28673,6,2,100675,100675,100677,0,2,1
28674,1,1,100676,100677,100678,1,2,0
28675,6,2,100682,100682,100684,0,2,4
28676,2,1,100684,100684,100685,0,1,0
28677,3,2,100687,100687,100689,0,2,2
28678,2,1,100689,100689,100690,0,1,0
28679,4,3,100693,100693,100696,0,3,3
28680,6,1,100699,100699,100700,0,1,3
28681,5,3,100704,100704,100707,0,3,4
28682,3,1,100707,100707,100708,0,1,0
28683,1,2,100708,100708,100710,0,2,0
28684,4,3,100712,100712,100715,0,3,2
28685,5,3,100717,100717,100720,0,3,2
28686,2,3,100719,100720,100723,1,4,0
28687,3,2,100722,100723,100725,1,3,0
28688,2,2,100724,100725,100727,1,3,0
28689,1,3,100725,100727,100730,2,5,0
28690,2,3,100727,100730,100733,3,6,0
28691,3,1,100730,100733,100734,3,4,0
28692,4,1,100734,100734,100735,0,1,0
28693,2,2,100736,100736,100738,0,2,1
28694,6,2,100742,100742,100744,0,2,4
28695,5,2,100747,100747,100749,0,2,3
28696,6,3,100753,100753,100756,0,3,4
28697,2,1,100755,100756,100757,1,2,0
28698,4,2,100759,100759,100761,0,2,2
28699,4,3,100763,100763,100766,0,3,2
28700,2,1,100765,100766,100767,1,2,0
28701,4,3,100769,100769,100772,0,3,2
28702,3,2,100772,100772,100774,0,2,0
28703,2,3,100774,100774,100777,0,3,0
28704,2,2,100776,100777,100779,1,3,0
28705,1,2,100777,100779,100781,2,4,0
28706,2,2,100779,100781,100783,2,4,0
28707,6,2,100785,100785,100787,0,2,2
28708,3,1,100788,100788,100789,0,1,1
28709,2,2,100790,100790,100792,0,2,1
28710,5,3,100795,100795,100798,0,3,3
28711,2,3,100797,100798,100801,1,4,0
28712,6,3,100803,100803,100806,0,3,2
28713,3,3,100806,100806,100809,0,3,0
28714,5,1,100811,100811,100812,0,1,2
28715,1,2,100812,100812,100814,0,2,0
28716,3,3,100815,100815,100818,0,3,1
28717,5,3,100820,100820,100823,0,3,2
28718,4,1,100824,100824,100825,0,1,1
28719,3,1,100827,100827,100828,0,1,2
28720,6,1,100833,100833,100834,0,1,5
28721,6,3,100839,100839,100842,0,3,5
28722,2,2,100841,100842,100844,1,3,0
28723,6,3,100847,100847,100850,0,3,3
28724,6,3,100853,100853,100856,0,3,3
28725,5,1,100858,100858,100859,0,1,2
28726,2,3,100860,100860,100863,0,3,1
28727,2,3,100862,100863,100866,1,4,0
28728,4,1,100866,100866,100867,0,1,0
28729,1,3,100867,100867,100870,0,3,0
28730,5,1,100872,100872,100873,0,1,2
28731,1,3,100873,100873,100876,0,3,0
28732,6,2,100879,100879,100881,0,2,3
28733,3,3,100882,100882,100885,0,3,1
28734,6,2,100888,100888,100890,0,2,3
28735,4,2,100892,100892,100894,0,2,2
28736,5,1,100897,100897,100898,0,1,3
28737,6,1,100903,100903,100904,0,1,5
28738,2,3,100905,100905,100908,0,3,1
28739,4,1,100909,100909,100910,0,1,1
28740,3,2,100912,100912,100914,0,2,2
28741,3,3,100915,100915,100918,0,3,1
28742,3,2,100918,100918,100920,0,2,0
28743,5,3,100923,100923,100926,0,3,3
28744,4,1,100927,100927,100928,0,1,1
28745,4,1,100931,100931,100932,0,1,3
28746,1,3,100932,100932,100935,0,3,0
28747,5,3,100937,100937,100940,0,3,2
28748,6,2,100943,100943,100945,0,2,3
28749,4,3,100947,100947,100950,0,3,2
28750,3,1,100950,100950,100951,0,1,0
28751,4,2,100954,100954,100956,0,2,3
28752,3,2,100957,100957,100959,0,2,1
28753,5,3,100962,100962,100965,0,3,3
28754,5,1,100967,100967,100968,0,1,2
28755,1,1,100968,100968,100969,0,1,0
28756,1,3,100969,100969,100972,0,3,0
28757,6,3,100975,100975,100978,0,3,3
28758,6,2,100981,100981,100983,0,2,3
28759,4,1,100985,100985,100986,0,1,2
28760,5,2,100990,100990,100992,0,2,4
28761,3,1,100993,100993,100994,0,1,1
28762,2,2,100995,100995,100997,0,2,1
28763,6,1,101001,101001,101002,0,1,4
28764,2,3,101003,101003,101006,0,3,1
28765,3,1,101006,101006,101007,0,1,0
28766,6,1,101012,101012,101013,0,1,5
28767,2,3,101014,101014,101017,0,3,1
28768,4,1,101018,101018,101019,0,1,1
28769,3,1,101021,101021,101022,0,1,2
28770,1,2,101022,101022,101024,0,2,0
28771,4,2,101026,101026,101028,0,2,2
28772,2,2,101028,101028,101030,0,2,0
28773,6,1,101034,101034,101035,0,1,4
28774,5,3,101039,101039,101042,0,3,4
28775,6,1,101045,101045,101046,0,1,3
28776,6,1,101051,101051,101052,0,1,5
28777,4,2,101055,101055,101057,0,2,3
28778,1,2,101056,101057,101059,1,3,0
28779,5,2,101061,101061,101063,0,2,2
28780,4,1,101065,101065,101066,0,1,2
28781,4,3,101069,101069,101072,0,3,3
28782,6,2,101075,101075,101077,0,2,3
28783,6,1,101081,101081,101082,0,1,4
28784,1,2,101082,101082,101084,0,2,0
28785,2,3,101084,101084,101087,0,3,0
28786,2,2,101086,101087,101089,1,3,0
28787,6,2,101092,101092,101094,0,2,3
28788,1,2,101093,101094,101096,1,3,0
28789,6,2,101099,101099,101101,0,2,3
28790,6,1,101105,101105,101106,0,1,4
28791,5,3,101110,101110,101113,0,3,4
28792,3,3,101113,101113,101116,0,3,0
28793,1,2,101114,101116,101118,2,4,0
28794,1,1,101115,101118,101119,3,4,0
28795,2,1,101117,101119,101120,2,3,0
28796,6,1,101123,101123,101124,0,1,3
28797,4,1,101127,101127,101128,0,1,3
28798,6,2,101133,101133,101135,0,2,5
28799,2,1,101135,101135,101136,0,1,0
28800,5,2,101140,101140,101142,0,2,4
28801,6,1,101146,101146,101147,0,1,4
28802,6,2,101152,101152,101154,0,2,5
28803,5,3,101157,101157,101160,0,3,3
28804,5,2,101162,101162,101164,0,2,2
28805,2,1,101164,101164,101165,0,1,0
28806,5,3,101169,101169,101172,0,3,4
28807,1,2,101170,101172,101174,2,4,0
28808,6,2,101176,101176,101178,0,2,2
28809,4,2,101180,101180,101182,0,2,2
28810,6,1,101186,101186,101187,0,1,4
28811,2,3,101188,101188,101191,0,3,1
28812,4,3,101192,101192,101195,0,3,1
28813,3,2,101195,101195,101197,0,2,0
28814,1,3,101196,101197,101200,1,4,0
28815,2,2,101198,101200,101202,2,4,0
28816,3,2,101201,101202,101204,1,3,0
28817,6,2,101207,101207,101209,0,2,3
28818,4,2,101211,101211,101213,0,2,2
28819,2,3,101213,101213,101216,0,3,0
28820,1,1,101214,101216,101217,2,3,0
28821,4,2,101218,101218,101220,0,2,1
28822,1,1,101219,101220,101221,1,2,0
28823,3,1,101222,101222,101223,0,1,1
28824,4,1,101226,101226,101227,0,1,3
28825,2,3,101228,101228,101231,0,3,1
28826,1,1,101229,101231,101232,2,3,0
28827,1,3,101230,101232,101235,2,5,0
28828,1,2,101231,101235,101237,4,6,0
28829,3,3,101234,101237,101240,3,6,0
28830,3,1,101237,101240,101241,3,4,0
28831,4,1,101241,101241,101242,0,1,0
28832,4,3,101245,101245,101248,0,3,3
28833,6,2,101251,101251,101253,0,2,3
28834,5,2,101256,101256,101258,0,2,3
28835,4,2,101260,101260,101262,0,2,2
28836,3,1,101263,101263,101264,0,1,1
28837,6,2,101269,101269,101271,0,2,5
28838,2,2,101271,101271,101273,0,2,0
28839,6,2,101277,101277,101279,0,2,4
28840,5,2,101282,101282,101284,0,2,3
28841,4,3,101286,101286,101289,0,3,2
28842,4,3,101290,101290,101293,0,3,1
28843,3,3,101293,101293,101296,0,3,0
28844,2,3,101295,101296,101299,1,4,0
28845,4,3,101299,101299,101302,0,3,0
28846,1,3,101300,101302,101305,2,5,0
28847,2,2,101302,101305,101307,3,5,0
28848,5,2,101307,101307,101309,0,2,0
28849,2,3,101309,101309,101312,0,3,0
28850,5,1,101314,101314,101315,0,1,2
28851,6,3,101320,101320,101323,0,3,5
28852,2,1,101322,101323,101324,1,2,0
28853,3,3,101325,101325,101328,0,3,1
28854,1,3,101326,101328,101331,2,5,0
28855,1,3,101327,101331,101334,4,7,0
28856,3,1,101330,101334,101335,4,5,0
28857,5,1,101335,101335,101336,0,1,0
28858,1,1,101336,101336,101337,0,1,0
28859,4,2,101340,101340,101342,0,2,3
28860,2,2,101342,101342,101344,0,2,0
28861,4,1,101346,101346,101347,0,1,2
28862,6,3,101352,101352,101355,0,3,5
28863,5,2,101357,101357,101359,0,2,2
28864,1,2,101358,101359,101361,1,3,0
28865,5,2,101363,101363,101365,0,2,2
28866,6,2,101369,101369,101371,0,2,4
28867,5,3,101374,101374,101377,0,3,3
28868,2,1,101376,101377,101378,1,2,0
28869,3,3,101379,101379,101382,0,3,1
28870,1,2,101380,101382,101384,2,4,0
28871,1,2,101381,101384,101386,3,5,0
28872,3,1,101384,101386,101387,2,3,0
28873,4,2,101388,101388,101390,0,2,1
28874,1,1,101389,101390,101391,1,2,0
28875,2,1,101391,101391,101392,0,1,0
28876,6,3,101397,101397,101400,0,3,5
28877,6,2,101403,101403,101405,0,2,3
28878,6,1,101409,101409,101410,0,1,4
28879,2,2,101411,101411,101413,0,2,1
28880,4,2,101415,101415,101417,0,2,2
28881,5,1,101420,101420,101421,0,1,3
28882,1,2,101421,101421,101423,0,2,0
28883,2,3,101423,101423,101426,0,3,0
28884,2,1,101425,101426,101427,1,2,0
28885,1,2,101426,101427,101429,1,3,0
28886,2,2,101428,101429,101431,1,3,0
28887,3,3,101431,101431,101434,0,3,0
28888,2,3,101433,101434,101437,1,4,0
28889,2,2,101435,101437,101439,2,4,0
28890,6,1,101441,101441,101442,0,1,2
28891,1,3,101442,101442,101445,0,3,0
28892,4,1,101446,101446,101447,0,1,1
28893,2,1,101448,101448,101449,0,1,1
28894,6,1,101454,101454,101455,0,1,5
28895,3,1,101457,101457,101458,0,1,2
28896,3,1,101460,101460,101461,0,1,2
28897,1,1,101461,101461,101462,0,1,0
28898,1,2,101462,101462,101464,0,2,0
28899,1,3,101463,101464,101467,1,4,0
28900,6,3,101469,101469,101472,0,3,2
28901,1,2,101470,101472,101474,2,4,0
28902,2,2,101472,101474,101476,2,4,0
28903,6,2,101478,101478,101480,0,2,2
28904,4,3,101482,101482,101485,0,3,2
28905,4,2,101486,101486,101488,0,2,1
28906,6,1,101492,101492,101493,0,1,4
28907,6,1,101498,101498,101499,0,1,5
28908,6,2,101504,101504,101506,0,2,5
28909,2,3,101506,101506,101509,0,3,0
28910,1,3,101507,101509,101512,2,5,0
28911,3,2,101510,101512,101514,2,4,0
28912,1,2,101511,101514,101516,3,5,0
28913,5,1,101516,101516,101517,0,1,0
28914,4,2,101520,101520,101522,0,2,3
28915,5,2,101525,101525,101527,0,2,3
28916,3,1,101528,101528,101529,0,1,1
28917,1,3,101529,101529,101532,0,3,0
28918,5,2,101534,101534,101536,0,2,2
28919,4,2,101538,101538,101540,0,2,2
28920,1,2,101539,101540,101542,1,3,0
28921,5,1,101544,101544,101545,0,1,2
28922,6,2,101550,101550,101552,0,2,5
28923,1,3,101551,101552,101555,1,4,0
28924,2,2,101553,101555,101557,2,4,0
28925,4,3,101557,101557,101560,0,3,0
28926,4,1,101561,101561,101562,0,1,1
28927,5,2,101566,101566,101568,0,2,4
28928,5,3,101571,101571,101574,0,3,3
28929,6,2,101577,101577,101579,0,2,3
28930,4,2,101581,101581,101583,0,2,2
28931,4,3,101585,101585,101588,0,3,2
28932,4,1,101589,101589,101590,0,1,1
28933,6,3,101595,101595,101598,0,3,5
28934,3,1,101598,101598,101599,0,1,0
28935,3,3,101601,101601,101604,0,3,2
28936,5,1,101606,101606,101607,0,1,2
28937,3,3,101609,101609,101612,0,3,2
28938,3,1,101612,101612,101613,0,1,0
28939,5,2,101617,101617,101619,0,2,4
28940,5,3,101622,101622,101625,0,3,3
28941,1,1,101623,101625,101626,2,3,0
28942,5,3,101628,101628,101631,0,3,2
28943,3,3,101631,101631,101634,0,3,0
28944,6,1,101637,101637,101638,0,1,3
28945,2,2,101639,101639,101641,0,2,1
28946,4,1,101643,101643,101644,0,1,2
28947,1,3,101644,101644,101647,0,3,0
28948,3,3,101647,101647,101650,0,3,0
28949,1,2,101648,101650,101652,2,4,0
28950,3,3,101651,101652,101655,1,4,0
28951,5,3,101656,101656,101659,0,3,1
28952,4,2,101660,101660,101662,0,2,1
28953,2,1,101662,101662,101663,0,1,0
28954,1,3,101663,101663,101666,0,3,0
28955,6,1,101669,101669,101670,0,1,3
28956,5,3,101674,101674,101677,0,3,4
28957,4,3,101678,101678,101681,0,3,1
28958,3,2,101681,101681,101683,0,2,0
28959,4,3,101685,101685,101688,0,3,2
28960,1,1,101686,101688,101689,2,3,0
28961,3,2,101689,101689,101691,0,2,0
28962,5,3,101694,101694,101697,0,3,3
28963,5,2,101699,101699,101701,0,2,2
28964,3,3,101702,101702,101705,0,3,1
28965,1,2,101703,101705,101707,2,4,0
28966,5,2,101708,101708,101710,0,2,1
28967,4,2,101712,101712,101714,0,2,2
28968,3,2,101715,101715,101717,0,2,1
28969,1,1,101716,101717,101718,1,2,0
28970,5,3,101721,101721,101724,0,3,3
28971,4,2,101725,101725,101727,0,2,1
28972,4,2,101729,101729,101731,0,2,2
28973,4,3,101733,101733,101736,0,3,2
28974,2,2,101735,101736,101738,1,3,0
28975,5,2,101740,101740,101742,0,2,2
28976,3,2,101743,101743,101745,0,2,1
28977,6,2,101749,101749,101751,0,2,4
28978,1,3,101750,101751,101754,1,4,0
28979,5,3,101755,101755,101758,0,3,1
28980,3,3,101758,101758,101761,0,3,0
28981,5,1,101763,101763,101764,0,1,2
28982,3,3,101766,101766,101769,0,3,2
28983,2,1,101768,101769,101770,1,2,0
28984,4,1,101772,101772,101773,0,1,2
28985,3,2,101775,101775,101777,0,2,2
28986,3,1,101778,101778,101779,0,1,1
28987,5,2,101783,101783,101785,0,2,4
28988,4,3,101787,101787,101790,0,3,2
28989,6,3,101793,101793,101796,0,3,3
28990,3,2,101796,101796,101798,0,2,0
28991,4,3,101800,101800,101803,0,3,2
28992,1,3,101801,101803,101806,2,5,0
28993,3,3,101804,101806,101809,2,5,0
28994,5,1,101809,101809,101810,0,1,0
28995,4,2,101813,101813,101815,0,2,3
28996,3,2,101816,101816,101818,0,2,1
28997,4,2,101820,101820,101822,0,2,2
28998,2,1,101822,101822,101823,0,1,0
28999,3,2,101825,101825,101827,0,2,2
29000,4,1,101829,101829,101830,0,1,2
29001,1,3,101830,101830,101833,0,3,0
29002,2,3,101832,101833,101836,1,4,0
29003,2,1,101834,101836,101837,2,3,0
29004,3,1,101837,101837,101838,0,1,0
29005,5,1,101842,101842,101843,0,1,4
29006,5,1,101847,101847,101848,0,1,4
29007,3,1,101850,101850,101851,0,1,2
29008,6,3,101856,101856,101859,0,3,5
29009,6,2,101862,101862,101864,0,2,3
29010,6,3,101868,101868,101871,0,3,4
29011,3,2,101871,101871,101873,0,2,0
29012,2,2,101873,101873,101875,0,2,0
29013,1,1,101874,101875,101876,1,2,0
29014,6,1,101880,101880,101881,0,1,4
29015,4,3,101884,101884,101887,0,3,3
29016,2,3,101886,101887,101890,1,4,0
29017,5,3,101891,101891,101894,0,3,1
29018,5,2,101896,101896,101898,0,2,2
29019,3,3,101899,101899,101902,0,3,1
29020,5,3,101904,101904,101907,0,3,2
29021,6,3,101910,101910,101913,0,3,3
29022,2,3,101912,101913,101916,1,4,0
29023,3,3,101915,101916,101919,1,4,0
29024,4,2,101919,101919,101921,0,2,0
29025,5,2,101924,101924,101926,0,2,3
29026,1,1,101925,101926,101927,1,2,0
29027,3,1,101928,101928,101929,0,1,1
29028,3,3,101931,101931,101934,0,3,2
29029,5,2,101936,101936,101938,0,2,2
29030,4,2,101940,101940,101942,0,2,2
29031,2,2,101942,101942,101944,0,2,0
29032,3,3,101945,101945,101948,0,3,1
29033,6,1,101951,101951,101952,0,1,3
29034,3,1,101954,101954,101955,0,1,2
29035,1,2,101955,101955,101957,0,2,0
29036,2,1,101957,101957,101958,0,1,0
29037,5,2,101962,101962,101964,0,2,4
29038,6,1,101968,101968,101969,0,1,4
29039,3,2,101971,101971,101973,0,2,2
29040,6,3,101977,101977,101980,0,3,4
29041,6,3,101983,101983,101986,0,3,3
29042,2,3,101985,101986,101989,1,4,0
29043,3,1,101988,101989,101990,1,2,0
29044,6,1,101994,101994,101995,0,1,4
29045,5,1,101999,101999,102000,0,1,4
29046,1,1,102000,102000,102001,0,1,0
29047,3,3,102003,102003,102006,0,3,2
29048,3,1,102006,102006,102007,0,1,0
29049,4,3,102010,102010,102013,0,3,3
29050,4,3,102014,102014,102017,0,3,1
29051,6,2,102020,102020,102022,0,2,3
29052,5,1,102025,102025,102026,0,1,3
29053,6,2,102031,102031,102033,0,2,5
29054,3,3,102034,102034,102037,0,3,1
29055,3,2,102037,102037,102039,0,2,0
29056,2,3,102039,102039,102042,0,3,0
29057,2,3,102041,102042,102045,1,4,0
29058,6,1,102047,102047,102048,0,1,2
29059,1,2,102048,102048,102050,0,2,0
29060,3,1,102051,102051,102052,0,1,1
29061,6,2,102057,102057,102059,0,2,5
29062,6,3,102063,102063,102066,0,3,4
29063,5,2,102068,102068,102070,0,2,2
29064,4,2,102072,102072,102074,0,2,2
29065,1,3,102073,102074,102077,1,4,0
29066,2,3,102075,102077,102080,2,5,0
29067,1,1,102076,102080,102081,4,5,0
29068,6,1,102082,102082,102083,0,1,1
29069,4,3,102086,102086,102089,0,3,3
29070,1,3,102087,102089,102092,2,5,0
29071,6,3,102093,102093,102096,0,3,1
29072,1,3,102094,102096,102099,2,5,0
29073,3,3,102097,102099,102102,2,5,0
29074,1,1,102098,102102,102103,4,5,0
29075,5,1,102103,102103,102104,0,1,0
29076,3,2,102106,102106,102108,0,2,2
29077,4,3,102110,102110,102113,0,3,2
29078,5,2,102115,102115,102117,0,2,2
29079,5,2,102120,102120,102122,0,2,3
29080,2,1,102122,102122,102123,0,1,0
29081,6,2,102128,102128,102130,0,2,5
29082,1,1,102129,102130,102131,1,2,0
29083,2,2,102131,102131,102133,0,2,0
29084,6,1,102137,102137,102138,0,1,4
29085,1,2,102138,102138,102140,0,2,0
29086,1,2,102139,102140,102142,1,3,0
29087,2,2,102141,102142,102144,1,3,0
29088,6,3,102147,102147,102150,0,3,3
29089,4,3,102151,102151,102154,0,3,1
29090,3,1,102154,102154,102155,0,1,0
29091,2,1,102156,102156,102157,0,1,1
29092,4,3,102160,102160,102163,0,3,3
29093,2,2,102162,102163,102165,1,3,0
29094,1,2,102163,102165,102167,2,4,0
29095,2,1,102165,102167,102168,2,3,0
29096,3,2,102168,102168,102170,0,2,0
29097,1,1,102169,102170,102171,1,2,0
29098,1,1,102170,102171,102172,1,2,0
29099,6,1,102176,102176,102177,0,1,4
29100,2,1,102178,102178,102179,0,1,1
29101,5,2,102183,102183,102185,0,2,4
29102,1,3,102184,102185,102188,1,4,0
29103,2,3,102186,102188,102191,2,5,0
29104,3,1,102189,102191,102192,2,3,0
29105,6,1,102195,102195,102196,0,1,3
29106,5,3,102200,102200,102203,0,3,4
29107,4,3,102204,102204,102207,0,3,1
29108,6,1,102210,102210,102211,0,1,3
29109,2,1,102212,102212,102213,0,1,1
29110,2,2,102214,102214,102216,0,2,1
29111,2,2,102216,102216,102218,0,2,0
29112,4,3,102220,102220,102223,0,3,2
29113,4,1,102224,102224,102225,0,1,1
29114,4,2,102228,102228,102230,0,2,3
29115,3,1,102231,102231,102232,0,1,1
29116,6,1,102237,102237,102238,0,1,5
29117,2,2,102239,102239,102241,0,2,1
29118,2,1,102241,102241,102242,0,1,0
29119,1,1,102242,102242,102243,0,1,0
29120,1,2,102243,102243,102245,0,2,0
29121,2,1,102245,102245,102246,0,1,0
29122,1,1,102246,102246,102247,0,1,0
29123,3,3,102249,102249,102252,0,3,2
29124,6,3,102255,102255,102258,0,3,3
29125,5,1,102260,102260,102261,0,1,2
29126,1,3,102261,102261,102264,0,3,0
29127,2,2,102263,102264,102266,1,3,0
29128,2,2,102265,102266,102268,1,3,0
29129,4,1,102269,102269,102270,0,1,1
29130,5,2,102274,102274,102276,0,2,4
29131,2,1,102276,102276,102277,0,1,0
29132,6,1,102282,102282,102283,0,1,5
29133,2,2,102284,102284,102286,0,2,1
29134,5,3,102289,102289,102292,0,3,3
29135,3,3,102292,102292,102295,0,3,0
29136,1,3,102293,102295,102298,2,5,0
29137,5,1,102298,102298,102299,0,1,0
29138,6,1,102304,102304,102305,0,1,5
29139,2,2,102306,102306,102308,0,2,1
29140,6,1,102312,102312,102313,0,1,4
29141,1,3,102313,102313,102316,0,3,0
29142,5,3,102318,102318,102321,0,3,2
29143,5,1,102323,102323,102324,0,1,2
29144,5,1,102328,102328,102329,0,1,4
29145,5,1,102333,102333,102334,0,1,4
29146,5,3,102338,102338,102341,0,3,4
29147,4,3,102342,102342,102345,0,3,1
29148,6,1,102348,102348,102349,0,1,3
29149,4,1,102352,102352,102353,0,1,3
29150,6,1,102358,102358,102359,0,1,5
29151,2,2,102360,102360,102362,0,2,1
29152,5,3,102365,102365,102368,0,3,3
29153,1,1,102366,102368,102369,2,3,0
29154,5,2,102371,102371,102373,0,2,2
29155,2,1,102373,102373,102374,0,1,0
29156,1,2,102374,102374,102376,0,2,0
29157,6,3,102380,102380,102383,0,3,4
29158,4,1,102384,102384,102385,0,1,1
29159,4,1,102388,102388,102389,0,1,3
29160,3,2,102391,102391,102393,0,2,2
29161,4,2,102395,102395,102397,0,2,2
29162,2,2,102397,102397,102399,0,2,0
29163,6,2,102403,102403,102405,0,2,4
29164,5,2,102408,102408,102410,0,2,3
29165,2,1,102410,102410,102411,0,1,0
29166,6,3,102416,102416,102419,0,3,5
29167,2,3,102418,102419,102422,1,4,0
29168,3,1,102421,102422,102423,1,2,0
29169,2,1,102423,102423,102424,0,1,0
29170,1,2,102424,102424,102426,0,2,0
29171,4,1,102428,102428,102429,0,1,2
29172,1,3,102429,102429,102432,0,3,0
29173,6,2,102435,102435,102437,0,2,3
29174,6,1,102441,102441,102442,0,1,4
29175,4,3,102445,102445,102448,0,3,3
29176,5,2,102450,102450,102452,0,2,2
29177,1,1,102451,102452,102453,1,2,0
29178,5,3,102456,102456,102459,0,3,3
29179,2,1,102458,102459,102460,1,2,0
29180,2,2,102460,102460,102462,0,2,0
29181,2,2,102462,102462,102464,0,2,0
29182,3,1,102465,102465,102466,0,1,1
29183,1,1,102466,102466,102467,0,1,0
29184,3,1,102469,102469,102470,0,1,2
29185,3,3,102472,102472,102475,0,3,2
29186,6,3,102478,102478,102481,0,3,3
29187,2,1,102480,102481,102482,1,2,0
29188,5,3,102485,102485,102488,0,3,3
29189,6,3,102491,102491,102494,0,3,3
29190,1,1,102492,102494,102495,2,3,0
29191,1,1,102493,102495,102496,2,3,0
29192,2,2,102495,102496,102498,1,3,0
29193,6,2,102501,102501,102503,0,2,3
29194,5,1,102506,102506,102507,0,1,3
29195,6,1,102512,102512,102513,0,1,5
29196,2,1,102514,102514,102515,0,1,1
29197,4,1,102518,102518,102519,0,1,3
29198,6,1,102524,102524,102525,0,1,5
29199,6,3,102530,102530,102533,0,3,5
29200,3,2,102533,102533,102535,0,2,0
29201,4,3,102537,102537,102540,0,3,2
29202,4,1,102541,102541,102542,0,1,1
29203,4,1,102545,102545,102546,0,1,3
29204,3,3,102548,102548,102551,0,3,2
29205,2,1,102550,102551,102552,1,2,0
29206,5,1,102555,102555,102556,0,1,3
29207,1,1,102556,102556,102557,0,1,0
29208,1,3,102557,102557,102560,0,3,0
29209,5,3,102562,102562,102565,0,3,2
29210,3,1,102565,102565,102566,0,1,0
29211,4,1,102569,102569,102570,0,1,3
29212,3,2,102572,102572,102574,0,2,2
29213,4,3,102576,102576,102579,0,3,2
29214,3,1,102579,102579,102580,0,1,0
29215,1,2,102580,102580,102582,0,2,0
29216,6,3,102586,102586,102589,0,3,4
29217,3,2,102589,102589,102591,0,2,0
29218,1,1,102590,102591,102592,1,2,0
29219,3,3,102593,102593,102596,0,3,1
29220,4,2,102597,102597,102599,0,2,1
29221,6,3,102603,102603,102606,0,3,4
29222,6,2,102609,102609,102611,0,2,3
29223,1,3,102610,102611,102614,1,4,0
29224,3,1,102613,102614,102615,1,2,0
29225,2,1,102615,102615,102616,0,1,0
29226,5,3,102620,102620,102623,0,3,4
29227,4,1,102624,102624,102625,0,1,1
29228,5,3,102629,102629,102632,0,3,4
29229,5,2,102634,102634,102636,0,2,2
29230,3,2,102637,102637,102639,0,2,1
29231,4,3,102641,102641,102644,0,3,2
29232,2,1,102643,102644,102645,1,2,0
29233,2,1,102645,102645,102646,0,1,0
29234,4,2,102649,102649,102651,0,2,3
29235,4,2,102653,102653,102655,0,2,2
29236,1,3,102654,102655,102658,1,4,0
29237,2,2,102656,102658,102660,2,4,0
29238,1,2,102657,102660,102662,3,5,0
29239,1,3,102658,102662,102665,4,7,0
29240,1,3,102659,102665,102668,6,9,0
29241,6,1,102665,102668,102669,3,4,0
29242,6,2,102671,102671,102673,0,2,2
29243,2,3,102673,102673,102676,0,3,0
29244,1,1,102674,102676,102677,2,3,0
29245,5,2,102679,102679,102681,0,2,2
29246,5,1,102684,102684,102685,0,1,3
29247,1,3,102685,102685,102688,0,3,0
29248,3,3,102688,102688,102691,0,3,0
29249,6,1,102694,102694,102695,0,1,3
29250,6,3,102700,102700,102703,0,3,5
29251,6,3,102706,102706,102709,0,3,3
29252,2,2,102708,102709,102711,1,3,0
29253,2,2,102710,102711,102713,1,3,0
29254,6,2,102716,102716,102718,0,2,3
29255,2,3,102718,102718,102721,0,3,0
29256,2,1,102720,102721,102722,1,2,0
29257,5,1,102725,102725,102726,0,1,3
29258,4,3,102729,102729,102732,0,3,3
29259,3,1,102732,102732,102733,0,1,0
29260,1,2,102733,102733,102735,0,2,0
29261,3,2,102736,102736,102738,0,2,1
29262,2,2,102738,102738,102740,0,2,0
29263,6,1,102744,102744,102745,0,1,4
29264,1,3,102745,102745,102748,0,3,0
29265,2,2,102747,102748,102750,1,3,0
29266,4,3,102751,102751,102754,0,3,1
29267,1,2,102752,102754,102756,2,4,0
29268,2,3,102754,102756,102759,2,5,0
29269,5,1,102759,102759,102760,0,1,0
29270,5,2,102764,102764,102766,0,2,4
29271,1,1,102765,102766,102767,1,2,0
29272,5,3,102770,102770,102773,0,3,3
29273,4,1,102774,102774,102775,0,1,1
29274,3,1,102777,102777,102778,0,1,2
29275,6,3,102783,102783,102786,0,3,5
29276,1,3,102784,102786,102789,2,5,0
29277,6,2,102790,102790,102792,0,2,1
29278,4,1,102794,102794,102795,0,1,2
29279,4,1,102798,102798,102799,0,1,3
29280,1,3,102799,102799,102802,0,3,0
29281,2,2,102801,102802,102804,1,3,0
29282,1,2,102802,102804,102806,2,4,0
29283,5,3,102807,102807,102810,0,3,1
29284,3,2,102810,102810,102812,0,2,0
29285,5,2,102815,102815,102817,0,2,3
29286,3,1,102818,102818,102819,0,1,1
29287,4,2,102822,102822,102824,0,2,3
29288,5,2,102827,102827,102829,0,2,3
29289,3,2,102830,102830,102832,0,2,1
29290,6,2,102836,102836,102838,0,2,4
29291,3,3,102839,102839,102842,0,3,1
29292,6,1,102845,102845,102846,0,1,3
29293,4,1,102849,102849,102850,0,1,3
29294,1,3,102850,102850,102853,0,3,0
29295,1,3,102851,102853,102856,2,5,0
29296,2,1,102853,102856,102857,3,4,0
29297,1,1,102854,102857,102858,3,4,0
29298,1,3,102855,102858,102861,3,6,0
29299,1,3,102856,102861,102864,5,8,0
29300,4,2,102860,102864,102866,4,6,0
29301,3,1,102863,102866,102867,3,4,0
29302,5,3,102868,102868,102871,0,3,1
29303,6,3,102874,102874,102877,0,3,3
29304,3,2,102877,102877,102879,0,2,0
29305,1,1,102878,102879,102880,1,2,0
29306,5,3,102883,102883,102886,0,3,3
29307,4,1,102887,102887,102888,0,1,1
29308,6,2,102893,102893,102895,0,2,5
29309,4,2,102897,102897,102899,0,2,2
29310,1,3,102898,102899,102902,1,4,0
29311,2,1,102900,102902,102903,2,3,0
29312,2,1,102902,102903,102904,1,2,0
29313,6,2,102908,102908,102910,0,2,4
29314,3,1,102911,102911,102912,0,1,1
29315,1,1,102912,102912,102913,0,1,0
29316,6,3,102918,102918,102921,0,3,5
29317,3,3,102921,102921,102924,0,3,0
29318,1,1,102922,102924,102925,2,3,0
29319,4,2,102926,102926,102928,0,2,1
29320,1,1,102927,102928,102929,1,2,0
29321,1,2,102928,102929,102931,1,3,0
29322,1,1,102929,102931,102932,2,3,0
29323,6,1,102935,102935,102936,0,1,3
29324,2,3,102937,102937,102940,0,3,1
29325,6,1,102943,102943,102944,0,1,3
29326,2,3,102945,102945,102948,0,3,1
29327,5,3,102950,102950,102953,0,3,2
29328,6,3,102956,102956,102959,0,3,3
29329,6,3,102962,102962,102965,0,3,3
29330,6,3,102968,102968,102971,0,3,3
29331,6,1,102974,102974,102975,0,1,3
29332,5,2,102979,102979,102981,0,2,4
29333,4,2,102983,102983,102985,0,2,2
29334,6,1,102989,102989,102990,0,1,4
29335,4,1,102993,102993,102994,0,1,3
29336,4,2,102997,102997,102999,0,2,3
29337,6,1,103003,103003,103004,0,1,4
29338,2,2,103005,103005,103007,0,2,1
29339,4,3,103009,103009,103012,0,3,2
29340,2,1,103011,103012,103013,1,2,0
29341,1,3,103012,103013,103016,1,4,0
29342,1,1,103013,103016,103017,3,4,0
29343,3,2,103016,103017,103019,1,3,0
29344,5,1,103021,103021,103022,0,1,2
29345,3,2,103024,103024,103026,0,2,2
29346,1,1,103025,103026,103027,1,2,0
29347,2,2,103027,103027,103029,0,2,0
29348,2,2,103029,103029,103031,0,2,0
29349,5,3,103034,103034,103037,0,3,3
29350,3,2,103037,103037,103039,0,2,0
29351,6,2,103043,103043,103045,0,2,4
29352,6,3,103049,103049,103052,0,3,4
29353,3,1,103052,103052,103053,0,1,0
29354,2,3,103054,103054,103057,0,3,1
29355,4,3,103058,103058,103061,0,3,1
29356,5,2,103063,103063,103065,0,2,2
29357,3,3,103066,103066,103069,0,3,1
29358,5,2,103071,103071,103073,0,2,2
29359,2,3,103073,103073,103076,0,3,0
29360,6,2,103079,103079,103081,0,2,3
29361,6,3,103085,103085,103088,0,3,4
29362,3,2,103088,103088,103090,0,2,0
29363,4,2,103092,103092,103094,0,2,2
29364,4,1,103096,103096,103097,0,1,2
29365,4,3,103100,103100,103103,0,3,3
29366,3,3,103103,103103,103106,0,3,0
29367,6,3,103109,103109,103112,0,3,3
29368,6,1,103115,103115,103116,0,1,3
29369,5,1,103120,103120,103121,0,1,4
29370,1,3,103121,103121,103124,0,3,0
29371,2,3,103123,103124,103127,1,4,0
29372,1,2,103124,103127,103129,3,5,0
29373,3,1,103127,103129,103130,2,3,0
29374,4,3,103131,103131,103134,0,3,1
29375,6,2,103137,103137,103139,0,2,3
29376,1,2,103138,103139,103141,1,3,0
29377,4,2,103142,103142,103144,0,2,1
29378,6,1,103148,103148,103149,0,1,4
29379,2,2,103150,103150,103152,0,2,1
29380,3,1,103153,103153,103154,0,1,1
29381,1,2,103154,103154,103156,0,2,0
29382,4,1,103158,103158,103159,0,1,2
29383,6,2,103164,103164,103166,0,2,5
29384,6,1,103170,103170,103171,0,1,4
29385,6,1,103176,103176,103177,0,1,5
29386,4,3,103180,103180,103183,0,3,3
29387,6,3,103186,103186,103189,0,3,3
29388,6,2,103192,103192,103194,0,2,3
29389,5,1,103197,103197,103198,0,1,3
29390,3,2,103200,103200,103202,0,2,2
29391,3,2,103203,103203,103205,0,2,1
29392,2,3,103205,103205,103208,0,3,0
29393,1,1,103206,103208,103209,2,3,0
29394,6,2,103212,103212,103214,0,2,3
29395,2,1,103214,103214,103215,0,1,0
29396,6,2,103220,103220,103222,0,2,5
29397,1,2,103221,103222,103224,1,3,0
29398,4,3,103225,103225,103228,0,3,1
29399,2,1,103227,103228,103229,1,2,0
29400,6,3,103233,103233,103236,0,3,4
29401,1,3,103234,103236,103239,2,5,0
29402,4,2,103238,103239,103241,1,3,0
29403,5,3,103243,103243,103246,0,3,2
29404,4,3,103247,103247,103250,0,3,1
29405,5,2,103252,103252,103254,0,2,2
29406,4,3,103256,103256,103259,0,3,2
29407,2,3,103258,103259,103262,1,4,0
29408,4,1,103262,103262,103263,0,1,0
29409,5,3,103267,103267,103270,0,3,4
29410,3,1,103270,103270,103271,0,1,0
29411,1,1,103271,103271,103272,0,1,0
29412,5,2,103276,103276,103278,0,2,4
29413,2,1,103278,103278,103279,0,1,0
29414,6,1,103284,103284,103285,0,1,5
29415,5,2,103289,103289,103291,0,2,4
29416,3,1,103292,103292,103293,0,1,1
29417,1,2,103293,103293,103295,0,2,0
29418,3,2,103296,103296,103298,0,2,1
29419,5,1,103301,103301,103302,0,1,3
29420,4,3,103305,103305,103308,0,3,3
29421,2,1,103307,103308,103309,1,2,0
29422,1,1,103308,103309,103310,1,2,0
29423,4,1,103312,103312,103313,0,1,2
29424,6,1,103318,103318,103319,0,1,5
29425,5,2,103323,103323,103325,0,2,4
29426,6,1,103329,103329,103330,0,1,4
29427,6,2,103335,103335,103337,0,2,5
29428,1,1,103336,103337,103338,1,2,0
29429,6,2,103342,103342,103344,0,2,4
29430,1,2,103343,103344,103346,1,3,0
29431,2,3,103345,103346,103349,1,4,0
29432,1,1,103346,103349,103350,3,4,0
29433,3,1,103349,103350,103351,1,2,0
29434,4,3,103353,103353,103356,0,3,2
29435,6,1,103359,103359,103360,0,1,3
29436,6,3,103365,103365,103368,0,3,5
29437,2,1,103367,103368,103369,1,2,0
29438,3,2,103370,103370,103372,0,2,1
29439,4,3,103374,103374,103377,0,3,2
29440,3,1,103377,103377,103378,0,1,0
29441,4,3,103381,103381,103384,0,3,3
29442,6,3,103387,103387,103390,0,3,3
29443,4,2,103391,103391,103393,0,2,1
29444,5,2,103396,103396,103398,0,2,3
29445,2,2,103398,103398,103400,0,2,0
29446,3,2,103401,103401,103403,0,2,1
29447,3,3,103404,103404,103407,0,3,1
29448,3,2,103407,103407,103409,0,2,0
29449,4,2,103411,103411,103413,0,2,2
29450,5,1,103416,103416,103417,0,1,3
29451,2,1,103418,103418,103419,0,1,1
29452,3,1,103421,103421,103422,0,1,2
29453,5,2,103426,103426,103428,0,2,4
29454,3,2,103429,103429,103431,0,2,1
29455,3,3,103432,103432,103435,0,3,1
29456,4,3,103436,103436,103439,0,3,1
29457,6,1,103442,103442,103443,0,1,3
29458,4,2,103446,103446,103448,0,2,3
29459,1,2,103447,103448,103450,1,3,0
29460,2,3,103449,103450,103453,1,4,0
29461,5,1,103454,103454,103455,0,1,1
29462,6,3,103460,103460,103463,0,3,5
29463,3,2,103463,103463,103465,0,2,0
29464,2,3,103465,103465,103468,0,3,0
29465,5,3,103470,103470,103473,0,3,2
29466,2,1,103472,103473,103474,1,2,0
29467,5,2,103477,103477,103479,0,2,3
29468,2,2,103479,103479,103481,0,2,0
29469,5,2,103484,103484,103486,0,2,3
29470,3,1,103487,103487,103488,0,1,1
29471,5,2,103492,103492,103494,0,2,4
29472,3,2,103495,103495,103497,0,2,1
29473,4,3,103499,103499,103502,0,3,2
29474,3,3,103502,103502,103505,0,3,0
29475,6,3,103508,103508,103511,0,3,3
29476,3,2,103511,103511,103513,0,2,0
29477,3,1,103514,103514,103515,0,1,1
29478,6,3,103520,103520,103523,0,3,5
29479,1,3,103521,103523,103526,2,5,0
29480,4,1,103525,103526,103527,1,2,0
29481,5,3,103530,103530,103533,0,3,3
29482,2,2,103532,103533,103535,1,3,0
29483,5,3,103537,103537,103540,0,3,2
29484,2,3,103539,103540,103543,1,4,0
29485,6,3,103545,103545,103548,0,3,2
29486,3,3,103548,103548,103551,0,3,0
29487,5,3,103553,103553,103556,0,3,2
29488,3,1,103556,103556,103557,0,1,0
29489,1,1,103557,103557,103558,0,1,0
29490,4,1,103561,103561,103562,0,1,3
29491,4,2,103565,103565,103567,0,2,3
29492,6,2,103571,103571,103573,0,2,4
29493,3,3,103574,103574,103577,0,3,1
29494,2,1,103576,103577,103578,1,2,0
29495,2,2,103578,103578,103580,0,2,0
29496,4,1,103582,103582,103583,0,1,2
29497,6,2,103588,103588,103590,0,2,5
29498,4,3,103592,103592,103595,0,3,2
29499,1,2,103593,103595,103597,2,4,0
29500,5,1,103598,103598,103599,0,1,1
29501,3,2,103601,103601,103603,0,2,2
29502,4,1,103605,103605,103606,0,1,2
29503,3,1,103608,103608,103609,0,1,2
29504,1,2,103609,103609,103611,0,2,0
29505,5,2,103614,103614,103616,0,2,3
29506,3,2,103617,103617,103619,0,2,1
29507,3,3,103620,103620,103623,0,3,1
29508,4,2,103624,103624,103626,0,2,1
29509,4,2,103628,103628,103630,0,2,2
29510,1,2,103629,103630,103632,1,3,0
29511,4,3,103633,103633,103636,0,3,1
29512,3,2,103636,103636,103638,0,2,0
29513,3,2,103639,103639,103641,0,2,1
29514,6,2,103645,103645,103647,0,2,4
29515,5,2,103650,103650,103652,0,2,3
29516,5,3,103655,103655,103658,0,3,3
29517,2,2,103657,103658,103660,1,3,0
29518,1,3,103658,103660,103663,2,5,0
29519,5,3,103663,103663,103666,0,3,0
29520,2,1,103665,103666,103667,1,2,0
29521,2,3,103667,103667,103670,0,3,0
29522,5,3,103672,103672,103675,0,3,2
29523,3,2,103675,103675,103677,0,2,0
29524,4,2,103679,103679,103681,0,2,2
29525,4,2,103683,103683,103685,0,2,2
29526,5,1,103688,103688,103689,0,1,3
29527,3,1,103691,103691,103692,0,1,2
29528,6,2,103697,103697,103699,0,2,5
29529,5,2,103702,103702,103704,0,2,3
29530,2,1,103704,103704,103705,0,1,0
29531,1,3,103705,103705,103708,0,3,0
29532,1,1,103706,103708,103709,2,3,0
29533,1,1,103707,103709,103710,2,3,0
29534,2,2,103709,103710,103712,1,3,0
29535,3,1,103712,103712,103713,0,1,0
29536,1,1,103713,103713,103714,0,1,0
29537,4,3,103717,103717,103720,0,3,3
29538,2,1,103719,103720,103721,1,2,0
29539,2,3,103721,103721,103724,0,3,0
29540,5,2,103726,103726,103728,0,2,2
29541,1,2,103727,103728,103730,1,3,0
29542,1,2,103728,103730,103732,2,4,0
29543,5,3,103733,103733,103736,0,3,1
29544,5,2,103738,103738,103740,0,2,2
29545,5,2,103743,103743,103745,0,2,3
29546,3,3,103746,103746,103749,0,3,1
29547,2,1,103748,103749,103750,1,2,0
29548,5,2,103753,103753,103755,0,2,3
29549,5,3,103758,103758,103761,0,3,3
29550,1,1,103759,103761,103762,2,3,0
29551,3,1,103762,103762,103763,0,1,0
29552,4,2,103766,103766,103768,0,2,3
29553,2,2,103768,103768,103770,0,2,0
29554,3,3,103771,103771,103774,0,3,1
29555,2,1,103773,103774,103775,1,2,0
29556,4,1,103777,103777,103778,0,1,2
29557,4,2,103781,103781,103783,0,2,3
29558,6,2,103787,103787,103789,0,2,4
29559,3,3,103790,103790,103793,0,3,1
29560,1,3,103791,103793,103796,2,5,0
29561,6,1,103797,103797,103798,0,1,1
29562,4,1,103801,103801,103802,0,1,3
29563,4,3,103805,103805,103808,0,3,3
29564,3,1,103808,103808,103809,0,1,0
29565,2,2,103810,103810,103812,0,2,1
29566,3,3,103813,103813,103816,0,3,1
29567,5,3,103818,103818,103821,0,3,2
29568,4,3,103822,103822,103825,0,3,1
29569,5,2,103827,103827,103829,0,2,2
29570,1,1,103828,103829,103830,1,2,0
29571,5,3,103833,103833,103836,0,3,3
29572,2,3,103835,103836,103839,1,4,0
29573,2,3,103837,103839,103842,2,5,0
29574,1,1,103838,103842,103843,4,5,0
29575,2,2,103840,103843,103845,3,5,0
29576,1,1,103841,103845,103846,4,5,0
29577,5,1,103846,103846,103847,0,1,0
29578,4,3,103850,103850,103853,0,3,3
29579,2,1,103852,103853,103854,1,2,0
29580,3,3,103855,103855,103858,0,3,1
29581,1,3,103856,103858,103861,2,5,0
29582,6,1,103862,103862,103863,0,1,1
29583,2,1,103864,103864,103865,0,1,1
29584,1,3,103865,103865,103868,0,3,0
29585,1,1,103866,103868,103869,2,3,0
29586,2,3,103868,103869,103872,1,4,0
29587,4,1,103872,103872,103873,0,1,0
29588,3,3,103875,103875,103878,0,3,2
29589,2,2,103877,103878,103880,1,3,0
29590,6,1,103883,103883,103884,0,1,3
29591,4,3,103887,103887,103890,0,3,3
29592,6,1,103893,103893,103894,0,1,3
29593,3,2,103896,103896,103898,0,2,2
29594,1,2,103897,103898,103900,1,3,0
29595,5,1,103902,103902,103903,0,1,2
29596,1,3,103903,103903,103906,0,3,0
29597,4,1,103907,103907,103908,0,1,1
29598,2,2,103909,103909,103911,0,2,1
29599,2,3,103911,103911,103914,0,3,0
29600,3,3,103914,103914,103917,0,3,0
29601,6,3,103920,103920,103923,0,3,3
29602,5,1,103925,103925,103926,0,1,2
29603,2,3,103927,103927,103930,0,3,1
29604,6,1,103933,103933,103934,0,1,3
29605,5,1,103938,103938,103939,0,1,4
29606,1,3,103939,103939,103942,0,3,0
29607,4,2,103943,103943,103945,0,2,1
29608,3,2,103946,103946,103948,0,2,1
29609,2,3,103948,103948,103951,0,3,0
29610,4,1,103952,103952,103953,0,1,1
29611,3,2,103955,103955,103957,0,2,2
29612,6,2,103961,103961,103963,0,2,4
29613,6,1,103967,103967,103968,0,1,4
29614,3,3,103970,103970,103973,0,3,2
29615,4,2,103974,103974,103976,0,2,1
29616,3,3,103977,103977,103980,0,3,1
29617,2,2,103979,103980,103982,1,3,0
29618,5,1,103984,103984,103985,0,1,2
29619,2,2,103986,103986,103988,0,2,1
29620,2,2,103988,103988,103990,0,2,0
29621,2,1,103990,103990,103991,0,1,0
29622,1,2,103991,103991,103993,0,2,0
29623,1,2,103992,103993,103995,1,3,0
29624,1,3,103993,103995,103998,2,5,0
29625,3,2,103996,103998,104000,2,4,0
29626,4,1,104000,104000,104001,0,1,0
29627,4,1,104004,104004,104005,0,1,3
29628,5,2,104009,104009,104011,0,2,4
29629,5,3,104014,104014,104017,0,3,3
29630,3,3,104017,104017,104020,0,3,0
29631,3,3,104020,104020,104023,0,3,0
29632,4,2,104024,104024,104026,0,2,1
29633,2,3,104026,104026,104029,0,3,0
29634,4,2,104030,104030,104032,0,2,1
29635,1,3,104031,104032,104035,1,4,0
29636,4,3,104035,104035,104038,0,3,0
29637,4,1,104039,104039,104040,0,1,1
29638,2,2,104041,104041,104043,0,2,1
29639,3,3,104044,104044,104047,0,3,1
29640,1,2,104045,104047,104049,2,4,0
29641,2,2,104047,104049,104051,2,4,0
29642,6,2,104053,104053,104055,0,2,2
29643,4,1,104057,104057,104058,0,1,2
29644,3,3,104060,104060,104063,0,3,2
29645,2,2,104062,104063,104065,1,3,0
29646,4,1,104066,104066,104067,0,1,1
29647,5,3,104071,104071,104074,0,3,4
29648,6,1,104077,104077,104078,0,1,3
29649,1,3,104078,104078,104081,0,3,0
29650,4,2,104082,104082,104084,0,2,1
29651,1,2,104083,104084,104086,1,3,0
29652,4,2,104087,104087,104089,0,2,1
29653,6,1,104093,104093,104094,0,1,4
29654,4,1,104097,104097,104098,0,1,3
29655,6,1,104103,104103,104104,0,1,5
29656,6,1,104109,104109,104110,0,1,5
29657,4,1,104113,104113,104114,0,1,3
29658,5,1,104118,104118,104119,0,1,4
29659,2,3,104120,104120,104123,0,3,1
29660,5,1,104125,104125,104126,0,1,2
29661,3,1,104128,104128,104129,0,1,2
29662,4,3,104132,104132,104135,0,3,3
29663,1,1,104133,104135,104136,2,3,0
29664,2,1,104135,104136,104137,1,2,0
29665,6,2,104141,104141,104143,0,2,4
29666,3,3,104144,104144,104147,0,3,1
29667,1,3,104145,104147,104150,2,5,0
29668,2,3,104147,104150,104153,3,6,0
29669,5,3,104152,104153,104156,1,4,0
29670,5,3,104157,104157,104160,0,3,1
29671,6,2,104163,104163,104165,0,2,3
29672,5,2,104168,104168,104170,0,2,3
29673,2,2,104170,104170,104172,0,2,0
29674,4,3,104174,104174,104177,0,3,2
29675,3,1,104177,104177,104178,0,1,0
29676,4,2,104181,104181,104183,0,2,3
29677,6,1,104187,104187,104188,0,1,4
29678,3,1,104190,104190,104191,0,1,2
29679,5,1,104195,104195,104196,0,1,4
29680,5,1,104200,104200,104201,0,1,4
29681,4,3,104204,104204,104207,0,3,3
29682,6,2,104210,104210,104212,0,2,3
29683,6,3,104216,104216,104219,0,3,4
29684,4,3,104220,104220,104223,0,3,1
29685,2,1,104222,104223,104224,1,2,0
29686,5,1,104227,104227,104228,0,1,3
29687,2,1,104229,104229,104230,0,1,1
29688,2,2,104231,104231,104233,0,2,1
29689,2,3,104233,104233,104236,0,3,0
29690,6,2,104239,104239,104241,0,2,3
29691,4,3,104243,104243,104246,0,3,2
29692,3,2,104246,104246,104248,0,2,0
29693,2,2,104248,104248,104250,0,2,0
29694,1,3,104249,104250,104253,1,4,0
29695,5,2,104254,104254,104256,0,2,1
29696,1,3,104255,104256,104259,1,4,0
29697,6,3,104261,104261,104264,0,3,2
29698,1,3,104262,104264,104267,2,5,0
29699,6,2,104268,104268,104270,0,2,1
29700,2,3,104270,104270,104273,0,3,0
29701,1,3,104271,104273,104276,2,5,0
29702,6,1,104277,104277,104278,0,1,1
29703,2,3,104279,104279,104282,0,3,1
29704,1,2,104280,104282,104284,2,4,0
29705,6,2,104286,104286,104288,0,2,2
29706,1,2,104287,104288,104290,1,3,0
29707,3,3,104290,104290,104293,0,3,0
29708,1,2,104291,104293,104295,2,4,0
29709,5,2,104296,104296,104298,0,2,1
29710,5,2,104301,104301,104303,0,2,3
29711,1,1,104302,104303,104304,1,2,0
29712,3,3,104305,104305,104308,0,3,1
29713,6,3,104311,104311,104314,0,3,3
29714,3,3,104314,104314,104317,0,3,0
29715,4,3,104318,104318,104321,0,3,1
29716,2,1,104320,104321,104322,1,2,0
29717,5,1,104325,104325,104326,0,1,3
29718,2,1,104327,104327,104328,0,1,1
29719,3,3,104330,104330,104333,0,3,2
29720,6,3,104336,104336,104339,0,3,3
29721,3,2,104339,104339,104341,0,2,0
29722,2,1,104341,104341,104342,0,1,0
29723,4,2,104345,104345,104347,0,2,3
29724,5,2,104350,104350,104352,0,2,3
29725,6,3,104356,104356,104359,0,3,4
29726,6,2,104362,104362,104364,0,2,3
29727,1,1,104363,104364,104365,1,2,0
29728,6,2,104369,104369,104371,0,2,4
29729,1,2,104370,104371,104373,1,3,0
29730,5,2,104375,104375,104377,0,2,2
29731,2,2,104377,104377,104379,0,2,0
29732,5,1,104382,104382,104383,0,1,3
29733,4,2,104386,104386,104388,0,2,3
29734,3,1,104389,104389,104390,0,1,1
29735,5,2,104394,104394,104396,0,2,4
29736,5,1,104399,104399,104400,0,1,3
29737,5,2,104404,104404,104406,0,2,4
29738,4,2,104408,104408,104410,0,2,2
29739,5,2,104413,104413,104415,0,2,3
29740,1,2,104414,104415,104417,1,3,0
29741,3,2,104417,104417,104419,0,2,0
29742,6,1,104423,104423,104424,0,1,4
29743,2,2,104425,104425,104427,0,2,1
29744,6,1,104431,104431,104432,0,1,4
29745,6,1,104437,104437,104438,0,1,5
29746,1,3,104438,104438,104441,0,3,0
29747,6,2,104444,104444,104446,0,2,3
29748,2,3,104446,104446,104449,0,3,0
29749,3,2,104449,104449,104451,0,2,0
29750,1,1,104450,104451,104452,1,2,0
29751,5,2,104455,104455,104457,0,2,3
29752,4,1,104459,104459,104460,0,1,2
29753,6,1,104465,104465,104466,0,1,5
29754,4,1,104469,104469,104470,0,1,3
29755,2,3,104471,104471,104474,0,3,1
29756,2,3,104473,104474,104477,1,4,0
29757,4,2,104477,104477,104479,0,2,0
29758,4,3,104481,104481,104484,0,3,2
29759,2,2,104483,104484,104486,1,3,0
29760,6,2,104489,104489,104491,0,2,3
29761,2,1,104491,104491,104492,0,1,0
29762,6,2,104497,104497,104499,0,2,5
29763,6,2,104503,104503,104505,0,2,4
29764,6,2,104509,104509,104511,0,2,4
29765,6,2,104515,104515,104517,0,2,4
29766,5,3,104520,104520,104523,0,3,3
29767,2,1,104522,104523,104524,1,2,0
29768,1,2,104523,104524,104526,1,3,0
29769,3,3,104526,104526,104529,0,3,0
29770,5,2,104531,104531,104533,0,2,2
29771,4,2,104535,104535,104537,0,2,2
29772,6,1,104541,104541,104542,0,1,4
29773,4,3,104545,104545,104548,0,3,3
29774,5,1,104550,104550,104551,0,1,2
29775,6,1,104556,104556,104557,0,1,5
29776,2,2,104558,104558,104560,0,2,1
29777,5,3,104563,104563,104566,0,3,3
29778,1,1,104564,104566,104567,2,3,0
29779,5,1,104569,104569,104570,0,1,2
29780,6,3,104575,104575,104578,0,3,5
29781,1,2,104576,104578,104580,2,4,0
29782,4,2,104580,104580,104582,0,2,0
29783,3,1,104583,104583,104584,0,1,1
29784,1,1,104584,104584,104585,0,1,0
29785,4,3,104588,104588,104591,0,3,3
29786,3,1,104591,104591,104592,0,1,0
29787,2,3,104593,104593,104596,0,3,1
29788,2,2,104595,104596,104598,1,3,0
29789,3,1,104598,104598,104599,0,1,0
29790,2,2,104600,104600,104602,0,2,1
29791,4,1,104604,104604,104605,0,1,2
29792,5,1,104609,104609,104610,0,1,4
29793,4,1,104613,104613,104614,0,1,3
29794,3,1,104616,104616,104617,0,1,2
29795,6,3,104622,104622,104625,0,3,5
29796,4,1,104626,104626,104627,0,1,1
29797,4,3,104630,104630,104633,0,3,3
29798,3,3,104633,104633,104636,0,3,0
29799,5,2,104638,104638,104640,0,2,2
29800,1,1,104639,104640,104641,1,2,0
29801,1,3,104640,104641,104644,1,4,0
29802,4,1,104644,104644,104645,0,1,0
29803,1,3,104645,104645,104648,0,3,0
29804,3,3,104648,104648,104651,0,3,0
29805,3,1,104651,104651,104652,0,1,0
29806,5,1,104656,104656,104657,0,1,4
29807,3,3,104659,104659,104662,0,3,2
29808,1,1,104660,104662,104663,2,3,0
29809,3,2,104663,104663,104665,0,2,0
29810,2,2,104665,104665,104667,0,2,0
29811,2,1,104667,104667,104668,0,1,0
29812,1,3,104668,104668,104671,0,3,0
29813,4,2,104672,104672,104674,0,2,1
29814,2,3,104674,104674,104677,0,3,0
29815,2,2,104676,104677,104679,1,3,0
29816,3,1,104679,104679,104680,0,1,0
29817,5,3,104684,104684,104687,0,3,4
29818,3,1,104687,104687,104688,0,1,0
29819,3,1,104690,104690,104691,0,1,2
29820,2,3,104692,104692,104695,0,3,1
29821,4,3,104696,104696,104699,0,3,1
29822,2,1,104698,104699,104700,1,2,0
29823,6,3,104704,104704,104707,0,3,4
29824,1,2,104705,104707,104709,2,4,0
29825,5,2,104710,104710,104712,0,2,1
29826,4,1,104714,104714,104715,0,1,2
29827,5,3,104719,104719,104722,0,3,4
29828,3,2,104722,104722,104724,0,2,0
29829,5,3,104727,104727,104730,0,3,3
29830,4,1,104731,104731,104732,0,1,1
29831,3,2,104734,104734,104736,0,2,2
29832,1,2,104735,104736,104738,1,3,0
29833,5,2,104740,104740,104742,0,2,2
29834,3,3,104743,104743,104746,0,3,1
29835,6,2,104749,104749,104751,0,2,3
29836,1,1,104750,104751,104752,1,2,0
29837,6,1,104756,104756,104757,0,1,4
29838,6,3,104762,104762,104765,0,3,5
29839,2,3,104764,104765,104768,1,4,0
29840,1,3,104765,104768,104771,3,6,0
29841,6,3,104771,104771,104774,0,3,0
29842,5,2,104776,104776,104778,0,2,2
29843,2,3,104778,104778,104781,0,3,0
29844,2,2,104780,104781,104783,1,3,0
29845,4,1,104784,104784,104785,0,1,1
29846,2,3,104786,104786,104789,0,3,1
29847,6,2,104792,104792,104794,0,2,3
29848,4,2,104796,104796,104798,0,2,2
29849,2,3,104798,104798,104801,0,3,0
29850,4,3,104802,104802,104805,0,3,1
29851,2,3,104804,104805,104808,1,4,0
29852,5,1,104809,104809,104810,0,1,1
29853,6,3,104815,104815,104818,0,3,5
29854,4,1,104819,104819,104820,0,1,1
29855,5,3,104824,104824,104827,0,3,4
29856,3,2,104827,104827,104829,0,2,0
29857,5,3,104832,104832,104835,0,3,3
29858,1,1,104833,104835,104836,2,3,0
29859,2,3,104835,104836,104839,1,4,0
29860,3,3,104838,104839,104842,1,4,0
29861,6,3,104844,104844,104847,0,3,2
29862,6,3,104850,104850,104853,0,3,3
29863,2,1,104852,104853,104854,1,2,0
29864,1,3,104853,104854,104857,1,4,0
29865,5,1,104858,104858,104859,0,1,1
29866,5,3,104863,104863,104866,0,3,4
29867,6,1,104869,104869,104870,0,1,3
29868,4,1,104873,104873,104874,0,1,3
29869,4,1,104877,104877,104878,0,1,3
29870,6,2,104883,104883,104885,0,2,5
29871,4,1,104887,104887,104888,0,1,2
29872,2,2,104889,104889,104891,0,2,1
29873,2,3,104891,104891,104894,0,3,0
29874,3,2,104894,104894,104896,0,2,0
29875,6,2,104900,104900,104902,0,2,4
29876,6,2,104906,104906,104908,0,2,4
29877,5,3,104911,104911,104914,0,3,3
29878,3,3,104914,104914,104917,0,3,0
29879,5,1,104919,104919,104920,0,1,2
29880,4,3,104923,104923,104926,0,3,3
29881,4,1,104927,104927,104928,0,1,1
29882,2,2,104929,104929,104931,0,2,1
29883,1,3,104930,104931,104934,1,4,0
29884,6,2,104936,104936,104938,0,2,2
29885,3,2,104939,104939,104941,0,2,1
29886,2,2,104941,104941,104943,0,2,0
29887,5,3,104946,104946,104949,0,3,3
29888,5,2,104951,104951,104953,0,2,2
29889,1,1,104952,104953,104954,1,2,0
29890,2,2,104954,104954,104956,0,2,0
29891,6,2,104960,104960,104962,0,2,4
29892,2,3,104962,104962,104965,0,3,0
29893,1,3,104963,104965,104968,2,5,0
29894,4,3,104967,104968,104971,1,4,0
29895,2,1,104969,104971,104972,2,3,0
29896,2,1,104971,104972,104973,1,2,0
29897,2,3,104973,104973,104976,0,3,0
29898,2,2,104975,104976,104978,1,3,0
29899,4,1,104979,104979,104980,0,1,1
29900,3,2,104982,104982,104984,0,2,2
29901,6,1,104988,104988,104989,0,1,4
29902,3,3,104991,104991,104994,0,3,2
29903,1,2,104992,104994,104996,2,4,0
29904,5,1,104997,104997,104998,0,1,1
29905,2,3,104999,104999,105002,0,3,1
29906,4,2,105003,105003,105005,0,2,1
29907,1,1,105004,105005,105006,1,2,0
29908,3,2,105007,105007,105009,0,2,1
29909,1,2,105008,105009,105011,1,3,0
29910,6,1,105014,105014,105015,0,1,3
29911,2,3,105016,105016,105019,0,3,1
29912,5,2,105021,105021,105023,0,2,2
29913,3,1,105024,105024,105025,0,1,1
29914,3,2,105027,105027,105029,0,2,2
29915,5,2,105032,105032,105034,0,2,3
29916,2,1,105034,105034,105035,0,1,0
29917,5,3,105039,105039,105042,0,3,4
29918,6,1,105045,105045,105046,0,1,3
29919,2,1,105047,105047,105048,0,1,1
29920,4,3,105051,105051,105054,0,3,3
29921,5,2,105056,105056,105058,0,2,2
29922,6,1,105062,105062,105063,0,1,4
29923,2,2,105064,105064,105066,0,2,1
29924,6,3,105070,105070,105073,0,3,4
29925,6,1,105076,105076,105077,0,1,3
29926,1,2,105077,105077,105079,0,2,0
29927,3,2,105080,105080,105082,0,2,1
29928,3,1,105083,105083,105084,0,1,1
29929,6,3,105089,105089,105092,0,3,5
29930,6,1,105095,105095,105096,0,1,3
29931,2,3,105097,105097,105100,0,3,1
29932,4,1,105101,105101,105102,0,1,1
29933,2,3,105103,105103,105106,0,3,1
29934,4,1,105107,105107,105108,0,1,1
29935,6,1,105113,105113,105114,0,1,5
29936,6,3,105119,105119,105122,0,3,5
29937,1,1,105120,105122,105123,2,3,0
29938,1,1,105121,105123,105124,2,3,0
29939,4,1,105125,105125,105126,0,1,1
29940,3,3,105128,105128,105131,0,3,2
29941,3,1,105131,105131,105132,0,1,0
29942,4,2,105135,105135,105137,0,2,3
29943,6,3,105141,105141,105144,0,3,4
29944,6,3,105147,105147,105150,0,3,3
29945,5,3,105152,105152,105155,0,3,2
29946,5,2,105157,105157,105159,0,2,2
29947,5,3,105162,105162,105165,0,3,3
29948,4,1,105166,105166,105167,0,1,1
29949,6,3,105172,105172,105175,0,3,5
29950,4,1,105176,105176,105177,0,1,1
29951,3,2,105179,105179,105181,0,2,2
29952,6,2,105185,105185,105187,0,2,4
29953,5,3,105190,105190,105193,0,3,3
29954,6,1,105196,105196,105197,0,1,3
29955,4,3,105200,105200,105203,0,3,3
29956,3,3,105203,105203,105206,0,3,0
29957,3,2,105206,105206,105208,0,2,0
29958,3,1,105209,105209,105210,0,1,1
29959,4,1,105213,105213,105214,0,1,3
29960,3,3,105216,105216,105219,0,3,2
29961,1,3,105217,105219,105222,2,5,0
29962,1,1,105218,105222,105223,4,5,0
29963,5,3,105223,105223,105226,0,3,0
29964,2,2,105225,105226,105228,1,3,0
29965,5,2,105230,105230,105232,0,2,2
29966,5,2,105235,105235,105237,0,2,3
29967,6,3,105241,105241,105244,0,3,4
29968,4,3,105245,105245,105248,0,3,1
29969,6,1,105251,105251,105252,0,1,3
29970,1,3,105252,105252,105255,0,3,0
29971,1,1,105253,105255,105256,2,3,0
29972,6,2,105259,105259,105261,0,2,3
29973,6,1,105265,105265,105266,0,1,4
29974,4,2,105269,105269,105271,0,2,3
29975,2,3,105271,105271,105274,0,3,0
29976,3,1,105274,105274,105275,0,1,0
29977,4,1,105278,105278,105279,0,1,3
29978,6,3,105284,105284,105287,0,3,5
29979,1,3,105285,105287,105290,2,5,0
29980,5,3,105290,105290,105293,0,3,0
29981,1,1,105291,105293,105294,2,3,0
29982,3,2,105294,105294,105296,0,2,0
29983,6,1,105300,105300,105301,0,1,4
29984,3,1,105303,105303,105304,0,1,2
29985,3,3,105306,105306,105309,0,3,2
29986,1,1,105307,105309,105310,2,3,0
29987,4,2,105311,105311,105313,0,2,1
29988,2,1,105313,105313,105314,0,1,0
29989,4,2,105317,105317,105319,0,2,3
29990,3,3,105320,105320,105323,0,3,1
29991,1,1,105321,105323,105324,2,3,0
29992,5,2,105326,105326,105328,0,2,2
29993,2,3,105328,105328,105331,0,3,0
29994,3,2,105331,105331,105333,0,2,0
29995,3,1,105334,105334,105335,0,1,1
29996,5,2,105339,105339,105341,0,2,4
29997,3,2,105342,105342,105344,0,2,1
29998,3,1,105345,105345,105346,0,1,1
29999,1,3,105346,105346,105349,0,3,0
30000,4,3,105350,105350,105353,0,3,1
30001,3,3,105353,105353,105356,0,3,0
30002,3,2,105356,105356,105358,0,2,0
30003,2,2,105358,105358,105360,0,2,0
30004,3,1,105361,105361,105362,0,1,1
30005,3,3,105364,105364,105367,0,3,2
30006,4,3,105368,105368,105371,0,3,1
30007,6,2,105374,105374,105376,0,2,3
30008,6,3,105380,105380,105383,0,3,4
30009,3,3,105383,105383,105386,0,3,0
30010,4,3,105387,105387,105390,0,3,1
30011,2,3,105389,105390,105393,1,4,0
30012,2,1,105391,105393,105394,2,3,0
30013,1,3,105392,105394,105397,2,5,0
30014,3,1,105395,105397,105398,2,3,0
30015,1,3,105396,105398,105401,2,5,0
30016,2,3,105398,105401,105404,3,6,0
30017,4,2,105402,105404,105406,2,4,0
30018,3,1,105405,105406,105407,1,2,0
30019,1,3,105406,105407,105410,1,4,0
30020,2,3,105408,105410,105413,2,5,0
30021,5,2,105413,105413,105415,0,2,0
30022,1,3,105414,105415,105418,1,4,0
30023,5,3,105419,105419,105422,0,3,1
30024,1,2,105420,105422,105424,2,4,0
30025,1,2,105421,105424,105426,3,5,0
30026,2,3,105423,105426,105429,3,6,0
30027,3,2,105426,105429,105431,3,5,0
30028,4,2,105430,105431,105433,1,3,0
30029,2,3,105432,105433,105436,1,4,0
30030,6,3,105438,105438,105441,0,3,2
30031,6,2,105444,105444,105446,0,2,3
30032,4,3,105448,105448,105451,0,3,2
30033,3,1,105451,105451,105452,0,1,0
30034,3,2,105454,105454,105456,0,2,2
30035,4,1,105458,105458,105459,0,1,2
30036,4,2,105462,105462,105464,0,2,3
30037,4,1,105466,105466,105467,0,1,2
30038,5,2,105471,105471,105473,0,2,4
30039,3,3,105474,105474,105477,0,3,1
30040,3,1,105477,105477,105478,0,1,0
30041,1,3,105478,105478,105481,0,3,0
30042,4,1,105482,105482,105483,0,1,1
30043,5,3,105487,105487,105490,0,3,4
30044,5,3,105492,105492,105495,0,3,2
30045,4,3,105496,105496,105499,0,3,1
30046,2,3,105498,105499,105502,1,4,0
30047,3,2,105501,105502,105504,1,3,0
30048,3,2,105504,105504,105506,0,2,0
30049,1,2,105505,105506,105508,1,3,0
30050,3,3,105508,105508,105511,0,3,0
30051,6,2,105514,105514,105516,0,2,3
30052,3,1,105517,105517,105518,0,1,1
30053,2,1,105519,105519,105520,0,1,1
30054,4,3,105523,105523,105526,0,3,3
30055,6,2,105529,105529,105531,0,2,3
30056,1,3,105530,105531,105534,1,4,0
30057,5,3,105535,105535,105538,0,3,1
30058,2,2,105537,105538,105540,1,3,0
30059,2,3,105539,105540,105543,1,4,0
30060,4,1,105543,105543,105544,0,1,0
30061,5,3,105548,105548,105551,0,3,4
30062,6,1,105554,105554,105555,0,1,3
30063,1,2,105555,105555,105557,0,2,0
30064,3,2,105558,105558,105560,0,2,1
30065,2,3,105560,105560,105563,0,3,0
30066,6,3,105566,105566,105569,0,3,3
30067,1,1,105567,105569,105570,2,3,0
30068,4,1,105571,105571,105572,0,1,1
30069,5,2,105576,105576,105578,0,2,4
30070,1,1,105577,105578,105579,1,2,0
30071,1,2,105578,105579,105581,1,3,0
30072,2,2,105580,105581,105583,1,3,0
30073,2,2,105582,105583,105585,1,3,0
30074,3,3,105585,105585,105588,0,3,0
30075,2,1,105587,105588,105589,1,2,0
30076,1,1,105588,105589,105590,1,2,0
30077,3,3,105591,105591,105594,0,3,1
30078,2,2,105593,105594,105596,1,3,0
30079,4,2,105597,105597,105599,0,2,1
30080,5,3,105602,105602,105605,0,3,3
30081,5,1,105607,105607,105608,0,1,2
30082,6,1,105613,105613,105614,0,1,5
30083,1,3,105614,105614,105617,0,3,0
30084,2,2,105616,105617,105619,1,3,0
30085,4,3,105620,105620,105623,0,3,1
30086,4,3,105624,105624,105627,0,3,1
30087,2,1,105626,105627,105628,1,2,0
30088,1,3,105627,105628,105631,1,4,0
30089,5,2,105632,105632,105634,0,2,1
30090,6,3,105638,105638,105641,0,3,4
30091,3,3,105641,105641,105644,0,3,0
30092,4,3,105645,105645,105648,0,3,1
30093,2,3,105647,105648,105651,1,4,0
30094,4,2,105651,105651,105653,0,2,0
30095,1,2,105652,105653,105655,1,3,0
30096,1,2,105653,105655,105657,2,4,0
30097,6,3,105659,105659,105662,0,3,2
30098,3,3,105662,105662,105665,0,3,0
30099,6,1,105668,105668,105669,0,1,3
30100,4,2,105672,105672,105674,0,2,3
30101,2,2,105674,105674,105676,0,2,0
30102,5,1,105679,105679,105680,0,1,3
30103,3,2,105682,105682,105684,0,2,2
30104,4,2,105686,105686,105688,0,2,2
30105,5,2,105691,105691,105693,0,2,3
30106,5,3,105696,105696,105699,0,3,3
30107,3,3,105699,105699,105702,0,3,0
30108,3,1,105702,105702,105703,0,1,0
30109,1,3,105703,105703,105706,0,3,0
30110,6,3,105709,105709,105712,0,3,3
30111,3,1,105712,105712,105713,0,1,0
30112,4,2,105716,105716,105718,0,2,3
30113,2,3,105718,105718,105721,0,3,0
30114,2,1,105720,105721,105722,1,2,0
30115,5,2,105725,105725,105727,0,2,3
30116,6,3,105731,105731,105734,0,3,4
30117,2,1,105733,105734,105735,1,2,0
30118,2,1,105735,105735,105736,0,1,0
30119,5,1,105740,105740,105741,0,1,4
30120,3,3,105743,105743,105746,0,3,2
30121,5,3,105748,105748,105751,0,3,2
30122,5,3,105753,105753,105756,0,3,2
30123,4,1,105757,105757,105758,0,1,1
30124,6,1,105763,105763,105764,0,1,5
30125,5,1,105768,105768,105769,0,1,4
30126,4,1,105772,105772,105773,0,1,3
30127,4,2,105776,105776,105778,0,2,3
30128,1,1,105777,105778,105779,1,2,0
30129,4,1,105781,105781,105782,0,1,2
30130,6,1,105787,105787,105788,0,1,5
30131,1,2,105788,105788,105790,0,2,0
30132,6,3,105794,105794,105797,0,3,4
30133,1,1,105795,105797,105798,2,3,0
30134,3,2,105798,105798,105800,0,2,0
30135,6,2,105804,105804,105806,0,2,4
30136,1,3,105805,105806,105809,1,4,0
30137,5,2,105810,105810,105812,0,2,1
30138,5,3,105815,105815,105818,0,3,3
30139,1,3,105816,105818,105821,2,5,0
30140,6,1,105822,105822,105823,0,1,1
30141,1,2,105823,105823,105825,0,2,0
30142,3,2,105826,105826,105828,0,2,1
30143,6,2,105832,105832,105834,0,2,4
30144,1,2,105833,105834,105836,1,3,0
30145,1,3,105834,105836,105839,2,5,0
30146,1,2,105835,105839,105841,4,6,0
30147,5,3,105840,105841,105844,1,4,0
30148,1,3,105841,105844,105847,3,6,0
30149,6,1,105847,105847,105848,0,1,0
30150,4,3,105851,105851,105854,0,3,3
30151,3,1,105854,105854,105855,0,1,0
30152,5,1,105859,105859,105860,0,1,4
30153,4,1,105863,105863,105864,0,1,3
30154,3,2,105866,105866,105868,0,2,2
30155,4,1,105870,105870,105871,0,1,2
30156,5,3,105875,105875,105878,0,3,4
30157,4,1,105879,105879,105880,0,1,1
30158,5,3,105884,105884,105887,0,3,4
30159,4,2,105888,105888,105890,0,2,1
30160,5,3,105893,105893,105896,0,3,3
30161,6,1,105899,105899,105900,0,1,3
30162,2,2,105901,105901,105903,0,2,1
30163,2,2,105903,105903,105905,0,2,0
30164,6,1,105909,105909,105910,0,1,4
30165,5,2,105914,105914,105916,0,2,4
30166,4,1,105918,105918,105919,0,1,2
30167,3,2,105921,105921,105923,0,2,2
30168,3,1,105924,105924,105925,0,1,1
30169,1,1,105925,105925,105926,0,1,0
30170,2,3,105927,105927,105930,0,3,1
30171,6,1,105933,105933,105934,0,1,3
30172,4,3,105937,105937,105940,0,3,3
30173,4,3,105941,105941,105944,0,3,1
30174,5,3,105946,105946,105949,0,3,2
30175,6,2,105952,105952,105954,0,2,3
30176,3,1,105955,105955,105956,0,1,1
30177,5,1,105960,105960,105961,0,1,4
30178,3,1,105963,105963,105964,0,1,2
30179,2,2,105965,105965,105967,0,2,1
30180,4,1,105969,105969,105970,0,1,2
30181,4,3,105973,105973,105976,0,3,3
30182,6,2,105979,105979,105981,0,2,3
30183,1,1,105980,105981,105982,1,2,0
30184,4,3,105984,105984,105987,0,3,2
30185,6,1,105990,105990,105991,0,1,3
30186,1,3,105991,105991,105994,0,3,0
30187,2,2,105993,105994,105996,1,3,0
30188,6,2,105999,105999,106001,0,2,3
30189,1,3,106000,106001,106004,1,4,0
30190,1,2,106001,106004,106006,3,5,0
30191,2,3,106003,106006,106009,3,6,0
30192,1,2,106004,106009,106011,5,7,0
30193,3,3,106007,106011,106014,4,7,0
30194,5,2,106012,106014,106016,2,4,0
30195,5,2,106017,106017,106019,0,2,1
30196,4,3,106021,106021,106024,0,3,2
30197,3,2,106024,106024,106026,0,2,0
30198,5,3,106029,106029,106032,0,3,3
30199,6,2,106035,106035,106037,0,2,3
30200,5,3,106040,106040,106043,0,3,3
30201,3,2,106043,106043,106045,0,2,0
30202,1,1,106044,106045,106046,1,2,0
30203,2,1,106046,106046,106047,0,1,0
30204,2,3,106048,106048,106051,0,3,1
30205,2,3,106050,106051,106054,1,4,0
30206,4,3,106054,106054,106057,0,3,0
30207,3,1,106057,106057,106058,0,1,0
30208,3,3,106060,106060,106063,0,3,2
30209,3,2,106063,106063,106065,0,2,0
30210,3,2,106066,106066,106068,0,2,1
30211,3,3,106069,106069,106072,0,3,1
30212,2,2,106071,106072,106074,1,3,0
30213,5,2,106076,106076,106078,0,2,2
30214,1,1,106077,106078,106079,1,2,0
30215,2,1,106079,106079,106080,0,1,0
30216,2,2,106081,106081,106083,0,2,1
30217,4,2,106085,106085,106087,0,2,2
30218,3,2,106088,106088,106090,0,2,1
30219,5,1,106093,106093,106094,0,1,3
30220,4,1,106097,106097,106098,0,1,3
30221,4,1,106101,106101,106102,0,1,3
30222,4,2,106105,106105,106107,0,2,3
30223,6,2,106111,106111,106113,0,2,4
30224,1,2,106112,106113,106115,1,3,0
30225,2,2,106114,106115,106117,1,3,0
30226,6,1,106120,106120,106121,0,1,3
30227,3,3,106123,106123,106126,0,3,2
30228,4,3,106127,106127,106130,0,3,1
30229,2,1,106129,106130,106131,1,2,0
30230,5,2,106134,106134,106136,0,2,3
30231,2,3,106136,106136,106139,0,3,0
30232,3,1,106139,106139,106140,0,1,0
30233,1,1,106140,106140,106141,0,1,0
30234,5,1,106145,106145,106146,0,1,4
30235,1,1,106146,106146,106147,0,1,0
30236,6,1,106152,106152,106153,0,1,5
30237,1,1,106153,106153,106154,0,1,0
30238,6,1,106159,106159,106160,0,1,5
30239,2,3,106161,106161,106164,0,3,1
30240,2,3,106163,106164,106167,1,4,0
30241,2,3,106165,106167,106170,2,5,0
30242,5,2,106170,106170,106172,0,2,0
30243,2,1,106172,106172,106173,0,1,0
30244,5,2,106177,106177,106179,0,2,4
30245,3,1,106180,106180,106181,0,1,1
30246,2,3,106182,106182,106185,0,3,1
30247,4,1,106186,106186,106187,0,1,1
30248,1,2,106187,106187,106189,0,2,0
30249,2,1,106189,106189,106190,0,1,0
30250,3,1,106192,106192,106193,0,1,2
30251,1,3,106193,106193,106196,0,3,0
30252,3,2,106196,106196,106198,0,2,0
30253,3,2,106199,106199,106201,0,2,1
30254,4,2,106203,106203,106205,0,2,2
30255,5,3,106208,106208,106211,0,3,3
30256,6,1,106214,106214,106215,0,1,3
30257,4,2,106218,106218,106220,0,2,3
30258,5,2,106223,106223,106225,0,2,3
30259,3,2,106226,106226,106228,0,2,1
30260,4,1,106230,106230,106231,0,1,2
30261,5,2,106235,106235,106237,0,2,4
30262,6,1,106241,106241,106242,0,1,4
30263,3,2,106244,106244,106246,0,2,2
30264,4,3,106248,106248,106251,0,3,2
30265,5,2,106253,106253,106255,0,2,2
30266,3,1,106256,106256,106257,0,1,1
30267,3,2,106259,106259,106261,0,2,2
30268,4,3,106263,106263,106266,0,3,2
30269,6,1,106269,106269,106270,0,1,3
30270,2,1,106271,106271,106272,0,1,1
30271,5,3,106276,106276,106279,0,3,4
30272,2,1,106278,106279,106280,1,2,0
30273,1,2,106279,106280,106282,1,3,0
30274,6,3,106285,106285,106288,0,3,3
30275,5,1,106290,106290,106291,0,1,2
30276,6,2,106296,106296,106298,0,2,5
30277,3,3,106299,106299,106302,0,3,1
30278,3,1,106302,106302,106303,0,1,0
30279,5,2,106307,106307,106309,0,2,4
30280,4,3,106311,106311,106314,0,3,2
30281,3,2,106314,106314,106316,0,2,0
30282,4,2,106318,106318,106320,0,2,2
30283,5,3,106323,106323,106326,0,3,3
30284,3,2,106326,106326,106328,0,2,0
30285,6,1,106332,106332,106333,0,1,4
30286,4,1,106336,106336,106337,0,1,3
30287,1,1,106337,106337,106338,0,1,0
30288,6,2,106343,106343,106345,0,2,5
30289,5,3,106348,106348,106351,0,3,3
30290,4,3,106352,106352,106355,0,3,1
30291,3,3,106355,106355,106358,0,3,0
30292,3,1,106358,106358,106359,0,1,0
30293,6,2,106364,106364,106366,0,2,5
30294,6,3,106370,106370,106373,0,3,4
30295,5,2,106375,106375,106377,0,2,2
30296,4,2,106379,106379,106381,0,2,2
30297,4,1,106383,106383,106384,0,1,2
30298,4,2,106387,106387,106389,0,2,3
30299,2,3,106389,106389,106392,0,3,0
30300,5,2,106394,106394,106396,0,2,2
30301,4,3,106398,106398,106401,0,3,2
30302,2,3,106400,106401,106404,1,4,0
30303,1,2,106401,106404,106406,3,5,0
30304,5,3,106406,106406,106409,0,3,0
30305,3,2,106409,106409,106411,0,2,0
30306,2,3,106411,106411,106414,0,3,0
30307,2,3,106413,106414,106417,1,4,0
30308,4,3,106417,106417,106420,0,3,0
30309,3,3,106420,106420,106423,0,3,0
30310,5,3,106425,106425,106428,0,3,2
30311,6,3,106431,106431,106434,0,3,3
30312,5,1,106436,106436,106437,0,1,2
30313,6,2,106442,106442,106444,0,2,5
30314,6,1,106448,106448,106449,0,1,4
30315,6,2,106454,106454,106456,0,2,5
30316,1,3,106455,106456,106459,1,4,0
30317,1,1,106456,106459,106460,3,4,0
30318,3,1,106459,106460,106461,1,2,0
30319,1,2,106460,106461,106463,1,3,0
30320,2,2,106462,106463,106465,1,3,0
30321,2,2,106464,106465,106467,1,3,0
30322,5,2,106469,106469,106471,0,2,2
30323,1,1,106470,106471,106472,1,2,0
30324,3,1,106473,106473,106474,0,1,1
30325,5,3,106478,106478,106481,0,3,4
30326,2,3,106480,106481,106484,1,4,0
30327,2,2,106482,106484,106486,2,4,0
30328,1,3,106483,106486,106489,3,6,0
30329,2,1,106485,106489,106490,4,5,0
30330,5,3,106490,106490,106493,0,3,0
30331,3,1,106493,106493,106494,0,1,0
30332,1,2,106494,106494,106496,0,2,0
30333,3,3,106497,106497,106500,0,3,1
30334,3,1,106500,106500,106501,0,1,0
30335,5,2,106505,106505,106507,0,2,4
30336,2,1,106507,106507,106508,0,1,0
30337,2,3,106509,106509,106512,0,3,1
30338,1,3,106510,106512,106515,2,5,0
30339,6,1,106516,106516,106517,0,1,1
30340,6,1,106522,106522,106523,0,1,5
30341,4,3,106526,106526,106529,0,3,3
30342,3,2,106529,106529,106531,0,2,0
30343,6,2,106535,106535,106537,0,2,4
30344,1,2,106536,106537,106539,1,3,0
30345,5,1,106541,106541,106542,0,1,2
30346,2,2,106543,106543,106545,0,2,1
30347,1,1,106544,106545,106546,1,2,0
30348,5,1,106549,106549,106550,0,1,3
30349,4,2,106553,106553,106555,0,2,3
30350,3,1,106556,106556,106557,0,1,1
30351,2,3,106558,106558,106561,0,3,1
30352,3,1,106561,106561,106562,0,1,0
30353,1,1,106562,106562,106563,0,1,0
30354,6,3,106568,106568,106571,0,3,5
30355,5,3,106573,106573,106576,0,3,2
30356,6,3,106579,106579,106582,0,3,3
30357,2,3,106581,106582,106585,1,4,0
30358,5,1,106586,106586,106587,0,1,1
30359,6,3,106592,106592,106595,0,3,5
30360,2,3,106594,106595,106598,1,4,0
30361,6,2,106600,106600,106602,0,2,2
30362,4,3,106604,106604,106607,0,3,2
30363,2,1,106606,106607,106608,1,2,0
30364,1,3,106607,106608,106611,1,4,0
30365,2,2,106609,106611,106613,2,4,0
30366,6,3,106615,106615,106618,0,3,2
30367,4,1,106619,106619,106620,0,1,1
30368,4,1,106623,106623,106624,0,1,3
30369,3,2,106626,106626,106628,0,2,2
30370,5,2,106631,106631,106633,0,2,3
30371,6,3,106637,106637,106640,0,3,4
30372,5,2,106642,106642,106644,0,2,2
30373,5,2,106647,106647,106649,0,2,3
30374,3,1,106650,106650,106651,0,1,1
30375,4,3,106654,106654,106657,0,3,3
30376,5,3,106659,106659,106662,0,3,2
30377,6,2,106665,106665,106667,0,2,3
30378,2,2,106667,106667,106669,0,2,0
30379,1,2,106668,106669,106671,1,3,0
30380,1,1,106669,106671,106672,2,3,0
30381,6,2,106675,106675,106677,0,2,3
30382,3,2,106678,106678,106680,0,2,1
30383,4,3,106682,106682,106685,0,3,2
30384,1,1,106683,106685,106686,2,3,0
30385,5,2,106688,106688,106690,0,2,2
30386,6,1,106694,106694,106695,0,1,4
30387,3,2,106697,106697,106699,0,2,2
30388,4,2,106701,106701,106703,0,2,2
30389,3,1,106704,106704,106705,0,1,1
30390,1,1,106705,106705,106706,0,1,0
30391,4,1,106709,106709,106710,0,1,3
30392,2,3,106711,106711,106714,0,3,1
30393,5,2,106716,106716,106718,0,2,2
30394,3,1,106719,106719,106720,0,1,1
30395,2,2,106721,106721,106723,0,2,1
30396,1,2,106722,106723,106725,1,3,0
30397,4,3,106726,106726,106729,0,3,1
30398,6,1,106732,106732,106733,0,1,3
30399,4,2,106736,106736,106738,0,2,3
30400,6,1,106742,106742,106743,0,1,4
30401,2,1,106744,106744,106745,0,1,1
30402,6,1,106750,106750,106751,0,1,5
30403,2,3,106752,106752,106755,0,3,1
30404,1,1,106753,106755,106756,2,3,0
30405,5,1,106758,106758,106759,0,1,2
30406,2,1,106760,106760,106761,0,1,1
30407,4,2,106764,106764,106766,0,2,3
30408,6,3,106770,106770,106773,0,3,4
30409,1,2,106771,106773,106775,2,4,0
30410,4,2,106775,106775,106777,0,2,0
30411,5,3,106780,106780,106783,0,3,3
30412,1,1,106781,106783,106784,2,3,0
30413,6,2,106787,106787,106789,0,2,3
30414,3,2,106790,106790,106792,0,2,1
30415,2,2,106792,106792,106794,0,2,0
30416,2,2,106794,106794,106796,0,2,0
30417,2,2,106796,106796,106798,0,2,0
30418,4,3,106800,106800,106803,0,3,2
30419,3,3,106803,106803,106806,0,3,0
30420,1,1,106804,106806,106807,2,3,0
30421,5,2,106809,106809,106811,0,2,2
30422,3,3,106812,106812,106815,0,3,1
30423,5,2,106817,106817,106819,0,2,2
30424,6,3,106823,106823,106826,0,3,4
30425,5,2,106828,106828,106830,0,2,2
30426,2,2,106830,106830,106832,0,2,0
30427,6,1,106836,106836,106837,0,1,4
30428,3,1,106839,106839,106840,0,1,2
30429,5,2,106844,106844,106846,0,2,4
30430,4,2,106848,106848,106850,0,2,2
30431,2,1,106850,106850,106851,0,1,0
30432,5,3,106855,106855,106858,0,3,4
30433,6,1,106861,106861,106862,0,1,3
30434,6,1,106867,106867,106868,0,1,5
30435,4,2,106871,106871,106873,0,2,3
30436,1,3,106872,106873,106876,1,4,0
30437,5,2,106877,106877,106879,0,2,1
30438,3,2,106880,106880,106882,0,2,1
30439,3,2,106883,106883,106885,0,2,1
30440,2,1,106885,106885,106886,0,1,0
30441,6,2,106891,106891,106893,0,2,5
30442,2,1,106893,106893,106894,0,1,0
30443,5,1,106898,106898,106899,0,1,4
30444,2,1,106900,106900,106901,0,1,1
30445,2,3,106902,106902,106905,0,3,1
30446,4,2,106906,106906,106908,0,2,1
30447,6,3,106912,106912,106915,0,3,4
30448,4,1,106916,106916,106917,0,1,1
30449,6,3,106922,106922,106925,0,3,5
30450,2,2,106924,106925,106927,1,3,0
30451,3,2,106927,106927,106929,0,2,0
30452,5,3,106932,106932,106935,0,3,3
30453,5,3,106937,106937,106940,0,3,2
30454,3,2,106940,106940,106942,0,2,0
30455,5,1,106945,106945,106946,0,1,3
30456,3,1,106948,106948,106949,0,1,2
30457,1,1,106949,106949,106950,0,1,0
30458,2,2,106951,106951,106953,0,2,1
30459,6,2,106957,106957,106959,0,2,4
30460,3,1,106960,106960,106961,0,1,1
30461,3,3,106963,106963,106966,0,3,2
30462,4,3,106967,106967,106970,0,3,1
30463,5,1,106972,106972,106973,0,1,2
30464,3,2,106975,106975,106977,0,2,2
30465,4,3,106979,106979,106982,0,3,2
30466,2,2,106981,106982,106984,1,3,0
30467,6,1,106987,106987,106988,0,1,3
30468,3,2,106990,106990,106992,0,2,2
30469,4,3,106994,106994,106997,0,3,2
30470,3,3,106997,106997,107000,0,3,0
30471,2,1,106999,107000,107001,1,2,0
30472,2,3,107001,107001,107004,0,3,0
30473,2,3,107003,107004,107007,1,4,0
30474,1,3,107004,107007,107010,3,6,0
30475,3,2,107007,107010,107012,3,5,0
30476,4,1,107011,107012,107013,1,2,0
30477,2,2,107013,107013,107015,0,2,0
30478,4,3,107017,107017,107020,0,3,2
30479,1,3,107018,107020,107023,2,5,0
30480,2,1,107020,107023,107024,3,4,0
30481,6,3,107026,107026,107029,0,3,2
30482,4,3,107030,107030,107033,0,3,1
30483,5,2,107035,107035,107037,0,2,2
30484,5,1,107040,107040,107041,0,1,3
30485,4,1,107044,107044,107045,0,1,3
30486,5,1,107049,107049,107050,0,1,4
30487,4,3,107053,107053,107056,0,3,3
30488,2,2,107055,107056,107058,1,3,0
30489,5,1,107060,107060,107061,0,1,2
30490,1,1,107061,107061,107062,0,1,0
30491,1,3,107062,107062,107065,0,3,0
30492,3,3,107065,107065,107068,0,3,0
30493,4,2,107069,107069,107071,0,2,1
30494,6,3,107075,107075,107078,0,3,4
30495,2,1,107077,107078,107079,1,2,0
30496,6,1,107083,107083,107084,0,1,4
30497,4,2,107087,107087,107089,0,2,3
30498,4,2,107091,107091,107093,0,2,2
30499,5,2,107096,107096,107098,0,2,3
30500,3,1,107099,107099,107100,0,1,1
30501,3,1,107102,107102,107103,0,1,2
30502,4,3,107106,107106,107109,0,3,3
30503,3,1,107109,107109,107110,0,1,0
30504,5,1,107114,107114,107115,0,1,4
30505,2,3,107116,107116,107119,0,3,1
30506,1,1,107117,107119,107120,2,3,0
30507,1,2,107118,107120,107122,2,4,0
30508,1,1,107119,107122,107123,3,4,0
30509,1,1,107120,107123,107124,3,4,0
30510,4,3,107124,107124,107127,0,3,0
30511,5,3,107129,107129,107132,0,3,2
30512,4,2,107133,107133,107135,0,2,1
30513,6,2,107139,107139,107141,0,2,4
30514,6,3,107145,107145,107148,0,3,4
30515,6,3,107151,107151,107154,0,3,3
30516,2,1,107153,107154,107155,1,2,0
30517,4,3,107157,107157,107160,0,3,2
30518,3,1,107160,107160,107161,0,1,0
30519,5,2,107165,107165,107167,0,2,4
30520,4,2,107169,107169,107171,0,2,2
30521,3,3,107172,107172,107175,0,3,1
30522,2,2,107174,107175,107177,1,3,0
30523,4,3,107178,107178,107181,0,3,1
30524,4,2,107182,107182,107184,0,2,1
30525,3,1,107185,107185,107186,0,1,1
30526,1,2,107186,107186,107188,0,2,0
30527,6,1,107192,107192,107193,0,1,4
30528,4,3,107196,107196,107199,0,3,3
30529,4,2,107200,107200,107202,0,2,1
30530,4,3,107204,107204,107207,0,3,2
30531,2,3,107206,107207,107210,1,4,0
30532,1,3,107207,107210,107213,3,6,0
30533,5,1,107212,107213,107214,1,2,0
30534,6,1,107218,107218,107219,0,1,4
30535,1,1,107219,107219,107220,0,1,0
30536,6,1,107225,107225,107226,0,1,5
30537,1,2,107226,107226,107228,0,2,0
30538,1,3,107227,107228,107231,1,4,0
30539,6,1,107233,107233,107234,0,1,2
30540,3,3,107236,107236,107239,0,3,2
30541,6,2,107242,107242,107244,0,2,3
30542,6,3,107248,107248,107251,0,3,4
30543,5,2,107253,107253,107255,0,2,2
30544,4,1,107257,107257,107258,0,1,2
30545,5,1,107262,107262,107263,0,1,4
30546,2,2,107264,107264,107266,0,2,1
30547,2,1,107266,107266,107267,0,1,0
30548,2,1,107268,107268,107269,0,1,1
30549,6,2,107274,107274,107276,0,2,5
30550,6,2,107280,107280,107282,0,2,4
30551,2,2,107282,107282,107284,0,2,0
30552,4,2,107286,107286,107288,0,2,2
30553,6,1,107292,107292,107293,0,1,4
30554,1,3,107293,107293,107296,0,3,0
30555,4,2,107297,107297,107299,0,2,1
30556,3,2,107300,107300,107302,0,2,1
30557,1,3,107301,107302,107305,1,4,0
30558,2,1,107303,107305,107306,2,3,0
30559,1,2,107304,107306,107308,2,4,0
30560,2,2,107306,107308,107310,2,4,0
30561,5,3,107311,107311,107314,0,3,1
30562,1,2,107312,107314,107316,2,4,0
30563,2,1,107314,107316,107317,2,3,0
30564,4,1,107318,107318,107319,0,1,1
30565,5,3,107323,107323,107326,0,3,4
30566,5,1,107328,107328,107329,0,1,2
30567,3,2,107331,107331,107333,0,2,2
30568,1,3,107332,107333,107336,1,4,0
30569,2,3,107334,107336,107339,2,5,0
30570,5,1,107339,107339,107340,0,1,0
30571,2,2,107341,107341,107343,0,2,1
30572,3,2,107344,107344,107346,0,2,1
30573,4,2,107348,107348,107350,0,2,2
30574,4,2,107352,107352,107354,0,2,2
30575,5,2,107357,107357,107359,0,2,3
30576,3,3,107360,107360,107363,0,3,1
30577,3,3,107363,107363,107366,0,3,0
30578,3,2,107366,107366,107368,0,2,0
30579,3,3,107369,107369,107372,0,3,1
30580,1,2,107370,107372,107374,2,4,0
30581,3,1,107373,107374,107375,1,2,0
30582,1,1,107374,107375,107376,1,2,0
30583,1,3,107375,107376,107379,1,4,0
30584,6,1,107381,107381,107382,0,1,2
30585,3,1,107384,107384,107385,0,1,2
30586,5,1,107389,107389,107390,0,1,4
30587,4,3,107393,107393,107396,0,3,3
30588,4,2,107397,107397,107399,0,2,1
30589,4,1,107401,107401,107402,0,1,2
30590,6,2,107407,107407,107409,0,2,5
30591,6,1,107413,107413,107414,0,1,4
30592,2,2,107415,107415,107417,0,2,1
30593,2,3,107417,107417,107420,0,3,0
30594,4,2,107421,107421,107423,0,2,1
30595,3,1,107424,107424,107425,0,1,1
30596,5,3,107429,107429,107432,0,3,4
30597,1,3,107430,107432,107435,2,5,0
30598,1,3,107431,107435,107438,4,7,0
30599,5,2,107436,107438,107440,2,4,0
30600,6,1,107442,107442,107443,0,1,2
30601,2,3,107444,107444,107447,0,3,1
30602,6,1,107450,107450,107451,0,1,3
30603,4,2,107454,107454,107456,0,2,3
30604,6,3,107460,107460,107463,0,3,4
30605,5,1,107465,107465,107466,0,1,2
30606,3,3,107468,107468,107471,0,3,2
30607,1,2,107469,107471,107473,2,4,0
30608,5,2,107474,107474,107476,0,2,1
30609,4,2,107478,107478,107480,0,2,2
30610,3,3,107481,107481,107484,0,3,1
30611,3,3,107484,107484,107487,0,3,0
30612,3,3,107487,107487,107490,0,3,0
30613,2,2,107489,107490,107492,1,3,0
30614,5,1,107494,107494,107495,0,1,2
30615,2,2,107496,107496,107498,0,2,1
30616,6,1,107502,107502,107503,0,1,4
30617,2,2,107504,107504,107506,0,2,1
30618,1,3,107505,107506,107509,1,4,0
30619,3,1,107508,107509,107510,1,2,0
30620,5,2,107513,107513,107515,0,2,3
30621,3,1,107516,107516,107517,0,1,1
30622,3,3,107519,107519,107522,0,3,2
30623,4,1,107523,107523,107524,0,1,1
30624,1,1,107524,107524,107525,0,1,0
30625,6,2,107530,107530,107532,0,2,5
30626,6,1,107536,107536,107537,0,1,4
30627,1,2,107537,107537,107539,0,2,0
30628,4,1,107541,107541,107542,0,1,2
30629,1,2,107542,107542,107544,0,2,0
30630,4,2,107546,107546,107548,0,2,2
30631,5,1,107551,107551,107552,0,1,3
30632,6,1,107557,107557,107558,0,1,5
30633,5,3,107562,107562,107565,0,3,4
30634,5,3,107567,107567,107570,0,3,2
30635,4,2,107571,107571,107573,0,2,1
30636,1,3,107572,107573,107576,1,4,0
30637,3,2,107575,107576,107578,1,3,0
30638,3,2,107578,107578,107580,0,2,0
30639,2,2,107580,107580,107582,0,2,0
30640,2,2,107582,107582,107584,0,2,0
30641,6,3,107588,107588,107591,0,3,4
30642,6,2,107594,107594,107596,0,2,3
30643,1,1,107595,107596,107597,1,2,0
30644,6,2,107601,107601,107603,0,2,4
30645,1,1,107602,107603,107604,1,2,0
30646,4,3,107606,107606,107609,0,3,2
30647,5,2,107611,107611,107613,0,2,2
30648,4,2,107615,107615,107617,0,2,2
30649,4,3,107619,107619,107622,0,3,2
30650,5,2,107624,107624,107626,0,2,2
30651,4,3,107628,107628,107631,0,3,2
30652,6,2,107634,107634,107636,0,2,3
30653,2,1,107636,107636,107637,0,1,0
30654,3,2,107639,107639,107641,0,2,2
30655,1,2,107640,107641,107643,1,3,0
30656,4,1,107644,107644,107645,0,1,1
30657,5,3,107649,107649,107652,0,3,4
30658,6,3,107655,107655,107658,0,3,3
30659,1,1,107656,107658,107659,2,3,0
30660,3,2,107659,107659,107661,0,2,0
30661,3,2,107662,107662,107664,0,2,1
30662,5,3,107667,107667,107670,0,3,3
30663,1,1,107668,107670,107671,2,3,0
30664,5,3,107673,107673,107676,0,3,2
30665,3,2,107676,107676,107678,0,2,0
30666,2,1,107678,107678,107679,0,1,0
30667,2,1,107680,107680,107681,0,1,1
30668,3,3,107683,107683,107686,0,3,2
30669,2,2,107685,107686,107688,1,3,0
30670,4,2,107689,107689,107691,0,2,1
30671,6,1,107695,107695,107696,0,1,4
30672,6,3,107701,107701,107704,0,3,5
30673,6,2,107707,107707,107709,0,2,3
30674,6,3,107713,107713,107716,0,3,4
30675,5,2,107718,107718,107720,0,2,2
30676,1,3,107719,107720,107723,1,4,0
30677,3,2,107722,107723,107725,1,3,0
30678,3,3,107725,107725,107728,0,3,0
30679,6,2,107731,107731,107733,0,2,3
30680,4,2,107735,107735,107737,0,2,2
30681,2,2,107737,107737,107739,0,2,0
30682,5,3,107742,107742,107745,0,3,3
30683,4,2,107746,107746,107748,0,2,1
30684,5,1,107751,107751,107752,0,1,3
30685,6,1,107757,107757,107758,0,1,5
30686,2,1,107759,107759,107760,0,1,1
30687,1,3,107760,107760,107763,0,3,0
30688,4,3,107764,107764,107767,0,3,1
30689,3,1,107767,107767,107768,0,1,0
30690,2,2,107769,107769,107771,0,2,1
30691,5,1,107774,107774,107775,0,1,3
30692,1,1,107775,107775,107776,0,1,0
30693,2,2,107777,107777,107779,0,2,1
30694,5,3,107782,107782,107785,0,3,3
30695,2,2,107784,107785,107787,1,3,0
30696,5,2,107789,107789,107791,0,2,2
30697,1,2,107790,107791,107793,1,3,0
30698,2,1,107792,107793,107794,1,2,0
30699,3,2,107795,107795,107797,0,2,1
30700,6,2,107801,107801,107803,0,2,4
30701,6,1,107807,107807,107808,0,1,4
30702,6,1,107813,107813,107814,0,1,5
30703,3,1,107816,107816,107817,0,1,2
30704,2,1,107818,107818,107819,0,1,1
30705,3,1,107821,107821,107822,0,1,2
30706,1,3,107822,107822,107825,0,3,0
30707,4,2,107826,107826,107828,0,2,1
30708,6,3,107832,107832,107835,0,3,4
30709,1,3,107833,107835,107838,2,5,0
30710,6,1,107839,107839,107840,0,1,1
30711,4,1,107843,107843,107844,0,1,3
30712,4,1,107847,107847,107848,0,1,3
30713,5,3,107852,107852,107855,0,3,4
30714,4,3,107856,107856,107859,0,3,1
30715,4,1,107860,107860,107861,0,1,1
30716,2,1,107862,107862,107863,0,1,1
30717,3,1,107865,107865,107866,0,1,2
30718,6,3,107871,107871,107874,0,3,5
30719,5,1,107876,107876,107877,0,1,2
30720,4,2,107880,107880,107882,0,2,3
30721,1,3,107881,107882,107885,1,4,0
30722,6,3,107887,107887,107890,0,3,2
30723,6,2,107893,107893,107895,0,2,3
30724,3,2,107896,107896,107898,0,2,1
30725,5,2,107901,107901,107903,0,2,3
30726,6,1,107907,107907,107908,0,1,4
30727,1,1,107908,107908,107909,0,1,0
30728,4,3,107912,107912,107915,0,3,3
30729,2,3,107914,107915,107918,1,4,0
30730,2,1,107916,107918,107919,2,3,0
30731,1,3,107917,107919,107922,2,5,0
30732,2,1,107919,107922,107923,3,4,0
30733,1,3,107920,107923,107926,3,6,0
30734,3,3,107923,107926,107929,3,6,0
30735,3,1,107926,107929,107930,3,4,0
30736,4,1,107930,107930,107931,0,1,0
30737,3,3,107933,107933,107936,0,3,2
30738,2,3,107935,107936,107939,1,4,0
30739,2,1,107937,107939,107940,2,3,0
30740,3,2,107940,107940,107942,0,2,0
30741,6,2,107946,107946,107948,0,2,4
30742,5,2,107951,107951,107953,0,2,3
30743,5,3,107956,107956,107959,0,3,3
30744,1,1,107957,107959,107960,2,3,0
30745,1,3,107958,107960,107963,2,5,0
30746,6,1,107964,107964,107965,0,1,1
30747,5,1,107969,107969,107970,0,1,4
30748,4,2,107973,107973,107975,0,2,3
30749,4,3,107977,107977,107980,0,3,2
30750,6,1,107983,107983,107984,0,1,3
30751,5,1,107988,107988,107989,0,1,4
30752,6,1,107994,107994,107995,0,1,5
30753,6,3,108000,108000,108003,0,3,5
30754,6,1,108006,108006,108007,0,1,3
30755,1,1,108007,108007,108008,0,1,0
30756,4,3,108011,108011,108014,0,3,3
30757,6,1,108017,108017,108018,0,1,3
30758,6,1,108023,108023,108024,0,1,5
30759,1,1,108024,108024,108025,0,1,0
30760,5,1,108029,108029,108030,0,1,4
30761,2,1,108031,108031,108032,0,1,1
30762,2,1,108033,108033,108034,0,1,1
30763,6,1,108039,108039,108040,0,1,5
30764,5,3,108044,108044,108047,0,3,4
30765,5,1,108049,108049,108050,0,1,2
30766,4,1,108053,108053,108054,0,1,3
30767,4,2,108057,108057,108059,0,2,3
30768,4,1,108061,108061,108062,0,1,2
30769,4,1,108065,108065,108066,0,1,3
30770,1,1,108066,108066,108067,0,1,0
30771,3,1,108069,108069,108070,0,1,2
30772,4,3,108073,108073,108076,0,3,3
30773,6,2,108079,108079,108081,0,2,3
30774,5,3,108084,108084,108087,0,3,3
30775,5,3,108089,108089,108092,0,3,2
30776,3,2,108092,108092,108094,0,2,0
30777,1,2,108093,108094,108096,1,3,0
30778,2,1,108095,108096,108097,1,2,0
30779,4,3,108099,108099,108102,0,3,2
30780,2,3,108101,108102,108105,1,4,0
30781,5,1,108106,108106,108107,0,1,1
30782,6,2,108112,108112,108114,0,2,5
30783,3,2,108115,108115,108117,0,2,1
30784,3,3,108118,108118,108121,0,3,1
30785,3,3,108121,108121,108124,0,3,0
30786,2,1,108123,108124,108125,1,2,0
30787,1,1,108124,108125,108126,1,2,0
30788,6,2,108130,108130,108132,0,2,4
30789,6,3,108136,108136,108139,0,3,4
30790,5,1,108141,108141,108142,0,1,2
30791,4,2,108145,108145,108147,0,2,3
30792,3,3,108148,108148,108151,0,3,1
30793,4,2,108152,108152,108154,0,2,1
30794,3,1,108155,108155,108156,0,1,1
30795,3,1,108158,108158,108159,0,1,2
30796,5,3,108163,108163,108166,0,3,4
30797,2,3,108165,108166,108169,1,4,0
30798,1,1,108166,108169,108170,3,4,0
30799,3,2,108169,108170,108172,1,3,0
30800,4,1,108173,108173,108174,0,1,1
30801,4,2,108177,108177,108179,0,2,3
30802,4,2,108181,108181,108183,0,2,2
30803,1,2,108182,108183,108185,1,3,0
30804,6,3,108188,108188,108191,0,3,3
30805,6,2,108194,108194,108196,0,2,3
30806,6,2,108200,108200,108202,0,2,4
30807,4,3,108204,108204,108207,0,3,2
30808,1,3,108205,108207,108210,2,5,0
30809,5,1,108210,108210,108211,0,1,0
30810,4,2,108214,108214,108216,0,2,3
30811,4,1,108218,108218,108219,0,1,2
30812,6,3,108224,108224,108227,0,3,5
30813,2,1,108226,108227,108228,1,2,0
30814,5,2,108231,108231,108233,0,2,3
30815,1,2,108232,108233,108235,1,3,0
30816,2,2,108234,108235,108237,1,3,0
30817,1,2,108235,108237,108239,2,4,0
30818,3,1,108238,108239,108240,1,2,0
30819,3,2,108241,108241,108243,0,2,1
30820,1,1,108242,108243,108244,1,2,0
30821,1,2,108243,108244,108246,1,3,0
30822,6,2,108249,108249,108251,0,2,3
30823,5,2,108254,108254,108256,0,2,3
30824,2,1,108256,108256,108257,0,1,0
30825,4,2,108260,108260,108262,0,2,3
30826,4,1,108264,108264,108265,0,1,2
30827,1,3,108265,108265,108268,0,3,0
30828,3,2,108268,108268,108270,0,2,0
30829,4,1,108272,108272,108273,0,1,2
30830,6,2,108278,108278,108280,0,2,5
30831,6,1,108284,108284,108285,0,1,4
30832,5,1,108289,108289,108290,0,1,4
30833,2,2,108291,108291,108293,0,2,1
30834,3,1,108294,108294,108295,0,1,1
30835,6,3,108300,108300,108303,0,3,5
30836,5,2,108305,108305,108307,0,2,2
30837,4,1,108309,108309,108310,0,1,2
30838,5,1,108314,108314,108315,0,1,4
30839,3,3,108317,108317,108320,0,3,2
30840,6,1,108323,108323,108324,0,1,3
30841,6,1,108329,108329,108330,0,1,5
30842,4,1,108333,108333,108334,0,1,3
30843,4,1,108337,108337,108338,0,1,3
30844,2,3,108339,108339,108342,0,3,1
30845,5,3,108344,108344,108347,0,3,2
30846,5,3,108349,108349,108352,0,3,2
30847,6,2,108355,108355,108357,0,2,3
30848,5,3,108360,108360,108363,0,3,3
30849,2,1,108362,108363,108364,1,2,0
30850,5,3,108367,108367,108370,0,3,3
30851,1,1,108368,108370,108371,2,3,0
30852,2,2,108370,108371,108373,1,3,0
30853,4,2,108374,108374,108376,0,2,1
30854,1,3,108375,108376,108379,1,4,0
30855,5,2,108380,108380,108382,0,2,1
30856,2,1,108382,108382,108383,0,1,0
30857,6,1,108388,108388,108389,0,1,5
30858,4,2,108392,108392,108394,0,2,3
30859,5,2,108397,108397,108399,0,2,3
30860,5,2,108402,108402,108404,0,2,3
30861,2,1,108404,108404,108405,0,1,0
30862,6,2,108410,108410,108412,0,2,5
30863,2,2,108412,108412,108414,0,2,0
30864,6,1,108418,108418,108419,0,1,4
30865,4,3,108422,108422,108425,0,3,3
30866,1,2,108423,108425,108427,2,4,0
30867,6,2,108429,108429,108431,0,2,2
30868,5,1,108434,108434,108435,0,1,3
30869,5,3,108439,108439,108442,0,3,4
30870,3,3,108442,108442,108445,0,3,0
30871,1,1,108443,108445,108446,2,3,0
30872,5,1,108448,108448,108449,0,1,2
30873,5,1,108453,108453,108454,0,1,4
30874,2,1,108455,108455,108456,0,1,1
30875,5,2,108460,108460,108462,0,2,4
30876,5,3,108465,108465,108468,0,3,3
30877,2,3,108467,108468,108471,1,4,0
30878,3,2,108470,108471,108473,1,3,0
30879,2,1,108472,108473,108474,1,2,0
30880,6,1,108478,108478,108479,0,1,4
30881,3,2,108481,108481,108483,0,2,2
30882,5,3,108486,108486,108489,0,3,3
30883,1,1,108487,108489,108490,2,3,0
30884,5,2,108492,108492,108494,0,2,2
30885,1,1,108493,108494,108495,1,2,0
30886,3,1,108496,108496,108497,0,1,1
30887,3,1,108499,108499,108500,0,1,2
30888,4,2,108503,108503,108505,0,2,3
30889,6,2,108509,108509,108511,0,2,4
30890,5,2,108514,108514,108516,0,2,3
30891,3,1,108517,108517,108518,0,1,1
30892,6,2,108523,108523,108525,0,2,5
30893,1,2,108524,108525,108527,1,3,0
30894,4,2,108528,108528,108530,0,2,1
30895,5,1,108533,108533,108534,0,1,3
30896,4,3,108537,108537,108540,0,3,3
30897,2,1,108539,108540,108541,1,2,0
30898,6,2,108545,108545,108547,0,2,4
30899,5,1,108550,108550,108551,0,1,3
30900,1,3,108551,108551,108554,0,3,0
30901,4,1,108555,108555,108556,0,1,1
30902,3,2,108558,108558,108560,0,2,2
30903,2,3,108560,108560,108563,0,3,0
30904,4,3,108564,108564,108567,0,3,1
30905,1,3,108565,108567,108570,2,5,0
30906,1,2,108566,108570,108572,4,6,0
30907,1,2,108567,108572,108574,5,7,0
30908,2,1,108569,108574,108575,5,6,0
30909,1,2,108570,108575,108577,5,7,0
30910,1,2,108571,108577,108579,6,8,0
30911,5,1,108576,108579,108580,3,4,0
30912,2,2,108578,108580,108582,2,4,0
30913,4,3,108582,108582,108585,0,3,0
30914,4,1,108586,108586,108587,0,1,1
30915,5,1,108591,108591,108592,0,1,4
30916,6,2,108597,108597,108599,0,2,5
30917,4,3,108601,108601,108604,0,3,2
30918,4,2,108605,108605,108607,0,2,1
30919,2,3,108607,108607,108610,0,3,0
30920,2,3,108609,108610,108613,1,4,0
30921,6,3,108615,108615,108618,0,3,2
30922,2,3,108617,108618,108621,1,4,0
30923,3,2,108620,108621,108623,1,3,0
30924,6,1,108626,108626,108627,0,1,3
30925,4,1,108630,108630,108631,0,1,3
30926,4,3,108634,108634,108637,0,3,3
30927,5,2,108639,108639,108641,0,2,2
30928,6,3,108645,108645,108648,0,3,4
30929,2,1,108647,108648,108649,1,2,0
30930,2,1,108649,108649,108650,0,1,0
30931,3,2,108652,108652,108654,0,2,2
30932,1,2,108653,108654,108656,1,3,0
30933,3,3,108656,108656,108659,0,3,0
30934,2,1,108658,108659,108660,1,2,0
30935,6,3,108664,108664,108667,0,3,4
30936,1,3,108665,108667,108670,2,5,0
30937,5,1,108670,108670,108671,0,1,0
30938,6,1,108676,108676,108677,0,1,5
30939,2,3,108678,108678,108681,0,3,1
30940,3,2,108681,108681,108683,0,2,0
30941,2,3,108683,108683,108686,0,3,0
30942,6,3,108689,108689,108692,0,3,3
30943,2,1,108691,108692,108693,1,2,0
30944,3,1,108694,108694,108695,0,1,1
30945,6,3,108700,108700,108703,0,3,5
30946,5,3,108705,108705,108708,0,3,2
30947,1,1,108706,108708,108709,2,3,0
30948,2,3,108708,108709,108712,1,4,0
30949,2,3,108710,108712,108715,2,5,0
30950,3,1,108713,108715,108716,2,3,0
30951,1,2,108714,108716,108718,2,4,0
30952,4,2,108718,108718,108720,0,2,0
30953,1,2,108719,108720,108722,1,3,0
30954,4,1,108723,108723,108724,0,1,1
30955,3,2,108726,108726,108728,0,2,2
30956,6,3,108732,108732,108735,0,3,4
30957,5,3,108737,108737,108740,0,3,2
30958,6,1,108743,108743,108744,0,1,3
30959,2,2,108745,108745,108747,0,2,1
30960,5,3,108750,108750,108753,0,3,3
30961,5,1,108755,108755,108756,0,1,2
30962,3,2,108758,108758,108760,0,2,2
30963,4,1,108762,108762,108763,0,1,2
30964,6,1,108768,108768,108769,0,1,5
30965,6,1,108774,108774,108775,0,1,5
30966,5,2,108779,108779,108781,0,2,4
30967,1,2,108780,108781,108783,1,3,0
30968,5,3,108785,108785,108788,0,3,2
30969,3,2,108788,108788,108790,0,2,0
30970,2,3,108790,108790,108793,0,3,0
30971,5,2,108795,108795,108797,0,2,2
30972,2,2,108797,108797,108799,0,2,0
30973,6,2,108803,108803,108805,0,2,4
30974,6,1,108809,108809,108810,0,1,4
30975,3,1,108812,108812,108813,0,1,2
30976,2,2,108814,108814,108816,0,2,1
30977,3,1,108817,108817,108818,0,1,1
30978,4,2,108821,108821,108823,0,2,3
30979,4,2,108825,108825,108827,0,2,2
30980,4,1,108829,108829,108830,0,1,2
30981,3,1,108832,108832,108833,0,1,2
30982,1,1,108833,108833,108834,0,1,0
30983,6,2,108839,108839,108841,0,2,5
30984,1,2,108840,108841,108843,1,3,0
30985,6,2,108846,108846,108848,0,2,3
30986,6,3,108852,108852,108855,0,3,4
30987,6,1,108858,108858,108859,0,1,3
30988,6,1,108864,108864,108865,0,1,5
30989,1,3,108865,108865,108868,0,3,0
30990,4,2,108869,108869,108871,0,2,1
30991,3,3,108872,108872,108875,0,3,1
30992,4,3,108876,108876,108879,0,3,1
30993,1,3,108877,108879,108882,2,5,0
30994,2,3,108879,108882,108885,3,6,0
30995,5,2,108884,108885,108887,1,3,0
30996,4,1,108888,108888,108889,0,1,1
30997,1,3,108889,108889,108892,0,3,0
30998,4,1,108893,108893,108894,0,1,1
30999,1,1,108894,108894,108895,0,1,0
31000,2,2,108896,108896,108898,0,2,1
31001,2,2,108898,108898,108900,0,2,0
31002,3,1,108901,108901,108902,0,1,1
31003,5,2,108906,108906,108908,0,2,4
31004,4,2,108910,108910,108912,0,2,2
31005,5,1,108915,108915,108916,0,1,3
31006,3,1,108918,108918,108919,0,1,2
31007,5,3,108923,108923,108926,0,3,4
31008,1,1,108924,108926,108927,2,3,0
31009,6,2,108930,108930,108932,0,2,3
31010,1,3,108931,108932,108935,1,4,0
31011,2,1,108933,108935,108936,2,3,0
31012,2,3,108935,108936,108939,1,4,0
31013,4,2,108939,108939,108941,0,2,0
31014,2,1,108941,108941,108942,0,1,0
31015,3,3,108944,108944,108947,0,3,2
31016,1,1,108945,108947,108948,2,3,0
31017,6,2,108951,108951,108953,0,2,3
31018,6,1,108957,108957,108958,0,1,4
31019,4,1,108961,108961,108962,0,1,3
31020,4,2,108965,108965,108967,0,2,3
31021,6,2,108971,108971,108973,0,2,4
31022,4,3,108975,108975,108978,0,3,2
31023,4,3,108979,108979,108982,0,3,1
31024,4,1,108983,108983,108984,0,1,1
31025,5,2,108988,108988,108990,0,2,4
31026,5,2,108993,108993,108995,0,2,3
31027,1,3,108994,108995,108998,1,4,0
31028,1,2,108995,108998,109000,3,5,0
31029,6,3,109001,109001,109004,0,3,1
31030,4,1,109005,109005,109006,0,1,1
31031,1,1,109006,109006,109007,0,1,0
31032,3,3,109009,109009,109012,0,3,2
31033,3,2,109012,109012,109014,0,2,0
31034,1,1,109013,109014,109015,1,2,0
31035,4,1,109017,109017,109018,0,1,2
31036,1,1,109018,109018,109019,0,1,0
31037,1,3,109019,109019,109022,0,3,0
31038,1,1,109020,109022,109023,2,3,0
31039,2,2,109022,109023,109025,1,3,0
31040,5,3,109027,109027,109030,0,3,2
31041,2,3,109029,109030,109033,1,4,0
31042,3,3,109032,109033,109036,1,4,0
31043,3,2,109035,109036,109038,1,3,0
31044,6,1,109041,109041,109042,0,1,3
31045,6,3,109047,109047,109050,0,3,5
31046,5,2,109052,109052,109054,0,2,2
31047,3,1,109055,109055,109056,0,1,1
31048,3,3,109058,109058,109061,0,3,2
31049,4,3,109062,109062,109065,0,3,1
31050,6,2,109068,109068,109070,0,2,3
31051,5,1,109073,109073,109074,0,1,3
31052,1,2,109074,109074,109076,0,2,0
31053,1,1,109075,109076,109077,1,2,0
31054,5,2,109080,109080,109082,0,2,3
31055,6,1,109086,109086,109087,0,1,4
31056,5,3,109091,109091,109094,0,3,4
31057,5,1,109096,109096,109097,0,1,2
31058,3,1,109099,109099,109100,0,1,2
31059,3,1,109102,109102,109103,0,1,2
31060,6,2,109108,109108,109110,0,2,5
31061,3,2,109111,109111,109113,0,2,1
31062,6,1,109117,109117,109118,0,1,4
31063,1,1,109118,109118,109119,0,1,0
31064,4,2,109122,109122,109124,0,2,3
31065,6,1,109128,109128,109129,0,1,4
31066,2,1,109130,109130,109131,0,1,1
31067,2,1,109132,109132,109133,0,1,1
31068,2,2,109134,109134,109136,0,2,1
31069,3,1,109137,109137,109138,0,1,1
31070,1,2,109138,109138,109140,0,2,0
31071,3,3,109141,109141,109144,0,3,1
31072,2,1,109143,109144,109145,1,2,0
31073,5,2,109148,109148,109150,0,2,3
31074,5,2,109153,109153,109155,0,2,3
31075,1,3,109154,109155,109158,1,4,0
31076,5,2,109159,109159,109161,0,2,1
31077,4,1,109163,109163,109164,0,1,2
31078,6,2,109169,109169,109171,0,2,5
31079,2,1,109171,109171,109172,0,1,0
31080,6,1,109177,109177,109178,0,1,5
31081,4,1,109181,109181,109182,0,1,3
31082,5,2,109186,109186,109188,0,2,4
31083,3,1,109189,109189,109190,0,1,1
31084,6,1,109195,109195,109196,0,1,5
31085,1,1,109196,109196,109197,0,1,0
31086,6,3,109202,109202,109205,0,3,5
31087,2,3,109204,109205,109208,1,4,0
31088,5,1,109209,109209,109210,0,1,1
31089,5,1,109214,109214,109215,0,1,4
31090,5,2,109219,109219,109221,0,2,4
31091,6,3,109225,109225,109228,0,3,4
31092,1,1,109226,109228,109229,2,3,0
31093,2,3,109228,109229,109232,1,4,0
31094,4,2,109232,109232,109234,0,2,0
31095,2,3,109234,109234,109237,0,3,0
31096,5,3,109239,109239,109242,0,3,2
31097,3,3,109242,109242,109245,0,3,0
31098,3,1,109245,109245,109246,0,1,0
31099,6,1,109251,109251,109252,0,1,5
31100,6,1,109257,109257,109258,0,1,5
31101,3,1,109260,109260,109261,0,1,2
31102,5,1,109265,109265,109266,0,1,4
31103,6,1,109271,109271,109272,0,1,5
31104,6,2,109277,109277,109279,0,2,5
31105,2,3,109279,109279,109282,0,3,0
31106,6,3,109285,109285,109288,0,3,3
31107,5,2,109290,109290,109292,0,2,2
31108,2,3,109292,109292,109295,0,3,0
31109,3,1,109295,109295,109296,0,1,0
31110,3,1,109298,109298,109299,0,1,2
31111,3,3,109301,109301,109304,0,3,2
31112,1,3,109302,109304,109307,2,5,0
31113,2,1,109304,109307,109308,3,4,0
31114,4,1,109308,109308,109309,0,1,0
31115,1,3,109309,109309,109312,0,3,0
31116,3,3,109312,109312,109315,0,3,0
31117,2,2,109314,109315,109317,1,3,0
31118,2,2,109316,109317,109319,1,3,0
31119,3,1,109319,109319,109320,0,1,0
31120,3,2,109322,109322,109324,0,2,2
31121,6,1,109328,109328,109329,0,1,4
31122,5,3,109333,109333,109336,0,3,4
31123,6,1,109339,109339,109340,0,1,3
31124,2,1,109341,109341,109342,0,1,1
31125,4,2,109345,109345,109347,0,2,3
31126,2,3,109347,109347,109350,0,3,0
31127,1,1,109348,109350,109351,2,3,0
31128,1,3,109349,109351,109354,2,5,0
31129,1,1,109350,109354,109355,4,5,0
31130,2,3,109352,109355,109358,3,6,0
31131,1,1,109353,109358,109359,5,6,0
31132,6,1,109359,109359,109360,0,1,0
31133,4,1,109363,109363,109364,0,1,3
31134,3,3,109366,109366,109369,0,3,2
31135,3,2,109369,109369,109371,0,2,0
31136,4,3,109373,109373,109376,0,3,2
31137,2,2,109375,109376,109378,1,3,0
31138,3,2,109378,109378,109380,0,2,0
31139,4,3,109382,109382,109385,0,3,2
31140,1,3,109383,109385,109388,2,5,0
31141,1,2,109384,109388,109390,4,6,0
31142,4,1,109388,109390,109391,2,3,0
31143,5,2,109393,109393,109395,0,2,2
31144,2,2,109395,109395,109397,0,2,0
31145,4,3,109399,109399,109402,0,3,2
31146,1,3,109400,109402,109405,2,5,0
31147,3,2,109403,109405,109407,2,4,0
31148,2,2,109405,109407,109409,2,4,0
31149,4,1,109409,109409,109410,0,1,0
31150,6,1,109415,109415,109416,0,1,5
31151,6,3,109421,109421,109424,0,3,5
31152,5,3,109426,109426,109429,0,3,2
31153,2,2,109428,109429,109431,1,3,0
31154,1,1,109429,109431,109432,2,3,0
31155,5,1,109434,109434,109435,0,1,2
31156,3,1,109437,109437,109438,0,1,2
31157,2,1,109439,109439,109440,0,1,1
31158,3,1,109442,109442,109443,0,1,2
31159,2,3,109444,109444,109447,0,3,1
31160,4,3,109448,109448,109451,0,3,1
31161,4,2,109452,109452,109454,0,2,1
31162,2,2,109454,109454,109456,0,2,0
31163,6,2,109460,109460,109462,0,2,4
31164,4,3,109464,109464,109467,0,3,2
31165,3,1,109467,109467,109468,0,1,0
31166,3,3,109470,109470,109473,0,3,2
31167,6,3,109476,109476,109479,0,3,3
31168,2,2,109478,109479,109481,1,3,0
31169,5,3,109483,109483,109486,0,3,2
31170,4,3,109487,109487,109490,0,3,1
31171,4,1,109491,109491,109492,0,1,1
31172,4,1,109495,109495,109496,0,1,3
31173,1,1,109496,109496,109497,0,1,0
31174,4,3,109500,109500,109503,0,3,3
31175,4,2,109504,109504,109506,0,2,1
31176,4,3,109508,109508,109511,0,3,2
31177,2,3,109510,109511,109514,1,4,0
31178,5,3,109515,109515,109518,0,3,1
31179,3,2,109518,109518,109520,0,2,0
31180,1,1,109519,109520,109521,1,2,0
31181,4,3,109523,109523,109526,0,3,2
31182,5,2,109528,109528,109530,0,2,2
31183,2,3,109530,109530,109533,0,3,0
31184,4,2,109534,109534,109536,0,2,1
31185,5,3,109539,109539,109542,0,3,3
31186,3,3,109542,109542,109545,0,3,0
31187,4,3,109546,109546,109549,0,3,1
31188,2,3,109548,109549,109552,1,4,0
31189,5,2,109553,109553,109555,0,2,1
31190,2,3,109555,109555,109558,0,3,0
31191,2,3,109557,109558,109561,1,4,0
31192,1,1,109558,109561,109562,3,4,0
31193,5,3,109563,109563,109566,0,3,1
31194,5,3,109568,109568,109571,0,3,2
31195,3,2,109571,109571,109573,0,2,0
31196,1,1,109572,109573,109574,1,2,0
31197,5,3,109577,109577,109580,0,3,3
31198,5,2,109582,109582,109584,0,2,2
31199,6,1,109588,109588,109589,0,1,4
31200,5,2,109593,109593,109595,0,2,4
31201,1,2,109594,109595,109597,1,3,0
31202,6,3,109600,109600,109603,0,3,3
31203,6,2,109606,109606,109608,0,2,3
31204,5,2,109611,109611,109613,0,2,3
31205,2,1,109613,109613,109614,0,1,0
31206,3,3,109616,109616,109619,0,3,2
31207,4,2,109620,109620,109622,0,2,1
31208,2,1,109622,109622,109623,0,1,0
31209,6,2,109628,109628,109630,0,2,5
31210,3,3,109631,109631,109634,0,3,1
31211,6,2,109637,109637,109639,0,2,3
31212,4,1,109641,109641,109642,0,1,2
31213,4,3,109645,109645,109648,0,3,3
31214,4,2,109649,109649,109651,0,2,1
31215,1,2,109650,109651,109653,1,3,0
31216,1,3,109651,109653,109656,2,5,0
31217,3,3,109654,109656,109659,2,5,0
31218,2,2,109656,109659,109661,3,5,0
31219,3,3,109659,109661,109664,2,5,0
31220,3,3,109662,109664,109667,2,5,0
31221,1,1,109663,109667,109668,4,5,0
31222,6,3,109669,109669,109672,0,3,1
31223,5,3,109674,109674,109677,0,3,2
31224,6,3,109680,109680,109683,0,3,3
31225,5,2,109685,109685,109687,0,2,2
31226,1,2,109686,109687,109689,1,3,0
31227,5,1,109691,109691,109692,0,1,2
31228,5,3,109696,109696,109699,0,3,4
31229,3,1,109699,109699,109700,0,1,0
31230,2,2,109701,109701,109703,0,2,1
31231,5,3,109706,109706,109709,0,3,3
31232,1,1,109707,109709,109710,2,3,0
31233,2,1,109709,109710,109711,1,2,0
31234,6,1,109715,109715,109716,0,1,4
31235,4,3,109719,109719,109722,0,3,3
31236,5,1,109724,109724,109725,0,1,2
31237,2,1,109726,109726,109727,0,1,1
31238,2,2,109728,109728,109730,0,2,1
31239,6,3,109734,109734,109737,0,3,4
31240,3,3,109737,109737,109740,0,3,0
31241,3,1,109740,109740,109741,0,1,0
31242,2,1,109742,109742,109743,0,1,1
31243,4,2,109746,109746,109748,0,2,3
31244,3,3,109749,109749,109752,0,3,1
31245,5,1,109754,109754,109755,0,1,2
31246,4,2,109758,109758,109760,0,2,3
31247,3,3,109761,109761,109764,0,3,1
31248,5,3,109766,109766,109769,0,3,2
31249,3,3,109769,109769,109772,0,3,0
31250,6,3,109775,109775,109778,0,3,3
31251,4,3,109779,109779,109782,0,3,1
31252,1,1,109780,109782,109783,2,3,0
31253,4,1,109784,109784,109785,0,1,1
31254,6,1,109790,109790,109791,0,1,5
31255,4,2,109794,109794,109796,0,2,3
31256,5,3,109799,109799,109802,0,3,3
31257,5,2,109804,109804,109806,0,2,2
31258,3,1,109807,109807,109808,0,1,1
31259,3,1,109810,109810,109811,0,1,2
31260,4,1,109814,109814,109815,0,1,3
31261,4,1,109818,109818,109819,0,1,3
31262,4,1,109822,109822,109823,0,1,3
31263,6,3,109828,109828,109831,0,3,5
31264,1,1,109829,109831,109832,2,3,0
31265,6,3,109835,109835,109838,0,3,3
31266,5,1,109840,109840,109841,0,1,2
31267,6,3,109846,109846,109849,0,3,5
31268,2,2,109848,109849,109851,1,3,0
31269,3,3,109851,109851,109854,0,3,0
31270,3,2,109854,109854,109856,0,2,0
31271,6,3,109860,109860,109863,0,3,4
31272,2,3,109862,109863,109866,1,4,0
31273,4,3,109866,109866,109869,0,3,0
31274,1,2,109867,109869,109871,2,4,0
31275,2,2,109869,109871,109873,2,4,0
31276,1,3,109870,109873,109876,3,6,0
31277,2,2,109872,109876,109878,4,6,0
31278,1,3,109873,109878,109881,5,8,0
31279,5,3,109878,109881,109884,3,6,0
31280,1,2,109879,109884,109886,5,7,0
31281,1,1,109880,109886,109887,6,7,0
31282,4,3,109884,109887,109890,3,6,0
31283,5,1,109889,109890,109891,1,2,0
31284,3,3,109892,109892,109895,0,3,1
31285,5,1,109897,109897,109898,0,1,2
31286,1,2,109898,109898,109900,0,2,0
31287,1,2,109899,109900,109902,1,3,0
31288,2,2,109901,109902,109904,1,3,0
31289,6,2,109907,109907,109909,0,2,3
31290,2,2,109909,109909,109911,0,2,0
31291,5,3,109914,109914,109917,0,3,3
31292,2,3,109916,109917,109920,1,4,0
31293,6,3,109922,109922,109925,0,3,2
31294,6,3,109928,109928,109931,0,3,3
31295,1,1,109929,109931,109932,2,3,0
31296,1,3,109930,109932,109935,2,5,0
31297,1,3,109931,109935,109938,4,7,0
31298,5,3,109936,109938,109941,2,5,0
31299,4,2,109940,109941,109943,1,3,0
31300,2,1,109942,109943,109944,1,2,0
31301,4,2,109946,109946,109948,0,2,2
31302,2,1,109948,109948,109949,0,1,0
31303,4,2,109952,109952,109954,0,2,3
31304,3,1,109955,109955,109956,0,1,1
31305,3,3,109958,109958,109961,0,3,2
31306,4,2,109962,109962,109964,0,2,1
31307,3,2,109965,109965,109967,0,2,1
31308,4,2,109969,109969,109971,0,2,2
31309,2,1,109971,109971,109972,0,1,0
31310,4,1,109975,109975,109976,0,1,3
31311,2,3,109977,109977,109980,0,3,1
31312,1,2,109978,109980,109982,2,4,0
31313,3,1,109981,109982,109983,1,2,0
31314,3,2,109984,109984,109986,0,2,1
31315,5,1,109989,109989,109990,0,1,3
31316,6,2,109995,109995,109997,0,2,5
31317,3,1,109998,109998,109999,0,1,1
31318,3,3,110001,110001,110004,0,3,2
31319,2,1,110003,110004,110005,1,2,0
31320,5,3,110008,110008,110011,0,3,3
31321,5,1,110013,110013,110014,0,1,2
31322,3,2,110016,110016,110018,0,2,2
31323,3,3,110019,110019,110022,0,3,1
31324,2,1,110021,110022,110023,1,2,0
31325,1,1,110022,110023,110024,1,2,0
31326,1,2,110023,110024,110026,1,3,0
31327,4,2,110027,110027,110029,0,2,1
31328,6,2,110033,110033,110035,0,2,4
31329,5,1,110038,110038,110039,0,1,3
31330,4,3,110042,110042,110045,0,3,3
31331,5,2,110047,110047,110049,0,2,2
31332,2,2,110049,110049,110051,0,2,0
31333,4,3,110053,110053,110056,0,3,2
31334,3,1,110056,110056,110057,0,1,0
31335,5,1,110061,110061,110062,0,1,4
31336,4,3,110065,110065,110068,0,3,3
31337,4,2,110069,110069,110071,0,2,1
31338,5,1,110074,110074,110075,0,1,3
31339,2,3,110076,110076,110079,0,3,1
31340,2,3,110078,110079,110082,1,4,0
31341,2,3,110080,110082,110085,2,5,0
31342,6,2,110086,110086,110088,0,2,1
31343,2,2,110088,110088,110090,0,2,0
31344,3,3,110091,110091,110094,0,3,1
31345,3,3,110094,110094,110097,0,3,0
31346,5,1,110099,110099,110100,0,1,2
31347,5,2,110104,110104,110106,0,2,4
31348,3,3,110107,110107,110110,0,3,1
31349,3,1,110110,110110,110111,0,1,0
31350,1,2,110111,110111,110113,0,2,0
31351,2,1,110113,110113,110114,0,1,0
31352,5,2,110118,110118,110120,0,2,4
31353,5,1,110123,110123,110124,0,1,3
31354,1,2,110124,110124,110126,0,2,0
31355,4,2,110128,110128,110130,0,2,2
31356,5,1,110133,110133,110134,0,1,3
31357,4,2,110137,110137,110139,0,2,3
31358,6,2,110143,110143,110145,0,2,4
31359,4,1,110147,110147,110148,0,1,2
31360,6,3,110153,110153,110156,0,3,5
31361,1,1,110154,110156,110157,2,3,0
31362,3,2,110157,110157,110159,0,2,0
31363,5,3,110162,110162,110165,0,3,3
31364,5,1,110167,110167,110168,0,1,2
31365,5,1,110172,110172,110173,0,1,4
31366,1,2,110173,110173,110175,0,2,0
31367,5,2,110178,110178,110180,0,2,3
31368,4,2,110182,110182,110184,0,2,2
31369,3,3,110185,110185,110188,0,3,1
31370,1,2,110186,110188,110190,2,4,0
31371,5,2,110191,110191,110193,0,2,1
31372,4,2,110195,110195,110197,0,2,2
31373,1,3,110196,110197,110200,1,4,0
31374,2,2,110198,110200,110202,2,4,0
31375,2,3,110200,110202,110205,2,5,0
31376,2,1,110202,110205,110206,3,4,0
31377,5,2,110207,110207,110209,0,2,1
31378,4,3,110211,110211,110214,0,3,2
31379,4,3,110215,110215,110218,0,3,1
31380,5,2,110220,110220,110222,0,2,2
31381,4,2,110224,110224,110226,0,2,2
31382,6,3,110230,110230,110233,0,3,4
31383,1,3,110231,110233,110236,2,5,0
31384,4,3,110235,110236,110239,1,4,0
31385,1,2,110236,110239,110241,3,5,0
31386,4,3,110240,110241,110244,1,4,0
31387,1,1,110241,110244,110245,3,4,0
31388,6,3,110247,110247,110250,0,3,2
31389,6,1,110253,110253,110254,0,1,3
31390,2,2,110255,110255,110257,0,2,1
31391,1,3,110256,110257,110260,1,4,0
31392,3,3,110259,110260,110263,1,4,0
31393,5,1,110264,110264,110265,0,1,1
31394,1,1,110265,110265,110266,0,1,0
31395,5,2,110270,110270,110272,0,2,4
31396,1,3,110271,110272,110275,1,4,0
31397,3,1,110274,110275,110276,1,2,0
31398,1,3,110275,110276,110279,1,4,0
31399,5,1,110280,110280,110281,0,1,1
31400,1,3,110281,110281,110284,0,3,0
31401,1,2,110282,110284,110286,2,4,0
31402,5,3,110287,110287,110290,0,3,1
31403,1,3,110288,110290,110293,2,5,0
31404,1,1,110289,110293,110294,4,5,0
31405,2,1,110291,110294,110295,3,4,0
31406,1,3,110292,110295,110298,3,6,0
31407,3,2,110295,110298,110300,3,5,0
31408,1,3,110296,110300,110303,4,7,0
31409,2,1,110298,110303,110304,5,6,0
31410,3,1,110301,110304,110305,3,4,0
31411,5,1,110306,110306,110307,0,1,1
31412,2,3,110308,110308,110311,0,3,1
31413,6,1,110314,110314,110315,0,1,3
31414,3,2,110317,110317,110319,0,2,2
31415,3,3,110320,110320,110323,0,3,1
31416,2,1,110322,110323,110324,1,2,0
31417,5,1,110327,110327,110328,0,1,3
31418,6,1,110333,110333,110334,0,1,5
31419,3,1,110336,110336,110337,0,1,2
31420,4,3,110340,110340,110343,0,3,3
31421,4,2,110344,110344,110346,0,2,1
31422,3,3,110347,110347,110350,0,3,1
31423,4,1,110351,110351,110352,0,1,1
31424,3,2,110354,110354,110356,0,2,2
31425,4,1,110358,110358,110359,0,1,2
31426,2,2,110360,110360,110362,0,2,1
31427,3,2,110363,110363,110365,0,2,1
31428,2,2,110365,110365,110367,0,2,0
31429,4,2,110369,110369,110371,0,2,2
31430,5,3,110374,110374,110377,0,3,3
31431,2,2,110376,110377,110379,1,3,0
31432,3,3,110379,110379,110382,0,3,0
31433,6,3,110385,110385,110388,0,3,3
31434,1,1,110386,110388,110389,2,3,0
31435,1,1,110387,110389,110390,2,3,0
31436,1,2,110388,110390,110392,2,4,0
31437,4,2,110392,110392,110394,0,2,0
31438,5,3,110397,110397,110400,0,3,3
31439,2,1,110399,110400,110401,1,2,0
31440,6,3,110405,110405,110408,0,3,4
31441,3,3,110408,110408,110411,0,3,0
31442,2,3,110410,110411,110414,1,4,0
31443,6,3,110416,110416,110419,0,3,2
31444,2,2,110418,110419,110421,1,3,0
31445,3,2,110421,110421,110423,0,2,0
31446,4,1,110425,110425,110426,0,1,2
31447,4,2,110429,110429,110431,0,2,3
31448,5,2,110434,110434,110436,0,2,3
31449,2,1,110436,110436,110437,0,1,0
31450,6,2,110442,110442,110444,0,2,5
31451,4,1,110446,110446,110447,0,1,2
31452,4,1,110450,110450,110451,0,1,3
31453,6,3,110456,110456,110459,0,3,5
31454,3,3,110459,110459,110462,0,3,0
31455,6,1,110465,110465,110466,0,1,3
31456,2,3,110467,110467,110470,0,3,1
31457,6,3,110473,110473,110476,0,3,3
31458,2,1,110475,110476,110477,1,2,0
31459,6,2,110481,110481,110483,0,2,4
31460,2,2,110483,110483,110485,0,2,0
31461,5,2,110488,110488,110490,0,2,3
31462,5,3,110493,110493,110496,0,3,3
31463,4,2,110497,110497,110499,0,2,1
31464,1,2,110498,110499,110501,1,3,0
31465,4,3,110502,110502,110505,0,3,1
31466,3,3,110505,110505,110508,0,3,0
31467,2,1,110507,110508,110509,1,2,0
31468,2,2,110509,110509,110511,0,2,0
31469,4,1,110513,110513,110514,0,1,2
31470,2,1,110515,110515,110516,0,1,1
31471,1,3,110516,110516,110519,0,3,0
31472,5,1,110521,110521,110522,0,1,2
31473,4,2,110525,110525,110527,0,2,3
31474,3,2,110528,110528,110530,0,2,1
31475,6,2,110534,110534,110536,0,2,4
31476,4,1,110538,110538,110539,0,1,2
31477,3,3,110541,110541,110544,0,3,2
31478,5,3,110546,110546,110549,0,3,2
31479,1,2,110547,110549,110551,2,4,0
31480,3,3,110550,110551,110554,1,4,0
31481,6,3,110556,110556,110559,0,3,2
31482,4,1,110560,110560,110561,0,1,1
31483,2,3,110562,110562,110565,0,3,1
31484,2,3,110564,110565,110568,1,4,0
31485,4,3,110568,110568,110571,0,3,0
31486,1,3,110569,110571,110574,2,5,0
31487,2,1,110571,110574,110575,3,4,0
31488,3,1,110574,110575,110576,1,2,0
31489,3,1,110577,110577,110578,0,1,1
31490,5,2,110582,110582,110584,0,2,4
31491,2,3,110584,110584,110587,0,3,0
31492,5,2,110589,110589,110591,0,2,2
31493,2,2,110591,110591,110593,0,2,0
31494,5,2,110596,110596,110598,0,2,3
31495,4,3,110600,110600,110603,0,3,2
31496,2,1,110602,110603,110604,1,2,0
31497,1,1,110603,110604,110605,1,2,0
31498,6,1,110609,110609,110610,0,1,4
31499,6,3,110615,110615,110618,0,3,5
31500,5,1,110620,110620,110621,0,1,2
31501,4,3,110624,110624,110627,0,3,3
31502,4,1,110628,110628,110629,0,1,1
31503,3,1,110631,110631,110632,0,1,2
31504,5,3,110636,110636,110639,0,3,4
31505,2,2,110638,110639,110641,1,3,0
31506,4,1,110642,110642,110643,0,1,1
31507,3,1,110645,110645,110646,0,1,2
31508,1,2,110646,110646,110648,0,2,0
31509,1,1,110647,110648,110649,1,2,0
31510,3,2,110650,110650,110652,0,2,1
31511,1,1,110651,110652,110653,1,2,0
31512,1,1,110652,110653,110654,1,2,0
31513,5,1,110657,110657,110658,0,1,3
31514,4,1,110661,110661,110662,0,1,3
31515,6,2,110667,110667,110669,0,2,5
31516,5,3,110672,110672,110675,0,3,3
31517,3,2,110675,110675,110677,0,2,0
31518,3,3,110678,110678,110681,0,3,1
31519,5,3,110683,110683,110686,0,3,2
31520,3,2,110686,110686,110688,0,2,0
31521,5,3,110691,110691,110694,0,3,3
31522,1,2,110692,110694,110696,2,4,0
31523,6,1,110698,110698,110699,0,1,2
31524,5,2,110703,110703,110705,0,2,4
31525,5,1,110708,110708,110709,0,1,3
31526,4,2,110712,110712,110714,0,2,3
31527,3,1,110715,110715,110716,0,1,1
31528,3,3,110718,110718,110721,0,3,2
31529,5,1,110723,110723,110724,0,1,2
31530,2,1,110725,110725,110726,0,1,1
31531,6,2,110731,110731,110733,0,2,5
31532,4,2,110735,110735,110737,0,2,2
31533,4,1,110739,110739,110740,0,1,2
31534,4,1,110743,110743,110744,0,1,3
31535,3,3,110746,110746,110749,0,3,2
31536,2,1,110748,110749,110750,1,2,0
31537,6,2,110754,110754,110756,0,2,4
31538,4,2,110758,110758,110760,0,2,2
31539,4,3,110762,110762,110765,0,3,2
31540,6,3,110768,110768,110771,0,3,3
31541,1,1,110769,110771,110772,2,3,0
31542,2,2,110771,110772,110774,1,3,0
31543,2,2,110773,110774,110776,1,3,0
31544,2,1,110775,110776,110777,1,2,0
31545,2,3,110777,110777,110780,0,3,0
31546,4,2,110781,110781,110783,0,2,1
31547,4,2,110785,110785,110787,0,2,2
31548,2,3,110787,110787,110790,0,3,0
31549,2,2,110789,110790,110792,1,3,0
31550,3,1,110792,110792,110793,0,1,0
31551,6,1,110798,110798,110799,0,1,5
31552,3,2,110801,110801,110803,0,2,2
31553,5,3,110806,110806,110809,0,3,3
31554,6,3,110812,110812,110815,0,3,3
31555,5,3,110817,110817,110820,0,3,2
31556,1,2,110818,110820,110822,2,4,0
31557,4,1,110822,110822,110823,0,1,0
31558,5,3,110827,110827,110830,0,3,4
31559,3,1,110830,110830,110831,0,1,0
31560,1,1,110831,110831,110832,0,1,0
31561,1,2,110832,110832,110834,0,2,0
31562,2,1,110834,110834,110835,0,1,0
31563,5,1,110839,110839,110840,0,1,4
31564,2,2,110841,110841,110843,0,2,1
31565,6,2,110847,110847,110849,0,2,4
31566,5,1,110852,110852,110853,0,1,3
31567,5,2,110857,110857,110859,0,2,4
31568,4,1,110861,110861,110862,0,1,2
31569,3,1,110864,110864,110865,0,1,2
31570,5,1,110869,110869,110870,0,1,4
31571,6,1,110875,110875,110876,0,1,5
31572,5,3,110880,110880,110883,0,3,4
31573,3,3,110883,110883,110886,0,3,0
31574,1,1,110884,110886,110887,2,3,0
31575,1,1,110885,110887,110888,2,3,0
31576,6,2,110891,110891,110893,0,2,3
31577,6,2,110897,110897,110899,0,2,4
31578,2,3,110899,110899,110902,0,3,0
31579,1,3,110900,110902,110905,2,5,0
31580,5,2,110905,110905,110907,0,2,0
31581,3,2,110908,110908,110910,0,2,1
31582,5,3,110913,110913,110916,0,3,3
31583,5,3,110918,110918,110921,0,3,2
31584,2,1,110920,110921,110922,1,2,0
31585,3,2,110923,110923,110925,0,2,1
31586,4,3,110927,110927,110930,0,3,2
31587,4,3,110931,110931,110934,0,3,1
31588,3,1,110934,110934,110935,0,1,0
31589,1,2,110935,110935,110937,0,2,0
31590,3,3,110938,110938,110941,0,3,1
31591,5,1,110943,110943,110944,0,1,2
31592,3,1,110946,110946,110947,0,1,2
31593,6,1,110952,110952,110953,0,1,5
31594,3,1,110955,110955,110956,0,1,2
31595,2,3,110957,110957,110960,0,3,1
31596,4,3,110961,110961,110964,0,3,1
31597,2,3,110963,110964,110967,1,4,0
31598,1,1,110964,110967,110968,3,4,0
31599,5,3,110969,110969,110972,0,3,1
31600,6,2,110975,110975,110977,0,2,3
31601,2,2,110977,110977,110979,0,2,0
31602,1,2,110978,110979,110981,1,3,0
31603,2,2,110980,110981,110983,1,3,0
31604,2,3,110982,110983,110986,1,4,0
31605,1,1,110983,110986,110987,3,4,0
31606,2,3,110985,110987,110990,2,5,0
31607,3,1,110988,110990,110991,2,3,0
31608,2,3,110990,110991,110994,1,4,0
31609,6,1,110996,110996,110997,0,1,2
31610,1,2,110997,110997,110999,0,2,0
31611,1,2,110998,110999,111001,1,3,0
31612,1,2,110999,111001,111003,2,4,0
31613,6,3,111005,111005,111008,0,3,2
31614,2,3,111007,111008,111011,1,4,0
31615,5,2,111012,111012,111014,0,2,1
31616,1,2,111013,111014,111016,1,3,0
31617,3,1,111016,111016,111017,0,1,0
31618,1,3,111017,111017,111020,0,3,0
31619,1,2,111018,111020,111022,2,4,0
31620,2,1,111020,111022,111023,2,3,0
31621,1,2,111021,111023,111025,2,4,0
31622,6,2,111027,111027,111029,0,2,2
31623,6,3,111033,111033,111036,0,3,4
31624,2,1,111035,111036,111037,1,2,0
31625,4,1,111039,111039,111040,0,1,2
31626,2,2,111041,111041,111043,0,2,1
31627,6,1,111047,111047,111048,0,1,4
31628,4,2,111051,111051,111053,0,2,3
31629,1,3,111052,111053,111056,1,4,0
31630,1,1,111053,111056,111057,3,4,0
31631,1,1,111054,111057,111058,3,4,0
31632,5,3,111059,111059,111062,0,3,1
31633,4,3,111063,111063,111066,0,3,1
31634,3,1,111066,111066,111067,0,1,0
31635,5,1,111071,111071,111072,0,1,4
31636,2,3,111073,111073,111076,0,3,1
31637,1,1,111074,111076,111077,2,3,0
31638,1,1,111075,111077,111078,2,3,0
31639,3,3,111078,111078,111081,0,3,0
31640,4,3,111082,111082,111085,0,3,1
31641,6,2,111088,111088,111090,0,2,3
31642,2,2,111090,111090,111092,0,2,0
31643,6,2,111096,111096,111098,0,2,4
31644,6,1,111102,111102,111103,0,1,4
31645,5,3,111107,111107,111110,0,3,4
31646,6,2,111113,111113,111115,0,2,3
31647,2,3,111115,111115,111118,0,3,0
31648,5,2,111120,111120,111122,0,2,2
31649,1,3,111121,111122,111125,1,4,0
31650,5,2,111126,111126,111128,0,2,1
31651,1,3,111127,111128,111131,1,4,0
31652,5,2,111132,111132,111134,0,2,1
31653,2,1,111134,111134,111135,0,1,0
31654,5,2,111139,111139,111141,0,2,4
31655,6,3,111145,111145,111148,0,3,4
31656,5,1,111150,111150,111151,0,1,2
31657,1,3,111151,111151,111154,0,3,0
31658,5,2,111156,111156,111158,0,2,2
31659,6,1,111162,111162,111163,0,1,4
31660,3,2,111165,111165,111167,0,2,2
31661,4,3,111169,111169,111172,0,3,2
31662,2,1,111171,111172,111173,1,2,0
31663,6,3,111177,111177,111180,0,3,4
31664,6,1,111183,111183,111184,0,1,3
31665,1,2,111184,111184,111186,0,2,0
31666,3,2,111187,111187,111189,0,2,1
31667,1,1,111188,111189,111190,1,2,0
31668,3,3,111191,111191,111194,0,3,1
31669,3,2,111194,111194,111196,0,2,0
31670,3,3,111197,111197,111200,0,3,1
31671,6,2,111203,111203,111205,0,2,3
31672,5,2,111208,111208,111210,0,2,3
31673,6,2,111214,111214,111216,0,2,4
31674,1,1,111215,111216,111217,1,2,0
31675,3,3,111218,111218,111221,0,3,1
31676,5,3,111223,111223,111226,0,3,2
31677,4,2,111227,111227,111229,0,2,1
31678,6,2,111233,111233,111235,0,2,4
31679,6,1,111239,111239,111240,0,1,4
31680,6,2,111245,111245,111247,0,2,5
31681,2,2,111247,111247,111249,0,2,0
31682,5,1,111252,111252,111253,0,1,3
31683,6,2,111258,111258,111260,0,2,5
31684,3,1,111261,111261,111262,0,1,1
31685,6,3,111267,111267,111270,0,3,5
31686,3,2,111270,111270,111272,0,2,0
31687,2,3,111272,111272,111275,0,3,0
31688,3,3,111275,111275,111278,0,3,0
31689,5,1,111280,111280,111281,0,1,2
31690,5,3,111285,111285,111288,0,3,4
31691,5,1,111290,111290,111291,0,1,2
31692,4,2,111294,111294,111296,0,2,3
31693,3,1,111297,111297,111298,0,1,1
31694,2,1,111299,111299,111300,0,1,1
31695,3,3,111302,111302,111305,0,3,2
31696,3,2,111305,111305,111307,0,2,0
31697,4,2,111309,111309,111311,0,2,2
31698,4,2,111313,111313,111315,0,2,2
31699,3,3,111316,111316,111319,0,3,1
31700,4,3,111320,111320,111323,0,3,1
31701,2,1,111322,111323,111324,1,2,0
31702,6,2,111328,111328,111330,0,2,4
31703,1,1,111329,111330,111331,1,2,0
31704,1,1,111330,111331,111332,1,2,0
31705,2,3,111332,111332,111335,0,3,0
31706,2,3,111334,111335,111338,1,4,0
31707,2,1,111336,111338,111339,2,3,0
31708,4,1,111340,111340,111341,0,1,1
31709,3,2,111343,111343,111345,0,2,2
31710,2,3,111345,111345,111348,0,3,0
31711,5,1,111350,111350,111351,0,1,2
31712,6,1,111356,111356,111357,0,1,5
31713,5,2,111361,111361,111363,0,2,4
31714,4,1,111365,111365,111366,0,1,2
31715,3,1,111368,111368,111369,0,1,2
31716,5,3,111373,111373,111376,0,3,4
31717,5,3,111378,111378,111381,0,3,2
31718,3,2,111381,111381,111383,0,2,0
31719,1,3,111382,111383,111386,1,4,0
31720,2,1,111384,111386,111387,2,3,0
31721,6,2,111390,111390,111392,0,2,3
31722,1,1,111391,111392,111393,1,2,0
31723,5,3,111396,111396,111399,0,3,3
31724,4,2,111400,111400,111402,0,2,1
31725,2,1,111402,111402,111403,0,1,0
31726,3,2,111405,111405,111407,0,2,2
31727,5,3,111410,111410,111413,0,3,3
31728,4,3,111414,111414,111417,0,3,1
31729,1,2,111415,111417,111419,2,4,0
31730,1,2,111416,111419,111421,3,5,0
31731,3,2,111419,111421,111423,2,4,0
31732,3,3,111422,111423,111426,1,4,0
31733,1,1,111423,111426,111427,3,4,0
31734,3,3,111426,111427,111430,1,4,0
31735,6,2,111432,111432,111434,0,2,2
31736,3,1,111435,111435,111436,0,1,1
31737,5,3,111440,111440,111443,0,3,4
31738,1,3,111441,111443,111446,2,5,0
31739,5,3,111446,111446,111449,0,3,0
31740,6,2,111452,111452,111454,0,2,3
31741,6,3,111458,111458,111461,0,3,4
31742,2,1,111460,111461,111462,1,2,0
31743,2,3,111462,111462,111465,0,3,0
31744,6,2,111468,111468,111470,0,2,3
31745,6,2,111474,111474,111476,0,2,4
31746,3,2,111477,111477,111479,0,2,1
31747,5,2,111482,111482,111484,0,2,3
31748,5,2,111487,111487,111489,0,2,3
31749,6,2,111493,111493,111495,0,2,4
31750,4,3,111497,111497,111500,0,3,2
31751,5,2,111502,111502,111504,0,2,2
31752,5,2,111507,111507,111509,0,2,3
31753,5,3,111512,111512,111515,0,3,3
31754,3,1,111515,111515,111516,0,1,0
31755,2,1,111517,111517,111518,0,1,1
31756,4,2,111521,111521,111523,0,2,3
31757,6,1,111527,111527,111528,0,1,4
31758,4,1,111531,111531,111532,0,1,3
31759,2,2,111533,111533,111535,0,2,1
31760,2,2,111535,111535,111537,0,2,0
31761,5,1,111540,111540,111541,0,1,3
31762,3,1,111543,111543,111544,0,1,2
31763,2,3,111545,111545,111548,0,3,1
31764,5,1,111550,111550,111551,0,1,2
31765,2,1,111552,111552,111553,0,1,1
31766,1,3,111553,111553,111556,0,3,0
31767,5,2,111558,111558,111560,0,2,2
31768,6,2,111564,111564,111566,0,2,4
31769,3,1,111567,111567,111568,0,1,1
31770,5,3,111572,111572,111575,0,3,4
31771,4,2,111576,111576,111578,0,2,1
31772,6,1,111582,111582,111583,0,1,4
31773,5,3,111587,111587,111590,0,3,4
31774,4,1,111591,111591,111592,0,1,1
31775,2,1,111593,111593,111594,0,1,1
31776,1,2,111594,111594,111596,0,2,0
31777,2,3,111596,111596,111599,0,3,0
31778,1,1,111597,111599,111600,2,3,0
31779,1,2,111598,111600,111602,2,4,0
31780,2,2,111600,111602,111604,2,4,0
31781,5,2,111605,111605,111607,0,2,1
31782,5,1,111610,111610,111611,0,1,3
31783,4,1,111614,111614,111615,0,1,3
31784,4,1,111618,111618,111619,0,1,3
31785,4,1,111622,111622,111623,0,1,3
31786,2,1,111624,111624,111625,0,1,1
31787,3,1,111627,111627,111628,0,1,2
31788,1,3,111628,111628,111631,0,3,0
31789,6,3,111634,111634,111637,0,3,3
31790,2,3,111636,111637,111640,1,4,0
31791,3,3,111639,111640,111643,1,4,0
31792,4,2,111643,111643,111645,0,2,0
31793,2,3,111645,111645,111648,0,3,0
31794,1,2,111646,111648,111650,2,4,0
31795,2,2,111648,111650,111652,2,4,0
31796,6,3,111654,111654,111657,0,3,2
31797,1,1,111655,111657,111658,2,3,0
31798,5,2,111660,111660,111662,0,2,2
31799,3,1,111663,111663,111664,0,1,1
31800,1,2,111664,111664,111666,0,2,0
31801,2,2,111666,111666,111668,0,2,0
31802,2,1,111668,111668,111669,0,1,0
31803,5,1,111673,111673,111674,0,1,4
31804,6,1,111679,111679,111680,0,1,5
31805,6,1,111685,111685,111686,0,1,5
31806,5,3,111690,111690,111693,0,3,4
31807,3,3,111693,111693,111696,0,3,0
31808,5,3,111698,111698,111701,0,3,2
31809,3,2,111701,111701,111703,0,2,0
31810,6,1,111707,111707,111708,0,1,4
31811,2,2,111709,111709,111711,0,2,1
31812,4,2,111713,111713,111715,0,2,2
31813,5,1,111718,111718,111719,0,1,3
31814,5,3,111723,111723,111726,0,3,4
31815,4,2,111727,111727,111729,0,2,1
31816,5,2,111732,111732,111734,0,2,3
31817,3,1,111735,111735,111736,0,1,1
31818,5,1,111740,111740,111741,0,1,4
31819,2,1,111742,111742,111743,0,1,1
31820,1,1,111743,111743,111744,0,1,0
31821,4,3,111747,111747,111750,0,3,3
31822,6,2,111753,111753,111755,0,2,3
31823,5,3,111758,111758,111761,0,3,3
31824,5,1,111763,111763,111764,0,1,2
31825,5,2,111768,111768,111770,0,2,4
31826,4,1,111772,111772,111773,0,1,2
31827,3,2,111775,111775,111777,0,2,2
31828,1,2,111776,111777,111779,1,3,0
31829,5,2,111781,111781,111783,0,2,2
31830,2,1,111783,111783,111784,0,1,0
31831,6,3,111789,111789,111792,0,3,5
31832,5,3,111794,111794,111797,0,3,2
31833,2,1,111796,111797,111798,1,2,0
31834,1,1,111797,111798,111799,1,2,0
31835,5,3,111802,111802,111805,0,3,3
31836,6,1,111808,111808,111809,0,1,3
31837,5,3,111813,111813,111816,0,3,4
31838,5,2,111818,111818,111820,0,2,2
31839,2,1,111820,111820,111821,0,1,0
31840,2,3,111822,111822,111825,0,3,1
31841,2,2,111824,111825,111827,1,3,0
31842,4,2,111828,111828,111830,0,2,1
31843,4,2,111832,111832,111834,0,2,2
31844,5,3,111837,111837,111840,0,3,3
31845,2,1,111839,111840,111841,1,2,0
31846,1,3,111840,111841,111844,1,4,0
31847,5,2,111845,111845,111847,0,2,1
31848,4,1,111849,111849,111850,0,1,2
31849,3,1,111852,111852,111853,0,1,2
31850,4,3,111856,111856,111859,0,3,3
31851,5,3,111861,111861,111864,0,3,2
31852,1,1,111862,111864,111865,2,3,0
31853,3,1,111865,111865,111866,0,1,0
31854,6,1,111871,111871,111872,0,1,5
31855,3,1,111874,111874,111875,0,1,2
31856,2,1,111876,111876,111877,0,1,1
31857,6,1,111882,111882,111883,0,1,5
31858,3,1,111885,111885,111886,0,1,2
31859,2,1,111887,111887,111888,0,1,1
31860,4,3,111891,111891,111894,0,3,3
31861,3,2,111894,111894,111896,0,2,0
31862,4,1,111898,111898,111899,0,1,2
31863,3,2,111901,111901,111903,0,2,2
31864,1,3,111902,111903,111906,1,4,0
31865,3,1,111905,111906,111907,1,2,0
31866,4,1,111909,111909,111910,0,1,2
31867,6,1,111915,111915,111916,0,1,5
31868,5,2,111920,111920,111922,0,2,4
31869,1,1,111921,111922,111923,1,2,0
31870,1,2,111922,111923,111925,1,3,0
31871,5,1,111927,111927,111928,0,1,2
31872,1,3,111928,111928,111931,0,3,0
31873,5,2,111933,111933,111935,0,2,2
31874,4,1,111937,111937,111938,0,1,2
31875,1,3,111938,111938,111941,0,3,0
31876,3,1,111941,111941,111942,0,1,0
31877,3,1,111944,111944,111945,0,1,2
31878,6,3,111950,111950,111953,0,3,5
31879,6,2,111956,111956,111958,0,2,3
31880,4,2,111960,111960,111962,0,2,2
31881,4,2,111964,111964,111966,0,2,2
31882,1,1,111965,111966,111967,1,2,0
31883,5,2,111970,111970,111972,0,2,3
31884,3,3,111973,111973,111976,0,3,1
31885,5,2,111978,111978,111980,0,2,2
31886,6,3,111984,111984,111987,0,3,4
31887,3,3,111987,111987,111990,0,3,0
31888,5,2,111992,111992,111994,0,2,2
31889,2,3,111994,111994,111997,0,3,0
31890,4,1,111998,111998,111999,0,1,1
31891,5,2,112003,112003,112005,0,2,4
31892,4,3,112007,112007,112010,0,3,2
31893,4,1,112011,112011,112012,0,1,1
31894,6,1,112017,112017,112018,0,1,5
31895,2,2,112019,112019,112021,0,2,1
31896,1,3,112020,112021,112024,1,4,0
31897,2,3,112022,112024,112027,2,5,0
31898,3,3,112025,112027,112030,2,5,0
31899,6,3,112031,112031,112034,0,3,1
31900,6,2,112037,112037,112039,0,2,3
31901,6,2,112043,112043,112045,0,2,4
31902,3,2,112046,112046,112048,0,2,1
31903,3,2,112049,112049,112051,0,2,1
31904,6,1,112055,112055,112056,0,1,4
31905,3,3,112058,112058,112061,0,3,2
31906,4,3,112062,112062,112065,0,3,1
31907,1,1,112063,112065,112066,2,3,0
31908,3,3,112066,112066,112069,0,3,0
31909,4,3,112070,112070,112073,0,3,1
31910,2,2,112072,112073,112075,1,3,0
31911,4,2,112076,112076,112078,0,2,1
31912,3,1,112079,112079,112080,0,1,1
31913,4,1,112083,112083,112084,0,1,3
31914,6,2,112089,112089,112091,0,2,5
31915,3,3,112092,112092,112095,0,3,1
31916,5,3,112097,112097,112100,0,3,2
31917,2,3,112099,112100,112103,1,4,0
31918,5,3,112104,112104,112107,0,3,1
31919,5,1,112109,112109,112110,0,1,2
31920,5,2,112114,112114,112116,0,2,4
31921,2,3,112116,112116,112119,0,3,0
31922,2,3,112118,112119,112122,1,4,0
31923,6,1,112124,112124,112125,0,1,2
31924,4,1,112128,112128,112129,0,1,3
31925,2,3,112130,112130,112133,0,3,1
31926,4,2,112134,112134,112136,0,2,1
31927,6,1,112140,112140,112141,0,1,4
31928,1,1,112141,112141,112142,0,1,0
31929,5,1,112146,112146,112147,0,1,4
31930,4,3,112150,112150,112153,0,3,3
31931,5,3,112155,112155,112158,0,3,2
31932,5,1,112160,112160,112161,0,1,2
31933,1,1,112161,112161,112162,0,1,0
31934,6,2,112167,112167,112169,0,2,5
31935,3,2,112170,112170,112172,0,2,1
31936,2,2,112172,112172,112174,0,2,0
31937,2,3,112174,112174,112177,0,3,0
31938,6,3,112180,112180,112183,0,3,3
31939,1,1,112181,112183,112184,2,3,0
31940,4,1,112185,112185,112186,0,1,1
31941,3,1,112188,112188,112189,0,1,2
31942,1,2,112189,112189,112191,0,2,0
31943,5,1,112194,112194,112195,0,1,3
31944,4,2,112198,112198,112200,0,2,3
31945,3,3,112201,112201,112204,0,3,1
31946,3,1,112204,112204,112205,0,1,0
31947,4,1,112208,112208,112209,0,1,3
31948,5,2,112213,112213,112215,0,2,4
31949,5,3,112218,112218,112221,0,3,3
31950,6,1,112224,112224,112225,0,1,3
31951,3,2,112227,112227,112229,0,2,2
31952,5,2,112232,112232,112234,0,2,3
31953,2,2,112234,112234,112236,0,2,0
31954,1,3,112235,112236,112239,1,4,0
31955,1,1,112236,112239,112240,3,4,0
31956,3,1,112239,112240,112241,1,2,0
31957,1,2,112240,112241,112243,1,3,0
31958,1,3,112241,112243,112246,2,5,0
31959,1,2,112242,112246,112248,4,6,0
31960,5,1,112247,112248,112249,1,2,0
31961,6,2,112253,112253,112255,0,2,4
31962,5,3,112258,112258,112261,0,3,3
31963,4,3,112262,112262,112265,0,3,1
31964,3,1,112265,112265,112266,0,1,0
31965,2,3,112267,112267,112270,0,3,1
31966,5,2,112272,112272,112274,0,2,2
31967,3,1,112275,112275,112276,0,1,1
31968,4,2,112279,112279,112281,0,2,3
31969,1,1,112280,112281,112282,1,2,0
31970,3,1,112283,112283,112284,0,1,1
31971,1,3,112284,112284,112287,0,3,0
31972,4,3,112288,112288,112291,0,3,1
31973,1,3,112289,112291,112294,2,5,0
31974,6,2,112295,112295,112297,0,2,1
31975,1,3,112296,112297,112300,1,4,0
31976,4,1,112300,112300,112301,0,1,0
31977,1,1,112301,112301,112302,0,1,0
31978,5,3,112306,112306,112309,0,3,4
31979,1,1,112307,112309,112310,2,3,0
31980,1,3,112308,112310,112313,2,5,0
31981,5,2,112313,112313,112315,0,2,0
31982,6,3,112319,112319,112322,0,3,4
31983,2,1,112321,112322,112323,1,2,0
31984,3,1,112324,112324,112325,0,1,1
31985,1,3,112325,112325,112328,0,3,0
31986,4,1,112329,112329,112330,0,1,1
31987,1,3,112330,112330,112333,0,3,0
31988,3,1,112333,112333,112334,0,1,0
31989,3,1,112336,112336,112337,0,1,2
31990,3,3,112339,112339,112342,0,3,2
31991,4,1,112343,112343,112344,0,1,1
31992,1,2,112344,112344,112346,0,2,0
31993,4,3,112348,112348,112351,0,3,2
31994,6,3,112354,112354,112357,0,3,3
31995,1,2,112355,112357,112359,2,4,0
31996,2,1,112357,112359,112360,2,3,0
31997,3,3,112360,112360,112363,0,3,0
31998,1,3,112361,112363,112366,2,5,0
31999,4,3,112365,112366,112369,1,4,0
32000,4,1,112369,112369,112370,0,1,0
32001,6,2,112375,112375,112377,0,2,5
32002,6,1,112381,112381,112382,0,1,4
32003,1,2,112382,112382,112384,0,2,0
32004,1,1,112383,112384,112385,1,2,0
32005,1,3,112384,112385,112388,1,4,0
32006,4,2,112388,112388,112390,0,2,0
32007,3,3,112391,112391,112394,0,3,1
32008,1,1,112392,112394,112395,2,3,0
32009,3,2,112395,112395,112397,0,2,0
32010,6,1,112401,112401,112402,0,1,4
32011,5,1,112406,112406,112407,0,1,4
32012,1,1,112407,112407,112408,0,1,0
32013,1,2,112408,112408,112410,0,2,0
32014,2,3,112410,112410,112413,0,3,0
32015,6,3,112416,112416,112419,0,3,3
32016,3,3,112419,112419,112422,0,3,0
32017,4,2,112423,112423,112425,0,2,1
32018,2,1,112425,112425,112426,0,1,0
32019,1,1,112426,112426,112427,0,1,0
32020,3,3,112429,112429,112432,0,3,2
32021,1,3,112430,112432,112435,2,5,0
32022,1,3,112431,112435,112438,4,7,0
32023,1,1,112432,112438,112439,6,7,0
32024,6,2,112438,112439,112441,1,3,0
32025,5,3,112443,112443,112446,0,3,2
32026,1,3,112444,112446,112449,2,5,0
32027,6,1,112450,112450,112451,0,1,1
32028,2,1,112452,112452,112453,0,1,1
32029,2,1,112454,112454,112455,0,1,1
32030,1,3,112455,112455,112458,0,3,0
32031,4,3,112459,112459,112462,0,3,1
32032,2,1,112461,112462,112463,1,2,0
32033,5,1,112466,112466,112467,0,1,3
32034,3,1,112469,112469,112470,0,1,2
32035,3,2,112472,112472,112474,0,2,2
32036,5,2,112477,112477,112479,0,2,3
32037,1,2,112478,112479,112481,1,3,0
32038,6,3,112484,112484,112487,0,3,3
32039,3,3,112487,112487,112490,0,3,0
32040,1,1,112488,112490,112491,2,3,0
32041,6,3,112494,112494,112497,0,3,3
32042,5,2,112499,112499,112501,0,2,2
32043,1,2,112500,112501,112503,1,3,0
32044,3,1,112503,112503,112504,0,1,0
32045,4,2,112507,112507,112509,0,2,3
32046,4,1,112511,112511,112512,0,1,2
32047,2,1,112513,112513,112514,0,1,1
32048,2,3,112515,112515,112518,0,3,1
32049,6,3,112521,112521,112524,0,3,3
32050,3,2,112524,112524,112526,0,2,0
32051,1,3,112525,112526,112529,1,4,0
32052,5,1,112530,112530,112531,0,1,1
32053,1,3,112531,112531,112534,0,3,0
32054,1,3,112532,112534,112537,2,5,0
32055,6,1,112538,112538,112539,0,1,1
32056,5,2,112543,112543,112545,0,2,4
32057,2,2,112545,112545,112547,0,2,0
32058,5,3,112550,112550,112553,0,3,3
32059,2,3,112552,112553,112556,1,4,0
32060,1,1,112553,112556,112557,3,4,0
32061,2,3,112555,112557,112560,2,5,0
32062,3,2,112558,112560,112562,2,4,0
32063,2,3,112560,112562,112565,2,5,0
32064,3,3,112563,112565,112568,2,5,0
32065,6,2,112569,112569,112571,0,2,1
32066,1,1,112570,112571,112572,1,2,0
32067,1,2,112571,112572,112574,1,3,0
32068,5,3,112576,112576,112579,0,3,2
32069,5,2,112581,112581,112583,0,2,2
32070,3,1,112584,112584,112585,0,1,1
32071,5,3,112589,112589,112592,0,3,4
32072,4,2,112593,112593,112595,0,2,1
32073,4,2,112597,112597,112599,0,2,2
32074,3,3,112600,112600,112603,0,3,1
32075,6,1,112606,112606,112607,0,1,3
32076,6,1,112612,112612,112613,0,1,5
32077,4,2,112616,112616,112618,0,2,3
32078,5,2,112621,112621,112623,0,2,3
32079,6,3,112627,112627,112630,0,3,4
32080,1,2,112628,112630,112632,2,4,0
32081,6,2,112634,112634,112636,0,2,2
32082,2,3,112636,112636,112639,0,3,0
32083,4,1,112640,112640,112641,0,1,1
32084,3,1,112643,112643,112644,0,1,2
32085,2,1,112645,112645,112646,0,1,1
32086,2,1,112647,112647,112648,0,1,1
32087,1,2,112648,112648,112650,0,2,0
32088,1,1,112649,112650,112651,1,2,0
32089,1,3,112650,112651,112654,1,4,0
32090,1,1,112651,112654,112655,3,4,0
32091,2,1,112653,112655,112656,2,3,0
32092,4,2,112657,112657,112659,0,2,1
32093,1,1,112658,112659,112660,1,2,0
32094,1,2,112659,112660,112662,1,3,0
32095,6,2,112665,112665,112667,0,2,3
32096,6,1,112671,112671,112672,0,1,4
32097,2,3,112673,112673,112676,0,3,1
32098,4,3,112677,112677,112680,0,3,1
32099,1,2,112678,112680,112682,2,4,0
32100,2,3,112680,112682,112685,2,5,0
32101,6,3,112686,112686,112689,0,3,1
32102,2,1,112688,112689,112690,1,2,0
32103,4,1,112692,112692,112693,0,1,2
32104,4,2,112696,112696,112698,0,2,3
32105,4,2,112700,112700,112702,0,2,2
32106,5,1,112705,112705,112706,0,1,3
32107,1,3,112706,112706,112709,0,3,0
32108,2,1,112708,112709,112710,1,2,0
32109,1,1,112709,112710,112711,1,2,0
32110,6,1,112715,112715,112716,0,1,4
32111,4,3,112719,112719,112722,0,3,3
32112,4,1,112723,112723,112724,0,1,1
32113,5,1,112728,112728,112729,0,1,4
32114,3,1,112731,112731,112732,0,1,2
32115,4,1,112735,112735,112736,0,1,3
32116,2,1,112737,112737,112738,0,1,1
32117,4,1,112741,112741,112742,0,1,3
32118,3,2,112744,112744,112746,0,2,2
32119,4,3,112748,112748,112751,0,3,2
32120,4,2,112752,112752,112754,0,2,1
32121,3,2,112755,112755,112757,0,2,1
32122,3,1,112758,112758,112759,0,1,1
32123,2,1,112760,112760,112761,0,1,1
32124,2,2,112762,112762,112764,0,2,1
32125,1,1,112763,112764,112765,1,2,0
32126,1,3,112764,112765,112768,1,4,0
32127,4,2,112768,112768,112770,0,2,0
32128,5,3,112773,112773,112776,0,3,3
32129,2,1,112775,112776,112777,1,2,0
32130,4,1,112779,112779,112780,0,1,2
32131,1,1,112780,112780,112781,0,1,0
32132,5,3,112785,112785,112788,0,3,4
32133,4,3,112789,112789,112792,0,3,1
32134,6,3,112795,112795,112798,0,3,3
32135,3,1,112798,112798,112799,0,1,0
32136,6,2,112804,112804,112806,0,2,5
32137,2,2,112806,112806,112808,0,2,0
32138,6,3,112812,112812,112815,0,3,4
32139,4,2,112816,112816,112818,0,2,1
32140,4,1,112820,112820,112821,0,1,2
32141,6,1,112826,112826,112827,0,1,5
32142,3,1,112829,112829,112830,0,1,2
32143,5,1,112834,112834,112835,0,1,4
32144,5,2,112839,112839,112841,0,2,4
32145,3,2,112842,112842,112844,0,2,1
32146,2,2,112844,112844,112846,0,2,0
32147,4,2,112848,112848,112850,0,2,2
32148,3,2,112851,112851,112853,0,2,1
32149,2,2,112853,112853,112855,0,2,0
32150,6,2,112859,112859,112861,0,2,4
32151,5,2,112864,112864,112866,0,2,3
32152,6,2,112870,112870,112872,0,2,4
32153,1,2,112871,112872,112874,1,3,0
32154,6,3,112877,112877,112880,0,3,3
32155,2,1,112879,112880,112881,1,2,0
32156,4,3,112883,112883,112886,0,3,2
32157,5,3,112888,112888,112891,0,3,2
32158,3,3,112891,112891,112894,0,3,0
32159,2,2,112893,112894,112896,1,3,0
32160,1,3,112894,112896,112899,2,5,0
32161,5,2,112899,112899,112901,0,2,0
32162,4,2,112903,112903,112905,0,2,2
32163,5,1,112908,112908,112909,0,1,3
32164,2,3,112910,112910,112913,0,3,1
32165,1,2,112911,112913,112915,2,4,0
32166,1,1,112912,112915,112916,3,4,0
32167,5,1,112917,112917,112918,0,1,1
32168,3,2,112920,112920,112922,0,2,2
32169,1,3,112921,112922,112925,1,4,0
32170,6,1,112927,112927,112928,0,1,2
32171,3,2,112930,112930,112932,0,2,2
32172,6,1,112936,112936,112937,0,1,4
32173,2,2,112938,112938,112940,0,2,1
32174,4,1,112942,112942,112943,0,1,2
32175,2,3,112944,112944,112947,0,3,1
32176,4,2,112948,112948,112950,0,2,1
32177,4,2,112952,112952,112954,0,2,2
32178,6,1,112958,112958,112959,0,1,4
32179,1,2,112959,112959,112961,0,2,0
32180,6,3,112965,112965,112968,0,3,4
32181,5,2,112970,112970,112972,0,2,2
32182,4,1,112974,112974,112975,0,1,2
32183,1,3,112975,112975,112978,0,3,0
32184,2,3,112977,112978,112981,1,4,0
32185,6,1,112983,112983,112984,0,1,2
32186,1,3,112984,112984,112987,0,3,0
32187,2,3,112986,112987,112990,1,4,0
32188,3,3,112989,112990,112993,1,4,0
32189,2,1,112991,112993,112994,2,3,0
32190,5,1,112996,112996,112997,0,1,2
32191,1,1,112997,112997,112998,0,1,0
32192,3,3,113000,113000,113003,0,3,2
32193,5,1,113005,113005,113006,0,1,2
32194,5,1,113010,113010,113011,0,1,4
32195,3,1,113013,113013,113014,0,1,2
32196,1,2,113014,113014,113016,0,2,0
32197,6,1,113020,113020,113021,0,1,4
32198,3,3,113023,113023,113026,0,3,2
32199,1,2,113024,113026,113028,2,4,0
32200,5,1,113029,113029,113030,0,1,1
32201,3,2,113032,113032,113034,0,2,2
32202,3,1,113035,113035,113036,0,1,1
32203,5,1,113040,113040,113041,0,1,4
32204,4,3,113044,113044,113047,0,3,3
32205,4,3,113048,113048,113051,0,3,1
32206,1,2,113049,113051,113053,2,4,0
32207,3,2,113052,113053,113055,1,3,0
32208,6,2,113058,113058,113060,0,2,3
32209,6,2,113064,113064,113066,0,2,4
32210,3,3,113067,113067,113070,0,3,1
32211,2,3,113069,113070,113073,1,4,0
32212,4,1,113073,113073,113074,0,1,0
32213,1,3,113074,113074,113077,0,3,0
32214,1,2,113075,113077,113079,2,4,0
32215,1,2,113076,113079,113081,3,5,0
32216,1,1,113077,113081,113082,4,5,0
32217,6,1,113083,113083,113084,0,1,1
32218,1,2,113084,113084,113086,0,2,0
32219,5,3,113089,113089,113092,0,3,3
32220,4,2,113093,113093,113095,0,2,1
32221,4,3,113097,113097,113100,0,3,2
32222,1,3,113098,113100,113103,2,5,0
32223,6,3,113104,113104,113107,0,3,1
32224,4,1,113108,113108,113109,0,1,1
32225,6,3,113114,113114,113117,0,3,5
32226,4,3,113118,113118,113121,0,3,1
32227,1,3,113119,113121,113124,2,5,0
32228,5,3,113124,113124,113127,0,3,0
32229,6,1,113130,113130,113131,0,1,3
32230,4,1,113134,113134,113135,0,1,3
32231,4,1,113138,113138,113139,0,1,3
32232,3,3,113141,113141,113144,0,3,2
32233,5,2,113146,113146,113148,0,2,2
32234,3,3,113149,113149,113152,0,3,1
32235,2,1,113151,113152,113153,1,2,0
32236,1,1,113152,113153,113154,1,2,0
32237,6,3,113158,113158,113161,0,3,4
32238,4,3,113162,113162,113165,0,3,1
32239,6,1,113168,113168,113169,0,1,3
32240,2,1,113170,113170,113171,0,1,1
32241,1,2,113171,113171,113173,0,2,0
32242,2,2,113173,113173,113175,0,2,0
32243,5,3,113178,113178,113181,0,3,3
32244,3,1,113181,113181,113182,0,1,0
32245,2,2,113183,113183,113185,0,2,1
32246,4,3,113187,113187,113190,0,3,2
32247,5,3,113192,113192,113195,0,3,2
32248,6,3,113198,113198,113201,0,3,3
32249,6,3,113204,113204,113207,0,3,3
32250,1,3,113205,113207,113210,2,5,0
32251,4,1,113209,113210,113211,1,2,0
32252,1,1,113210,113211,113212,1,2,0
32253,1,1,113211,113212,113213,1,2,0
32254,3,3,113214,113214,113217,0,3,1
32255,4,3,113218,113218,113221,0,3,1
32256,1,2,113219,113221,113223,2,4,0
32257,2,1,113221,113223,113224,2,3,0
32258,4,1,113225,113225,113226,0,1,1
32259,3,3,113228,113228,113231,0,3,2
32260,4,3,113232,113232,113235,0,3,1
32261,2,1,113234,113235,113236,1,2,0
32262,6,1,113240,113240,113241,0,1,4
32263,4,1,113244,113244,113245,0,1,3
32264,1,3,113245,113245,113248,0,3,0
32265,4,3,113249,113249,113252,0,3,1
32266,1,3,113250,113252,113255,2,5,0
32267,3,3,113253,113255,113258,2,5,0
32268,3,1,113256,113258,113259,2,3,0
32269,4,3,113260,113260,113263,0,3,1
32270,6,1,113266,113266,113267,0,1,3
32271,6,1,113272,113272,113273,0,1,5
32272,3,2,113275,113275,113277,0,2,2
32273,5,3,113280,113280,113283,0,3,3
32274,4,3,113284,113284,113287,0,3,1
32275,4,1,113288,113288,113289,0,1,1
32276,5,3,113293,113293,113296,0,3,4
32277,3,1,113296,113296,113297,0,1,0
32278,3,2,113299,113299,113301,0,2,2
32279,6,3,113305,113305,113308,0,3,4
32280,6,2,113311,113311,113313,0,2,3
32281,6,2,113317,113317,113319,0,2,4
32282,2,1,113319,113319,113320,0,1,0
32283,3,3,113322,113322,113325,0,3,2
32284,4,1,113326,113326,113327,0,1,1
32285,4,1,113330,113330,113331,0,1,3
32286,5,3,113335,113335,113338,0,3,4
32287,5,3,113340,113340,113343,0,3,2
32288,6,2,113346,113346,113348,0,2,3
32289,1,1,113347,113348,113349,1,2,0
32290,1,1,113348,113349,113350,1,2,0
32291,4,1,113352,113352,113353,0,1,2
32292,2,3,113354,113354,113357,0,3,1
32293,1,1,113355,113357,113358,2,3,0
32294,4,1,113359,113359,113360,0,1,1
32295,4,2,113363,113363,113365,0,2,3
32296,5,1,113368,113368,113369,0,1,3
32297,5,3,113373,113373,113376,0,3,4
32298,1,3,113374,113376,113379,2,5,0
32299,6,3,113380,113380,113383,0,3,1
32300,5,3,113385,113385,113388,0,3,2
32301,5,3,113390,113390,113393,0,3,2
32302,4,2,113394,113394,113396,0,2,1
32303,6,1,113400,113400,113401,0,1,4
32304,4,1,113404,113404,113405,0,1,3
32305,1,1,113405,113405,113406,0,1,0
32306,6,3,113411,113411,113414,0,3,5
32307,4,2,113415,113415,113417,0,2,1
32308,2,3,113417,113417,113420,0,3,0
32309,4,1,113421,113421,113422,0,1,1
32310,4,2,113425,113425,113427,0,2,3
32311,4,2,113429,113429,113431,0,2,2
32312,1,2,113430,113431,113433,1,3,0
32313,2,3,113432,113433,113436,1,4,0
32314,4,3,113436,113436,113439,0,3,0
32315,6,3,113442,113442,113445,0,3,3
32316,2,1,113444,113445,113446,1,2,0
32317,1,3,113445,113446,113449,1,4,0
32318,3,1,113448,113449,113450,1,2,0
32319,4,2,113452,113452,113454,0,2,2
32320,3,3,113455,113455,113458,0,3,1
32321,6,1,113461,113461,113462,0,1,3
32322,5,2,113466,113466,113468,0,2,4
32323,4,2,113470,113470,113472,0,2,2
32324,3,2,113473,113473,113475,0,2,1
32325,2,2,113475,113475,113477,0,2,0
32326,2,1,113477,113477,113478,0,1,0
32327,4,1,113481,113481,113482,0,1,3
32328,6,2,113487,113487,113489,0,2,5
32329,5,3,113492,113492,113495,0,3,3
32330,6,3,113498,113498,113501,0,3,3
32331,6,2,113504,113504,113506,0,2,3
32332,6,1,113510,113510,113511,0,1,4
32333,1,3,113511,113511,113514,0,3,0
32334,3,2,113514,113514,113516,0,2,0
32335,2,2,113516,113516,113518,0,2,0
32336,5,2,113521,113521,113523,0,2,3
32337,5,2,113526,113526,113528,0,2,3
32338,3,2,113529,113529,113531,0,2,1
32339,5,1,113534,113534,113535,0,1,3
32340,2,1,113536,113536,113537,0,1,1
32341,3,2,113539,113539,113541,0,2,2
32342,4,3,113543,113543,113546,0,3,2
32343,1,3,113544,113546,113549,2,5,0
32344,6,3,113550,113550,113553,0,3,1
32345,2,1,113552,113553,113554,1,2,0
32346,4,2,113556,113556,113558,0,2,2
32347,3,3,113559,113559,113562,0,3,1
32348,1,2,113560,113562,113564,2,4,0
32349,3,3,113563,113564,113567,1,4,0
32350,2,3,113565,113567,113570,2,5,0
32351,5,2,113570,113570,113572,0,2,0
32352,3,3,113573,113573,113576,0,3,1
32353,4,1,113577,113577,113578,0,1,1
32354,5,1,113582,113582,113583,0,1,4
32355,5,2,113587,113587,113589,0,2,4
32356,3,2,113590,113590,113592,0,2,1
32357,6,3,113596,113596,113599,0,3,4
32358,1,3,113597,113599,113602,2,5,0
32359,3,2,113600,113602,113604,2,4,0
32360,1,3,113601,113604,113607,3,6,0
32361,6,3,113607,113607,113610,0,3,0
32362,6,2,113613,113613,113615,0,2,3
32363,1,3,113614,113615,113618,1,4,0
32364,4,1,113618,113618,113619,0,1,0
32365,5,2,113623,113623,113625,0,2,4
32366,3,3,113626,113626,113629,0,3,1
32367,1,3,113627,113629,113632,2,5,0
32368,1,3,113628,113632,113635,4,7,0
32369,4,2,113632,113635,113637,3,5,0
32370,2,2,113634,113637,113639,3,5,0
32371,1,1,113635,113639,113640,4,5,0
32372,4,1,113639,113640,113641,1,2,0
32373,5,3,113644,113644,113647,0,3,3
32374,3,2,113647,113647,113649,0,2,0
32375,3,1,113650,113650,113651,0,1,1
32376,2,3,113652,113652,113655,0,3,1
32377,1,1,113653,113655,113656,2,3,0
32378,2,1,113655,113656,113657,1,2,0
32379,4,1,113659,113659,113660,0,1,2
32380,3,2,113662,113662,113664,0,2,2
32381,5,1,113667,113667,113668,0,1,3
32382,4,3,113671,113671,113674,0,3,3
32383,6,1,113677,113677,113678,0,1,3
32384,3,1,113680,113680,113681,0,1,2
32385,2,2,113682,113682,113684,0,2,1
32386,5,1,113687,113687,113688,0,1,3
32387,4,1,113691,113691,113692,0,1,3
32388,4,3,113695,113695,113698,0,3,3
32389,3,2,113698,113698,113700,0,2,0
32390,1,3,113699,113700,113703,1,4,0
32391,5,3,113704,113704,113707,0,3,1
32392,1,3,113705,113707,113710,2,5,0
32393,5,1,113710,113710,113711,0,1,0
32394,5,3,113715,113715,113718,0,3,4
32395,2,3,113717,113718,113721,1,4,0
32396,2,1,113719,113721,113722,2,3,0
32397,6,2,113725,113725,113727,0,2,3
32398,1,1,113726,113727,113728,1,2,0
32399,6,3,113732,113732,113735,0,3,4
32400,2,3,113734,113735,113738,1,4,0
32401,6,2,113740,113740,113742,0,2,2
32402,6,2,113746,113746,113748,0,2,4
32403,2,2,113748,113748,113750,0,2,0
32404,5,1,113753,113753,113754,0,1,3
32405,5,3,113758,113758,113761,0,3,4
32406,4,2,113762,113762,113764,0,2,1
32407,6,3,113768,113768,113771,0,3,4
32408,4,2,113772,113772,113774,0,2,1
32409,1,3,113773,113774,113777,1,4,0
32410,6,2,113779,113779,113781,0,2,2
32411,3,1,113782,113782,113783,0,1,1
32412,2,1,113784,113784,113785,0,1,1
32413,5,1,113789,113789,113790,0,1,4
32414,3,2,113792,113792,113794,0,2,2
32415,4,2,113796,113796,113798,0,2,2
32416,5,1,113801,113801,113802,0,1,3
32417,5,1,113806,113806,113807,0,1,4
32418,5,1,113811,113811,113812,0,1,4
32419,6,3,113817,113817,113820,0,3,5
32420,4,2,113821,113821,113823,0,2,1
32421,2,3,113823,113823,113826,0,3,0
32422,4,3,113827,113827,113830,0,3,1
32423,6,1,113833,113833,113834,0,1,3
32424,6,2,113839,113839,113841,0,2,5
32425,4,1,113843,113843,113844,0,1,2
32426,2,2,113845,113845,113847,0,2,1
32427,3,2,113848,113848,113850,0,2,1
32428,5,1,113853,113853,113854,0,1,3
32429,1,3,113854,113854,113857,0,3,0
32430,4,1,113858,113858,113859,0,1,1
32431,5,1,113863,113863,113864,0,1,4
32432,4,1,113867,113867,113868,0,1,3
32433,2,2,113869,113869,113871,0,2,1
32434,3,2,113872,113872,113874,0,2,1
32435,5,3,113877,113877,113880,0,3,3
32436,3,1,113880,113880,113881,0,1,0
32437,3,2,113883,113883,113885,0,2,2
32438,1,2,113884,113885,113887,1,3,0
32439,1,2,113885,113887,113889,2,4,0
32440,3,2,113888,113889,113891,1,3,0
32441,4,2,113892,113892,113894,0,2,1
32442,5,3,113897,113897,113900,0,3,3
32443,2,1,113899,113900,113901,1,2,0
32444,2,1,113901,113901,113902,0,1,0
32445,1,3,113902,113902,113905,0,3,0
32446,4,1,113906,113906,113907,0,1,1
32447,6,2,113912,113912,113914,0,2,5
32448,4,1,113916,113916,113917,0,1,2
32449,6,3,113922,113922,113925,0,3,5
32450,2,3,113924,113925,113928,1,4,0
32451,4,1,113928,113928,113929,0,1,0
32452,6,2,113934,113934,113936,0,2,5
32453,1,3,113935,113936,113939,1,4,0
32454,1,2,113936,113939,113941,3,5,0
32455,2,1,113938,113941,113942,3,4,0
32456,6,2,113944,113944,113946,0,2,2
32457,4,1,113948,113948,113949,0,1,2
32458,4,2,113952,113952,113954,0,2,3
32459,2,2,113954,113954,113956,0,2,0
32460,5,1,113959,113959,113960,0,1,3
32461,1,2,113960,113960,113962,0,2,0
32462,2,1,113962,113962,113963,0,1,0
32463,5,1,113967,113967,113968,0,1,4
32464,5,2,113972,113972,113974,0,2,4
32465,1,3,113973,113974,113977,1,4,0
32466,4,2,113977,113977,113979,0,2,0
32467,2,1,113979,113979,113980,0,1,0
32468,3,2,113982,113982,113984,0,2,2
32469,2,2,113984,113984,113986,0,2,0
32470,3,3,113987,113987,113990,0,3,1
32471,1,1,113988,113990,113991,2,3,0
32472,2,1,113990,113991,113992,1,2,0
32473,1,3,113991,113992,113995,1,4,0
32474,4,1,113995,113995,113996,0,1,0
32475,1,1,113996,113996,113997,0,1,0
32476,3,2,113999,113999,114001,0,2,2
32477,4,3,114003,114003,114006,0,3,2
32478,6,2,114009,114009,114011,0,2,3
32479,5,1,114014,114014,114015,0,1,3
32480,2,3,114016,114016,114019,0,3,1
32481,6,3,114022,114022,114025,0,3,3
32482,5,1,114027,114027,114028,0,1,2
32483,2,3,114029,114029,114032,0,3,1
32484,1,1,114030,114032,114033,2,3,0
32485,6,1,114036,114036,114037,0,1,3
32486,3,3,114039,114039,114042,0,3,2
32487,6,3,114045,114045,114048,0,3,3
32488,4,3,114049,114049,114052,0,3,1
32489,1,3,114050,114052,114055,2,5,0
32490,3,1,114053,114055,114056,2,3,0
32491,2,1,114055,114056,114057,1,2,0
32492,4,1,114059,114059,114060,0,1,2
32493,5,2,114064,114064,114066,0,2,4
32494,6,3,114070,114070,114073,0,3,4
32495,2,1,114072,114073,114074,1,2,0
32496,5,2,114077,114077,114079,0,2,3
32497,1,2,114078,114079,114081,1,3,0
32498,5,2,114083,114083,114085,0,2,2
32499,6,3,114089,114089,114092,0,3,4
32500,1,3,114090,114092,114095,2,5,0
32501,4,1,114094,114095,114096,1,2,0
32502,3,1,114097,114097,114098,0,1,1
32503,4,3,114101,114101,114104,0,3,3
32504,5,3,114106,114106,114109,0,3,2
32505,5,3,114111,114111,114114,0,3,2
32506,1,1,114112,114114,114115,2,3,0
32507,1,1,114113,114115,114116,2,3,0
32508,2,2,114115,114116,114118,1,3,0
32509,4,1,114119,114119,114120,0,1,1
32510,4,2,114123,114123,114125,0,2,3
32511,4,3,114127,114127,114130,0,3,2
32512,3,1,114130,114130,114131,0,1,0
32513,2,2,114132,114132,114134,0,2,1
32514,1,3,114133,114134,114137,1,4,0
32515,5,2,114138,114138,114140,0,2,1
32516,5,1,114143,114143,114144,0,1,3
32517,6,3,114149,114149,114152,0,3,5
32518,2,3,114151,114152,114155,1,4,0
32519,2,3,114153,114155,114158,2,5,0
32520,4,3,114157,114158,114161,1,4,0
32521,4,2,114161,114161,114163,0,2,0
32522,4,2,114165,114165,114167,0,2,2
32523,4,2,114169,114169,114171,0,2,2
32524,3,2,114172,114172,114174,0,2,1
32525,4,2,114176,114176,114178,0,2,2
32526,5,1,114181,114181,114182,0,1,3
32527,2,2,114183,114183,114185,0,2,1
32528,2,1,114185,114185,114186,0,1,0
32529,5,1,114190,114190,114191,0,1,4
32530,2,2,114192,114192,114194,0,2,1
32531,6,1,114198,114198,114199,0,1,4
32532,3,3,114201,114201,114204,0,3,2
32533,2,1,114203,114204,114205,1,2,0
32534,4,1,114207,114207,114208,0,1,2
32535,3,3,114210,114210,114213,0,3,2
32536,2,2,114212,114213,114215,1,3,0
32537,2,2,114214,114215,114217,1,3,0
32538,2,2,114216,114217,114219,1,3,0
32539,5,2,114221,114221,114223,0,2,2
32540,3,2,114224,114224,114226,0,2,1
32541,4,3,114228,114228,114231,0,3,2
32542,4,3,114232,114232,114235,0,3,1
32543,5,3,114237,114237,114240,0,3,2
32544,2,3,114239,114240,114243,1,4,0
32545,1,3,114240,114243,114246,3,6,0
32546,3,3,114243,114246,114249,3,6,0
32547,4,2,114247,114249,114251,2,4,0
32548,3,3,114250,114251,114254,1,4,0
32549,3,2,114253,114254,114256,1,3,0
32550,5,3,114258,114258,114261,0,3,2
32551,3,1,114261,114261,114262,0,1,0
32552,6,2,114267,114267,114269,0,2,5
32553,6,2,114273,114273,114275,0,2,4
32554,5,3,114278,114278,114281,0,3,3
32555,3,3,114281,114281,114284,0,3,0
32556,2,3,114283,114284,114287,1,4,0
32557,3,3,114286,114287,114290,1,4,0
32558,6,3,114292,114292,114295,0,3,2
32559,1,3,114293,114295,114298,2,5,0
32560,3,3,114296,114298,114301,2,5,0
32561,5,1,114301,114301,114302,0,1,0
32562,1,3,114302,114302,114305,0,3,0
32563,4,3,114306,114306,114309,0,3,1
32564,2,1,114308,114309,114310,1,2,0
32565,2,1,114310,114310,114311,0,1,0
32566,2,3,114312,114312,114315,0,3,1
32567,1,3,114313,114315,114318,2,5,0
32568,3,2,114316,114318,114320,2,4,0
32569,5,2,114321,114321,114323,0,2,1
32570,3,3,114324,114324,114327,0,3,1
32571,1,3,114325,114327,114330,2,5,0
32572,4,3,114329,114330,114333,1,4,0
32573,6,2,114335,114335,114337,0,2,2
32574,3,2,114338,114338,114340,0,2,1
32575,3,2,114341,114341,114343,0,2,1
32576,2,2,114343,114343,114345,0,2,0
32577,1,2,114344,114345,114347,1,3,0
32578,5,2,114349,114349,114351,0,2,2
32579,4,2,114353,114353,114355,0,2,2
32580,3,1,114356,114356,114357,0,1,1
32581,1,2,114357,114357,114359,0,2,0
32582,2,1,114359,114359,114360,0,1,0
32583,2,2,114361,114361,114363,0,2,1
32584,6,1,114367,114367,114368,0,1,4
32585,2,2,114369,114369,114371,0,2,1
32586,2,2,114371,114371,114373,0,2,0
32587,4,2,114375,114375,114377,0,2,2
32588,5,3,114380,114380,114383,0,3,3
32589,1,1,114381,114383,114384,2,3,0
32590,5,3,114386,114386,114389,0,3,2
32591,4,2,114390,114390,114392,0,2,1
32592,5,2,114395,114395,114397,0,2,3
32593,2,3,114397,114397,114400,0,3,0
32594,3,3,114400,114400,114403,0,3,0
32595,6,3,114406,114406,114409,0,3,3
32596,5,1,114411,114411,114412,0,1,2
32597,1,3,114412,114412,114415,0,3,0
32598,4,3,114416,114416,114419,0,3,1
32599,2,3,114418,114419,114422,1,4,0
32600,3,1,114421,114422,114423,1,2,0
32601,4,3,114425,114425,114428,0,3,2
32602,1,2,114426,114428,114430,2,4,0
32603,4,1,114430,114430,114431,0,1,0
32604,3,2,114433,114433,114435,0,2,2
32605,2,1,114435,114435,114436,0,1,0
32606,2,1,114437,114437,114438,0,1,1
32607,6,3,114443,114443,114446,0,3,5
32608,2,3,114445,114446,114449,1,4,0
32609,1,2,114446,114449,114451,3,5,0
32610,1,1,114447,114451,114452,4,5,0
32611,6,2,114453,114453,114455,0,2,1
32612,6,3,114459,114459,114462,0,3,4
32613,2,3,114461,114462,114465,1,4,0
32614,1,2,114462,114465,114467,3,5,0
32615,5,2,114467,114467,114469,0,2,0
32616,3,2,114470,114470,114472,0,2,1
32617,3,2,114473,114473,114475,0,2,1
32618,6,1,114479,114479,114480,0,1,4
32619,5,3,114484,114484,114487,0,3,4
32620,6,1,114490,114490,114491,0,1,3
32621,3,1,114493,114493,114494,0,1,2
32622,6,2,114499,114499,114501,0,2,5
32623,1,2,114500,114501,114503,1,3,0
32624,6,3,114506,114506,114509,0,3,3
32625,2,1,114508,114509,114510,1,2,0
32626,2,3,114510,114510,114513,0,3,0
32627,1,3,114511,114513,114516,2,5,0
32628,4,3,114515,114516,114519,1,4,0
32629,5,1,114520,114520,114521,0,1,1
32630,4,2,114524,114524,114526,0,2,3
32631,3,3,114527,114527,114530,0,3,1
32632,2,2,114529,114530,114532,1,3,0
32633,3,1,114532,114532,114533,0,1,0
32634,5,2,114537,114537,114539,0,2,4
32635,4,3,114541,114541,114544,0,3,2
32636,2,1,114543,114544,114545,1,2,0
32637,1,3,114544,114545,114548,1,4,0
32638,1,2,114545,114548,114550,3,5,0
32639,3,2,114548,114550,114552,2,4,0
32640,5,3,114553,114553,114556,0,3,1
32641,4,2,114557,114557,114559,0,2,1
32642,5,1,114562,114562,114563,0,1,3
32643,6,3,114568,114568,114571,0,3,5
32644,1,2,114569,114571,114573,2,4,0
32645,5,1,114574,114574,114575,0,1,1
32646,5,1,114579,114579,114580,0,1,4
32647,6,2,114585,114585,114587,0,2,5
32648,3,2,114588,114588,114590,0,2,1
32649,2,3,114590,114590,114593,0,3,0
32650,4,2,114594,114594,114596,0,2,1
32651,1,2,114595,114596,114598,1,3,0
32652,2,2,114597,114598,114600,1,3,0
32653,2,2,114599,114600,114602,1,3,0
32654,3,3,114602,114602,114605,0,3,0
32655,5,1,114607,114607,114608,0,1,2
32656,3,3,114610,114610,114613,0,3,2
32657,2,2,114612,114613,114615,1,3,0
32658,6,3,114618,114618,114621,0,3,3
32659,6,1,114624,114624,114625,0,1,3
32660,1,1,114625,114625,114626,0,1,0
32661,3,2,114628,114628,114630,0,2,2
32662,6,1,114634,114634,114635,0,1,4
32663,6,3,114640,114640,114643,0,3,5
32664,4,1,114644,114644,114645,0,1,1
32665,6,1,114650,114650,114651,0,1,5
32666,5,2,114655,114655,114657,0,2,4
32667,2,2,114657,114657,114659,0,2,0
32668,3,2,114660,114660,114662,0,2,1
32669,2,2,114662,114662,114664,0,2,0
32670,3,2,114665,114665,114667,0,2,1
32671,5,2,114670,114670,114672,0,2,3
32672,3,1,114673,114673,114674,0,1,1
32673,4,2,114677,114677,114679,0,2,3
32674,2,1,114679,114679,114680,0,1,0
32675,5,1,114684,114684,114685,0,1,4
32676,3,3,114687,114687,114690,0,3,2
32677,3,2,114690,114690,114692,0,2,0
32678,5,1,114695,114695,114696,0,1,3
32679,2,2,114697,114697,114699,0,2,1
32680,5,2,114702,114702,114704,0,2,3
32681,1,3,114703,114704,114707,1,4,0
32682,4,2,114707,114707,114709,0,2,0
32683,3,1,114710,114710,114711,0,1,1
32684,6,3,114716,114716,114719,0,3,5
32685,4,3,114720,114720,114723,0,3,1
32686,4,1,114724,114724,114725,0,1,1
32687,3,3,114727,114727,114730,0,3,2
32688,4,2,114731,114731,114733,0,2,1
32689,3,3,114734,114734,114737,0,3,1
32690,2,2,114736,114737,114739,1,3,0
32691,2,2,114738,114739,114741,1,3,0
32692,4,1,114742,114742,114743,0,1,1
32693,2,3,114744,114744,114747,0,3,1
32694,1,1,114745,114747,114748,2,3,0
32695,6,2,114751,114751,114753,0,2,3
32696,1,1,114752,114753,114754,1,2,0
32697,5,2,114757,114757,114759,0,2,3
32698,3,1,114760,114760,114761,0,1,1
32699,1,1,114761,114761,114762,0,1,0
32700,4,3,114765,114765,114768,0,3,3
32701,6,1,114771,114771,114772,0,1,3
32702,1,2,114772,114772,114774,0,2,0
32703,3,2,114775,114775,114777,0,2,1
32704,4,1,114779,114779,114780,0,1,2
32705,1,1,114780,114780,114781,0,1,0
32706,5,2,114785,114785,114787,0,2,4
32707,3,2,114788,114788,114790,0,2,1
32708,5,1,114793,114793,114794,0,1,3
32709,4,1,114797,114797,114798,0,1,3
32710,5,1,114802,114802,114803,0,1,4
32711,5,2,114807,114807,114809,0,2,4
32712,6,2,114813,114813,114815,0,2,4
32713,6,2,114819,114819,114821,0,2,4
32714,5,1,114824,114824,114825,0,1,3
32715,2,1,114826,114826,114827,0,1,1
32716,6,3,114832,114832,114835,0,3,5
32717,3,1,114835,114835,114836,0,1,0
32718,5,3,114840,114840,114843,0,3,4
32719,2,1,114842,114843,114844,1,2,0
32720,1,1,114843,114844,114845,1,2,0
32721,2,2,114845,114845,114847,0,2,0
32722,1,1,114846,114847,114848,1,2,0
32723,3,2,114849,114849,114851,0,2,1
32724,6,2,114855,114855,114857,0,2,4
32725,3,1,114858,114858,114859,0,1,1
32726,3,3,114861,114861,114864,0,3,2
32727,3,1,114864,114864,114865,0,1,0
32728,3,2,114867,114867,114869,0,2,2
32729,4,3,114871,114871,114874,0,3,2
32730,3,1,114874,114874,114875,0,1,0
32731,6,2,114880,114880,114882,0,2,5
32732,4,1,114884,114884,114885,0,1,2
32733,4,3,114888,114888,114891,0,3,3
32734,4,1,114892,114892,114893,0,1,1
32735,4,3,114896,114896,114899,0,3,3
32736,1,3,114897,114899,114902,2,5,0
32737,2,2,114899,114902,114904,3,5,0
32738,4,1,114903,114904,114905,1,2,0
32739,4,1,114907,114907,114908,0,1,2
32740,2,3,114909,114909,114912,0,3,1
32741,1,2,114910,114912,114914,2,4,0
32742,5,3,114915,114915,114918,0,3,1
32743,1,3,114916,114918,114921,2,5,0
32744,1,1,114917,114921,114922,4,5,0
32745,5,2,114922,114922,114924,0,2,0
32746,6,1,114928,114928,114929,0,1,4
32747,5,1,114933,114933,114934,0,1,4
32748,2,2,114935,114935,114937,0,2,1
32749,6,2,114941,114941,114943,0,2,4
32750,2,1,114943,114943,114944,0,1,0
32751,2,3,114945,114945,114948,0,3,1
32752,3,2,114948,114948,114950,0,2,0
32753,2,1,114950,114950,114951,0,1,0
32754,5,3,114955,114955,114958,0,3,4
32755,4,1,114959,114959,114960,0,1,1
32756,3,2,114962,114962,114964,0,2,2
32757,5,3,114967,114967,114970,0,3,3
32758,5,2,114972,114972,114974,0,2,2
32759,3,1,114975,114975,114976,0,1,1
32760,3,3,114978,114978,114981,0,3,2
32761,2,2,114980,114981,114983,1,3,0
32762,5,3,114985,114985,114988,0,3,2
32763,2,3,114987,114988,114991,1,4,0
32764,1,2,114988,114991,114993,3,5,0
32765,4,2,114992,114993,114995,1,3,0
32766,4,3,114996,114996,114999,0,3,1
32767,2,2,114998,114999,115001,1,3,0
32768,4,2,115002,115002,115004,0,2,1
32769,2,3,115004,115004,115007,0,3,0
32770,1,1,115005,115007,115008,2,3,0
32771,4,3,115009,115009,115012,0,3,1
32772,1,1,115010,115012,115013,2,3,0
32773,3,1,115013,115013,115014,0,1,0
32774,6,1,115019,115019,115020,0,1,5
32775,4,1,115023,115023,115024,0,1,3
32776,4,3,115027,115027,115030,0,3,3
32777,3,2,115030,115030,115032,0,2,0
32778,6,3,115036,115036,115039,0,3,4
32779,4,1,115040,115040,115041,0,1,1
32780,6,2,115046,115046,115048,0,2,5
32781,5,3,115051,115051,115054,0,3,3
32782,1,3,115052,115054,115057,2,5,0
32783,2,1,115054,115057,115058,3,4,0
32784,1,3,115055,115058,115061,3,6,0
32785,2,3,115057,115061,115064,4,7,0
32786,5,1,115062,115064,115065,2,3,0
32787,5,2,115067,115067,115069,0,2,2
32788,3,3,115070,115070,115073,0,3,1
32789,1,2,115071,115073,115075,2,4,0
32790,4,2,115075,115075,115077,0,2,0
32791,2,2,115077,115077,115079,0,2,0
32792,1,1,115078,115079,115080,1,2,0
32793,5,2,115083,115083,115085,0,2,3
32794,5,2,115088,115088,115090,0,2,3
32795,6,1,115094,115094,115095,0,1,4
32796,2,3,115096,115096,115099,0,3,1
32797,5,3,115101,115101,115104,0,3,2
32798,4,1,115105,115105,115106,0,1,1
32799,4,2,115109,115109,115111,0,2,3
32800,3,1,115112,115112,115113,0,1,1
32801,2,2,115114,115114,115116,0,2,1
32802,2,3,115116,115116,115119,0,3,0
32803,5,3,115121,115121,115124,0,3,2
32804,2,2,115123,115124,115126,1,3,0
32805,1,3,115124,115126,115129,2,5,0
32806,4,2,115128,115129,115131,1,3,0
32807,4,1,115132,115132,115133,0,1,1
32808,3,3,115135,115135,115138,0,3,2
32809,1,2,115136,115138,115140,2,4,0
32810,4,3,115140,115140,115143,0,3,0
32811,2,3,115142,115143,115146,1,4,0
32812,2,3,115144,115146,115149,2,5,0
32813,4,2,115148,115149,115151,1,3,0
32814,4,1,115152,115152,115153,0,1,1
32815,2,1,115154,115154,115155,0,1,1
32816,1,2,115155,115155,115157,0,2,0
32817,6,2,115161,115161,115163,0,2,4
32818,4,1,115165,115165,115166,0,1,2
32819,4,2,115169,115169,115171,0,2,3
32820,1,3,115170,115171,115174,1,4,0
32821,4,1,115174,115174,115175,0,1,0
32822,4,1,115178,115178,115179,0,1,3
32823,5,3,115183,115183,115186,0,3,4
32824,3,2,115186,115186,115188,0,2,0
32825,1,3,115187,115188,115191,1,4,0
32826,5,2,115192,115192,115194,0,2,1
32827,3,3,115195,115195,115198,0,3,1
32828,5,1,115200,115200,115201,0,1,2
32829,3,2,115203,115203,115205,0,2,2
32830,4,1,115207,115207,115208,0,1,2
32831,3,1,115210,115210,115211,0,1,2
32832,3,1,115213,115213,115214,0,1,2
32833,4,2,115217,115217,115219,0,2,3
32834,3,1,115220,115220,115221,0,1,1
32835,6,2,115226,115226,115228,0,2,5
32836,2,1,115228,115228,115229,0,1,0
32837,2,2,115230,115230,115232,0,2,1
32838,5,3,115235,115235,115238,0,3,3
32839,5,3,115240,115240,115243,0,3,2
32840,3,2,115243,115243,115245,0,2,0
32841,4,2,115247,115247,115249,0,2,2
32842,6,3,115253,115253,115256,0,3,4
32843,2,2,115255,115256,115258,1,3,0
32844,4,3,115259,115259,115262,0,3,1
32845,1,2,115260,115262,115264,2,4,0
32846,6,1,115266,115266,115267,0,1,2
32847,3,3,115269,115269,115272,0,3,2
32848,2,3,115271,115272,115275,1,4,0
32849,1,3,115272,115275,115278,3,6,0
32850,5,1,115277,115278,115279,1,2,0
32851,4,1,115281,115281,115282,0,1,2
32852,5,3,115286,115286,115289,0,3,4
32853,1,2,115287,115289,115291,2,4,0
32854,3,2,115290,115291,115293,1,3,0
32855,5,2,115295,115295,115297,0,2,2
32856,3,3,115298,115298,115301,0,3,1
32857,5,2,115303,115303,115305,0,2,2
32858,5,3,115308,115308,115311,0,3,3
32859,6,1,115314,115314,115315,0,1,3
32860,6,2,115320,115320,115322,0,2,5
32861,2,3,115322,115322,115325,0,3,0
32862,2,1,115324,115325,115326,1,2,0
32863,2,1,115326,115326,115327,0,1,0
32864,4,3,115330,115330,115333,0,3,3
32865,1,1,115331,115333,115334,2,3,0
32866,2,1,115333,115334,115335,1,2,0
32867,5,1,115338,115338,115339,0,1,3
32868,6,3,115344,115344,115347,0,3,5
32869,3,2,115347,115347,115349,0,2,0
32870,1,3,115348,115349,115352,1,4,0
32871,2,1,115350,115352,115353,2,3,0
32872,2,1,115352,115353,115354,1,2,0
32873,6,3,115358,115358,115361,0,3,4
32874,6,2,115364,115364,115366,0,2,3
32875,2,3,115366,115366,115369,0,3,0
32876,1,3,115367,115369,115372,2,5,0
32877,2,3,115369,115372,115375,3,6,0
32878,6,2,115375,115375,115377,0,2,0
32879,2,1,115377,115377,115378,0,1,0
32880,1,1,115378,115378,115379,0,1,0
32881,1,1,115379,115379,115380,0,1,0
32882,4,2,115383,115383,115385,0,2,3
32883,5,1,115388,115388,115389,0,1,3
32884,6,1,115394,115394,115395,0,1,5
32885,4,2,115398,115398,115400,0,2,3
32886,3,3,115401,115401,115404,0,3,1
32887,4,1,115405,115405,115406,0,1,1
32888,4,1,115409,115409,115410,0,1,3
32889,4,1,115413,115413,115414,0,1,3
32890,2,3,115415,115415,115418,0,3,1
32891,6,1,115421,115421,115422,0,1,3
32892,2,3,115423,115423,115426,0,3,1
32893,5,1,115428,115428,115429,0,1,2
32894,1,2,115429,115429,115431,0,2,0
32895,4,3,115433,115433,115436,0,3,2
32896,1,1,115434,115436,115437,2,3,0
32897,3,3,115437,115437,115440,0,3,0
32898,5,2,115442,115442,115444,0,2,2
32899,3,3,115445,115445,115448,0,3,1
32900,4,3,115449,115449,115452,0,3,1
32901,1,1,115450,115452,115453,2,3,0
32902,2,1,115452,115453,115454,1,2,0
32903,5,2,115457,115457,115459,0,2,3
32904,5,3,115462,115462,115465,0,3,3
32905,3,2,115465,115465,115467,0,2,0
32906,6,1,115471,115471,115472,0,1,4
32907,1,1,115472,115472,115473,0,1,0
32908,3,3,115475,115475,115478,0,3,2
32909,5,3,115480,115480,115483,0,3,2
32910,4,1,115484,115484,115485,0,1,1
32911,5,3,115489,115489,115492,0,3,4
32912,5,3,115494,115494,115497,0,3,2
32913,3,3,115497,115497,115500,0,3,0
32914,3,2,115500,115500,115502,0,2,0
32915,5,2,115505,115505,115507,0,2,3
32916,6,3,115511,115511,115514,0,3,4
32917,5,3,115516,115516,115519,0,3,2
32918,4,2,115520,115520,115522,0,2,1
32919,4,3,115524,115524,115527,0,3,2
32920,2,3,115526,115527,115530,1,4,0
32921,3,2,115529,115530,115532,1,3,0
32922,2,1,115531,115532,115533,1,2,0
32923,4,3,115535,115535,115538,0,3,2
32924,4,3,115539,115539,115542,0,3,1
32925,4,2,115543,115543,115545,0,2,1
32926,3,3,115546,115546,115549,0,3,1
32927,2,3,115548,115549,115552,1,4,0
32928,6,3,115554,115554,115557,0,3,2
32929,4,3,115558,115558,115561,0,3,1
32930,6,3,115564,115564,115567,0,3,3
32931,5,1,115569,115569,115570,0,1,2
32932,6,2,115575,115575,115577,0,2,5
32933,5,2,115580,115580,115582,0,2,3
32934,1,1,115581,115582,115583,1,2,0
32935,4,3,115585,115585,115588,0,3,2
32936,1,2,115586,115588,115590,2,4,0
32937,5,3,115591,115591,115594,0,3,1
32938,4,2,115595,115595,115597,0,2,1
32939,2,2,115597,115597,115599,0,2,0
32940,1,1,115598,115599,115600,1,2,0
32941,4,2,115602,115602,115604,0,2,2
32942,5,3,115607,115607,115610,0,3,3
32943,4,1,115611,115611,115612,0,1,1
32944,5,1,115616,115616,115617,0,1,4
32945,4,3,115620,115620,115623,0,3,3
32946,6,2,115626,115626,115628,0,2,3
32947,6,2,115632,115632,115634,0,2,4
32948,2,3,115634,115634,115637,0,3,0
32949,6,3,115640,115640,115643,0,3,3
32950,3,2,115643,115643,115645,0,2,0
32951,1,2,115644,115645,115647,1,3,0
32952,5,3,115649,115649,115652,0,3,2
32953,3,3,115652,115652,115655,0,3,0
32954,6,3,115658,115658,115661,0,3,3
32955,6,2,115664,115664,115666,0,2,3
32956,6,2,115670,115670,115672,0,2,4
32957,4,2,115674,115674,115676,0,2,2
32958,6,1,115680,115680,115681,0,1,4
32959,1,1,115681,115681,115682,0,1,0
32960,3,3,115684,115684,115687,0,3,2
32961,5,3,115689,115689,115692,0,3,2
32962,6,3,115695,115695,115698,0,3,3
32963,6,2,115701,115701,115703,0,2,3
32964,2,3,115703,115703,115706,0,3,0
32965,1,2,115704,115706,115708,2,4,0
32966,4,1,115708,115708,115709,0,1,0
32967,3,2,115711,115711,115713,0,2,2
32968,5,2,115716,115716,115718,0,2,3
32969,1,2,115717,115718,115720,1,3,0
32970,4,2,115721,115721,115723,0,2,1
32971,4,1,115725,115725,115726,0,1,2
32972,3,2,115728,115728,115730,0,2,2
32973,4,1,115732,115732,115733,0,1,2
32974,4,3,115736,115736,115739,0,3,3
32975,4,1,115740,115740,115741,0,1,1
32976,5,2,115745,115745,115747,0,2,4
32977,4,2,115749,115749,115751,0,2,2
32978,4,1,115753,115753,115754,0,1,2
32979,4,1,115757,115757,115758,0,1,3
32980,4,3,115761,115761,115764,0,3,3
32981,2,2,115763,115764,115766,1,3,0
32982,1,3,115764,115766,115769,2,5,0
32983,4,3,115768,115769,115772,1,4,0
32984,6,3,115774,115774,115777,0,3,2
32985,1,3,115775,115777,115780,2,5,0
32986,3,3,115778,115780,115783,2,5,0
32987,6,2,115784,115784,115786,0,2,1
32988,1,1,115785,115786,115787,1,2,0
32989,1,3,115786,115787,115790,1,4,0
32990,2,3,115788,115790,115793,2,5,0
32991,3,1,115791,115793,115794,2,3,0
32992,5,2,115796,115796,115798,0,2,2
32993,4,1,115800,115800,115801,0,1,2
32994,2,1,115802,115802,115803,0,1,1
32995,2,3,115804,115804,115807,0,3,1
32996,3,1,115807,115807,115808,0,1,0
32997,6,3,115813,115813,115816,0,3,5
32998,2,2,115815,115816,115818,1,3,0
32999,4,3,115819,115819,115822,0,3,1
33000,6,1,115825,115825,115826,0,1,3
33001,3,1,115828,115828,115829,0,1,2
33002,3,3,115831,115831,115834,0,3,2
33003,5,1,115836,115836,115837,0,1,2
33004,2,3,115838,115838,115841,0,3,1
33005,2,1,115840,115841,115842,1,2,0
33006,2,2,115842,115842,115844,0,2,0
33007,1,1,115843,115844,115845,1,2,0
33008,6,1,115849,115849,115850,0,1,4
33009,1,1,115850,115850,115851,0,1,0
33010,6,3,115856,115856,115859,0,3,5
33011,2,1,115858,115859,115860,1,2,0
33012,6,1,115864,115864,115865,0,1,4
33013,3,1,115867,115867,115868,0,1,2
33014,2,1,115869,115869,115870,0,1,1
33015,1,2,115870,115870,115872,0,2,0
33016,3,1,115873,115873,115874,0,1,1
33017,6,1,115879,115879,115880,0,1,5
33018,6,2,115885,115885,115887,0,2,5
33019,6,2,115891,115891,115893,0,2,4
33020,6,1,115897,115897,115898,0,1,4
33021,3,3,115900,115900,115903,0,3,2
33022,4,1,115904,115904,115905,0,1,1
33023,3,2,115907,115907,115909,0,2,2
33024,1,1,115908,115909,115910,1,2,0
33025,1,2,115909,115910,115912,1,3,0
33026,1,3,115910,115912,115915,2,5,0
33027,5,2,115915,115915,115917,0,2,0
33028,1,1,115916,115917,115918,1,2,0
33029,4,1,115920,115920,115921,0,1,2
33030,4,2,115924,115924,115926,0,2,3
33031,5,1,115929,115929,115930,0,1,3
33032,3,1,115932,115932,115933,0,1,2
33033,2,1,115934,115934,115935,0,1,1
33034,2,1,115936,115936,115937,0,1,1
33035,4,2,115940,115940,115942,0,2,3
33036,3,1,115943,115943,115944,0,1,1
33037,3,2,115946,115946,115948,0,2,2
33038,4,3,115950,115950,115953,0,3,2
33039,6,2,115956,115956,115958,0,2,3
33040,5,1,115961,115961,115962,0,1,3
33041,4,2,115965,115965,115967,0,2,3
33042,3,1,115968,115968,115969,0,1,1
33043,6,3,115974,115974,115977,0,3,5
33044,2,3,115976,115977,115980,1,4,0
33045,3,3,115979,115980,115983,1,4,0
33046,1,3,115980,115983,115986,3,6,0
33047,5,1,115985,115986,115987,1,2,0
33048,4,2,115989,115989,115991,0,2,2
33049,3,1,115992,115992,115993,0,1,1
33050,2,3,115994,115994,115997,0,3,1
33051,6,2,116000,116000,116002,0,2,3
33052,2,1,116002,116002,116003,0,1,0
33053,3,2,116005,116005,116007,0,2,2
33054,4,3,116009,116009,116012,0,3,2
33055,4,1,116013,116013,116014,0,1,1
33056,5,3,116018,116018,116021,0,3,4
33057,3,2,116021,116021,116023,0,2,0
33058,1,3,116022,116023,116026,1,4,0
33059,5,1,116027,116027,116028,0,1,1
33060,3,2,116030,116030,116032,0,2,2
33061,3,3,116033,116033,116036,0,3,1
33062,3,2,116036,116036,116038,0,2,0
33063,3,3,116039,116039,116042,0,3,1
33064,2,2,116041,116042,116044,1,3,0
33065,1,3,116042,116044,116047,2,5,0
33066,2,3,116044,116047,116050,3,6,0
33067,5,2,116049,116050,116052,1,3,0
33068,4,2,116053,116053,116055,0,2,1
33069,2,3,116055,116055,116058,0,3,0
33070,3,3,116058,116058,116061,0,3,0
33071,4,3,116062,116062,116065,0,3,1
33072,1,1,116063,116065,116066,2,3,0
33073,3,3,116066,116066,116069,0,3,0
33074,1,3,116067,116069,116072,2,5,0
33075,3,3,116070,116072,116075,2,5,0
33076,3,2,116073,116075,116077,2,4,0
33077,4,2,116077,116077,116079,0,2,0
33078,2,3,116079,116079,116082,0,3,0
33079,5,1,116084,116084,116085,0,1,2
33080,2,1,116086,116086,116087,0,1,1
33081,3,2,116089,116089,116091,0,2,2
33082,4,2,116093,116093,116095,0,2,2
33083,2,2,116095,116095,116097,0,2,0
33084,2,2,116097,116097,116099,0,2,0
33085,4,2,116101,116101,116103,0,2,2
33086,3,1,116104,116104,116105,0,1,1
33087,2,3,116106,116106,116109,0,3,1
33088,6,1,116112,116112,116113,0,1,3
33089,3,1,116115,116115,116116,0,1,2
33090,6,3,116121,116121,116124,0,3,5
33091,3,1,116124,116124,116125,0,1,0
33092,3,3,116127,116127,116130,0,3,2
33093,1,1,116128,116130,116131,2,3,0
33094,2,2,116130,116131,116133,1,3,0
33095,5,2,116135,116135,116137,0,2,2
33096,3,2,116138,116138,116140,0,2,1
33097,1,3,116139,116140,116143,1,4,0
33098,3,3,116142,116143,116146,1,4,0
33099,6,3,116148,116148,116151,0,3,2
33100,6,3,116154,116154,116157,0,3,3
33101,5,1,116159,116159,116160,0,1,2
33102,6,2,116165,116165,116167,0,2,5
33103,1,1,116166,116167,116168,1,2,0
33104,2,2,116168,116168,116170,0,2,0
33105,2,3,116170,116170,116173,0,3,0
33106,2,3,116172,116173,116176,1,4,0
33107,6,3,116178,116178,116181,0,3,2
33108,3,1,116181,116181,116182,0,1,0
33109,2,1,116183,116183,116184,0,1,1
33110,2,3,116185,116185,116188,0,3,1
33111,1,3,116186,116188,116191,2,5,0
33112,1,2,116187,116191,116193,4,6,0
33113,6,3,116193,116193,116196,0,3,0
33114,2,1,116195,116196,116197,1,2,0
33115,6,1,116201,116201,116202,0,1,4
33116,2,3,116203,116203,116206,0,3,1
33117,6,3,116209,116209,116212,0,3,3
33118,2,1,116211,116212,116213,1,2,0
33119,6,3,116217,116217,116220,0,3,4
33120,3,2,116220,116220,116222,0,2,0
33121,2,1,116222,116222,116223,0,1,0
33122,4,3,116226,116226,116229,0,3,3
33123,6,1,116232,116232,116233,0,1,3
33124,4,2,116236,116236,116238,0,2,3
33125,1,2,116237,116238,116240,1,3,0
33126,2,1,116239,116240,116241,1,2,0
33127,6,3,116245,116245,116248,0,3,4
33128,1,3,116246,116248,116251,2,5,0
33129,6,3,116252,116252,116255,0,3,1
33130,5,2,116257,116257,116259,0,2,2
33131,3,1,116260,116260,116261,0,1,1
33132,2,3,116262,116262,116265,0,3,1
33133,2,2,116264,116265,116267,1,3,0
33134,4,2,116268,116268,116270,0,2,1
33135,2,3,116270,116270,116273,0,3,0
33136,1,2,116271,116273,116275,2,4,0
33137,3,1,116274,116275,116276,1,2,0
33138,2,1,116276,116276,116277,0,1,0
33139,1,2,116277,116277,116279,0,2,0
33140,3,3,116280,116280,116283,0,3,1
33141,3,2,116283,116283,116285,0,2,0
33142,3,2,116286,116286,116288,0,2,1
33143,2,3,116288,116288,116291,0,3,0
33144,5,3,116293,116293,116296,0,3,2
33145,1,2,116294,116296,116298,2,4,0
33146,1,3,116295,116298,116301,3,6,0
33147,1,3,116296,116301,116304,5,8,0
33148,4,1,116300,116304,116305,4,5,0
33149,4,2,116304,116305,116307,1,3,0
33150,4,1,116308,116308,116309,0,1,1
33151,1,2,116309,116309,116311,0,2,0
33152,5,3,116314,116314,116317,0,3,3
33153,2,1,116316,116317,116318,1,2,0
33154,4,1,116320,116320,116321,0,1,2
33155,3,1,116323,116323,116324,0,1,2
33156,6,3,116329,116329,116332,0,3,5
33157,6,2,116335,116335,116337,0,2,3
33158,3,2,116338,116338,116340,0,2,1
33159,4,2,116342,116342,116344,0,2,2
33160,4,2,116346,116346,116348,0,2,2
33161,1,1,116347,116348,116349,1,2,0
33162,1,2,116348,116349,116351,1,3,0
33163,6,1,116354,116354,116355,0,1,3
33164,6,1,116360,116360,116361,0,1,5
33165,1,3,116361,116361,116364,0,3,0
33166,6,3,116367,116367,116370,0,3,3
33167,6,3,116373,116373,116376,0,3,3
33168,5,3,116378,116378,116381,0,3,2
33169,3,3,116381,116381,116384,0,3,0
33170,6,1,116387,116387,116388,0,1,3
33171,4,3,116391,116391,116394,0,3,3
33172,2,2,116393,116394,116396,1,3,0
33173,5,1,116398,116398,116399,0,1,2
33174,2,2,116400,116400,116402,0,2,1
33175,6,3,116406,116406,116409,0,3,4
33176,5,3,116411,116411,116414,0,3,2
33177,4,2,116415,116415,116417,0,2,1
33178,1,1,116416,116417,116418,1,2,0
33179,2,1,116418,116418,116419,0,1,0
33180,6,1,116424,116424,116425,0,1,5
33181,1,1,116425,116425,116426,0,1,0
33182,3,1,116428,116428,116429,0,1,2
33183,6,1,116434,116434,116435,0,1,5
33184,6,3,116440,116440,116443,0,3,5
33185,4,1,116444,116444,116445,0,1,1
33186,3,3,116447,116447,116450,0,3,2
33187,4,2,116451,116451,116453,0,2,1
33188,5,1,116456,116456,116457,0,1,3
33189,1,3,116457,116457,116460,0,3,0
33190,1,3,116458,116460,116463,2,5,0
33191,2,3,116460,116463,116466,3,6,0
33192,2,2,116462,116466,116468,4,6,0
33193,3,2,116465,116468,116470,3,5,0
33194,6,2,116471,116471,116473,0,2,1
33195,3,3,116474,116474,116477,0,3,1
33196,5,1,116479,116479,116480,0,1,2
33197,3,3,116482,116482,116485,0,3,2
33198,3,1,116485,116485,116486,0,1,0
33199,4,2,116489,116489,116491,0,2,3
33200,4,3,116493,116493,116496,0,3,2
33201,1,2,116494,116496,116498,2,4,0
33202,1,3,116495,116498,116501,3,6,0
33203,4,3,116499,116501,116504,2,5,0
33204,4,2,116503,116504,116506,1,3,0
33205,6,3,116509,116509,116512,0,3,3
33206,1,2,116510,116512,116514,2,4,0
33207,5,1,116515,116515,116516,0,1,1
33208,1,1,116516,116516,116517,0,1,0
33209,4,1,116520,116520,116521,0,1,3
33210,5,3,116525,116525,116528,0,3,4
33211,2,3,116527,116528,116531,1,4,0
33212,2,2,116529,116531,116533,2,4,0
33213,6,1,116535,116535,116536,0,1,2
33214,4,2,116539,116539,116541,0,2,3
33215,1,2,116540,116541,116543,1,3,0
33216,5,1,116545,116545,116546,0,1,2
33217,1,1,116546,116546,116547,0,1,0
33218,4,3,116550,116550,116553,0,3,3
33219,5,3,116555,116555,116558,0,3,2
33220,4,3,116559,116559,116562,0,3,1
33221,5,1,116564,116564,116565,0,1,2
33222,1,3,116565,116565,116568,0,3,0
33223,3,1,116568,116568,116569,0,1,0
33224,3,1,116571,116571,116572,0,1,2
33225,2,3,116573,116573,116576,0,3,1
33226,3,1,116576,116576,116577,0,1,0
33227,4,2,116580,116580,116582,0,2,3
33228,5,3,116585,116585,116588,0,3,3
33229,1,1,116586,116588,116589,2,3,0
33230,3,3,116589,116589,116592,0,3,0
33231,6,3,116595,116595,116598,0,3,3
33232,6,3,116601,116601,116604,0,3,3
33233,4,1,116605,116605,116606,0,1,1
33234,4,2,116609,116609,116611,0,2,3
33235,2,3,116611,116611,116614,0,3,0
33236,5,2,116616,116616,116618,0,2,2
33237,5,2,116621,116621,116623,0,2,3
33238,3,2,116624,116624,116626,0,2,1
33239,5,1,116629,116629,116630,0,1,3
33240,5,3,116634,116634,116637,0,3,4
33241,4,1,116638,116638,116639,0,1,1
33242,1,2,116639,116639,116641,0,2,0
33243,4,3,116643,116643,116646,0,3,2
33244,4,2,116647,116647,116649,0,2,1
33245,5,1,116652,116652,116653,0,1,3
33246,6,1,116658,116658,116659,0,1,5
33247,2,3,116660,116660,116663,0,3,1
33248,3,2,116663,116663,116665,0,2,0
33249,6,3,116669,116669,116672,0,3,4
33250,5,1,116674,116674,116675,0,1,2
33251,3,3,116677,116677,116680,0,3,2
33252,5,1,116682,116682,116683,0,1,2
33253,1,2,116683,116683,116685,0,2,0
33254,2,2,116685,116685,116687,0,2,0
33255,4,2,116689,116689,116691,0,2,2
33256,4,3,116693,116693,116696,0,3,2
33257,5,2,116698,116698,116700,0,2,2
33258,1,2,116699,116700,116702,1,3,0
33259,1,1,116700,116702,116703,2,3,0
33260,6,1,116706,116706,116707,0,1,3
33261,4,2,116710,116710,116712,0,2,3
33262,1,2,116711,116712,116714,1,3,0
33263,2,2,116713,116714,116716,1,3,0
33264,2,3,116715,116716,116719,1,4,0
33265,6,1,116721,116721,116722,0,1,2
33266,5,2,116726,116726,116728,0,2,4
33267,4,2,116730,116730,116732,0,2,2
33268,2,3,116732,116732,116735,0,3,0
33269,4,2,116736,116736,116738,0,2,1
33270,6,1,116742,116742,116743,0,1,4
33271,4,1,116746,116746,116747,0,1,3
33272,5,3,116751,116751,116754,0,3,4
33273,6,2,116757,116757,116759,0,2,3
33274,3,2,116760,116760,116762,0,2,1
33275,5,2,116765,116765,116767,0,2,3
33276,3,3,116768,116768,116771,0,3,1
33277,2,3,116770,116771,116774,1,4,0
33278,5,3,116775,116775,116778,0,3,1
33279,1,2,116776,116778,116780,2,4,0
33280,1,1,116777,116780,116781,3,4,0
33281,1,1,116778,116781,116782,3,4,0
33282,6,1,116784,116784,116785,0,1,2
33283,3,1,116787,116787,116788,0,1,2
33284,1,1,116788,116788,116789,0,1,0
33285,6,2,116794,116794,116796,0,2,5
33286,3,1,116797,116797,116798,0,1,1
33287,4,3,116801,116801,116804,0,3,3
33288,1,2,116802,116804,116806,2,4,0
33289,3,3,116805,116806,116809,1,4,0
33290,3,1,116808,116809,116810,1,2,0
33291,4,2,116812,116812,116814,0,2,2
33292,5,2,116817,116817,116819,0,2,3
33293,2,1,116819,116819,116820,0,1,0
33294,2,3,116821,116821,116824,0,3,1
33295,1,2,116822,116824,116826,2,4,0
33296,2,1,116824,116826,116827,2,3,0
33297,3,1,116827,116827,116828,0,1,0
33298,1,2,116828,116828,116830,0,2,0
33299,5,2,116833,116833,116835,0,2,3
33300,5,1,116838,116838,116839,0,1,3
33301,1,1,116839,116839,116840,0,1,0
33302,4,1,116843,116843,116844,0,1,3
33303,5,3,116848,116848,116851,0,3,4
33304,3,2,116851,116851,116853,0,2,0
33305,6,3,116857,116857,116860,0,3,4
33306,3,3,116860,116860,116863,0,3,0
33307,6,3,116866,116866,116869,0,3,3
33308,4,1,116870,116870,116871,0,1,1
33309,1,1,116871,116871,116872,0,1,0
33310,6,2,116877,116877,116879,0,2,5
33311,5,2,116882,116882,116884,0,2,3
33312,3,2,116885,116885,116887,0,2,1
33313,4,1,116889,116889,116890,0,1,2
33314,1,2,116890,116890,116892,0,2,0
33315,6,1,116896,116896,116897,0,1,4
33316,6,1,116902,116902,116903,0,1,5
33317,5,1,116907,116907,116908,0,1,4
33318,4,3,116911,116911,116914,0,3,3
33319,6,3,116917,116917,116920,0,3,3
33320,4,2,116921,116921,116923,0,2,1
33321,1,2,116922,116923,116925,1,3,0
33322,4,1,116926,116926,116927,0,1,1
33323,4,2,116930,116930,116932,0,2,3
33324,6,2,116936,116936,116938,0,2,4
33325,5,3,116941,116941,116944,0,3,3
33326,4,3,116945,116945,116948,0,3,1
33327,2,1,116947,116948,116949,1,2,0
33328,3,1,116950,116950,116951,0,1,1
33329,2,1,116952,116952,116953,0,1,1
33330,6,2,116958,116958,116960,0,2,5
33331,1,3,116959,116960,116963,1,4,0
33332,6,1,116965,116965,116966,0,1,2
33333,5,1,116970,116970,116971,0,1,4
33334,5,3,116975,116975,116978,0,3,4
33335,5,3,116980,116980,116983,0,3,2
33336,1,3,116981,116983,116986,2,5,0
33337,5,1,116986,116986,116987,0,1,0
33338,3,1,116989,116989,116990,0,1,2
33339,5,1,116994,116994,116995,0,1,4
33340,3,2,116997,116997,116999,0,2,2
33341,4,2,117001,117001,117003,0,2,2
33342,5,3,117006,117006,117009,0,3,3
33343,1,2,117007,117009,117011,2,4,0
33344,3,1,117010,117011,117012,1,2,0
33345,2,1,117012,117012,117013,0,1,0
33346,3,3,117015,117015,117018,0,3,2
33347,5,3,117020,117020,117023,0,3,2
33348,1,3,117021,117023,117026,2,5,0
33349,2,3,117023,117026,117029,3,6,0
33350,6,3,117029,117029,117032,0,3,0
33351,2,1,117031,117032,117033,1,2,0
33352,4,1,117035,117035,117036,0,1,2
33353,1,3,117036,117036,117039,0,3,0
33354,1,1,117037,117039,117040,2,3,0
33355,4,1,117041,117041,117042,0,1,1
33356,5,3,117046,117046,117049,0,3,4
33357,6,2,117052,117052,117054,0,2,3
33358,6,3,117058,117058,117061,0,3,4
33359,2,2,117060,117061,117063,1,3,0
33360,1,3,117061,117063,117066,2,5,0
33361,2,2,117063,117066,117068,3,5,0
33362,1,1,117064,117068,117069,4,5,0
33363,5,3,117069,117069,117072,0,3,0
33364,6,2,117075,117075,117077,0,2,3
33365,4,3,117079,117079,117082,0,3,2
33366,2,3,117081,117082,117085,1,4,0
33367,5,2,117086,117086,117088,0,2,1
33368,3,3,117089,117089,117092,0,3,1
33369,5,1,117094,117094,117095,0,1,2
33370,5,3,117099,117099,117102,0,3,4
33371,3,3,117102,117102,117105,0,3,0
33372,6,1,117108,117108,117109,0,1,3
33373,1,1,117109,117109,117110,0,1,0
33374,3,2,117112,117112,117114,0,2,2
33375,3,2,117115,117115,117117,0,2,1
33376,2,2,117117,117117,117119,0,2,0
33377,5,2,117122,117122,117124,0,2,3
33378,6,1,117128,117128,117129,0,1,4
33379,1,2,117129,117129,117131,0,2,0
33380,6,1,117135,117135,117136,0,1,4
33381,1,3,117136,117136,117139,0,3,0
33382,2,1,117138,117139,117140,1,2,0
33383,2,1,117140,117140,117141,0,1,0
33384,6,2,117146,117146,117148,0,2,5
33385,4,1,117150,117150,117151,0,1,2
33386,4,1,117154,117154,117155,0,1,3
33387,3,3,117157,117157,117160,0,3,2
33388,5,2,117162,117162,117164,0,2,2
33389,4,1,117166,117166,117167,0,1,2
33390,3,3,117169,117169,117172,0,3,2
33391,4,3,117173,117173,117176,0,3,1
33392,1,3,117174,117176,117179,2,5,0
33393,4,1,117178,117179,117180,1,2,0
33394,6,1,117184,117184,117185,0,1,4
33395,6,3,117190,117190,117193,0,3,5
33396,6,1,117196,117196,117197,0,1,3
33397,6,1,117202,117202,117203,0,1,5
33398,1,1,117203,117203,117204,0,1,0
33399,4,1,117207,117207,117208,0,1,3
33400,2,3,117209,117209,117212,0,3,1
33401,4,1,117213,117213,117214,0,1,1
33402,5,1,117218,117218,117219,0,1,4
33403,3,1,117221,117221,117222,0,1,2
33404,6,2,117227,117227,117229,0,2,5
33405,5,1,117232,117232,117233,0,1,3
33406,4,2,117236,117236,117238,0,2,3
33407,4,3,117240,117240,117243,0,3,2
33408,4,1,117244,117244,117245,0,1,1
33409,5,1,117249,117249,117250,0,1,4
33410,2,2,117251,117251,117253,0,2,1
33411,1,1,117252,117253,117254,1,2,0
33412,1,3,117253,117254,117257,1,4,0
33413,4,1,117257,117257,117258,0,1,0
33414,5,1,117262,117262,117263,0,1,4
33415,3,1,117265,117265,117266,0,1,2
33416,6,3,117271,117271,117274,0,3,5
33417,1,1,117272,117274,117275,2,3,0
33418,1,3,117273,117275,117278,2,5,0
33419,2,1,117275,117278,117279,3,4,0
33420,5,3,117280,117280,117283,0,3,1
33421,6,3,117286,117286,117289,0,3,3
33422,6,2,117292,117292,117294,0,2,3
33423,3,1,117295,117295,117296,0,1,1
33424,2,2,117297,117297,117299,0,2,1
33425,1,3,117298,117299,117302,1,4,0
33426,4,2,117302,117302,117304,0,2,0
33427,2,3,117304,117304,117307,0,3,0
33428,1,3,117305,117307,117310,2,5,0
33429,6,3,117311,117311,117314,0,3,1
33430,2,1,117313,117314,117315,1,2,0
33431,5,2,117318,117318,117320,0,2,3
33432,4,3,117322,117322,117325,0,3,2
33433,2,1,117324,117325,117326,1,2,0
33434,6,3,117330,117330,117333,0,3,4
33435,5,3,117335,117335,117338,0,3,2
33436,2,2,117337,117338,117340,1,3,0
33437,3,3,117340,117340,117343,0,3,0
33438,6,2,117346,117346,117348,0,2,3
33439,3,3,117349,117349,117352,0,3,1
33440,2,2,117351,117352,117354,1,3,0
33441,1,3,117352,117354,117357,2,5,0
33442,4,2,117356,117357,117359,1,3,0
33443,5,1,117361,117361,117362,0,1,2
33444,1,3,117362,117362,117365,0,3,0
33445,6,3,117368,117368,117371,0,3,3
33446,6,1,117374,117374,117375,0,1,3
33447,2,3,117376,117376,117379,0,3,1
33448,6,1,117382,117382,117383,0,1,3
33449,6,2,117388,117388,117390,0,2,5
33450,4,2,117392,117392,117394,0,2,2
33451,1,2,117393,117394,117396,1,3,0
33452,1,2,117394,117396,117398,2,4,0
33453,2,1,117396,117398,117399,2,3,0
33454,2,3,117398,117399,117402,1,4,0
33455,3,3,117401,117402,117405,1,4,0
33456,1,1,117402,117405,117406,3,4,0
33457,5,3,117407,117407,117410,0,3,1
33458,2,3,117409,117410,117413,1,4,0
33459,6,2,117415,117415,117417,0,2,2
33460,4,1,117419,117419,117420,0,1,2
33461,3,3,117422,117422,117425,0,3,2
33462,6,3,117428,117428,117431,0,3,3
33463,6,1,117434,117434,117435,0,1,3
33464,5,3,117439,117439,117442,0,3,4
33465,1,1,117440,117442,117443,2,3,0
33466,5,3,117445,117445,117448,0,3,2
33467,2,2,117447,117448,117450,1,3,0
33468,6,2,117453,117453,117455,0,2,3
33469,2,2,117455,117455,117457,0,2,0
33470,4,3,117459,117459,117462,0,3,2
33471,3,1,117462,117462,117463,0,1,0
33472,1,2,117463,117463,117465,0,2,0
33473,3,1,117466,117466,117467,0,1,1
33474,1,1,117467,117467,117468,0,1,0
33475,5,2,117472,117472,117474,0,2,4
33476,2,3,117474,117474,117477,0,3,0
33477,6,1,117480,117480,117481,0,1,3
33478,5,1,117485,117485,117486,0,1,4
33479,3,3,117488,117488,117491,0,3,2
33480,1,1,117489,117491,117492,2,3,0
33481,4,1,117493,117493,117494,0,1,1
33482,4,3,117497,117497,117500,0,3,3
33483,6,1,117503,117503,117504,0,1,3
33484,1,1,117504,117504,117505,0,1,0
33485,6,2,117510,117510,117512,0,2,5
33486,6,2,117516,117516,117518,0,2,4
33487,5,3,117521,117521,117524,0,3,3
33488,4,3,117525,117525,117528,0,3,1
33489,1,2,117526,117528,117530,2,4,0
33490,6,1,117532,117532,117533,0,1,2
33491,6,1,117538,117538,117539,0,1,5
33492,6,2,117544,117544,117546,0,2,5
33493,2,3,117546,117546,117549,0,3,0
33494,6,2,117552,117552,117554,0,2,3
33495,5,2,117557,117557,117559,0,2,3
33496,4,1,117561,117561,117562,0,1,2
33497,3,1,117564,117564,117565,0,1,2
33498,2,3,117566,117566,117569,0,3,1
33499,3,1,117569,117569,117570,0,1,0
33500,1,3,117570,117570,117573,0,3,0
33501,4,3,117574,117574,117577,0,3,1
33502,5,2,117579,117579,117581,0,2,2
33503,6,1,117585,117585,117586,0,1,4
33504,6,2,117591,117591,117593,0,2,5
33505,3,1,117594,117594,117595,0,1,1
33506,6,1,117600,117600,117601,0,1,5
33507,4,1,117604,117604,117605,0,1,3
33508,4,2,117608,117608,117610,0,2,3
33509,3,1,117611,117611,117612,0,1,1
33510,2,1,117613,117613,117614,0,1,1
33511,6,1,117619,117619,117620,0,1,5
33512,2,3,117621,117621,117624,0,3,1
33513,1,1,117622,117624,117625,2,3,0
33514,6,3,117628,117628,117631,0,3,3
33515,3,2,117631,117631,117633,0,2,0
33516,6,1,117637,117637,117638,0,1,4
33517,2,2,117639,117639,117641,0,2,1
33518,3,1,117642,117642,117643,0,1,1
33519,5,3,117647,117647,117650,0,3,4
33520,5,1,117652,117652,117653,0,1,2
33521,4,3,117656,117656,117659,0,3,3
33522,5,2,117661,117661,117663,0,2,2
33523,5,1,117666,117666,117667,0,1,3
33524,2,2,117668,117668,117670,0,2,1
33525,5,2,117673,117673,117675,0,2,3
33526,4,3,117677,117677,117680,0,3,2
33527,6,3,117683,117683,117686,0,3,3
33528,3,1,117686,117686,117687,0,1,0
33529,4,2,117690,117690,117692,0,2,3
33530,1,3,117691,117692,117695,1,4,0
33531,2,2,117693,117695,117697,2,4,0
33532,1,3,117694,117697,117700,3,6,0
33533,1,1,117695,117700,117701,5,6,0
33534,3,3,117698,117701,117704,3,6,0
33535,6,3,117704,117704,117707,0,3,0
33536,1,1,117705,117707,117708,2,3,0
33537,4,2,117709,117709,117711,0,2,1
33538,4,2,117713,117713,117715,0,2,2
33539,2,2,117715,117715,117717,0,2,0
33540,4,3,117719,117719,117722,0,3,2
33541,2,1,117721,117722,117723,1,2,0
33542,2,3,117723,117723,117726,0,3,0
33543,2,3,117725,117726,117729,1,4,0
33544,1,1,117726,117729,117730,3,4,0
33545,3,2,117729,117730,117732,1,3,0
33546,5,3,117734,117734,117737,0,3,2
33547,4,2,117738,117738,117740,0,2,1
33548,2,1,117740,117740,117741,0,1,0
33549,4,2,117744,117744,117746,0,2,3
33550,3,2,117747,117747,117749,0,2,1
33551,1,2,117748,117749,117751,1,3,0
33552,4,2,117752,117752,117754,0,2,1
33553,5,3,117757,117757,117760,0,3,3
33554,3,2,117760,117760,117762,0,2,0
33555,4,1,117764,117764,117765,0,1,2
33556,1,2,117765,117765,117767,0,2,0
33557,1,3,117766,117767,117770,1,4,0
33558,6,1,117772,117772,117773,0,1,2
33559,2,1,117774,117774,117775,0,1,1
33560,6,1,117780,117780,117781,0,1,5
33561,6,2,117786,117786,117788,0,2,5
33562,4,3,117790,117790,117793,0,3,2
33563,2,1,117792,117793,117794,1,2,0
33564,2,2,117794,117794,117796,0,2,0
33565,3,3,117797,117797,117800,0,3,1
33566,4,3,117801,117801,117804,0,3,1
33567,3,3,117804,117804,117807,0,3,0
33568,4,1,117808,117808,117809,0,1,1
33569,1,3,117809,117809,117812,0,3,0
33570,1,2,117810,117812,117814,2,4,0
33571,2,2,117812,117814,117816,2,4,0
33572,6,1,117818,117818,117819,0,1,2
33573,3,1,117821,117821,117822,0,1,2
33574,1,3,117822,117822,117825,0,3,0
33575,6,3,117828,117828,117831,0,3,3
33576,2,3,117830,117831,117834,1,4,0
33577,1,3,117831,117834,117837,3,6,0
33578,3,3,117834,117837,117840,3,6,0
33579,5,2,117839,117840,117842,1,3,0
33580,4,2,117843,117843,117845,0,2,1
33581,4,1,117847,117847,117848,0,1,2
33582,3,1,117850,117850,117851,0,1,2
33583,2,3,117852,117852,117855,0,3,1
33584,4,1,117856,117856,117857,0,1,1
33585,3,2,117859,117859,117861,0,2,2
33586,6,1,117865,117865,117866,0,1,4
33587,6,1,117871,117871,117872,0,1,5
33588,4,3,117875,117875,117878,0,3,3
33589,4,2,117879,117879,117881,0,2,1
33590,5,1,117884,117884,117885,0,1,3
33591,2,2,117886,117886,117888,0,2,1
33592,2,1,117888,117888,117889,0,1,0
33593,5,2,117893,117893,117895,0,2,4
33594,4,2,117897,117897,117899,0,2,2
33595,2,3,117899,117899,117902,0,3,0
33596,5,1,117904,117904,117905,0,1,2
33597,3,3,117907,117907,117910,0,3,2
33598,6,3,117913,117913,117916,0,3,3
33599,6,1,117919,117919,117920,0,1,3
33600,6,3,117925,117925,117928,0,3,5
33601,6,1,117931,117931,117932,0,1,3
33602,6,2,117937,117937,117939,0,2,5
33603,4,2,117941,117941,117943,0,2,2
33604,2,3,117943,117943,117946,0,3,0
33605,4,2,117947,117947,117949,0,2,1
33606,2,2,117949,117949,117951,0,2,0
33607,5,3,117954,117954,117957,0,3,3
33608,2,2,117956,117957,117959,1,3,0
33609,1,3,117957,117959,117962,2,5,0
33610,2,3,117959,117962,117965,3,6,0
33611,1,2,117960,117965,117967,5,7,0
33612,5,3,117965,117967,117970,2,5,0
33613,3,2,117968,117970,117972,2,4,0
33614,5,1,117973,117973,117974,0,1,1
33615,1,1,117974,117974,117975,0,1,0
33616,6,2,117980,117980,117982,0,2,5
33617,4,3,117984,117984,117987,0,3,2
33618,3,1,117987,117987,117988,0,1,0
33619,1,2,117988,117988,117990,0,2,0
33620,5,3,117993,117993,117996,0,3,3
33621,1,2,117994,117996,117998,2,4,0
33622,5,1,117999,117999,118000,0,1,1
33623,6,2,118005,118005,118007,0,2,5
33624,1,3,118006,118007,118010,1,4,0
33625,4,3,118010,118010,118013,0,3,0
33626,3,1,118013,118013,118014,0,1,0
33627,5,3,118018,118018,118021,0,3,4
33628,1,1,118019,118021,118022,2,3,0
33629,6,2,118025,118025,118027,0,2,3
33630,6,1,118031,118031,118032,0,1,4
33631,6,1,118037,118037,118038,0,1,5
33632,5,3,118042,118042,118045,0,3,4
33633,4,2,118046,118046,118048,0,2,1
33634,1,1,118047,118048,118049,1,2,0
33635,6,3,118053,118053,118056,0,3,4
33636,3,2,118056,118056,118058,0,2,0
33637,1,2,118057,118058,118060,1,3,0
33638,3,1,118060,118060,118061,0,1,0
33639,2,2,118062,118062,118064,0,2,1
33640,3,2,118065,118065,118067,0,2,1
33641,2,3,118067,118067,118070,0,3,0
33642,4,2,118071,118071,118073,0,2,1
33643,6,1,118077,118077,118078,0,1,4
33644,2,2,118079,118079,118081,0,2,1
33645,2,1,118081,118081,118082,0,1,0
33646,5,1,118086,118086,118087,0,1,4
33647,4,1,118090,118090,118091,0,1,3
33648,3,3,118093,118093,118096,0,3,2
33649,6,1,118099,118099,118100,0,1,3
33650,1,2,118100,118100,118102,0,2,0
33651,3,3,118103,118103,118106,0,3,1
33652,5,3,118108,118108,118111,0,3,2
33653,2,2,118110,118111,118113,1,3,0
33654,4,2,118114,118114,118116,0,2,1
33655,4,1,118118,118118,118119,0,1,2
33656,5,2,118123,118123,118125,0,2,4
33657,3,3,118126,118126,118129,0,3,1
33658,5,2,118131,118131,118133,0,2,2
33659,2,1,118133,118133,118134,0,1,0
33660,5,3,118138,118138,118141,0,3,4
33661,4,1,118142,118142,118143,0,1,1
33662,6,3,118148,118148,118151,0,3,5
33663,5,2,118153,118153,118155,0,2,2
33664,2,3,118155,118155,118158,0,3,0
33665,4,1,118159,118159,118160,0,1,1
33666,6,1,118165,118165,118166,0,1,5
33667,5,2,118170,118170,118172,0,2,4
33668,2,2,118172,118172,118174,0,2,0
33669,6,3,118178,118178,118181,0,3,4
33670,1,2,118179,118181,118183,2,4,0
33671,4,3,118183,118183,118186,0,3,0
33672,5,3,118188,118188,118191,0,3,2
33673,1,3,118189,118191,118194,2,5,0
33674,1,2,118190,118194,118196,4,6,0
33675,4,3,118194,118196,118199,2,5,0
33676,4,2,118198,118199,118201,1,3,0
33677,4,1,118202,118202,118203,0,1,1
33678,3,1,118205,118205,118206,0,1,2
33679,2,2,118207,118207,118209,0,2,1
33680,2,3,118209,118209,118212,0,3,0
33681,4,2,118213,118213,118215,0,2,1
33682,1,2,118214,118215,118217,1,3,0
33683,5,3,118219,118219,118222,0,3,2
33684,6,3,118225,118225,118228,0,3,3
33685,4,1,118229,118229,118230,0,1,1
33686,6,1,118235,118235,118236,0,1,5
33687,3,3,118238,118238,118241,0,3,2
33688,4,2,118242,118242,118244,0,2,1
33689,5,1,118247,118247,118248,0,1,3
33690,5,1,118252,118252,118253,0,1,4
33691,3,2,118255,118255,118257,0,2,2
33692,4,2,118259,118259,118261,0,2,2
33693,3,3,118262,118262,118265,0,3,1
33694,6,3,118268,118268,118271,0,3,3
33695,2,3,118270,118271,118274,1,4,0
33696,3,1,118273,118274,118275,1,2,0
33697,2,2,118275,118275,118277,0,2,0
33698,4,1,118279,118279,118280,0,1,2
33699,4,3,118283,118283,118286,0,3,3
33700,4,3,118287,118287,118290,0,3,1
33701,2,2,118289,118290,118292,1,3,0
33702,5,1,118294,118294,118295,0,1,2
33703,6,1,118300,118300,118301,0,1,5
33704,5,3,118305,118305,118308,0,3,4
33705,3,2,118308,118308,118310,0,2,0
33706,2,3,118310,118310,118313,0,3,0
33707,5,2,118315,118315,118317,0,2,2
33708,3,1,118318,118318,118319,0,1,1
33709,1,2,118319,118319,118321,0,2,0
33710,1,2,118320,118321,118323,1,3,0
33711,4,2,118324,118324,118326,0,2,1
33712,3,1,118327,118327,118328,0,1,1
33713,3,2,118330,118330,118332,0,2,2
33714,3,3,118333,118333,118336,0,3,1
33715,4,1,118337,118337,118338,0,1,1
33716,3,3,118340,118340,118343,0,3,2
33717,3,3,118343,118343,118346,0,3,0
33718,5,3,118348,118348,118351,0,3,2
33719,5,1,118353,118353,118354,0,1,2
33720,6,3,118359,118359,118362,0,3,5
33721,2,3,118361,118362,118365,1,4,0
33722,4,1,118365,118365,118366,0,1,0
33723,2,3,118367,118367,118370,0,3,1
33724,6,3,118373,118373,118376,0,3,3
33725,1,1,118374,118376,118377,2,3,0
33726,6,3,118380,118380,118383,0,3,3
33727,1,2,118381,118383,118385,2,4,0
33728,1,1,118382,118385,118386,3,4,0
33729,6,3,118388,118388,118391,0,3,2
33730,2,3,118390,118391,118394,1,4,0
33731,3,1,118393,118394,118395,1,2,0
33732,1,3,118394,118395,118398,1,4,0
33733,6,2,118400,118400,118402,0,2,2
33734,5,1,118405,118405,118406,0,1,3
33735,4,1,118409,118409,118410,0,1,3
33736,3,2,118412,118412,118414,0,2,2
33737,3,2,118415,118415,118417,0,2,1
33738,4,3,118419,118419,118422,0,3,2
33739,3,2,118422,118422,118424,0,2,0
33740,6,3,118428,118428,118431,0,3,4
33741,2,1,118430,118431,118432,1,2,0
33742,5,2,118435,118435,118437,0,2,3
33743,4,3,118439,118439,118442,0,3,2
33744,1,1,118440,118442,118443,2,3,0
33745,5,2,118445,118445,118447,0,2,2
33746,1,3,118446,118447,118450,1,4,0
33747,2,1,118448,118450,118451,2,3,0
33748,3,1,118451,118451,118452,0,1,0
33749,1,2,118452,118452,118454,0,2,0
33750,5,2,118457,118457,118459,0,2,3
33751,6,2,118463,118463,118465,0,2,4
33752,3,3,118466,118466,118469,0,3,1
33753,1,1,118467,118469,118470,2,3,0
33754,6,3,118473,118473,118476,0,3,3
33755,4,1,118477,118477,118478,0,1,1
33756,2,1,118479,118479,118480,0,1,1
33757,6,1,118485,118485,118486,0,1,5
33758,3,1,118488,118488,118489,0,1,2
33759,5,1,118493,118493,118494,0,1,4
33760,4,2,118497,118497,118499,0,2,3
33761,4,2,118501,118501,118503,0,2,2
33762,2,3,118503,118503,118506,0,3,0
33763,6,1,118509,118509,118510,0,1,3
33764,3,1,118512,118512,118513,0,1,2
33765,5,1,118517,118517,118518,0,1,4
33766,6,2,118523,118523,118525,0,2,5
33767,1,1,118524,118525,118526,1,2,0
33768,3,3,118527,118527,118530,0,3,1
33769,1,1,118528,118530,118531,2,3,0
33770,6,3,118534,118534,118537,0,3,3
33771,4,2,118538,118538,118540,0,2,1
33772,3,2,118541,118541,118543,0,2,1
33773,2,3,118543,118543,118546,0,3,0
33774,3,1,118546,118546,118547,0,1,0
33775,5,3,118551,118551,118554,0,3,4
33776,4,1,118555,118555,118556,0,1,1
33777,1,3,118556,118556,118559,0,3,0
33778,4,2,118560,118560,118562,0,2,1
33779,1,3,118561,118562,118565,1,4,0
33780,4,2,118565,118565,118567,0,2,0
33781,2,3,118567,118567,118570,0,3,0
33782,6,3,118573,118573,118576,0,3,3
33783,1,3,118574,118576,118579,2,5,0
33784,6,2,118580,118580,118582,0,2,1
33785,6,1,118586,118586,118587,0,1,4
33786,1,3,118587,118587,118590,0,3,0
33787,3,1,118590,118590,118591,0,1,0
33788,4,1,118594,118594,118595,0,1,3
33789,3,3,118597,118597,118600,0,3,2
33790,3,3,118600,118600,118603,0,3,0
33791,6,3,118606,118606,118609,0,3,3
33792,5,3,118611,118611,118614,0,3,2
33793,2,2,118613,118614,118616,1,3,0
33794,5,2,118618,118618,118620,0,2,2
33795,6,1,118624,118624,118625,0,1,4
33796,4,2,118628,118628,118630,0,2,3
33797,1,2,118629,118630,118632,1,3,0
33798,5,3,118634,118634,118637,0,3,2
33799,2,2,118636,118637,118639,1,3,0
33800,5,2,118641,118641,118643,0,2,2
33801,3,2,118644,118644,118646,0,2,1
33802,2,2,118646,118646,118648,0,2,0
33803,6,2,118652,118652,118654,0,2,4
33804,1,1,118653,118654,118655,1,2,0
33805,2,3,118655,118655,118658,0,3,0
33806,6,1,118661,118661,118662,0,1,3
33807,3,3,118664,118664,118667,0,3,2
33808,1,3,118665,118667,118670,2,5,0
33809,3,2,118668,118670,118672,2,4,0
33810,4,1,118672,118672,118673,0,1,0
33811,4,1,118676,118676,118677,0,1,3
33812,6,1,118682,118682,118683,0,1,5
33813,3,1,118685,118685,118686,0,1,2
33814,6,2,118691,118691,118693,0,2,5
33815,4,1,118695,118695,118696,0,1,2
33816,3,1,118698,118698,118699,0,1,2
33817,4,1,118702,118702,118703,0,1,3
33818,1,2,118703,118703,118705,0,2,0
33819,2,2,118705,118705,118707,0,2,0
33820,2,2,118707,118707,118709,0,2,0
33821,5,2,118712,118712,118714,0,2,3
33822,1,3,118713,118714,118717,1,4,0
33823,1,2,118714,118717,118719,3,5,0
33824,5,3,118719,118719,118722,0,3,0
33825,3,3,118722,118722,118725,0,3,0
33826,4,1,118726,118726,118727,0,1,1
33827,4,1,118730,118730,118731,0,1,3
33828,1,3,118731,118731,118734,0,3,0
33829,3,1,118734,118734,118735,0,1,0
33830,1,3,118735,118735,118738,0,3,0
33831,1,1,118736,118738,118739,2,3,0
33832,5,1,118741,118741,118742,0,1,2
33833,4,3,118745,118745,118748,0,3,3
33834,5,3,118750,118750,118753,0,3,2
33835,1,2,118751,118753,118755,2,4,0
33836,2,1,118753,118755,118756,2,3,0
33837,1,3,118754,118756,118759,2,5,0
33838,1,1,118755,118759,118760,4,5,0
33839,6,2,118761,118761,118763,0,2,1
33840,3,2,118764,118764,118766,0,2,1
33841,1,1,118765,118766,118767,1,2,0
33842,5,1,118770,118770,118771,0,1,3
33843,4,1,118774,118774,118775,0,1,3
33844,6,1,118780,118780,118781,0,1,5
33845,6,2,118786,118786,118788,0,2,5
33846,1,2,118787,118788,118790,1,3,0
33847,6,3,118793,118793,118796,0,3,3
33848,5,2,118798,118798,118800,0,2,2
33849,3,2,118801,118801,118803,0,2,1
33850,1,1,118802,118803,118804,1,2,0
33851,1,3,118803,118804,118807,1,4,0
33852,2,2,118805,118807,118809,2,4,0
33853,2,2,118807,118809,118811,2,4,0
33854,2,3,118809,118811,118814,2,5,0
33855,2,1,118811,118814,118815,3,4,0
33856,5,2,118816,118816,118818,0,2,1
33857,1,2,118817,118818,118820,1,3,0
33858,5,2,118822,118822,118824,0,2,2
33859,5,3,118827,118827,118830,0,3,3
33860,3,1,118830,118830,118831,0,1,0
33861,4,2,118834,118834,118836,0,2,3
33862,2,2,118836,118836,118838,0,2,0
33863,4,3,118840,118840,118843,0,3,2
33864,6,3,118846,118846,118849,0,3,3
33865,3,1,118849,118849,118850,0,1,0
33866,4,2,118853,118853,118855,0,2,3
33867,1,3,118854,118855,118858,1,4,0
33868,3,1,118857,118858,118859,1,2,0
33869,5,3,118862,118862,118865,0,3,3
33870,4,1,118866,118866,118867,0,1,1
33871,4,2,118870,118870,118872,0,2,3
33872,2,3,118872,118872,118875,0,3,0
33873,1,2,118873,118875,118877,2,4,0
33874,4,2,118877,118877,118879,0,2,0
33875,5,2,118882,118882,118884,0,2,3
33876,1,1,118883,118884,118885,1,2,0
33877,4,2,118887,118887,118889,0,2,2
33878,6,3,118893,118893,118896,0,3,4
33879,4,1,118897,118897,118898,0,1,1
33880,1,1,118898,118898,118899,0,1,0
33881,3,1,118901,118901,118902,0,1,2
33882,6,1,118907,118907,118908,0,1,5
33883,5,2,118912,118912,118914,0,2,4
33884,6,2,118918,118918,118920,0,2,4
33885,3,3,118921,118921,118924,0,3,1
33886,1,3,118922,118924,118927,2,5,0
33887,6,2,118928,118928,118930,0,2,1
33888,2,2,118930,118930,118932,0,2,0
33889,5,3,118935,118935,118938,0,3,3
33890,5,1,118940,118940,118941,0,1,2
33891,1,2,118941,118941,118943,0,2,0
33892,3,3,118944,118944,118947,0,3,1
33893,6,1,118950,118950,118951,0,1,3
33894,6,2,118956,118956,118958,0,2,5
33895,4,3,118960,118960,118963,0,3,2
33896,4,1,118964,118964,118965,0,1,1
33897,5,1,118969,118969,118970,0,1,4
33898,1,2,118970,118970,118972,0,2,0
33899,3,2,118973,118973,118975,0,2,1
33900,2,1,118975,118975,118976,0,1,0
33901,6,1,118981,118981,118982,0,1,5
33902,1,3,118982,118982,118985,0,3,0
33903,2,1,118984,118985,118986,1,2,0
33904,1,3,118985,118986,118989,1,4,0
33905,3,3,118988,118989,118992,1,4,0
33906,4,2,118992,118992,118994,0,2,0
33907,4,1,118996,118996,118997,0,1,2
33908,3,3,118999,118999,119002,0,3,2
33909,5,3,119004,119004,119007,0,3,2
33910,4,3,119008,119008,119011,0,3,1
33911,4,3,119012,119012,119015,0,3,1
33912,3,1,119015,119015,119016,0,1,0
33913,5,2,119020,119020,119022,0,2,4
33914,2,1,119022,119022,119023,0,1,0
33915,4,1,119026,119026,119027,0,1,3
33916,6,1,119032,119032,119033,0,1,5
33917,4,2,119036,119036,119038,0,2,3
33918,5,1,119041,119041,119042,0,1,3
33919,6,3,119047,119047,119050,0,3,5
33920,6,3,119053,119053,119056,0,3,3
33921,6,3,119059,119059,119062,0,3,3
33922,4,1,119063,119063,119064,0,1,1
33923,5,2,119068,119068,119070,0,2,4
33924,4,1,119072,119072,119073,0,1,2
33925,5,2,119077,119077,119079,0,2,4
33926,5,1,119082,119082,119083,0,1,3
33927,6,1,119088,119088,119089,0,1,5
33928,6,1,119094,119094,119095,0,1,5
33929,4,3,119098,119098,119101,0,3,3
33930,6,2,119104,119104,119106,0,2,3
33931,6,2,119110,119110,119112,0,2,4
33932,3,3,119113,119113,119116,0,3,1
33933,4,3,119117,119117,119120,0,3,1
33934,6,3,119123,119123,119126,0,3,3
33935,1,2,119124,119126,119128,2,4,0
33936,1,2,119125,119128,119130,3,5,0
33937,2,3,119127,119130,119133,3,6,0
33938,3,2,119130,119133,119135,3,5,0
33939,6,3,119136,119136,119139,0,3,1
33940,3,2,119139,119139,119141,0,2,0
33941,4,1,119143,119143,119144,0,1,2
33942,3,3,119146,119146,119149,0,3,2
33943,1,1,119147,119149,119150,2,3,0
33944,2,2,119149,119150,119152,1,3,0
33945,6,1,119155,119155,119156,0,1,3
33946,1,1,119156,119156,119157,0,1,0
33947,6,2,119162,119162,119164,0,2,5
33948,1,2,119163,119164,119166,1,3,0
33949,4,2,119167,119167,119169,0,2,1
33950,4,3,119171,119171,119174,0,3,2
33951,6,1,119177,119177,119178,0,1,3
33952,5,1,119182,119182,119183,0,1,4
33953,5,1,119187,119187,119188,0,1,4
33954,2,3,119189,119189,119192,0,3,1
33955,2,2,119191,119192,119194,1,3,0
33956,6,2,119197,119197,119199,0,2,3
33957,2,2,119199,119199,119201,0,2,0
33958,3,1,119202,119202,119203,0,1,1
33959,2,2,119204,119204,119206,0,2,1
33960,5,2,119209,119209,119211,0,2,3
33961,1,3,119210,119211,119214,1,4,0
33962,3,1,119213,119214,119215,1,2,0
33963,2,3,119215,119215,119218,0,3,0
33964,2,1,119217,119218,119219,1,2,0
33965,1,2,119218,119219,119221,1,3,0
33966,6,1,119224,119224,119225,0,1,3
33967,5,2,119229,119229,119231,0,2,4
33968,4,2,119233,119233,119235,0,2,2
33969,5,2,119238,119238,119240,0,2,3
33970,6,3,119244,119244,119247,0,3,4
33971,4,2,119248,119248,119250,0,2,1
33972,4,1,119252,119252,119253,0,1,2
33973,5,3,119257,119257,119260,0,3,4
33974,4,1,119261,119261,119262,0,1,1
33975,2,3,119263,119263,119266,0,3,1
33976,5,3,119268,119268,119271,0,3,2
33977,5,3,119273,119273,119276,0,3,2
33978,2,3,119275,119276,119279,1,4,0
33979,3,1,119278,119279,119280,1,2,0
33980,5,2,119283,119283,119285,0,2,3
33981,4,2,119287,119287,119289,0,2,2
33982,1,1,119288,119289,119290,1,2,0
33983,6,1,119294,119294,119295,0,1,4
33984,4,2,119298,119298,119300,0,2,3
33985,3,2,119301,119301,119303,0,2,1
33986,3,3,119304,119304,119307,0,3,1
33987,6,3,119310,119310,119313,0,3,3
33988,1,3,119311,119313,119316,2,5,0
33989,5,1,119316,119316,119317,0,1,0
33990,1,2,119317,119317,119319,0,2,0
33991,4,1,119321,119321,119322,0,1,2
33992,5,1,119326,119326,119327,0,1,4
33993,5,2,119331,119331,119333,0,2,4
33994,3,2,119334,119334,119336,0,2,1
33995,3,3,119337,119337,119340,0,3,1
33996,4,2,119341,119341,119343,0,2,1
33997,6,2,119347,119347,119349,0,2,4
33998,6,2,119353,119353,119355,0,2,4
33999,5,3,119358,119358,119361,0,3,3
34000,3,2,119361,119361,119363,0,2,0
34001,4,2,119365,119365,119367,0,2,2
34002,5,3,119370,119370,119373,0,3,3
34003,2,3,119372,119373,119376,1,4,0
34004,6,3,119378,119378,119381,0,3,2
34005,5,3,119383,119383,119386,0,3,2
34006,2,2,119385,119386,119388,1,3,0
34007,1,2,119386,119388,119390,2,4,0
34008,3,3,119389,119390,119393,1,4,0
34009,6,2,119395,119395,119397,0,2,2
34010,6,2,119401,119401,119403,0,2,4
34011,4,3,119405,119405,119408,0,3,2
34012,1,2,119406,119408,119410,2,4,0
34013,5,1,119411,119411,119412,0,1,1
34014,3,3,119414,119414,119417,0,3,2
34015,3,3,119417,119417,119420,0,3,0
34016,4,3,119421,119421,119424,0,3,1
34017,2,2,119423,119424,119426,1,3,0
34018,6,1,119429,119429,119430,0,1,3
34019,6,3,119435,119435,119438,0,3,5
34020,1,3,119436,119438,119441,2,5,0
34021,4,3,119440,119441,119444,1,4,0
34022,1,2,119441,119444,119446,3,5,0
34023,1,2,119442,119446,119448,4,6,0
34024,4,3,119446,119448,119451,2,5,0
34025,4,1,119450,119451,119452,1,2,0
34026,5,3,119455,119455,119458,0,3,3
34027,4,3,119459,119459,119462,0,3,1
34028,2,3,119461,119462,119465,1,4,0
34029,3,3,119464,119465,119468,1,4,0
34030,6,3,119470,119470,119473,0,3,2
34031,3,1,119473,119473,119474,0,1,0
34032,1,1,119474,119474,119475,0,1,0
34033,2,3,119476,119476,119479,0,3,1
34034,3,2,119479,119479,119481,0,2,0
34035,2,2,119481,119481,119483,0,2,0
34036,2,1,119483,119483,119484,0,1,0
34037,6,3,119489,119489,119492,0,3,5
34038,4,3,119493,119493,119496,0,3,1
34039,4,3,119497,119497,119500,0,3,1
34040,4,3,119501,119501,119504,0,3,1
34041,3,3,119504,119504,119507,0,3,0
34042,6,3,119510,119510,119513,0,3,3
34043,2,3,119512,119513,119516,1,4,0
34044,5,2,119517,119517,119519,0,2,1
34045,3,1,119520,119520,119521,0,1,1
34046,3,1,119523,119523,119524,0,1,2
34047,3,1,119526,119526,119527,0,1,2
34048,5,1,119531,119531,119532,0,1,4
34049,6,2,119537,119537,119539,0,2,5
34050,1,2,119538,119539,119541,1,3,0
34051,4,3,119542,119542,119545,0,3,1
34052,5,2,119547,119547,119549,0,2,2
34053,4,1,119551,119551,119552,0,1,2
34054,3,2,119554,119554,119556,0,2,2
34055,1,2,119555,119556,119558,1,3,0
34056,6,3,119561,119561,119564,0,3,3
34057,6,3,119567,119567,119570,0,3,3
34058,4,2,119571,119571,119573,0,2,1
34059,4,2,119575,119575,119577,0,2,2
34060,6,1,119581,119581,119582,0,1,4
34061,3,2,119584,119584,119586,0,2,2
34062,1,1,119585,119586,119587,1,2,0
34063,1,2,119586,119587,119589,1,3,0
34064,4,2,119590,119590,119592,0,2,1
34065,6,3,119596,119596,119599,0,3,4
34066,1,3,119597,119599,119602,2,5,0
34067,5,3,119602,119602,119605,0,3,0
34068,4,2,119606,119606,119608,0,2,1
34069,5,2,119611,119611,119613,0,2,3
34070,4,1,119615,119615,119616,0,1,2
34071,3,2,119618,119618,119620,0,2,2
34072,3,3,119621,119621,119624,0,3,1
34073,4,3,119625,119625,119628,0,3,1
34074,2,2,119627,119628,119630,1,3,0
34075,6,2,119633,119633,119635,0,2,3
34076,5,2,119638,119638,119640,0,2,3
34077,2,3,119640,119640,119643,0,3,0
34078,1,2,119641,119643,119645,2,4,0
34079,3,1,119644,119645,119646,1,2,0
34080,1,1,119645,119646,119647,1,2,0
34081,6,1,119651,119651,119652,0,1,4
34082,4,3,119655,119655,119658,0,3,3
34083,1,1,119656,119658,119659,2,3,0
34084,1,2,119657,119659,119661,2,4,0
34085,6,3,119663,119663,119666,0,3,2
34086,3,2,119666,119666,119668,0,2,0
34087,6,1,119672,119672,119673,0,1,4
34088,1,1,119673,119673,119674,0,1,0
34089,4,3,119677,119677,119680,0,3,3
34090,3,1,119680,119680,119681,0,1,0
34091,6,2,119686,119686,119688,0,2,5
34092,1,3,119687,119688,119691,1,4,0
34093,3,3,119690,119691,119694,1,4,0
34094,3,3,119693,119694,119697,1,4,0
34095,6,2,119699,119699,119701,0,2,2
34096,2,1,119701,119701,119702,0,1,0
34097,5,3,119706,119706,119709,0,3,4
34098,3,1,119709,119709,119710,0,1,0
34099,3,2,119712,119712,119714,0,2,2
34100,2,3,119714,119714,119717,0,3,0
34101,3,1,119717,119717,119718,0,1,0
34102,6,2,119723,119723,119725,0,2,5
34103,4,3,119727,119727,119730,0,3,2
34104,6,2,119733,119733,119735,0,2,3
34105,5,1,119738,119738,119739,0,1,3
34106,2,2,119740,119740,119742,0,2,1
34107,1,2,119741,119742,119744,1,3,0
34108,1,1,119742,119744,119745,2,3,0
34109,5,2,119747,119747,119749,0,2,2
34110,3,3,119750,119750,119753,0,3,1
34111,5,3,119755,119755,119758,0,3,2
34112,6,1,119761,119761,119762,0,1,3
34113,3,3,119764,119764,119767,0,3,2
34114,3,3,119767,119767,119770,0,3,0
34115,6,1,119773,119773,119774,0,1,3
34116,1,1,119774,119774,119775,0,1,0
34117,2,3,119776,119776,119779,0,3,1
34118,6,1,119782,119782,119783,0,1,3
34119,5,2,119787,119787,119789,0,2,4
34120,3,1,119790,119790,119791,0,1,1
34121,3,1,119793,119793,119794,0,1,2
34122,6,2,119799,119799,119801,0,2,5
34123,3,3,119802,119802,119805,0,3,1
34124,6,3,119808,119808,119811,0,3,3
34125,5,3,119813,119813,119816,0,3,2
34126,3,3,119816,119816,119819,0,3,0
34127,4,3,119820,119820,119823,0,3,1
34128,2,1,119822,119823,119824,1,2,0
34129,5,3,119827,119827,119830,0,3,3
34130,3,1,119830,119830,119831,0,1,0
34131,2,2,119832,119832,119834,0,2,1
34132,5,3,119837,119837,119840,0,3,3
34133,2,3,119839,119840,119843,1,4,0
34134,4,3,119843,119843,119846,0,3,0
34135,5,1,119848,119848,119849,0,1,2
34136,5,2,119853,119853,119855,0,2,4
34137,2,2,119855,119855,119857,0,2,0
34138,5,2,119860,119860,119862,0,2,3
34139,5,3,119865,119865,119868,0,3,3
34140,6,1,119871,119871,119872,0,1,3
34141,6,3,119877,119877,119880,0,3,5
34142,5,3,119882,119882,119885,0,3,2
34143,1,1,119883,119885,119886,2,3,0
34144,1,1,119884,119886,119887,2,3,0
34145,4,3,119888,119888,119891,0,3,1
34146,3,3,119891,119891,119894,0,3,0
34147,2,3,119893,119894,119897,1,4,0
34148,1,3,119894,119897,119900,3,6,0
34149,2,1,119896,119900,119901,4,5,0
34150,3,3,119899,119901,119904,2,5,0
34151,1,2,119900,119904,119906,4,6,0
34152,6,3,119906,119906,119909,0,3,0
34153,6,3,119912,119912,119915,0,3,3
34154,4,1,119916,119916,119917,0,1,1
34155,4,1,119920,119920,119921,0,1,3
34156,5,1,119925,119925,119926,0,1,4
34157,3,3,119928,119928,119931,0,3,2
34158,1,1,119929,119931,119932,2,3,0
34159,3,3,119932,119932,119935,0,3,0
34160,3,3,119935,119935,119938,0,3,0
34161,1,2,119936,119938,119940,2,4,0
34162,3,3,119939,119940,119943,1,4,0
34163,3,1,119942,119943,119944,1,2,0
34164,2,1,119944,119944,119945,0,1,0
34165,2,3,119946,119946,119949,0,3,1
34166,3,1,119949,119949,119950,0,1,0
34167,2,2,119951,119951,119953,0,2,1
34168,6,3,119957,119957,119960,0,3,4
34169,4,2,119961,119961,119963,0,2,1
34170,2,3,119963,119963,119966,0,3,0
34171,2,3,119965,119966,119969,1,4,0
34172,1,1,119966,119969,119970,3,4,0
34173,5,3,119971,119971,119974,0,3,1
34174,2,2,119973,119974,119976,1,3,0
34175,4,2,119977,119977,119979,0,2,1
34176,2,3,119979,119979,119982,0,3,0
34177,6,2,119985,119985,119987,0,2,3
34178,4,1,119989,119989,119990,0,1,2
34179,3,3,119992,119992,119995,0,3,2
34180,6,1,119998,119998,119999,0,1,3
34181,3,1,120001,120001,120002,0,1,2
34182,3,1,120004,120004,120005,0,1,2
34183,1,2,120005,120005,120007,0,2,0
34184,1,1,120006,120007,120008,1,2,0
34185,3,3,120009,120009,120012,0,3,1
34186,1,2,120010,120012,120014,2,4,0
34187,3,3,120013,120014,120017,1,4,0
34188,2,1,120015,120017,120018,2,3,0
34189,4,2,120019,120019,120021,0,2,1
34190,3,3,120022,120022,120025,0,3,1
34191,3,2,120025,120025,120027,0,2,0
34192,1,1,120026,120027,120028,1,2,0
34193,1,2,120027,120028,120030,1,3,0
34194,6,2,120033,120033,120035,0,2,3
34195,1,1,120034,120035,120036,1,2,0
34196,1,2,120035,120036,120038,1,3,0
34197,1,2,120036,120038,120040,2,4,0
34198,5,2,120041,120041,120043,0,2,1
34199,3,2,120044,120044,120046,0,2,1
34200,3,2,120047,120047,120049,0,2,1
34201,3,3,120050,120050,120053,0,3,1
34202,2,2,120052,120053,120055,1,3,0
34203,2,2,120054,120055,120057,1,3,0
34204,4,3,120058,120058,120061,0,3,1
34205,3,2,120061,120061,120063,0,2,0
34206,2,3,120063,120063,120066,0,3,0
34207,3,3,120066,120066,120069,0,3,0
34208,1,1,120067,120069,120070,2,3,0
34209,1,2,120068,120070,120072,2,4,0
34210,6,2,120074,120074,120076,0,2,2
34211,6,1,120080,120080,120081,0,1,4
34212,2,2,120082,120082,120084,0,2,1
34213,5,3,120087,120087,120090,0,3,3
34214,4,3,120091,120091,120094,0,3,1
34215,2,2,120093,120094,120096,1,3,0
34216,2,3,120095,120096,120099,1,4,0
34217,6,1,120101,120101,120102,0,1,2
34218,5,3,120106,120106,120109,0,3,4
34219,3,2,120109,120109,120111,0,2,0
34220,4,2,120113,120113,120115,0,2,2
34221,4,1,120117,120117,120118,0,1,2
34222,4,2,120121,120121,120123,0,2,3
34223,3,1,120124,120124,120125,0,1,1
34224,6,2,120130,120130,120132,0,2,5
34225,5,2,120135,120135,120137,0,2,3
34226,3,3,120138,120138,120141,0,3,1
34227,3,3,120141,120141,120144,0,3,0
34228,6,1,120147,120147,120148,0,1,3
34229,5,3,120152,120152,120155,0,3,4
34230,6,2,120158,120158,120160,0,2,3
34231,1,1,120159,120160,120161,1,2,0
34232,3,3,120162,120162,120165,0,3,1
34233,4,2,120166,120166,120168,0,2,1
34234,4,3,120170,120170,120173,0,3,2
34235,4,2,120174,120174,120176,0,2,1
34236,1,2,120175,120176,120178,1,3,0
34237,4,1,120179,120179,120180,0,1,1
34238,6,1,120185,120185,120186,0,1,5
34239,3,2,120188,120188,120190,0,2,2
34240,2,1,120190,120190,120191,0,1,0
34241,6,1,120196,120196,120197,0,1,5
34242,1,3,120197,120197,120200,0,3,0
34243,5,1,120202,120202,120203,0,1,2
34244,3,3,120205,120205,120208,0,3,2
34245,1,3,120206,120208,120211,2,5,0
34246,5,1,120211,120211,120212,0,1,0
34247,1,2,120212,120212,120214,0,2,0
34248,5,1,120217,120217,120218,0,1,3
34249,5,2,120222,120222,120224,0,2,4
34250,1,1,120223,120224,120225,1,2,0
34251,5,1,120228,120228,120229,0,1,3
34252,2,3,120230,120230,120233,0,3,1
34253,2,2,120232,120233,120235,1,3,0
34254,1,2,120233,120235,120237,2,4,0
34255,2,2,120235,120237,120239,2,4,0
34256,4,1,120239,120239,120240,0,1,0
34257,4,2,120243,120243,120245,0,2,3
34258,5,1,120248,120248,120249,0,1,3
34259,4,1,120252,120252,120253,0,1,3
34260,5,1,120257,120257,120258,0,1,4
34261,2,1,120259,120259,120260,0,1,1
34262,6,3,120265,120265,120268,0,3,5
34263,6,1,120271,120271,120272,0,1,3
34264,1,1,120272,120272,120273,0,1,0
34265,5,1,120277,120277,120278,0,1,4
34266,5,3,120282,120282,120285,0,3,4
34267,6,2,120288,120288,120290,0,2,3
34268,2,3,120290,120290,120293,0,3,0
34269,1,2,120291,120293,120295,2,4,0
34270,1,1,120292,120295,120296,3,4,0
34271,5,2,120297,120297,120299,0,2,1
34272,4,1,120301,120301,120302,0,1,2
34273,4,3,120305,120305,120308,0,3,3
34274,2,2,120307,120308,120310,1,3,0
34275,5,1,120312,120312,120313,0,1,2
34276,4,1,120316,120316,120317,0,1,3
34277,1,1,120317,120317,120318,0,1,0
34278,1,3,120318,120318,120321,0,3,0
34279,5,1,120323,120323,120324,0,1,2
34280,3,3,120326,120326,120329,0,3,2
34281,4,2,120330,120330,120332,0,2,1
34282,1,2,120331,120332,120334,1,3,0
34283,6,1,120337,120337,120338,0,1,3
34284,1,2,120338,120338,120340,0,2,0
34285,5,1,120343,120343,120344,0,1,3
34286,1,3,120344,120344,120347,0,3,0
34287,1,3,120345,120347,120350,2,5,0
34288,5,2,120350,120350,120352,0,2,0
34289,5,2,120355,120355,120357,0,2,3
34290,2,2,120357,120357,120359,0,2,0
34291,5,2,120362,120362,120364,0,2,3
34292,2,1,120364,120364,120365,0,1,0
34293,3,2,120367,120367,120369,0,2,2
34294,2,3,120369,120369,120372,0,3,0
34295,6,3,120375,120375,120378,0,3,3
34296,5,2,120380,120380,120382,0,2,2
34297,6,1,120386,120386,120387,0,1,4
34298,3,3,120389,120389,120392,0,3,2
34299,4,1,120393,120393,120394,0,1,1
34300,6,2,120399,120399,120401,0,2,5
34301,1,3,120400,120401,120404,1,4,0
34302,2,2,120402,120404,120406,2,4,0
34303,5,1,120407,120407,120408,0,1,1
34304,2,3,120409,120409,120412,0,3,1
34305,6,2,120415,120415,120417,0,2,3
34306,4,2,120419,120419,120421,0,2,2
34307,4,2,120423,120423,120425,0,2,2
34308,5,3,120428,120428,120431,0,3,3
34309,3,2,120431,120431,120433,0,2,0
34310,2,2,120433,120433,120435,0,2,0
34311,5,2,120438,120438,120440,0,2,3
34312,1,1,120439,120440,120441,1,2,0
34313,3,2,120442,120442,120444,0,2,1
34314,2,3,120444,120444,120447,0,3,0
34315,5,1,120449,120449,120450,0,1,2
34316,1,3,120450,120450,120453,0,3,0
34317,4,3,120454,120454,120457,0,3,1
34318,5,3,120459,120459,120462,0,3,2
34319,4,1,120463,120463,120464,0,1,1
34320,5,3,120468,120468,120471,0,3,4
34321,1,3,120469,120471,120474,2,5,0
34322,6,1,120475,120475,120476,0,1,1
34323,3,3,120478,120478,120481,0,3,2
34324,2,1,120480,120481,120482,1,2,0
34325,5,3,120485,120485,120488,0,3,3
34326,3,1,120488,120488,120489,0,1,0
34327,5,2,120493,120493,120495,0,2,4
34328,1,3,120494,120495,120498,1,4,0
34329,3,2,120497,120498,120500,1,3,0
34330,6,3,120503,120503,120506,0,3,3
34331,4,1,120507,120507,120508,0,1,1
34332,3,2,120510,120510,120512,0,2,2
34333,4,3,120514,120514,120517,0,3,2
34334,3,2,120517,120517,120519,0,2,0
34335,3,3,120520,120520,120523,0,3,1
34336,1,1,120521,120523,120524,2,3,0
34337,5,1,120526,120526,120527,0,1,2
34338,3,2,120529,120529,120531,0,2,2
34339,3,2,120532,120532,120534,0,2,1
34340,2,3,120534,120534,120537,0,3,0
34341,2,2,120536,120537,120539,1,3,0
34342,1,3,120537,120539,120542,2,5,0
34343,2,2,120539,120542,120544,3,5,0
34344,3,1,120542,120544,120545,2,3,0
34345,6,2,120548,120548,120550,0,2,3
34346,1,3,120549,120550,120553,1,4,0
34347,4,2,120553,120553,120555,0,2,0
34348,6,1,120559,120559,120560,0,1,4
34349,1,1,120560,120560,120561,0,1,0
34350,2,3,120562,120562,120565,0,3,1
34351,2,1,120564,120565,120566,1,2,0
34352,2,2,120566,120566,120568,0,2,0
34353,2,2,120568,120568,120570,0,2,0
34354,3,3,120571,120571,120574,0,3,1
34355,2,2,120573,120574,120576,1,3,0
34356,4,2,120577,120577,120579,0,2,1
34357,4,2,120581,120581,120583,0,2,2
34358,1,3,120582,120583,120586,1,4,0
34359,6,3,120588,120588,120591,0,3,2
34360,3,1,120591,120591,120592,0,1,0
34361,2,3,120593,120593,120596,0,3,1
34362,4,2,120597,120597,120599,0,2,1
34363,1,3,120598,120599,120602,1,4,0
34364,2,1,120600,120602,120603,2,3,0
34365,6,3,120606,120606,120609,0,3,3
34366,3,1,120609,120609,120610,0,1,0
34367,3,1,120612,120612,120613,0,1,2
34368,1,3,120613,120613,120616,0,3,0
34369,2,2,120615,120616,120618,1,3,0
34370,3,2,120618,120618,120620,0,2,0
34371,1,1,120619,120620,120621,1,2,0
34372,4,1,120623,120623,120624,0,1,2
34373,6,2,120629,120629,120631,0,2,5
34374,1,2,120630,120631,120633,1,3,0
34375,6,1,120636,120636,120637,0,1,3
34376,4,1,120640,120640,120641,0,1,3
34377,5,2,120645,120645,120647,0,2,4
34378,5,3,120650,120650,120653,0,3,3
34379,3,2,120653,120653,120655,0,2,0
34380,4,3,120657,120657,120660,0,3,2
34381,3,1,120660,120660,120661,0,1,0
34382,4,1,120664,120664,120665,0,1,3
34383,2,3,120666,120666,120669,0,3,1
34384,1,2,120667,120669,120671,2,4,0
34385,1,1,120668,120671,120672,3,4,0
34386,3,2,120671,120672,120674,1,3,0
34387,4,1,120675,120675,120676,0,1,1
34388,3,2,120678,120678,120680,0,2,2
34389,3,1,120681,120681,120682,0,1,1
34390,2,3,120683,120683,120686,0,3,1
34391,1,2,120684,120686,120688,2,4,0
34392,5,2,120689,120689,120691,0,2,1
34393,6,2,120695,120695,120697,0,2,4
34394,4,1,120699,120699,120700,0,1,2
34395,6,3,120705,120705,120708,0,3,5
34396,1,3,120706,120708,120711,2,5,0
34397,6,3,120712,120712,120715,0,3,1
34398,1,1,120713,120715,120716,2,3,0
34399,4,3,120717,120717,120720,0,3,1
34400,6,2,120723,120723,120725,0,2,3
34401,5,2,120728,120728,120730,0,2,3
34402,1,2,120729,120730,120732,1,3,0
34403,6,3,120735,120735,120738,0,3,3
34404,4,1,120739,120739,120740,0,1,1
34405,6,3,120745,120745,120748,0,3,5
34406,5,2,120750,120750,120752,0,2,2
34407,2,3,120752,120752,120755,0,3,0
34408,5,2,120757,120757,120759,0,2,2
34409,4,2,120761,120761,120763,0,2,2
34410,4,2,120765,120765,120767,0,2,2
34411,2,1,120767,120767,120768,0,1,0
34412,1,3,120768,120768,120771,0,3,0
34413,6,2,120774,120774,120776,0,2,3
34414,5,2,120779,120779,120781,0,2,3
34415,1,3,120780,120781,120784,1,4,0
34416,2,3,120782,120784,120787,2,5,0
34417,4,1,120786,120787,120788,1,2,0
34418,4,3,120790,120790,120793,0,3,2
34419,1,2,120791,120793,120795,2,4,0
34420,5,3,120796,120796,120799,0,3,1
34421,6,2,120802,120802,120804,0,2,3
34422,2,1,120804,120804,120805,0,1,0
34423,2,2,120806,120806,120808,0,2,1
34424,6,2,120812,120812,120814,0,2,4
34425,5,1,120817,120817,120818,0,1,3
34426,3,3,120820,120820,120823,0,3,2
34427,4,2,120824,120824,120826,0,2,1
34428,4,3,120828,120828,120831,0,3,2
34429,4,2,120832,120832,120834,0,2,1
34430,4,3,120836,120836,120839,0,3,2
34431,1,2,120837,120839,120841,2,4,0
34432,6,1,120843,120843,120844,0,1,2
34433,3,2,120846,120846,120848,0,2,2
34434,4,1,120850,120850,120851,0,1,2
34435,5,1,120855,120855,120856,0,1,4
34436,4,1,120859,120859,120860,0,1,3
34437,3,1,120862,120862,120863,0,1,2
34438,1,2,120863,120863,120865,0,2,0
34439,2,2,120865,120865,120867,0,2,0
34440,6,2,120871,120871,120873,0,2,4
34441,5,1,120876,120876,120877,0,1,3
34442,3,2,120879,120879,120881,0,2,2
34443,4,1,120883,120883,120884,0,1,2
34444,1,1,120884,120884,120885,0,1,0
34445,5,1,120889,120889,120890,0,1,4
34446,4,1,120893,120893,120894,0,1,3
34447,4,1,120897,120897,120898,0,1,3
34448,3,3,120900,120900,120903,0,3,2
34449,3,3,120903,120903,120906,0,3,0
34450,4,1,120907,120907,120908,0,1,1
34451,4,2,120911,120911,120913,0,2,3
34452,3,3,120914,120914,120917,0,3,1
34453,1,1,120915,120917,120918,2,3,0
34454,2,2,120917,120918,120920,1,3,0
34455,6,3,120923,120923,120926,0,3,3
34456,6,1,120929,120929,120930,0,1,3
34457,2,3,120931,120931,120934,0,3,1
34458,1,3,120932,120934,120937,2,5,0
34459,1,3,120933,120937,120940,4,7,0
34460,5,1,120938,120940,120941,2,3,0
34461,4,1,120942,120942,120943,0,1,1
34462,3,1,120945,120945,120946,0,1,2
34463,4,2,120949,120949,120951,0,2,3
34464,2,2,120951,120951,120953,0,2,0
34465,2,1,120953,120953,120954,0,1,0
34466,2,3,120955,120955,120958,0,3,1
34467,2,2,120957,120958,120960,1,3,0
34468,6,3,120963,120963,120966,0,3,3
34469,1,2,120964,120966,120968,2,4,0
34470,2,1,120966,120968,120969,2,3,0
34471,6,3,120972,120972,120975,0,3,3
34472,2,3,120974,120975,120978,1,4,0
34473,3,1,120977,120978,120979,1,2,0
34474,1,2,120978,120979,120981,1,3,0
34475,6,3,120984,120984,120987,0,3,3
34476,2,3,120986,120987,120990,1,4,0
34477,3,3,120989,120990,120993,1,4,0
34478,3,3,120992,120993,120996,1,4,0
34479,3,3,120995,120996,120999,1,4,0
34480,2,2,120997,120999,121001,2,4,0
34481,6,3,121003,121003,121006,0,3,2
34482,2,2,121005,121006,121008,1,3,0
34483,4,3,121009,121009,121012,0,3,1
34484,2,1,121011,121012,121013,1,2,0
34485,1,2,121012,121013,121015,1,3,0
34486,1,2,121013,121015,121017,2,4,0
34487,6,1,121019,121019,121020,0,1,2
34488,4,3,121023,121023,121026,0,3,3
34489,5,3,121028,121028,121031,0,3,2
34490,6,2,121034,121034,121036,0,2,3
34491,5,3,121039,121039,121042,0,3,3
34492,1,3,121040,121042,121045,2,5,0
34493,1,3,121041,121045,121048,4,7,0
34494,6,3,121047,121048,121051,1,4,0
34495,1,3,121048,121051,121054,3,6,0
34496,6,1,121054,121054,121055,0,1,0
34497,4,3,121058,121058,121061,0,3,3
34498,3,1,121061,121061,121062,0,1,0
34499,4,2,121065,121065,121067,0,2,3
34500,2,3,121067,121067,121070,0,3,0
34501,4,1,121071,121071,121072,0,1,1
34502,6,1,121077,121077,121078,0,1,5
34503,1,1,121078,121078,121079,0,1,0
34504,3,1,121081,121081,121082,0,1,2
34505,4,3,121085,121085,121088,0,3,3
34506,5,1,121090,121090,121091,0,1,2
34507,2,1,121092,121092,121093,0,1,1
34508,5,2,121097,121097,121099,0,2,4
34509,4,2,121101,121101,121103,0,2,2
34510,2,3,121103,121103,121106,0,3,0
34511,5,1,121108,121108,121109,0,1,2
34512,5,1,121113,121113,121114,0,1,4
34513,5,3,121118,121118,121121,0,3,4
34514,4,2,121122,121122,121124,0,2,1
34515,5,1,121127,121127,121128,0,1,3
34516,6,1,121133,121133,121134,0,1,5
34517,6,2,121139,121139,121141,0,2,5
34518,2,2,121141,121141,121143,0,2,0
34519,6,2,121147,121147,121149,0,2,4
34520,2,3,121149,121149,121152,0,3,0
34521,3,2,121152,121152,121154,0,2,0
34522,1,1,121153,121154,121155,1,2,0
34523,3,3,121156,121156,121159,0,3,1
34524,2,2,121158,121159,121161,1,3,0
34525,2,3,121160,121161,121164,1,4,0
34526,4,2,121164,121164,121166,0,2,0
34527,4,2,121168,121168,121170,0,2,2
34528,3,1,121171,121171,121172,0,1,1
34529,3,3,121174,121174,121177,0,3,2
34530,6,1,121180,121180,121181,0,1,3
34531,1,2,121181,121181,121183,0,2,0
34532,5,3,121186,121186,121189,0,3,3
34533,1,2,121187,121189,121191,2,4,0
34534,6,2,121193,121193,121195,0,2,2
34535,5,3,121198,121198,121201,0,3,3
34536,6,2,121204,121204,121206,0,2,3
34537,3,1,121207,121207,121208,0,1,1
34538,1,3,121208,121208,121211,0,3,0
34539,5,2,121213,121213,121215,0,2,2
34540,3,1,121216,121216,121217,0,1,1
34541,3,1,121219,121219,121220,0,1,2
34542,5,3,121224,121224,121227,0,3,4
34543,5,2,121229,121229,121231,0,2,2
34544,4,1,121233,121233,121234,0,1,2
34545,5,3,121238,121238,121241,0,3,4
34546,6,3,121244,121244,121247,0,3,3
34547,4,2,121248,121248,121250,0,2,1
34548,6,3,121254,121254,121257,0,3,4
34549,1,2,121255,121257,121259,2,4,0
34550,3,1,121258,121259,121260,1,2,0
34551,2,3,121260,121260,121263,0,3,0
34552,2,2,121262,121263,121265,1,3,0
34553,3,2,121265,121265,121267,0,2,0
34554,2,1,121267,121267,121268,0,1,0
34555,3,1,121270,121270,121271,0,1,2
34556,4,3,121274,121274,121277,0,3,3
34557,2,1,121276,121277,121278,1,2,0
34558,6,2,121282,121282,121284,0,2,4
34559,3,3,121285,121285,121288,0,3,1
34560,5,3,121290,121290,121293,0,3,2
34561,3,3,121293,121293,121296,0,3,0
34562,1,3,121294,121296,121299,2,5,0
34563,4,3,121298,121299,121302,1,4,0
34564,1,2,121299,121302,121304,3,5,0
34565,6,2,121305,121305,121307,0,2,1
34566,6,2,121311,121311,121313,0,2,4
34567,4,1,121315,121315,121316,0,1,2
34568,6,1,121321,121321,121322,0,1,5
34569,1,3,121322,121322,121325,0,3,0
34570,3,3,121325,121325,121328,0,3,0
34571,2,2,121327,121328,121330,1,3,0
34572,6,1,121333,121333,121334,0,1,3
34573,1,1,121334,121334,121335,0,1,0
34574,1,3,121335,121335,121338,0,3,0
34575,4,2,121339,121339,121341,0,2,1
34576,1,1,121340,121341,121342,1,2,0
34577,2,1,121342,121342,121343,0,1,0
34578,5,1,121347,121347,121348,0,1,4
34579,1,2,121348,121348,121350,0,2,0
34580,6,2,121354,121354,121356,0,2,4
34581,3,2,121357,121357,121359,0,2,1
34582,4,1,121361,121361,121362,0,1,2
34583,4,3,121365,121365,121368,0,3,3
34584,2,2,121367,121368,121370,1,3,0
34585,1,2,121368,121370,121372,2,4,0
34586,3,2,121371,121372,121374,1,3,0
34587,3,2,121374,121374,121376,0,2,0
34588,2,3,121376,121376,121379,0,3,0
34589,3,3,121379,121379,121382,0,3,0
34590,1,3,121380,121382,121385,2,5,0
34591,5,2,121385,121385,121387,0,2,0
34592,6,1,121391,121391,121392,0,1,4
34593,6,2,121397,121397,121399,0,2,5
34594,2,3,121399,121399,121402,0,3,0
34595,1,1,121400,121402,121403,2,3,0
34596,2,1,121402,121403,121404,1,2,0
34597,4,3,121406,121406,121409,0,3,2
34598,4,3,121410,121410,121413,0,3,1
34599,5,3,121415,121415,121418,0,3,2
34600,4,1,121419,121419,121420,0,1,1
34601,4,3,121423,121423,121426,0,3,3
34602,1,2,121424,121426,121428,2,4,0
34603,6,2,121430,121430,121432,0,2,2
34604,1,1,121431,121432,121433,1,2,0
34605,1,1,121432,121433,121434,1,2,0
34606,5,2,121437,121437,121439,0,2,3
34607,3,2,121440,121440,121442,0,2,1
34608,2,3,121442,121442,121445,0,3,0
34609,5,2,121447,121447,121449,0,2,2
34610,3,3,121450,121450,121453,0,3,1
34611,6,3,121456,121456,121459,0,3,3
34612,3,1,121459,121459,121460,0,1,0
34613,3,1,121462,121462,121463,0,1,2
34614,4,1,121466,121466,121467,0,1,3
34615,1,2,121467,121467,121469,0,2,0
34616,1,1,121468,121469,121470,1,2,0
34617,3,1,121471,121471,121472,0,1,1
34618,6,3,121477,121477,121480,0,3,5
34619,4,1,121481,121481,121482,0,1,1
34620,2,1,121483,121483,121484,0,1,1
34621,6,2,121489,121489,121491,0,2,5
34622,1,1,121490,121491,121492,1,2,0
34623,1,1,121491,121492,121493,1,2,0
34624,1,2,121492,121493,121495,1,3,0
34625,4,3,121496,121496,121499,0,3,1
34626,1,1,121497,121499,121500,2,3,0
34627,1,3,121498,121500,121503,2,5,0
34628,1,1,121499,121503,121504,4,5,0
34629,4,2,121503,121504,121506,1,3,0
34630,4,1,121507,121507,121508,0,1,1
34631,3,3,121510,121510,121513,0,3,2
34632,3,3,121513,121513,121516,0,3,0
34633,4,3,121517,121517,121520,0,3,1
34634,6,1,121523,121523,121524,0,1,3
34635,2,3,121525,121525,121528,0,3,1
34636,3,3,121528,121528,121531,0,3,0
34637,1,1,121529,121531,121532,2,3,0
34638,1,1,121530,121532,121533,2,3,0
34639,6,2,121536,121536,121538,0,2,3
34640,4,1,121540,121540,121541,0,1,2
34641,4,2,121544,121544,121546,0,2,3
34642,2,2,121546,121546,121548,0,2,0
34643,4,1,121550,121550,121551,0,1,2
34644,2,2,121552,121552,121554,0,2,1
34645,3,3,121555,121555,121558,0,3,1
34646,2,2,121557,121558,121560,1,3,0
34647,5,1,121562,121562,121563,0,1,2
34648,2,1,121564,121564,121565,0,1,1
34649,3,2,121567,121567,121569,0,2,2
34650,6,3,121573,121573,121576,0,3,4
34651,1,1,121574,121576,121577,2,3,0
34652,1,3,121575,121577,121580,2,5,0
34653,2,2,121577,121580,121582,3,5,0
34654,5,3,121582,121582,121585,0,3,0
34655,5,2,121587,121587,121589,0,2,2
34656,6,1,121593,121593,121594,0,1,4
34657,4,1,121597,121597,121598,0,1,3
34658,2,1,121599,121599,121600,0,1,1
34659,5,2,121604,121604,121606,0,2,4
34660,2,2,121606,121606,121608,0,2,0
34661,3,3,121609,121609,121612,0,3,1
34662,1,3,121610,121612,121615,2,5,0
34663,1,3,121611,121615,121618,4,7,0
34664,6,3,121617,121618,121621,1,4,0
34665,4,2,121621,121621,121623,0,2,0
34666,3,2,121624,121624,121626,0,2,1
34667,3,2,121627,121627,121629,0,2,1
34668,5,2,121632,121632,121634,0,2,3
34669,4,1,121636,121636,121637,0,1,2
34670,5,1,121641,121641,121642,0,1,4
34671,2,2,121643,121643,121645,0,2,1
34672,6,3,121649,121649,121652,0,3,4
34673,3,3,121652,121652,121655,0,3,0
34674,6,3,121658,121658,121661,0,3,3
34675,6,3,121664,121664,121667,0,3,3
34676,4,2,121668,121668,121670,0,2,1
34677,3,3,121671,121671,121674,0,3,1
34678,2,2,121673,121674,121676,1,3,0
34679,4,1,121677,121677,121678,0,1,1
34680,5,2,121682,121682,121684,0,2,4
34681,1,3,121683,121684,121687,1,4,0
34682,1,3,121684,121687,121690,3,6,0
34683,1,2,121685,121690,121692,5,7,0
34684,6,2,121691,121692,121694,1,3,0
34685,3,1,121694,121694,121695,0,1,0
34686,4,3,121698,121698,121701,0,3,3
34687,2,1,121700,121701,121702,1,2,0
34688,1,2,121701,121702,121704,1,3,0
34689,5,3,121706,121706,121709,0,3,2
34690,3,3,121709,121709,121712,0,3,0
34691,5,2,121714,121714,121716,0,2,2
34692,5,1,121719,121719,121720,0,1,3
34693,1,1,121720,121720,121721,0,1,0
34694,1,2,121721,121721,121723,0,2,0
34695,4,1,121725,121725,121726,0,1,2
34696,1,2,121726,121726,121728,0,2,0
34697,1,1,121727,121728,121729,1,2,0
34698,5,3,121732,121732,121735,0,3,3
34699,1,3,121733,121735,121738,2,5,0
34700,4,3,121737,121738,121741,1,4,0
34701,5,1,121742,121742,121743,0,1,1
34702,1,1,121743,121743,121744,0,1,0
34703,3,3,121746,121746,121749,0,3,2
34704,6,1,121752,121752,121753,0,1,3
34705,1,2,121753,121753,121755,0,2,0
34706,2,2,121755,121755,121757,0,2,0
34707,3,2,121758,121758,121760,0,2,1
34708,3,1,121761,121761,121762,0,1,1
34709,4,1,121765,121765,121766,0,1,3
34710,3,1,121768,121768,121769,0,1,2
34711,2,2,121770,121770,121772,0,2,1
34712,5,3,121775,121775,121778,0,3,3
34713,2,2,121777,121778,121780,1,3,0
34714,4,2,121781,121781,121783,0,2,1
34715,1,1,121782,121783,121784,1,2,0
34716,5,2,121787,121787,121789,0,2,3
34717,1,2,121788,121789,121791,1,3,0
34718,6,1,121794,121794,121795,0,1,3
34719,6,2,121800,121800,121802,0,2,5
34720,2,1,121802,121802,121803,0,1,0
34721,1,3,121803,121803,121806,0,3,0
34722,3,2,121806,121806,121808,0,2,0
34723,1,1,121807,121808,121809,1,2,0
34724,2,2,121809,121809,121811,0,2,0
34725,5,1,121814,121814,121815,0,1,3
34726,6,3,121820,121820,121823,0,3,5
34727,2,3,121822,121823,121826,1,4,0
34728,5,2,121827,121827,121829,0,2,1
34729,2,3,121829,121829,121832,0,3,0
34730,3,1,121832,121832,121833,0,1,0
34731,2,3,121834,121834,121837,0,3,1
34732,4,1,121838,121838,121839,0,1,1
34733,3,3,121841,121841,121844,0,3,2
34734,1,3,121842,121844,121847,2,5,0
34735,3,1,121845,121847,121848,2,3,0
34736,1,1,121846,121848,121849,2,3,0
34737,5,1,121851,121851,121852,0,1,2
34738,2,3,121853,121853,121856,0,3,1
34739,5,3,121858,121858,121861,0,3,2
34740,5,2,121863,121863,121865,0,2,2
34741,2,3,121865,121865,121868,0,3,0
34742,6,1,121871,121871,121872,0,1,3
34743,6,3,121877,121877,121880,0,3,5
34744,3,1,121880,121880,121881,0,1,0
34745,4,1,121884,121884,121885,0,1,3
34746,3,1,121887,121887,121888,0,1,2
34747,5,3,121892,121892,121895,0,3,4
34748,2,3,121894,121895,121898,1,4,0
34749,5,1,121899,121899,121900,0,1,1
34750,1,1,121900,121900,121901,0,1,0
34751,2,2,121902,121902,121904,0,2,1
34752,5,2,121907,121907,121909,0,2,3
34753,5,1,121912,121912,121913,0,1,3
34754,2,2,121914,121914,121916,0,2,1
34755,1,2,121915,121916,121918,1,3,0
34756,2,2,121917,121918,121920,1,3,0
34757,5,2,121922,121922,121924,0,2,2
34758,2,2,121924,121924,121926,0,2,0
34759,5,1,121929,121929,121930,0,1,3
34760,2,3,121931,121931,121934,0,3,1
34761,6,1,121937,121937,121938,0,1,3
34762,4,2,121941,121941,121943,0,2,3
34763,4,3,121945,121945,121948,0,3,2
34764,2,3,121947,121948,121951,1,4,0
34765,1,3,121948,121951,121954,3,6,0
34766,3,3,121951,121954,121957,3,6,0
34767,1,2,121952,121957,121959,5,7,0
34768,1,3,121953,121959,121962,6,9,0
34769,1,3,121954,121962,121965,8,11,0
34770,5,2,121959,121965,121967,6,8,0
34771,1,2,121960,121967,121969,7,9,0
34772,1,3,121961,121969,121972,8,11,0
34773,4,3,121965,121972,121975,7,10,0
34774,6,1,121971,121975,121976,4,5,0
34775,3,1,121974,121976,121977,2,3,0
34776,4,2,121978,121978,121980,0,2,1
34777,5,1,121983,121983,121984,0,1,3
34778,3,2,121986,121986,121988,0,2,2
34779,4,1,121990,121990,121991,0,1,2
34780,3,2,121993,121993,121995,0,2,2
34781,5,3,121998,121998,122001,0,3,3
34782,2,2,122000,122001,122003,1,3,0
34783,5,2,122005,122005,122007,0,2,2
34784,3,1,122008,122008,122009,0,1,1
34785,6,3,122014,122014,122017,0,3,5
34786,4,1,122018,122018,122019,0,1,1
34787,3,1,122021,122021,122022,0,1,2
34788,2,1,122023,122023,122024,0,1,1
34789,2,3,122025,122025,122028,0,3,1
34790,3,2,122028,122028,122030,0,2,0
34791,3,2,122031,122031,122033,0,2,1
34792,4,2,122035,122035,122037,0,2,2
34793,5,2,122040,122040,122042,0,2,3
34794,3,2,122043,122043,122045,0,2,1
34795,3,1,122046,122046,122047,0,1,1
34796,3,3,122049,122049,122052,0,3,2
34797,1,2,122050,122052,122054,2,4,0
34798,4,1,122054,122054,122055,0,1,0
34799,6,1,122060,122060,122061,0,1,5
34800,6,3,122066,122066,122069,0,3,5
34801,3,2,122069,122069,122071,0,2,0
34802,3,2,122072,122072,122074,0,2,1
34803,6,1,122078,122078,122079,0,1,4
34804,1,2,122079,122079,122081,0,2,0
34805,2,2,122081,122081,122083,0,2,0
34806,5,3,122086,122086,122089,0,3,3
34807,1,2,122087,122089,122091,2,4,0
34808,2,2,122089,122091,122093,2,4,0
34809,2,2,122091,122093,122095,2,4,0
34810,4,1,122095,122095,122096,0,1,0
34811,2,3,122097,122097,122100,0,3,1
34812,1,2,122098,122100,122102,2,4,0
34813,5,2,122103,122103,122105,0,2,1
34814,6,1,122109,122109,122110,0,1,4
34815,4,2,122113,122113,122115,0,2,3
34816,2,3,122115,122115,122118,0,3,0
34817,4,1,122119,122119,122120,0,1,1
34818,4,3,122123,122123,122126,0,3,3
34819,4,1,122127,122127,122128,0,1,1
34820,6,3,122133,122133,122136,0,3,5
34821,4,3,122137,122137,122140,0,3,1
34822,4,2,122141,122141,122143,0,2,1
34823,1,3,122142,122143,122146,1,4,0
34824,6,3,122148,122148,122151,0,3,2
34825,1,1,122149,122151,122152,2,3,0
34826,6,1,122155,122155,122156,0,1,3
34827,5,2,122160,122160,122162,0,2,4
34828,4,2,122164,122164,122166,0,2,2
34829,2,3,122166,122166,122169,0,3,0
34830,1,3,122167,122169,122172,2,5,0
34831,4,2,122171,122172,122174,1,3,0
34832,6,2,122177,122177,122179,0,2,3
34833,4,3,122181,122181,122184,0,3,2
34834,3,3,122184,122184,122187,0,3,0
34835,2,1,122186,122187,122188,1,2,0
34836,4,3,122190,122190,122193,0,3,2
34837,3,3,122193,122193,122196,0,3,0
34838,1,1,122194,122196,122197,2,3,0
34839,3,2,122197,122197,122199,0,2,0
34840,4,3,122201,122201,122204,0,3,2
34841,6,1,122207,122207,122208,0,1,3
34842,4,3,122211,122211,122214,0,3,3
34843,2,1,122213,122214,122215,1,2,0
34844,3,2,122216,122216,122218,0,2,1
34845,1,2,122217,122218,122220,1,3,0
34846,2,2,122219,122220,122222,1,3,0
34847,1,3,122220,122222,122225,2,5,0
34848,4,3,122224,122225,122228,1,4,0
34849,3,1,122227,122228,122229,1,2,0
34850,3,1,122230,122230,122231,0,1,1
34851,1,1,122231,122231,122232,0,1,0
34852,1,3,122232,122232,122235,0,3,0
34853,3,3,122235,122235,122238,0,3,0
34854,5,2,122240,122240,122242,0,2,2
34855,5,3,122245,122245,122248,0,3,3
34856,5,3,122250,122250,122253,0,3,2
34857,2,2,122252,122253,122255,1,3,0
34858,6,1,122258,122258,122259,0,1,3
34859,6,3,122264,122264,122267,0,3,5
34860,3,2,122267,122267,122269,0,2,0
34861,1,3,122268,122269,122272,1,4,0
34862,3,1,122271,122272,122273,1,2,0
34863,6,2,122277,122277,122279,0,2,4
34864,4,3,122281,122281,122284,0,3,2
34865,5,3,122286,122286,122289,0,3,2
34866,5,3,122291,122291,122294,0,3,2
34867,6,1,122297,122297,122298,0,1,3
34868,1,1,122298,122298,122299,0,1,0
34869,4,1,122302,122302,122303,0,1,3
34870,2,3,122304,122304,122307,0,3,1
34871,4,3,122308,122308,122311,0,3,1
34872,2,1,122310,122311,122312,1,2,0
34873,5,3,122315,122315,122318,0,3,3
34874,4,1,122319,122319,122320,0,1,1
34875,2,1,122321,122321,122322,0,1,1
34876,6,2,122327,122327,122329,0,2,5
34877,3,2,122330,122330,122332,0,2,1
34878,5,1,122335,122335,122336,0,1,3
34879,6,1,122341,122341,122342,0,1,5
34880,6,3,122347,122347,122350,0,3,5
34881,4,2,122351,122351,122353,0,2,1
34882,5,2,122356,122356,122358,0,2,3
34883,4,3,122360,122360,122363,0,3,2
34884,2,2,122362,122363,122365,1,3,0
34885,2,1,122364,122365,122366,1,2,0
34886,3,3,122367,122367,122370,0,3,1
34887,5,3,122372,122372,122375,0,3,2
34888,6,3,122378,122378,122381,0,3,3
34889,6,3,122384,122384,122387,0,3,3
34890,6,1,122390,122390,122391,0,1,3
34891,2,2,122392,122392,122394,0,2,1
34892,3,3,122395,122395,122398,0,3,1
34893,6,2,122401,122401,122403,0,2,3
34894,1,1,122402,122403,122404,1,2,0
34895,6,3,122408,122408,122411,0,3,4
34896,1,3,122409,122411,122414,2,5,0
34897,1,1,122410,122414,122415,4,5,0
34898,6,2,122416,122416,122418,0,2,1
34899,2,1,122418,122418,122419,0,1,0
34900,5,3,122423,122423,122426,0,3,4
34901,2,2,122425,122426,122428,1,3,0
34902,5,3,122430,122430,122433,0,3,2
34903,4,3,122434,122434,122437,0,3,1
34904,3,3,122437,122437,122440,0,3,0
34905,6,2,122443,122443,122445,0,2,3
34906,6,1,122449,122449,122450,0,1,4
34907,3,3,122452,122452,122455,0,3,2
34908,5,3,122457,122457,122460,0,3,2
34909,5,2,122462,122462,122464,0,2,2
34910,6,2,122468,122468,122470,0,2,4
34911,2,1,122470,122470,122471,0,1,0
34912,4,2,122474,122474,122476,0,2,3
34913,3,3,122477,122477,122480,0,3,1
34914,4,3,122481,122481,122484,0,3,1
34915,3,1,122484,122484,122485,0,1,0
34916,6,2,122490,122490,122492,0,2,5
34917,4,2,122494,122494,122496,0,2,2
34918,5,3,122499,122499,122502,0,3,3
34919,5,2,122504,122504,122506,0,2,2
34920,5,2,122509,122509,122511,0,2,3
34921,1,3,122510,122511,122514,1,4,0
34922,3,2,122513,122514,122516,1,3,0
34923,6,1,122519,122519,122520,0,1,3
34924,3,1,122522,122522,122523,0,1,2
34925,1,3,122523,122523,122526,0,3,0
34926,4,1,122527,122527,122528,0,1,1
34927,3,3,122530,122530,122533,0,3,2
34928,3,2,122533,122533,122535,0,2,0
34929,3,3,122536,122536,122539,0,3,1
34930,1,2,122537,122539,122541,2,4,0
34931,3,3,122540,122541,122544,1,4,0
34932,5,2,122545,122545,122547,0,2,1
34933,1,1,122546,122547,122548,1,2,0
34934,2,3,122548,122548,122551,0,3,0
34935,2,3,122550,122551,122554,1,4,0
34936,3,1,122553,122554,122555,1,2,0
34937,6,1,122559,122559,122560,0,1,4
34938,3,2,122562,122562,122564,0,2,2
34939,3,3,122565,122565,122568,0,3,1
34940,2,1,122567,122568,122569,1,2,0
34941,3,1,122570,122570,122571,0,1,1
34942,6,2,122576,122576,122578,0,2,5
34943,4,3,122580,122580,122583,0,3,2
34944,6,3,122586,122586,122589,0,3,3
34945,2,2,122588,122589,122591,1,3,0
34946,5,3,122593,122593,122596,0,3,2
34947,1,2,122594,122596,122598,2,4,0
34948,6,1,122600,122600,122601,0,1,2
34949,6,3,122606,122606,122609,0,3,5
34950,5,3,122611,122611,122614,0,3,2
34951,4,3,122615,122615,122618,0,3,1
34952,5,2,122620,122620,122622,0,2,2
34953,4,2,122624,122624,122626,0,2,2
34954,4,3,122628,122628,122631,0,3,2
34955,5,2,122633,122633,122635,0,2,2
34956,3,3,122636,122636,122639,0,3,1
34957,2,2,122638,122639,122641,1,3,0
34958,6,2,122644,122644,122646,0,2,3
34959,4,1,122648,122648,122649,0,1,2
34960,4,1,122652,122652,122653,0,1,3
34961,4,2,122656,122656,122658,0,2,3
34962,1,3,122657,122658,122661,1,4,0
34963,1,3,122658,122661,122664,3,6,0
34964,6,2,122664,122664,122666,0,2,0
34965,1,2,122665,122666,122668,1,3,0
34966,4,2,122669,122669,122671,0,2,1
34967,2,1,122671,122671,122672,0,1,0
34968,2,1,122673,122673,122674,0,1,1
34969,5,3,122678,122678,122681,0,3,4
34970,5,3,122683,122683,122686,0,3,2
34971,4,3,122687,122687,122690,0,3,1
34972,6,2,122693,122693,122695,0,2,3
34973,1,2,122694,122695,122697,1,3,0
34974,3,2,122697,122697,122699,0,2,0
34975,4,1,122701,122701,122702,0,1,2
34976,1,1,122702,122702,122703,0,1,0
34977,3,3,122705,122705,122708,0,3,2
34978,4,2,122709,122709,122711,0,2,1
34979,3,2,122712,122712,122714,0,2,1
34980,3,3,122715,122715,122718,0,3,1
34981,1,3,122716,122718,122721,2,5,0
34982,1,1,122717,122721,122722,4,5,0
34983,1,2,122718,122722,122724,4,6,0
34984,4,2,122722,122724,122726,2,4,0
34985,1,3,122723,122726,122729,3,6,0
34986,6,3,122729,122729,122732,0,3,0
34987,1,1,122730,122732,122733,2,3,0
34988,3,3,122733,122733,122736,0,3,0
34989,2,3,122735,122736,122739,1,4,0
34990,1,1,122736,122739,122740,3,4,0
34991,6,2,122742,122742,122744,0,2,2
34992,3,2,122745,122745,122747,0,2,1
34993,4,1,122749,122749,122750,0,1,2
34994,5,2,122754,122754,122756,0,2,4
34995,2,2,122756,122756,122758,0,2,0
34996,1,1,122757,122758,122759,1,2,0
34997,2,1,122759,122759,122760,0,1,0
34998,2,1,122761,122761,122762,0,1,1
34999,1,3,122762,122762,122765,0,3,0
35000,2,1,122764,122765,122766,1,2,0
35001,6,1,122770,122770,122771,0,1,4
35002,2,3,122772,122772,122775,0,3,1
35003,6,3,122778,122778,122781,0,3,3
35004,6,2,122784,122784,122786,0,2,3
35005,4,3,122788,122788,122791,0,3,2
35006,4,1,122792,122792,122793,0,1,1
35007,1,3,122793,122793,122796,0,3,0
35008,5,1,122798,122798,122799,0,1,2
35009,5,1,122803,122803,122804,0,1,4
35010,4,2,122807,122807,122809,0,2,3
35011,4,3,122811,122811,122814,0,3,2
35012,4,2,122815,122815,122817,0,2,1
35013,4,3,122819,122819,122822,0,3,2
35014,2,2,122821,122822,122824,1,3,0
35015,1,3,122822,122824,122827,2,5,0
35016,1,1,122823,122827,122828,4,5,0
35017,3,3,122826,122828,122831,2,5,0
35018,6,3,122832,122832,122835,0,3,1
35019,4,2,122836,122836,122838,0,2,1
35020,1,1,122837,122838,122839,1,2,0
35021,2,1,122839,122839,122840,0,1,0
35022,1,2,122840,122840,122842,0,2,0
35023,6,2,122846,122846,122848,0,2,4
35024,3,3,122849,122849,122852,0,3,1
35025,4,2,122853,122853,122855,0,2,1
35026,4,2,122857,122857,122859,0,2,2
35027,1,2,122858,122859,122861,1,3,0
35028,2,2,122860,122861,122863,1,3,0
35029,4,3,122864,122864,122867,0,3,1
35030,1,3,122865,122867,122870,2,5,0
35031,4,3,122869,122870,122873,1,4,0
35032,3,2,122872,122873,122875,1,3,0
35033,5,1,122877,122877,122878,0,1,2
35034,6,2,122883,122883,122885,0,2,5
35035,6,1,122889,122889,122890,0,1,4
35036,2,2,122891,122891,122893,0,2,1
35037,4,2,122895,122895,122897,0,2,2
35038,1,2,122896,122897,122899,1,3,0
35039,6,3,122902,122902,122905,0,3,3
35040,5,1,122907,122907,122908,0,1,2
35041,4,2,122911,122911,122913,0,2,3
35042,3,1,122914,122914,122915,0,1,1
35043,4,1,122918,122918,122919,0,1,3
35044,2,2,122920,122920,122922,0,2,1
35045,3,2,122923,122923,122925,0,2,1
35046,6,2,122929,122929,122931,0,2,4
35047,4,2,122933,122933,122935,0,2,2
35048,6,1,122939,122939,122940,0,1,4
35049,5,1,122944,122944,122945,0,1,4
35050,6,1,122950,122950,122951,0,1,5
35051,1,2,122951,122951,122953,0,2,0
35052,6,2,122957,122957,122959,0,2,4
35053,5,2,122962,122962,122964,0,2,3
35054,3,2,122965,122965,122967,0,2,1
35055,3,2,122968,122968,122970,0,2,1
35056,2,3,122970,122970,122973,0,3,0
35057,3,2,122973,122973,122975,0,2,0
35058,3,3,122976,122976,122979,0,3,1
35059,4,2,122980,122980,122982,0,2,1
35060,1,1,122981,122982,122983,1,2,0
35061,5,2,122986,122986,122988,0,2,3
35062,6,2,122992,122992,122994,0,2,4
35063,6,2,122998,122998,123000,0,2,4
35064,2,2,123000,123000,123002,0,2,0
35065,2,2,123002,123002,123004,0,2,0
35066,3,1,123005,123005,123006,0,1,1
35067,6,1,123011,123011,123012,0,1,5
35068,5,3,123016,123016,123019,0,3,4
35069,6,3,123022,123022,123025,0,3,3
35070,3,3,123025,123025,123028,0,3,0
35071,6,1,123031,123031,123032,0,1,3
35072,5,1,123036,123036,123037,0,1,4
35073,4,3,123040,123040,123043,0,3,3
35074,6,2,123046,123046,123048,0,2,3
35075,2,1,123048,123048,123049,0,1,0
35076,4,1,123052,123052,123053,0,1,3
35077,6,1,123058,123058,123059,0,1,5
35078,4,1,123062,123062,123063,0,1,3
35079,3,2,123065,123065,123067,0,2,2
35080,6,1,123071,123071,123072,0,1,4
35081,6,3,123077,123077,123080,0,3,5
35082,1,1,123078,123080,123081,2,3,0
35083,3,3,123081,123081,123084,0,3,0
35084,6,3,123087,123087,123090,0,3,3
35085,5,3,123092,123092,123095,0,3,2
35086,5,1,123097,123097,123098,0,1,2
35087,6,2,123103,123103,123105,0,2,5
35088,6,1,123109,123109,123110,0,1,4
35089,1,2,123110,123110,123112,0,2,0
35090,4,3,123114,123114,123117,0,3,2
35091,6,2,123120,123120,123122,0,2,3
35092,4,1,123124,123124,123125,0,1,2
35093,6,1,123130,123130,123131,0,1,5
35094,2,1,123132,123132,123133,0,1,1
35095,2,1,123134,123134,123135,0,1,1
35096,6,2,123140,123140,123142,0,2,5
35097,4,2,123144,123144,123146,0,2,2
35098,5,1,123149,123149,123150,0,1,3
35099,3,2,123152,123152,123154,0,2,2
35100,3,1,123155,123155,123156,0,1,1
35101,3,1,123158,123158,123159,0,1,2
35102,5,3,123163,123163,123166,0,3,4
35103,2,2,123165,123166,123168,1,3,0
35104,3,2,123168,123168,123170,0,2,0
35105,1,1,123169,123170,123171,1,2,0
35106,1,1,123170,123171,123172,1,2,0
35107,1,2,123171,123172,123174,1,3,0
35108,5,1,123176,123176,123177,0,1,2
35109,2,2,123178,123178,123180,0,2,1
35110,1,2,123179,123180,123182,1,3,0
35111,1,2,123180,123182,123184,2,4,0
35112,1,3,123181,123184,123187,3,6,0
35113,3,1,123184,123187,123188,3,4,0
35114,2,1,123186,123188,123189,2,3,0
35115,5,2,123191,123191,123193,0,2,2
35116,1,3,123192,123193,123196,1,4,0
35117,4,2,123196,123196,123198,0,2,0
35118,1,1,123197,123198,123199,1,2,0
35119,6,2,123203,123203,123205,0,2,4
35120,4,2,123207,123207,123209,0,2,2
35121,6,2,123213,123213,123215,0,2,4
35122,5,2,123218,123218,123220,0,2,3
35123,3,3,123221,123221,123224,0,3,1
35124,6,2,123227,123227,123229,0,2,3
35125,6,3,123233,123233,123236,0,3,4
35126,6,2,123239,123239,123241,0,2,3
35127,2,1,123241,123241,123242,0,1,0
35128,6,2,123247,123247,123249,0,2,5
35129,4,1,123251,123251,123252,0,1,2
35130,4,2,123255,123255,123257,0,2,3
35131,3,3,123258,123258,123261,0,3,1
35132,5,1,123263,123263,123264,0,1,2
35133,6,3,123269,123269,123272,0,3,5
35134,4,3,123273,123273,123276,0,3,1
35135,4,1,123277,123277,123278,0,1,1
35136,2,3,123279,123279,123282,0,3,1
35137,3,1,123282,123282,123283,0,1,0
35138,5,3,123287,123287,123290,0,3,4
35139,4,1,123291,123291,123292,0,1,1
35140,1,1,123292,123292,123293,0,1,0
35141,6,3,123298,123298,123301,0,3,5
35142,1,1,123299,123301,123302,2,3,0
35143,5,1,123304,123304,123305,0,1,2
35144,1,2,123305,123305,123307,0,2,0
35145,5,3,123310,123310,123313,0,3,3
35146,5,2,123315,123315,123317,0,2,2
35147,2,1,123317,123317,123318,0,1,0
35148,5,3,123322,123322,123325,0,3,4
35149,6,3,123328,123328,123331,0,3,3
35150,2,2,123330,123331,123333,1,3,0
35151,2,2,123332,123333,123335,1,3,0
35152,1,2,123333,123335,123337,2,4,0
35153,5,3,123338,123338,123341,0,3,1
35154,3,1,123341,123341,123342,0,1,0
35155,3,3,123344,123344,123347,0,3,2
35156,1,3,123345,123347,123350,2,5,0
35157,3,1,123348,123350,123351,2,3,0
35158,5,2,123353,123353,123355,0,2,2
35159,3,3,123356,123356,123359,0,3,1
35160,2,3,123358,123359,123362,1,4,0
35161,1,3,123359,123362,123365,3,6,0
35162,5,1,123364,123365,123366,1,2,0
35163,1,1,123365,123366,123367,1,2,0
35164,5,1,123370,123370,123371,0,1,3
35165,2,1,123372,123372,123373,0,1,1
35166,6,1,123378,123378,123379,0,1,5
35167,5,3,123383,123383,123386,0,3,4
35168,6,2,123389,123389,123391,0,2,3
35169,2,1,123391,123391,123392,0,1,0
35170,2,2,123393,123393,123395,0,2,1
35171,3,3,123396,123396,123399,0,3,1
35172,1,3,123397,123399,123402,2,5,0
35173,5,2,123402,123402,123404,0,2,0
35174,1,1,123403,123404,123405,1,2,0
35175,1,1,123404,123405,123406,1,2,0
35176,5,1,123409,123409,123410,0,1,3
35177,4,3,123413,123413,123416,0,3,3
35178,3,3,123416,123416,123419,0,3,0
35179,6,3,123422,123422,123425,0,3,3
35180,6,1,123428,123428,123429,0,1,3
35181,6,2,123434,123434,123436,0,2,5
35182,2,3,123436,123436,123439,0,3,0
35183,1,1,123437,123439,123440,2,3,0
35184,4,3,123441,123441,123444,0,3,1
35185,6,3,123447,123447,123450,0,3,3
35186,4,3,123451,123451,123454,0,3,1
35187,4,1,123455,123455,123456,0,1,1
35188,3,3,123458,123458,123461,0,3,2
35189,5,1,123463,123463,123464,0,1,2
35190,2,1,123465,123465,123466,0,1,1
35191,5,3,123470,123470,123473,0,3,4
35192,2,2,123472,123473,123475,1,3,0
35193,3,3,123475,123475,123478,0,3,0
35194,1,2,123476,123478,123480,2,4,0
35195,5,1,123481,123481,123482,0,1,1
35196,5,2,123486,123486,123488,0,2,4
35197,2,1,123488,123488,123489,0,1,0
35198,2,3,123490,123490,123493,0,3,1
35199,3,1,123493,123493,123494,0,1,0
35200,3,1,123496,123496,123497,0,1,2
35201,5,2,123501,123501,123503,0,2,4
35202,4,2,123505,123505,123507,0,2,2
35203,5,2,123510,123510,123512,0,2,3
35204,5,3,123515,123515,123518,0,3,3
35205,5,3,123520,123520,123523,0,3,2
35206,1,2,123521,123523,123525,2,4,0
35207,2,2,123523,123525,123527,2,4,0
35208,3,1,123526,123527,123528,1,2,0
35209,6,3,123532,123532,123535,0,3,4
35210,1,3,123533,123535,123538,2,5,0
35211,5,3,123538,123538,123541,0,3,0
35212,4,1,123542,123542,123543,0,1,1
35213,4,3,123546,123546,123549,0,3,3
35214,5,3,123551,123551,123554,0,3,2
35215,5,1,123556,123556,123557,0,1,2
35216,5,3,123561,123561,123564,0,3,4
35217,5,1,123566,123566,123567,0,1,2
35218,1,2,123567,123567,123569,0,2,0
35219,2,3,123569,123569,123572,0,3,0
35220,3,1,123572,123572,123573,0,1,0
35221,4,3,123576,123576,123579,0,3,3
35222,3,2,123579,123579,123581,0,2,0
35223,4,1,123583,123583,123584,0,1,2
35224,4,1,123587,123587,123588,0,1,3
35225,1,3,123588,123588,123591,0,3,0
35226,1,1,123589,123591,123592,2,3,0
35227,3,3,123592,123592,123595,0,3,0
35228,1,1,123593,123595,123596,2,3,0
35229,5,2,123598,123598,123600,0,2,2
35230,4,3,123602,123602,123605,0,3,2
35231,3,3,123605,123605,123608,0,3,0
35232,4,2,123609,123609,123611,0,2,1
35233,6,2,123615,123615,123617,0,2,4
35234,6,3,123621,123621,123624,0,3,4
35235,5,2,123626,123626,123628,0,2,2
35236,2,1,123628,123628,123629,0,1,0
35237,3,2,123631,123631,123633,0,2,2
35238,6,3,123637,123637,123640,0,3,4
35239,4,3,123641,123641,123644,0,3,1
35240,4,3,123645,123645,123648,0,3,1
35241,3,2,123648,123648,123650,0,2,0
35242,1,3,123649,123650,123653,1,4,0
35243,5,1,123654,123654,123655,0,1,1
35244,3,3,123657,123657,123660,0,3,2
35245,3,2,123660,123660,123662,0,2,0
35246,1,1,123661,123662,123663,1,2,0
35247,3,3,123664,123664,123667,0,3,1
35248,5,1,123669,123669,123670,0,1,2
35249,2,2,123671,123671,123673,0,2,1
35250,2,3,123673,123673,123676,0,3,0
35251,6,2,123679,123679,123681,0,2,3
35252,2,2,123681,123681,123683,0,2,0
35253,5,3,123686,123686,123689,0,3,3
35254,5,2,123691,123691,123693,0,2,2
35255,5,2,123696,123696,123698,0,2,3
35256,2,3,123698,123698,123701,0,3,0
35257,4,2,123702,123702,123704,0,2,1
35258,2,2,123704,123704,123706,0,2,0
35259,6,2,123710,123710,123712,0,2,4
35260,6,3,123716,123716,123719,0,3,4
35261,1,2,123717,123719,123721,2,4,0
35262,3,2,123720,123721,123723,1,3,0
35263,5,2,123725,123725,123727,0,2,2
35264,3,3,123728,123728,123731,0,3,1
35265,5,1,123733,123733,123734,0,1,2
35266,3,3,123736,123736,123739,0,3,2
35267,3,1,123739,123739,123740,0,1,0
35268,5,2,123744,123744,123746,0,2,4
35269,5,1,123749,123749,123750,0,1,3
35270,1,3,123750,123750,123753,0,3,0
35271,1,3,123751,123753,123756,2,5,0
35272,6,3,123757,123757,123760,0,3,1
35273,5,2,123762,123762,123764,0,2,2
35274,6,3,123768,123768,123771,0,3,4
35275,1,3,123769,123771,123774,2,5,0
35276,6,1,123775,123775,123776,0,1,1
35277,1,3,123776,123776,123779,0,3,0
35278,2,2,123778,123779,123781,1,3,0
35279,5,3,123783,123783,123786,0,3,2
35280,6,1,123789,123789,123790,0,1,3
35281,6,1,123795,123795,123796,0,1,5
35282,1,1,123796,123796,123797,0,1,0
35283,6,1,123802,123802,123803,0,1,5
35284,6,2,123808,123808,123810,0,2,5
35285,5,3,123813,123813,123816,0,3,3
35286,3,1,123816,123816,123817,0,1,0
35287,6,2,123822,123822,123824,0,2,5
35288,4,2,123826,123826,123828,0,2,2
35289,2,3,123828,123828,123831,0,3,0
35290,5,3,123833,123833,123836,0,3,2
35291,1,2,123834,123836,123838,2,4,0
35292,4,1,123838,123838,123839,0,1,0
35293,4,2,123842,123842,123844,0,2,3
35294,1,1,123843,123844,123845,1,2,0
35295,3,2,123846,123846,123848,0,2,1
35296,2,3,123848,123848,123851,0,3,0
35297,5,1,123853,123853,123854,0,1,2
35298,5,3,123858,123858,123861,0,3,4
35299,5,2,123863,123863,123865,0,2,2
35300,3,1,123866,123866,123867,0,1,1
35301,5,2,123871,123871,123873,0,2,4
35302,4,3,123875,123875,123878,0,3,2
35303,6,1,123881,123881,123882,0,1,3
35304,4,1,123885,123885,123886,0,1,3
35305,1,3,123886,123886,123889,0,3,0
35306,5,1,123891,123891,123892,0,1,2
35307,1,3,123892,123892,123895,0,3,0
35308,5,2,123897,123897,123899,0,2,2
35309,3,3,123900,123900,123903,0,3,1
35310,2,1,123902,123903,123904,1,2,0
35311,4,1,123906,123906,123907,0,1,2
35312,6,1,123912,123912,123913,0,1,5
35313,6,2,123918,123918,123920,0,2,5
35314,2,2,123920,123920,123922,0,2,0
35315,6,2,123926,123926,123928,0,2,4
35316,6,3,123932,123932,123935,0,3,4
35317,5,2,123937,123937,123939,0,2,2
35318,5,3,123942,123942,123945,0,3,3
35319,2,3,123944,123945,123948,1,4,0
35320,4,3,123948,123948,123951,0,3,0
35321,5,1,123953,123953,123954,0,1,2
35322,4,2,123957,123957,123959,0,2,3
35323,1,1,123958,123959,123960,1,2,0
35324,3,2,123961,123961,123963,0,2,1
35325,4,3,123965,123965,123968,0,3,2
35326,1,3,123966,123968,123971,2,5,0
35327,1,3,123967,123971,123974,4,7,0
35328,5,1,123972,123974,123975,2,3,0
35329,3,3,123975,123975,123978,0,3,0
35330,6,1,123981,123981,123982,0,1,3
35331,6,1,123987,123987,123988,0,1,5
35332,5,1,123992,123992,123993,0,1,4
35333,1,1,123993,123993,123994,0,1,0
35334,3,2,123996,123996,123998,0,2,2
35335,3,1,123999,123999,124000,0,1,1
35336,3,1,124002,124002,124003,0,1,2
35337,5,2,124007,124007,124009,0,2,4
35338,5,3,124012,124012,124015,0,3,3
35339,5,1,124017,124017,124018,0,1,2
35340,1,2,124018,124018,124020,0,2,0
35341,6,2,124024,124024,124026,0,2,4
35342,6,2,124030,124030,124032,0,2,4
35343,6,1,124036,124036,124037,0,1,4
35344,5,2,124041,124041,124043,0,2,4
35345,3,3,124044,124044,124047,0,3,1
35346,4,3,124048,124048,124051,0,3,1
35347,4,2,124052,124052,124054,0,2,1
35348,4,3,124056,124056,124059,0,3,2
35349,6,2,124062,124062,124064,0,2,3
35350,5,3,124067,124067,124070,0,3,3
35351,1,1,124068,124070,124071,2,3,0
35352,2,2,124070,124071,124073,1,3,0
35353,3,2,124073,124073,124075,0,2,0
35354,3,1,124076,124076,124077,0,1,1
35355,6,3,124082,124082,124085,0,3,5
35356,1,3,124083,124085,124088,2,5,0
35357,2,3,124085,124088,124091,3,6,0
35358,1,3,124086,124091,124094,5,8,0
35359,1,3,124087,124094,124097,7,10,0
35360,3,2,124090,124097,124099,7,9,0
35361,4,2,124094,124099,124101,5,7,0
35362,4,1,124098,124101,124102,3,4,0
35363,1,3,124099,124102,124105,3,6,0
35364,5,2,124104,124105,124107,1,3,0
35365,3,2,124107,124107,124109,0,2,0
35366,2,1,124109,124109,124110,0,1,0
35367,3,1,124112,124112,124113,0,1,2
35368,5,2,124117,124117,124119,0,2,4
35369,5,3,124122,124122,124125,0,3,3
35370,2,2,124124,124125,124127,1,3,0
35371,6,2,124130,124130,124132,0,2,3
35372,2,2,124132,124132,124134,0,2,0
35373,4,3,124136,124136,124139,0,3,2
35374,2,2,124138,124139,124141,1,3,0
35375,4,3,124142,124142,124145,0,3,1
35376,1,2,124143,124145,124147,2,4,0
35377,5,3,124148,124148,124151,0,3,1
35378,3,3,124151,124151,124154,0,3,0
35379,5,2,124156,124156,124158,0,2,2
35380,4,1,124160,124160,124161,0,1,2
35381,6,1,124166,124166,124167,0,1,5
35382,6,2,124172,124172,124174,0,2,5
35383,1,3,124173,124174,124177,1,4,0
35384,3,2,124176,124177,124179,1,3,0
35385,3,1,124179,124179,124180,0,1,0
35386,1,3,124180,124180,124183,0,3,0
35387,1,2,124181,124183,124185,2,4,0
35388,1,3,124182,124185,124188,3,6,0
35389,3,2,124185,124188,124190,3,5,0
35390,4,3,124189,124190,124193,1,4,0
35391,5,2,124194,124194,124196,0,2,1
35392,2,3,124196,124196,124199,0,3,0
35393,2,3,124198,124199,124202,1,4,0
35394,5,1,124203,124203,124204,0,1,1
35395,4,1,124207,124207,124208,0,1,3
35396,3,3,124210,124210,124213,0,3,2
35397,5,1,124215,124215,124216,0,1,2
35398,5,3,124220,124220,124223,0,3,4
35399,6,3,124226,124226,124229,0,3,3
35400,1,1,124227,124229,124230,2,3,0
35401,1,3,124228,124230,124233,2,5,0
35402,6,3,124234,124234,124237,0,3,1
35403,2,3,124236,124237,124240,1,4,0
35404,5,1,124241,124241,124242,0,1,1
35405,4,3,124245,124245,124248,0,3,3
35406,2,3,124247,124248,124251,1,4,0
35407,3,3,124250,124251,124254,1,4,0
35408,3,2,124253,124254,124256,1,3,0
35409,4,2,124257,124257,124259,0,2,1
35410,4,3,124261,124261,124264,0,3,2
35411,3,3,124264,124264,124267,0,3,0
35412,6,3,124270,124270,124273,0,3,3
35413,5,2,124275,124275,124277,0,2,2
35414,5,1,124280,124280,124281,0,1,3
35415,1,3,124281,124281,124284,0,3,0
35416,2,3,124283,124284,124287,1,4,0
35417,4,3,124287,124287,124290,0,3,0
35418,2,1,124289,124290,124291,1,2,0
35419,5,1,124294,124294,124295,0,1,3
35420,3,3,124297,124297,124300,0,3,2
35421,2,3,124299,124300,124303,1,4,0
35422,2,2,124301,124303,124305,2,4,0
35423,6,3,124307,124307,124310,0,3,2
35424,2,2,124309,124310,124312,1,3,0
35425,5,3,124314,124314,124317,0,3,2
35426,4,3,124318,124318,124321,0,3,1
35427,2,2,124320,124321,124323,1,3,0
35428,5,1,124325,124325,124326,0,1,2
35429,2,2,124327,124327,124329,0,2,1
35430,3,1,124330,124330,124331,0,1,1
35431,6,2,124336,124336,124338,0,2,5
35432,2,3,124338,124338,124341,0,3,0
35433,4,1,124342,124342,124343,0,1,1
35434,6,2,124348,124348,124350,0,2,5
35435,6,3,124354,124354,124357,0,3,4
35436,1,3,124355,124357,124360,2,5,0
35437,3,1,124358,124360,124361,2,3,0
35438,1,2,124359,124361,124363,2,4,0
35439,6,1,124365,124365,124366,0,1,2
35440,3,1,124368,124368,124369,0,1,2
35441,5,2,124373,124373,124375,0,2,4
35442,3,1,124376,124376,124377,0,1,1
35443,3,3,124379,124379,124382,0,3,2
35444,1,3,124380,124382,124385,2,5,0
35445,1,2,124381,124385,124387,4,6,0
35446,5,2,124386,124387,124389,1,3,0
35447,6,2,124392,124392,124394,0,2,3
35448,2,1,124394,124394,124395,0,1,0
35449,5,3,124399,124399,124402,0,3,4
35450,2,2,124401,124402,124404,1,3,0
35451,4,3,124405,124405,124408,0,3,1
35452,2,2,124407,124408,124410,1,3,0
35453,1,2,124408,124410,124412,2,4,0
35454,3,1,124411,124412,124413,1,2,0
35455,1,1,124412,124413,124414,1,2,0
35456,1,1,124413,124414,124415,1,2,0
35457,3,1,124416,124416,124417,0,1,1
35458,5,3,124421,124421,124424,0,3,4
35459,2,3,124423,124424,124427,1,4,0
35460,6,2,124429,124429,124431,0,2,2
35461,5,3,124434,124434,124437,0,3,3
35462,2,2,124436,124437,124439,1,3,0
35463,3,2,124439,124439,124441,0,2,0
35464,4,1,124443,124443,124444,0,1,2
35465,6,1,124449,124449,124450,0,1,5
35466,1,2,124450,124450,124452,0,2,0
35467,3,2,124453,124453,124455,0,2,1
35468,2,3,124455,124455,124458,0,3,0
35469,3,2,124458,124458,124460,0,2,0
35470,2,2,124460,124460,124462,0,2,0
35471,5,1,124465,124465,124466,0,1,3
35472,5,3,124470,124470,124473,0,3,4
35473,1,1,124471,124473,124474,2,3,0
35474,2,3,124473,124474,124477,1,4,0
35475,1,3,124474,124477,124480,3,6,0
35476,4,3,124478,124480,124483,2,5,0
35477,1,1,124479,124483,124484,4,5,0
35478,2,3,124481,124484,124487,3,6,0
35479,2,1,124483,124487,124488,4,5,0
35480,1,2,124484,124488,124490,4,6,0
35481,3,3,124487,124490,124493,3,6,0
35482,1,1,124488,124493,124494,5,6,0
35483,5,2,124493,124494,124496,1,3,0
35484,6,1,124499,124499,124500,0,1,3
35485,3,2,124502,124502,124504,0,2,2
35486,4,1,124506,124506,124507,0,1,2
35487,1,2,124507,124507,124509,0,2,0
35488,2,2,124509,124509,124511,0,2,0
35489,6,1,124515,124515,124516,0,1,4
35490,3,3,124518,124518,124521,0,3,2
35491,6,3,124524,124524,124527,0,3,3
35492,4,1,124528,124528,124529,0,1,1
35493,6,1,124534,124534,124535,0,1,5
35494,4,3,124538,124538,124541,0,3,3
35495,5,1,124543,124543,124544,0,1,2
35496,5,2,124548,124548,124550,0,2,4
35497,1,1,124549,124550,124551,1,2,0
35498,5,3,124554,124554,124557,0,3,3
35499,4,2,124558,124558,124560,0,2,1
35500,3,3,124561,124561,124564,0,3,1
35501,3,1,124564,124564,124565,0,1,0
35502,3,1,124567,124567,124568,0,1,2
35503,2,1,124569,124569,124570,0,1,1
35504,3,3,124572,124572,124575,0,3,2
35505,4,3,124576,124576,124579,0,3,1
35506,4,3,124580,124580,124583,0,3,1
35507,6,3,124586,124586,124589,0,3,3
35508,1,2,124587,124589,124591,2,4,0
35509,6,1,124593,124593,124594,0,1,2
35510,5,1,124598,124598,124599,0,1,4
35511,6,3,124604,124604,124607,0,3,5
35512,5,3,124609,124609,124612,0,3,2
35513,1,2,124610,124612,124614,2,4,0
35514,5,1,124615,124615,124616,0,1,1
35515,3,3,124618,124618,124621,0,3,2
35516,1,3,124619,124621,124624,2,5,0
35517,3,2,124622,124624,124626,2,4,0
35518,4,3,124626,124626,124629,0,3,0
35519,5,3,124631,124631,124634,0,3,2
35520,3,2,124634,124634,124636,0,2,0
35521,6,3,124640,124640,124643,0,3,4
35522,1,1,124641,124643,124644,2,3,0
35523,2,3,124643,124644,124647,1,4,0
35524,1,2,124644,124647,124649,3,5,0
35525,6,1,124650,124650,124651,0,1,1
35526,1,2,124651,124651,124653,0,2,0
35527,5,2,124656,124656,124658,0,2,3
35528,5,1,124661,124661,124662,0,1,3
35529,6,1,124667,124667,124668,0,1,5
35530,4,2,124671,124671,124673,0,2,3
35531,1,2,124672,124673,124675,1,3,0
35532,5,1,124677,124677,124678,0,1,2
35533,2,2,124679,124679,124681,0,2,1
35534,4,3,124683,124683,124686,0,3,2
35535,5,3,124688,124688,124691,0,3,2
35536,2,2,124690,124691,124693,1,3,0
35537,1,3,124691,124693,124696,2,5,0
35538,5,3,124696,124696,124699,0,3,0
35539,6,3,124702,124702,124705,0,3,3
35540,3,3,124705,124705,124708,0,3,0
35541,3,1,124708,124708,124709,0,1,0
35542,6,2,124714,124714,124716,0,2,5
35543,6,2,124720,124720,124722,0,2,4
35544,2,1,124722,124722,124723,0,1,0
35545,1,1,124723,124723,124724,0,1,0
35546,6,3,124729,124729,124732,0,3,5
35547,4,2,124733,124733,124735,0,2,1
35548,2,3,124735,124735,124738,0,3,0
35549,3,3,124738,124738,124741,0,3,0
35550,2,1,124740,124741,124742,1,2,0
35551,6,2,124746,124746,124748,0,2,4
35552,2,1,124748,124748,124749,0,1,0
35553,6,1,124754,124754,124755,0,1,5
35554,6,3,124760,124760,124763,0,3,5
35555,5,1,124765,124765,124766,0,1,2
35556,5,1,124770,124770,124771,0,1,4
35557,5,1,124775,124775,124776,0,1,4
35558,2,1,124777,124777,124778,0,1,1
35559,6,3,124783,124783,124786,0,3,5
35560,3,1,124786,124786,124787,0,1,0
35561,1,1,124787,124787,124788,0,1,0
35562,5,1,124792,124792,124793,0,1,4
35563,2,3,124794,124794,124797,0,3,1
35564,6,1,124800,124800,124801,0,1,3
35565,3,2,124803,124803,124805,0,2,2
35566,6,1,124809,124809,124810,0,1,4
35567,5,2,124814,124814,124816,0,2,4
35568,5,3,124819,124819,124822,0,3,3
35569,1,1,124820,124822,124823,2,3,0
35570,6,1,124826,124826,124827,0,1,3
35571,6,2,124832,124832,124834,0,2,5
35572,4,3,124836,124836,124839,0,3,2
35573,6,3,124842,124842,124845,0,3,3
35574,5,3,124847,124847,124850,0,3,2
35575,3,2,124850,124850,124852,0,2,0
35576,3,2,124853,124853,124855,0,2,1
35577,1,3,124854,124855,124858,1,4,0
35578,2,2,124856,124858,124860,2,4,0
35579,1,1,124857,124860,124861,3,4,0
35580,1,3,124858,124861,124864,3,6,0
35581,2,2,124860,124864,124866,4,6,0
35582,2,2,124862,124866,124868,4,6,0
35583,1,1,124863,124868,124869,5,6,0
35584,1,1,124864,124869,124870,5,6,0
35585,3,1,124867,124870,124871,3,4,0
35586,4,3,124871,124871,124874,0,3,0
35587,6,1,124877,124877,124878,0,1,3
35588,3,1,124880,124880,124881,0,1,2
35589,2,2,124882,124882,124884,0,2,1
35590,1,3,124883,124884,124887,1,4,0
35591,5,2,124888,124888,124890,0,2,1
35592,3,3,124891,124891,124894,0,3,1
35593,2,1,124893,124894,124895,1,2,0
35594,3,2,124896,124896,124898,0,2,1
35595,1,3,124897,124898,124901,1,4,0
35596,4,3,124901,124901,124904,0,3,0
35597,6,1,124907,124907,124908,0,1,3
35598,6,3,124913,124913,124916,0,3,5
35599,1,2,124914,124916,124918,2,4,0
35600,1,1,124915,124918,124919,3,4,0
35601,5,3,124920,124920,124923,0,3,1
35602,2,3,124922,124923,124926,1,4,0
35603,1,3,124923,124926,124929,3,6,0
35604,6,1,124929,124929,124930,0,1,0
35605,6,3,124935,124935,124938,0,3,5
35606,1,3,124936,124938,124941,2,5,0
35607,6,2,124942,124942,124944,0,2,1
35608,6,2,124948,124948,124950,0,2,4
35609,3,1,124951,124951,124952,0,1,1
35610,3,2,124954,124954,124956,0,2,2
35611,1,3,124955,124956,124959,1,4,0
35612,6,3,124961,124961,124964,0,3,2
35613,1,2,124962,124964,124966,2,4,0
35614,4,1,124966,124966,124967,0,1,0
35615,4,1,124970,124970,124971,0,1,3
35616,2,3,124972,124972,124975,0,3,1
35617,5,2,124977,124977,124979,0,2,2
35618,4,3,124981,124981,124984,0,3,2
35619,4,2,124985,124985,124987,0,2,1
35620,5,1,124990,124990,124991,0,1,3
35621,2,3,124992,124992,124995,0,3,1
35622,2,3,124994,124995,124998,1,4,0
35623,3,3,124997,124998,125001,1,4,0
35624,4,2,125001,125001,125003,0,2,0
35625,3,3,125004,125004,125007,0,3,1
35626,1,3,125005,125007,125010,2,5,0
35627,3,3,125008,125010,125013,2,5,0
35628,2,3,125010,125013,125016,3,6,0
35629,5,3,125015,125016,125019,1,4,0
35630,4,3,125019,125019,125022,0,3,0
35631,4,1,125023,125023,125024,0,1,1
35632,1,3,125024,125024,125027,0,3,0
35633,5,1,125029,125029,125030,0,1,2
35634,6,2,125035,125035,125037,0,2,5
35635,6,3,125041,125041,125044,0,3,4
35636,5,1,125046,125046,125047,0,1,2
35637,3,1,125049,125049,125050,0,1,2
35638,4,2,125053,125053,125055,0,2,3
35639,2,2,125055,125055,125057,0,2,0
35640,4,2,125059,125059,125061,0,2,2
35641,1,2,125060,125061,125063,1,3,0
35642,1,3,125061,125063,125066,2,5,0
35643,1,3,125062,125066,125069,4,7,0
35644,2,1,125064,125069,125070,5,6,0
35645,4,3,125068,125070,125073,2,5,0
35646,2,1,125070,125073,125074,3,4,0
35647,2,1,125072,125074,125075,2,3,0
35648,3,3,125075,125075,125078,0,3,0
35649,6,3,125081,125081,125084,0,3,3
35650,6,2,125087,125087,125089,0,2,3
35651,2,1,125089,125089,125090,0,1,0
35652,5,3,125094,125094,125097,0,3,4
35653,5,3,125099,125099,125102,0,3,2
35654,1,3,125100,125102,125105,2,5,0
35655,4,2,125104,125105,125107,1,3,0
35656,2,3,125106,125107,125110,1,4,0
35657,4,2,125110,125110,125112,0,2,0
35658,2,1,125112,125112,125113,0,1,0
35659,6,2,125118,125118,125120,0,2,5
35660,6,2,125124,125124,125126,0,2,4
35661,5,2,125129,125129,125131,0,2,3
35662,6,1,125135,125135,125136,0,1,4
35663,3,2,125138,125138,125140,0,2,2
35664,4,1,125142,125142,125143,0,1,2
35665,4,2,125146,125146,125148,0,2,3
35666,5,2,125151,125151,125153,0,2,3
35667,4,2,125155,125155,125157,0,2,2
35668,5,3,125160,125160,125163,0,3,3
35669,6,2,125166,125166,125168,0,2,3
35670,2,2,125168,125168,125170,0,2,0
35671,2,3,125170,125170,125173,0,3,0
35672,5,3,125175,125175,125178,0,3,2
35673,4,2,125179,125179,125181,0,2,1
35674,3,3,125182,125182,125185,0,3,1
35675,3,2,125185,125185,125187,0,2,0
35676,4,1,125189,125189,125190,0,1,2
35677,6,2,125195,125195,125197,0,2,5
35678,5,3,125200,125200,125203,0,3,3
35679,6,2,125206,125206,125208,0,2,3
35680,3,2,125209,125209,125211,0,2,1
35681,3,1,125212,125212,125213,0,1,1
35682,5,2,125217,125217,125219,0,2,4
35683,1,1,125218,125219,125220,1,2,0
35684,4,1,125222,125222,125223,0,1,2
35685,3,2,125225,125225,125227,0,2,2
35686,5,2,125230,125230,125232,0,2,3
35687,2,1,125232,125232,125233,0,1,0
35688,1,3,125233,125233,125236,0,3,0
35689,4,1,125237,125237,125238,0,1,1
35690,1,2,125238,125238,125240,0,2,0
35691,3,1,125241,125241,125242,0,1,1
35692,1,1,125242,125242,125243,0,1,0
35693,3,2,125245,125245,125247,0,2,2
35694,2,3,125247,125247,125250,0,3,0
35695,4,1,125251,125251,125252,0,1,1
35696,5,1,125256,125256,125257,0,1,4
35697,2,3,125258,125258,125261,0,3,1
35698,6,2,125264,125264,125266,0,2,3
35699,3,3,125267,125267,125270,0,3,1
35700,1,1,125268,125270,125271,2,3,0
35701,6,1,125274,125274,125275,0,1,3
35702,3,1,125277,125277,125278,0,1,2
35703,2,2,125279,125279,125281,0,2,1
35704,2,2,125281,125281,125283,0,2,0
35705,5,2,125286,125286,125288,0,2,3
35706,3,3,125289,125289,125292,0,3,1
35707,4,2,125293,125293,125295,0,2,1
35708,6,2,125299,125299,125301,0,2,4
35709,3,1,125302,125302,125303,0,1,1
35710,6,1,125308,125308,125309,0,1,5
35711,6,2,125314,125314,125316,0,2,5
35712,4,2,125318,125318,125320,0,2,2
35713,3,2,125321,125321,125323,0,2,1
35714,1,2,125322,125323,125325,1,3,0
35715,1,2,125323,125325,125327,2,4,0
35716,6,3,125329,125329,125332,0,3,2
35717,5,1,125334,125334,125335,0,1,2
35718,6,2,125340,125340,125342,0,2,5
35719,2,1,125342,125342,125343,0,1,0
35720,4,2,125346,125346,125348,0,2,3
35721,2,3,125348,125348,125351,0,3,0
35722,1,3,125349,125351,125354,2,5,0
35723,3,2,125352,125354,125356,2,4,0
35724,5,2,125357,125357,125359,0,2,1
35725,5,1,125362,125362,125363,0,1,3
35726,4,2,125366,125366,125368,0,2,3
35727,4,1,125370,125370,125371,0,1,2
35728,3,2,125373,125373,125375,0,2,2
35729,3,2,125376,125376,125378,0,2,1
35730,5,3,125381,125381,125384,0,3,3
35731,1,2,125382,125384,125386,2,4,0
35732,1,3,125383,125386,125389,3,6,0
35733,6,3,125389,125389,125392,0,3,0
35734,6,3,125395,125395,125398,0,3,3
35735,4,3,125399,125399,125402,0,3,1
35736,3,2,125402,125402,125404,0,2,0
35737,2,3,125404,125404,125407,0,3,0
35738,5,1,125409,125409,125410,0,1,2
35739,3,1,125412,125412,125413,0,1,2
35740,2,3,125414,125414,125417,0,3,1
35741,4,2,125418,125418,125420,0,2,1
35742,1,2,125419,125420,125422,1,3,0
35743,3,1,125422,125422,125423,0,1,0
35744,1,2,125423,125423,125425,0,2,0
35745,1,1,125424,125425,125426,1,2,0
35746,2,1,125426,125426,125427,0,1,0
35747,5,2,125431,125431,125433,0,2,4
35748,5,3,125436,125436,125439,0,3,3
35749,5,3,125441,125441,125444,0,3,2
35750,1,1,125442,125444,125445,2,3,0
35751,1,1,125443,125445,125446,2,3,0
35752,3,3,125446,125446,125449,0,3,0
35753,1,2,125447,125449,125451,2,4,0
35754,1,2,125448,125451,125453,3,5,0
35755,1,2,125449,125453,125455,4,6,0
35756,4,2,125453,125455,125457,2,4,0
35757,5,2,125458,125458,125460,0,2,1
35758,2,3,125460,125460,125463,0,3,0
35759,6,1,125466,125466,125467,0,1,3
35760,1,2,125467,125467,125469,0,2,0
35761,5,2,125472,125472,125474,0,2,3
35762,2,1,125474,125474,125475,0,1,0
35763,2,1,125476,125476,125477,0,1,1
35764,6,3,125482,125482,125485,0,3,5
35765,5,3,125487,125487,125490,0,3,2
35766,3,1,125490,125490,125491,0,1,0
35767,1,3,125491,125491,125494,0,3,0
35768,2,3,125493,125494,125497,1,4,0
35769,1,3,125494,125497,125500,3,6,0
35770,3,2,125497,125500,125502,3,5,0
35771,6,3,125503,125503,125506,0,3,1
35772,1,3,125504,125506,125509,2,5,0
35773,2,2,125506,125509,125511,3,5,0
35774,1,1,125507,125511,125512,4,5,0
35775,2,2,125509,125512,125514,3,5,0
35776,6,1,125515,125515,125516,0,1,1
35777,6,2,125521,125521,125523,0,2,5
35778,6,1,125527,125527,125528,0,1,4
35779,6,2,125533,125533,125535,0,2,5
35780,1,1,125534,125535,125536,1,2,0
35781,1,1,125535,125536,125537,1,2,0
35782,3,1,125538,125538,125539,0,1,1
35783,2,2,125540,125540,125542,0,2,1
35784,6,1,125546,125546,125547,0,1,4
35785,6,3,125552,125552,125555,0,3,5
35786,1,1,125553,125555,125556,2,3,0
35787,4,3,125557,125557,125560,0,3,1
35788,3,1,125560,125560,125561,0,1,0
35789,5,3,125565,125565,125568,0,3,4
35790,2,3,125567,125568,125571,1,4,0
35791,3,1,125570,125571,125572,1,2,0
35792,5,1,125575,125575,125576,0,1,3
35793,4,1,125579,125579,125580,0,1,3
35794,3,1,125582,125582,125583,0,1,2
35795,3,3,125585,125585,125588,0,3,2
35796,4,1,125589,125589,125590,0,1,1
35797,1,1,125590,125590,125591,0,1,0
35798,6,1,125596,125596,125597,0,1,5
35799,6,1,125602,125602,125603,0,1,5
35800,3,1,125605,125605,125606,0,1,2
35801,2,3,125607,125607,125610,0,3,1
35802,3,1,125610,125610,125611,0,1,0
35803,4,1,125614,125614,125615,0,1,3
35804,1,1,125615,125615,125616,0,1,0
35805,3,1,125618,125618,125619,0,1,2
35806,5,3,125623,125623,125626,0,3,4
35807,3,3,125626,125626,125629,0,3,0
35808,5,3,125631,125631,125634,0,3,2
35809,2,1,125633,125634,125635,1,2,0
35810,3,2,125636,125636,125638,0,2,1
35811,1,3,125637,125638,125641,1,4,0
35812,6,1,125643,125643,125644,0,1,2
35813,2,1,125645,125645,125646,0,1,1
35814,2,3,125647,125647,125650,0,3,1
35815,3,3,125650,125650,125653,0,3,0
35816,3,2,125653,125653,125655,0,2,0
35817,6,2,125659,125659,125661,0,2,4
35818,4,3,125663,125663,125666,0,3,2
35819,4,2,125667,125667,125669,0,2,1
35820,3,1,125670,125670,125671,0,1,1
35821,3,3,125673,125673,125676,0,3,2
35822,3,2,125676,125676,125678,0,2,0
35823,2,3,125678,125678,125681,0,3,0
35824,6,1,125684,125684,125685,0,1,3
35825,1,2,125685,125685,125687,0,2,0
35826,2,3,125687,125687,125690,0,3,0
35827,4,3,125691,125691,125694,0,3,1
35828,6,3,125697,125697,125700,0,3,3
35829,3,1,125700,125700,125701,0,1,0
35830,5,3,125705,125705,125708,0,3,4
35831,3,3,125708,125708,125711,0,3,0
35832,5,3,125713,125713,125716,0,3,2
35833,3,1,125716,125716,125717,0,1,0
35834,3,3,125719,125719,125722,0,3,2
35835,4,1,125723,125723,125724,0,1,1
35836,1,3,125724,125724,125727,0,3,0
35837,1,1,125725,125727,125728,2,3,0
35838,3,2,125728,125728,125730,0,2,0
35839,3,2,125731,125731,125733,0,2,1
35840,3,3,125734,125734,125737,0,3,1
35841,6,3,125740,125740,125743,0,3,3
35842,2,2,125742,125743,125745,1,3,0
35843,1,1,125743,125745,125746,2,3,0
35844,4,1,125747,125747,125748,0,1,1
35845,6,2,125753,125753,125755,0,2,5
35846,1,1,125754,125755,125756,1,2,0
35847,2,3,125756,125756,125759,0,3,0
35848,1,3,125757,125759,125762,2,5,0
35849,4,2,125761,125762,125764,1,3,0
35850,6,3,125767,125767,125770,0,3,3
35851,6,3,125773,125773,125776,0,3,3
35852,1,2,125774,125776,125778,2,4,0
35853,6,2,125780,125780,125782,0,2,2
35854,1,1,125781,125782,125783,1,2,0
35855,6,2,125787,125787,125789,0,2,4
35856,4,3,125791,125791,125794,0,3,2
35857,6,2,125797,125797,125799,0,2,3
35858,5,2,125802,125802,125804,0,2,3
35859,2,1,125804,125804,125805,0,1,0
35860,6,1,125810,125810,125811,0,1,5
35861,2,1,125812,125812,125813,0,1,1
35862,4,1,125816,125816,125817,0,1,3
35863,2,2,125818,125818,125820,0,2,1
35864,1,3,125819,125820,125823,1,4,0
35865,1,2,125820,125823,125825,3,5,0
35866,3,1,125823,125825,125826,2,3,0
35867,3,1,125826,125826,125827,0,1,0
35868,2,3,125828,125828,125831,0,3,1
35869,2,2,125830,125831,125833,1,3,0
35870,3,2,125833,125833,125835,0,2,0
35871,6,2,125839,125839,125841,0,2,4
35872,2,1,125841,125841,125842,0,1,0
35873,1,1,125842,125842,125843,0,1,0
35874,2,3,125844,125844,125847,0,3,1
35875,4,3,125848,125848,125851,0,3,1
35876,2,2,125850,125851,125853,1,3,0
35877,2,1,125852,125853,125854,1,2,0
35878,6,1,125858,125858,125859,0,1,4
35879,5,1,125863,125863,125864,0,1,4
35880,6,3,125869,125869,125872,0,3,5
35881,1,2,125870,125872,125874,2,4,0
35882,1,1,125871,125874,125875,3,4,0
35883,2,3,125873,125875,125878,2,5,0
35884,4,3,125877,125878,125881,1,4,0
35885,2,1,125879,125881,125882,2,3,0
35886,5,3,125884,125884,125887,0,3,2
35887,3,2,125887,125887,125889,0,2,0
35888,4,2,125891,125891,125893,0,2,2
35889,2,2,125893,125893,125895,0,2,0
35890,4,1,125897,125897,125898,0,1,2
35891,6,1,125903,125903,125904,0,1,5
35892,6,3,125909,125909,125912,0,3,5
35893,5,1,125914,125914,125915,0,1,2
35894,5,1,125919,125919,125920,0,1,4
35895,4,3,125923,125923,125926,0,3,3
35896,4,1,125927,125927,125928,0,1,1
35897,5,3,125932,125932,125935,0,3,4
35898,5,2,125937,125937,125939,0,2,2
35899,2,1,125939,125939,125940,0,1,0
35900,1,2,125940,125940,125942,0,2,0
35901,2,2,125942,125942,125944,0,2,0
35902,5,2,125947,125947,125949,0,2,3
35903,4,3,125951,125951,125954,0,3,2
35904,1,3,125952,125954,125957,2,5,0
35905,2,3,125954,125957,125960,3,6,0
35906,4,1,125958,125960,125961,2,3,0
35907,4,3,125962,125962,125965,0,3,1
35908,5,2,125967,125967,125969,0,2,2
35909,3,2,125970,125970,125972,0,2,1
35910,5,3,125975,125975,125978,0,3,3
35911,1,2,125976,125978,125980,2,4,0
35912,4,1,125980,125980,125981,0,1,0
35913,4,2,125984,125984,125986,0,2,3
35914,2,2,125986,125986,125988,0,2,0
35915,5,1,125991,125991,125992,0,1,3
35916,6,1,125997,125997,125998,0,1,5
35917,2,2,125999,125999,126001,0,2,1
35918,2,2,126001,126001,126003,0,2,0
35919,3,2,126004,126004,126006,0,2,1
35920,2,3,126006,126006,126009,0,3,0
35921,4,3,126010,126010,126013,0,3,1
35922,5,1,126015,126015,126016,0,1,2
35923,2,3,126017,126017,126020,0,3,1
35924,1,3,126018,126020,126023,2,5,0
35925,3,1,126021,126023,126024,2,3,0
35926,6,2,126027,126027,126029,0,2,3
35927,4,2,126031,126031,126033,0,2,2
35928,2,2,126033,126033,126035,0,2,0
35929,5,3,126038,126038,126041,0,3,3
35930,2,1,126040,126041,126042,1,2,0
35931,6,2,126046,126046,126048,0,2,4
35932,4,2,126050,126050,126052,0,2,2
35933,3,3,126053,126053,126056,0,3,1
35934,3,1,126056,126056,126057,0,1,0
35935,4,2,126060,126060,126062,0,2,3
35936,3,3,126063,126063,126066,0,3,1
35937,2,2,126065,126066,126068,1,3,0
35938,2,2,126067,126068,126070,1,3,0
35939,5,1,126072,126072,126073,0,1,2
35940,3,1,126075,126075,126076,0,1,2
35941,6,2,126081,126081,126083,0,2,5
35942,1,2,126082,126083,126085,1,3,0
35943,3,3,126085,126085,126088,0,3,0
35944,4,2,126089,126089,126091,0,2,1
35945,5,2,126094,126094,126096,0,2,3
35946,1,2,126095,126096,126098,1,3,0
35947,1,1,126096,126098,126099,2,3,0
35948,5,2,126101,126101,126103,0,2,2
35949,6,3,126107,126107,126110,0,3,4
35950,2,2,126109,126110,126112,1,3,0
35951,3,2,126112,126112,126114,0,2,0
35952,6,1,126118,126118,126119,0,1,4
35953,2,1,126120,126120,126121,0,1,1
35954,4,1,126124,126124,126125,0,1,3
35955,1,3,126125,126125,126128,0,3,0
35956,1,1,126126,126128,126129,2,3,0
35957,4,2,126130,126130,126132,0,2,1
35958,5,1,126135,126135,126136,0,1,3
35959,2,1,126137,126137,126138,0,1,1
35960,2,3,126139,126139,126142,0,3,1
35961,3,1,126142,126142,126143,0,1,0
35962,6,3,126148,126148,126151,0,3,5
35963,4,1,126152,126152,126153,0,1,1
35964,1,3,126153,126153,126156,0,3,0
35965,5,1,126158,126158,126159,0,1,2
35966,6,2,126164,126164,126166,0,2,5
35967,1,3,126165,126166,126169,1,4,0
35968,3,1,126168,126169,126170,1,2,0
35969,1,2,126169,126170,126172,1,3,0
35970,3,2,126172,126172,126174,0,2,0
35971,4,1,126176,126176,126177,0,1,2
35972,4,3,126180,126180,126183,0,3,3
35973,3,3,126183,126183,126186,0,3,0
35974,5,2,126188,126188,126190,0,2,2
35975,4,3,126192,126192,126195,0,3,2
35976,1,1,126193,126195,126196,2,3,0
35977,5,1,126198,126198,126199,0,1,2
35978,4,1,126202,126202,126203,0,1,3
35979,4,1,126206,126206,126207,0,1,3
35980,3,3,126209,126209,126212,0,3,2
35981,1,1,126210,126212,126213,2,3,0
35982,4,3,126214,126214,126217,0,3,1
35983,4,2,126218,126218,126220,0,2,1
35984,2,2,126220,126220,126222,0,2,0
35985,3,1,126223,126223,126224,0,1,1
35986,1,1,126224,126224,126225,0,1,0
35987,3,1,126227,126227,126228,0,1,2
35988,5,3,126232,126232,126235,0,3,4
35989,6,1,126238,126238,126239,0,1,3
35990,1,2,126239,126239,126241,0,2,0
35991,4,2,126243,126243,126245,0,2,2
35992,5,1,126248,126248,126249,0,1,3
35993,2,2,126250,126250,126252,0,2,1
35994,4,2,126254,126254,126256,0,2,2
35995,1,2,126255,126256,126258,1,3,0
35996,3,3,126258,126258,126261,0,3,0
35997,3,3,126261,126261,126264,0,3,0
35998,4,2,126265,126265,126267,0,2,1
35999,6,2,126271,126271,126273,0,2,4
36000,4,2,126275,126275,126277,0,2,2
36001,2,1,126277,126277,126278,0,1,0
36002,5,2,126282,126282,126284,0,2,4
36003,5,3,126287,126287,126290,0,3,3
36004,1,3,126288,126290,126293,2,5,0
36005,4,2,126292,126293,126295,1,3,0
36006,1,3,126293,126295,126298,2,5,0
36007,5,3,126298,126298,126301,0,3,0
36008,6,3,126304,126304,126307,0,3,3
36009,6,1,126310,126310,126311,0,1,3
36010,4,2,126314,126314,126316,0,2,3
36011,4,1,126318,126318,126319,0,1,2
36012,4,3,126322,126322,126325,0,3,3
36013,1,1,126323,126325,126326,2,3,0
36014,5,1,126328,126328,126329,0,1,2
36015,5,2,126333,126333,126335,0,2,4
36016,5,1,126338,126338,126339,0,1,3
36017,1,3,126339,126339,126342,0,3,0
36018,4,1,126343,126343,126344,0,1,1
36019,2,2,126345,126345,126347,0,2,1
36020,4,3,126349,126349,126352,0,3,2
36021,5,2,126354,126354,126356,0,2,2
36022,6,2,126360,126360,126362,0,2,4
36023,5,2,126365,126365,126367,0,2,3
36024,2,3,126367,126367,126370,0,3,0
36025,1,2,126368,126370,126372,2,4,0
36026,4,3,126372,126372,126375,0,3,0
36027,5,1,126377,126377,126378,0,1,2
36028,5,3,126382,126382,126385,0,3,4
36029,6,3,126388,126388,126391,0,3,3
36030,6,1,126394,126394,126395,0,1,3
36031,3,3,126397,126397,126400,0,3,2
36032,6,1,126403,126403,126404,0,1,3
36033,3,3,126406,126406,126409,0,3,2
36034,4,1,126410,126410,126411,0,1,1
36035,5,1,126415,126415,126416,0,1,4
36036,3,2,126418,126418,126420,0,2,2
36037,5,3,126423,126423,126426,0,3,3
36038,2,3,126425,126426,126429,1,4,0
36039,6,3,126431,126431,126434,0,3,2
36040,3,1,126434,126434,126435,0,1,0
36041,5,3,126439,126439,126442,0,3,4
36042,2,1,126441,126442,126443,1,2,0
36043,2,2,126443,126443,126445,0,2,0
36044,2,1,126445,126445,126446,0,1,0
36045,2,2,126447,126447,126449,0,2,1
36046,2,2,126449,126449,126451,0,2,0
36047,1,3,126450,126451,126454,1,4,0
36048,2,2,126452,126454,126456,2,4,0
36049,3,1,126455,126456,126457,1,2,0
36050,4,1,126459,126459,126460,0,1,2
36051,3,3,126462,126462,126465,0,3,2
36052,5,1,126467,126467,126468,0,1,2
36053,4,3,126471,126471,126474,0,3,3
36054,5,2,126476,126476,126478,0,2,2
36055,2,2,126478,126478,126480,0,2,0
36056,5,1,126483,126483,126484,0,1,3
36057,1,3,126484,126484,126487,0,3,0
36058,1,1,126485,126487,126488,2,3,0
36059,3,1,126488,126488,126489,0,1,0
36060,5,1,126493,126493,126494,0,1,4
36061,3,3,126496,126496,126499,0,3,2
36062,2,1,126498,126499,126500,1,2,0
36063,6,3,126504,126504,126507,0,3,4
36064,3,2,126507,126507,126509,0,2,0
36065,3,3,126510,126510,126513,0,3,1
36066,6,1,126516,126516,126517,0,1,3
36067,5,2,126521,126521,126523,0,2,4
36068,5,1,126526,126526,126527,0,1,3
36069,1,3,126527,126527,126530,0,3,0
36070,2,2,126529,126530,126532,1,3,0
36071,6,3,126535,126535,126538,0,3,3
36072,6,2,126541,126541,126543,0,2,3
36073,2,1,126543,126543,126544,0,1,0
36074,1,2,126544,126544,126546,0,2,0
36075,5,2,126549,126549,126551,0,2,3
36076,3,3,126552,126552,126555,0,3,1
36077,3,3,126555,126555,126558,0,3,0
36078,6,1,126561,126561,126562,0,1,3
36079,4,3,126565,126565,126568,0,3,3
36080,5,2,126570,126570,126572,0,2,2
36081,6,3,126576,126576,126579,0,3,4
36082,4,3,126580,126580,126583,0,3,1
36083,2,3,126582,126583,126586,1,4,0
36084,4,1,126586,126586,126587,0,1,0
36085,4,2,126590,126590,126592,0,2,3
36086,4,2,126594,126594,126596,0,2,2
36087,1,1,126595,126596,126597,1,2,0
36088,6,1,126601,126601,126602,0,1,4
36089,5,3,126606,126606,126609,0,3,4
36090,5,1,126611,126611,126612,0,1,2
36091,6,3,126617,126617,126620,0,3,5
36092,4,2,126621,126621,126623,0,2,1
36093,4,3,126625,126625,126628,0,3,2
36094,3,1,126628,126628,126629,0,1,0
36095,1,3,126629,126629,126632,0,3,0
36096,1,2,126630,126632,126634,2,4,0
36097,5,1,126635,126635,126636,0,1,1
36098,4,3,126639,126639,126642,0,3,3
36099,4,1,126643,126643,126644,0,1,1
36100,4,1,126647,126647,126648,0,1,3
36101,2,2,126649,126649,126651,0,2,1
36102,4,3,126653,126653,126656,0,3,2
36103,5,3,126658,126658,126661,0,3,2
36104,6,1,126664,126664,126665,0,1,3
36105,4,1,126668,126668,126669,0,1,3
36106,3,1,126671,126671,126672,0,1,2
36107,1,1,126672,126672,126673,0,1,0
36108,6,3,126678,126678,126681,0,3,5
36109,5,2,126683,126683,126685,0,2,2
36110,2,2,126685,126685,126687,0,2,0
36111,2,2,126687,126687,126689,0,2,0
36112,2,2,126689,126689,126691,0,2,0
36113,1,2,126690,126691,126693,1,3,0
36114,2,3,126692,126693,126696,1,4,0
36115,5,3,126697,126697,126700,0,3,1
36116,1,3,126698,126700,126703,2,5,0
36117,5,2,126703,126703,126705,0,2,0
36118,1,2,126704,126705,126707,1,3,0
36119,1,2,126705,126707,126709,2,4,0
36120,6,2,126711,126711,126713,0,2,2
36121,2,1,126713,126713,126714,0,1,0
36122,1,1,126714,126714,126715,0,1,0
36123,2,1,126716,126716,126717,0,1,1
36124,3,2,126719,126719,126721,0,2,2
36125,1,2,126720,126721,126723,1,3,0
36126,2,1,126722,126723,126724,1,2,0
36127,5,2,126727,126727,126729,0,2,3
36128,5,1,126732,126732,126733,0,1,3
36129,5,1,126737,126737,126738,0,1,4
36130,6,3,126743,126743,126746,0,3,5
36131,4,1,126747,126747,126748,0,1,1
36132,3,1,126750,126750,126751,0,1,2
36133,3,1,126753,126753,126754,0,1,2
36134,1,2,126754,126754,126756,0,2,0
36135,2,1,126756,126756,126757,0,1,0
36136,4,3,126760,126760,126763,0,3,3
36137,4,1,126764,126764,126765,0,1,1
36138,4,3,126768,126768,126771,0,3,3
36139,6,2,126774,126774,126776,0,2,3
36140,6,3,126780,126780,126783,0,3,4
36141,4,1,126784,126784,126785,0,1,1
36142,6,3,126790,126790,126793,0,3,5
36143,6,3,126796,126796,126799,0,3,3
36144,1,2,126797,126799,126801,2,4,0
36145,1,3,126798,126801,126804,3,6,0
36146,3,3,126801,126804,126807,3,6,0
36147,1,3,126802,126807,126810,5,8,0
36148,4,1,126806,126810,126811,4,5,0
36149,5,1,126811,126811,126812,0,1,0
36150,4,3,126815,126815,126818,0,3,3
36151,1,3,126816,126818,126821,2,5,0
36152,6,2,126822,126822,126824,0,2,1
36153,5,2,126827,126827,126829,0,2,3
36154,2,3,126829,126829,126832,0,3,0
36155,5,3,126834,126834,126837,0,3,2
36156,1,1,126835,126837,126838,2,3,0
36157,1,1,126836,126838,126839,2,3,0
36158,2,3,126838,126839,126842,1,4,0
36159,5,3,126843,126843,126846,0,3,1
36160,1,2,126844,126846,126848,2,4,0
36161,4,1,126848,126848,126849,0,1,0
36162,2,2,126850,126850,126852,0,2,1
36163,5,2,126855,126855,126857,0,2,3
36164,6,3,126861,126861,126864,0,3,4
36165,1,1,126862,126864,126865,2,3,0
36166,5,3,126867,126867,126870,0,3,2
36167,5,1,126872,126872,126873,0,1,2
36168,2,2,126874,126874,126876,0,2,1
36169,2,1,126876,126876,126877,0,1,0
36170,6,3,126882,126882,126885,0,3,5
36171,3,1,126885,126885,126886,0,1,0
36172,3,2,126888,126888,126890,0,2,2
36173,6,1,126894,126894,126895,0,1,4
36174,6,3,126900,126900,126903,0,3,5
36175,4,2,126904,126904,126906,0,2,1
36176,3,2,126907,126907,126909,0,2,1
36177,4,2,126911,126911,126913,0,2,2
36178,1,1,126912,126913,126914,1,2,0
36179,4,3,126916,126916,126919,0,3,2
36180,2,1,126918,126919,126920,1,2,0
36181,3,1,126921,126921,126922,0,1,1
36182,1,1,126922,126922,126923,0,1,0
36183,6,2,126928,126928,126930,0,2,5
36184,1,2,126929,126930,126932,1,3,0
36185,3,2,126932,126932,126934,0,2,0
36186,5,3,126937,126937,126940,0,3,3
36187,3,3,126940,126940,126943,0,3,0
36188,1,2,126941,126943,126945,2,4,0
36189,2,2,126943,126945,126947,2,4,0
36190,5,3,126948,126948,126951,0,3,1
36191,1,3,126949,126951,126954,2,5,0
36192,3,2,126952,126954,126956,2,4,0
36193,3,1,126955,126956,126957,1,2,0
36194,6,3,126961,126961,126964,0,3,4
36195,1,2,126962,126964,126966,2,4,0
36196,6,2,126968,126968,126970,0,2,2
36197,4,2,126972,126972,126974,0,2,2
36198,1,2,126973,126974,126976,1,3,0
36199,5,1,126978,126978,126979,0,1,2
36200,5,3,126983,126983,126986,0,3,4
36201,6,2,126989,126989,126991,0,2,3
36202,6,1,126995,126995,126996,0,1,4
36203,5,2,127000,127000,127002,0,2,4
36204,3,1,127003,127003,127004,0,1,1
36205,1,1,127004,127004,127005,0,1,0
36206,6,3,127010,127010,127013,0,3,5
36207,6,3,127016,127016,127019,0,3,3
36208,1,1,127017,127019,127020,2,3,0
36209,4,2,127021,127021,127023,0,2,1
36210,6,2,127027,127027,127029,0,2,4
36211,3,2,127030,127030,127032,0,2,1
36212,6,1,127036,127036,127037,0,1,4
36213,3,1,127039,127039,127040,0,1,2
36214,6,3,127045,127045,127048,0,3,5
36215,2,3,127047,127048,127051,1,4,0
36216,5,3,127052,127052,127055,0,3,1
36217,1,2,127053,127055,127057,2,4,0
36218,1,2,127054,127057,127059,3,5,0
36219,6,1,127060,127060,127061,0,1,1
36220,6,3,127066,127066,127069,0,3,5
36221,6,3,127072,127072,127075,0,3,3
36222,6,3,127078,127078,127081,0,3,3
36223,3,2,127081,127081,127083,0,2,0
36224,4,3,127085,127085,127088,0,3,2
36225,3,1,127088,127088,127089,0,1,0
36226,3,3,127091,127091,127094,0,3,2
36227,6,2,127097,127097,127099,0,2,3
36228,6,1,127103,127103,127104,0,1,4
36229,1,2,127104,127104,127106,0,2,0
36230,3,1,127107,127107,127108,0,1,1
36231,6,1,127113,127113,127114,0,1,5
36232,4,1,127117,127117,127118,0,1,3
36233,4,2,127121,127121,127123,0,2,3
36234,3,2,127124,127124,127126,0,2,1
36235,4,3,127128,127128,127131,0,3,2
36236,2,2,127130,127131,127133,1,3,0
36237,6,2,127136,127136,127138,0,2,3
36238,3,3,127139,127139,127142,0,3,1
36239,2,2,127141,127142,127144,1,3,0
36240,5,3,127146,127146,127149,0,3,2
36241,4,1,127150,127150,127151,0,1,1
36242,3,3,127153,127153,127156,0,3,2
36243,1,2,127154,127156,127158,2,4,0
36244,4,1,127158,127158,127159,0,1,0
36245,1,3,127159,127159,127162,0,3,0
36246,4,1,127163,127163,127164,0,1,1
36247,2,2,127165,127165,127167,0,2,1
36248,3,1,127168,127168,127169,0,1,1
36249,4,2,127172,127172,127174,0,2,3
36250,1,3,127173,127174,127177,1,4,0
36251,6,2,127179,127179,127181,0,2,2
36252,5,2,127184,127184,127186,0,2,3
36253,5,1,127189,127189,127190,0,1,3
36254,4,3,127193,127193,127196,0,3,3
36255,1,1,127194,127196,127197,2,3,0
36256,3,3,127197,127197,127200,0,3,0
36257,4,2,127201,127201,127203,0,2,1
36258,2,3,127203,127203,127206,0,3,0
36259,1,1,127204,127206,127207,2,3,0
36260,4,3,127208,127208,127211,0,3,1
36261,2,3,127210,127211,127214,1,4,0
36262,1,3,127211,127214,127217,3,6,0
36263,3,1,127214,127217,127218,3,4,0
36264,1,1,127215,127218,127219,3,4,0
36265,4,3,127219,127219,127222,0,3,0
36266,2,2,127221,127222,127224,1,3,0
36267,3,3,127224,127224,127227,0,3,0
36268,6,1,127230,127230,127231,0,1,3
36269,3,2,127233,127233,127235,0,2,2
36270,2,3,127235,127235,127238,0,3,0
36271,4,3,127239,127239,127242,0,3,1
36272,5,1,127244,127244,127245,0,1,2
36273,2,1,127246,127246,127247,0,1,1
36274,5,2,127251,127251,127253,0,2,4
36275,3,3,127254,127254,127257,0,3,1
36276,5,2,127259,127259,127261,0,2,2
36277,2,3,127261,127261,127264,0,3,0
36278,1,3,127262,127264,127267,2,5,0
36279,6,3,127268,127268,127271,0,3,1
36280,3,2,127271,127271,127273,0,2,0
36281,1,2,127272,127273,127275,1,3,0
36282,4,2,127276,127276,127278,0,2,1
36283,4,3,127280,127280,127283,0,3,2
36284,1,2,127281,127283,127285,2,4,0
36285,3,2,127284,127285,127287,1,3,0
36286,2,3,127286,127287,127290,1,4,0
36287,4,2,127290,127290,127292,0,2,0
36288,4,3,127294,127294,127297,0,3,2
36289,4,1,127298,127298,127299,0,1,1
36290,5,2,127303,127303,127305,0,2,4
36291,5,1,127308,127308,127309,0,1,3
36292,6,3,127314,127314,127317,0,3,5
36293,5,2,127319,127319,127321,0,2,2
36294,6,1,127325,127325,127326,0,1,4
36295,6,2,127331,127331,127333,0,2,5
36296,4,3,127335,127335,127338,0,3,2
36297,3,3,127338,127338,127341,0,3,0
36298,1,1,127339,127341,127342,2,3,0
36299,3,3,127342,127342,127345,0,3,0
36300,4,1,127346,127346,127347,0,1,1
36301,4,1,127350,127350,127351,0,1,3
36302,6,3,127356,127356,127359,0,3,5
36303,2,1,127358,127359,127360,1,2,0
36304,6,3,127364,127364,127367,0,3,4
36305,3,2,127367,127367,127369,0,2,0
36306,5,1,127372,127372,127373,0,1,3
36307,3,2,127375,127375,127377,0,2,2
36308,5,1,127380,127380,127381,0,1,3
36309,5,2,127385,127385,127387,0,2,4
36310,6,2,127391,127391,127393,0,2,4
36311,1,3,127392,127393,127396,1,4,0
36312,6,3,127398,127398,127401,0,3,2
36313,6,3,127404,127404,127407,0,3,3
36314,2,1,127406,127407,127408,1,2,0
36315,3,2,127409,127409,127411,0,2,1
36316,3,3,127412,127412,127415,0,3,1
36317,3,3,127415,127415,127418,0,3,0
36318,6,1,127421,127421,127422,0,1,3
36319,5,2,127426,127426,127428,0,2,4
36320,5,1,127431,127431,127432,0,1,3
36321,3,3,127434,127434,127437,0,3,2
36322,6,2,127440,127440,127442,0,2,3
36323,5,1,127445,127445,127446,0,1,3
36324,5,2,127450,127450,127452,0,2,4
36325,3,2,127453,127453,127455,0,2,1
36326,2,3,127455,127455,127458,0,3,0
36327,2,2,127457,127458,127460,1,3,0
36328,4,2,127461,127461,127463,0,2,1
36329,6,3,127467,127467,127470,0,3,4
36330,4,3,127471,127471,127474,0,3,1
36331,6,1,127477,127477,127478,0,1,3
36332,2,3,127479,127479,127482,0,3,1
36333,4,1,127483,127483,127484,0,1,1
36334,5,1,127488,127488,127489,0,1,4
36335,5,1,127493,127493,127494,0,1,4
36336,3,1,127496,127496,127497,0,1,2
36337,2,1,127498,127498,127499,0,1,1
36338,3,1,127501,127501,127502,0,1,2
36339,2,1,127503,127503,127504,0,1,1
36340,3,2,127506,127506,127508,0,2,2
36341,1,2,127507,127508,127510,1,3,0
36342,5,2,127512,127512,127514,0,2,2
36343,1,3,127513,127514,127517,1,4,0
36344,3,3,127516,127517,127520,1,4,0
36345,2,2,127518,127520,127522,2,4,0
36346,3,1,127521,127522,127523,1,2,0
36347,2,1,127523,127523,127524,0,1,0
36348,6,2,127529,127529,127531,0,2,5
36349,6,3,127535,127535,127538,0,3,4
36350,6,3,127541,127541,127544,0,3,3
36351,1,2,127542,127544,127546,2,4,0
36352,5,1,127547,127547,127548,0,1,1
36353,2,1,127549,127549,127550,0,1,1
36354,3,2,127552,127552,127554,0,2,2
36355,2,1,127554,127554,127555,0,1,0
36356,1,1,127555,127555,127556,0,1,0
36357,2,2,127557,127557,127559,0,2,1
36358,4,2,127561,127561,127563,0,2,2
36359,6,1,127567,127567,127568,0,1,4
36360,1,1,127568,127568,127569,0,1,0
36361,1,3,127569,127569,127572,0,3,0
36362,5,3,127574,127574,127577,0,3,2
36363,3,1,127577,127577,127578,0,1,0
36364,5,2,127582,127582,127584,0,2,4
36365,2,3,127584,127584,127587,0,3,0
36366,1,1,127585,127587,127588,2,3,0
36367,2,3,127587,127588,127591,1,4,0
36368,6,3,127593,127593,127596,0,3,2
36369,4,3,127597,127597,127600,0,3,1
36370,1,3,127598,127600,127603,2,5,0
36371,6,1,127604,127604,127605,0,1,1
36372,5,3,127609,127609,127612,0,3,4
36373,3,3,127612,127612,127615,0,3,0
36374,6,1,127618,127618,127619,0,1,3
36375,2,2,127620,127620,127622,0,2,1
36376,5,2,127625,127625,127627,0,2,3
36377,3,1,127628,127628,127629,0,1,1
36378,2,3,127630,127630,127633,0,3,1
36379,4,2,127634,127634,127636,0,2,1
36380,1,2,127635,127636,127638,1,3,0
36381,2,1,127637,127638,127639,1,2,0
36382,3,3,127640,127640,127643,0,3,1
36383,5,2,127645,127645,127647,0,2,2
36384,2,2,127647,127647,127649,0,2,0
36385,5,3,127652,127652,127655,0,3,3
36386,6,2,127658,127658,127660,0,2,3
36387,2,2,127660,127660,127662,0,2,0
36388,1,2,127661,127662,127664,1,3,0
36389,3,3,127664,127664,127667,0,3,0
36390,1,2,127665,127667,127669,2,4,0
36391,1,1,127666,127669,127670,3,4,0
36392,5,1,127671,127671,127672,0,1,1
36393,3,2,127674,127674,127676,0,2,2
36394,6,2,127680,127680,127682,0,2,4
36395,2,3,127682,127682,127685,0,3,0
36396,5,1,127687,127687,127688,0,1,2
36397,3,1,127690,127690,127691,0,1,2
36398,4,2,127694,127694,127696,0,2,3
36399,2,3,127696,127696,127699,0,3,0
36400,4,2,127700,127700,127702,0,2,1
36401,6,3,127706,127706,127709,0,3,4
36402,3,2,127709,127709,127711,0,2,0
36403,3,1,127712,127712,127713,0,1,1
36404,5,3,127717,127717,127720,0,3,4
36405,2,1,127719,127720,127721,1,2,0
36406,6,1,127725,127725,127726,0,1,4
36407,5,1,127730,127730,127731,0,1,4
36408,4,3,127734,127734,127737,0,3,3
36409,1,2,127735,127737,127739,2,4,0
36410,1,1,127736,127739,127740,3,4,0
36411,6,3,127742,127742,127745,0,3,2
36412,2,3,127744,127745,127748,1,4,0
36413,2,3,127746,127748,127751,2,5,0
36414,4,2,127750,127751,127753,1,3,0
36415,3,1,127753,127753,127754,0,1,0
36416,3,1,127756,127756,127757,0,1,2
36417,2,1,127758,127758,127759,0,1,1
36418,5,1,127763,127763,127764,0,1,4
36419,1,3,127764,127764,127767,0,3,0
36420,5,3,127769,127769,127772,0,3,2
36421,6,3,127775,127775,127778,0,3,3
36422,3,1,127778,127778,127779,0,1,0
36423,1,1,127779,127779,127780,0,1,0
36424,2,1,127781,127781,127782,0,1,1
36425,4,1,127785,127785,127786,0,1,3
36426,2,2,127787,127787,127789,0,2,1
36427,3,3,127790,127790,127793,0,3,1
36428,3,1,127793,127793,127794,0,1,0
36429,1,1,127794,127794,127795,0,1,0
36430,1,3,127795,127795,127798,0,3,0
36431,3,2,127798,127798,127800,0,2,0
36432,4,2,127802,127802,127804,0,2,2
36433,5,3,127807,127807,127810,0,3,3
36434,4,3,127811,127811,127814,0,3,1
36435,1,2,127812,127814,127816,2,4,0
36436,6,2,127818,127818,127820,0,2,2
36437,3,2,127821,127821,127823,0,2,1
36438,5,1,127826,127826,127827,0,1,3
36439,6,1,127832,127832,127833,0,1,5
36440,5,1,127837,127837,127838,0,1,4
36441,5,2,127842,127842,127844,0,2,4
36442,2,2,127844,127844,127846,0,2,0
36443,6,2,127850,127850,127852,0,2,4
36444,6,3,127856,127856,127859,0,3,4
36445,5,3,127861,127861,127864,0,3,2
36446,4,1,127865,127865,127866,0,1,1
36447,1,2,127866,127866,127868,0,2,0
36448,4,2,127870,127870,127872,0,2,2
36449,2,3,127872,127872,127875,0,3,0
36450,4,1,127876,127876,127877,0,1,1
36451,6,3,127882,127882,127885,0,3,5
36452,3,3,127885,127885,127888,0,3,0
36453,4,1,127889,127889,127890,0,1,1
36454,4,2,127893,127893,127895,0,2,3
36455,5,1,127898,127898,127899,0,1,3
36456,4,1,127902,127902,127903,0,1,3
36457,1,2,127903,127903,127905,0,2,0
36458,2,3,127905,127905,127908,0,3,0
36459,1,1,127906,127908,127909,2,3,0
36460,4,1,127910,127910,127911,0,1,1
36461,3,1,127913,127913,127914,0,1,2
36462,2,2,127915,127915,127917,0,2,1
36463,5,2,127920,127920,127922,0,2,3
36464,6,1,127926,127926,127927,0,1,4
36465,3,3,127929,127929,127932,0,3,2
36466,2,2,127931,127932,127934,1,3,0
36467,2,3,127933,127934,127937,1,4,0
36468,4,1,127937,127937,127938,0,1,0
36469,3,3,127940,127940,127943,0,3,2
36470,1,2,127941,127943,127945,2,4,0
36471,3,3,127944,127945,127948,1,4,0
36472,1,3,127945,127948,127951,3,6,0
36473,3,2,127948,127951,127953,3,5,0
36474,3,3,127951,127953,127956,2,5,0
36475,1,1,127952,127956,127957,4,5,0
36476,4,2,127956,127957,127959,1,3,0
36477,6,1,127962,127962,127963,0,1,3
36478,3,3,127965,127965,127968,0,3,2
36479,5,3,127970,127970,127973,0,3,2
36480,5,1,127975,127975,127976,0,1,2
36481,5,3,127980,127980,127983,0,3,4
36482,4,1,127984,127984,127985,0,1,1
36483,4,1,127988,127988,127989,0,1,3
36484,3,1,127991,127991,127992,0,1,2
36485,1,3,127992,127992,127995,0,3,0
36486,2,3,127994,127995,127998,1,4,0
36487,6,3,128000,128000,128003,0,3,2
36488,2,2,128002,128003,128005,1,3,0
36489,2,3,128004,128005,128008,1,4,0
36490,6,3,128010,128010,128013,0,3,2
36491,3,2,128013,128013,128015,0,2,0
36492,1,1,128014,128015,128016,1,2,0
36493,5,2,128019,128019,128021,0,2,3
36494,4,3,128023,128023,128026,0,3,2
36495,1,1,128024,128026,128027,2,3,0
36496,1,2,128025,128027,128029,2,4,0
36497,3,2,128028,128029,128031,1,3,0
36498,4,1,128032,128032,128033,0,1,1
36499,6,3,128038,128038,128041,0,3,5
36500,3,3,128041,128041,128044,0,3,0
36501,6,3,128047,128047,128050,0,3,3
36502,5,2,128052,128052,128054,0,2,2
36503,6,3,128058,128058,128061,0,3,4
36504,6,3,128064,128064,128067,0,3,3
36505,4,1,128068,128068,128069,0,1,1
36506,4,3,128072,128072,128075,0,3,3
36507,1,1,128073,128075,128076,2,3,0
36508,1,1,128074,128076,128077,2,3,0
36509,5,1,128079,128079,128080,0,1,2
36510,3,1,128082,128082,128083,0,1,2
36511,5,1,128087,128087,128088,0,1,4
36512,4,1,128091,128091,128092,0,1,3
36513,4,3,128095,128095,128098,0,3,3
36514,6,3,128101,128101,128104,0,3,3
36515,4,2,128105,128105,128107,0,2,1
36516,5,3,128110,128110,128113,0,3,3
36517,5,1,128115,128115,128116,0,1,2
36518,2,3,128117,128117,128120,0,3,1
36519,5,2,128122,128122,128124,0,2,2
36520,2,1,128124,128124,128125,0,1,0
36521,6,3,128130,128130,128133,0,3,5
36522,6,1,128136,128136,128137,0,1,3
36523,4,2,128140,128140,128142,0,2,3
36524,6,2,128146,128146,128148,0,2,4
36525,5,1,128151,128151,128152,0,1,3
36526,2,1,128153,128153,128154,0,1,1
36527,1,1,128154,128154,128155,0,1,0
36528,4,3,128158,128158,128161,0,3,3
36529,6,2,128164,128164,128166,0,2,3
36530,6,1,128170,128170,128171,0,1,4
36531,2,1,128172,128172,128173,0,1,1
36532,3,1,128175,128175,128176,0,1,2
36533,1,1,128176,128176,128177,0,1,0
36534,6,1,128182,128182,128183,0,1,5
36535,4,3,128186,128186,128189,0,3,3
36536,6,1,128192,128192,128193,0,1,3
36537,4,3,128196,128196,128199,0,3,3
36538,1,3,128197,128199,128202,2,5,0
36539,3,3,128200,128202,128205,2,5,0
36540,2,2,128202,128205,128207,3,5,0
36541,3,2,128205,128207,128209,2,4,0
36542,1,3,128206,128209,128212,3,6,0
36543,1,3,128207,128212,128215,5,8,0
36544,2,3,128209,128215,128218,6,9,0
36545,1,3,128210,128218,128221,8,11,0
36546,3,3,128213,128221,128224,8,11,0
36547,1,2,128214,128224,128226,10,12,0
36548,3,2,128217,128226,128228,9,11,0
36549,4,1,128221,128228,128229,7,8,0
36550,6,1,128227,128229,128230,2,3,0
36551,2,2,128229,128230,128232,1,3,0
36552,5,1,128234,128234,128235,0,1,2
36553,4,2,128238,128238,128240,0,2,3
36554,1,2,128239,128240,128242,1,3,0
36555,1,2,128240,128242,128244,2,4,0
36556,3,2,128243,128244,128246,1,3,0
36557,2,3,128245,128246,128249,1,4,0
36558,1,2,128246,128249,128251,3,5,0
36559,6,1,128252,128252,128253,0,1,1
36560,6,1,128258,128258,128259,0,1,5
36561,1,1,128259,128259,128260,0,1,0
36562,3,1,128262,128262,128263,0,1,2
36563,4,1,128266,128266,128267,0,1,3
36564,2,1,128268,128268,128269,0,1,1
36565,3,3,128271,128271,128274,0,3,2
36566,1,3,128272,128274,128277,2,5,0
36567,2,2,128274,128277,128279,3,5,0
36568,5,1,128279,128279,128280,0,1,0
36569,4,3,128283,128283,128286,0,3,3
36570,5,2,128288,128288,128290,0,2,2
36571,1,3,128289,128290,128293,1,4,0
36572,2,1,128291,128293,128294,2,3,0
36573,1,2,128292,128294,128296,2,4,0
36574,3,2,128295,128296,128298,1,3,0
36575,2,1,128297,128298,128299,1,2,0
36576,2,2,128299,128299,128301,0,2,0
36577,5,2,128304,128304,128306,0,2,3
36578,2,3,128306,128306,128309,0,3,0
36579,6,1,128312,128312,128313,0,1,3
36580,2,1,128314,128314,128315,0,1,1
36581,3,2,128317,128317,128319,0,2,2
36582,1,3,128318,128319,128322,1,4,0
36583,3,2,128321,128322,128324,1,3,0
36584,3,2,128324,128324,128326,0,2,0
36585,3,3,128327,128327,128330,0,3,1
36586,2,1,128329,128330,128331,1,2,0
36587,3,3,128332,128332,128335,0,3,1
36588,3,1,128335,128335,128336,0,1,0
36589,1,3,128336,128336,128339,0,3,0
36590,2,1,128338,128339,128340,1,2,0
36591,3,2,128341,128341,128343,0,2,1
36592,4,1,128345,128345,128346,0,1,2
36593,4,3,128349,128349,128352,0,3,3
36594,3,1,128352,128352,128353,0,1,0
36595,6,3,128358,128358,128361,0,3,5
36596,6,1,128364,128364,128365,0,1,3
36597,3,1,128367,128367,128368,0,1,2
36598,6,3,128373,128373,128376,0,3,5
36599,2,3,128375,128376,128379,1,4,0
36600,1,2,128376,128379,128381,3,5,0
36601,5,1,128381,128381,128382,0,1,0
36602,5,1,128386,128386,128387,0,1,4
36603,2,3,128388,128388,128391,0,3,1
36604,5,1,128393,128393,128394,0,1,2
36605,4,2,128397,128397,128399,0,2,3
36606,6,3,128403,128403,128406,0,3,4
36607,6,3,128409,128409,128412,0,3,3
36608,2,2,128411,128412,128414,1,3,0
36609,1,3,128412,128414,128417,2,5,0
36610,3,2,128415,128417,128419,2,4,0
36611,5,2,128420,128420,128422,0,2,1
36612,5,1,128425,128425,128426,0,1,3
36613,4,3,128429,128429,128432,0,3,3
36614,1,2,128430,128432,128434,2,4,0
36615,6,3,128436,128436,128439,0,3,2
36616,6,1,128442,128442,128443,0,1,3
36617,4,3,128446,128446,128449,0,3,3
36618,6,2,128452,128452,128454,0,2,3
36619,6,2,128458,128458,128460,0,2,4
36620,4,2,128462,128462,128464,0,2,2
36621,1,2,128463,128464,128466,1,3,0
36622,5,1,128468,128468,128469,0,1,2
36623,1,1,128469,128469,128470,0,1,0
36624,6,3,128475,128475,128478,0,3,5
36625,3,1,128478,128478,128479,0,1,0
36626,3,1,128481,128481,128482,0,1,2
36627,2,2,128483,128483,128485,0,2,1
36628,4,2,128487,128487,128489,0,2,2
36629,4,3,128491,128491,128494,0,3,2
36630,4,2,128495,128495,128497,0,2,1
36631,1,2,128496,128497,128499,1,3,0
36632,6,1,128502,128502,128503,0,1,3
36633,1,3,128503,128503,128506,0,3,0
36634,1,3,128504,128506,128509,2,5,0
36635,4,1,128508,128509,128510,1,2,0
36636,2,1,128510,128510,128511,0,1,0
36637,2,3,128512,128512,128515,0,3,1
36638,4,2,128516,128516,128518,0,2,1
36639,5,1,128521,128521,128522,0,1,3
36640,4,1,128525,128525,128526,0,1,3
36641,3,2,128528,128528,128530,0,2,2
36642,1,2,128529,128530,128532,1,3,0
36643,2,3,128531,128532,128535,1,4,0
36644,1,3,128532,128535,128538,3,6,0
36645,6,2,128538,128538,128540,0,2,0
36646,5,1,128543,128543,128544,0,1,3
36647,6,1,128549,128549,128550,0,1,5
36648,6,1,128555,128555,128556,0,1,5
36649,3,1,128558,128558,128559,0,1,2
36650,3,2,128561,128561,128563,0,2,2
36651,1,2,128562,128563,128565,1,3,0
36652,5,2,128567,128567,128569,0,2,2
36653,1,3,128568,128569,128572,1,4,0
36654,5,1,128573,128573,128574,0,1,1
36655,4,2,128577,128577,128579,0,2,3
36656,5,1,128582,128582,128583,0,1,3
36657,5,1,128587,128587,128588,0,1,4
36658,3,2,128590,128590,128592,0,2,2
36659,3,3,128593,128593,128596,0,3,1
36660,1,3,128594,128596,128599,2,5,0
36661,4,1,128598,128599,128600,1,2,0
36662,3,2,128601,128601,128603,0,2,1
36663,2,1,128603,128603,128604,0,1,0
36664,3,3,128606,128606,128609,0,3,2
36665,1,2,128607,128609,128611,2,4,0
36666,4,2,128611,128611,128613,0,2,0
36667,5,3,128616,128616,128619,0,3,3
36668,4,3,128620,128620,128623,0,3,1
36669,2,3,128622,128623,128626,1,4,0
36670,6,1,128628,128628,128629,0,1,2
36671,3,1,128631,128631,128632,0,1,2
36672,5,3,128636,128636,128639,0,3,4
36673,6,1,128642,128642,128643,0,1,3
36674,5,1,128647,128647,128648,0,1,4
36675,1,1,128648,128648,128649,0,1,0
36676,2,1,128650,128650,128651,0,1,1
36677,2,3,128652,128652,128655,0,3,1
36678,2,2,128654,128655,128657,1,3,0
36679,1,1,128655,128657,128658,2,3,0
36680,6,3,128661,128661,128664,0,3,3
36681,4,2,128665,128665,128667,0,2,1
36682,4,2,128669,128669,128671,0,2,2
36683,3,2,128672,128672,128674,0,2,1
36684,6,1,128678,128678,128679,0,1,4
36685,3,1,128681,128681,128682,0,1,2
36686,5,3,128686,128686,128689,0,3,4
36687,5,2,128691,128691,128693,0,2,2
36688,4,3,128695,128695,128698,0,3,2
36689,4,1,128699,128699,128700,0,1,1
36690,5,1,128704,128704,128705,0,1,4
36691,5,1,128709,128709,128710,0,1,4
36692,1,3,128710,128710,128713,0,3,0
36693,6,1,128716,128716,128717,0,1,3
36694,5,3,128721,128721,128724,0,3,4
36695,3,1,128724,128724,128725,0,1,0
36696,2,3,128726,128726,128729,0,3,1
36697,3,2,128729,128729,128731,0,2,0
36698,6,3,128735,128735,128738,0,3,4
36699,5,2,128740,128740,128742,0,2,2
36700,5,2,128745,128745,128747,0,2,3
36701,2,1,128747,128747,128748,0,1,0
36702,3,2,128750,128750,128752,0,2,2
36703,1,3,128751,128752,128755,1,4,0
36704,3,3,128754,128755,128758,1,4,0
36705,6,2,128760,128760,128762,0,2,2
36706,3,2,128763,128763,128765,0,2,1
36707,2,2,128765,128765,128767,0,2,0
36708,5,1,128770,128770,128771,0,1,3
36709,3,1,128773,128773,128774,0,1,2
36710,6,3,128779,128779,128782,0,3,5
36711,5,1,128784,128784,128785,0,1,2
36712,2,1,128786,128786,128787,0,1,1
36713,5,1,128791,128791,128792,0,1,4
36714,4,2,128795,128795,128797,0,2,3
36715,3,2,128798,128798,128800,0,2,1
36716,5,1,128803,128803,128804,0,1,3
36717,2,2,128805,128805,128807,0,2,1
36718,6,2,128811,128811,128813,0,2,4
36719,3,3,128814,128814,128817,0,3,1
36720,2,1,128816,128817,128818,1,2,0
36721,1,2,128817,128818,128820,1,3,0
36722,5,3,128822,128822,128825,0,3,2
36723,1,3,128823,128825,128828,2,5,0
36724,1,3,128824,128828,128831,4,7,0
36725,1,2,128825,128831,128833,6,8,0
36726,5,3,128830,128833,128836,3,6,0
36727,5,2,128835,128836,128838,1,3,0
36728,4,1,128839,128839,128840,0,1,1
36729,4,1,128843,128843,128844,0,1,3
36730,4,1,128847,128847,128848,0,1,3
36731,4,2,128851,128851,128853,0,2,3
36732,6,3,128857,128857,128860,0,3,4
36733,4,2,128861,128861,128863,0,2,1
36734,4,1,128865,128865,128866,0,1,2
36735,3,3,128868,128868,128871,0,3,2
36736,5,3,128873,128873,128876,0,3,2
36737,4,1,128877,128877,128878,0,1,1
36738,6,2,128883,128883,128885,0,2,5
36739,3,1,128886,128886,128887,0,1,1
36740,4,2,128890,128890,128892,0,2,3
36741,4,1,128894,128894,128895,0,1,2
36742,4,1,128898,128898,128899,0,1,3
36743,1,3,128899,128899,128902,0,3,0
36744,2,2,128901,128902,128904,1,3,0
36745,1,3,128902,128904,128907,2,5,0
36746,3,1,128905,128907,128908,2,3,0
36747,1,2,128906,128908,128910,2,4,0
36748,2,1,128908,128910,128911,2,3,0
36749,3,3,128911,128911,128914,0,3,0
36750,4,2,128915,128915,128917,0,2,1
36751,1,1,128916,128917,128918,1,2,0
36752,2,2,128918,128918,128920,0,2,0
36753,1,1,128919,128920,128921,1,2,0
36754,3,1,128922,128922,128923,0,1,1
36755,6,2,128928,128928,128930,0,2,5
36756,3,3,128931,128931,128934,0,3,1
36757,2,3,128933,128934,128937,1,4,0
36758,3,3,128936,128937,128940,1,4,0
36759,4,3,128940,128940,128943,0,3,0
36760,4,1,128944,128944,128945,0,1,1
36761,1,3,128945,128945,128948,0,3,0
36762,4,1,128949,128949,128950,0,1,1
36763,5,1,128954,128954,128955,0,1,4
36764,5,3,128959,128959,128962,0,3,4
36765,4,1,128963,128963,128964,0,1,1
36766,5,3,128968,128968,128971,0,3,4
36767,3,1,128971,128971,128972,0,1,0
36768,5,2,128976,128976,128978,0,2,4
36769,1,1,128977,128978,128979,1,2,0
36770,4,3,128981,128981,128984,0,3,2
36771,4,1,128985,128985,128986,0,1,1
36772,2,3,128987,128987,128990,0,3,1
36773,6,1,128993,128993,128994,0,1,3
36774,3,3,128996,128996,128999,0,3,2
36775,5,1,129001,129001,129002,0,1,2
36776,6,2,129007,129007,129009,0,2,5
36777,3,2,129010,129010,129012,0,2,1
36778,6,1,129016,129016,129017,0,1,4
36779,4,1,129020,129020,129021,0,1,3
36780,5,1,129025,129025,129026,0,1,4
36781,6,3,129031,129031,129034,0,3,5
36782,4,1,129035,129035,129036,0,1,1
36783,6,3,129041,129041,129044,0,3,5
36784,5,3,129046,129046,129049,0,3,2
36785,3,2,129049,129049,129051,0,2,0
36786,3,2,129052,129052,129054,0,2,1
36787,2,2,129054,129054,129056,0,2,0
36788,6,1,129060,129060,129061,0,1,4
36789,4,3,129064,129064,129067,0,3,3
36790,2,1,129066,129067,129068,1,2,0
36791,1,3,129067,129068,129071,1,4,0
36792,1,2,129068,129071,129073,3,5,0
36793,1,1,129069,129073,129074,4,5,0
36794,6,3,129075,129075,129078,0,3,1
36795,5,1,129080,129080,129081,0,1,2
36796,3,3,129083,129083,129086,0,3,2
36797,2,2,129085,129086,129088,1,3,0
36798,1,1,129086,129088,129089,2,3,0
36799,2,3,129088,129089,129092,1,4,0
36800,6,1,129094,129094,129095,0,1,2
36801,2,2,129096,129096,129098,0,2,1
36802,3,1,129099,129099,129100,0,1,1
36803,2,3,129101,129101,129104,0,3,1
36804,1,3,129102,129104,129107,2,5,0
36805,6,1,129108,129108,129109,0,1,1
36806,2,3,129110,129110,129113,0,3,1
36807,4,1,129114,129114,129115,0,1,1
36808,5,1,129119,129119,129120,0,1,4
36809,1,3,129120,129120,129123,0,3,0
36810,4,1,129124,129124,129125,0,1,1
36811,2,2,129126,129126,129128,0,2,1
36812,3,1,129129,129129,129130,0,1,1
36813,4,1,129133,129133,129134,0,1,3
36814,1,2,129134,129134,129136,0,2,0
36815,5,3,129139,129139,129142,0,3,3
36816,6,1,129145,129145,129146,0,1,3
36817,2,3,129147,129147,129150,0,3,1
36818,2,1,129149,129150,129151,1,2,0
36819,4,1,129153,129153,129154,0,1,2
36820,3,3,129156,129156,129159,0,3,2
36821,2,1,129158,129159,129160,1,2,0
36822,5,3,129163,129163,129166,0,3,3
36823,1,1,129164,129166,129167,2,3,0
36824,5,3,129169,129169,129172,0,3,2
36825,1,3,129170,129172,129175,2,5,0
36826,2,3,129172,129175,129178,3,6,0
36827,6,1,129178,129178,129179,0,1,0
36828,1,3,129179,129179,129182,0,3,0
36829,4,2,129183,129183,129185,0,2,1
36830,2,3,129185,129185,129188,0,3,0
36831,1,3,129186,129188,129191,2,5,0
36832,6,2,129192,129192,129194,0,2,1
36833,2,1,129194,129194,129195,0,1,0
36834,6,2,129200,129200,129202,0,2,5
36835,5,2,129205,129205,129207,0,2,3
36836,5,1,129210,129210,129211,0,1,3
36837,2,3,129212,129212,129215,0,3,1
36838,2,1,129214,129215,129216,1,2,0
36839,1,2,129215,129216,129218,1,3,0
36840,4,3,129219,129219,129222,0,3,1
36841,2,3,129221,129222,129225,1,4,0
36842,1,1,129222,129225,129226,3,4,0
36843,6,3,129228,129228,129231,0,3,2
36844,1,2,129229,129231,129233,2,4,0
36845,5,2,129234,129234,129236,0,2,1
36846,1,3,129235,129236,129239,1,4,0
36847,3,1,129238,129239,129240,1,2,0
36848,6,2,129244,129244,129246,0,2,4
36849,2,1,129246,129246,129247,0,1,0
36850,1,1,129247,129247,129248,0,1,0
36851,3,2,129250,129250,129252,0,2,2
36852,1,3,129251,129252,129255,1,4,0
36853,3,1,129254,129255,129256,1,2,0
36854,5,1,129259,129259,129260,0,1,3
36855,1,3,129260,129260,129263,0,3,0
36856,6,3,129266,129266,129269,0,3,3
36857,5,1,129271,129271,129272,0,1,2
36858,3,3,129274,129274,129277,0,3,2
36859,6,1,129280,129280,129281,0,1,3
36860,6,3,129286,129286,129289,0,3,5
36861,1,2,129287,129289,129291,2,4,0
36862,2,2,129289,129291,129293,2,4,0
36863,4,2,129293,129293,129295,0,2,0
36864,3,3,129296,129296,129299,0,3,1
36865,6,1,129302,129302,129303,0,1,3
36866,6,3,129308,129308,129311,0,3,5
36867,2,1,129310,129311,129312,1,2,0
36868,1,1,129311,129312,129313,1,2,0
36869,4,3,129315,129315,129318,0,3,2
36870,2,3,129317,129318,129321,1,4,0
36871,5,2,129322,129322,129324,0,2,1
36872,5,1,129327,129327,129328,0,1,3
36873,3,1,129330,129330,129331,0,1,2
36874,3,3,129333,129333,129336,0,3,2
36875,3,1,129336,129336,129337,0,1,0
36876,5,3,129341,129341,129344,0,3,4
36877,6,3,129347,129347,129350,0,3,3
36878,6,2,129353,129353,129355,0,2,3
36879,6,1,129359,129359,129360,0,1,4
36880,4,1,129363,129363,129364,0,1,3
36881,4,3,129367,129367,129370,0,3,3
36882,5,2,129372,129372,129374,0,2,2
36883,1,2,129373,129374,129376,1,3,0
36884,3,3,129376,129376,129379,0,3,0
36885,4,2,129380,129380,129382,0,2,1
36886,5,2,129385,129385,129387,0,2,3
36887,5,2,129390,129390,129392,0,2,3
36888,4,3,129394,129394,129397,0,3,2
36889,2,1,129396,129397,129398,1,2,0
36890,4,2,129400,129400,129402,0,2,2
36891,2,1,129402,129402,129403,0,1,0
36892,4,3,129406,129406,129409,0,3,3
36893,2,2,129408,129409,129411,1,3,0
36894,4,3,129412,129412,129415,0,3,1
36895,4,3,129416,129416,129419,0,3,1
36896,5,2,129421,129421,129423,0,2,2
36897,2,3,129423,129423,129426,0,3,0
36898,4,3,129427,129427,129430,0,3,1
36899,4,3,129431,129431,129434,0,3,1
36900,3,1,129434,129434,129435,0,1,0
36901,3,2,129437,129437,129439,0,2,2
36902,6,1,129443,129443,129444,0,1,4
36903,5,2,129448,129448,129450,0,2,4
36904,5,2,129453,129453,129455,0,2,3
36905,5,3,129458,129458,129461,0,3,3
36906,5,2,129463,129463,129465,0,2,2
36907,1,1,129464,129465,129466,1,2,0
36908,6,1,129470,129470,129471,0,1,4
36909,2,3,129472,129472,129475,0,3,1
36910,6,1,129478,129478,129479,0,1,3
36911,2,1,129480,129480,129481,0,1,1
36912,5,2,129485,129485,129487,0,2,4
36913,1,1,129486,129487,129488,1,2,0
36914,5,2,129491,129491,129493,0,2,3
36915,4,3,129495,129495,129498,0,3,2
36916,6,3,129501,129501,129504,0,3,3
36917,3,1,129504,129504,129505,0,1,0
36918,4,2,129508,129508,129510,0,2,3
36919,4,3,129512,129512,129515,0,3,2
36920,3,1,129515,129515,129516,0,1,0
36921,2,2,129517,129517,129519,0,2,1
36922,4,2,129521,129521,129523,0,2,2
36923,6,2,129527,129527,129529,0,2,4
36924,3,1,129530,129530,129531,0,1,1
36925,3,2,129533,129533,129535,0,2,2
36926,2,3,129535,129535,129538,0,3,0
36927,5,1,129540,129540,129541,0,1,2
36928,6,2,129546,129546,129548,0,2,5
36929,3,2,129549,129549,129551,0,2,1
36930,6,1,129555,129555,129556,0,1,4
36931,3,1,129558,129558,129559,0,1,2
36932,3,2,129561,129561,129563,0,2,2
36933,3,1,129564,129564,129565,0,1,1
36934,6,2,129570,129570,129572,0,2,5
36935,2,2,129572,129572,129574,0,2,0
36936,6,3,129578,129578,129581,0,3,4
36937,4,3,129582,129582,129585,0,3,1
36938,1,3,129583,129585,129588,2,5,0
36939,2,3,129585,129588,129591,3,6,0
36940,2,1,129587,129591,129592,4,5,0
36941,5,1,129592,129592,129593,0,1,0
36942,3,1,129595,129595,129596,0,1,2
36943,4,2,129599,129599,129601,0,2,3
36944,2,1,129601,129601,129602,0,1,0
36945,4,2,129605,129605,129607,0,2,3
36946,3,3,129608,129608,129611,0,3,1
36947,6,1,129614,129614,129615,0,1,3
36948,4,3,129618,129618,129621,0,3,3
36949,4,2,129622,129622,129624,0,2,1
36950,5,1,129627,129627,129628,0,1,3
36951,4,1,129631,129631,129632,0,1,3
36952,5,2,129636,129636,129638,0,2,4
36953,5,1,129641,129641,129642,0,1,3
36954,3,1,129644,129644,129645,0,1,2
36955,1,3,129645,129645,129648,0,3,0
36956,1,2,129646,129648,129650,2,4,0
36957,4,1,129650,129650,129651,0,1,0
36958,5,3,129655,129655,129658,0,3,4
36959,2,1,129657,129658,129659,1,2,0
36960,2,2,129659,129659,129661,0,2,0
36961,5,1,129664,129664,129665,0,1,3
36962,1,3,129665,129665,129668,0,3,0
36963,6,2,129671,129671,129673,0,2,3
36964,5,3,129676,129676,129679,0,3,3
36965,2,1,129678,129679,129680,1,2,0
36966,3,1,129681,129681,129682,0,1,1
36967,2,3,129683,129683,129686,0,3,1
36968,3,3,129686,129686,129689,0,3,0
36969,3,1,129689,129689,129690,0,1,0
36970,3,3,129692,129692,129695,0,3,2
36971,4,2,129696,129696,129698,0,2,1
36972,3,3,129699,129699,129702,0,3,1
36973,2,2,129701,129702,129704,1,3,0
36974,6,3,129707,129707,129710,0,3,3
36975,6,3,129713,129713,129716,0,3,3
36976,2,3,129715,129716,129719,1,4,0
36977,4,2,129719,129719,129721,0,2,0
36978,3,1,129722,129722,129723,0,1,1
36979,1,3,129723,129723,129726,0,3,0
36980,1,1,129724,129726,129727,2,3,0
36981,5,1,129729,129729,129730,0,1,2
36982,6,3,129735,129735,129738,0,3,5
36983,2,1,129737,129738,129739,1,2,0
36984,6,2,129743,129743,129745,0,2,4
36985,5,2,129748,129748,129750,0,2,3
36986,5,3,129753,129753,129756,0,3,3
36987,4,3,129757,129757,129760,0,3,1
36988,1,1,129758,129760,129761,2,3,0
36989,6,2,129764,129764,129766,0,2,3
36990,4,2,129768,129768,129770,0,2,2
36991,6,2,129774,129774,129776,0,2,4
36992,1,2,129775,129776,129778,1,3,0
36993,5,3,129780,129780,129783,0,3,2
36994,5,3,129785,129785,129788,0,3,2
36995,2,2,129787,129788,129790,1,3,0
36996,6,3,129793,129793,129796,0,3,3
36997,3,2,129796,129796,129798,0,2,0
36998,6,3,129802,129802,129805,0,3,4
36999,4,1,129806,129806,129807,0,1,1
37000,4,2,129810,129810,129812,0,2,3
37001,2,1,129812,129812,129813,0,1,0
37002,6,3,129818,129818,129821,0,3,5
37003,4,2,129822,129822,129824,0,2,1
37004,5,3,129827,129827,129830,0,3,3
37005,5,3,129832,129832,129835,0,3,2
37006,6,3,129838,129838,129841,0,3,3
37007,3,2,129841,129841,129843,0,2,0
37008,5,3,129846,129846,129849,0,3,3
37009,1,3,129847,129849,129852,2,5,0
37010,1,3,129848,129852,129855,4,7,0
37011,5,2,129853,129855,129857,2,4,0
37012,4,1,129857,129857,129858,0,1,0
37013,4,2,129861,129861,129863,0,2,3
37014,4,3,129865,129865,129868,0,3,2
37015,1,3,129866,129868,129871,2,5,0
37016,5,1,129871,129871,129872,0,1,0
37017,2,1,129873,129873,129874,0,1,1
37018,6,1,129879,129879,129880,0,1,5
37019,2,2,129881,129881,129883,0,2,1
37020,4,1,129885,129885,129886,0,1,2
37021,5,1,129890,129890,129891,0,1,4
37022,6,2,129896,129896,129898,0,2,5
37023,5,3,129901,129901,129904,0,3,3
37024,2,2,129903,129904,129906,1,3,0
37025,3,1,129906,129906,129907,0,1,0
37026,1,3,129907,129907,129910,0,3,0
37027,6,1,129913,129913,129914,0,1,3
37028,5,1,129918,129918,129919,0,1,4
37029,6,2,129924,129924,129926,0,2,5
37030,3,2,129927,129927,129929,0,2,1
37031,6,1,129933,129933,129934,0,1,4
37032,5,3,129938,129938,129941,0,3,4
37033,5,2,129943,129943,129945,0,2,2
37034,1,3,129944,129945,129948,1,4,0
37035,5,3,129949,129949,129952,0,3,1
37036,1,1,129950,129952,129953,2,3,0
37037,1,3,129951,129953,129956,2,5,0
37038,5,1,129956,129956,129957,0,1,0
37039,1,3,129957,129957,129960,0,3,0
37040,3,3,129960,129960,129963,0,3,0
37041,3,1,129963,129963,129964,0,1,0
37042,2,3,129965,129965,129968,0,3,1
37043,3,2,129968,129968,129970,0,2,0
37044,4,2,129972,129972,129974,0,2,2
37045,4,2,129976,129976,129978,0,2,2
37046,5,3,129981,129981,129984,0,3,3
37047,5,2,129986,129986,129988,0,2,2
37048,5,2,129991,129991,129993,0,2,3
37049,5,3,129996,129996,129999,0,3,3
37050,1,1,129997,129999,130000,2,3,0
37051,3,3,130000,130000,130003,0,3,0
37052,5,3,130005,130005,130008,0,3,2
37053,3,3,130008,130008,130011,0,3,0
37054,1,3,130009,130011,130014,2,5,0
37055,2,3,130011,130014,130017,3,6,0
37056,6,2,130017,130017,130019,0,2,0
37057,2,3,130019,130019,130022,0,3,0
37058,6,1,130025,130025,130026,0,1,3
37059,4,1,130029,130029,130030,0,1,3
37060,3,2,130032,130032,130034,0,2,2
37061,2,3,130034,130034,130037,0,3,0
37062,3,2,130037,130037,130039,0,2,0
37063,1,2,130038,130039,130041,1,3,0
37064,2,1,130040,130041,130042,1,2,0
37065,2,1,130042,130042,130043,0,1,0
37066,4,1,130046,130046,130047,0,1,3
37067,3,3,130049,130049,130052,0,3,2
37068,2,2,130051,130052,130054,1,3,0
37069,5,2,130056,130056,130058,0,2,2
37070,4,1,130060,130060,130061,0,1,2
37071,6,3,130066,130066,130069,0,3,5
37072,2,2,130068,130069,130071,1,3,0
37073,4,3,130072,130072,130075,0,3,1
37074,6,3,130078,130078,130081,0,3,3
37075,6,3,130084,130084,130087,0,3,3
37076,6,3,130090,130090,130093,0,3,3
37077,4,3,130094,130094,130097,0,3,1
37078,6,2,130100,130100,130102,0,2,3
37079,5,3,130105,130105,130108,0,3,3
37080,4,1,130109,130109,130110,0,1,1
37081,2,2,130111,130111,130113,0,2,1
37082,3,1,130114,130114,130115,0,1,1
37083,6,1,130120,130120,130121,0,1,5
37084,1,1,130121,130121,130122,0,1,0
37085,1,1,130122,130122,130123,0,1,0
37086,1,2,130123,130123,130125,0,2,0
37087,2,2,130125,130125,130127,0,2,0
37088,5,3,130130,130130,130133,0,3,3
37089,2,1,130132,130133,130134,1,2,0
37090,6,3,130138,130138,130141,0,3,4
37091,4,2,130142,130142,130144,0,2,1
37092,5,1,130147,130147,130148,0,1,3
37093,6,2,130153,130153,130155,0,2,5
37094,4,3,130157,130157,130160,0,3,2
37095,2,1,130159,130160,130161,1,2,0
37096,1,1,130160,130161,130162,1,2,0
37097,4,3,130164,130164,130167,0,3,2
37098,5,2,130169,130169,130171,0,2,2
37099,2,3,130171,130171,130174,0,3,0
37100,6,1,130177,130177,130178,0,1,3
37101,1,3,130178,130178,130181,0,3,0
37102,5,2,130183,130183,130185,0,2,2
37103,2,3,130185,130185,130188,0,3,0
37104,3,3,130188,130188,130191,0,3,0
37105,5,1,130193,130193,130194,0,1,2
37106,5,2,130198,130198,130200,0,2,4
37107,3,1,130201,130201,130202,0,1,1
37108,1,2,130202,130202,130204,0,2,0
37109,6,2,130208,130208,130210,0,2,4
37110,1,2,130209,130210,130212,1,3,0
37111,3,2,130212,130212,130214,0,2,0
37112,1,1,130213,130214,130215,1,2,0
37113,5,3,130218,130218,130221,0,3,3
37114,2,2,130220,130221,130223,1,3,0
37115,4,3,130224,130224,130227,0,3,1
37116,5,2,130229,130229,130231,0,2,2
37117,4,2,130233,130233,130235,0,2,2
37118,5,1,130238,130238,130239,0,1,3
37119,1,2,130239,130239,130241,0,2,0
37120,4,3,130243,130243,130246,0,3,2
37121,6,1,130249,130249,130250,0,1,3
37122,5,2,130254,130254,130256,0,2,4
37123,5,3,130259,130259,130262,0,3,3
37124,1,3,130260,130262,130265,2,5,0
37125,5,3,130265,130265,130268,0,3,0
37126,1,3,130266,130268,130271,2,5,0
37127,6,1,130272,130272,130273,0,1,1
37128,2,3,130274,130274,130277,0,3,1
37129,1,1,130275,130277,130278,2,3,0
37130,1,2,130276,130278,130280,2,4,0
37131,2,3,130278,130280,130283,2,5,0
37132,5,3,130283,130283,130286,0,3,0
37133,4,1,130287,130287,130288,0,1,1
37134,6,2,130293,130293,130295,0,2,5
37135,5,1,130298,130298,130299,0,1,3
37136,3,3,130301,130301,130304,0,3,2
37137,4,1,130305,130305,130306,0,1,1
37138,1,2,130306,130306,130308,0,2,0
37139,4,1,130310,130310,130311,0,1,2
37140,1,2,130311,130311,130313,0,2,0
37141,3,2,130314,130314,130316,0,2,1
37142,2,3,130316,130316,130319,0,3,0
37143,2,2,130318,130319,130321,1,3,0
37144,2,1,130320,130321,130322,1,2,0
37145,4,1,130324,130324,130325,0,1,2
37146,4,2,130328,130328,130330,0,2,3
37147,2,2,130330,130330,130332,0,2,0
37148,6,2,130336,130336,130338,0,2,4
37149,5,2,130341,130341,130343,0,2,3
37150,2,2,130343,130343,130345,0,2,0
37151,1,1,130344,130345,130346,1,2,0
37152,4,2,130348,130348,130350,0,2,2
37153,3,1,130351,130351,130352,0,1,1
37154,3,2,130354,130354,130356,0,2,2
37155,5,3,130359,130359,130362,0,3,3
37156,6,1,130365,130365,130366,0,1,3
37157,3,2,130368,130368,130370,0,2,2
37158,4,2,130372,130372,130374,0,2,2
37159,4,1,130376,130376,130377,0,1,2
37160,1,3,130377,130377,130380,0,3,0
37161,5,2,130382,130382,130384,0,2,2
37162,3,1,130385,130385,130386,0,1,1
37163,3,2,130388,130388,130390,0,2,2
37164,4,1,130392,130392,130393,0,1,2
37165,2,3,130394,130394,130397,0,3,1
37166,4,1,130398,130398,130399,0,1,1
37167,3,1,130401,130401,130402,0,1,2
37168,3,3,130404,130404,130407,0,3,2
37169,6,2,130410,130410,130412,0,2,3
37170,2,1,130412,130412,130413,0,1,0
37171,2,2,130414,130414,130416,0,2,1
37172,5,3,130419,130419,130422,0,3,3
37173,2,1,130421,130422,130423,1,2,0
37174,4,3,130425,130425,130428,0,3,2
37175,6,2,130431,130431,130433,0,2,3
37176,3,3,130434,130434,130437,0,3,1
37177,3,1,130437,130437,130438,0,1,0
37178,3,1,130440,130440,130441,0,1,2
37179,4,2,130444,130444,130446,0,2,3
37180,6,1,130450,130450,130451,0,1,4
37181,2,3,130452,130452,130455,0,3,1
37182,6,1,130458,130458,130459,0,1,3
37183,3,1,130461,130461,130462,0,1,2
37184,2,1,130463,130463,130464,0,1,1
37185,1,3,130464,130464,130467,0,3,0
37186,4,3,130468,130468,130471,0,3,1
37187,5,2,130473,130473,130475,0,2,2
37188,4,2,130477,130477,130479,0,2,2
37189,4,3,130481,130481,130484,0,3,2
37190,2,3,130483,130484,130487,1,4,0
37191,4,3,130487,130487,130490,0,3,0
37192,2,1,130489,130490,130491,1,2,0
37193,4,3,130493,130493,130496,0,3,2
37194,1,2,130494,130496,130498,2,4,0
37195,6,2,130500,130500,130502,0,2,2
37196,4,2,130504,130504,130506,0,2,2
37197,3,2,130507,130507,130509,0,2,1
37198,1,1,130508,130509,130510,1,2,0
37199,5,1,130513,130513,130514,0,1,3
37200,5,3,130518,130518,130521,0,3,4
37201,6,2,130524,130524,130526,0,2,3
37202,4,3,130528,130528,130531,0,3,2
37203,5,3,130533,130533,130536,0,3,2
37204,5,3,130538,130538,130541,0,3,2
37205,5,1,130543,130543,130544,0,1,2
37206,3,1,130546,130546,130547,0,1,2
37207,5,3,130551,130551,130554,0,3,4
37208,2,3,130553,130554,130557,1,4,0
37209,6,1,130559,130559,130560,0,1,2
37210,2,2,130561,130561,130563,0,2,1
37211,4,2,130565,130565,130567,0,2,2
37212,1,3,130566,130567,130570,1,4,0
37213,6,2,130572,130572,130574,0,2,2
37214,3,2,130575,130575,130577,0,2,1
37215,4,1,130579,130579,130580,0,1,2
37216,2,3,130581,130581,130584,0,3,1
37217,2,3,130583,130584,130587,1,4,0
37218,5,1,130588,130588,130589,0,1,1
37219,3,3,130591,130591,130594,0,3,2
37220,2,2,130593,130594,130596,1,3,0
37221,4,3,130597,130597,130600,0,3,1
37222,6,3,130603,130603,130606,0,3,3
37223,3,3,130606,130606,130609,0,3,0
37224,2,3,130608,130609,130612,1,4,0
37225,5,3,130613,130613,130616,0,3,1
37226,1,1,130614,130616,130617,2,3,0
37227,3,2,130617,130617,130619,0,2,0
37228,5,2,130622,130622,130624,0,2,3
37229,3,3,130625,130625,130628,0,3,1
37230,5,2,130630,130630,130632,0,2,2
37231,6,2,130636,130636,130638,0,2,4
37232,5,2,130641,130641,130643,0,2,3
37233,6,3,130647,130647,130650,0,3,4
37234,4,3,130651,130651,130654,0,3,1
37235,1,2,130652,130654,130656,2,4,0
37236,1,2,130653,130656,130658,3,5,0
37237,1,3,130654,130658,130661,4,7,0
37238,4,1,130658,130661,130662,3,4,0
37239,5,2,130663,130663,130665,0,2,1
37240,4,2,130667,130667,130669,0,2,2
37241,5,1,130672,130672,130673,0,1,3
37242,2,3,130674,130674,130677,0,3,1
37243,1,1,130675,130677,130678,2,3,0
37244,3,1,130678,130678,130679,0,1,0
37245,4,2,130682,130682,130684,0,2,3
37246,1,3,130683,130684,130687,1,4,0
37247,5,3,130688,130688,130691,0,3,1
37248,2,2,130690,130691,130693,1,3,0
37249,4,1,130694,130694,130695,0,1,1
37250,4,2,130698,130698,130700,0,2,3
37251,6,1,130704,130704,130705,0,1,4
37252,3,1,130707,130707,130708,0,1,2
37253,5,1,130712,130712,130713,0,1,4
37254,5,3,130717,130717,130720,0,3,4
37255,4,2,130721,130721,130723,0,2,1
37256,5,2,130726,130726,130728,0,2,3
37257,5,3,130731,130731,130734,0,3,3
37258,2,1,130733,130734,130735,1,2,0
37259,4,1,130737,130737,130738,0,1,2
37260,5,1,130742,130742,130743,0,1,4
37261,4,3,130746,130746,130749,0,3,3
37262,5,2,130751,130751,130753,0,2,2
37263,3,1,130754,130754,130755,0,1,1
37264,2,3,130756,130756,130759,0,3,1
37265,5,2,130761,130761,130763,0,2,2
37266,4,2,130765,130765,130767,0,2,2
37267,2,1,130767,130767,130768,0,1,0
37268,4,2,130771,130771,130773,0,2,3
37269,3,1,130774,130774,130775,0,1,1
37270,1,2,130775,130775,130777,0,2,0
37271,2,2,130777,130777,130779,0,2,0
37272,1,3,130778,130779,130782,1,4,0
37273,2,1,130780,130782,130783,2,3,0
37274,5,2,130785,130785,130787,0,2,2
37275,1,3,130786,130787,130790,1,4,0
37276,5,2,130791,130791,130793,0,2,1
37277,5,2,130796,130796,130798,0,2,3
37278,4,1,130800,130800,130801,0,1,2
37279,4,2,130804,130804,130806,0,2,3
37280,2,3,130806,130806,130809,0,3,0
37281,5,2,130811,130811,130813,0,2,2
37282,1,3,130812,130813,130816,1,4,0
37283,6,1,130818,130818,130819,0,1,2
37284,2,1,130820,130820,130821,0,1,1
37285,2,3,130822,130822,130825,0,3,1
37286,3,2,130825,130825,130827,0,2,0
37287,1,1,130826,130827,130828,1,2,0
37288,3,3,130829,130829,130832,0,3,1
37289,6,1,130835,130835,130836,0,1,3
37290,2,1,130837,130837,130838,0,1,1
37291,4,2,130841,130841,130843,0,2,3
37292,2,1,130843,130843,130844,0,1,0
37293,6,3,130849,130849,130852,0,3,5
37294,5,2,130854,130854,130856,0,2,2
37295,4,1,130858,130858,130859,0,1,2
37296,4,2,130862,130862,130864,0,2,3
37297,4,1,130866,130866,130867,0,1,2
37298,6,3,130872,130872,130875,0,3,5
37299,4,3,130876,130876,130879,0,3,1
37300,2,3,130878,130879,130882,1,4,0
37301,2,1,130880,130882,130883,2,3,0
37302,1,1,130881,130883,130884,2,3,0
37303,5,2,130886,130886,130888,0,2,2
37304,4,1,130890,130890,130891,0,1,2
37305,3,2,130893,130893,130895,0,2,2
37306,1,3,130894,130895,130898,1,4,0
37307,5,1,130899,130899,130900,0,1,1
37308,3,3,130902,130902,130905,0,3,2
37309,6,2,130908,130908,130910,0,2,3
37310,4,3,130912,130912,130915,0,3,2
37311,4,1,130916,130916,130917,0,1,1
37312,5,3,130921,130921,130924,0,3,4
37313,2,1,130923,130924,130925,1,2,0
37314,6,3,130929,130929,130932,0,3,4
37315,1,3,130930,130932,130935,2,5,0
37316,6,1,130936,130936,130937,0,1,1
37317,3,3,130939,130939,130942,0,3,2
37318,5,1,130944,130944,130945,0,1,2
37319,3,3,130947,130947,130950,0,3,2
37320,5,3,130952,130952,130955,0,3,2
37321,4,1,130956,130956,130957,0,1,1
37322,1,2,130957,130957,130959,0,2,0
37323,2,1,130959,130959,130960,0,1,0
37324,2,3,130961,130961,130964,0,3,1
37325,4,1,130965,130965,130966,0,1,1
37326,2,3,130967,130967,130970,0,3,1
37327,2,3,130969,130970,130973,1,4,0
37328,2,2,130971,130973,130975,2,4,0
37329,4,2,130975,130975,130977,0,2,0
37330,2,2,130977,130977,130979,0,2,0
37331,6,3,130983,130983,130986,0,3,4
37332,4,3,130987,130987,130990,0,3,1
37333,3,2,130990,130990,130992,0,2,0
37334,4,3,130994,130994,130997,0,3,2
37335,1,2,130995,130997,130999,2,4,0
37336,1,1,130996,130999,131000,3,4,0
37337,5,3,131001,131001,131004,0,3,1
37338,6,3,131007,131007,131010,0,3,3
37339,2,1,131009,131010,131011,1,2,0
37340,5,1,131014,131014,131015,0,1,3
37341,5,3,131019,131019,131022,0,3,4
37342,1,1,131020,131022,131023,2,3,0
37343,2,1,131022,131023,131024,1,2,0
37344,3,1,131025,131025,131026,0,1,1
37345,5,3,131030,131030,131033,0,3,4
37346,4,2,131034,131034,131036,0,2,1
37347,4,1,131038,131038,131039,0,1,2
37348,3,3,131041,131041,131044,0,3,2
37349,6,1,131047,131047,131048,0,1,3
37350,1,1,131048,131048,131049,0,1,0
37351,4,3,131052,131052,131055,0,3,3
37352,4,3,131056,131056,131059,0,3,1
37353,5,3,131061,131061,131064,0,3,2
37354,2,1,131063,131064,131065,1,2,0
37355,3,1,131066,131066,131067,0,1,1
37356,1,2,131067,131067,131069,0,2,0
37357,1,3,131068,131069,131072,1,4,0
37358,1,1,131069,131072,131073,3,4,0
37359,6,2,131075,131075,131077,0,2,2
37360,3,3,131078,131078,131081,0,3,1
37361,6,1,131084,131084,131085,0,1,3
37362,3,3,131087,131087,131090,0,3,2
37363,5,1,131092,131092,131093,0,1,2
37364,6,1,131098,131098,131099,0,1,5
37365,2,1,131100,131100,131101,0,1,1
37366,6,2,131106,131106,131108,0,2,5
37367,1,1,131107,131108,131109,1,2,0
37368,5,3,131112,131112,131115,0,3,3
37369,1,2,131113,131115,131117,2,4,0
37370,2,1,131115,131117,131118,2,3,0
37371,2,1,131117,131118,131119,1,2,0
37372,5,1,131122,131122,131123,0,1,3
37373,3,1,131125,131125,131126,0,1,2
37374,4,1,131129,131129,131130,0,1,3
37375,6,1,131135,131135,131136,0,1,5
37376,4,3,131139,131139,131142,0,3,3
37377,3,3,131142,131142,131145,0,3,0
37378,3,1,131145,131145,131146,0,1,0
37379,2,2,131147,131147,131149,0,2,1
37380,4,1,131151,131151,131152,0,1,2
37381,1,1,131152,131152,131153,0,1,0
37382,5,3,131157,131157,131160,0,3,4
37383,4,2,131161,131161,131163,0,2,1
37384,4,3,131165,131165,131168,0,3,2
37385,1,3,131166,131168,131171,2,5,0
37386,6,2,131172,131172,131174,0,2,1
37387,4,1,131176,131176,131177,0,1,2
37388,2,1,131178,131178,131179,0,1,1
37389,2,3,131180,131180,131183,0,3,1
37390,3,1,131183,131183,131184,0,1,0
37391,4,1,131187,131187,131188,0,1,3
37392,4,3,131191,131191,131194,0,3,3
37393,1,1,131192,131194,131195,2,3,0
37394,6,2,131198,131198,131200,0,2,3
37395,3,2,131201,131201,131203,0,2,1
37396,4,1,131205,131205,131206,0,1,2
37397,2,2,131207,131207,131209,0,2,1
37398,2,1,131209,131209,131210,0,1,0
37399,1,3,131210,131210,131213,0,3,0
37400,3,2,131213,131213,131215,0,2,0
37401,4,1,131217,131217,131218,0,1,2
37402,5,1,131222,131222,131223,0,1,4
37403,4,1,131226,131226,131227,0,1,3
37404,1,2,131227,131227,131229,0,2,0
37405,4,3,131231,131231,131234,0,3,2
37406,5,2,131236,131236,131238,0,2,2
37407,2,1,131238,131238,131239,0,1,0
37408,4,3,131242,131242,131245,0,3,3
37409,5,1,131247,131247,131248,0,1,2
37410,2,3,131249,131249,131252,0,3,1
37411,2,2,131251,131252,131254,1,3,0
37412,6,3,131257,131257,131260,0,3,3
37413,1,1,131258,131260,131261,2,3,0
37414,1,1,131259,131261,131262,2,3,0
37415,3,2,131262,131262,131264,0,2,0
37416,1,3,131263,131264,131267,1,4,0
37417,1,3,131264,131267,131270,3,6,0
37418,3,1,131267,131270,131271,3,4,0
37419,2,2,131269,131271,131273,2,4,0
37420,3,2,131272,131273,131275,1,3,0
37421,6,1,131278,131278,131279,0,1,3
37422,3,3,131281,131281,131284,0,3,2
37423,1,1,131282,131284,131285,2,3,0
37424,2,2,131284,131285,131287,1,3,0
37425,6,3,131290,131290,131293,0,3,3
37426,3,2,131293,131293,131295,0,2,0
37427,5,2,131298,131298,131300,0,2,3
37428,3,2,131301,131301,131303,0,2,1
37429,5,1,131306,131306,131307,0,1,3
37430,2,2,131308,131308,131310,0,2,1
37431,2,3,131310,131310,131313,0,3,0
37432,2,1,131312,131313,131314,1,2,0
37433,3,3,131315,131315,131318,0,3,1
37434,4,1,131319,131319,131320,0,1,1
37435,5,2,131324,131324,131326,0,2,4
37436,4,2,131328,131328,131330,0,2,2
37437,1,2,131329,131330,131332,1,3,0
37438,5,2,131334,131334,131336,0,2,2
37439,5,1,131339,131339,131340,0,1,3
37440,6,3,131345,131345,131348,0,3,5
37441,2,3,131347,131348,131351,1,4,0
37442,6,2,131353,131353,131355,0,2,2
37443,2,2,131355,131355,131357,0,2,0
37444,5,2,131360,131360,131362,0,2,3
37445,3,2,131363,131363,131365,0,2,1
37446,1,1,131364,131365,131366,1,2,0
37447,1,1,131365,131366,131367,1,2,0
37448,1,2,131366,131367,131369,1,3,0
37449,2,3,131368,131369,131372,1,4,0
37450,1,2,131369,131372,131374,3,5,0
37451,1,1,131370,131374,131375,4,5,0
37452,5,2,131375,131375,131377,0,2,0
37453,2,2,131377,131377,131379,0,2,0
37454,3,2,131380,131380,131382,0,2,1
37455,6,2,131386,131386,131388,0,2,4
37456,3,3,131389,131389,131392,0,3,1
37457,5,3,131394,131394,131397,0,3,2
37458,4,3,131398,131398,131401,0,3,1
37459,3,3,131401,131401,131404,0,3,0
37460,3,1,131404,131404,131405,0,1,0
37461,1,3,131405,131405,131408,0,3,0
37462,2,3,131407,131408,131411,1,4,0
37463,3,3,131410,131411,131414,1,4,0
37464,2,2,131412,131414,131416,2,4,0
37465,6,2,131418,131418,131420,0,2,2
37466,4,3,131422,131422,131425,0,3,2
37467,1,3,131423,131425,131428,2,5,0
37468,6,1,131429,131429,131430,0,1,1
37469,4,1,131433,131433,131434,0,1,3
37470,1,2,131434,131434,131436,0,2,0
37471,1,2,131435,131436,131438,1,3,0
37472,1,1,131436,131438,131439,2,3,0
37473,5,1,131441,131441,131442,0,1,2
37474,2,3,131443,131443,131446,0,3,1
37475,6,3,131449,131449,131452,0,3,3
37476,6,2,131455,131455,131457,0,2,3
37477,4,1,131459,131459,131460,0,1,2
37478,5,3,131464,131464,131467,0,3,4
37479,5,3,131469,131469,131472,0,3,2
37480,3,2,131472,131472,131474,0,2,0
37481,2,2,131474,131474,131476,0,2,0
37482,6,1,131480,131480,131481,0,1,4
37483,3,2,131483,131483,131485,0,2,2
37484,3,1,131486,131486,131487,0,1,1
37485,2,1,131488,131488,131489,0,1,1
37486,1,3,131489,131489,131492,0,3,0
37487,6,1,131495,131495,131496,0,1,3
37488,5,2,131500,131500,131502,0,2,4
37489,4,3,131504,131504,131507,0,3,2
37490,4,1,131508,131508,131509,0,1,1
37491,6,2,131514,131514,131516,0,2,5
37492,5,2,131519,131519,131521,0,2,3
37493,2,1,131521,131521,131522,0,1,0
37494,2,1,131523,131523,131524,0,1,1
37495,1,2,131524,131524,131526,0,2,0
37496,2,2,131526,131526,131528,0,2,0
37497,4,3,131530,131530,131533,0,3,2
37498,1,2,131531,131533,131535,2,4,0
37499,3,3,131534,131535,131538,1,4,0
37500,4,1,131538,131538,131539,0,1,0
37501,3,1,131541,131541,131542,0,1,2
37502,3,2,131544,131544,131546,0,2,2
37503,6,2,131550,131550,131552,0,2,4
37504,5,1,131555,131555,131556,0,1,3
37505,6,3,131561,131561,131564,0,3,5
37506,4,1,131565,131565,131566,0,1,1
37507,6,3,131571,131571,131574,0,3,5
37508,2,1,131573,131574,131575,1,2,0
37509,2,3,131575,131575,131578,0,3,0
37510,3,3,131578,131578,131581,0,3,0
37511,5,2,131583,131583,131585,0,2,2
37512,2,2,131585,131585,131587,0,2,0
37513,6,1,131591,131591,131592,0,1,4
37514,3,2,131594,131594,131596,0,2,2
37515,1,2,131595,131596,131598,1,3,0
37516,6,2,131601,131601,131603,0,2,3
37517,4,1,131605,131605,131606,0,1,2
37518,5,3,131610,131610,131613,0,3,4
37519,3,3,131613,131613,131616,0,3,0
37520,2,1,131615,131616,131617,1,2,0
37521,2,1,131617,131617,131618,0,1,0
37522,2,1,131619,131619,131620,0,1,1
37523,6,3,131625,131625,131628,0,3,5
37524,3,2,131628,131628,131630,0,2,0
37525,1,3,131629,131630,131633,1,4,0
37526,5,1,131634,131634,131635,0,1,1
37527,1,2,131635,131635,131637,0,2,0
37528,6,1,131641,131641,131642,0,1,4
37529,4,1,131645,131645,131646,0,1,3
37530,3,1,131648,131648,131649,0,1,2
37531,4,1,131652,131652,131653,0,1,3
37532,3,2,131655,131655,131657,0,2,2
37533,5,1,131660,131660,131661,0,1,3
37534,1,2,131661,131661,131663,0,2,0
37535,1,1,131662,131663,131664,1,2,0
37536,1,1,131663,131664,131665,1,2,0
37537,4,3,131667,131667,131670,0,3,2
37538,1,3,131668,131670,131673,2,5,0
37539,1,2,131669,131673,131675,4,6,0
37540,2,2,131671,131675,131677,4,6,0
37541,6,3,131677,131677,131680,0,3,0
37542,2,2,131679,131680,131682,1,3,0
37543,3,1,131682,131682,131683,0,1,0
37544,1,2,131683,131683,131685,0,2,0
37545,6,2,131689,131689,131691,0,2,4
37546,1,2,131690,131691,131693,1,3,0
37547,1,2,131691,131693,131695,2,4,0
37548,2,2,131693,131695,131697,2,4,0
37549,5,2,131698,131698,131700,0,2,1
37550,4,3,131702,131702,131705,0,3,2
37551,6,2,131708,131708,131710,0,2,3
37552,1,2,131709,131710,131712,1,3,0
37553,1,1,131710,131712,131713,2,3,0
37554,1,1,131711,131713,131714,2,3,0
37555,3,2,131714,131714,131716,0,2,0
37556,3,3,131717,131717,131720,0,3,1
37557,3,1,131720,131720,131721,0,1,0
37558,6,3,131726,131726,131729,0,3,5
37559,5,3,131731,131731,131734,0,3,2
37560,6,2,131737,131737,131739,0,2,3
37561,5,3,131742,131742,131745,0,3,3
37562,3,3,131745,131745,131748,0,3,0
37563,4,2,131749,131749,131751,0,2,1
37564,3,2,131752,131752,131754,0,2,1
37565,2,2,131754,131754,131756,0,2,0
37566,3,2,131757,131757,131759,0,2,1
37567,6,3,131763,131763,131766,0,3,4
37568,4,1,131767,131767,131768,0,1,1
37569,2,3,131769,131769,131772,0,3,1
37570,4,3,131773,131773,131776,0,3,1
37571,6,1,131779,131779,131780,0,1,3
37572,1,3,131780,131780,131783,0,3,0
37573,4,1,131784,131784,131785,0,1,1
37574,2,1,131786,131786,131787,0,1,1
37575,4,2,131790,131790,131792,0,2,3
37576,4,3,131794,131794,131797,0,3,2
37577,4,1,131798,131798,131799,0,1,1
37578,1,2,131799,131799,131801,0,2,0
37579,4,1,131803,131803,131804,0,1,2
37580,3,1,131806,131806,131807,0,1,2
37581,1,2,131807,131807,131809,0,2,0
37582,4,3,131811,131811,131814,0,3,2
37583,1,1,131812,131814,131815,2,3,0
37584,1,1,131813,131815,131816,2,3,0
37585,4,1,131817,131817,131818,0,1,1
37586,2,1,131819,131819,131820,0,1,1
37587,1,1,131820,131820,131821,0,1,0
37588,4,3,131824,131824,131827,0,3,3
37589,3,3,131827,131827,131830,0,3,0
37590,6,1,131833,131833,131834,0,1,3
37591,2,3,131835,131835,131838,0,3,1
37592,1,1,131836,131838,131839,2,3,0
37593,3,1,131839,131839,131840,0,1,0
37594,6,3,131845,131845,131848,0,3,5
37595,2,3,131847,131848,131851,1,4,0
37596,6,3,131853,131853,131856,0,3,2
37597,3,1,131856,131856,131857,0,1,0
37598,5,1,131861,131861,131862,0,1,4
37599,2,3,131863,131863,131866,0,3,1
37600,5,2,131868,131868,131870,0,2,2
37601,1,1,131869,131870,131871,1,2,0
37602,3,2,131872,131872,131874,0,2,1
37603,4,1,131876,131876,131877,0,1,2
37604,1,2,131877,131877,131879,0,2,0
37605,5,2,131882,131882,131884,0,2,3
37606,5,1,131887,131887,131888,0,1,3
37607,3,2,131890,131890,131892,0,2,2
37608,4,2,131894,131894,131896,0,2,2
37609,3,3,131897,131897,131900,0,3,1
37610,5,2,131902,131902,131904,0,2,2
37611,6,2,131908,131908,131910,0,2,4
37612,6,1,131914,131914,131915,0,1,4
37613,3,3,131917,131917,131920,0,3,2
37614,4,3,131921,131921,131924,0,3,1
37615,4,1,131925,131925,131926,0,1,1
37616,4,1,131929,131929,131930,0,1,3
37617,4,3,131933,131933,131936,0,3,3
37618,1,1,131934,131936,131937,2,3,0
37619,4,3,131938,131938,131941,0,3,1
37620,4,2,131942,131942,131944,0,2,1
37621,3,2,131945,131945,131947,0,2,1
37622,2,3,131947,131947,131950,0,3,0
37623,1,1,131948,131950,131951,2,3,0
37624,3,3,131951,131951,131954,0,3,0
37625,6,1,131957,131957,131958,0,1,3
37626,2,3,131959,131959,131962,0,3,1
37627,5,1,131964,131964,131965,0,1,2
37628,6,3,131970,131970,131973,0,3,5
37629,6,3,131976,131976,131979,0,3,3
37630,4,1,131980,131980,131981,0,1,1
37631,2,1,131982,131982,131983,0,1,1
37632,1,3,131983,131983,131986,0,3,0
37633,6,3,131989,131989,131992,0,3,3
37634,2,3,131991,131992,131995,1,4,0
37635,6,3,131997,131997,132000,0,3,2
37636,5,3,132002,132002,132005,0,3,2
37637,5,2,132007,132007,132009,0,2,2
37638,6,3,132013,132013,132016,0,3,4
37639,6,1,132019,132019,132020,0,1,3
37640,2,1,132021,132021,132022,0,1,1
37641,3,2,132024,132024,132026,0,2,2
37642,6,3,132030,132030,132033,0,3,4
37643,4,2,132034,132034,132036,0,2,1
37644,6,1,132040,132040,132041,0,1,4
37645,5,2,132045,132045,132047,0,2,4
37646,2,1,132047,132047,132048,0,1,0
37647,3,3,132050,132050,132053,0,3,2
37648,6,2,132056,132056,132058,0,2,3
37649,5,2,132061,132061,132063,0,2,3
37650,6,2,132067,132067,132069,0,2,4
37651,4,2,132071,132071,132073,0,2,2
37652,2,1,132073,132073,132074,0,1,0
37653,5,1,132078,132078,132079,0,1,4
37654,5,2,132083,132083,132085,0,2,4
37655,4,1,132087,132087,132088,0,1,2
37656,2,3,132089,132089,132092,0,3,1
37657,5,3,132094,132094,132097,0,3,2
37658,6,1,132100,132100,132101,0,1,3
37659,2,3,132102,132102,132105,0,3,1
37660,4,2,132106,132106,132108,0,2,1
37661,1,1,132107,132108,132109,1,2,0
37662,3,3,132110,132110,132113,0,3,1
37663,2,1,132112,132113,132114,1,2,0
37664,1,2,132113,132114,132116,1,3,0
37665,6,2,132119,132119,132121,0,2,3
37666,3,1,132122,132122,132123,0,1,1
37667,2,3,132124,132124,132127,0,3,1
37668,6,3,132130,132130,132133,0,3,3
37669,6,1,132136,132136,132137,0,1,3
37670,3,3,132139,132139,132142,0,3,2
37671,4,3,132143,132143,132146,0,3,1
37672,4,3,132147,132147,132150,0,3,1
37673,5,2,132152,132152,132154,0,2,2
37674,3,3,132155,132155,132158,0,3,1
37675,6,1,132161,132161,132162,0,1,3
37676,4,3,132165,132165,132168,0,3,3
37677,3,3,132168,132168,132171,0,3,0
37678,3,1,132171,132171,132172,0,1,0
37679,6,2,132177,132177,132179,0,2,5
37680,3,3,132180,132180,132183,0,3,1
37681,4,3,132184,132184,132187,0,3,1
37682,3,3,132187,132187,132190,0,3,0
37683,2,3,132189,132190,132193,1,4,0
37684,1,3,132190,132193,132196,3,6,0
37685,5,2,132195,132196,132198,1,3,0
37686,4,1,132199,132199,132200,0,1,1
37687,4,1,132203,132203,132204,0,1,3
37688,3,3,132206,132206,132209,0,3,2
37689,4,2,132210,132210,132212,0,2,1
37690,3,3,132213,132213,132216,0,3,1
37691,6,2,132219,132219,132221,0,2,3
37692,5,1,132224,132224,132225,0,1,3
37693,6,1,132230,132230,132231,0,1,5
37694,4,1,132234,132234,132235,0,1,3
37695,1,1,132235,132235,132236,0,1,0
37696,4,2,132239,132239,132241,0,2,3
37697,3,2,132242,132242,132244,0,2,1
37698,4,2,132246,132246,132248,0,2,2
37699,6,1,132252,132252,132253,0,1,4
37700,1,3,132253,132253,132256,0,3,0
37701,2,2,132255,132256,132258,1,3,0
37702,4,3,132259,132259,132262,0,3,1
37703,4,1,132263,132263,132264,0,1,1
37704,1,2,132264,132264,132266,0,2,0
37705,2,1,132266,132266,132267,0,1,0
37706,2,1,132268,132268,132269,0,1,1
37707,3,1,132271,132271,132272,0,1,2
37708,1,1,132272,132272,132273,0,1,0
37709,2,1,132274,132274,132275,0,1,1
37710,5,3,132279,132279,132282,0,3,4
37711,5,1,132284,132284,132285,0,1,2
37712,2,2,132286,132286,132288,0,2,1
37713,5,1,132291,132291,132292,0,1,3
37714,5,2,132296,132296,132298,0,2,4
37715,5,2,132301,132301,132303,0,2,3
37716,3,2,132304,132304,132306,0,2,1
37717,2,3,132306,132306,132309,0,3,0
37718,4,3,132310,132310,132313,0,3,1
37719,5,1,132315,132315,132316,0,1,2
37720,6,1,132321,132321,132322,0,1,5
37721,6,1,132327,132327,132328,0,1,5
37722,2,2,132329,132329,132331,0,2,1
37723,2,2,132331,132331,132333,0,2,0
37724,4,3,132335,132335,132338,0,3,2
37725,6,3,132341,132341,132344,0,3,3
37726,3,3,132344,132344,132347,0,3,0
37727,4,2,132348,132348,132350,0,2,1
37728,6,1,132354,132354,132355,0,1,4
37729,3,3,132357,132357,132360,0,3,2
37730,4,1,132361,132361,132362,0,1,1
37731,2,3,132363,132363,132366,0,3,1
37732,4,1,132367,132367,132368,0,1,1
37733,4,1,132371,132371,132372,0,1,3
37734,6,2,132377,132377,132379,0,2,5
37735,4,2,132381,132381,132383,0,2,2
37736,4,3,132385,132385,132388,0,3,2
37737,1,1,132386,132388,132389,2,3,0
37738,4,2,132390,132390,132392,0,2,1
37739,1,3,132391,132392,132395,1,4,0
37740,2,3,132393,132395,132398,2,5,0
37741,4,3,132397,132398,132401,1,4,0
37742,2,3,132399,132401,132404,2,5,0
37743,3,3,132402,132404,132407,2,5,0
37744,4,2,132406,132407,132409,1,3,0
37745,1,1,132407,132409,132410,2,3,0
37746,3,1,132410,132410,132411,0,1,0
37747,1,2,132411,132411,132413,0,2,0
37748,1,3,132412,132413,132416,1,4,0
37749,4,2,132416,132416,132418,0,2,0
37750,2,2,132418,132418,132420,0,2,0
37751,4,1,132422,132422,132423,0,1,2
37752,5,2,132427,132427,132429,0,2,4
37753,6,2,132433,132433,132435,0,2,4
37754,4,2,132437,132437,132439,0,2,2
37755,6,2,132443,132443,132445,0,2,4
37756,2,2,132445,132445,132447,0,2,0
37757,2,3,132447,132447,132450,0,3,0
37758,4,1,132451,132451,132452,0,1,1
37759,6,3,132457,132457,132460,0,3,5
37760,3,2,132460,132460,132462,0,2,0
37761,4,2,132464,132464,132466,0,2,2
37762,4,1,132468,132468,132469,0,1,2
37763,4,1,132472,132472,132473,0,1,3
37764,6,3,132478,132478,132481,0,3,5
37765,3,1,132481,132481,132482,0,1,0
37766,4,3,132485,132485,132488,0,3,3
37767,4,1,132489,132489,132490,0,1,1
37768,2,1,132491,132491,132492,0,1,1
37769,1,2,132492,132492,132494,0,2,0
37770,4,1,132496,132496,132497,0,1,2
37771,3,1,132499,132499,132500,0,1,2
37772,2,1,132501,132501,132502,0,1,1
37773,4,2,132505,132505,132507,0,2,3
37774,6,1,132511,132511,132512,0,1,4
37775,4,3,132515,132515,132518,0,3,3
37776,2,3,132517,132518,132521,1,4,0
37777,4,2,132521,132521,132523,0,2,0
37778,2,3,132523,132523,132526,0,3,0
37779,3,1,132526,132526,132527,0,1,0
37780,2,2,132528,132528,132530,0,2,1
37781,5,2,132533,132533,132535,0,2,3
37782,2,1,132535,132535,132536,0,1,0
37783,1,3,132536,132536,132539,0,3,0
37784,4,3,132540,132540,132543,0,3,1
37785,1,2,132541,132543,132545,2,4,0
37786,6,1,132547,132547,132548,0,1,2
37787,3,2,132550,132550,132552,0,2,2
37788,1,1,132551,132552,132553,1,2,0
37789,4,1,132555,132555,132556,0,1,2
37790,4,2,132559,132559,132561,0,2,3
37791,2,3,132561,132561,132564,0,3,0
37792,5,3,132566,132566,132569,0,3,2
37793,6,3,132572,132572,132575,0,3,3
37794,6,3,132578,132578,132581,0,3,3
37795,6,2,132584,132584,132586,0,2,3
37796,5,1,132589,132589,132590,0,1,3
37797,1,2,132590,132590,132592,0,2,0
37798,4,1,132594,132594,132595,0,1,2
37799,5,3,132599,132599,132602,0,3,4
37800,6,3,132605,132605,132608,0,3,3
37801,4,1,132609,132609,132610,0,1,1
37802,4,1,132613,132613,132614,0,1,3
37803,6,3,132619,132619,132622,0,3,5
37804,4,2,132623,132623,132625,0,2,1
37805,1,2,132624,132625,132627,1,3,0
37806,1,2,132625,132627,132629,2,4,0
37807,2,3,132627,132629,132632,2,5,0
37808,1,2,132628,132632,132634,4,6,0
37809,5,3,132633,132634,132637,1,4,0
37810,5,3,132638,132638,132641,0,3,1
37811,2,3,132640,132641,132644,1,4,0
37812,2,3,132642,132644,132647,2,5,0
37813,5,2,132647,132647,132649,0,2,0
37814,6,1,132653,132653,132654,0,1,4
37815,5,2,132658,132658,132660,0,2,4
37816,5,1,132663,132663,132664,0,1,3
37817,6,3,132669,132669,132672,0,3,5
37818,5,1,132674,132674,132675,0,1,2
37819,6,1,132680,132680,132681,0,1,5
37820,6,2,132686,132686,132688,0,2,5
37821,5,1,132691,132691,132692,0,1,3
37822,3,3,132694,132694,132697,0,3,2
37823,5,2,132699,132699,132701,0,2,2
37824,4,3,132703,132703,132706,0,3,2
37825,4,2,132707,132707,132709,0,2,1
37826,5,3,132712,132712,132715,0,3,3
37827,1,1,132713,132715,132716,2,3,0
37828,3,3,132716,132716,132719,0,3,0
37829,6,1,132722,132722,132723,0,1,3
37830,1,3,132723,132723,132726,0,3,0
37831,3,2,132726,132726,132728,0,2,0
37832,3,2,132729,132729,132731,0,2,1
37833,5,1,132734,132734,132735,0,1,3
37834,1,1,132735,132735,132736,0,1,0
37835,4,1,132739,132739,132740,0,1,3
37836,4,3,132743,132743,132746,0,3,3
37837,5,3,132748,132748,132751,0,3,2
37838,1,1,132749,132751,132752,2,3,0
37839,1,3,132750,132752,132755,2,5,0
37840,4,1,132754,132755,132756,1,2,0
37841,1,2,132755,132756,132758,1,3,0
37842,2,3,132757,132758,132761,1,4,0
37843,4,2,132761,132761,132763,0,2,0
37844,4,2,132765,132765,132767,0,2,2
37845,6,2,132771,132771,132773,0,2,4
37846,1,1,132772,132773,132774,1,2,0
37847,6,2,132778,132778,132780,0,2,4
37848,5,3,132783,132783,132786,0,3,3
37849,4,1,132787,132787,132788,0,1,1
37850,1,2,132788,132788,132790,0,2,0
37851,1,2,132789,132790,132792,1,3,0
37852,1,2,132790,132792,132794,2,4,0
37853,1,2,132791,132794,132796,3,5,0
37854,6,2,132797,132797,132799,0,2,1
37855,1,3,132798,132799,132802,1,4,0
37856,4,2,132802,132802,132804,0,2,0
37857,4,1,132806,132806,132807,0,1,2
37858,5,1,132811,132811,132812,0,1,4
37859,5,2,132816,132816,132818,0,2,4
37860,4,2,132820,132820,132822,0,2,2
37861,1,1,132821,132822,132823,1,2,0
37862,1,1,132822,132823,132824,1,2,0
37863,5,3,132827,132827,132830,0,3,3
37864,6,1,132833,132833,132834,0,1,3
37865,1,3,132834,132834,132837,0,3,0
37866,4,3,132838,132838,132841,0,3,1
37867,3,1,132841,132841,132842,0,1,0
37868,4,2,132845,132845,132847,0,2,3
37869,2,3,132847,132847,132850,0,3,0
37870,5,2,132852,132852,132854,0,2,2
37871,2,3,132854,132854,132857,0,3,0
37872,1,1,132855,132857,132858,2,3,0
37873,1,2,132856,132858,132860,2,4,0
37874,5,1,132861,132861,132862,0,1,1
37875,3,3,132864,132864,132867,0,3,2
37876,5,1,132869,132869,132870,0,1,2
37877,3,1,132872,132872,132873,0,1,2
37878,1,2,132873,132873,132875,0,2,0
37879,5,3,132878,132878,132881,0,3,3
37880,4,1,132882,132882,132883,0,1,1
37881,1,1,132883,132883,132884,0,1,0
37882,6,3,132889,132889,132892,0,3,5
37883,3,1,132892,132892,132893,0,1,0
37884,2,1,132894,132894,132895,0,1,1
37885,1,1,132895,132895,132896,0,1,0
37886,4,2,132899,132899,132901,0,2,3
37887,3,3,132902,132902,132905,0,3,1
37888,5,1,132907,132907,132908,0,1,2
37889,2,3,132909,132909,132912,0,3,1
37890,5,2,132914,132914,132916,0,2,2
37891,6,2,132920,132920,132922,0,2,4
37892,4,3,132924,132924,132927,0,3,2
37893,5,2,132929,132929,132931,0,2,2
37894,5,2,132934,132934,132936,0,2,3
37895,5,3,132939,132939,132942,0,3,3
37896,1,1,132940,132942,132943,2,3,0
37897,4,3,132944,132944,132947,0,3,1
37898,6,1,132950,132950,132951,0,1,3
37899,6,1,132956,132956,132957,0,1,5
37900,1,1,132957,132957,132958,0,1,0
37901,6,3,132963,132963,132966,0,3,5
37902,4,3,132967,132967,132970,0,3,1
37903,6,2,132973,132973,132975,0,2,3
37904,1,1,132974,132975,132976,1,2,0
37905,6,2,132980,132980,132982,0,2,4
37906,3,3,132983,132983,132986,0,3,1
37907,2,2,132985,132986,132988,1,3,0
37908,4,1,132989,132989,132990,0,1,1
37909,6,3,132995,132995,132998,0,3,5
37910,1,2,132996,132998,133000,2,4,0
37911,3,1,132999,133000,133001,1,2,0
37912,1,2,133000,133001,133003,1,3,0
37913,1,2,133001,133003,133005,2,4,0
37914,4,2,133005,133005,133007,0,2,0
37915,2,1,133007,133007,133008,0,1,0
37916,4,1,133011,133011,133012,0,1,3
37917,5,1,133016,133016,133017,0,1,4
37918,6,3,133022,133022,133025,0,3,5
37919,4,2,133026,133026,133028,0,2,1
37920,1,2,133027,133028,133030,1,3,0
37921,2,1,133029,133030,133031,1,2,0
37922,2,1,133031,133031,133032,0,1,0
37923,6,1,133037,133037,133038,0,1,5
37924,3,3,133040,133040,133043,0,3,2
37925,4,1,133044,133044,133045,0,1,1
37926,5,2,133049,133049,133051,0,2,4
37927,4,1,133053,133053,133054,0,1,2
37928,1,1,133054,133054,133055,0,1,0
37929,1,1,133055,133055,133056,0,1,0
37930,5,1,133060,133060,133061,0,1,4
37931,1,3,133061,133061,133064,0,3,0
37932,3,3,133064,133064,133067,0,3,0
37933,2,2,133066,133067,133069,1,3,0
37934,1,3,133067,133069,133072,2,5,0
37935,6,2,133073,133073,133075,0,2,1
37936,3,1,133076,133076,133077,0,1,1
37937,4,2,133080,133080,133082,0,2,3
37938,3,1,133083,133083,133084,0,1,1
37939,6,1,133089,133089,133090,0,1,5
37940,4,1,133093,133093,133094,0,1,3
37941,6,2,133099,133099,133101,0,2,5
37942,5,3,133104,133104,133107,0,3,3
37943,5,3,133109,133109,133112,0,3,2
37944,4,1,133113,133113,133114,0,1,1
37945,4,3,133117,133117,133120,0,3,3
37946,1,2,133118,133120,133122,2,4,0
37947,6,3,133124,133124,133127,0,3,2
37948,5,3,133129,133129,133132,0,3,2
37949,4,1,133133,133133,133134,0,1,1
37950,3,3,133136,133136,133139,0,3,2
37951,4,2,133140,133140,133142,0,2,1
37952,6,2,133146,133146,133148,0,2,4
37953,3,1,133149,133149,133150,0,1,1
37954,4,1,133153,133153,133154,0,1,3
37955,2,1,133155,133155,133156,0,1,1
37956,3,1,133158,133158,133159,0,1,2
37957,4,2,133162,133162,133164,0,2,3
37958,1,3,133163,133164,133167,1,4,0
37959,2,3,133165,133167,133170,2,5,0
37960,4,1,133169,133170,133171,1,2,0
37961,5,2,133174,133174,133176,0,2,3
37962,3,3,133177,133177,133180,0,3,1
37963,3,3,133180,133180,133183,0,3,0
37964,6,1,133186,133186,133187,0,1,3
37965,4,3,133190,133190,133193,0,3,3
37966,6,2,133196,133196,133198,0,2,3
37967,1,3,133197,133198,133201,1,4,0
37968,5,2,133202,133202,133204,0,2,1
37969,1,1,133203,133204,133205,1,2,0
37970,3,3,133206,133206,133209,0,3,1
37971,6,3,133212,133212,133215,0,3,3
37972,1,1,133213,133215,133216,2,3,0
37973,5,3,133218,133218,133221,0,3,2
37974,3,2,133221,133221,133223,0,2,0
37975,5,1,133226,133226,133227,0,1,3
37976,5,3,133231,133231,133234,0,3,4
37977,2,2,133233,133234,133236,1,3,0
37978,6,1,133239,133239,133240,0,1,3
37979,2,1,133241,133241,133242,0,1,1
37980,5,3,133246,133246,133249,0,3,4
37981,5,2,133251,133251,133253,0,2,2
37982,4,1,133255,133255,133256,0,1,2
37983,1,1,133256,133256,133257,0,1,0
37984,6,1,133262,133262,133263,0,1,5
37985,5,1,133267,133267,133268,0,1,4
37986,1,2,133268,133268,133270,0,2,0
37987,3,2,133271,133271,133273,0,2,1
37988,4,1,133275,133275,133276,0,1,2
37989,3,3,133278,133278,133281,0,3,2
37990,4,1,133282,133282,133283,0,1,1
37991,4,3,133286,133286,133289,0,3,3
37992,4,3,133290,133290,133293,0,3,1
37993,6,3,133296,133296,133299,0,3,3
37994,5,1,133301,133301,133302,0,1,2
37995,4,1,133305,133305,133306,0,1,3
37996,6,2,133311,133311,133313,0,2,5
37997,4,1,133315,133315,133316,0,1,2
37998,5,2,133320,133320,133322,0,2,4
37999,4,1,133324,133324,133325,0,1,2
38000,5,2,133329,133329,133331,0,2,4
38001,2,3,133331,133331,133334,0,3,0
38002,5,3,133336,133336,133339,0,3,2
38003,4,1,133340,133340,133341,0,1,1
38004,4,3,133344,133344,133347,0,3,3
38005,5,3,133349,133349,133352,0,3,2
38006,6,3,133355,133355,133358,0,3,3
38007,3,2,133358,133358,133360,0,2,0
38008,5,2,133363,133363,133365,0,2,3
38009,1,1,133364,133365,133366,1,2,0
38010,4,2,133368,133368,133370,0,2,2
38011,5,3,133373,133373,133376,0,3,3
38012,3,1,133376,133376,133377,0,1,0
38013,6,2,133382,133382,133384,0,2,5
38014,3,2,133385,133385,133387,0,2,1
38015,2,2,133387,133387,133389,0,2,0
38016,2,1,133389,133389,133390,0,1,0
38017,2,3,133391,133391,133394,0,3,1
38018,2,2,133393,133394,133396,1,3,0
38019,1,1,133394,133396,133397,2,3,0
38020,1,3,133395,133397,133400,2,5,0
38021,6,3,133401,133401,133404,0,3,1
38022,4,3,133405,133405,133408,0,3,1
38023,1,3,133406,133408,133411,2,5,0
38024,5,2,133411,133411,133413,0,2,0
38025,4,1,133415,133415,133416,0,1,2
38026,2,3,133417,133417,133420,0,3,1
38027,5,2,133422,133422,133424,0,2,2
38028,3,1,133425,133425,133426,0,1,1
38029,4,2,133429,133429,133431,0,2,3
38030,6,3,133435,133435,133438,0,3,4
38031,2,2,133437,133438,133440,1,3,0
38032,5,3,133442,133442,133445,0,3,2
38033,6,3,133448,133448,133451,0,3,3
38034,3,3,133451,133451,133454,0,3,0
38035,6,1,133457,133457,133458,0,1,3
38036,6,1,133463,133463,133464,0,1,5
38037,3,2,133466,133466,133468,0,2,2
38038,6,2,133472,133472,133474,0,2,4
38039,3,3,133475,133475,133478,0,3,1
38040,5,3,133480,133480,133483,0,3,2
38041,2,1,133482,133483,133484,1,2,0
38042,3,1,133485,133485,133486,0,1,1
38043,1,3,133486,133486,133489,0,3,0
38044,1,1,133487,133489,133490,2,3,0
38045,2,2,133489,133490,133492,1,3,0
38046,6,1,133495,133495,133496,0,1,3
38047,5,1,133500,133500,133501,0,1,4
38048,6,1,133506,133506,133507,0,1,5
38049,4,2,133510,133510,133512,0,2,3
38050,2,1,133512,133512,133513,0,1,0
38051,4,3,133516,133516,133519,0,3,3
38052,4,2,133520,133520,133522,0,2,1
38053,6,2,133526,133526,133528,0,2,4
38054,6,3,133532,133532,133535,0,3,4
38055,2,2,133534,133535,133537,1,3,0
38056,6,3,133540,133540,133543,0,3,3
38057,4,1,133544,133544,133545,0,1,1
38058,2,1,133546,133546,133547,0,1,1
38059,6,1,133552,133552,133553,0,1,5
38060,3,3,133555,133555,133558,0,3,2
38061,2,2,133557,133558,133560,1,3,0
38062,5,2,133562,133562,133564,0,2,2
38063,6,2,133568,133568,133570,0,2,4
38064,4,3,133572,133572,133575,0,3,2
38065,3,2,133575,133575,133577,0,2,0
38066,4,3,133579,133579,133582,0,3,2
38067,1,2,133580,133582,133584,2,4,0
38068,4,1,133584,133584,133585,0,1,0
38069,6,1,133590,133590,133591,0,1,5
38070,5,2,133595,133595,133597,0,2,4
38071,5,3,133600,133600,133603,0,3,3
38072,1,3,133601,133603,133606,2,5,0
38073,5,1,133606,133606,133607,0,1,0
38074,6,3,133612,133612,133615,0,3,5
38075,2,1,133614,133615,133616,1,2,0
38076,2,2,133616,133616,133618,0,2,0
38077,1,3,133617,133618,133621,1,4,0
38078,2,1,133619,133621,133622,2,3,0
38079,3,3,133622,133622,133625,0,3,0
38080,1,1,133623,133625,133626,2,3,0
38081,6,2,133629,133629,133631,0,2,3
38082,6,3,133635,133635,133638,0,3,4
38083,6,1,133641,133641,133642,0,1,3
38084,3,3,133644,133644,133647,0,3,2
38085,1,3,133645,133647,133650,2,5,0
38086,2,2,133647,133650,133652,3,5,0
38087,5,3,133652,133652,133655,0,3,0
38088,3,2,133655,133655,133657,0,2,0
38089,3,1,133658,133658,133659,0,1,1
38090,3,1,133661,133661,133662,0,1,2
38091,2,3,133663,133663,133666,0,3,1
38092,4,3,133667,133667,133670,0,3,1
38093,4,2,133671,133671,133673,0,2,1
38094,2,3,133673,133673,133676,0,3,0
38095,2,2,133675,133676,133678,1,3,0
38096,4,2,133679,133679,133681,0,2,1
38097,3,1,133682,133682,133683,0,1,1
38098,3,1,133685,133685,133686,0,1,2
38099,3,2,133688,133688,133690,0,2,2
38100,5,2,133693,133693,133695,0,2,3
38101,5,2,133698,133698,133700,0,2,3
38102,1,3,133699,133700,133703,1,4,0
38103,3,1,133702,133703,133704,1,2,0
38104,3,1,133705,133705,133706,0,1,1
38105,4,1,133709,133709,133710,0,1,3
38106,3,3,133712,133712,133715,0,3,2
38107,3,1,133715,133715,133716,0,1,0
38108,2,2,133717,133717,133719,0,2,1
38109,2,3,133719,133719,133722,0,3,0
38110,1,1,133720,133722,133723,2,3,0
38111,4,3,133724,133724,133727,0,3,1
38112,4,3,133728,133728,133731,0,3,1
38113,2,1,133730,133731,133732,1,2,0
38114,5,3,133735,133735,133738,0,3,3
38115,3,1,133738,133738,133739,0,1,0
38116,4,2,133742,133742,133744,0,2,3
38117,6,3,133748,133748,133751,0,3,4
38118,1,3,133749,133751,133754,2,5,0
38119,6,3,133755,133755,133758,0,3,1
38120,6,2,133761,133761,133763,0,2,3
38121,5,3,133766,133766,133769,0,3,3
38122,5,3,133771,133771,133774,0,3,2
38123,4,1,133775,133775,133776,0,1,1
38124,1,2,133776,133776,133778,0,2,0
38125,2,3,133778,133778,133781,0,3,0
38126,6,2,133784,133784,133786,0,2,3
38127,5,1,133789,133789,133790,0,1,3
38128,2,3,133791,133791,133794,0,3,1
38129,4,3,133795,133795,133798,0,3,1
38130,4,1,133799,133799,133800,0,1,1
38131,3,2,133802,133802,133804,0,2,2
38132,2,1,133804,133804,133805,0,1,0
38133,3,2,133807,133807,133809,0,2,2
38134,6,2,133813,133813,133815,0,2,4
38135,4,3,133817,133817,133820,0,3,2
38136,2,3,133819,133820,133823,1,4,0
38137,2,2,133821,133823,133825,2,4,0
38138,3,2,133824,133825,133827,1,3,0
38139,6,2,133830,133830,133832,0,2,3
38140,3,3,133833,133833,133836,0,3,1
38141,1,2,133834,133836,133838,2,4,0
38142,1,1,133835,133838,133839,3,4,0
38143,2,3,133837,133839,133842,2,5,0
38144,3,2,133840,133842,133844,2,4,0
38145,3,2,133843,133844,133846,1,3,0
38146,2,3,133845,133846,133849,1,4,0
38147,3,3,133848,133849,133852,1,4,0
38148,5,2,133853,133853,133855,0,2,1
38149,5,2,133858,133858,133860,0,2,3
38150,1,1,133859,133860,133861,1,2,0
38151,5,3,133864,133864,133867,0,3,3
38152,3,1,133867,133867,133868,0,1,0
38153,4,1,133871,133871,133872,0,1,3
38154,2,3,133873,133873,133876,0,3,1
38155,1,1,133874,133876,133877,2,3,0
38156,4,2,133878,133878,133880,0,2,1
38157,3,3,133881,133881,133884,0,3,1
38158,6,3,133887,133887,133890,0,3,3
38159,3,2,133890,133890,133892,0,2,0
38160,3,2,133893,133893,133895,0,2,1
38161,6,2,133899,133899,133901,0,2,4
38162,3,2,133902,133902,133904,0,2,1
38163,4,2,133906,133906,133908,0,2,2
38164,5,2,133911,133911,133913,0,2,3
38165,3,3,133914,133914,133917,0,3,1
38166,5,2,133919,133919,133921,0,2,2
38167,3,2,133922,133922,133924,0,2,1
38168,5,2,133927,133927,133929,0,2,3
38169,2,1,133929,133929,133930,0,1,0
38170,4,1,133933,133933,133934,0,1,3
38171,2,2,133935,133935,133937,0,2,1
38172,4,3,133939,133939,133942,0,3,2
38173,3,3,133942,133942,133945,0,3,0
38174,4,3,133946,133946,133949,0,3,1
38175,3,3,133949,133949,133952,0,3,0
38176,5,3,133954,133954,133957,0,3,2
38177,6,2,133960,133960,133962,0,2,3
38178,4,1,133964,133964,133965,0,1,2
38179,2,2,133966,133966,133968,0,2,1
38180,2,1,133968,133968,133969,0,1,0
38181,1,3,133969,133969,133972,0,3,0
38182,3,2,133972,133972,133974,0,2,0
38183,1,3,133973,133974,133977,1,4,0
38184,4,2,133977,133977,133979,0,2,0
38185,1,3,133978,133979,133982,1,4,0
38186,5,1,133983,133983,133984,0,1,1
38187,3,2,133986,133986,133988,0,2,2
38188,3,2,133989,133989,133991,0,2,1
38189,1,1,133990,133991,133992,1,2,0
38190,6,1,133996,133996,133997,0,1,4
38191,3,3,133999,133999,134002,0,3,2
38192,4,2,134003,134003,134005,0,2,1
38193,5,2,134008,134008,134010,0,2,3
38194,6,2,134014,134014,134016,0,2,4
38195,5,2,134019,134019,134021,0,2,3
38196,1,3,134020,134021,134024,1,4,0
38197,6,1,134026,134026,134027,0,1,2
38198,3,2,134029,134029,134031,0,2,2
38199,3,1,134032,134032,134033,0,1,1
38200,6,3,134038,134038,134041,0,3,5
38201,6,1,134044,134044,134045,0,1,3
38202,1,1,134045,134045,134046,0,1,0
38203,3,1,134048,134048,134049,0,1,2
38204,3,2,134051,134051,134053,0,2,2
38205,2,1,134053,134053,134054,0,1,0
38206,2,1,134055,134055,134056,0,1,1
38207,6,2,134061,134061,134063,0,2,5
38208,2,3,134063,134063,134066,0,3,0
38209,3,1,134066,134066,134067,0,1,0
38210,1,3,134067,134067,134070,0,3,0
38211,2,1,134069,134070,134071,1,2,0
38212,4,3,134073,134073,134076,0,3,2
38213,2,3,134075,134076,134079,1,4,0
38214,4,3,134079,134079,134082,0,3,0
38215,3,2,134082,134082,134084,0,2,0
38216,3,1,134085,134085,134086,0,1,1
38217,4,2,134089,134089,134091,0,2,3
38218,1,3,134090,134091,134094,1,4,0
38219,3,2,134093,134094,134096,1,3,0
38220,6,3,134099,134099,134102,0,3,3
38221,5,2,134104,134104,134106,0,2,2
38222,1,2,134105,134106,134108,1,3,0
38223,6,3,134111,134111,134114,0,3,3
38224,6,2,134117,134117,134119,0,2,3
38225,4,3,134121,134121,134124,0,3,2
38226,5,1,134126,134126,134127,0,1,2
38227,6,3,134132,134132,134135,0,3,5
38228,3,3,134135,134135,134138,0,3,0
38229,3,3,134138,134138,134141,0,3,0
38230,4,2,134142,134142,134144,0,2,1
38231,1,1,134143,134144,134145,1,2,0
38232,5,1,134148,134148,134149,0,1,3
38233,3,3,134151,134151,134154,0,3,2
38234,1,1,134152,134154,134155,2,3,0
38235,6,1,134158,134158,134159,0,1,3
38236,6,1,134164,134164,134165,0,1,5
38237,4,1,134168,134168,134169,0,1,3
38238,2,2,134170,134170,134172,0,2,1
38239,5,1,134175,134175,134176,0,1,3
38240,5,1,134180,134180,134181,0,1,4
38241,5,1,134185,134185,134186,0,1,4
38242,4,1,134189,134189,134190,0,1,3
38243,5,2,134194,134194,134196,0,2,4
38244,1,3,134195,134196,134199,1,4,0
38245,3,3,134198,134199,134202,1,4,0
38246,5,3,134203,134203,134206,0,3,1
38247,1,2,134204,134206,134208,2,4,0
38248,3,1,134207,134208,134209,1,2,0
38249,3,2,134210,134210,134212,0,2,1
38250,4,3,134214,134214,134217,0,3,2
38251,3,1,134217,134217,134218,0,1,0
38252,5,1,134222,134222,134223,0,1,4
38253,4,1,134226,134226,134227,0,1,3
38254,6,1,134232,134232,134233,0,1,5
38255,3,3,134235,134235,134238,0,3,2
38256,3,2,134238,134238,134240,0,2,0
38257,1,3,134239,134240,134243,1,4,0
38258,3,3,134242,134243,134246,1,4,0
38259,6,1,134248,134248,134249,0,1,2
38260,6,3,134254,134254,134257,0,3,5
38261,5,3,134259,134259,134262,0,3,2
38262,2,2,134261,134262,134264,1,3,0
38263,5,1,134266,134266,134267,0,1,2
38264,4,3,134270,134270,134273,0,3,3
38265,2,1,134272,134273,134274,1,2,0
38266,5,1,134277,134277,134278,0,1,3
38267,4,1,134281,134281,134282,0,1,3
38268,6,1,134287,134287,134288,0,1,5
38269,3,1,134290,134290,134291,0,1,2
38270,2,3,134292,134292,134295,0,3,1
38271,1,2,134293,134295,134297,2,4,0
38272,3,2,134296,134297,134299,1,3,0
38273,1,2,134297,134299,134301,2,4,0
38274,6,2,134303,134303,134305,0,2,2
38275,6,1,134309,134309,134310,0,1,4
38276,2,2,134311,134311,134313,0,2,1
38277,4,1,134315,134315,134316,0,1,2
38278,5,2,134320,134320,134322,0,2,4
38279,2,1,134322,134322,134323,0,1,0
38280,6,1,134328,134328,134329,0,1,5
38281,5,2,134333,134333,134335,0,2,4
38282,5,1,134338,134338,134339,0,1,3
38283,3,1,134341,134341,134342,0,1,2
38284,5,2,134346,134346,134348,0,2,4
38285,4,3,134350,134350,134353,0,3,2
38286,3,1,134353,134353,134354,0,1,0
38287,6,3,134359,134359,134362,0,3,5
38288,4,2,134363,134363,134365,0,2,1
38289,6,3,134369,134369,134372,0,3,4
38290,6,1,134375,134375,134376,0,1,3
38291,4,1,134379,134379,134380,0,1,3
38292,6,1,134385,134385,134386,0,1,5
38293,5,2,134390,134390,134392,0,2,4
38294,1,2,134391,134392,134394,1,3,0
38295,4,1,134395,134395,134396,0,1,1
38296,1,1,134396,134396,134397,0,1,0
38297,4,2,134400,134400,134402,0,2,3
38298,5,3,134405,134405,134408,0,3,3
38299,6,3,134411,134411,134414,0,3,3
38300,2,1,134413,134414,134415,1,2,0
38301,3,3,134416,134416,134419,0,3,1
38302,5,3,134421,134421,134424,0,3,2
38303,3,2,134424,134424,134426,0,2,0
38304,4,2,134428,134428,134430,0,2,2
38305,6,2,134434,134434,134436,0,2,4
38306,6,3,134440,134440,134443,0,3,4
38307,5,2,134445,134445,134447,0,2,2
38308,6,3,134451,134451,134454,0,3,4
38309,6,2,134457,134457,134459,0,2,3
38310,4,1,134461,134461,134462,0,1,2
38311,1,1,134462,134462,134463,0,1,0
38312,5,3,134467,134467,134470,0,3,4
38313,5,3,134472,134472,134475,0,3,2
38314,4,2,134476,134476,134478,0,2,1
38315,5,2,134481,134481,134483,0,2,3
38316,3,2,134484,134484,134486,0,2,1
38317,4,1,134488,134488,134489,0,1,2
38318,5,3,134493,134493,134496,0,3,4
38319,2,1,134495,134496,134497,1,2,0
38320,5,3,134500,134500,134503,0,3,3
38321,5,2,134505,134505,134507,0,2,2
38322,1,2,134506,134507,134509,1,3,0
38323,2,2,134508,134509,134511,1,3,0
38324,5,2,134513,134513,134515,0,2,2
38325,2,2,134515,134515,134517,0,2,0
38326,6,2,134521,134521,134523,0,2,4
38327,6,1,134527,134527,134528,0,1,4
38328,1,3,134528,134528,134531,0,3,0
38329,5,2,134533,134533,134535,0,2,2
38330,3,3,134536,134536,134539,0,3,1
38331,6,2,134542,134542,134544,0,2,3
38332,5,1,134547,134547,134548,0,1,3
38333,3,3,134550,134550,134553,0,3,2
38334,5,3,134555,134555,134558,0,3,2
38335,4,1,134559,134559,134560,0,1,1
38336,6,3,134565,134565,134568,0,3,5
38337,3,2,134568,134568,134570,0,2,0
38338,6,3,134574,134574,134577,0,3,4
38339,3,2,134577,134577,134579,0,2,0
38340,6,3,134583,134583,134586,0,3,4
38341,3,3,134586,134586,134589,0,3,0
38342,5,1,134591,134591,134592,0,1,2
38343,2,3,134593,134593,134596,0,3,1
38344,6,2,134599,134599,134601,0,2,3
38345,6,2,134605,134605,134607,0,2,4
38346,5,1,134610,134610,134611,0,1,3
38347,2,2,134612,134612,134614,0,2,1
38348,4,2,134616,134616,134618,0,2,2
38349,2,1,134618,134618,134619,0,1,0
38350,1,2,134619,134619,134621,0,2,0
38351,2,2,134621,134621,134623,0,2,0
38352,2,3,134623,134623,134626,0,3,0
38353,4,3,134627,134627,134630,0,3,1
38354,6,3,134633,134633,134636,0,3,3
38355,1,3,134634,134636,134639,2,5,0
38356,1,1,134635,134639,134640,4,5,0
38357,6,3,134641,134641,134644,0,3,1
38358,1,3,134642,134644,134647,2,5,0
38359,5,3,134647,134647,134650,0,3,0
38360,4,1,134651,134651,134652,0,1,1
38361,3,3,134654,134654,134657,0,3,2
38362,5,2,134659,134659,134661,0,2,2
38363,1,2,134660,134661,134663,1,3,0
38364,3,2,134663,134663,134665,0,2,0
38365,6,3,134669,134669,134672,0,3,4
38366,2,2,134671,134672,134674,1,3,0
38367,3,2,134674,134674,134676,0,2,0
38368,5,1,134679,134679,134680,0,1,3
38369,5,3,134684,134684,134687,0,3,4
38370,6,3,134690,134690,134693,0,3,3
38371,2,2,134692,134693,134695,1,3,0
38372,4,1,134696,134696,134697,0,1,1
38373,2,2,134698,134698,134700,0,2,1
38374,1,3,134699,134700,134703,1,4,0
38375,3,1,134702,134703,134704,1,2,0
38376,5,3,134707,134707,134710,0,3,3
38377,2,1,134709,134710,134711,1,2,0
38378,1,2,134710,134711,134713,1,3,0
38379,1,3,134711,134713,134716,2,5,0
38380,4,1,134715,134716,134717,1,2,0
38381,4,2,134719,134719,134721,0,2,2
38382,1,1,134720,134721,134722,1,2,0
38383,1,1,134721,134722,134723,1,2,0
38384,5,1,134726,134726,134727,0,1,3
38385,5,1,134731,134731,134732,0,1,4
38386,5,3,134736,134736,134739,0,3,4
38387,6,1,134742,134742,134743,0,1,3
38388,2,1,134744,134744,134745,0,1,1
38389,6,2,134750,134750,134752,0,2,5
38390,2,1,134752,134752,134753,0,1,0
38391,3,1,134755,134755,134756,0,1,2
38392,2,3,134757,134757,134760,0,3,1
38393,2,3,134759,134760,134763,1,4,0
38394,1,2,134760,134763,134765,3,5,0
38395,6,1,134766,134766,134767,0,1,1
38396,3,3,134769,134769,134772,0,3,2
38397,2,1,134771,134772,134773,1,2,0
38398,4,1,134775,134775,134776,0,1,2
38399,2,3,134777,134777,134780,0,3,1
38400,2,1,134779,134780,134781,1,2,0
38401,2,3,134781,134781,134784,0,3,0
38402,2,2,134783,134784,134786,1,3,0
38403,5,3,134788,134788,134791,0,3,2
38404,2,3,134790,134791,134794,1,4,0
38405,6,1,134796,134796,134797,0,1,2
38406,4,1,134800,134800,134801,0,1,3
38407,6,2,134806,134806,134808,0,2,5
38408,2,3,134808,134808,134811,0,3,0
38409,2,3,134810,134811,134814,1,4,0
38410,4,2,134814,134814,134816,0,2,0
38411,1,2,134815,134816,134818,1,3,0
38412,1,1,134816,134818,134819,2,3,0
38413,2,2,134818,134819,134821,1,3,0
38414,6,2,134824,134824,134826,0,2,3
38415,3,2,134827,134827,134829,0,2,1
38416,4,3,134831,134831,134834,0,3,2
38417,3,3,134834,134834,134837,0,3,0
38418,2,3,134836,134837,134840,1,4,0
38419,5,1,134841,134841,134842,0,1,1
38420,2,1,134843,134843,134844,0,1,1
38421,1,2,134844,134844,134846,0,2,0
38422,6,2,134850,134850,134852,0,2,4
38423,6,2,134856,134856,134858,0,2,4
38424,2,3,134858,134858,134861,0,3,0
38425,3,2,134861,134861,134863,0,2,0
38426,3,2,134864,134864,134866,0,2,1
38427,6,1,134870,134870,134871,0,1,4
38428,6,1,134876,134876,134877,0,1,5
38429,3,2,134879,134879,134881,0,2,2
38430,4,1,134883,134883,134884,0,1,2
38431,4,1,134887,134887,134888,0,1,3
38432,5,2,134892,134892,134894,0,2,4
38433,2,3,134894,134894,134897,0,3,0
38434,3,3,134897,134897,134900,0,3,0
38435,5,2,134902,134902,134904,0,2,2
38436,2,2,134904,134904,134906,0,2,0
38437,6,1,134910,134910,134911,0,1,4
38438,5,1,134915,134915,134916,0,1,4
38439,6,2,134921,134921,134923,0,2,5
38440,1,1,134922,134923,134924,1,2,0
38441,1,1,134923,134924,134925,1,2,0
38442,3,2,134926,134926,134928,0,2,1
38443,4,2,134930,134930,134932,0,2,2
38444,5,1,134935,134935,134936,0,1,3
38445,4,1,134939,134939,134940,0,1,3
38446,3,3,134942,134942,134945,0,3,2
38447,3,3,134945,134945,134948,0,3,0
38448,1,2,134946,134948,134950,2,4,0
38449,3,2,134949,134950,134952,1,3,0
38450,1,1,134950,134952,134953,2,3,0
38451,4,2,134954,134954,134956,0,2,1
38452,6,1,134960,134960,134961,0,1,4
38453,4,3,134964,134964,134967,0,3,3
38454,4,2,134968,134968,134970,0,2,1
38455,3,2,134971,134971,134973,0,2,1
38456,5,1,134976,134976,134977,0,1,3
38457,3,3,134979,134979,134982,0,3,2
38458,6,2,134985,134985,134987,0,2,3
38459,5,2,134990,134990,134992,0,2,3
38460,1,2,134991,134992,134994,1,3,0
38461,2,1,134993,134994,134995,1,2,0
38462,1,2,134994,134995,134997,1,3,0
38463,5,1,134999,134999,135000,0,1,2
38464,4,1,135003,135003,135004,0,1,3
38465,3,2,135006,135006,135008,0,2,2
38466,4,3,135010,135010,135013,0,3,2
38467,2,3,135012,135013,135016,1,4,0
38468,1,1,135013,135016,135017,3,4,0
38469,6,1,135019,135019,135020,0,1,2
38470,3,1,135022,135022,135023,0,1,2
38471,3,2,135025,135025,135027,0,2,2
38472,2,2,135027,135027,135029,0,2,0
38473,6,2,135033,135033,135035,0,2,4
38474,4,1,135037,135037,135038,0,1,2
38475,1,2,135038,135038,135040,0,2,0
38476,5,1,135043,135043,135044,0,1,3
38477,3,3,135046,135046,135049,0,3,2
38478,4,1,135050,135050,135051,0,1,1
38479,4,2,135054,135054,135056,0,2,3
38480,6,1,135060,135060,135061,0,1,4
38481,2,3,135062,135062,135065,0,3,1
38482,5,3,135067,135067,135070,0,3,2
38483,2,3,135069,135070,135073,1,4,0
38484,4,2,135073,135073,135075,0,2,0
38485,6,1,135079,135079,135080,0,1,4
38486,4,2,135083,135083,135085,0,2,3
38487,5,3,135088,135088,135091,0,3,3
38488,1,1,135089,135091,135092,2,3,0
38489,6,1,135095,135095,135096,0,1,3
38490,6,3,135101,135101,135104,0,3,5
38491,2,1,135103,135104,135105,1,2,0
38492,2,1,135105,135105,135106,0,1,0
38493,3,1,135108,135108,135109,0,1,2
38494,3,1,135111,135111,135112,0,1,2
38495,6,3,135117,135117,135120,0,3,5
38496,6,2,135123,135123,135125,0,2,3
38497,6,2,135129,135129,135131,0,2,4
38498,6,2,135135,135135,135137,0,2,4
38499,5,3,135140,135140,135143,0,3,3
38500,5,2,135145,135145,135147,0,2,2
38501,4,3,135149,135149,135152,0,3,2
38502,2,3,135151,135152,135155,1,4,0
38503,4,1,135155,135155,135156,0,1,0
38504,1,1,135156,135156,135157,0,1,0
38505,6,1,135162,135162,135163,0,1,5
38506,2,3,135164,135164,135167,0,3,1
38507,6,3,135170,135170,135173,0,3,3
38508,4,2,135174,135174,135176,0,2,1
38509,3,2,135177,135177,135179,0,2,1
38510,6,3,135183,135183,135186,0,3,4
38511,4,1,135187,135187,135188,0,1,1
38512,2,1,135189,135189,135190,0,1,1
38513,5,3,135194,135194,135197,0,3,4
38514,3,1,135197,135197,135198,0,1,0
38515,6,2,135203,135203,135205,0,2,5
38516,2,1,135205,135205,135206,0,1,0
38517,2,2,135207,135207,135209,0,2,1
38518,3,3,135210,135210,135213,0,3,1
38519,5,3,135215,135215,135218,0,3,2
38520,6,3,135221,135221,135224,0,3,3
38521,3,3,135224,135224,135227,0,3,0
38522,4,3,135228,135228,135231,0,3,1
38523,6,2,135234,135234,135236,0,2,3
38524,6,3,135240,135240,135243,0,3,4
38525,1,2,135241,135243,135245,2,4,0
38526,4,2,135245,135245,135247,0,2,0
38527,1,2,135246,135247,135249,1,3,0
38528,4,1,135250,135250,135251,0,1,1
38529,3,2,135253,135253,135255,0,2,2
38530,6,2,135259,135259,135261,0,2,4
38531,6,2,135265,135265,135267,0,2,4
38532,4,1,135269,135269,135270,0,1,2
38533,6,1,135275,135275,135276,0,1,5
38534,5,2,135280,135280,135282,0,2,4
38535,4,3,135284,135284,135287,0,3,2
38536,6,2,135290,135290,135292,0,2,3
38537,3,3,135293,135293,135296,0,3,1
38538,1,3,135294,135296,135299,2,5,0
38539,2,2,135296,135299,135301,3,5,0
38540,2,1,135298,135301,135302,3,4,0
38541,2,1,135300,135302,135303,2,3,0
38542,4,2,135304,135304,135306,0,2,1
38543,1,3,135305,135306,135309,1,4,0
38544,5,1,135310,135310,135311,0,1,1
38545,3,3,135313,135313,135316,0,3,2
38546,2,1,135315,135316,135317,1,2,0
38547,4,3,135319,135319,135322,0,3,2
38548,6,3,135325,135325,135328,0,3,3
38549,4,3,135329,135329,135332,0,3,1
38550,1,3,135330,135332,135335,2,5,0
38551,2,2,135332,135335,135337,3,5,0
38552,4,2,135336,135337,135339,1,3,0
38553,1,2,135337,135339,135341,2,4,0
38554,3,3,135340,135341,135344,1,4,0
38555,2,1,135342,135344,135345,2,3,0
38556,1,1,135343,135345,135346,2,3,0
38557,6,1,135349,135349,135350,0,1,3
38558,6,2,135355,135355,135357,0,2,5
38559,4,3,135359,135359,135362,0,3,2
38560,6,2,135365,135365,135367,0,2,3
38561,5,2,135370,135370,135372,0,2,3
38562,6,3,135376,135376,135379,0,3,4
38563,4,1,135380,135380,135381,0,1,1
38564,3,2,135383,135383,135385,0,2,2
38565,5,3,135388,135388,135391,0,3,3
38566,5,1,135393,135393,135394,0,1,2
38567,6,3,135399,135399,135402,0,3,5
38568,6,3,135405,135405,135408,0,3,3
38569,2,1,135407,135408,135409,1,2,0
38570,4,2,135411,135411,135413,0,2,2
38571,1,2,135412,135413,135415,1,3,0
38572,3,3,135415,135415,135418,0,3,0
38573,5,3,135420,135420,135423,0,3,2
38574,3,2,135423,135423,135425,0,2,0
38575,3,2,135426,135426,135428,0,2,1
38576,5,1,135431,135431,135432,0,1,3
38577,3,1,135434,135434,135435,0,1,2
38578,1,3,135435,135435,135438,0,3,0
38579,6,2,135441,135441,135443,0,2,3
38580,5,3,135446,135446,135449,0,3,3
38581,1,2,135447,135449,135451,2,4,0
38582,6,3,135453,135453,135456,0,3,2
38583,3,2,135456,135456,135458,0,2,0
38584,6,3,135462,135462,135465,0,3,4
38585,5,1,135467,135467,135468,0,1,2
38586,6,2,135473,135473,135475,0,2,5
38587,6,1,135479,135479,135480,0,1,4
38588,5,2,135484,135484,135486,0,2,4
38589,4,3,135488,135488,135491,0,3,2
38590,6,2,135494,135494,135496,0,2,3
38591,4,1,135498,135498,135499,0,1,2
38592,6,2,135504,135504,135506,0,2,5
38593,5,3,135509,135509,135512,0,3,3
38594,4,3,135513,135513,135516,0,3,1
38595,4,1,135517,135517,135518,0,1,1
38596,1,3,135518,135518,135521,0,3,0
38597,5,3,135523,135523,135526,0,3,2
38598,4,2,135527,135527,135529,0,2,1
38599,5,2,135532,135532,135534,0,2,3
38600,2,2,135534,135534,135536,0,2,0
38601,5,1,135539,135539,135540,0,1,3
38602,1,2,135540,135540,135542,0,2,0
38603,4,1,135544,135544,135545,0,1,2
38604,1,1,135545,135545,135546,0,1,0
38605,3,2,135548,135548,135550,0,2,2
38606,5,3,135553,135553,135556,0,3,3
38607,1,2,135554,135556,135558,2,4,0
38608,1,1,135555,135558,135559,3,4,0
38609,1,3,135556,135559,135562,3,6,0
38610,3,3,135559,135562,135565,3,6,0
38611,3,1,135562,135565,135566,3,4,0
38612,5,2,135567,135567,135569,0,2,1
38613,6,2,135573,135573,135575,0,2,4
38614,3,1,135576,135576,135577,0,1,1
38615,5,3,135581,135581,135584,0,3,4
38616,3,3,135584,135584,135587,0,3,0
38617,3,3,135587,135587,135590,0,3,0
38618,5,2,135592,135592,135594,0,2,2
38619,6,2,135598,135598,135600,0,2,4
38620,4,3,135602,135602,135605,0,3,2
38621,1,2,135603,135605,135607,2,4,0
38622,5,2,135608,135608,135610,0,2,1
38623,6,2,135614,135614,135616,0,2,4
38624,2,1,135616,135616,135617,0,1,0
38625,6,2,135622,135622,135624,0,2,5
38626,2,2,135624,135624,135626,0,2,0
38627,1,1,135625,135626,135627,1,2,0
38628,3,2,135628,135628,135630,0,2,1
38629,2,1,135630,135630,135631,0,1,0
38630,6,3,135636,135636,135639,0,3,5
38631,1,3,135637,135639,135642,2,5,0
38632,5,2,135642,135642,135644,0,2,0
38633,1,3,135643,135644,135647,1,4,0
38634,1,1,135644,135647,135648,3,4,0
38635,4,1,135648,135648,135649,0,1,0
38636,6,1,135654,135654,135655,0,1,5
38637,2,3,135656,135656,135659,0,3,1
38638,5,2,135661,135661,135663,0,2,2
38639,2,1,135663,135663,135664,0,1,0
38640,6,1,135669,135669,135670,0,1,5
38641,6,1,135675,135675,135676,0,1,5
38642,1,2,135676,135676,135678,0,2,0
38643,2,1,135678,135678,135679,0,1,0
38644,3,3,135681,135681,135684,0,3,2
38645,4,1,135685,135685,135686,0,1,1
38646,3,2,135688,135688,135690,0,2,2
38647,6,3,135694,135694,135697,0,3,4
38648,2,1,135696,135697,135698,1,2,0
38649,3,3,135699,135699,135702,0,3,1
38650,4,3,135703,135703,135706,0,3,1
38651,2,2,135705,135706,135708,1,3,0
38652,1,2,135706,135708,135710,2,4,0
38653,4,3,135710,135710,135713,0,3,0
38654,2,2,135712,135713,135715,1,3,0
38655,2,1,135714,135715,135716,1,2,0
38656,2,3,135716,135716,135719,0,3,0
38657,1,3,135717,135719,135722,2,5,0
38658,3,3,135720,135722,135725,2,5,0
38659,1,1,135721,135725,135726,4,5,0
38660,1,2,135722,135726,135728,4,6,0
38661,3,2,135725,135728,135730,3,5,0
38662,2,3,135727,135730,135733,3,6,0
38663,3,2,135730,135733,135735,3,5,0
38664,6,1,135736,135736,135737,0,1,1
38665,1,2,135737,135737,135739,0,2,0
38666,1,1,135738,135739,135740,1,2,0
38667,6,3,135744,135744,135747,0,3,4
38668,4,3,135748,135748,135751,0,3,1
38669,2,1,135750,135751,135752,1,2,0
38670,6,1,135756,135756,135757,0,1,4
38671,5,1,135761,135761,135762,0,1,4
38672,1,2,135762,135762,135764,0,2,0
38673,5,2,135767,135767,135769,0,2,3
38674,5,3,135772,135772,135775,0,3,3
38675,6,2,135778,135778,135780,0,2,3
38676,5,3,135783,135783,135786,0,3,3
38677,1,3,135784,135786,135789,2,5,0
38678,1,2,135785,135789,135791,4,6,0
38679,2,1,135787,135791,135792,4,5,0
38680,2,2,135789,135792,135794,3,5,0
38681,2,1,135791,135794,135795,3,4,0
38682,2,1,135793,135795,135796,2,3,0
38683,6,1,135799,135799,135800,0,1,3
38684,2,3,135801,135801,135804,0,3,1
38685,5,1,135806,135806,135807,0,1,2
38686,1,2,135807,135807,135809,0,2,0
38687,1,2,135808,135809,135811,1,3,0
38688,5,2,135813,135813,135815,0,2,2
38689,1,2,135814,135815,135817,1,3,0
38690,4,3,135818,135818,135821,0,3,1
38691,3,3,135821,135821,135824,0,3,0
38692,1,3,135822,135824,135827,2,5,0
38693,3,2,135825,135827,135829,2,4,0
38694,4,1,135829,135829,135830,0,1,0
38695,6,3,135835,135835,135838,0,3,5
38696,2,1,135837,135838,135839,1,2,0
38697,6,1,135843,135843,135844,0,1,4
38698,4,1,135847,135847,135848,0,1,3
38699,1,1,135848,135848,135849,0,1,0
38700,6,3,135854,135854,135857,0,3,5
38701,6,1,135860,135860,135861,0,1,3
38702,1,1,135861,135861,135862,0,1,0
38703,2,1,135863,135863,135864,0,1,1
38704,6,3,135869,135869,135872,0,3,5
38705,2,3,135871,135872,135875,1,4,0
38706,6,2,135877,135877,135879,0,2,2
38707,4,2,135881,135881,135883,0,2,2
38708,1,1,135882,135883,135884,1,2,0
38709,1,3,135883,135884,135887,1,4,0
38710,2,1,135885,135887,135888,2,3,0
38711,1,1,135886,135888,135889,2,3,0
38712,1,2,135887,135889,135891,2,4,0
38713,3,1,135890,135891,135892,1,2,0
38714,1,1,135891,135892,135893,1,2,0
38715,4,1,135895,135895,135896,0,1,2
38716,6,2,135901,135901,135903,0,2,5
38717,6,1,135907,135907,135908,0,1,4
38718,6,1,135913,135913,135914,0,1,5
38719,5,3,135918,135918,135921,0,3,4
38720,4,3,135922,135922,135925,0,3,1
38721,1,1,135923,135925,135926,2,3,0
38722,5,2,135928,135928,135930,0,2,2
38723,4,1,135932,135932,135933,0,1,2
38724,6,3,135938,135938,135941,0,3,5
38725,3,2,135941,135941,135943,0,2,0
38726,4,2,135945,135945,135947,0,2,2
38727,6,3,135951,135951,135954,0,3,4
38728,2,3,135953,135954,135957,1,4,0
38729,1,2,135954,135957,135959,3,5,0
38730,5,1,135959,135959,135960,0,1,0
38731,6,2,135965,135965,135967,0,2,5
38732,2,2,135967,135967,135969,0,2,0
38733,2,2,135969,135969,135971,0,2,0
38734,4,3,135973,135973,135976,0,3,2
38735,4,3,135977,135977,135980,0,3,1
38736,1,2,135978,135980,135982,2,4,0
38737,3,2,135981,135982,135984,1,3,0
38738,3,1,135984,135984,135985,0,1,0
38739,3,2,135987,135987,135989,0,2,2
38740,3,3,135990,135990,135993,0,3,1
38741,4,3,135994,135994,135997,0,3,1
38742,6,1,136000,136000,136001,0,1,3
38743,5,3,136005,136005,136008,0,3,4
38744,5,3,136010,136010,136013,0,3,2
38745,2,3,136012,136013,136016,1,4,0
38746,5,2,136017,136017,136019,0,2,1
38747,3,1,136020,136020,136021,0,1,1
38748,2,2,136022,136022,136024,0,2,1
38749,5,2,136027,136027,136029,0,2,3
38750,6,2,136033,136033,136035,0,2,4
38751,2,3,136035,136035,136038,0,3,0
38752,5,2,136040,136040,136042,0,2,2
38753,4,2,136044,136044,136046,0,2,2
38754,5,2,136049,136049,136051,0,2,3
38755,3,3,136052,136052,136055,0,3,1
38756,6,3,136058,136058,136061,0,3,3
38757,2,2,136060,136061,136063,1,3,0
38758,2,2,136062,136063,136065,1,3,0
38759,3,3,136065,136065,136068,0,3,0
38760,2,3,136067,136068,136071,1,4,0
38761,5,3,136072,136072,136075,0,3,1
38762,4,2,136076,136076,136078,0,2,1
38763,4,2,136080,136080,136082,0,2,2
38764,1,3,136081,136082,136085,1,4,0
38765,1,2,136082,136085,136087,3,5,0
38766,3,2,136085,136087,136089,2,4,0
38767,6,2,136091,136091,136093,0,2,2
38768,1,1,136092,136093,136094,1,2,0
38769,6,2,136098,136098,136100,0,2,4
38770,2,1,136100,136100,136101,0,1,0
38771,2,3,136102,136102,136105,0,3,1
38772,4,2,136106,136106,136108,0,2,1
38773,5,3,136111,136111,136114,0,3,3
38774,1,1,136112,136114,136115,2,3,0
38775,1,1,136113,136115,136116,2,3,0
38776,3,1,136116,136116,136117,0,1,0
38777,2,2,136118,136118,136120,0,2,1
38778,1,3,136119,136120,136123,1,4,0
38779,6,2,136125,136125,136127,0,2,2
38780,5,3,136130,136130,136133,0,3,3
38781,5,2,136135,136135,136137,0,2,2
38782,4,2,136139,136139,136141,0,2,2
38783,3,2,136142,136142,136144,0,2,1
38784,1,2,136143,136144,136146,1,3,0
38785,4,3,136147,136147,136150,0,3,1
38786,4,3,136151,136151,136154,0,3,1
38787,2,3,136153,136154,136157,1,4,0
38788,2,1,136155,136157,136158,2,3,0
38789,6,2,136161,136161,136163,0,2,3
38790,3,1,136164,136164,136165,0,1,1
38791,6,2,136170,136170,136172,0,2,5
38792,5,1,136175,136175,136176,0,1,3
38793,4,3,136179,136179,136182,0,3,3
38794,4,3,136183,136183,136186,0,3,1
38795,2,3,136185,136186,136189,1,4,0
38796,1,3,136186,136189,136192,3,6,0
38797,2,2,136188,136192,136194,4,6,0
38798,1,1,136189,136194,136195,5,6,0
38799,3,3,136192,136195,136198,3,6,0
38800,5,2,136197,136198,136200,1,3,0
38801,2,1,136199,136200,136201,1,2,0
38802,1,1,136200,136201,136202,1,2,0
38803,5,3,136205,136205,136208,0,3,3
38804,5,1,136210,136210,136211,0,1,2
38805,5,3,136215,136215,136218,0,3,4
38806,3,1,136218,136218,136219,0,1,0
38807,2,1,136220,136220,136221,0,1,1
38808,5,2,136225,136225,136227,0,2,4
38809,4,2,136229,136229,136231,0,2,2
38810,1,1,136230,136231,136232,1,2,0
38811,2,1,136232,136232,136233,0,1,0
38812,1,3,136233,136233,136236,0,3,0
38813,2,1,136235,136236,136237,1,2,0
38814,1,2,136236,136237,136239,1,3,0
38815,6,1,136242,136242,136243,0,1,3
38816,1,3,136243,136243,136246,0,3,0
38817,5,2,136248,136248,136250,0,2,2
38818,4,3,136252,136252,136255,0,3,2
38819,1,3,136253,136255,136258,2,5,0
38820,2,2,136255,136258,136260,3,5,0
38821,2,1,136257,136260,136261,3,4,0
38822,5,3,136262,136262,136265,0,3,1
38823,6,3,136268,136268,136271,0,3,3
38824,6,2,136274,136274,136276,0,2,3
38825,6,2,136280,136280,136282,0,2,4
38826,2,1,136282,136282,136283,0,1,0
38827,4,2,136286,136286,136288,0,2,3
38828,1,3,136287,136288,136291,1,4,0
38829,6,2,136293,136293,136295,0,2,2
38830,3,3,136296,136296,136299,0,3,1
38831,1,3,136297,136299,136302,2,5,0
38832,2,1,136299,136302,136303,3,4,0
38833,4,1,136303,136303,136304,0,1,0
38834,4,1,136307,136307,136308,0,1,3
38835,1,3,136308,136308,136311,0,3,0
38836,1,3,136309,136311,136314,2,5,0
38837,6,1,136315,136315,136316,0,1,1
38838,1,2,136316,136316,136318,0,2,0
38839,4,1,136320,136320,136321,0,1,2
38840,4,2,136324,136324,136326,0,2,3
38841,4,3,136328,136328,136331,0,3,2
38842,6,1,136334,136334,136335,0,1,3
38843,3,1,136337,136337,136338,0,1,2
38844,3,2,136340,136340,136342,0,2,2
38845,2,1,136342,136342,136343,0,1,0
38846,2,2,136344,136344,136346,0,2,1
38847,6,1,136350,136350,136351,0,1,4
38848,3,3,136353,136353,136356,0,3,2
38849,4,1,136357,136357,136358,0,1,1
38850,2,3,136359,136359,136362,0,3,1
38851,4,1,136363,136363,136364,0,1,1
38852,3,1,136366,136366,136367,0,1,2
38853,5,3,136371,136371,136374,0,3,4
38854,5,2,136376,136376,136378,0,2,2
38855,1,2,136377,136378,136380,1,3,0
38856,4,2,136381,136381,136383,0,2,1
38857,6,3,136387,136387,136390,0,3,4
38858,1,2,136388,136390,136392,2,4,0
38859,6,2,136394,136394,136396,0,2,2
38860,2,3,136396,136396,136399,0,3,0
38861,5,2,136401,136401,136403,0,2,2
38862,2,3,136403,136403,136406,0,3,0
38863,4,1,136407,136407,136408,0,1,1
38864,6,3,136413,136413,136416,0,3,5
38865,5,1,136418,136418,136419,0,1,2
38866,4,1,136422,136422,136423,0,1,3
38867,2,2,136424,136424,136426,0,2,1
38868,5,2,136429,136429,136431,0,2,3
38869,3,1,136432,136432,136433,0,1,1
38870,6,3,136438,136438,136441,0,3,5
38871,5,3,136443,136443,136446,0,3,2
38872,3,1,136446,136446,136447,0,1,0
38873,6,2,136452,136452,136454,0,2,5
38874,5,1,136457,136457,136458,0,1,3
38875,1,2,136458,136458,136460,0,2,0
38876,2,1,136460,136460,136461,0,1,0
38877,5,3,136465,136465,136468,0,3,4
38878,6,1,136471,136471,136472,0,1,3
38879,6,2,136477,136477,136479,0,2,5
38880,4,2,136481,136481,136483,0,2,2
38881,6,1,136487,136487,136488,0,1,4
38882,3,1,136490,136490,136491,0,1,2
38883,1,1,136491,136491,136492,0,1,0
38884,5,1,136496,136496,136497,0,1,4
38885,3,3,136499,136499,136502,0,3,2
38886,3,2,136502,136502,136504,0,2,0
38887,1,3,136503,136504,136507,1,4,0
38888,4,1,136507,136507,136508,0,1,0
38889,4,2,136511,136511,136513,0,2,3
38890,4,1,136515,136515,136516,0,1,2
38891,3,1,136518,136518,136519,0,1,2
38892,5,3,136523,136523,136526,0,3,4
38893,3,3,136526,136526,136529,0,3,0
38894,6,2,136532,136532,136534,0,2,3
38895,4,3,136536,136536,136539,0,3,2
38896,4,2,136540,136540,136542,0,2,1
38897,3,1,136543,136543,136544,0,1,1
38898,3,3,136546,136546,136549,0,3,2
38899,5,1,136551,136551,136552,0,1,2
38900,3,3,136554,136554,136557,0,3,2
38901,6,3,136560,136560,136563,0,3,3
38902,1,1,136561,136563,136564,2,3,0
38903,3,1,136564,136564,136565,0,1,0
38904,2,2,136566,136566,136568,0,2,1
38905,6,1,136572,136572,136573,0,1,4
38906,1,2,136573,136573,136575,0,2,0
38907,3,3,136576,136576,136579,0,3,1
38908,5,2,136581,136581,136583,0,2,2
38909,5,2,136586,136586,136588,0,2,3
38910,3,3,136589,136589,136592,0,3,1
38911,5,3,136594,136594,136597,0,3,2
38912,1,1,136595,136597,136598,2,3,0
38913,4,1,136599,136599,136600,0,1,1
38914,5,1,136604,136604,136605,0,1,4
38915,3,1,136607,136607,136608,0,1,2
38916,2,3,136609,136609,136612,0,3,1
38917,1,1,136610,136612,136613,2,3,0
38918,3,2,136613,136613,136615,0,2,0
38919,3,3,136616,136616,136619,0,3,1
38920,6,3,136622,136622,136625,0,3,3
38921,3,3,136625,136625,136628,0,3,0
38922,3,2,136628,136628,136630,0,2,0
38923,2,1,136630,136630,136631,0,1,0
38924,3,1,136633,136633,136634,0,1,2
38925,2,3,136635,136635,136638,0,3,1
38926,2,2,136637,136638,136640,1,3,0
38927,1,1,136638,136640,136641,2,3,0
38928,3,1,136641,136641,136642,0,1,0
38929,5,1,136646,136646,136647,0,1,4
38930,4,3,136650,136650,136653,0,3,3
38931,3,1,136653,136653,136654,0,1,0
38932,6,1,136659,136659,136660,0,1,5
38933,2,3,136661,136661,136664,0,3,1
38934,2,2,136663,136664,136666,1,3,0
38935,6,3,136669,136669,136672,0,3,3
38936,5,2,136674,136674,136676,0,2,2
38937,5,1,136679,136679,136680,0,1,3
38938,2,2,136681,136681,136683,0,2,1
38939,6,3,136687,136687,136690,0,3,4
38940,6,2,136693,136693,136695,0,2,3
38941,2,3,136695,136695,136698,0,3,0
38942,3,3,136698,136698,136701,0,3,0
38943,2,3,136700,136701,136704,1,4,0
38944,2,2,136702,136704,136706,2,4,0
38945,4,1,136706,136706,136707,0,1,0
38946,3,2,136709,136709,136711,0,2,2
38947,4,1,136713,136713,136714,0,1,2
38948,2,2,136715,136715,136717,0,2,1
38949,4,1,136719,136719,136720,0,1,2
38950,2,2,136721,136721,136723,0,2,1
38951,1,1,136722,136723,136724,1,2,0
38952,6,3,136728,136728,136731,0,3,4
38953,1,1,136729,136731,136732,2,3,0
38954,5,3,136734,136734,136737,0,3,2
38955,3,1,136737,136737,136738,0,1,0
38956,4,2,136741,136741,136743,0,2,3
38957,2,3,136743,136743,136746,0,3,0
38958,1,1,136744,136746,136747,2,3,0
38959,6,2,136750,136750,136752,0,2,3
38960,5,1,136755,136755,136756,0,1,3
38961,6,3,136761,136761,136764,0,3,5
38962,1,1,136762,136764,136765,2,3,0
38963,6,2,136768,136768,136770,0,2,3
38964,2,2,136770,136770,136772,0,2,0
38965,2,1,136772,136772,136773,0,1,0
38966,3,2,136775,136775,136777,0,2,2
38967,6,3,136781,136781,136784,0,3,4
38968,6,2,136787,136787,136789,0,2,3
38969,4,2,136791,136791,136793,0,2,2
38970,4,1,136795,136795,136796,0,1,2
38971,2,2,136797,136797,136799,0,2,1
38972,5,3,136802,136802,136805,0,3,3
38973,6,3,136808,136808,136811,0,3,3
38974,2,3,136810,136811,136814,1,4,0
38975,2,3,136812,136814,136817,2,5,0
38976,2,3,136814,136817,136820,3,6,0
38977,4,3,136818,136820,136823,2,5,0
38978,6,3,136824,136824,136827,0,3,1
38979,2,1,136826,136827,136828,1,2,0
38980,5,2,136831,136831,136833,0,2,3
38981,2,2,136833,136833,136835,0,2,0
38982,3,1,136836,136836,136837,0,1,1
38983,6,2,136842,136842,136844,0,2,5
38984,1,2,136843,136844,136846,1,3,0
38985,2,1,136845,136846,136847,1,2,0
38986,2,2,136847,136847,136849,0,2,0
38987,2,1,136849,136849,136850,0,1,0
38988,1,3,136850,136850,136853,0,3,0
38989,1,1,136851,136853,136854,2,3,0
38990,3,3,136854,136854,136857,0,3,0
38991,4,3,136858,136858,136861,0,3,1
38992,6,2,136864,136864,136866,0,2,3
38993,4,2,136868,136868,136870,0,2,2
38994,4,3,136872,136872,136875,0,3,2
38995,5,3,136877,136877,136880,0,3,2
38996,2,2,136879,136880,136882,1,3,0
38997,4,1,136883,136883,136884,0,1,1
38998,1,2,136884,136884,136886,0,2,0
38999,4,1,136888,136888,136889,0,1,2
39000,2,3,136890,136890,136893,0,3,1
39001,1,1,136891,136893,136894,2,3,0
39002,2,3,136893,136894,136897,1,4,0
39003,4,2,136897,136897,136899,0,2,0
39004,5,2,136902,136902,136904,0,2,3
39005,5,3,136907,136907,136910,0,3,3
39006,4,2,136911,136911,136913,0,2,1
39007,1,3,136912,136913,136916,1,4,0
39008,5,3,136917,136917,136920,0,3,1
39009,2,2,136919,136920,136922,1,3,0
39010,5,3,136924,136924,136927,0,3,2
39011,4,1,136928,136928,136929,0,1,1
39012,5,3,136933,136933,136936,0,3,4
39013,2,3,136935,136936,136939,1,4,0
39014,5,2,136940,136940,136942,0,2,1
39015,4,1,136944,136944,136945,0,1,2
39016,5,2,136949,136949,136951,0,2,4
39017,1,1,136950,136951,136952,1,2,0
39018,1,1,136951,136952,136953,1,2,0
39019,2,3,136953,136953,136956,0,3,0
39020,1,3,136954,136956,136959,2,5,0
39021,3,3,136957,136959,136962,2,5,0
39022,1,1,136958,136962,136963,4,5,0
39023,4,1,136962,136963,136964,1,2,0
39024,5,2,136967,136967,136969,0,2,3
39025,6,3,136973,136973,136976,0,3,4
39026,4,1,136977,136977,136978,0,1,1
39027,6,3,136983,136983,136986,0,3,5
39028,6,1,136989,136989,136990,0,1,3
39029,1,3,136990,136990,136993,0,3,0
39030,3,1,136993,136993,136994,0,1,0
39031,2,2,136995,136995,136997,0,2,1
39032,2,3,136997,136997,137000,0,3,0
39033,5,2,137002,137002,137004,0,2,2
39034,4,1,137006,137006,137007,0,1,2
39035,1,2,137007,137007,137009,0,2,0
39036,5,2,137012,137012,137014,0,2,3
39037,3,2,137015,137015,137017,0,2,1
39038,5,2,137020,137020,137022,0,2,3
39039,4,2,137024,137024,137026,0,2,2
39040,2,3,137026,137026,137029,0,3,0
39041,6,1,137032,137032,137033,0,1,3
39042,1,1,137033,137033,137034,0,1,0
39043,6,1,137039,137039,137040,0,1,5
39044,3,2,137042,137042,137044,0,2,2
39045,2,1,137044,137044,137045,0,1,0
39046,6,1,137050,137050,137051,0,1,5
39047,5,2,137055,137055,137057,0,2,4
39048,3,1,137058,137058,137059,0,1,1
39049,3,2,137061,137061,137063,0,2,2
39050,6,3,137067,137067,137070,0,3,4
39051,1,2,137068,137070,137072,2,4,0
39052,1,3,137069,137072,137075,3,6,0
39053,6,2,137075,137075,137077,0,2,0
39054,6,3,137081,137081,137084,0,3,4
39055,2,2,137083,137084,137086,1,3,0
39056,6,1,137089,137089,137090,0,1,3
39057,2,3,137091,137091,137094,0,3,1
39058,4,2,137095,137095,137097,0,2,1
39059,1,2,137096,137097,137099,1,3,0
39060,3,2,137099,137099,137101,0,2,0
39061,5,1,137104,137104,137105,0,1,3
39062,4,3,137108,137108,137111,0,3,3
39063,4,1,137112,137112,137113,0,1,1
39064,1,2,137113,137113,137115,0,2,0
39065,1,2,137114,137115,137117,1,3,0
39066,5,1,137119,137119,137120,0,1,2
39067,2,1,137121,137121,137122,0,1,1
39068,2,2,137123,137123,137125,0,2,1
39069,2,3,137125,137125,137128,0,3,0
39070,4,3,137129,137129,137132,0,3,1
39071,1,3,137130,137132,137135,2,5,0
39072,6,2,137136,137136,137138,0,2,1
39073,5,2,137141,137141,137143,0,2,3
39074,5,1,137146,137146,137147,0,1,3
39075,1,2,137147,137147,137149,0,2,0
39076,3,2,137150,137150,137152,0,2,1
39077,3,2,137153,137153,137155,0,2,1
39078,3,2,137156,137156,137158,0,2,1
39079,3,3,137159,137159,137162,0,3,1
39080,5,2,137164,137164,137166,0,2,2
39081,4,1,137168,137168,137169,0,1,2
39082,1,2,137169,137169,137171,0,2,0
39083,5,1,137174,137174,137175,0,1,3
39084,2,3,137176,137176,137179,0,3,1
39085,1,2,137177,137179,137181,2,4,0
39086,1,2,137178,137181,137183,3,5,0
39087,4,3,137182,137183,137186,1,4,0
39088,2,3,137184,137186,137189,2,5,0
39089,5,2,137189,137189,137191,0,2,0
39090,3,2,137192,137192,137194,0,2,1
39091,5,1,137197,137197,137198,0,1,3
39092,1,2,137198,137198,137200,0,2,0
39093,5,3,137203,137203,137206,0,3,3
39094,2,2,137205,137206,137208,1,3,0
39095,2,1,137207,137208,137209,1,2,0
39096,5,2,137212,137212,137214,0,2,3
39097,5,1,137217,137217,137218,0,1,3
39098,5,2,137222,137222,137224,0,2,4
39099,3,1,137225,137225,137226,0,1,1
39100,1,3,137226,137226,137229,0,3,0
39101,6,1,137232,137232,137233,0,1,3
39102,1,3,137233,137233,137236,0,3,0
39103,6,2,137239,137239,137241,0,2,3
39104,2,2,137241,137241,137243,0,2,0
39105,1,2,137242,137243,137245,1,3,0
39106,1,1,137243,137245,137246,2,3,0
39107,2,3,137245,137246,137249,1,4,0
39108,5,2,137250,137250,137252,0,2,1
39109,1,3,137251,137252,137255,1,4,0
39110,2,3,137253,137255,137258,2,5,0
39111,4,1,137257,137258,137259,1,2,0
39112,1,1,137258,137259,137260,1,2,0
39113,6,2,137264,137264,137266,0,2,4
39114,6,1,137270,137270,137271,0,1,4
39115,4,2,137274,137274,137276,0,2,3
39116,6,1,137280,137280,137281,0,1,4
39117,3,1,137283,137283,137284,0,1,2
39118,2,1,137285,137285,137286,0,1,1
39119,4,3,137289,137289,137292,0,3,3
39120,5,1,137294,137294,137295,0,1,2
39121,6,2,137300,137300,137302,0,2,5
39122,4,2,137304,137304,137306,0,2,2
39123,6,1,137310,137310,137311,0,1,4
39124,1,1,137311,137311,137312,0,1,0
39125,6,1,137317,137317,137318,0,1,5
39126,2,2,137319,137319,137321,0,2,1
39127,4,1,137323,137323,137324,0,1,2
39128,2,1,137325,137325,137326,0,1,1
39129,2,3,137327,137327,137330,0,3,1
39130,1,1,137328,137330,137331,2,3,0
39131,4,1,137332,137332,137333,0,1,1
39132,2,3,137334,137334,137337,0,3,1
39133,2,3,137336,137337,137340,1,4,0
39134,6,3,137342,137342,137345,0,3,2
39135,4,2,137346,137346,137348,0,2,1
39136,2,2,137348,137348,137350,0,2,0
39137,5,3,137353,137353,137356,0,3,3
39138,1,1,137354,137356,137357,2,3,0
39139,6,2,137360,137360,137362,0,2,3
39140,6,1,137366,137366,137367,0,1,4
39141,5,1,137371,137371,137372,0,1,4
39142,1,1,137372,137372,137373,0,1,0
39143,4,1,137376,137376,137377,0,1,3
39144,2,2,137378,137378,137380,0,2,1
39145,2,2,137380,137380,137382,0,2,0
39146,2,1,137382,137382,137383,0,1,0
39147,4,2,137386,137386,137388,0,2,3
39148,1,2,137387,137388,137390,1,3,0
39149,6,1,137393,137393,137394,0,1,3
39150,3,2,137396,137396,137398,0,2,2
39151,3,1,137399,137399,137400,0,1,1
39152,6,1,137405,137405,137406,0,1,5
39153,5,1,137410,137410,137411,0,1,4
39154,6,3,137416,137416,137419,0,3,5
39155,5,3,137421,137421,137424,0,3,2
39156,2,1,137423,137424,137425,1,2,0
39157,3,1,137426,137426,137427,0,1,1
39158,3,1,137429,137429,137430,0,1,2
39159,1,1,137430,137430,137431,0,1,0
39160,3,1,137433,137433,137434,0,1,2
39161,1,2,137434,137434,137436,0,2,0
39162,3,2,137437,137437,137439,0,2,1
39163,6,3,137443,137443,137446,0,3,4
39164,3,3,137446,137446,137449,0,3,0
39165,5,2,137451,137451,137453,0,2,2
39166,5,3,137456,137456,137459,0,3,3
39167,3,1,137459,137459,137460,0,1,0
39168,4,2,137463,137463,137465,0,2,3
39169,4,3,137467,137467,137470,0,3,2
39170,2,3,137469,137470,137473,1,4,0
39171,4,3,137473,137473,137476,0,3,0
39172,6,1,137479,137479,137480,0,1,3
39173,4,3,137483,137483,137486,0,3,3
39174,5,3,137488,137488,137491,0,3,2
39175,2,2,137490,137491,137493,1,3,0
39176,5,1,137495,137495,137496,0,1,2
39177,1,2,137496,137496,137498,0,2,0
39178,1,2,137497,137498,137500,1,3,0
39179,5,2,137502,137502,137504,0,2,2
39180,3,1,137505,137505,137506,0,1,1
39181,5,2,137510,137510,137512,0,2,4
39182,2,3,137512,137512,137515,0,3,0
39183,5,3,137517,137517,137520,0,3,2
39184,3,3,137520,137520,137523,0,3,0
39185,5,1,137525,137525,137526,0,1,2
39186,4,1,137529,137529,137530,0,1,3
39187,2,3,137531,137531,137534,0,3,1
39188,2,1,137533,137534,137535,1,2,0
39189,4,2,137537,137537,137539,0,2,2
39190,2,3,137539,137539,137542,0,3,0
39191,3,2,137542,137542,137544,0,2,0
39192,5,2,137547,137547,137549,0,2,3
39193,3,1,137550,137550,137551,0,1,1
39194,5,2,137555,137555,137557,0,2,4
39195,4,2,137559,137559,137561,0,2,2
39196,2,2,137561,137561,137563,0,2,0
39197,6,3,137567,137567,137570,0,3,4
39198,5,2,137572,137572,137574,0,2,2
39199,6,1,137578,137578,137579,0,1,4
39200,4,2,137582,137582,137584,0,2,3
39201,3,2,137585,137585,137587,0,2,1
39202,3,2,137588,137588,137590,0,2,1
39203,3,3,137591,137591,137594,0,3,1
39204,5,2,137596,137596,137598,0,2,2
39205,4,3,137600,137600,137603,0,3,2
39206,6,3,137606,137606,137609,0,3,3
39207,6,1,137612,137612,137613,0,1,3
39208,1,2,137613,137613,137615,0,2,0
39209,5,1,137618,137618,137619,0,1,3
39210,4,1,137622,137622,137623,0,1,3
39211,6,1,137628,137628,137629,0,1,5
39212,6,1,137634,137634,137635,0,1,5
39213,5,2,137639,137639,137641,0,2,4
39214,1,2,137640,137641,137643,1,3,0
39215,4,1,137644,137644,137645,0,1,1
39216,1,3,137645,137645,137648,0,3,0
39217,6,1,137651,137651,137652,0,1,3
39218,5,3,137656,137656,137659,0,3,4
39219,1,3,137657,137659,137662,2,5,0
39220,4,2,137661,137662,137664,1,3,0
39221,2,3,137663,137664,137667,1,4,0
39222,5,1,137668,137668,137669,0,1,1
39223,5,3,137673,137673,137676,0,3,4
39224,1,3,137674,137676,137679,2,5,0
39225,1,3,137675,137679,137682,4,7,0
39226,5,3,137680,137682,137685,2,5,0
39227,1,2,137681,137685,137687,4,6,0
39228,1,2,137682,137687,137689,5,7,0
39229,4,3,137686,137689,137692,3,6,0
39230,2,3,137688,137692,137695,4,7,0
39231,3,1,137691,137695,137696,4,5,0
39232,1,3,137692,137696,137699,4,7,0
39233,1,2,137693,137699,137701,6,8,0
39234,3,1,137696,137701,137702,5,6,0
39235,6,1,137702,137702,137703,0,1,0
39236,3,1,137705,137705,137706,0,1,2
39237,5,2,137710,137710,137712,0,2,4
39238,5,2,137715,137715,137717,0,2,3
39239,2,2,137717,137717,137719,0,2,0
39240,1,3,137718,137719,137722,1,4,0
39241,6,3,137724,137724,137727,0,3,2
39242,5,2,137729,137729,137731,0,2,2
39243,5,2,137734,137734,137736,0,2,3
39244,4,2,137738,137738,137740,0,2,2
39245,4,3,137742,137742,137745,0,3,2
39246,4,3,137746,137746,137749,0,3,1
39247,2,1,137748,137749,137750,1,2,0
39248,1,1,137749,137750,137751,1,2,0
39249,3,3,137752,137752,137755,0,3,1
39250,4,2,137756,137756,137758,0,2,1
39251,5,2,137761,137761,137763,0,2,3
39252,2,2,137763,137763,137765,0,2,0
39253,6,2,137769,137769,137771,0,2,4
39254,5,2,137774,137774,137776,0,2,3
39255,4,1,137778,137778,137779,0,1,2
39256,5,1,137783,137783,137784,0,1,4
39257,3,1,137786,137786,137787,0,1,2
39258,6,2,137792,137792,137794,0,2,5
39259,1,3,137793,137794,137797,1,4,0
39260,4,2,137797,137797,137799,0,2,0
39261,3,1,137800,137800,137801,0,1,1
39262,3,3,137803,137803,137806,0,3,2
39263,5,2,137808,137808,137810,0,2,2
39264,3,2,137811,137811,137813,0,2,1
39265,6,2,137817,137817,137819,0,2,4
39266,4,3,137821,137821,137824,0,3,2
39267,1,2,137822,137824,137826,2,4,0
39268,6,2,137828,137828,137830,0,2,2
39269,6,2,137834,137834,137836,0,2,4
39270,5,3,137839,137839,137842,0,3,3
39271,4,2,137843,137843,137845,0,2,1
39272,5,2,137848,137848,137850,0,2,3
39273,1,3,137849,137850,137853,1,4,0
39274,3,3,137852,137853,137856,1,4,0
39275,6,2,137858,137858,137860,0,2,2
39276,3,2,137861,137861,137863,0,2,1
39277,2,3,137863,137863,137866,0,3,0
39278,2,2,137865,137866,137868,1,3,0
39279,5,1,137870,137870,137871,0,1,2
39280,6,3,137876,137876,137879,0,3,5
39281,2,1,137878,137879,137880,1,2,0
39282,6,2,137884,137884,137886,0,2,4
39283,1,2,137885,137886,137888,1,3,0
39284,4,2,137889,137889,137891,0,2,1
39285,1,1,137890,137891,137892,1,2,0
39286,4,3,137894,137894,137897,0,3,2
39287,2,3,137896,137897,137900,1,4,0
39288,2,1,137898,137900,137901,2,3,0
39289,6,2,137904,137904,137906,0,2,3
39290,3,2,137907,137907,137909,0,2,1
39291,5,1,137912,137912,137913,0,1,3
39292,4,3,137916,137916,137919,0,3,3
39293,2,3,137918,137919,137922,1,4,0
39294,3,3,137921,137922,137925,1,4,0
39295,6,2,137927,137927,137929,0,2,2
39296,2,2,137929,137929,137931,0,2,0
39297,3,2,137932,137932,137934,0,2,1
39298,5,3,137937,137937,137940,0,3,3
39299,4,2,137941,137941,137943,0,2,1
39300,1,2,137942,137943,137945,1,3,0
39301,4,2,137946,137946,137948,0,2,1
39302,5,2,137951,137951,137953,0,2,3
39303,2,3,137953,137953,137956,0,3,0
39304,2,1,137955,137956,137957,1,2,0
39305,4,1,137959,137959,137960,0,1,2
39306,1,3,137960,137960,137963,0,3,0
39307,6,2,137966,137966,137968,0,2,3
39308,6,2,137972,137972,137974,0,2,4
39309,2,3,137974,137974,137977,0,3,0
39310,6,3,137980,137980,137983,0,3,3
39311,1,2,137981,137983,137985,2,4,0
39312,2,3,137983,137985,137988,2,5,0
39313,2,2,137985,137988,137990,3,5,0
39314,6,3,137991,137991,137994,0,3,1
39315,2,2,137993,137994,137996,1,3,0
39316,4,2,137997,137997,137999,0,2,1
39317,1,1,137998,137999,138000,1,2,0
39318,2,3,138000,138000,138003,0,3,0
39319,2,3,138002,138003,138006,1,4,0
39320,6,2,138008,138008,138010,0,2,2
39321,2,1,138010,138010,138011,0,1,0
39322,4,3,138014,138014,138017,0,3,3
39323,3,1,138017,138017,138018,0,1,0
39324,1,1,138018,138018,138019,0,1,0
39325,2,2,138020,138020,138022,0,2,1
39326,5,2,138025,138025,138027,0,2,3
39327,2,1,138027,138027,138028,0,1,0
39328,2,1,138029,138029,138030,0,1,1
39329,1,3,138030,138030,138033,0,3,0
39330,1,2,138031,138033,138035,2,4,0
39331,4,3,138035,138035,138038,0,3,0
39332,2,1,138037,138038,138039,1,2,0
39333,6,1,138043,138043,138044,0,1,4
39334,1,3,138044,138044,138047,0,3,0
39335,1,2,138045,138047,138049,2,4,0
39336,6,2,138051,138051,138053,0,2,2
39337,1,2,138052,138053,138055,1,3,0
39338,5,3,138057,138057,138060,0,3,2
39339,5,2,138062,138062,138064,0,2,2
39340,5,2,138067,138067,138069,0,2,3
39341,2,1,138069,138069,138070,0,1,0
39342,2,1,138071,138071,138072,0,1,1
39343,3,1,138074,138074,138075,0,1,2
39344,1,3,138075,138075,138078,0,3,0
39345,2,2,138077,138078,138080,1,3,0
39346,1,2,138078,138080,138082,2,4,0
39347,2,1,138080,138082,138083,2,3,0
39348,6,3,138086,138086,138089,0,3,3
39349,1,2,138087,138089,138091,2,4,0
39350,4,3,138091,138091,138094,0,3,0
39351,6,2,138097,138097,138099,0,2,3
39352,1,1,138098,138099,138100,1,2,0
39353,1,2,138099,138100,138102,1,3,0
39354,3,1,138102,138102,138103,0,1,0
39355,2,3,138104,138104,138107,0,3,1
39356,2,2,138106,138107,138109,1,3,0
39357,1,1,138107,138109,138110,2,3,0
39358,1,3,138108,138110,138113,2,5,0
39359,6,3,138114,138114,138117,0,3,1
39360,2,3,138116,138117,138120,1,4,0
39361,1,1,138117,138120,138121,3,4,0
39362,1,1,138118,138121,138122,3,4,0
39363,6,3,138124,138124,138127,0,3,2
39364,2,1,138126,138127,138128,1,2,0
39365,4,1,138130,138130,138131,0,1,2
39366,3,1,138133,138133,138134,0,1,2
39367,2,2,138135,138135,138137,0,2,1
39368,4,3,138139,138139,138142,0,3,2
39369,1,2,138140,138142,138144,2,4,0
39370,6,2,138146,138146,138148,0,2,2
39371,4,2,138150,138150,138152,0,2,2
39372,1,1,138151,138152,138153,1,2,0
39373,2,3,138153,138153,138156,0,3,0
39374,3,1,138156,138156,138157,0,1,0
39375,2,2,138158,138158,138160,0,2,1
39376,3,1,138161,138161,138162,0,1,1
39377,3,1,138164,138164,138165,0,1,2
39378,5,1,138169,138169,138170,0,1,4
39379,4,3,138173,138173,138176,0,3,3
39380,1,1,138174,138176,138177,2,3,0
39381,1,1,138175,138177,138178,2,3,0
39382,2,2,138177,138178,138180,1,3,0
39383,3,3,138180,138180,138183,0,3,0
39384,5,1,138185,138185,138186,0,1,2
39385,6,1,138191,138191,138192,0,1,5
39386,2,1,138193,138193,138194,0,1,1
39387,4,3,138197,138197,138200,0,3,3
39388,3,2,138200,138200,138202,0,2,0
39389,3,2,138203,138203,138205,0,2,1
39390,6,2,138209,138209,138211,0,2,4
39391,4,1,138213,138213,138214,0,1,2
39392,5,2,138218,138218,138220,0,2,4
39393,2,1,138220,138220,138221,0,1,0
39394,4,1,138224,138224,138225,0,1,3
39395,2,2,138226,138226,138228,0,2,1
39396,4,1,138230,138230,138231,0,1,2
39397,6,1,138236,138236,138237,0,1,5
39398,1,1,138237,138237,138238,0,1,0
39399,6,3,138243,138243,138246,0,3,5
39400,5,2,138248,138248,138250,0,2,2
39401,3,3,138251,138251,138254,0,3,1
39402,3,3,138254,138254,138257,0,3,0
39403,6,2,138260,138260,138262,0,2,3
39404,1,2,138261,138262,138264,1,3,0
39405,3,2,138264,138264,138266,0,2,0
39406,2,1,138266,138266,138267,0,1,0
39407,1,3,138267,138267,138270,0,3,0
39408,6,1,138273,138273,138274,0,1,3
39409,4,1,138277,138277,138278,0,1,3
39410,1,2,138278,138278,138280,0,2,0
39411,2,3,138280,138280,138283,0,3,0
39412,5,1,138285,138285,138286,0,1,2
39413,1,1,138286,138286,138287,0,1,0
39414,6,1,138292,138292,138293,0,1,5
39415,3,3,138295,138295,138298,0,3,2
39416,1,3,138296,138298,138301,2,5,0
39417,3,1,138299,138301,138302,2,3,0
39418,6,1,138305,138305,138306,0,1,3
39419,3,3,138308,138308,138311,0,3,2
39420,5,1,138313,138313,138314,0,1,2
39421,6,3,138319,138319,138322,0,3,5
39422,4,2,138323,138323,138325,0,2,1
39423,1,2,138324,138325,138327,1,3,0
39424,6,3,138330,138330,138333,0,3,3
39425,3,3,138333,138333,138336,0,3,0
39426,6,3,138339,138339,138342,0,3,3
39427,2,1,138341,138342,138343,1,2,0
39428,2,1,138343,138343,138344,0,1,0
39429,1,1,138344,138344,138345,0,1,0
39430,4,1,138348,138348,138349,0,1,3
39431,5,1,138353,138353,138354,0,1,4
39432,2,1,138355,138355,138356,0,1,1
39433,2,1,138357,138357,138358,0,1,1
39434,2,1,138359,138359,138360,0,1,1
39435,1,1,138360,138360,138361,0,1,0
39436,4,1,138364,138364,138365,0,1,3
39437,2,3,138366,138366,138369,0,3,1
39438,5,2,138371,138371,138373,0,2,2
39439,1,1,138372,138373,138374,1,2,0
39440,5,3,138377,138377,138380,0,3,3
39441,2,1,138379,138380,138381,1,2,0
39442,2,3,138381,138381,138384,0,3,0
39443,2,3,138383,138384,138387,1,4,0
39444,4,2,138387,138387,138389,0,2,0
39445,6,1,138393,138393,138394,0,1,4
39446,5,3,138398,138398,138401,0,3,4
39447,5,3,138403,138403,138406,0,3,2
39448,3,1,138406,138406,138407,0,1,0
39449,5,1,138411,138411,138412,0,1,4
39450,5,3,138416,138416,138419,0,3,4
39451,1,2,138417,138419,138421,2,4,0
39452,2,3,138419,138421,138424,2,5,0
39453,2,1,138421,138424,138425,3,4,0
39454,2,3,138423,138425,138428,2,5,0
39455,3,2,138426,138428,138430,2,4,0
39456,3,1,138429,138430,138431,1,2,0
39457,1,1,138430,138431,138432,1,2,0
39458,3,3,138433,138433,138436,0,3,1
39459,4,2,138437,138437,138439,0,2,1
39460,5,2,138442,138442,138444,0,2,3
39461,5,1,138447,138447,138448,0,1,3
39462,2,3,138449,138449,138452,0,3,1
39463,6,1,138455,138455,138456,0,1,3
39464,5,3,138460,138460,138463,0,3,4
39465,5,2,138465,138465,138467,0,2,2
39466,2,3,138467,138467,138470,0,3,0
39467,1,3,138468,138470,138473,2,5,0
39468,1,1,138469,138473,138474,4,5,0
39469,3,3,138472,138474,138477,2,5,0
39470,4,2,138476,138477,138479,1,3,0
39471,1,3,138477,138479,138482,2,5,0
39472,4,3,138481,138482,138485,1,4,0
39473,6,1,138487,138487,138488,0,1,2
39474,1,1,138488,138488,138489,0,1,0
39475,3,3,138491,138491,138494,0,3,2
39476,3,1,138494,138494,138495,0,1,0
39477,5,2,138499,138499,138501,0,2,4
39478,1,1,138500,138501,138502,1,2,0
39479,4,3,138504,138504,138507,0,3,2
39480,4,1,138508,138508,138509,0,1,1
39481,3,3,138511,138511,138514,0,3,2
39482,4,3,138515,138515,138518,0,3,1
39483,5,2,138520,138520,138522,0,2,2
39484,5,3,138525,138525,138528,0,3,3
39485,2,3,138527,138528,138531,1,4,0
39486,4,2,138531,138531,138533,0,2,0
39487,5,3,138536,138536,138539,0,3,3
39488,6,1,138542,138542,138543,0,1,3
39489,3,3,138545,138545,138548,0,3,2
39490,5,1,138550,138550,138551,0,1,2
39491,4,1,138554,138554,138555,0,1,3
39492,1,3,138555,138555,138558,0,3,0
39493,4,3,138559,138559,138562,0,3,1
39494,1,3,138560,138562,138565,2,5,0
39495,2,2,138562,138565,138567,3,5,0
39496,6,1,138568,138568,138569,0,1,1
39497,2,3,138570,138570,138573,0,3,1
39498,3,3,138573,138573,138576,0,3,0
39499,4,1,138577,138577,138578,0,1,1
39500,2,2,138579,138579,138581,0,2,1
39501,4,2,138583,138583,138585,0,2,2
39502,4,3,138587,138587,138590,0,3,2
39503,1,1,138588,138590,138591,2,3,0
39504,2,2,138590,138591,138593,1,3,0
39505,1,1,138591,138593,138594,2,3,0
39506,1,1,138592,138594,138595,2,3,0
39507,3,2,138595,138595,138597,0,2,0
39508,4,3,138599,138599,138602,0,3,2
39509,4,2,138603,138603,138605,0,2,1
39510,1,1,138604,138605,138606,1,2,0
39511,4,2,138608,138608,138610,0,2,2
39512,5,1,138613,138613,138614,0,1,3
39513,3,1,138616,138616,138617,0,1,2
39514,6,2,138622,138622,138624,0,2,5
39515,4,2,138626,138626,138628,0,2,2
39516,3,1,138629,138629,138630,0,1,1
39517,3,3,138632,138632,138635,0,3,2
39518,4,3,138636,138636,138639,0,3,1
39519,5,3,138641,138641,138644,0,3,2
39520,1,1,138642,138644,138645,2,3,0
39521,2,2,138644,138645,138647,1,3,0
39522,6,2,138650,138650,138652,0,2,3
39523,2,2,138652,138652,138654,0,2,0
39524,1,2,138653,138654,138656,1,3,0
39525,3,1,138656,138656,138657,0,1,0
39526,6,2,138662,138662,138664,0,2,5
39527,2,1,138664,138664,138665,0,1,0
39528,6,3,138670,138670,138673,0,3,5
39529,1,3,138671,138673,138676,2,5,0
39530,6,2,138677,138677,138679,0,2,1
39531,5,3,138682,138682,138685,0,3,3
39532,5,2,138687,138687,138689,0,2,2
39533,4,2,138691,138691,138693,0,2,2
39534,5,2,138696,138696,138698,0,2,3
39535,1,3,138697,138698,138701,1,4,0
39536,3,3,138700,138701,138704,1,4,0
39537,5,1,138705,138705,138706,0,1,1
39538,6,3,138711,138711,138714,0,3,5
39539,5,1,138716,138716,138717,0,1,2
39540,6,3,138722,138722,138725,0,3,5
39541,5,1,138727,138727,138728,0,1,2
39542,3,2,138730,138730,138732,0,2,2
39543,6,3,138736,138736,138739,0,3,4
39544,3,2,138739,138739,138741,0,2,0
39545,6,3,138745,138745,138748,0,3,4
39546,5,3,138750,138750,138753,0,3,2
39547,1,3,138751,138753,138756,2,5,0
39548,4,2,138755,138756,138758,1,3,0
39549,4,3,138759,138759,138762,0,3,1
39550,6,2,138765,138765,138767,0,2,3
39551,6,2,138771,138771,138773,0,2,4
39552,1,2,138772,138773,138775,1,3,0
39553,3,2,138775,138775,138777,0,2,0
39554,2,3,138777,138777,138780,0,3,0
39555,6,2,138783,138783,138785,0,2,3
39556,4,3,138787,138787,138790,0,3,2
39557,2,1,138789,138790,138791,1,2,0
39558,1,2,138790,138791,138793,1,3,0
39559,4,3,138794,138794,138797,0,3,1
39560,2,2,138796,138797,138799,1,3,0
39561,1,2,138797,138799,138801,2,4,0
39562,3,1,138800,138801,138802,1,2,0
39563,3,3,138803,138803,138806,0,3,1
39564,1,2,138804,138806,138808,2,4,0
39565,4,2,138808,138808,138810,0,2,0
39566,1,1,138809,138810,138811,1,2,0
39567,3,2,138812,138812,138814,0,2,1
39568,2,1,138814,138814,138815,0,1,0
39569,1,2,138815,138815,138817,0,2,0
39570,2,1,138817,138817,138818,0,1,0
39571,6,1,138823,138823,138824,0,1,5
39572,2,3,138825,138825,138828,0,3,1
39573,2,3,138827,138828,138831,1,4,0
39574,4,3,138831,138831,138834,0,3,0
39575,2,3,138833,138834,138837,1,4,0
39576,1,2,138834,138837,138839,3,5,0
39577,1,3,138835,138839,138842,4,7,0
39578,3,3,138838,138842,138845,4,7,0
39579,3,2,138841,138845,138847,4,6,0
39580,5,2,138846,138847,138849,1,3,0
39581,2,3,138848,138849,138852,1,4,0
39582,5,1,138853,138853,138854,0,1,1
39583,2,2,138855,138855,138857,0,2,1
39584,6,1,138861,138861,138862,0,1,4
39585,3,1,138864,138864,138865,0,1,2
39586,5,3,138869,138869,138872,0,3,4
39587,3,3,138872,138872,138875,0,3,0
39588,5,3,138877,138877,138880,0,3,2
39589,6,3,138883,138883,138886,0,3,3
39590,1,1,138884,138886,138887,2,3,0
39591,4,3,138888,138888,138891,0,3,1
39592,1,2,138889,138891,138893,2,4,0
39593,6,3,138895,138895,138898,0,3,2
39594,3,2,138898,138898,138900,0,2,0
39595,5,3,138903,138903,138906,0,3,3
39596,4,1,138907,138907,138908,0,1,1
39597,2,3,138909,138909,138912,0,3,1
39598,3,1,138912,138912,138913,0,1,0
39599,2,3,138914,138914,138917,0,3,1
39600,3,1,138917,138917,138918,0,1,0
39601,2,3,138919,138919,138922,0,3,1
39602,6,1,138925,138925,138926,0,1,3
39603,2,3,138927,138927,138930,0,3,1
39604,3,2,138930,138930,138932,0,2,0
39605,5,3,138935,138935,138938,0,3,3
39606,2,1,138937,138938,138939,1,2,0
39607,5,3,138942,138942,138945,0,3,3
39608,1,3,138943,138945,138948,2,5,0
39609,3,3,138946,138948,138951,2,5,0
39610,5,3,138951,138951,138954,0,3,0
39611,4,1,138955,138955,138956,0,1,1
39612,5,1,138960,138960,138961,0,1,4
39613,2,2,138962,138962,138964,0,2,1
39614,3,1,138965,138965,138966,0,1,1
39615,6,2,138971,138971,138973,0,2,5
39616,1,3,138972,138973,138976,1,4,0
39617,3,2,138975,138976,138978,1,3,0
39618,3,3,138978,138978,138981,0,3,0
39619,2,2,138980,138981,138983,1,3,0
39620,3,3,138983,138983,138986,0,3,0
39621,6,2,138989,138989,138991,0,2,3
39622,3,2,138992,138992,138994,0,2,1
39623,4,2,138996,138996,138998,0,2,2
39624,1,3,138997,138998,139001,1,4,0
39625,4,2,139001,139001,139003,0,2,0
39626,3,3,139004,139004,139007,0,3,1
39627,5,1,139009,139009,139010,0,1,2
39628,6,2,139015,139015,139017,0,2,5
39629,5,2,139020,139020,139022,0,2,3
39630,6,1,139026,139026,139027,0,1,4
39631,1,3,139027,139027,139030,0,3,0
39632,3,1,139030,139030,139031,0,1,0
39633,5,1,139035,139035,139036,0,1,4
39634,6,1,139041,139041,139042,0,1,5
39635,1,3,139042,139042,139045,0,3,0
39636,4,3,139046,139046,139049,0,3,1
39637,1,3,139047,139049,139052,2,5,0
39638,6,1,139053,139053,139054,0,1,1
39639,1,1,139054,139054,139055,0,1,0
39640,1,1,139055,139055,139056,0,1,0
39641,5,3,139060,139060,139063,0,3,4
39642,4,1,139064,139064,139065,0,1,1
39643,1,1,139065,139065,139066,0,1,0
39644,4,1,139069,139069,139070,0,1,3
39645,5,2,139074,139074,139076,0,2,4
39646,4,3,139078,139078,139081,0,3,2
39647,4,1,139082,139082,139083,0,1,1
39648,3,1,139085,139085,139086,0,1,2
39649,1,3,139086,139086,139089,0,3,0
39650,3,1,139089,139089,139090,0,1,0
39651,4,3,139093,139093,139096,0,3,3
39652,3,1,139096,139096,139097,0,1,0
39653,3,3,139099,139099,139102,0,3,2
39654,5,1,139104,139104,139105,0,1,2
39655,2,2,139106,139106,139108,0,2,1
39656,6,1,139112,139112,139113,0,1,4
39657,5,1,139117,139117,139118,0,1,4
39658,6,2,139123,139123,139125,0,2,5
39659,3,1,139126,139126,139127,0,1,1
39660,1,1,139127,139127,139128,0,1,0
39661,1,3,139128,139128,139131,0,3,0
39662,6,2,139134,139134,139136,0,2,3
39663,5,3,139139,139139,139142,0,3,3
39664,3,1,139142,139142,139143,0,1,0
39665,1,3,139143,139143,139146,0,3,0
39666,4,1,139147,139147,139148,0,1,1
39667,1,1,139148,139148,139149,0,1,0
39668,3,3,139151,139151,139154,0,3,2
39669,2,3,139153,139154,139157,1,4,0
39670,2,2,139155,139157,139159,2,4,0
39671,5,2,139160,139160,139162,0,2,1
39672,2,2,139162,139162,139164,0,2,0
39673,2,1,139164,139164,139165,0,1,0
39674,3,3,139167,139167,139170,0,3,2
39675,3,3,139170,139170,139173,0,3,0
39676,2,1,139172,139173,139174,1,2,0
39677,1,2,139173,139174,139176,1,3,0
39678,5,3,139178,139178,139181,0,3,2
39679,3,1,139181,139181,139182,0,1,0
39680,3,1,139184,139184,139185,0,1,2
39681,2,2,139186,139186,139188,0,2,1
39682,1,1,139187,139188,139189,1,2,0
39683,5,2,139192,139192,139194,0,2,3
39684,1,1,139193,139194,139195,1,2,0
39685,5,1,139198,139198,139199,0,1,3
39686,2,3,139200,139200,139203,0,3,1
39687,3,2,139203,139203,139205,0,2,0
39688,3,3,139206,139206,139209,0,3,1
39689,3,2,139209,139209,139211,0,2,0
39690,2,1,139211,139211,139212,0,1,0
39691,2,2,139213,139213,139215,0,2,1
39692,4,2,139217,139217,139219,0,2,2
39693,2,1,139219,139219,139220,0,1,0
39694,1,2,139220,139220,139222,0,2,0
39695,6,3,139226,139226,139229,0,3,4
39696,5,1,139231,139231,139232,0,1,2
39697,4,2,139235,139235,139237,0,2,3
39698,3,3,139238,139238,139241,0,3,1
39699,6,3,139244,139244,139247,0,3,3
39700,4,3,139248,139248,139251,0,3,1
39701,5,3,139253,139253,139256,0,3,2
39702,6,2,139259,139259,139261,0,2,3
39703,4,1,139263,139263,139264,0,1,2
39704,3,3,139266,139266,139269,0,3,2
39705,1,3,139267,139269,139272,2,5,0
39706,1,1,139268,139272,139273,4,5,0
39707,2,2,139270,139273,139275,3,5,0
39708,3,1,139273,139275,139276,2,3,0
39709,6,1,139279,139279,139280,0,1,3
39710,3,1,139282,139282,139283,0,1,2
39711,6,2,139288,139288,139290,0,2,5
39712,6,3,139294,139294,139297,0,3,4
39713,4,1,139298,139298,139299,0,1,1
39714,5,1,139303,139303,139304,0,1,4
39715,2,2,139305,139305,139307,0,2,1
39716,5,3,139310,139310,139313,0,3,3
39717,1,1,139311,139313,139314,2,3,0
39718,5,2,139316,139316,139318,0,2,2
39719,3,3,139319,139319,139322,0,3,1
39720,4,2,139323,139323,139325,0,2,1
39721,3,2,139326,139326,139328,0,2,1
39722,1,1,139327,139328,139329,1,2,0
39723,3,1,139330,139330,139331,0,1,1
39724,2,1,139332,139332,139333,0,1,1
39725,5,3,139337,139337,139340,0,3,4
39726,6,3,139343,139343,139346,0,3,3
39727,5,2,139348,139348,139350,0,2,2
39728,3,2,139351,139351,139353,0,2,1
39729,5,3,139356,139356,139359,0,3,3
39730,3,2,139359,139359,139361,0,2,0
39731,1,3,139360,139361,139364,1,4,0
39732,5,1,139365,139365,139366,0,1,1
39733,4,3,139369,139369,139372,0,3,3
39734,1,3,139370,139372,139375,2,5,0
39735,2,1,139372,139375,139376,3,4,0
39736,6,3,139378,139378,139381,0,3,2
39737,2,2,139380,139381,139383,1,3,0
39738,2,2,139382,139383,139385,1,3,0
39739,2,1,139384,139385,139386,1,2,0
39740,2,2,139386,139386,139388,0,2,0
39741,1,2,139387,139388,139390,1,3,0
39742,3,3,139390,139390,139393,0,3,0
39743,4,1,139394,139394,139395,0,1,1
39744,6,3,139400,139400,139403,0,3,5
39745,4,1,139404,139404,139405,0,1,1
39746,6,3,139410,139410,139413,0,3,5
39747,6,1,139416,139416,139417,0,1,3
39748,2,1,139418,139418,139419,0,1,1
39749,2,2,139420,139420,139422,0,2,1
39750,5,1,139425,139425,139426,0,1,3
39751,3,3,139428,139428,139431,0,3,2
39752,4,3,139432,139432,139435,0,3,1
39753,2,2,139434,139435,139437,1,3,0
39754,6,3,139440,139440,139443,0,3,3
39755,5,3,139445,139445,139448,0,3,2
39756,1,3,139446,139448,139451,2,5,0
39757,4,1,139450,139451,139452,1,2,0
39758,6,1,139456,139456,139457,0,1,4
39759,5,3,139461,139461,139464,0,3,4
39760,2,2,139463,139464,139466,1,3,0
39761,5,1,139468,139468,139469,0,1,2
39762,4,3,139472,139472,139475,0,3,3
39763,2,1,139474,139475,139476,1,2,0
39764,2,2,139476,139476,139478,0,2,0
39765,6,3,139482,139482,139485,0,3,4
39766,6,2,139488,139488,139490,0,2,3
39767,4,1,139492,139492,139493,0,1,2
39768,6,1,139498,139498,139499,0,1,5
39769,3,1,139501,139501,139502,0,1,2
39770,4,2,139505,139505,139507,0,2,3
39771,2,1,139507,139507,139508,0,1,0
39772,1,1,139508,139508,139509,0,1,0
39773,1,3,139509,139509,139512,0,3,0
39774,1,3,139510,139512,139515,2,5,0
39775,5,3,139515,139515,139518,0,3,0
39776,4,3,139519,139519,139522,0,3,1
39777,3,2,139522,139522,139524,0,2,0
39778,2,3,139524,139524,139527,0,3,0
39779,2,1,139526,139527,139528,1,2,0
39780,2,1,139528,139528,139529,0,1,0
39781,5,3,139533,139533,139536,0,3,4
39782,1,3,139534,139536,139539,2,5,0
39783,3,2,139537,139539,139541,2,4,0
39784,2,2,139539,139541,139543,2,4,0
39785,5,3,139544,139544,139547,0,3,1
39786,3,2,139547,139547,139549,0,2,0
39787,5,3,139552,139552,139555,0,3,3
39788,1,2,139553,139555,139557,2,4,0
39789,2,2,139555,139557,139559,2,4,0
39790,3,1,139558,139559,139560,1,2,0
39791,6,1,139564,139564,139565,0,1,4
39792,4,1,139568,139568,139569,0,1,3
39793,2,2,139570,139570,139572,0,2,1
39794,2,2,139572,139572,139574,0,2,0
39795,4,1,139576,139576,139577,0,1,2
39796,6,2,139582,139582,139584,0,2,5
39797,1,3,139583,139584,139587,1,4,0
39798,3,3,139586,139587,139590,1,4,0
39799,4,3,139590,139590,139593,0,3,0
39800,6,1,139596,139596,139597,0,1,3
39801,4,2,139600,139600,139602,0,2,3
39802,5,3,139605,139605,139608,0,3,3
39803,1,1,139606,139608,139609,2,3,0
39804,2,1,139608,139609,139610,1,2,0
39805,1,3,139609,139610,139613,1,4,0
39806,1,1,139610,139613,139614,3,4,0
39807,1,3,139611,139614,139617,3,6,0
39808,1,2,139612,139617,139619,5,7,0
39809,3,2,139615,139619,139621,4,6,0
39810,3,2,139618,139621,139623,3,5,0
39811,2,1,139620,139623,139624,3,4,0
39812,6,3,139626,139626,139629,0,3,2
39813,3,3,139629,139629,139632,0,3,0
39814,6,3,139635,139635,139638,0,3,3
39815,2,2,139637,139638,139640,1,3,0
39816,6,1,139643,139643,139644,0,1,3
39817,3,3,139646,139646,139649,0,3,2
39818,6,1,139652,139652,139653,0,1,3
39819,5,1,139657,139657,139658,0,1,4
39820,1,1,139658,139658,139659,0,1,0
39821,5,3,139663,139663,139666,0,3,4
39822,3,3,139666,139666,139669,0,3,0
39823,3,1,139669,139669,139670,0,1,0
39824,3,3,139672,139672,139675,0,3,2
39825,5,2,139677,139677,139679,0,2,2
39826,3,1,139680,139680,139681,0,1,1
39827,1,1,139681,139681,139682,0,1,0
39828,1,3,139682,139682,139685,0,3,0
39829,2,2,139684,139685,139687,1,3,0
39830,6,3,139690,139690,139693,0,3,3
39831,6,1,139696,139696,139697,0,1,3
39832,1,3,139697,139697,139700,0,3,0
39833,5,2,139702,139702,139704,0,2,2
39834,5,1,139707,139707,139708,0,1,3
39835,3,2,139710,139710,139712,0,2,2
39836,1,3,139711,139712,139715,1,4,0
39837,1,1,139712,139715,139716,3,4,0
39838,6,2,139718,139718,139720,0,2,2
39839,5,2,139723,139723,139725,0,2,3
39840,1,1,139724,139725,139726,1,2,0
39841,6,2,139730,139730,139732,0,2,4
39842,6,1,139736,139736,139737,0,1,4
39843,5,3,139741,139741,139744,0,3,4
39844,2,2,139743,139744,139746,1,3,0
39845,1,1,139744,139746,139747,2,3,0
39846,1,2,139745,139747,139749,2,4,0
39847,2,2,139747,139749,139751,2,4,0
39848,2,1,139749,139751,139752,2,3,0
39849,5,3,139754,139754,139757,0,3,2
39850,6,3,139760,139760,139763,0,3,3
39851,2,3,139762,139763,139766,1,4,0
39852,2,1,139764,139766,139767,2,3,0
39853,5,1,139769,139769,139770,0,1,2
39854,6,1,139775,139775,139776,0,1,5
39855,6,2,139781,139781,139783,0,2,5
39856,6,3,139787,139787,139790,0,3,4
39857,2,1,139789,139790,139791,1,2,0
39858,5,3,139794,139794,139797,0,3,3
39859,6,2,139800,139800,139802,0,2,3
39860,3,1,139803,139803,139804,0,1,1
39861,5,2,139808,139808,139810,0,2,4
39862,1,2,139809,139810,139812,1,3,0
39863,5,2,139814,139814,139816,0,2,2
39864,5,1,139819,139819,139820,0,1,3
39865,3,1,139822,139822,139823,0,1,2
39866,5,1,139827,139827,139828,0,1,4
39867,2,1,139829,139829,139830,0,1,1
39868,2,1,139831,139831,139832,0,1,1
39869,2,2,139833,139833,139835,0,2,1
39870,1,3,139834,139835,139838,1,4,0
39871,3,3,139837,139838,139841,1,4,0
39872,4,1,139841,139841,139842,0,1,0
39873,4,2,139845,139845,139847,0,2,3
39874,6,1,139851,139851,139852,0,1,4
39875,2,2,139853,139853,139855,0,2,1
39876,2,2,139855,139855,139857,0,2,0
39877,5,1,139860,139860,139861,0,1,3
39878,3,1,139863,139863,139864,0,1,2
39879,1,3,139864,139864,139867,0,3,0
39880,4,2,139868,139868,139870,0,2,1
39881,6,3,139874,139874,139877,0,3,4
39882,1,1,139875,139877,139878,2,3,0
39883,2,2,139877,139878,139880,1,3,0
39884,5,1,139882,139882,139883,0,1,2
39885,4,2,139886,139886,139888,0,2,3
39886,2,3,139888,139888,139891,0,3,0
39887,4,2,139892,139892,139894,0,2,1
39888,2,3,139894,139894,139897,0,3,0
39889,3,2,139897,139897,139899,0,2,0
39890,3,1,139900,139900,139901,0,1,1
39891,2,1,139902,139902,139903,0,1,1
39892,1,3,139903,139903,139906,0,3,0
39893,1,1,139904,139906,139907,2,3,0
39894,4,1,139908,139908,139909,0,1,1
39895,1,3,139909,139909,139912,0,3,0
39896,6,3,139915,139915,139918,0,3,3
39897,3,3,139918,139918,139921,0,3,0
39898,6,2,139924,139924,139926,0,2,3
39899,6,3,139930,139930,139933,0,3,4
39900,2,1,139932,139933,139934,1,2,0
39901,5,3,139937,139937,139940,0,3,3
39902,3,2,139940,139940,139942,0,2,0
39903,1,3,139941,139942,139945,1,4,0
39904,4,2,139945,139945,139947,0,2,0
39905,4,2,139949,139949,139951,0,2,2
39906,1,3,139950,139951,139954,1,4,0
39907,5,3,139955,139955,139958,0,3,1
39908,2,2,139957,139958,139960,1,3,0
39909,2,2,139959,139960,139962,1,3,0
39910,6,3,139965,139965,139968,0,3,3
39911,5,1,139970,139970,139971,0,1,2
39912,2,3,139972,139972,139975,0,3,1
39913,3,1,139975,139975,139976,0,1,0
39914,6,2,139981,139981,139983,0,2,5
39915,1,1,139982,139983,139984,1,2,0
39916,2,2,139984,139984,139986,0,2,0
39917,5,2,139989,139989,139991,0,2,3
39918,5,2,139994,139994,139996,0,2,3
39919,1,3,139995,139996,139999,1,4,0
39920,1,2,139996,139999,140001,3,5,0
39921,2,1,139998,140001,140002,3,4,0
39922,1,2,139999,140002,140004,3,5,0
39923,3,1,140002,140004,140005,2,3,0
39924,5,3,140007,140007,140010,0,3,2
39925,3,3,140010,140010,140013,0,3,0
39926,1,3,140011,140013,140016,2,5,0
39927,1,2,140012,140016,140018,4,6,0
39928,3,3,140015,140018,140021,3,6,0
39929,1,2,140016,140021,140023,5,7,0
39930,6,1,140022,140023,140024,1,2,0
39931,2,2,140024,140024,140026,0,2,0
39932,1,2,140025,140026,140028,1,3,0
39933,5,1,140030,140030,140031,0,1,2
39934,1,1,140031,140031,140032,0,1,0
39935,5,3,140036,140036,140039,0,3,4
39936,6,3,140042,140042,140045,0,3,3
39937,6,1,140048,140048,140049,0,1,3
39938,1,2,140049,140049,140051,0,2,0
39939,6,1,140055,140055,140056,0,1,4
39940,1,3,140056,140056,140059,0,3,0
39941,4,2,140060,140060,140062,0,2,1
39942,3,3,140063,140063,140066,0,3,1
39943,3,3,140066,140066,140069,0,3,0
39944,5,1,140071,140071,140072,0,1,2
39945,6,2,140077,140077,140079,0,2,5
39946,2,2,140079,140079,140081,0,2,0
39947,5,1,140084,140084,140085,0,1,3
39948,3,3,140087,140087,140090,0,3,2
39949,6,1,140093,140093,140094,0,1,3
39950,3,2,140096,140096,140098,0,2,2
39951,6,2,140102,140102,140104,0,2,4
39952,5,2,140107,140107,140109,0,2,3
39953,5,2,140112,140112,140114,0,2,3
39954,1,3,140113,140114,140117,1,4,0
39955,1,2,140114,140117,140119,3,5,0
39956,6,1,140120,140120,140121,0,1,1
39957,6,2,140126,140126,140128,0,2,5
39958,2,3,140128,140128,140131,0,3,0
39959,5,2,140133,140133,140135,0,2,2
39960,3,1,140136,140136,140137,0,1,1
39961,6,2,140142,140142,140144,0,2,5
39962,3,1,140145,140145,140146,0,1,1
39963,2,3,140147,140147,140150,0,3,1
39964,4,2,140151,140151,140153,0,2,1
39965,5,3,140156,140156,140159,0,3,3
39966,2,2,140158,140159,140161,1,3,0
39967,2,3,140160,140161,140164,1,4,0
39968,1,2,140161,140164,140166,3,5,0
39969,1,2,140162,140166,140168,4,6,0
39970,6,2,140168,140168,140170,0,2,0
39971,5,3,140173,140173,140176,0,3,3
39972,4,1,140177,140177,140178,0,1,1
39973,4,1,140181,140181,140182,0,1,3
39974,5,1,140186,140186,140187,0,1,4
39975,6,3,140192,140192,140195,0,3,5
39976,3,2,140195,140195,140197,0,2,0
39977,2,2,140197,140197,140199,0,2,0
39978,3,1,140200,140200,140201,0,1,1
39979,5,3,140205,140205,140208,0,3,4
39980,2,1,140207,140208,140209,1,2,0
39981,1,2,140208,140209,140211,1,3,0
39982,2,2,140210,140211,140213,1,3,0
39983,6,2,140216,140216,140218,0,2,3
39984,6,3,140222,140222,140225,0,3,4
39985,1,1,140223,140225,140226,2,3,0
39986,5,1,140228,140228,140229,0,1,2
39987,4,2,140232,140232,140234,0,2,3
39988,5,1,140237,140237,140238,0,1,3
39989,6,1,140243,140243,140244,0,1,5
39990,6,2,140249,140249,140251,0,2,5
39991,2,2,140251,140251,140253,0,2,0
39992,4,3,140255,140255,140258,0,3,2
39993,5,2,140260,140260,140262,0,2,2
39994,2,1,140262,140262,140263,0,1,0
39995,1,1,140263,140263,140264,0,1,0
39996,2,2,140265,140265,140267,0,2,1
39997,4,1,140269,140269,140270,0,1,2
39998,2,3,140271,140271,140274,0,3,1
39999,3,1,140274,140274,140275,0,1,0
40000,6,3,140280,140280,140283,0,3,5
40001,3,3,140283,140283,140286,0,3,0
40002,1,1,140284,140286,140287,2,3,0
40003,4,3,140288,140288,140291,0,3,1
40004,1,1,140289,140291,140292,2,3,0
40005,2,3,140291,140292,140295,1,4,0
40006,1,3,140292,140295,140298,3,6,0
40007,6,2,140298,140298,140300,0,2,0
40008,3,3,140301,140301,140304,0,3,1
40009,2,1,140303,140304,140305,1,2,0
40010,1,3,140304,140305,140308,1,4,0
40011,5,2,140309,140309,140311,0,2,1
40012,3,3,140312,140312,140315,0,3,1
40013,4,2,140316,140316,140318,0,2,1
40014,5,2,140321,140321,140323,0,2,3
40015,6,3,140327,140327,140330,0,3,4
40016,5,2,140332,140332,140334,0,2,2
40017,1,2,140333,140334,140336,1,3,0
40018,4,2,140337,140337,140339,0,2,1
40019,5,3,140342,140342,140345,0,3,3
40020,5,1,140347,140347,140348,0,1,2
40021,2,3,140349,140349,140352,0,3,1
40022,1,3,140350,140352,140355,2,5,0
40023,3,2,140353,140355,140357,2,4,0
40024,6,2,140359,140359,140361,0,2,2
40025,5,3,140364,140364,140367,0,3,3
40026,6,3,140370,140370,140373,0,3,3
40027,2,1,140372,140373,140374,1,2,0
40028,3,1,140375,140375,140376,0,1,1
40029,5,3,140380,140380,140383,0,3,4
40030,3,3,140383,140383,140386,0,3,0
40031,5,3,140388,140388,140391,0,3,2
40032,6,3,140394,140394,140397,0,3,3
40033,4,3,140398,140398,140401,0,3,1
40034,5,1,140403,140403,140404,0,1,2
40035,5,3,140408,140408,140411,0,3,4
40036,1,3,140409,140411,140414,2,5,0
40037,4,2,140413,140414,140416,1,3,0
40038,3,2,140416,140416,140418,0,2,0
40039,4,3,140420,140420,140423,0,3,2
40040,5,2,140425,140425,140427,0,2,2
40041,1,1,140426,140427,140428,1,2,0
40042,3,2,140429,140429,140431,0,2,1
40043,1,2,140430,140431,140433,1,3,0
40044,2,2,140432,140433,140435,1,3,0
40045,5,2,140437,140437,140439,0,2,2
40046,3,1,140440,140440,140441,0,1,1
40047,3,3,140443,140443,140446,0,3,2
40048,2,1,140445,140446,140447,1,2,0
40049,5,3,140450,140450,140453,0,3,3
40050,5,2,140455,140455,140457,0,2,2
40051,4,2,140459,140459,140461,0,2,2
40052,6,1,140465,140465,140466,0,1,4
40053,2,3,140467,140467,140470,0,3,1
40054,6,3,140473,140473,140476,0,3,3
40055,1,1,140474,140476,140477,2,3,0
40056,2,3,140476,140477,140480,1,4,0
40057,4,2,140480,140480,140482,0,2,0
40058,6,1,140486,140486,140487,0,1,4
40059,1,3,140487,140487,140490,0,3,0
40060,3,2,140490,140490,140492,0,2,0
40061,4,2,140494,140494,140496,0,2,2
40062,5,1,140499,140499,140500,0,1,3
40063,2,2,140501,140501,140503,0,2,1
40064,6,2,140507,140507,140509,0,2,4
40065,5,1,140512,140512,140513,0,1,3
40066,3,3,140515,140515,140518,0,3,2
40067,3,3,140518,140518,140521,0,3,0
40068,2,1,140520,140521,140522,1,2,0
40069,1,2,140521,140522,140524,1,3,0
40070,1,2,140522,140524,140526,2,4,0
40071,1,2,140523,140526,140528,3,5,0
40072,5,2,140528,140528,140530,0,2,0
40073,6,1,140534,140534,140535,0,1,4
40074,5,3,140539,140539,140542,0,3,4
40075,3,3,140542,140542,140545,0,3,0
40076,1,1,140543,140545,140546,2,3,0
40077,1,1,140544,140546,140547,2,3,0
40078,3,3,140547,140547,140550,0,3,0
40079,3,1,140550,140550,140551,0,1,0
40080,2,2,140552,140552,140554,0,2,1
40081,4,1,140556,140556,140557,0,1,2
40082,3,1,140559,140559,140560,0,1,2
40083,6,1,140565,140565,140566,0,1,5
40084,3,1,140568,140568,140569,0,1,2
40085,3,1,140571,140571,140572,0,1,2
40086,4,2,140575,140575,140577,0,2,3
40087,1,1,140576,140577,140578,1,2,0
40088,4,1,140580,140580,140581,0,1,2
40089,1,1,140581,140581,140582,0,1,0
40090,3,3,140584,140584,140587,0,3,2
40091,2,1,140586,140587,140588,1,2,0
40092,5,1,140591,140591,140592,0,1,3
40093,3,1,140594,140594,140595,0,1,2
40094,5,3,140599,140599,140602,0,3,4
40095,5,3,140604,140604,140607,0,3,2
40096,5,1,140609,140609,140610,0,1,2
40097,1,1,140610,140610,140611,0,1,0
40098,2,1,140612,140612,140613,0,1,1
40099,1,2,140613,140613,140615,0,2,0
40100,4,3,140617,140617,140620,0,3,2
40101,5,3,140622,140622,140625,0,3,2
40102,2,3,140624,140625,140628,1,4,0
40103,2,3,140626,140628,140631,2,5,0
40104,3,1,140629,140631,140632,2,3,0
40105,2,3,140631,140632,140635,1,4,0
40106,5,2,140636,140636,140638,0,2,1
40107,3,2,140639,140639,140641,0,2,1
40108,4,2,140643,140643,140645,0,2,2
40109,2,1,140645,140645,140646,0,1,0
40110,1,3,140646,140646,140649,0,3,0
40111,2,1,140648,140649,140650,1,2,0
40112,5,1,140653,140653,140654,0,1,3
40113,5,2,140658,140658,140660,0,2,4
40114,5,2,140663,140663,140665,0,2,3
40115,4,2,140667,140667,140669,0,2,2
40116,3,2,140670,140670,140672,0,2,1
40117,4,1,140674,140674,140675,0,1,2
40118,6,2,140680,140680,140682,0,2,5
40119,6,2,140686,140686,140688,0,2,4
40120,6,2,140692,140692,140694,0,2,4
40121,6,3,140698,140698,140701,0,3,4
40122,2,1,140700,140701,140702,1,2,0
40123,5,1,140705,140705,140706,0,1,3
40124,3,1,140708,140708,140709,0,1,2
40125,5,1,140713,140713,140714,0,1,4
40126,6,3,140719,140719,140722,0,3,5
40127,4,3,140723,140723,140726,0,3,1
40128,6,2,140729,140729,140731,0,2,3
40129,2,3,140731,140731,140734,0,3,0
40130,4,1,140735,140735,140736,0,1,1
40131,4,1,140739,140739,140740,0,1,3
40132,6,2,140745,140745,140747,0,2,5
40133,1,2,140746,140747,140749,1,3,0
40134,5,3,140751,140751,140754,0,3,2
40135,3,1,140754,140754,140755,0,1,0
40136,2,1,140756,140756,140757,0,1,1
40137,3,2,140759,140759,140761,0,2,2
40138,2,3,140761,140761,140764,0,3,0
40139,2,2,140763,140764,140766,1,3,0
40140,6,3,140769,140769,140772,0,3,3
40141,2,2,140771,140772,140774,1,3,0
40142,3,3,140774,140774,140777,0,3,0
40143,4,3,140778,140778,140781,0,3,1
40144,1,2,140779,140781,140783,2,4,0
40145,6,3,140785,140785,140788,0,3,2
40146,5,2,140790,140790,140792,0,2,2
40147,2,2,140792,140792,140794,0,2,0
40148,6,3,140798,140798,140801,0,3,4
40149,5,1,140803,140803,140804,0,1,2
40150,4,3,140807,140807,140810,0,3,3
40151,4,3,140811,140811,140814,0,3,1
40152,2,1,140813,140814,140815,1,2,0
40153,4,3,140817,140817,140820,0,3,2
40154,5,2,140822,140822,140824,0,2,2
40155,3,2,140825,140825,140827,0,2,1
40156,4,2,140829,140829,140831,0,2,2
40157,6,2,140835,140835,140837,0,2,4
40158,4,2,140839,140839,140841,0,2,2
40159,6,3,140845,140845,140848,0,3,4
40160,4,3,140849,140849,140852,0,3,1
40161,6,2,140855,140855,140857,0,2,3
40162,5,2,140860,140860,140862,0,2,3
40163,2,1,140862,140862,140863,0,1,0
40164,4,3,140866,140866,140869,0,3,3
40165,2,3,140868,140869,140872,1,4,0
40166,3,2,140871,140872,140874,1,3,0
40167,4,1,140875,140875,140876,0,1,1
40168,6,3,140881,140881,140884,0,3,5
40169,6,1,140887,140887,140888,0,1,3
40170,4,3,140891,140891,140894,0,3,3
40171,6,2,140897,140897,140899,0,2,3
40172,3,3,140900,140900,140903,0,3,1
40173,3,3,140903,140903,140906,0,3,0
40174,3,1,140906,140906,140907,0,1,0
40175,6,3,140912,140912,140915,0,3,5
40176,3,3,140915,140915,140918,0,3,0
40177,6,3,140921,140921,140924,0,3,3
40178,4,2,140925,140925,140927,0,2,1
40179,3,3,140928,140928,140931,0,3,1
40180,5,2,140933,140933,140935,0,2,2
40181,5,2,140938,140938,140940,0,2,3
40182,5,2,140943,140943,140945,0,2,3
40183,3,2,140946,140946,140948,0,2,1
40184,2,2,140948,140948,140950,0,2,0
40185,5,2,140953,140953,140955,0,2,3
40186,1,3,140954,140955,140958,1,4,0
40187,2,2,140956,140958,140960,2,4,0
40188,4,3,140960,140960,140963,0,3,0
40189,4,1,140964,140964,140965,0,1,1
40190,4,1,140968,140968,140969,0,1,3
40191,3,1,140971,140971,140972,0,1,2
40192,5,1,140976,140976,140977,0,1,4
40193,1,1,140977,140977,140978,0,1,0
40194,6,1,140983,140983,140984,0,1,5
40195,3,1,140986,140986,140987,0,1,2
40196,1,2,140987,140987,140989,0,2,0
40197,6,2,140993,140993,140995,0,2,4
40198,4,2,140997,140997,140999,0,2,2
40199,5,2,141002,141002,141004,0,2,3
40200,5,2,141007,141007,141009,0,2,3
40201,5,2,141012,141012,141014,0,2,3
40202,6,1,141018,141018,141019,0,1,4
40203,4,1,141022,141022,141023,0,1,3
40204,1,3,141023,141023,141026,0,3,0
40205,1,2,141024,141026,141028,2,4,0
40206,5,2,141029,141029,141031,0,2,1
40207,4,2,141033,141033,141035,0,2,2
40208,6,2,141039,141039,141041,0,2,4
40209,6,3,141045,141045,141048,0,3,4
40210,4,3,141049,141049,141052,0,3,1
40211,5,1,141054,141054,141055,0,1,2
40212,2,3,141056,141056,141059,0,3,1
40213,2,3,141058,141059,141062,1,4,0
40214,6,1,141064,141064,141065,0,1,2
40215,3,2,141067,141067,141069,0,2,2
40216,6,2,141073,141073,141075,0,2,4
40217,3,1,141076,141076,141077,0,1,1
40218,1,1,141077,141077,141078,0,1,0
40219,5,2,141082,141082,141084,0,2,4
40220,3,3,141085,141085,141088,0,3,1
40221,5,2,141090,141090,141092,0,2,2
40222,6,1,141096,141096,141097,0,1,4
40223,5,1,141101,141101,141102,0,1,4
40224,6,2,141107,141107,141109,0,2,5
40225,6,2,141113,141113,141115,0,2,4
40226,1,2,141114,141115,141117,1,3,0
40227,5,2,141119,141119,141121,0,2,2
40228,3,2,141122,141122,141124,0,2,1
40229,2,3,141124,141124,141127,0,3,0
40230,1,1,141125,141127,141128,2,3,0
40231,6,3,141131,141131,141134,0,3,3
40232,6,1,141137,141137,141138,0,1,3
40233,6,2,141143,141143,141145,0,2,5
40234,6,3,141149,141149,141152,0,3,4
40235,1,3,141150,141152,141155,2,5,0
40236,1,3,141151,141155,141158,4,7,0
40237,2,2,141153,141158,141160,5,7,0
40238,4,2,141157,141160,141162,3,5,0
40239,5,2,141162,141162,141164,0,2,0
40240,1,3,141163,141164,141167,1,4,0
40241,6,3,141169,141169,141172,0,3,2
40242,2,3,141171,141172,141175,1,4,0
40243,4,2,141175,141175,141177,0,2,0
40244,5,3,141180,141180,141183,0,3,3
40245,3,2,141183,141183,141185,0,2,0
40246,4,2,141187,141187,141189,0,2,2
40247,2,2,141189,141189,141191,0,2,0
40248,3,1,141192,141192,141193,0,1,1
40249,2,3,141194,141194,141197,0,3,1
40250,5,2,141199,141199,141201,0,2,2
40251,2,2,141201,141201,141203,0,2,0
40252,1,3,141202,141203,141206,1,4,0
40253,3,3,141205,141206,141209,1,4,0
40254,6,3,141211,141211,141214,0,3,2
40255,3,3,141214,141214,141217,0,3,0
40256,4,3,141218,141218,141221,0,3,1
40257,5,2,141223,141223,141225,0,2,2
40258,4,2,141227,141227,141229,0,2,2
40259,5,2,141232,141232,141234,0,2,3
40260,4,1,141236,141236,141237,0,1,2
40261,5,3,141241,141241,141244,0,3,4
40262,5,1,141246,141246,141247,0,1,2
40263,5,2,141251,141251,141253,0,2,4
40264,4,1,141255,141255,141256,0,1,2
40265,4,3,141259,141259,141262,0,3,3
40266,1,1,141260,141262,141263,2,3,0
40267,2,2,141262,141263,141265,1,3,0
40268,2,1,141264,141265,141266,1,2,0
40269,5,1,141269,141269,141270,0,1,3
40270,4,1,141273,141273,141274,0,1,3
40271,3,3,141276,141276,141279,0,3,2
40272,1,2,141277,141279,141281,2,4,0
40273,4,2,141281,141281,141283,0,2,0
40274,6,2,141287,141287,141289,0,2,4
40275,5,1,141292,141292,141293,0,1,3
40276,2,1,141294,141294,141295,0,1,1
40277,4,1,141298,141298,141299,0,1,3
40278,2,2,141300,141300,141302,0,2,1
40279,2,1,141302,141302,141303,0,1,0
40280,3,2,141305,141305,141307,0,2,2
40281,6,1,141311,141311,141312,0,1,4
40282,6,1,141317,141317,141318,0,1,5
40283,1,2,141318,141318,141320,0,2,0
40284,2,2,141320,141320,141322,0,2,0
40285,3,3,141323,141323,141326,0,3,1
40286,4,3,141327,141327,141330,0,3,1
40287,4,2,141331,141331,141333,0,2,1
40288,4,1,141335,141335,141336,0,1,2
40289,6,1,141341,141341,141342,0,1,5
40290,5,2,141346,141346,141348,0,2,4
40291,1,3,141347,141348,141351,1,4,0
40292,1,3,141348,141351,141354,3,6,0
40293,3,1,141351,141354,141355,3,4,0
40294,3,3,141354,141355,141358,1,4,0
40295,2,2,141356,141358,141360,2,4,0
40296,6,1,141362,141362,141363,0,1,2
40297,1,3,141363,141363,141366,0,3,0
40298,5,3,141368,141368,141371,0,3,2
40299,1,3,141369,141371,141374,2,5,0
40300,5,2,141374,141374,141376,0,2,0
40301,5,3,141379,141379,141382,0,3,3
40302,1,2,141380,141382,141384,2,4,0
40303,3,2,141383,141384,141386,1,3,0
40304,6,2,141389,141389,141391,0,2,3
40305,3,1,141392,141392,141393,0,1,1
40306,3,2,141395,141395,141397,0,2,2
40307,2,2,141397,141397,141399,0,2,0
40308,2,1,141399,141399,141400,0,1,0
40309,1,3,141400,141400,141403,0,3,0
40310,3,1,141403,141403,141404,0,1,0
40311,3,1,141406,141406,141407,0,1,2
40312,2,1,141408,141408,141409,0,1,1
40313,1,2,141409,141409,141411,0,2,0
40314,5,3,141414,141414,141417,0,3,3
40315,3,1,141417,141417,141418,0,1,0
40316,6,1,141423,141423,141424,0,1,5
40317,6,3,141429,141429,141432,0,3,5
40318,1,1,141430,141432,141433,2,3,0
40319,4,3,141434,141434,141437,0,3,1
40320,6,2,141440,141440,141442,0,2,3
40321,3,1,141443,141443,141444,0,1,1
40322,5,3,141448,141448,141451,0,3,4
40323,6,2,141454,141454,141456,0,2,3
40324,1,3,141455,141456,141459,1,4,0
40325,3,2,141458,141459,141461,1,3,0
40326,2,3,141460,141461,141464,1,4,0
40327,2,2,141462,141464,141466,2,4,0
40328,4,1,141466,141466,141467,0,1,0
40329,6,3,141472,141472,141475,0,3,5
40330,4,2,141476,141476,141478,0,2,1
40331,1,3,141477,141478,141481,1,4,0
40332,2,1,141479,141481,141482,2,3,0
40333,1,3,141480,141482,141485,2,5,0
40334,1,2,141481,141485,141487,4,6,0
40335,1,3,141482,141487,141490,5,8,0
40336,5,2,141487,141490,141492,3,5,0
40337,1,3,141488,141492,141495,4,7,0
40338,3,2,141491,141495,141497,4,6,0
40339,4,1,141495,141497,141498,2,3,0
40340,2,3,141497,141498,141501,1,4,0
40341,6,3,141503,141503,141506,0,3,2
40342,5,2,141508,141508,141510,0,2,2
40343,6,3,141514,141514,141517,0,3,4
40344,6,2,141520,141520,141522,0,2,3
40345,6,2,141526,141526,141528,0,2,4
40346,1,3,141527,141528,141531,1,4,0
40347,5,3,141532,141532,141535,0,3,1
40348,2,1,141534,141535,141536,1,2,0
40349,3,3,141537,141537,141540,0,3,1
40350,2,1,141539,141540,141541,1,2,0
40351,2,2,141541,141541,141543,0,2,0
40352,1,3,141542,141543,141546,1,4,0
40353,1,1,141543,141546,141547,3,4,0
40354,3,3,141546,141547,141550,1,4,0
40355,3,3,141549,141550,141553,1,4,0
40356,1,3,141550,141553,141556,3,6,0
40357,2,3,141552,141556,141559,4,7,0
40358,2,2,141554,141559,141561,5,7,0
40359,6,1,141560,141561,141562,1,2,0
40360,5,2,141565,141565,141567,0,2,3
40361,6,2,141571,141571,141573,0,2,4
40362,1,2,141572,141573,141575,1,3,0
40363,4,3,141576,141576,141579,0,3,1
40364,2,2,141578,141579,141581,1,3,0
40365,6,2,141584,141584,141586,0,2,3
40366,4,3,141588,141588,141591,0,3,2
40367,2,1,141590,141591,141592,1,2,0
40368,1,3,141591,141592,141595,1,4,0
40369,2,1,141593,141595,141596,2,3,0
40370,2,2,141595,141596,141598,1,3,0
40371,5,3,141600,141600,141603,0,3,2
40372,5,1,141605,141605,141606,0,1,2
40373,1,1,141606,141606,141607,0,1,0
40374,1,1,141607,141607,141608,0,1,0
40375,5,1,141612,141612,141613,0,1,4
40376,6,3,141618,141618,141621,0,3,5
40377,2,2,141620,141621,141623,1,3,0
40378,2,1,141622,141623,141624,1,2,0
40379,4,3,141626,141626,141629,0,3,2
40380,3,3,141629,141629,141632,0,3,0
40381,5,3,141634,141634,141637,0,3,2
40382,3,2,141637,141637,141639,0,2,0
40383,4,1,141641,141641,141642,0,1,2
40384,3,1,141644,141644,141645,0,1,2
40385,2,3,141646,141646,141649,0,3,1
40386,2,2,141648,141649,141651,1,3,0
40387,5,3,141653,141653,141656,0,3,2
40388,5,2,141658,141658,141660,0,2,2
40389,2,1,141660,141660,141661,0,1,0
40390,3,2,141663,141663,141665,0,2,2
40391,6,1,141669,141669,141670,0,1,4
40392,4,1,141673,141673,141674,0,1,3
40393,1,2,141674,141674,141676,0,2,0
40394,5,2,141679,141679,141681,0,2,3
40395,2,1,141681,141681,141682,0,1,0
40396,4,1,141685,141685,141686,0,1,3
40397,5,2,141690,141690,141692,0,2,4
40398,2,3,141692,141692,141695,0,3,0
40399,2,2,141694,141695,141697,1,3,0
40400,3,1,141697,141697,141698,0,1,0
40401,4,2,141701,141701,141703,0,2,3
40402,6,2,141707,141707,141709,0,2,4
40403,4,3,141711,141711,141714,0,3,2
40404,2,2,141713,141714,141716,1,3,0
40405,4,1,141717,141717,141718,0,1,1
40406,5,1,141722,141722,141723,0,1,4
40407,2,2,141724,141724,141726,0,2,1
40408,2,3,141726,141726,141729,0,3,0
40409,1,1,141727,141729,141730,2,3,0
40410,6,1,141733,141733,141734,0,1,3
40411,3,3,141736,141736,141739,0,3,2
40412,6,1,141742,141742,141743,0,1,3
40413,1,3,141743,141743,141746,0,3,0
40414,5,2,141748,141748,141750,0,2,2
40415,5,2,141753,141753,141755,0,2,3
40416,1,2,141754,141755,141757,1,3,0
40417,5,1,141759,141759,141760,0,1,2
40418,5,3,141764,141764,141767,0,3,4
40419,4,2,141768,141768,141770,0,2,1
40420,2,2,141770,141770,141772,0,2,0
40421,4,2,141774,141774,141776,0,2,2
40422,5,1,141779,141779,141780,0,1,3
40423,5,2,141784,141784,141786,0,2,4
40424,2,1,141786,141786,141787,0,1,0
40425,3,1,141789,141789,141790,0,1,2
40426,3,3,141792,141792,141795,0,3,2
40427,1,1,141793,141795,141796,2,3,0
40428,2,3,141795,141796,141799,1,4,0
40429,3,1,141798,141799,141800,1,2,0
40430,6,2,141804,141804,141806,0,2,4
40431,5,3,141809,141809,141812,0,3,3
40432,4,2,141813,141813,141815,0,2,1
40433,2,3,141815,141815,141818,0,3,0
40434,1,2,141816,141818,141820,2,4,0
40435,3,3,141819,141820,141823,1,4,0
40436,4,3,141823,141823,141826,0,3,0
40437,4,1,141827,141827,141828,0,1,1
40438,6,3,141833,141833,141836,0,3,5
40439,3,2,141836,141836,141838,0,2,0
40440,1,3,141837,141838,141841,1,4,0
40441,5,3,141842,141842,141845,0,3,1
40442,5,1,141847,141847,141848,0,1,2
40443,4,1,141851,141851,141852,0,1,3
40444,3,2,141854,141854,141856,0,2,2
40445,1,2,141855,141856,141858,1,3,0
40446,5,2,141860,141860,141862,0,2,2
40447,5,2,141865,141865,141867,0,2,3
40448,2,1,141867,141867,141868,0,1,0
40449,1,3,141868,141868,141871,0,3,0
40450,4,3,141872,141872,141875,0,3,1
40451,4,3,141876,141876,141879,0,3,1
40452,6,2,141882,141882,141884,0,2,3
40453,2,1,141884,141884,141885,0,1,0
40454,4,3,141888,141888,141891,0,3,3
40455,1,3,141889,141891,141894,2,5,0
40456,4,1,141893,141894,141895,1,2,0
40457,4,2,141897,141897,141899,0,2,2
40458,4,2,141901,141901,141903,0,2,2
40459,2,1,141903,141903,141904,0,1,0
40460,4,3,141907,141907,141910,0,3,3
40461,3,2,141910,141910,141912,0,2,0
40462,1,2,141911,141912,141914,1,3,0
40463,5,2,141916,141916,141918,0,2,2
40464,1,3,141917,141918,141921,1,4,0
40465,2,3,141919,141921,141924,2,5,0
40466,4,3,141923,141924,141927,1,4,0
40467,2,1,141925,141927,141928,2,3,0
40468,4,1,141929,141929,141930,0,1,1
40469,4,1,141933,141933,141934,0,1,3
40470,1,3,141934,141934,141937,0,3,0
40471,4,1,141938,141938,141939,0,1,1
40472,3,2,141941,141941,141943,0,2,2
40473,4,2,141945,141945,141947,0,2,2
40474,2,3,141947,141947,141950,0,3,0
40475,2,1,141949,141950,141951,1,2,0
40476,3,3,141952,141952,141955,0,3,1
40477,3,2,141955,141955,141957,0,2,0
40478,6,1,141961,141961,141962,0,1,4
40479,4,3,141965,141965,141968,0,3,3
40480,6,2,141971,141971,141973,0,2,3
40481,6,1,141977,141977,141978,0,1,4
40482,1,2,141978,141978,141980,0,2,0
40483,6,1,141984,141984,141985,0,1,4
40484,6,1,141990,141990,141991,0,1,5
40485,5,1,141995,141995,141996,0,1,4
40486,3,3,141998,141998,142001,0,3,2
40487,6,2,142004,142004,142006,0,2,3
40488,3,3,142007,142007,142010,0,3,1
40489,3,1,142010,142010,142011,0,1,0
40490,2,3,142012,142012,142015,0,3,1
40491,1,1,142013,142015,142016,2,3,0
40492,5,1,142018,142018,142019,0,1,2
40493,5,3,142023,142023,142026,0,3,4
40494,2,3,142025,142026,142029,1,4,0
40495,6,3,142031,142031,142034,0,3,2
40496,5,1,142036,142036,142037,0,1,2
40497,4,3,142040,142040,142043,0,3,3
40498,5,3,142045,142045,142048,0,3,2
40499,5,1,142050,142050,142051,0,1,2
40500,5,2,142055,142055,142057,0,2,4
40501,1,2,142056,142057,142059,1,3,0
40502,4,2,142060,142060,142062,0,2,1
40503,6,3,142066,142066,142069,0,3,4
40504,4,2,142070,142070,142072,0,2,1
40505,4,3,142074,142074,142077,0,3,2
40506,1,1,142075,142077,142078,2,3,0
40507,4,2,142079,142079,142081,0,2,1
40508,3,1,142082,142082,142083,0,1,1
40509,3,2,142085,142085,142087,0,2,2
40510,1,1,142086,142087,142088,1,2,0
40511,1,2,142087,142088,142090,1,3,0
40512,1,1,142088,142090,142091,2,3,0
40513,3,2,142091,142091,142093,0,2,0
40514,1,1,142092,142093,142094,1,2,0
40515,4,3,142096,142096,142099,0,3,2
40516,2,2,142098,142099,142101,1,3,0
40517,2,2,142100,142101,142103,1,3,0
40518,4,3,142104,142104,142107,0,3,1
40519,6,3,142110,142110,142113,0,3,3
40520,3,1,142113,142113,142114,0,1,0
40521,5,3,142118,142118,142121,0,3,4
40522,2,1,142120,142121,142122,1,2,0
40523,4,3,142124,142124,142127,0,3,2
40524,2,3,142126,142127,142130,1,4,0
40525,6,1,142132,142132,142133,0,1,2
40526,3,3,142135,142135,142138,0,3,2
40527,3,1,142138,142138,142139,0,1,0
40528,3,2,142141,142141,142143,0,2,2
40529,4,3,142145,142145,142148,0,3,2
40530,6,2,142151,142151,142153,0,2,3
40531,3,3,142154,142154,142157,0,3,1
40532,3,2,142157,142157,142159,0,2,0
40533,6,2,142163,142163,142165,0,2,4
40534,4,2,142167,142167,142169,0,2,2
40535,1,3,142168,142169,142172,1,4,0
40536,5,1,142173,142173,142174,0,1,1
40537,5,2,142178,142178,142180,0,2,4
40538,4,3,142182,142182,142185,0,3,2
40539,1,1,142183,142185,142186,2,3,0
40540,3,3,142186,142186,142189,0,3,0
40541,5,1,142191,142191,142192,0,1,2
40542,6,3,142197,142197,142200,0,3,5
40543,2,1,142199,142200,142201,1,2,0
40544,4,2,142203,142203,142205,0,2,2
40545,4,3,142207,142207,142210,0,3,2
40546,5,1,142212,142212,142213,0,1,2
40547,2,2,142214,142214,142216,0,2,1
40548,6,1,142220,142220,142221,0,1,4
40549,6,1,142226,142226,142227,0,1,5
40550,6,2,142232,142232,142234,0,2,5
40551,5,1,142237,142237,142238,0,1,3
40552,5,2,142242,142242,142244,0,2,4
40553,3,2,142245,142245,142247,0,2,1
40554,6,1,142251,142251,142252,0,1,4
40555,2,2,142253,142253,142255,0,2,1
40556,4,2,142257,142257,142259,0,2,2
40557,3,1,142260,142260,142261,0,1,1
40558,2,1,142262,142262,142263,0,1,1
40559,4,2,142266,142266,142268,0,2,3
40560,3,1,142269,142269,142270,0,1,1
40561,5,1,142274,142274,142275,0,1,4
40562,1,3,142275,142275,142278,0,3,0
40563,2,1,142277,142278,142279,1,2,0
40564,3,2,142280,142280,142282,0,2,1
40565,4,3,142284,142284,142287,0,3,2
40566,5,3,142289,142289,142292,0,3,2
40567,5,3,142294,142294,142297,0,3,2
40568,6,2,142300,142300,142302,0,2,3
40569,1,3,142301,142302,142305,1,4,0
40570,4,2,142305,142305,142307,0,2,0
40571,4,2,142309,142309,142311,0,2,2
40572,1,1,142310,142311,142312,1,2,0
40573,4,1,142314,142314,142315,0,1,2
40574,2,2,142316,142316,142318,0,2,1
40575,5,2,142321,142321,142323,0,2,3
40576,6,2,142327,142327,142329,0,2,4
40577,5,1,142332,142332,142333,0,1,3
40578,4,1,142336,142336,142337,0,1,3
40579,6,2,142342,142342,142344,0,2,5
40580,4,2,142346,142346,142348,0,2,2
40581,6,1,142352,142352,142353,0,1,4
40582,5,1,142357,142357,142358,0,1,4
40583,1,1,142358,142358,142359,0,1,0
40584,3,3,142361,142361,142364,0,3,2
40585,6,3,142367,142367,142370,0,3,3
40586,5,3,142372,142372,142375,0,3,2
40587,4,1,142376,142376,142377,0,1,1
40588,4,2,142380,142380,142382,0,2,3
40589,1,3,142381,142382,142385,1,4,0
40590,5,1,142386,142386,142387,0,1,1
40591,1,1,142387,142387,142388,0,1,0
40592,6,3,142393,142393,142396,0,3,5
40593,4,2,142397,142397,142399,0,2,1
40594,1,2,142398,142399,142401,1,3,0
40595,6,1,142404,142404,142405,0,1,3
40596,4,3,142408,142408,142411,0,3,3
40597,2,1,142410,142411,142412,1,2,0
40598,6,3,142416,142416,142419,0,3,4
40599,1,1,142417,142419,142420,2,3,0
40600,1,1,142418,142420,142421,2,3,0
40601,4,1,142422,142422,142423,0,1,1
40602,2,1,142424,142424,142425,0,1,1
40603,3,1,142427,142427,142428,0,1,2
40604,5,1,142432,142432,142433,0,1,4
40605,4,1,142436,142436,142437,0,1,3
40606,5,3,142441,142441,142444,0,3,4
40607,5,3,142446,142446,142449,0,3,2
40608,3,1,142449,142449,142450,0,1,0
40609,2,1,142451,142451,142452,0,1,1
40610,5,2,142456,142456,142458,0,2,4
40611,6,3,142462,142462,142465,0,3,4
40612,4,1,142466,142466,142467,0,1,1
40613,2,2,142468,142468,142470,0,2,1
40614,2,3,142470,142470,142473,0,3,0
40615,2,1,142472,142473,142474,1,2,0
40616,2,3,142474,142474,142477,0,3,0
40617,4,3,142478,142478,142481,0,3,1
40618,2,3,142480,142481,142484,1,4,0
40619,2,2,142482,142484,142486,2,4,0
40620,3,2,142485,142486,142488,1,3,0
40621,6,3,142491,142491,142494,0,3,3
40622,5,3,142496,142496,142499,0,3,2
40623,1,1,142497,142499,142500,2,3,0
40624,5,3,142502,142502,142505,0,3,2
40625,1,3,142503,142505,142508,2,5,0
40626,2,1,142505,142508,142509,3,4,0
40627,2,2,142507,142509,142511,2,4,0
40628,4,1,142511,142511,142512,0,1,0
40629,3,3,142514,142514,142517,0,3,2
40630,1,2,142515,142517,142519,2,4,0
40631,3,1,142518,142519,142520,1,2,0
40632,3,1,142521,142521,142522,0,1,1
40633,2,1,142523,142523,142524,0,1,1
40634,5,2,142528,142528,142530,0,2,4
40635,5,1,142533,142533,142534,0,1,3
40636,2,2,142535,142535,142537,0,2,1
40637,2,1,142537,142537,142538,0,1,0
40638,6,1,142543,142543,142544,0,1,5
40639,6,3,142549,142549,142552,0,3,5
40640,1,3,142550,142552,142555,2,5,0
40641,1,1,142551,142555,142556,4,5,0
40642,3,2,142554,142556,142558,2,4,0
40643,4,1,142558,142558,142559,0,1,0
40644,5,3,142563,142563,142566,0,3,4
40645,4,3,142567,142567,142570,0,3,1
40646,4,3,142571,142571,142574,0,3,1
40647,3,1,142574,142574,142575,0,1,0
40648,1,1,142575,142575,142576,0,1,0
40649,1,3,142576,142576,142579,0,3,0
40650,1,2,142577,142579,142581,2,4,0
40651,2,1,142579,142581,142582,2,3,0
40652,3,1,142582,142582,142583,0,1,0
40653,4,2,142586,142586,142588,0,2,3
40654,1,2,142587,142588,142590,1,3,0
40655,3,3,142590,142590,142593,0,3,0
40656,2,2,142592,142593,142595,1,3,0
40657,5,3,142597,142597,142600,0,3,2
40658,4,1,142601,142601,142602,0,1,1
40659,6,3,142607,142607,142610,0,3,5
40660,5,3,142612,142612,142615,0,3,2
40661,1,3,142613,142615,142618,2,5,0
40662,2,2,142615,142618,142620,3,5,0
40663,6,2,142621,142621,142623,0,2,1
40664,3,1,142624,142624,142625,0,1,1
40665,6,3,142630,142630,142633,0,3,5
40666,2,1,142632,142633,142634,1,2,0
40667,5,3,142637,142637,142640,0,3,3
40668,5,2,142642,142642,142644,0,2,2
40669,4,3,142646,142646,142649,0,3,2
40670,5,1,142651,142651,142652,0,1,2
40671,5,2,142656,142656,142658,0,2,4
40672,2,2,142658,142658,142660,0,2,0
40673,4,2,142662,142662,142664,0,2,2
40674,3,1,142665,142665,142666,0,1,1
40675,6,3,142671,142671,142674,0,3,5
40676,4,2,142675,142675,142677,0,2,1
40677,3,1,142678,142678,142679,0,1,1
40678,2,2,142680,142680,142682,0,2,1
40679,3,2,142683,142683,142685,0,2,1
40680,5,1,142688,142688,142689,0,1,3
40681,2,2,142690,142690,142692,0,2,1
40682,2,3,142692,142692,142695,0,3,0
40683,3,2,142695,142695,142697,0,2,0
40684,2,1,142697,142697,142698,0,1,0
40685,1,1,142698,142698,142699,0,1,0
40686,2,3,142700,142700,142703,0,3,1
40687,5,1,142705,142705,142706,0,1,2
40688,5,2,142710,142710,142712,0,2,4
40689,1,3,142711,142712,142715,1,4,0
40690,2,1,142713,142715,142716,2,3,0
40691,5,3,142718,142718,142721,0,3,2
40692,4,2,142722,142722,142724,0,2,1
40693,6,2,142728,142728,142730,0,2,4
40694,6,1,142734,142734,142735,0,1,4
40695,1,2,142735,142735,142737,0,2,0
40696,6,1,142741,142741,142742,0,1,4
40697,6,2,142747,142747,142749,0,2,5
40698,4,2,142751,142751,142753,0,2,2
40699,4,3,142755,142755,142758,0,3,2
40700,4,1,142759,142759,142760,0,1,1
40701,1,3,142760,142760,142763,0,3,0
40702,5,3,142765,142765,142768,0,3,2
40703,2,2,142767,142768,142770,1,3,0
40704,5,3,142772,142772,142775,0,3,2
40705,3,3,142775,142775,142778,0,3,0
40706,4,1,142779,142779,142780,0,1,1
40707,6,3,142785,142785,142788,0,3,5
40708,2,1,142787,142788,142789,1,2,0
40709,5,1,142792,142792,142793,0,1,3
40710,3,1,142795,142795,142796,0,1,2
40711,2,2,142797,142797,142799,0,2,1
40712,3,2,142800,142800,142802,0,2,1
40713,2,1,142802,142802,142803,0,1,0
40714,3,2,142805,142805,142807,0,2,2
40715,1,2,142806,142807,142809,1,3,0
40716,1,3,142807,142809,142812,2,5,0
40717,3,3,142810,142812,142815,2,5,0
40718,1,2,142811,142815,142817,4,6,0
40719,4,3,142815,142817,142820,2,5,0
40720,6,3,142821,142821,142824,0,3,1
40721,6,1,142827,142827,142828,0,1,3
40722,2,1,142829,142829,142830,0,1,1
40723,6,1,142835,142835,142836,0,1,5
40724,2,1,142837,142837,142838,0,1,1
40725,2,2,142839,142839,142841,0,2,1
40726,5,2,142844,142844,142846,0,2,3
40727,6,1,142850,142850,142851,0,1,4
40728,3,1,142853,142853,142854,0,1,2
40729,3,3,142856,142856,142859,0,3,2
40730,5,2,142861,142861,142863,0,2,2
40731,6,1,142867,142867,142868,0,1,4
40732,5,3,142872,142872,142875,0,3,4
40733,2,1,142874,142875,142876,1,2,0
40734,1,2,142875,142876,142878,1,3,0
40735,1,2,142876,142878,142880,2,4,0
40736,4,1,142880,142880,142881,0,1,0
40737,1,3,142881,142881,142884,0,3,0
40738,6,3,142887,142887,142890,0,3,3
40739,5,1,142892,142892,142893,0,1,2
40740,1,2,142893,142893,142895,0,2,0
40741,4,2,142897,142897,142899,0,2,2
40742,1,1,142898,142899,142900,1,2,0
40743,3,2,142901,142901,142903,0,2,1
40744,1,3,142902,142903,142906,1,4,0
40745,1,1,142903,142906,142907,3,4,0
40746,1,1,142904,142907,142908,3,4,0
40747,1,2,142905,142908,142910,3,5,0
40748,3,2,142908,142910,142912,2,4,0
40749,1,2,142909,142912,142914,3,5,0
40750,4,2,142913,142914,142916,1,3,0
40751,6,3,142919,142919,142922,0,3,3
40752,2,1,142921,142922,142923,1,2,0
40753,1,2,142922,142923,142925,1,3,0
40754,4,3,142926,142926,142929,0,3,1
40755,1,3,142927,142929,142932,2,5,0
40756,1,3,142928,142932,142935,4,7,0
40757,2,1,142930,142935,142936,5,6,0
40758,4,2,142934,142936,142938,2,4,0
40759,6,1,142940,142940,142941,0,1,2
40760,1,1,142941,142941,142942,0,1,0
40761,2,1,142943,142943,142944,0,1,1
40762,1,2,142944,142944,142946,0,2,0
40763,1,2,142945,142946,142948,1,3,0
40764,1,2,142946,142948,142950,2,4,0
40765,2,3,142948,142950,142953,2,5,0
40766,4,2,142952,142953,142955,1,3,0
40767,3,1,142955,142955,142956,0,1,0
40768,1,1,142956,142956,142957,0,1,0
40769,6,1,142962,142962,142963,0,1,5
40770,2,3,142964,142964,142967,0,3,1
40771,2,3,142966,142967,142970,1,4,0
40772,4,3,142970,142970,142973,0,3,0
40773,6,1,142976,142976,142977,0,1,3
40774,2,1,142978,142978,142979,0,1,1
40775,4,3,142982,142982,142985,0,3,3
40776,4,1,142986,142986,142987,0,1,1
40777,6,3,142992,142992,142995,0,3,5
40778,5,1,142997,142997,142998,0,1,2
40779,1,3,142998,142998,143001,0,3,0
40780,1,3,142999,143001,143004,2,5,0
40781,1,3,143000,143004,143007,4,7,0
40782,4,1,143004,143007,143008,3,4,0
40783,5,3,143009,143009,143012,0,3,1
40784,4,2,143013,143013,143015,0,2,1
40785,6,1,143019,143019,143020,0,1,4
40786,3,1,143022,143022,143023,0,1,2
40787,5,3,143027,143027,143030,0,3,4
40788,6,1,143033,143033,143034,0,1,3
40789,5,3,143038,143038,143041,0,3,4
40790,1,3,143039,143041,143044,2,5,0
40791,2,3,143041,143044,143047,3,6,0
40792,3,3,143044,143047,143050,3,6,0
40793,3,2,143047,143050,143052,3,5,0
40794,5,3,143052,143052,143055,0,3,0
40795,2,2,143054,143055,143057,1,3,0
40796,3,1,143057,143057,143058,0,1,0
40797,1,2,143058,143058,143060,0,2,0
40798,3,2,143061,143061,143063,0,2,1
40799,6,2,143067,143067,143069,0,2,4
40800,6,2,143073,143073,143075,0,2,4
40801,4,3,143077,143077,143080,0,3,2
40802,1,1,143078,143080,143081,2,3,0
40803,6,2,143084,143084,143086,0,2,3
40804,5,3,143089,143089,143092,0,3,3
40805,4,1,143093,143093,143094,0,1,1
40806,1,1,143094,143094,143095,0,1,0
40807,3,2,143097,143097,143099,0,2,2
40808,4,2,143101,143101,143103,0,2,2
40809,1,2,143102,143103,143105,1,3,0
40810,5,3,143107,143107,143110,0,3,2
40811,6,1,143113,143113,143114,0,1,3
40812,5,2,143118,143118,143120,0,2,4
40813,5,2,143123,143123,143125,0,2,3
40814,5,3,143128,143128,143131,0,3,3
40815,4,2,143132,143132,143134,0,2,1
40816,6,3,143138,143138,143141,0,3,4
40817,1,2,143139,143141,143143,2,4,0
40818,1,1,143140,143143,143144,3,4,0
40819,1,2,143141,143144,143146,3,5,0
40820,3,1,143144,143146,143147,2,3,0
40821,3,2,143147,143147,143149,0,2,0
40822,4,2,143151,143151,143153,0,2,2
40823,3,2,143154,143154,143156,0,2,1
40824,3,2,143157,143157,143159,0,2,1
40825,4,1,143161,143161,143162,0,1,2
40826,1,1,143162,143162,143163,0,1,0
40827,4,2,143166,143166,143168,0,2,3
40828,3,3,143169,143169,143172,0,3,1
40829,6,3,143175,143175,143178,0,3,3
40830,1,3,143176,143178,143181,2,5,0
40831,1,1,143177,143181,143182,4,5,0
40832,6,3,143183,143183,143186,0,3,1
40833,4,3,143187,143187,143190,0,3,1
40834,2,3,143189,143190,143193,1,4,0
40835,6,3,143195,143195,143198,0,3,2
40836,1,2,143196,143198,143200,2,4,0
40837,2,3,143198,143200,143203,2,5,0
40838,4,1,143202,143203,143204,1,2,0
40839,1,1,143203,143204,143205,1,2,0
40840,2,1,143205,143205,143206,0,1,0
40841,5,3,143210,143210,143213,0,3,4
40842,6,2,143216,143216,143218,0,2,3
40843,5,1,143221,143221,143222,0,1,3
40844,5,1,143226,143226,143227,0,1,4
40845,4,3,143230,143230,143233,0,3,3
40846,1,1,143231,143233,143234,2,3,0
40847,2,1,143233,143234,143235,1,2,0
40848,4,2,143237,143237,143239,0,2,2
40849,3,1,143240,143240,143241,0,1,1
40850,2,3,143242,143242,143245,0,3,1
40851,6,2,143248,143248,143250,0,2,3
40852,1,1,143249,143250,143251,1,2,0
40853,1,2,143250,143251,143253,1,3,0
40854,2,1,143252,143253,143254,1,2,0
40855,3,1,143255,143255,143256,0,1,1
40856,3,2,143258,143258,143260,0,2,2
40857,2,1,143260,143260,143261,0,1,0
40858,1,1,143261,143261,143262,0,1,0
40859,3,2,143264,143264,143266,0,2,2
40860,1,2,143265,143266,143268,1,3,0
40861,5,3,143270,143270,143273,0,3,2
40862,5,1,143275,143275,143276,0,1,2
40863,4,2,143279,143279,143281,0,2,3
40864,6,3,143285,143285,143288,0,3,4
40865,6,3,143291,143291,143294,0,3,3
40866,2,2,143293,143294,143296,1,3,0
40867,4,1,143297,143297,143298,0,1,1
40868,4,3,143301,143301,143304,0,3,3
40869,5,1,143306,143306,143307,0,1,2
40870,3,1,143309,143309,143310,0,1,2
40871,3,3,143312,143312,143315,0,3,2
40872,2,1,143314,143315,143316,1,2,0
40873,4,1,143318,143318,143319,0,1,2
40874,4,1,143322,143322,143323,0,1,3
40875,2,1,143324,143324,143325,0,1,1
40876,1,1,143325,143325,143326,0,1,0
40877,5,1,143330,143330,143331,0,1,4
40878,2,2,143332,143332,143334,0,2,1
40879,3,1,143335,143335,143336,0,1,1
40880,2,2,143337,143337,143339,0,2,1
40881,3,1,143340,143340,143341,0,1,1
40882,1,1,143341,143341,143342,0,1,0
40883,3,3,143344,143344,143347,0,3,2
40884,5,3,143349,143349,143352,0,3,2
40885,5,2,143354,143354,143356,0,2,2
40886,2,2,143356,143356,143358,0,2,0
40887,2,1,143358,143358,143359,0,1,0
40888,6,1,143364,143364,143365,0,1,5
40889,4,1,143368,143368,143369,0,1,3
40890,1,3,143369,143369,143372,0,3,0
40891,2,2,143371,143372,143374,1,3,0
40892,6,3,143377,143377,143380,0,3,3
40893,5,1,143382,143382,143383,0,1,2
40894,1,2,143383,143383,143385,0,2,0
40895,2,3,143385,143385,143388,0,3,0
40896,3,1,143388,143388,143389,0,1,0
40897,1,2,143389,143389,143391,0,2,0
40898,4,1,143393,143393,143394,0,1,2
40899,3,1,143396,143396,143397,0,1,2
40900,6,1,143402,143402,143403,0,1,5
40901,6,1,143408,143408,143409,0,1,5
40902,2,2,143410,143410,143412,0,2,1
40903,3,3,143413,143413,143416,0,3,1
40904,3,2,143416,143416,143418,0,2,0
40905,3,1,143419,143419,143420,0,1,1
40906,5,2,143424,143424,143426,0,2,4
40907,6,2,143430,143430,143432,0,2,4
40908,3,3,143433,143433,143436,0,3,1
40909,3,2,143436,143436,143438,0,2,0
40910,4,1,143440,143440,143441,0,1,2
40911,6,3,143446,143446,143449,0,3,5
40912,4,3,143450,143450,143453,0,3,1
40913,1,3,143451,143453,143456,2,5,0
40914,5,2,143456,143456,143458,0,2,0
40915,1,3,143457,143458,143461,1,4,0
40916,6,1,143463,143463,143464,0,1,2
40917,4,2,143467,143467,143469,0,2,3
40918,1,2,143468,143469,143471,1,3,0
40919,6,2,143474,143474,143476,0,2,3
40920,2,1,143476,143476,143477,0,1,0
40921,2,1,143478,143478,143479,0,1,1
40922,2,2,143480,143480,143482,0,2,1
40923,4,3,143484,143484,143487,0,3,2
40924,5,3,143489,143489,143492,0,3,2
40925,6,1,143495,143495,143496,0,1,3
40926,3,2,143498,143498,143500,0,2,2
40927,5,3,143503,143503,143506,0,3,3
40928,3,3,143506,143506,143509,0,3,0
40929,4,1,143510,143510,143511,0,1,1
40930,6,1,143516,143516,143517,0,1,5
40931,4,1,143520,143520,143521,0,1,3
40932,1,3,143521,143521,143524,0,3,0
40933,3,3,143524,143524,143527,0,3,0
40934,1,2,143525,143527,143529,2,4,0
40935,3,1,143528,143529,143530,1,2,0
40936,5,1,143533,143533,143534,0,1,3
40937,2,1,143535,143535,143536,0,1,1
40938,6,1,143541,143541,143542,0,1,5
40939,3,3,143544,143544,143547,0,3,2
40940,2,3,143546,143547,143550,1,4,0
40941,6,1,143552,143552,143553,0,1,2
40942,1,3,143553,143553,143556,0,3,0
40943,4,1,143557,143557,143558,0,1,1
40944,2,3,143559,143559,143562,0,3,1
40945,5,1,143564,143564,143565,0,1,2
40946,3,2,143567,143567,143569,0,2,2
40947,5,1,143572,143572,143573,0,1,3
40948,5,1,143577,143577,143578,0,1,4
40949,4,1,143581,143581,143582,0,1,3
40950,4,1,143585,143585,143586,0,1,3
40951,6,2,143591,143591,143593,0,2,5
40952,5,1,143596,143596,143597,0,1,3
40953,2,1,143598,143598,143599,0,1,1
40954,6,3,143604,143604,143607,0,3,5
40955,1,1,143605,143607,143608,2,3,0
40956,5,1,143610,143610,143611,0,1,2
40957,1,2,143611,143611,143613,0,2,0
40958,5,3,143616,143616,143619,0,3,3
40959,3,3,143619,143619,143622,0,3,0
40960,2,3,143621,143622,143625,1,4,0
40961,1,3,143622,143625,143628,3,6,0
40962,4,3,143626,143628,143631,2,5,0
40963,4,3,143630,143631,143634,1,4,0
40964,4,1,143634,143634,143635,0,1,0
40965,5,2,143639,143639,143641,0,2,4
40966,6,3,143645,143645,143648,0,3,4
40967,5,2,143650,143650,143652,0,2,2
40968,5,2,143655,143655,143657,0,2,3
40969,1,1,143656,143657,143658,1,2,0
40970,4,3,143660,143660,143663,0,3,2
40971,2,3,143662,143663,143666,1,4,0
40972,5,2,143667,143667,143669,0,2,1
40973,2,1,143669,143669,143670,0,1,0
40974,1,1,143670,143670,143671,0,1,0
40975,6,3,143676,143676,143679,0,3,5
40976,5,3,143681,143681,143684,0,3,2
40977,4,3,143685,143685,143688,0,3,1
40978,1,3,143686,143688,143691,2,5,0
40979,3,3,143689,143691,143694,2,5,0
40980,6,2,143695,143695,143697,0,2,1
40981,1,3,143696,143697,143700,1,4,0
40982,4,1,143700,143700,143701,0,1,0
40983,1,1,143701,143701,143702,0,1,0
40984,6,1,143707,143707,143708,0,1,5
40985,5,3,143712,143712,143715,0,3,4
40986,3,3,143715,143715,143718,0,3,0
40987,2,1,143717,143718,143719,1,2,0
40988,1,2,143718,143719,143721,1,3,0
40989,1,2,143719,143721,143723,2,4,0
40990,6,3,143725,143725,143728,0,3,2
40991,1,1,143726,143728,143729,2,3,0
40992,1,1,143727,143729,143730,2,3,0
40993,2,2,143729,143730,143732,1,3,0
40994,3,1,143732,143732,143733,0,1,0
40995,5,1,143737,143737,143738,0,1,4
40996,6,1,143743,143743,143744,0,1,5
40997,6,3,143749,143749,143752,0,3,5
40998,4,1,143753,143753,143754,0,1,1
40999,1,3,143754,143754,143757,0,3,0
41000,3,3,143757,143757,143760,0,3,0
41001,2,2,143759,143760,143762,1,3,0
41002,2,3,143761,143762,143765,1,4,0
41003,4,1,143765,143765,143766,0,1,0
41004,6,1,143771,143771,143772,0,1,5
41005,3,3,143774,143774,143777,0,3,2
41006,4,2,143778,143778,143780,0,2,1
41007,1,1,143779,143780,143781,1,2,0
41008,3,2,143782,143782,143784,0,2,1
41009,6,2,143788,143788,143790,0,2,4
41010,5,3,143793,143793,143796,0,3,3
41011,3,1,143796,143796,143797,0,1,0
41012,3,2,143799,143799,143801,0,2,2
41013,1,1,143800,143801,143802,1,2,0
41014,4,3,143804,143804,143807,0,3,2
41015,3,2,143807,143807,143809,0,2,0
41016,2,2,143809,143809,143811,0,2,0
41017,4,2,143813,143813,143815,0,2,2
41018,3,1,143816,143816,143817,0,1,1
41019,6,2,143822,143822,143824,0,2,5
41020,4,2,143826,143826,143828,0,2,2
41021,5,1,143831,143831,143832,0,1,3
41022,3,3,143834,143834,143837,0,3,2
41023,5,1,143839,143839,143840,0,1,2
41024,4,3,143843,143843,143846,0,3,3
41025,5,3,143848,143848,143851,0,3,2
41026,6,3,143854,143854,143857,0,3,3
41027,6,1,143860,143860,143861,0,1,3
41028,1,2,143861,143861,143863,0,2,0
41029,6,1,143867,143867,143868,0,1,4
41030,2,2,143869,143869,143871,0,2,1
41031,2,2,143871,143871,143873,0,2,0
41032,1,1,143872,143873,143874,1,2,0
41033,2,3,143874,143874,143877,0,3,0
41034,1,3,143875,143877,143880,2,5,0
41035,4,3,143879,143880,143883,1,4,0
41036,2,2,143881,143883,143885,2,4,0
41037,3,2,143884,143885,143887,1,3,0
41038,5,1,143889,143889,143890,0,1,2
41039,1,1,143890,143890,143891,0,1,0
41040,5,3,143895,143895,143898,0,3,4
41041,6,1,143901,143901,143902,0,1,3
41042,3,3,143904,143904,143907,0,3,2
41043,2,2,143906,143907,143909,1,3,0
41044,4,1,143910,143910,143911,0,1,1
41045,4,3,143914,143914,143917,0,3,3
41046,6,2,143920,143920,143922,0,2,3
41047,6,3,143926,143926,143929,0,3,4
41048,6,2,143932,143932,143934,0,2,3
41049,1,1,143933,143934,143935,1,2,0
41050,3,1,143936,143936,143937,0,1,1
41051,3,2,143939,143939,143941,0,2,2
41052,3,1,143942,143942,143943,0,1,1
41053,6,2,143948,143948,143950,0,2,5
41054,5,3,143953,143953,143956,0,3,3
41055,4,1,143957,143957,143958,0,1,1
41056,6,2,143963,143963,143965,0,2,5
41057,1,2,143964,143965,143967,1,3,0
41058,4,1,143968,143968,143969,0,1,1
41059,4,2,143972,143972,143974,0,2,3
41060,5,2,143977,143977,143979,0,2,3
41061,5,3,143982,143982,143985,0,3,3
41062,4,1,143986,143986,143987,0,1,1
41063,2,1,143988,143988,143989,0,1,1
41064,6,1,143994,143994,143995,0,1,5
41065,3,3,143997,143997,144000,0,3,2
41066,1,2,143998,144000,144002,2,4,0
41067,1,3,143999,144002,144005,3,6,0
41068,3,3,144002,144005,144008,3,6,0
41069,1,1,144003,144008,144009,5,6,0
41070,4,3,144007,144009,144012,2,5,0
41071,2,2,144009,144012,144014,3,5,0
41072,6,1,144015,144015,144016,0,1,1
41073,6,3,144021,144021,144024,0,3,5
41074,1,2,144022,144024,144026,2,4,0
41075,1,2,144023,144026,144028,3,5,0
41076,5,1,144028,144028,144029,0,1,0
41077,2,1,144030,144030,144031,0,1,1
41078,3,3,144033,144033,144036,0,3,2
41079,4,1,144037,144037,144038,0,1,1
41080,6,2,144043,144043,144045,0,2,5
41081,6,2,144049,144049,144051,0,2,4
41082,2,1,144051,144051,144052,0,1,0
41083,6,2,144057,144057,144059,0,2,5
41084,6,2,144063,144063,144065,0,2,4
41085,1,3,144064,144065,144068,1,4,0
41086,4,2,144068,144068,144070,0,2,0
41087,3,1,144071,144071,144072,0,1,1
41088,4,2,144075,144075,144077,0,2,3
41089,3,2,144078,144078,144080,0,2,1
41090,2,1,144080,144080,144081,0,1,0
41091,3,2,144083,144083,144085,0,2,2
41092,6,1,144089,144089,144090,0,1,4
41093,5,3,144094,144094,144097,0,3,4
41094,1,3,144095,144097,144100,2,5,0
41095,1,3,144096,144100,144103,4,7,0
41096,1,3,144097,144103,144106,6,9,0
41097,2,1,144099,144106,144107,7,8,0
41098,1,1,144100,144107,144108,7,8,0
41099,2,2,144102,144108,144110,6,8,0
41100,1,1,144103,144110,144111,7,8,0
41101,3,2,144106,144111,144113,5,7,0
41102,1,3,144107,144113,144116,6,9,0
41103,6,2,144113,144116,144118,3,5,0
41104,3,1,144116,144118,144119,2,3,0
41105,4,2,144120,144120,144122,0,2,1
41106,6,1,144126,144126,144127,0,1,4
41107,1,3,144127,144127,144130,0,3,0
41108,5,2,144132,144132,144134,0,2,2
41109,5,1,144137,144137,144138,0,1,3
41110,3,3,144140,144140,144143,0,3,2
41111,5,2,144145,144145,144147,0,2,2
41112,3,2,144148,144148,144150,0,2,1
41113,2,3,144150,144150,144153,0,3,0
41114,6,1,144156,144156,144157,0,1,3
41115,6,2,144162,144162,144164,0,2,5
41116,6,3,144168,144168,144171,0,3,4
41117,4,1,144172,144172,144173,0,1,1
41118,3,3,144175,144175,144178,0,3,2
41119,4,2,144179,144179,144181,0,2,1
41120,2,3,144181,144181,144184,0,3,0
41121,2,1,144183,144184,144185,1,2,0
41122,4,1,144187,144187,144188,0,1,2
41123,6,3,144193,144193,144196,0,3,5
41124,1,3,144194,144196,144199,2,5,0
41125,5,1,144199,144199,144200,0,1,0
41126,5,1,144204,144204,144205,0,1,4
41127,3,3,144207,144207,144210,0,3,2
41128,4,1,144211,144211,144212,0,1,1
41129,5,3,144216,144216,144219,0,3,4
41130,4,2,144220,144220,144222,0,2,1
41131,5,3,144225,144225,144228,0,3,3
41132,1,1,144226,144228,144229,2,3,0
41133,5,3,144231,144231,144234,0,3,2
41134,1,3,144232,144234,144237,2,5,0
41135,2,1,144234,144237,144238,3,4,0
41136,4,3,144238,144238,144241,0,3,0
41137,5,1,144243,144243,144244,0,1,2
41138,5,2,144248,144248,144250,0,2,4
41139,3,3,144251,144251,144254,0,3,1
41140,6,3,144257,144257,144260,0,3,3
41141,5,3,144262,144262,144265,0,3,2
41142,2,2,144264,144265,144267,1,3,0
41143,2,3,144266,144267,144270,1,4,0
41144,1,2,144267,144270,144272,3,5,0
41145,6,1,144273,144273,144274,0,1,1
41146,2,2,144275,144275,144277,0,2,1
41147,4,1,144279,144279,144280,0,1,2
41148,4,2,144283,144283,144285,0,2,3
41149,5,1,144288,144288,144289,0,1,3
41150,4,3,144292,144292,144295,0,3,3
41151,1,3,144293,144295,144298,2,5,0
41152,6,2,144299,144299,144301,0,2,1
41153,2,2,144301,144301,144303,0,2,0
41154,6,1,144307,144307,144308,0,1,4
41155,2,1,144309,144309,144310,0,1,1
41156,4,1,144313,144313,144314,0,1,3
41157,4,2,144317,144317,144319,0,2,3
41158,6,1,144323,144323,144324,0,1,4
41159,2,2,144325,144325,144327,0,2,1
41160,4,2,144329,144329,144331,0,2,2
41161,5,1,144334,144334,144335,0,1,3
41162,6,1,144340,144340,144341,0,1,5
41163,5,1,144345,144345,144346,0,1,4
41164,5,2,144350,144350,144352,0,2,4
41165,3,3,144353,144353,144356,0,3,1
41166,5,1,144358,144358,144359,0,1,2
41167,1,2,144359,144359,144361,0,2,0
41168,1,3,144360,144361,144364,1,4,0
41169,5,1,144365,144365,144366,0,1,1
41170,2,2,144367,144367,144369,0,2,1
41171,3,3,144370,144370,144373,0,3,1
41172,5,3,144375,144375,144378,0,3,2
41173,5,3,144380,144380,144383,0,3,2
41174,1,3,144381,144383,144386,2,5,0
41175,2,1,144383,144386,144387,3,4,0
41176,2,2,144385,144387,144389,2,4,0
41177,2,3,144387,144389,144392,2,5,0
41178,1,3,144388,144392,144395,4,7,0
41179,6,3,144394,144395,144398,1,4,0
41180,2,1,144396,144398,144399,2,3,0
41181,5,3,144401,144401,144404,0,3,2
41182,6,3,144407,144407,144410,0,3,3
41183,5,1,144412,144412,144413,0,1,2
41184,3,2,144415,144415,144417,0,2,2
41185,6,3,144421,144421,144424,0,3,4
41186,1,3,144422,144424,144427,2,5,0
41187,6,2,144428,144428,144430,0,2,1
41188,5,1,144433,144433,144434,0,1,3
41189,6,3,144439,144439,144442,0,3,5
41190,4,3,144443,144443,144446,0,3,1
41191,2,2,144445,144446,144448,1,3,0
41192,5,2,144450,144450,144452,0,2,2
41193,4,3,144454,144454,144457,0,3,2
41194,6,1,144460,144460,144461,0,1,3
41195,3,1,144463,144463,144464,0,1,2
41196,1,2,144464,144464,144466,0,2,0
41197,5,3,144469,144469,144472,0,3,3
41198,2,3,144471,144472,144475,1,4,0
41199,4,3,144475,144475,144478,0,3,0
41200,1,2,144476,144478,144480,2,4,0
41201,2,2,144478,144480,144482,2,4,0
41202,6,1,144484,144484,144485,0,1,2
41203,3,1,144487,144487,144488,0,1,2
41204,1,3,144488,144488,144491,0,3,0
41205,3,2,144491,144491,144493,0,2,0
41206,1,1,144492,144493,144494,1,2,0
41207,1,3,144493,144494,144497,1,4,0
41208,1,1,144494,144497,144498,3,4,0
41209,2,3,144496,144498,144501,2,5,0
41210,3,1,144499,144501,144502,2,3,0
41211,4,1,144503,144503,144504,0,1,1
41212,1,2,144504,144504,144506,0,2,0
41213,6,3,144510,144510,144513,0,3,4
41214,2,1,144512,144513,144514,1,2,0
41215,2,2,144514,144514,144516,0,2,0
41216,4,2,144518,144518,144520,0,2,2
41217,4,3,144522,144522,144525,0,3,2
41218,4,1,144526,144526,144527,0,1,1
41219,3,3,144529,144529,144532,0,3,2
41220,3,2,144532,144532,144534,0,2,0
41221,2,2,144534,144534,144536,0,2,0
41222,3,1,144537,144537,144538,0,1,1
41223,3,2,144540,144540,144542,0,2,2
41224,2,3,144542,144542,144545,0,3,0
41225,3,3,144545,144545,144548,0,3,0
41226,4,1,144549,144549,144550,0,1,1
41227,6,3,144555,144555,144558,0,3,5
41228,5,1,144560,144560,144561,0,1,2
41229,6,2,144566,144566,144568,0,2,5
41230,3,1,144569,144569,144570,0,1,1
41231,5,2,144574,144574,144576,0,2,4
41232,5,1,144579,144579,144580,0,1,3
41233,3,1,144582,144582,144583,0,1,2
41234,4,3,144586,144586,144589,0,3,3
41235,3,3,144589,144589,144592,0,3,0
41236,5,1,144594,144594,144595,0,1,2
41237,1,2,144595,144595,144597,0,2,0
41238,3,2,144598,144598,144600,0,2,1
41239,6,1,144604,144604,144605,0,1,4
41240,1,3,144605,144605,144608,0,3,0
41241,1,1,144606,144608,144609,2,3,0
41242,3,3,144609,144609,144612,0,3,0
41243,5,2,144614,144614,144616,0,2,2
41244,5,1,144619,144619,144620,0,1,3
41245,5,3,144624,144624,144627,0,3,4
41246,5,1,144629,144629,144630,0,1,2
41247,6,1,144635,144635,144636,0,1,5
41248,1,3,144636,144636,144639,0,3,0
41249,6,3,144642,144642,144645,0,3,3
41250,2,1,144644,144645,144646,1,2,0
41251,4,1,144648,144648,144649,0,1,2
41252,5,2,144653,144653,144655,0,2,4
41253,2,1,144655,144655,144656,0,1,0
41254,3,3,144658,144658,144661,0,3,2
41255,6,3,144664,144664,144667,0,3,3
41256,5,2,144669,144669,144671,0,2,2
41257,5,3,144674,144674,144677,0,3,3
41258,3,1,144677,144677,144678,0,1,0
41259,3,2,144680,144680,144682,0,2,2
41260,6,2,144686,144686,144688,0,2,4
41261,5,2,144691,144691,144693,0,2,3
41262,2,1,144693,144693,144694,0,1,0
41263,3,3,144696,144696,144699,0,3,2
41264,2,1,144698,144699,144700,1,2,0
41265,2,1,144700,144700,144701,0,1,0
41266,2,3,144702,144702,144705,0,3,1
41267,6,1,144708,144708,144709,0,1,3
41268,5,3,144713,144713,144716,0,3,4
41269,1,1,144714,144716,144717,2,3,0
41270,6,1,144720,144720,144721,0,1,3
41271,4,3,144724,144724,144727,0,3,3
41272,1,1,144725,144727,144728,2,3,0
41273,4,3,144729,144729,144732,0,3,1
41274,3,3,144732,144732,144735,0,3,0
41275,5,1,144737,144737,144738,0,1,2
41276,2,1,144739,144739,144740,0,1,1
41277,1,2,144740,144740,144742,0,2,0
41278,2,1,144742,144742,144743,0,1,0
41279,4,1,144746,144746,144747,0,1,3
41280,5,1,144751,144751,144752,0,1,4
41281,6,2,144757,144757,144759,0,2,5
41282,3,1,144760,144760,144761,0,1,1
41283,3,2,144763,144763,144765,0,2,2
41284,2,3,144765,144765,144768,0,3,0
41285,2,3,144767,144768,144771,1,4,0
41286,1,1,144768,144771,144772,3,4,0
41287,5,1,144773,144773,144774,0,1,1
41288,1,1,144774,144774,144775,0,1,0
41289,5,1,144779,144779,144780,0,1,4
41290,4,3,144783,144783,144786,0,3,3
41291,2,2,144785,144786,144788,1,3,0
41292,6,1,144791,144791,144792,0,1,3
41293,5,3,144796,144796,144799,0,3,4
41294,4,1,144800,144800,144801,0,1,1
41295,6,2,144806,144806,144808,0,2,5
41296,5,2,144811,144811,144813,0,2,3
41297,5,3,144816,144816,144819,0,3,3
41298,2,3,144818,144819,144822,1,4,0
41299,4,1,144822,144822,144823,0,1,0
41300,2,2,144824,144824,144826,0,2,1
41301,2,2,144826,144826,144828,0,2,0
41302,4,2,144830,144830,144832,0,2,2
41303,4,1,144834,144834,144835,0,1,2
41304,6,1,144840,144840,144841,0,1,5
41305,3,1,144843,144843,144844,0,1,2
41306,5,1,144848,144848,144849,0,1,4
41307,2,2,144850,144850,144852,0,2,1
41308,4,3,144854,144854,144857,0,3,2
41309,6,1,144860,144860,144861,0,1,3
41310,2,2,144862,144862,144864,0,2,1
41311,5,1,144867,144867,144868,0,1,3
41312,5,2,144872,144872,144874,0,2,4
41313,2,1,144874,144874,144875,0,1,0
41314,1,2,144875,144875,144877,0,2,0
41315,5,2,144880,144880,144882,0,2,3
41316,2,1,144882,144882,144883,0,1,0
41317,3,3,144885,144885,144888,0,3,2
41318,6,2,144891,144891,144893,0,2,3
41319,2,2,144893,144893,144895,0,2,0
41320,1,3,144894,144895,144898,1,4,0
41321,6,3,144900,144900,144903,0,3,2
41322,3,2,144903,144903,144905,0,2,0
41323,5,3,144908,144908,144911,0,3,3
41324,5,3,144913,144913,144916,0,3,2
41325,4,2,144917,144917,144919,0,2,1
41326,1,1,144918,144919,144920,1,2,0
41327,4,1,144922,144922,144923,0,1,2
41328,1,2,144923,144923,144925,0,2,0
41329,6,1,144929,144929,144930,0,1,4
41330,3,2,144932,144932,144934,0,2,2
41331,4,1,144936,144936,144937,0,1,2
41332,6,2,144942,144942,144944,0,2,5
41333,5,1,144947,144947,144948,0,1,3
41334,1,1,144948,144948,144949,0,1,0
41335,5,2,144953,144953,144955,0,2,4
41336,4,3,144957,144957,144960,0,3,2
41337,3,2,144960,144960,144962,0,2,0
41338,1,3,144961,144962,144965,1,4,0
41339,4,3,144965,144965,144968,0,3,0
41340,6,3,144971,144971,144974,0,3,3
41341,3,3,144974,144974,144977,0,3,0
41342,3,1,144977,144977,144978,0,1,0
41343,3,2,144980,144980,144982,0,2,2
41344,5,3,144985,144985,144988,0,3,3
41345,4,2,144989,144989,144991,0,2,1
41346,6,3,144995,144995,144998,0,3,4
41347,5,1,145000,145000,145001,0,1,2
41348,4,1,145004,145004,145005,0,1,3
41349,1,3,145005,145005,145008,0,3,0
41350,5,1,145010,145010,145011,0,1,2
41351,4,2,145014,145014,145016,0,2,3
41352,6,3,145020,145020,145023,0,3,4
41353,3,1,145023,145023,145024,0,1,0
41354,6,1,145029,145029,145030,0,1,5
41355,2,3,145031,145031,145034,0,3,1
41356,5,3,145036,145036,145039,0,3,2
41357,3,1,145039,145039,145040,0,1,0
41358,2,2,145041,145041,145043,0,2,1
41359,5,1,145046,145046,145047,0,1,3
41360,4,1,145050,145050,145051,0,1,3
41361,6,2,145056,145056,145058,0,2,5
41362,3,1,145059,145059,145060,0,1,1
41363,6,3,145065,145065,145068,0,3,5
41364,2,2,145067,145068,145070,1,3,0
41365,5,3,145072,145072,145075,0,3,2
41366,6,2,145078,145078,145080,0,2,3
41367,6,2,145084,145084,145086,0,2,4
41368,6,1,145090,145090,145091,0,1,4
41369,6,3,145096,145096,145099,0,3,5
41370,2,2,145098,145099,145101,1,3,0
41371,6,3,145104,145104,145107,0,3,3
41372,1,2,145105,145107,145109,2,4,0
41373,5,2,145110,145110,145112,0,2,1
41374,2,1,145112,145112,145113,0,1,0
41375,6,2,145118,145118,145120,0,2,5
41376,4,3,145122,145122,145125,0,3,2
41377,1,1,145123,145125,145126,2,3,0
41378,3,2,145126,145126,145128,0,2,0
41379,3,1,145129,145129,145130,0,1,1
41380,3,1,145132,145132,145133,0,1,2
41381,2,2,145134,145134,145136,0,2,1
41382,3,3,145137,145137,145140,0,3,1
41383,1,3,145138,145140,145143,2,5,0
41384,6,1,145144,145144,145145,0,1,1
41385,5,2,145149,145149,145151,0,2,4
41386,4,3,145153,145153,145156,0,3,2
41387,3,2,145156,145156,145158,0,2,0
41388,4,2,145160,145160,145162,0,2,2
41389,1,3,145161,145162,145165,1,4,0
41390,1,1,145162,145165,145166,3,4,0
41391,1,3,145163,145166,145169,3,6,0
41392,4,2,145167,145169,145171,2,4,0
41393,1,1,145168,145171,145172,3,4,0
41394,5,1,145173,145173,145174,0,1,1
41395,3,1,145176,145176,145177,0,1,2
41396,4,3,145180,145180,145183,0,3,3
41397,2,3,145182,145183,145186,1,4,0
41398,3,1,145185,145186,145187,1,2,0
41399,6,2,145191,145191,145193,0,2,4
41400,4,3,145195,145195,145198,0,3,2
41401,6,2,145201,145201,145203,0,2,3
41402,2,1,145203,145203,145204,0,1,0
41403,5,3,145208,145208,145211,0,3,4
41404,3,3,145211,145211,145214,0,3,0
41405,1,1,145212,145214,145215,2,3,0
41406,2,1,145214,145215,145216,1,2,0
41407,1,1,145215,145216,145217,1,2,0
41408,2,2,145217,145217,145219,0,2,0
41409,6,3,145223,145223,145226,0,3,4
41410,5,3,145228,145228,145231,0,3,2
41411,4,3,145232,145232,145235,0,3,1
41412,6,2,145238,145238,145240,0,2,3
41413,3,1,145241,145241,145242,0,1,1
41414,5,2,145246,145246,145248,0,2,4
41415,6,3,145252,145252,145255,0,3,4
41416,6,1,145258,145258,145259,0,1,3
41417,1,1,145259,145259,145260,0,1,0
41418,1,3,145260,145260,145263,0,3,0
41419,1,2,145261,145263,145265,2,4,0
41420,4,2,145265,145265,145267,0,2,0
41421,4,2,145269,145269,145271,0,2,2
41422,1,1,145270,145271,145272,1,2,0
41423,5,1,145275,145275,145276,0,1,3
41424,6,1,145281,145281,145282,0,1,5
41425,1,1,145282,145282,145283,0,1,0
41426,5,2,145287,145287,145289,0,2,4
41427,4,2,145291,145291,145293,0,2,2
41428,1,1,145292,145293,145294,1,2,0
41429,2,2,145294,145294,145296,0,2,0
41430,5,2,145299,145299,145301,0,2,3
41431,3,2,145302,145302,145304,0,2,1
41432,4,2,145306,145306,145308,0,2,2
41433,5,1,145311,145311,145312,0,1,3
41434,5,2,145316,145316,145318,0,2,4
41435,3,2,145319,145319,145321,0,2,1
41436,6,1,145325,145325,145326,0,1,4
41437,5,1,145330,145330,145331,0,1,4
41438,5,1,145335,145335,145336,0,1,4
41439,5,3,145340,145340,145343,0,3,4
41440,4,3,145344,145344,145347,0,3,1
41441,1,2,145345,145347,145349,2,4,0
41442,2,2,145347,145349,145351,2,4,0
41443,5,2,145352,145352,145354,0,2,1
41444,4,3,145356,145356,145359,0,3,2
41445,4,2,145360,145360,145362,0,2,1
41446,2,3,145362,145362,145365,0,3,0
41447,4,1,145366,145366,145367,0,1,1
41448,3,2,145369,145369,145371,0,2,2
41449,1,1,145370,145371,145372,1,2,0
41450,5,1,145375,145375,145376,0,1,3
41451,2,2,145377,145377,145379,0,2,1
41452,2,2,145379,145379,145381,0,2,0
41453,6,2,145385,145385,145387,0,2,4
41454,2,3,145387,145387,145390,0,3,0
41455,5,1,145392,145392,145393,0,1,2
41456,1,3,145393,145393,145396,0,3,0
41457,5,1,145398,145398,145399,0,1,2
41458,4,3,145402,145402,145405,0,3,3
41459,5,1,145407,145407,145408,0,1,2
41460,5,3,145412,145412,145415,0,3,4
41461,4,3,145416,145416,145419,0,3,1
41462,3,2,145419,145419,145421,0,2,0
41463,3,1,145422,145422,145423,0,1,1
41464,6,2,145428,145428,145430,0,2,5
41465,2,1,145430,145430,145431,0,1,0
41466,3,2,145433,145433,145435,0,2,2
41467,6,2,145439,145439,145441,0,2,4
41468,6,2,145445,145445,145447,0,2,4
41469,3,1,145448,145448,145449,0,1,1
41470,6,2,145454,145454,145456,0,2,5
41471,3,1,145457,145457,145458,0,1,1
41472,4,3,145461,145461,145464,0,3,3
41473,3,3,145464,145464,145467,0,3,0
41474,5,1,145469,145469,145470,0,1,2
41475,2,2,145471,145471,145473,0,2,1
41476,3,2,145474,145474,145476,0,2,1
41477,6,2,145480,145480,145482,0,2,4
41478,6,1,145486,145486,145487,0,1,4
41479,4,2,145490,145490,145492,0,2,3
41480,2,3,145492,145492,145495,0,3,0
41481,2,3,145494,145495,145498,1,4,0
41482,5,1,145499,145499,145500,0,1,1
41483,4,3,145503,145503,145506,0,3,3
41484,3,3,145506,145506,145509,0,3,0
41485,2,1,145508,145509,145510,1,2,0
41486,5,1,145513,145513,145514,0,1,3
41487,4,3,145517,145517,145520,0,3,3
41488,3,1,145520,145520,145521,0,1,0
41489,5,1,145525,145525,145526,0,1,4
41490,1,3,145526,145526,145529,0,3,0
41491,3,2,145529,145529,145531,0,2,0
41492,4,1,145533,145533,145534,0,1,2
41493,5,1,145538,145538,145539,0,1,4
41494,2,1,145540,145540,145541,0,1,1
41495,1,2,145541,145541,145543,0,2,0
41496,1,1,145542,145543,145544,1,2,0
41497,5,1,145547,145547,145548,0,1,3
41498,1,2,145548,145548,145550,0,2,0
41499,5,3,145553,145553,145556,0,3,3
41500,1,2,145554,145556,145558,2,4,0
41501,2,1,145556,145558,145559,2,3,0
41502,3,2,145559,145559,145561,0,2,0
41503,4,3,145563,145563,145566,0,3,2
41504,4,3,145567,145567,145570,0,3,1
41505,4,3,145571,145571,145574,0,3,1
41506,2,3,145573,145574,145577,1,4,0
41507,6,2,145579,145579,145581,0,2,2
41508,3,2,145582,145582,145584,0,2,1
41509,1,2,145583,145584,145586,1,3,0
41510,6,3,145589,145589,145592,0,3,3
41511,3,3,145592,145592,145595,0,3,0
41512,2,2,145594,145595,145597,1,3,0
41513,1,1,145595,145597,145598,2,3,0
41514,1,2,145596,145598,145600,2,4,0
41515,1,2,145597,145600,145602,3,5,0
41516,4,1,145601,145602,145603,1,2,0
41517,6,1,145607,145607,145608,0,1,4
41518,5,1,145612,145612,145613,0,1,4
41519,2,1,145614,145614,145615,0,1,1
41520,6,3,145620,145620,145623,0,3,5
41521,2,1,145622,145623,145624,1,2,0
41522,4,1,145626,145626,145627,0,1,2
41523,6,3,145632,145632,145635,0,3,5
41524,1,3,145633,145635,145638,2,5,0
41525,4,2,145637,145638,145640,1,3,0
41526,5,3,145642,145642,145645,0,3,2
41527,6,3,145648,145648,145651,0,3,3
41528,3,2,145651,145651,145653,0,2,0
41529,4,3,145655,145655,145658,0,3,2
41530,3,2,145658,145658,145660,0,2,0
41531,1,2,145659,145660,145662,1,3,0
41532,4,3,145663,145663,145666,0,3,1
41533,2,2,145665,145666,145668,1,3,0
41534,4,1,145669,145669,145670,0,1,1
41535,5,2,145674,145674,145676,0,2,4
41536,4,2,145678,145678,145680,0,2,2
41537,3,2,145681,145681,145683,0,2,1
41538,3,3,145684,145684,145687,0,3,1
41539,5,1,145689,145689,145690,0,1,2
41540,2,1,145691,145691,145692,0,1,1
41541,2,2,145693,145693,145695,0,2,1
41542,6,3,145699,145699,145702,0,3,4
41543,4,1,145703,145703,145704,0,1,1
41544,1,3,145704,145704,145707,0,3,0
41545,3,1,145707,145707,145708,0,1,0
41546,1,2,145708,145708,145710,0,2,0
41547,4,2,145712,145712,145714,0,2,2
41548,2,1,145714,145714,145715,0,1,0
41549,6,2,145720,145720,145722,0,2,5
41550,3,1,145723,145723,145724,0,1,1
41551,6,3,145729,145729,145732,0,3,5
41552,3,2,145732,145732,145734,0,2,0
41553,2,1,145734,145734,145735,0,1,0
41554,3,1,145737,145737,145738,0,1,2
41555,5,2,145742,145742,145744,0,2,4
41556,6,1,145748,145748,145749,0,1,4
41557,6,3,145754,145754,145757,0,3,5
41558,4,1,145758,145758,145759,0,1,1
41559,4,1,145762,145762,145763,0,1,3
41560,4,2,145766,145766,145768,0,2,3
41561,4,1,145770,145770,145771,0,1,2
41562,4,3,145774,145774,145777,0,3,3
41563,5,1,145779,145779,145780,0,1,2
41564,1,3,145780,145780,145783,0,3,0
41565,3,2,145783,145783,145785,0,2,0
41566,3,1,145786,145786,145787,0,1,1
41567,1,3,145787,145787,145790,0,3,0
41568,1,3,145788,145790,145793,2,5,0
41569,5,2,145793,145793,145795,0,2,0
41570,1,1,145794,145795,145796,1,2,0
41571,6,1,145800,145800,145801,0,1,4
41572,1,1,145801,145801,145802,0,1,0
41573,4,3,145805,145805,145808,0,3,3
41574,5,1,145810,145810,145811,0,1,2
41575,3,1,145813,145813,145814,0,1,2
41576,5,3,145818,145818,145821,0,3,4
41577,3,1,145821,145821,145822,0,1,0
41578,3,2,145824,145824,145826,0,2,2
41579,5,2,145829,145829,145831,0,2,3
41580,6,2,145835,145835,145837,0,2,4
41581,5,2,145840,145840,145842,0,2,3
41582,6,2,145846,145846,145848,0,2,4
41583,4,1,145850,145850,145851,0,1,2
41584,5,2,145855,145855,145857,0,2,4
41585,1,3,145856,145857,145860,1,4,0
41586,2,2,145858,145860,145862,2,4,0
41587,4,2,145862,145862,145864,0,2,0
41588,3,2,145865,145865,145867,0,2,1
41589,4,2,145869,145869,145871,0,2,2
41590,4,3,145873,145873,145876,0,3,2
41591,2,3,145875,145876,145879,1,4,0
41592,5,1,145880,145880,145881,0,1,1
41593,6,1,145886,145886,145887,0,1,5
41594,5,1,145891,145891,145892,0,1,4
41595,1,1,145892,145892,145893,0,1,0
41596,5,3,145897,145897,145900,0,3,4
41597,6,2,145903,145903,145905,0,2,3
41598,5,3,145908,145908,145911,0,3,3
41599,6,3,145914,145914,145917,0,3,3
41600,6,2,145920,145920,145922,0,2,3
41601,3,3,145923,145923,145926,0,3,1
41602,4,2,145927,145927,145929,0,2,1
41603,1,2,145928,145929,145931,1,3,0
41604,1,1,145929,145931,145932,2,3,0
41605,3,1,145932,145932,145933,0,1,0
41606,3,1,145935,145935,145936,0,1,2
41607,2,2,145937,145937,145939,0,2,1
41608,3,2,145940,145940,145942,0,2,1
41609,6,1,145946,145946,145947,0,1,4
41610,4,3,145950,145950,145953,0,3,3
41611,4,3,145954,145954,145957,0,3,1
41612,3,2,145957,145957,145959,0,2,0
41613,1,1,145958,145959,145960,1,2,0
41614,3,3,145961,145961,145964,0,3,1
41615,5,3,145966,145966,145969,0,3,2
41616,3,2,145969,145969,145971,0,2,0
41617,5,2,145974,145974,145976,0,2,3
41618,6,1,145980,145980,145981,0,1,4
41619,2,1,145982,145982,145983,0,1,1
41620,1,3,145983,145983,145986,0,3,0
41621,3,3,145986,145986,145989,0,3,0
41622,3,1,145989,145989,145990,0,1,0
41623,5,2,145994,145994,145996,0,2,4
41624,4,1,145998,145998,145999,0,1,2
41625,4,3,146002,146002,146005,0,3,3
41626,3,1,146005,146005,146006,0,1,0
41627,2,2,146007,146007,146009,0,2,1
41628,4,2,146011,146011,146013,0,2,2
41629,2,2,146013,146013,146015,0,2,0
41630,5,1,146018,146018,146019,0,1,3
41631,5,2,146023,146023,146025,0,2,4
41632,2,2,146025,146025,146027,0,2,0
41633,2,1,146027,146027,146028,0,1,0
41634,2,2,146029,146029,146031,0,2,1
41635,6,1,146035,146035,146036,0,1,4
41636,2,1,146037,146037,146038,0,1,1
41637,1,1,146038,146038,146039,0,1,0
41638,4,1,146042,146042,146043,0,1,3
41639,5,1,146047,146047,146048,0,1,4
41640,4,2,146051,146051,146053,0,2,3
41641,2,3,146053,146053,146056,0,3,0
41642,6,2,146059,146059,146061,0,2,3
41643,4,3,146063,146063,146066,0,3,2
41644,3,3,146066,146066,146069,0,3,0
41645,2,2,146068,146069,146071,1,3,0
41646,2,2,146070,146071,146073,1,3,0
41647,3,3,146073,146073,146076,0,3,0
41648,6,1,146079,146079,146080,0,1,3
41649,2,1,146081,146081,146082,0,1,1
41650,6,3,146087,146087,146090,0,3,5
41651,5,3,146092,146092,146095,0,3,2
41652,5,2,146097,146097,146099,0,2,2
41653,3,1,146100,146100,146101,0,1,1
41654,1,3,146101,146101,146104,0,3,0
41655,3,2,146104,146104,146106,0,2,0
41656,4,2,146108,146108,146110,0,2,2
41657,6,1,146114,146114,146115,0,1,4
41658,3,2,146117,146117,146119,0,2,2
41659,3,2,146120,146120,146122,0,2,1
41660,6,2,146126,146126,146128,0,2,4
41661,1,2,146127,146128,146130,1,3,0
41662,4,2,146131,146131,146133,0,2,1
41663,5,2,146136,146136,146138,0,2,3
41664,3,1,146139,146139,146140,0,1,1
41665,3,1,146142,146142,146143,0,1,2
41666,1,1,146143,146143,146144,0,1,0
41667,5,2,146148,146148,146150,0,2,4
41668,2,2,146150,146150,146152,0,2,0
41669,1,2,146151,146152,146154,1,3,0
41670,2,2,146153,146154,146156,1,3,0
41671,4,3,146157,146157,146160,0,3,1
41672,6,1,146163,146163,146164,0,1,3
41673,5,3,146168,146168,146171,0,3,4
41674,2,1,146170,146171,146172,1,2,0
41675,4,1,146174,146174,146175,0,1,2
41676,5,3,146179,146179,146182,0,3,4
41677,1,1,146180,146182,146183,2,3,0
41678,5,3,146185,146185,146188,0,3,2
41679,1,2,146186,146188,146190,2,4,0
41680,4,1,146190,146190,146191,0,1,0
41681,3,3,146193,146193,146196,0,3,2
41682,2,1,146195,146196,146197,1,2,0
41683,4,3,146199,146199,146202,0,3,2
41684,5,1,146204,146204,146205,0,1,2
41685,5,1,146209,146209,146210,0,1,4
41686,6,3,146215,146215,146218,0,3,5
41687,6,3,146221,146221,146224,0,3,3
41688,4,3,146225,146225,146228,0,3,1
41689,5,2,146230,146230,146232,0,2,2
41690,3,3,146233,146233,146236,0,3,1
41691,6,3,146239,146239,146242,0,3,3
41692,6,2,146245,146245,146247,0,2,3
41693,6,2,146251,146251,146253,0,2,4
41694,3,2,146254,146254,146256,0,2,1
41695,3,1,146257,146257,146258,0,1,1
41696,1,3,146258,146258,146261,0,3,0
41697,1,1,146259,146261,146262,2,3,0
41698,5,3,146264,146264,146267,0,3,2
41699,1,3,146265,146267,146270,2,5,0
41700,1,1,146266,146270,146271,4,5,0
41701,1,3,146267,146271,146274,4,7,0
41702,1,1,146268,146274,146275,6,7,0
41703,3,2,146271,146275,146277,4,6,0
41704,3,1,146274,146277,146278,3,4,0
41705,6,3,146280,146280,146283,0,3,2
41706,1,3,146281,146283,146286,2,5,0
41707,4,1,146285,146286,146287,1,2,0
41708,6,1,146291,146291,146292,0,1,4
41709,4,3,146295,146295,146298,0,3,3
41710,6,1,146301,146301,146302,0,1,3
41711,1,2,146302,146302,146304,0,2,0
41712,3,3,146305,146305,146308,0,3,1
41713,6,1,146311,146311,146312,0,1,3
41714,5,3,146316,146316,146319,0,3,4
41715,4,2,146320,146320,146322,0,2,1
41716,5,1,146325,146325,146326,0,1,3
41717,6,1,146331,146331,146332,0,1,5
41718,4,3,146335,146335,146338,0,3,3
41719,2,3,146337,146338,146341,1,4,0
41720,1,1,146338,146341,146342,3,4,0
41721,3,3,146341,146342,146345,1,4,0
41722,3,1,146344,146345,146346,1,2,0
41723,2,2,146346,146346,146348,0,2,0
41724,6,1,146352,146352,146353,0,1,4
41725,3,2,146355,146355,146357,0,2,2
41726,2,1,146357,146357,146358,0,1,0
41727,3,2,146360,146360,146362,0,2,2
41728,3,1,146363,146363,146364,0,1,1
41729,1,2,146364,146364,146366,0,2,0
41730,3,2,146367,146367,146369,0,2,1
41731,6,1,146373,146373,146374,0,1,4
41732,4,3,146377,146377,146380,0,3,3
41733,4,2,146381,146381,146383,0,2,1
41734,2,3,146383,146383,146386,0,3,0
41735,4,2,146387,146387,146389,0,2,1
41736,6,1,146393,146393,146394,0,1,4
41737,6,3,146399,146399,146402,0,3,5
41738,5,2,146404,146404,146406,0,2,2
41739,1,2,146405,146406,146408,1,3,0
41740,4,1,146409,146409,146410,0,1,1
41741,4,3,146413,146413,146416,0,3,3
41742,6,1,146419,146419,146420,0,1,3
41743,6,1,146425,146425,146426,0,1,5
41744,5,2,146430,146430,146432,0,2,4
41745,1,1,146431,146432,146433,1,2,0
41746,6,1,146437,146437,146438,0,1,4
41747,4,1,146441,146441,146442,0,1,3
41748,3,2,146444,146444,146446,0,2,2
41749,4,1,146448,146448,146449,0,1,2
41750,3,3,146451,146451,146454,0,3,2
41751,4,3,146455,146455,146458,0,3,1
41752,5,1,146460,146460,146461,0,1,2
41753,5,2,146465,146465,146467,0,2,4
41754,1,3,146466,146467,146470,1,4,0
41755,3,2,146469,146470,146472,1,3,0
41756,3,2,146472,146472,146474,0,2,0
41757,5,3,146477,146477,146480,0,3,3
41758,5,3,146482,146482,146485,0,3,2
41759,1,1,146483,146485,146486,2,3,0
41760,5,1,146488,146488,146489,0,1,2
41761,1,2,146489,146489,146491,0,2,0
41762,2,3,146491,146491,146494,0,3,0
41763,3,2,146494,146494,146496,0,2,0
41764,3,2,146497,146497,146499,0,2,1
41765,3,2,146500,146500,146502,0,2,1
41766,5,3,146505,146505,146508,0,3,3
41767,2,2,146507,146508,146510,1,3,0
41768,1,2,146508,146510,146512,2,4,0
41769,6,2,146514,146514,146516,0,2,2
41770,2,3,146516,146516,146519,0,3,0
41771,1,2,146517,146519,146521,2,4,0
41772,1,1,146518,146521,146522,3,4,0
41773,4,2,146522,146522,146524,0,2,0
41774,1,2,146523,146524,146526,1,3,0
41775,2,1,146525,146526,146527,1,2,0
41776,6,1,146531,146531,146532,0,1,4
41777,1,1,146532,146532,146533,0,1,0
41778,2,1,146534,146534,146535,0,1,1
41779,6,1,146540,146540,146541,0,1,5
41780,5,1,146545,146545,146546,0,1,4
41781,1,3,146546,146546,146549,0,3,0
41782,6,3,146552,146552,146555,0,3,3
41783,1,2,146553,146555,146557,2,4,0
41784,3,3,146556,146557,146560,1,4,0
41785,5,1,146561,146561,146562,0,1,1
41786,6,3,146567,146567,146570,0,3,5
41787,6,3,146573,146573,146576,0,3,3
41788,4,1,146577,146577,146578,0,1,1
41789,6,3,146583,146583,146586,0,3,5
41790,4,1,146587,146587,146588,0,1,1
41791,2,1,146589,146589,146590,0,1,1
41792,3,2,146592,146592,146594,0,2,2
41793,2,3,146594,146594,146597,0,3,0
41794,5,3,146599,146599,146602,0,3,2
41795,6,1,146605,146605,146606,0,1,3
41796,2,1,146607,146607,146608,0,1,1
41797,6,2,146613,146613,146615,0,2,5
41798,4,2,146617,146617,146619,0,2,2
41799,6,1,146623,146623,146624,0,1,4
41800,6,2,146629,146629,146631,0,2,5
41801,1,1,146630,146631,146632,1,2,0
41802,3,2,146633,146633,146635,0,2,1
41803,2,3,146635,146635,146638,0,3,0
41804,5,3,146640,146640,146643,0,3,2
41805,3,3,146643,146643,146646,0,3,0
41806,3,3,146646,146646,146649,0,3,0
41807,2,3,146648,146649,146652,1,4,0
41808,2,2,146650,146652,146654,2,4,0
41809,6,1,146656,146656,146657,0,1,2
41810,2,2,146658,146658,146660,0,2,1
41811,4,3,146662,146662,146665,0,3,2
41812,5,3,146667,146667,146670,0,3,2
41813,5,1,146672,146672,146673,0,1,2
41814,2,1,146674,146674,146675,0,1,1
41815,5,2,146679,146679,146681,0,2,4
41816,4,2,146683,146683,146685,0,2,2
41817,5,1,146688,146688,146689,0,1,3
41818,4,1,146692,146692,146693,0,1,3
41819,2,1,146694,146694,146695,0,1,1
41820,3,1,146697,146697,146698,0,1,2
41821,4,2,146701,146701,146703,0,2,3
41822,2,1,146703,146703,146704,0,1,0
41823,5,1,146708,146708,146709,0,1,4
41824,5,1,146713,146713,146714,0,1,4
41825,5,3,146718,146718,146721,0,3,4
41826,4,2,146722,146722,146724,0,2,1
41827,4,2,146726,146726,146728,0,2,2
41828,2,3,146728,146728,146731,0,3,0
41829,4,1,146732,146732,146733,0,1,1
41830,2,1,146734,146734,146735,0,1,1
41831,5,3,146739,146739,146742,0,3,4
41832,6,3,146745,146745,146748,0,3,3
41833,3,1,146748,146748,146749,0,1,0
41834,1,2,146749,146749,146751,0,2,0
41835,6,3,146755,146755,146758,0,3,4
41836,3,3,146758,146758,146761,0,3,0
41837,4,3,146762,146762,146765,0,3,1
41838,2,2,146764,146765,146767,1,3,0
41839,2,1,146766,146767,146768,1,2,0
41840,1,1,146767,146768,146769,1,2,0
41841,6,3,146773,146773,146776,0,3,4
41842,3,1,146776,146776,146777,0,1,0
41843,1,1,146777,146777,146778,0,1,0
41844,4,1,146781,146781,146782,0,1,3
41845,4,2,146785,146785,146787,0,2,3
41846,6,2,146791,146791,146793,0,2,4
41847,2,1,146793,146793,146794,0,1,0
41848,3,2,146796,146796,146798,0,2,2
41849,5,3,146801,146801,146804,0,3,3
41850,2,3,146803,146804,146807,1,4,0
41851,3,3,146806,146807,146810,1,4,0
41852,6,3,146812,146812,146815,0,3,2
41853,3,3,146815,146815,146818,0,3,0
41854,2,3,146817,146818,146821,1,4,0
41855,4,2,146821,146821,146823,0,2,0
41856,6,1,146827,146827,146828,0,1,4
41857,4,2,146831,146831,146833,0,2,3
41858,3,1,146834,146834,146835,0,1,1
41859,4,3,146838,146838,146841,0,3,3
41860,2,3,146840,146841,146844,1,4,0
41861,2,2,146842,146844,146846,2,4,0
41862,6,3,146848,146848,146851,0,3,2
41863,5,2,146853,146853,146855,0,2,2
41864,2,1,146855,146855,146856,0,1,0
41865,3,3,146858,146858,146861,0,3,2
41866,3,1,146861,146861,146862,0,1,0
41867,4,3,146865,146865,146868,0,3,3
41868,6,3,146871,146871,146874,0,3,3
41869,2,1,146873,146874,146875,1,2,0
41870,4,2,146877,146877,146879,0,2,2
41871,1,3,146878,146879,146882,1,4,0
41872,1,1,146879,146882,146883,3,4,0
41873,2,2,146881,146883,146885,2,4,0
41874,4,1,146885,146885,146886,0,1,0
41875,5,1,146890,146890,146891,0,1,4
41876,4,1,146894,146894,146895,0,1,3
41877,3,1,146897,146897,146898,0,1,2
41878,4,1,146901,146901,146902,0,1,3
41879,6,3,146907,146907,146910,0,3,5
41880,2,1,146909,146910,146911,1,2,0
41881,4,3,146913,146913,146916,0,3,2
41882,1,1,146914,146916,146917,2,3,0
41883,6,2,146920,146920,146922,0,2,3
41884,5,2,146925,146925,146927,0,2,3
41885,5,1,146930,146930,146931,0,1,3
41886,5,2,146935,146935,146937,0,2,4
41887,2,3,146937,146937,146940,0,3,0
41888,5,1,146942,146942,146943,0,1,2
41889,4,2,146946,146946,146948,0,2,3
41890,5,3,146951,146951,146954,0,3,3
41891,1,1,146952,146954,146955,2,3,0
41892,4,3,146956,146956,146959,0,3,1
41893,2,3,146958,146959,146962,1,4,0
41894,1,3,146959,146962,146965,3,6,0
41895,2,3,146961,146965,146968,4,7,0
41896,6,2,146967,146968,146970,1,3,0
41897,6,2,146973,146973,146975,0,2,3
41898,1,3,146974,146975,146978,1,4,0
41899,6,3,146980,146980,146983,0,3,2
41900,4,1,146984,146984,146985,0,1,1
41901,4,2,146988,146988,146990,0,2,3
41902,1,1,146989,146990,146991,1,2,0
41903,6,2,146995,146995,146997,0,2,4
41904,5,3,147000,147000,147003,0,3,3
41905,2,2,147002,147003,147005,1,3,0
41906,6,2,147008,147008,147010,0,2,3
41907,2,3,147010,147010,147013,0,3,0
41908,5,3,147015,147015,147018,0,3,2
41909,2,1,147017,147018,147019,1,2,0
41910,6,3,147023,147023,147026,0,3,4
41911,2,1,147025,147026,147027,1,2,0
41912,6,3,147031,147031,147034,0,3,4
41913,3,1,147034,147034,147035,0,1,0
41914,6,3,147040,147040,147043,0,3,5
41915,6,3,147046,147046,147049,0,3,3
41916,4,3,147050,147050,147053,0,3,1
41917,5,3,147055,147055,147058,0,3,2
41918,4,1,147059,147059,147060,0,1,1
41919,5,3,147064,147064,147067,0,3,4
41920,4,1,147068,147068,147069,0,1,1
41921,2,3,147070,147070,147073,0,3,1
41922,4,1,147074,147074,147075,0,1,1
41923,1,3,147075,147075,147078,0,3,0
41924,2,1,147077,147078,147079,1,2,0
41925,3,1,147080,147080,147081,0,1,1
41926,5,2,147085,147085,147087,0,2,4
41927,1,3,147086,147087,147090,1,4,0
41928,4,2,147090,147090,147092,0,2,0
41929,2,1,147092,147092,147093,0,1,0
41930,2,1,147094,147094,147095,0,1,1
41931,6,1,147100,147100,147101,0,1,5
41932,4,1,147104,147104,147105,0,1,3
41933,3,2,147107,147107,147109,0,2,2
41934,1,1,147108,147109,147110,1,2,0
41935,5,1,147113,147113,147114,0,1,3
41936,1,3,147114,147114,147117,0,3,0
41937,4,1,147118,147118,147119,0,1,1
41938,6,1,147124,147124,147125,0,1,5
41939,5,1,147129,147129,147130,0,1,4
41940,3,1,147132,147132,147133,0,1,2
41941,4,2,147136,147136,147138,0,2,3
41942,3,1,147139,147139,147140,0,1,1
41943,5,1,147144,147144,147145,0,1,4
41944,6,3,147150,147150,147153,0,3,5
41945,2,3,147152,147153,147156,1,4,0
41946,2,1,147154,147156,147157,2,3,0
41947,2,1,147156,147157,147158,1,2,0
41948,1,1,147157,147158,147159,1,2,0
41949,1,3,147158,147159,147162,1,4,0
41950,4,3,147162,147162,147165,0,3,0
41951,3,1,147165,147165,147166,0,1,0
41952,4,3,147169,147169,147172,0,3,3
41953,1,3,147170,147172,147175,2,5,0
41954,2,3,147172,147175,147178,3,6,0
41955,5,3,147177,147178,147181,1,4,0
41956,3,2,147180,147181,147183,1,3,0
41957,5,3,147185,147185,147188,0,3,2
41958,3,3,147188,147188,147191,0,3,0
41959,1,1,147189,147191,147192,2,3,0
41960,3,3,147192,147192,147195,0,3,0
41961,3,1,147195,147195,147196,0,1,0
41962,5,2,147200,147200,147202,0,2,4
41963,2,3,147202,147202,147205,0,3,0
41964,2,2,147204,147205,147207,1,3,0
41965,4,1,147208,147208,147209,0,1,1
41966,3,1,147211,147211,147212,0,1,2
41967,1,1,147212,147212,147213,0,1,0
41968,3,2,147215,147215,147217,0,2,2
41969,3,3,147218,147218,147221,0,3,1
41970,6,1,147224,147224,147225,0,1,3
41971,3,1,147227,147227,147228,0,1,2
41972,3,3,147230,147230,147233,0,3,2
41973,1,3,147231,147233,147236,2,5,0
41974,1,3,147232,147236,147239,4,7,0
41975,4,3,147236,147239,147242,3,6,0
41976,5,3,147241,147242,147245,1,4,0
41977,3,1,147244,147245,147246,1,2,0
41978,1,3,147245,147246,147249,1,4,0
41979,5,1,147250,147250,147251,0,1,1
41980,2,3,147252,147252,147255,0,3,1
41981,5,1,147257,147257,147258,0,1,2
41982,1,2,147258,147258,147260,0,2,0
41983,5,2,147263,147263,147265,0,2,3
41984,2,2,147265,147265,147267,0,2,0
41985,2,2,147267,147267,147269,0,2,0
41986,4,3,147271,147271,147274,0,3,2
41987,4,2,147275,147275,147277,0,2,1
41988,6,1,147281,147281,147282,0,1,4
41989,2,2,147283,147283,147285,0,2,1
41990,4,2,147287,147287,147289,0,2,2
41991,4,1,147291,147291,147292,0,1,2
41992,5,3,147296,147296,147299,0,3,4
41993,4,1,147300,147300,147301,0,1,1
41994,5,1,147305,147305,147306,0,1,4
41995,6,3,147311,147311,147314,0,3,5
41996,6,2,147317,147317,147319,0,2,3
41997,3,2,147320,147320,147322,0,2,1
41998,2,2,147322,147322,147324,0,2,0
41999,3,3,147325,147325,147328,0,3,1
42000,4,2,147329,147329,147331,0,2,1
42001,6,3,147335,147335,147338,0,3,4
42002,1,1,147336,147338,147339,2,3,0
42003,5,3,147341,147341,147344,0,3,2
42004,6,1,147347,147347,147348,0,1,3
42005,5,3,147352,147352,147355,0,3,4
42006,2,3,147354,147355,147358,1,4,0
42007,3,1,147357,147358,147359,1,2,0
42008,4,3,147361,147361,147364,0,3,2
42009,2,1,147363,147364,147365,1,2,0
42010,1,2,147364,147365,147367,1,3,0
42011,5,2,147369,147369,147371,0,2,2
42012,2,2,147371,147371,147373,0,2,0
42013,6,1,147377,147377,147378,0,1,4
42014,1,2,147378,147378,147380,0,2,0
42015,4,3,147382,147382,147385,0,3,2
42016,5,1,147387,147387,147388,0,1,2
42017,1,2,147388,147388,147390,0,2,0
42018,6,2,147394,147394,147396,0,2,4
42019,5,3,147399,147399,147402,0,3,3
42020,2,1,147401,147402,147403,1,2,0
42021,6,3,147407,147407,147410,0,3,4
42022,3,3,147410,147410,147413,0,3,0
42023,1,1,147411,147413,147414,2,3,0
42024,4,2,147415,147415,147417,0,2,1
42025,5,2,147420,147420,147422,0,2,3
42026,2,1,147422,147422,147423,0,1,0
42027,3,2,147425,147425,147427,0,2,2
42028,5,2,147430,147430,147432,0,2,3
42029,1,3,147431,147432,147435,1,4,0
42030,3,1,147434,147435,147436,1,2,0
42031,2,2,147436,147436,147438,0,2,0
42032,6,2,147442,147442,147444,0,2,4
42033,5,2,147447,147447,147449,0,2,3
42034,3,3,147450,147450,147453,0,3,1
42035,2,3,147452,147453,147456,1,4,0
42036,2,1,147454,147456,147457,2,3,0
42037,3,3,147457,147457,147460,0,3,0
42038,3,3,147460,147460,147463,0,3,0
42039,6,1,147466,147466,147467,0,1,3
42040,6,2,147472,147472,147474,0,2,5
42041,1,2,147473,147474,147476,1,3,0
42042,2,2,147475,147476,147478,1,3,0
42043,5,2,147480,147480,147482,0,2,2
42044,6,2,147486,147486,147488,0,2,4
42045,2,2,147488,147488,147490,0,2,0
42046,6,3,147494,147494,147497,0,3,4
42047,4,1,147498,147498,147499,0,1,1
42048,5,2,147503,147503,147505,0,2,4
42049,5,1,147508,147508,147509,0,1,3
42050,5,2,147513,147513,147515,0,2,4
42051,2,1,147515,147515,147516,0,1,0
42052,1,2,147516,147516,147518,0,2,0
42053,4,1,147520,147520,147521,0,1,2
42054,4,3,147524,147524,147527,0,3,3
42055,2,3,147526,147527,147530,1,4,0
42056,4,2,147530,147530,147532,0,2,0
42057,1,1,147531,147532,147533,1,2,0
42058,1,2,147532,147533,147535,1,3,0
42059,4,2,147536,147536,147538,0,2,1
42060,5,2,147541,147541,147543,0,2,3
42061,2,2,147543,147543,147545,0,2,0
42062,4,1,147547,147547,147548,0,1,2
42063,2,3,147549,147549,147552,0,3,1
42064,6,1,147555,147555,147556,0,1,3
42065,5,2,147560,147560,147562,0,2,4
42066,2,3,147562,147562,147565,0,3,0
42067,3,2,147565,147565,147567,0,2,0
42068,2,2,147567,147567,147569,0,2,0
42069,3,3,147570,147570,147573,0,3,1
42070,6,2,147576,147576,147578,0,2,3
42071,4,2,147580,147580,147582,0,2,2
42072,1,3,147581,147582,147585,1,4,0
42073,2,3,147583,147585,147588,2,5,0
42074,5,1,147588,147588,147589,0,1,0
42075,5,2,147593,147593,147595,0,2,4
42076,1,1,147594,147595,147596,1,2,0
42077,4,1,147598,147598,147599,0,1,2
42078,2,3,147600,147600,147603,0,3,1
42079,2,1,147602,147603,147604,1,2,0
42080,4,3,147606,147606,147609,0,3,2
42081,5,3,147611,147611,147614,0,3,2
42082,5,1,147616,147616,147617,0,1,2
42083,2,1,147618,147618,147619,0,1,1
42084,1,1,147619,147619,147620,0,1,0
42085,6,3,147625,147625,147628,0,3,5
42086,3,2,147628,147628,147630,0,2,0
42087,3,3,147631,147631,147634,0,3,1
42088,1,1,147632,147634,147635,2,3,0
42089,5,2,147637,147637,147639,0,2,2
42090,1,1,147638,147639,147640,1,2,0
42091,5,1,147643,147643,147644,0,1,3
42092,2,2,147645,147645,147647,0,2,1
42093,5,2,147650,147650,147652,0,2,3
42094,4,3,147654,147654,147657,0,3,2
42095,3,3,147657,147657,147660,0,3,0
42096,6,1,147663,147663,147664,0,1,3
42097,2,1,147665,147665,147666,0,1,1
42098,1,1,147666,147666,147667,0,1,0
42099,1,3,147667,147667,147670,0,3,0
42100,1,2,147668,147670,147672,2,4,0
42101,4,2,147672,147672,147674,0,2,0
42102,4,2,147676,147676,147678,0,2,2
42103,1,1,147677,147678,147679,1,2,0
42104,1,3,147678,147679,147682,1,4,0
42105,6,2,147684,147684,147686,0,2,2
42106,4,2,147688,147688,147690,0,2,2
42107,4,2,147692,147692,147694,0,2,2
42108,3,1,147695,147695,147696,0,1,1
42109,1,1,147696,147696,147697,0,1,0
42110,4,2,147700,147700,147702,0,2,3
42111,1,2,147701,147702,147704,1,3,0
42112,1,2,147702,147704,147706,2,4,0
42113,5,2,147707,147707,147709,0,2,1
42114,6,3,147713,147713,147716,0,3,4
42115,3,1,147716,147716,147717,0,1,0
42116,1,3,147717,147717,147720,0,3,0
42117,5,1,147722,147722,147723,0,1,2
42118,1,3,147723,147723,147726,0,3,0
42119,6,3,147729,147729,147732,0,3,3
42120,4,3,147733,147733,147736,0,3,1
42121,5,3,147738,147738,147741,0,3,2
42122,2,2,147740,147741,147743,1,3,0
42123,4,1,147744,147744,147745,0,1,1
42124,6,2,147750,147750,147752,0,2,5
42125,2,2,147752,147752,147754,0,2,0
42126,2,3,147754,147754,147757,0,3,0
42127,4,2,147758,147758,147760,0,2,1
42128,3,1,147761,147761,147762,0,1,1
42129,4,1,147765,147765,147766,0,1,3
42130,5,2,147770,147770,147772,0,2,4
42131,1,1,147771,147772,147773,1,2,0
42132,4,1,147775,147775,147776,0,1,2
42133,3,1,147778,147778,147779,0,1,2
42134,3,1,147781,147781,147782,0,1,2
42135,1,1,147782,147782,147783,0,1,0
42136,1,1,147783,147783,147784,0,1,0
42137,3,1,147786,147786,147787,0,1,2
42138,2,1,147788,147788,147789,0,1,1
42139,4,1,147792,147792,147793,0,1,3
42140,2,1,147794,147794,147795,0,1,1
42141,6,2,147800,147800,147802,0,2,5
42142,3,1,147803,147803,147804,0,1,1
42143,3,3,147806,147806,147809,0,3,2
42144,6,1,147812,147812,147813,0,1,3
42145,4,2,147816,147816,147818,0,2,3
42146,5,2,147821,147821,147823,0,2,3
42147,1,3,147822,147823,147826,1,4,0
42148,3,2,147825,147826,147828,1,3,0
42149,3,1,147828,147828,147829,0,1,0
42150,5,3,147833,147833,147836,0,3,4
42151,5,3,147838,147838,147841,0,3,2
42152,1,2,147839,147841,147843,2,4,0
42153,2,1,147841,147843,147844,2,3,0
42154,3,2,147844,147844,147846,0,2,0
42155,1,1,147845,147846,147847,1,2,0
42156,1,3,147846,147847,147850,1,4,0
42157,5,3,147851,147851,147854,0,3,1
42158,1,1,147852,147854,147855,2,3,0
42159,6,3,147858,147858,147861,0,3,3
42160,4,2,147862,147862,147864,0,2,1
42161,2,2,147864,147864,147866,0,2,0
42162,1,3,147865,147866,147869,1,4,0
42163,2,3,147867,147869,147872,2,5,0
42164,3,1,147870,147872,147873,2,3,0
42165,1,2,147871,147873,147875,2,4,0
42166,4,3,147875,147875,147878,0,3,0
42167,4,3,147879,147879,147882,0,3,1
42168,2,3,147881,147882,147885,1,4,0
42169,3,1,147884,147885,147886,1,2,0
42170,5,1,147889,147889,147890,0,1,3
42171,6,3,147895,147895,147898,0,3,5
42172,1,1,147896,147898,147899,2,3,0
42173,4,1,147900,147900,147901,0,1,1
42174,5,1,147905,147905,147906,0,1,4
42175,5,1,147910,147910,147911,0,1,4
42176,1,1,147911,147911,147912,0,1,0
42177,1,2,147912,147912,147914,0,2,0
42178,2,2,147914,147914,147916,0,2,0
42179,5,2,147919,147919,147921,0,2,3
42180,4,3,147923,147923,147926,0,3,2
42181,1,3,147924,147926,147929,2,5,0
42182,3,2,147927,147929,147931,2,4,0
42183,5,1,147932,147932,147933,0,1,1
42184,3,2,147935,147935,147937,0,2,2
42185,6,2,147941,147941,147943,0,2,4
42186,6,2,147947,147947,147949,0,2,4
42187,2,3,147949,147949,147952,0,3,0
42188,3,2,147952,147952,147954,0,2,0
42189,3,2,147955,147955,147957,0,2,1
42190,1,1,147956,147957,147958,1,2,0
42191,6,3,147962,147962,147965,0,3,4
42192,4,1,147966,147966,147967,0,1,1
42193,1,3,147967,147967,147970,0,3,0
42194,2,2,147969,147970,147972,1,3,0
42195,1,3,147970,147972,147975,2,5,0
42196,6,1,147976,147976,147977,0,1,1
42197,1,1,147977,147977,147978,0,1,0
42198,4,1,147981,147981,147982,0,1,3
42199,3,3,147984,147984,147987,0,3,2
42200,2,1,147986,147987,147988,1,2,0
42201,3,1,147989,147989,147990,0,1,1
42202,6,3,147995,147995,147998,0,3,5
42203,3,1,147998,147998,147999,0,1,0
42204,3,3,148001,148001,148004,0,3,2
42205,5,1,148006,148006,148007,0,1,2
42206,6,2,148012,148012,148014,0,2,5
42207,1,1,148013,148014,148015,1,2,0
42208,4,3,148017,148017,148020,0,3,2
42209,3,2,148020,148020,148022,0,2,0
42210,4,3,148024,148024,148027,0,3,2
42211,3,3,148027,148027,148030,0,3,0
42212,2,3,148029,148030,148033,1,4,0
42213,6,2,148035,148035,148037,0,2,2
42214,1,2,148036,148037,148039,1,3,0
42215,2,2,148038,148039,148041,1,3,0
42216,1,3,148039,148041,148044,2,5,0
42217,4,1,148043,148044,148045,1,2,0
42218,2,1,148045,148045,148046,0,1,0
42219,4,1,148049,148049,148050,0,1,3
42220,5,1,148054,148054,148055,0,1,4
42221,1,2,148055,148055,148057,0,2,0
42222,6,1,148061,148061,148062,0,1,4
42223,1,3,148062,148062,148065,0,3,0
42224,5,3,148067,148067,148070,0,3,2
42225,5,2,148072,148072,148074,0,2,2
42226,6,3,148078,148078,148081,0,3,4
42227,5,2,148083,148083,148085,0,2,2
42228,5,1,148088,148088,148089,0,1,3
42229,4,1,148092,148092,148093,0,1,3
42230,2,3,148094,148094,148097,0,3,1
42231,4,1,148098,148098,148099,0,1,1
42232,6,1,148104,148104,148105,0,1,5
42233,3,1,148107,148107,148108,0,1,2
42234,5,3,148112,148112,148115,0,3,4
42235,2,1,148114,148115,148116,1,2,0
42236,2,1,148116,148116,148117,0,1,0
42237,4,3,148120,148120,148123,0,3,3
42238,5,2,148125,148125,148127,0,2,2
42239,4,1,148129,148129,148130,0,1,2
42240,6,1,148135,148135,148136,0,1,5
42241,1,1,148136,148136,148137,0,1,0
42242,4,3,148140,148140,148143,0,3,3
42243,6,2,148146,148146,148148,0,2,3
42244,1,2,148147,148148,148150,1,3,0
42245,4,2,148151,148151,148153,0,2,1
42246,3,2,148154,148154,148156,0,2,1
42247,2,2,148156,148156,148158,0,2,0
42248,3,1,148159,148159,148160,0,1,1
42249,2,3,148161,148161,148164,0,3,1
42250,5,3,148166,148166,148169,0,3,2
42251,6,1,148172,148172,148173,0,1,3
42252,2,3,148174,148174,148177,0,3,1
42253,2,1,148176,148177,148178,1,2,0
42254,6,1,148182,148182,148183,0,1,4
42255,2,3,148184,148184,148187,0,3,1
42256,5,2,148189,148189,148191,0,2,2
42257,6,1,148195,148195,148196,0,1,4
42258,2,2,148197,148197,148199,0,2,1
42259,2,1,148199,148199,148200,0,1,0
42260,4,1,148203,148203,148204,0,1,3
42261,1,3,148204,148204,148207,0,3,0
42262,6,2,148210,148210,148212,0,2,3
42263,4,3,148214,148214,148217,0,3,2
42264,1,3,148215,148217,148220,2,5,0
42265,2,2,148217,148220,148222,3,5,0
42266,1,3,148218,148222,148225,4,7,0
42267,3,3,148221,148225,148228,4,7,0
42268,3,1,148224,148228,148229,4,5,0
42269,2,3,148226,148229,148232,3,6,0
42270,5,2,148231,148232,148234,1,3,0
42271,4,1,148235,148235,148236,0,1,1
42272,2,2,148237,148237,148239,0,2,1
42273,1,1,148238,148239,148240,1,2,0
42274,4,1,148242,148242,148243,0,1,2
42275,1,2,148243,148243,148245,0,2,0
42276,4,1,148247,148247,148248,0,1,2
42277,1,1,148248,148248,148249,0,1,0
42278,3,1,148251,148251,148252,0,1,2
42279,2,2,148253,148253,148255,0,2,1
42280,1,2,148254,148255,148257,1,3,0
42281,5,1,148259,148259,148260,0,1,2
42282,3,3,148262,148262,148265,0,3,2
42283,4,2,148266,148266,148268,0,2,1
42284,5,2,148271,148271,148273,0,2,3
42285,4,3,148275,148275,148278,0,3,2
42286,4,3,148279,148279,148282,0,3,1
42287,1,3,148280,148282,148285,2,5,0
42288,3,3,148283,148285,148288,2,5,0
42289,2,2,148285,148288,148290,3,5,0
42290,6,3,148291,148291,148294,0,3,1
42291,2,1,148293,148294,148295,1,2,0
42292,2,3,148295,148295,148298,0,3,0
42293,3,2,148298,148298,148300,0,2,0
42294,2,2,148300,148300,148302,0,2,0
42295,2,3,148302,148302,148305,0,3,0
42296,1,1,148303,148305,148306,2,3,0
42297,4,1,148307,148307,148308,0,1,1
42298,2,3,148309,148309,148312,0,3,1
42299,4,2,148313,148313,148315,0,2,1
42300,2,1,148315,148315,148316,0,1,0
42301,4,3,148319,148319,148322,0,3,3
42302,3,1,148322,148322,148323,0,1,0
42303,6,1,148328,148328,148329,0,1,5
42304,3,2,148331,148331,148333,0,2,2
42305,1,1,148332,148333,148334,1,2,0
42306,5,2,148337,148337,148339,0,2,3
42307,2,3,148339,148339,148342,0,3,0
42308,2,3,148341,148342,148345,1,4,0
42309,3,1,148344,148345,148346,1,2,0
42310,2,1,148346,148346,148347,0,1,0
42311,4,3,148350,148350,148353,0,3,3
42312,2,2,148352,148353,148355,1,3,0
42313,1,2,148353,148355,148357,2,4,0
42314,3,2,148356,148357,148359,1,3,0
42315,5,1,148361,148361,148362,0,1,2
42316,6,2,148367,148367,148369,0,2,5
42317,6,1,148373,148373,148374,0,1,4
42318,2,2,148375,148375,148377,0,2,1
42319,3,3,148378,148378,148381,0,3,1
42320,3,1,148381,148381,148382,0,1,0
42321,3,3,148384,148384,148387,0,3,2
42322,4,3,148388,148388,148391,0,3,1
42323,1,1,148389,148391,148392,2,3,0
42324,3,3,148392,148392,148395,0,3,0
42325,4,1,148396,148396,148397,0,1,1
42326,4,2,148400,148400,148402,0,2,3
42327,4,2,148404,148404,148406,0,2,2
42328,1,3,148405,148406,148409,1,4,0
42329,4,2,148409,148409,148411,0,2,0
42330,1,3,148410,148411,148414,1,4,0
42331,6,2,148416,148416,148418,0,2,2
42332,3,2,148419,148419,148421,0,2,1
42333,2,2,148421,148421,148423,0,2,0
42334,3,3,148424,148424,148427,0,3,1
42335,4,2,148428,148428,148430,0,2,1
42336,4,2,148432,148432,148434,0,2,2
42337,6,2,148438,148438,148440,0,2,4
42338,3,1,148441,148441,148442,0,1,1
42339,3,2,148444,148444,148446,0,2,2
42340,6,2,148450,148450,148452,0,2,4
42341,4,2,148454,148454,148456,0,2,2
42342,2,3,148456,148456,148459,0,3,0
42343,6,1,148462,148462,148463,0,1,3
42344,5,3,148467,148467,148470,0,3,4
42345,6,2,148473,148473,148475,0,2,3
42346,5,2,148478,148478,148480,0,2,3
42347,1,3,148479,148480,148483,1,4,0
42348,2,1,148481,148483,148484,2,3,0
42349,5,1,148486,148486,148487,0,1,2
42350,3,1,148489,148489,148490,0,1,2
42351,2,3,148491,148491,148494,0,3,1
42352,6,3,148497,148497,148500,0,3,3
42353,3,2,148500,148500,148502,0,2,0
42354,1,2,148501,148502,148504,1,3,0
42355,1,1,148502,148504,148505,2,3,0
42356,5,2,148507,148507,148509,0,2,2
42357,5,1,148512,148512,148513,0,1,3
42358,4,3,148516,148516,148519,0,3,3
42359,6,1,148522,148522,148523,0,1,3
42360,2,2,148524,148524,148526,0,2,1
42361,3,2,148527,148527,148529,0,2,1
42362,3,3,148530,148530,148533,0,3,1
42363,3,3,148533,148533,148536,0,3,0
42364,4,2,148537,148537,148539,0,2,1
42365,3,3,148540,148540,148543,0,3,1
42366,2,1,148542,148543,148544,1,2,0
42367,2,1,148544,148544,148545,0,1,0
42368,2,1,148546,148546,148547,0,1,1
42369,6,1,148552,148552,148553,0,1,5
42370,2,3,148554,148554,148557,0,3,1
42371,4,1,148558,148558,148559,0,1,1
42372,1,1,148559,148559,148560,0,1,0
42373,1,2,148560,148560,148562,0,2,0
42374,2,2,148562,148562,148564,0,2,0
42375,3,3,148565,148565,148568,0,3,1
42376,2,2,148567,148568,148570,1,3,0
42377,1,1,148568,148570,148571,2,3,0
42378,1,3,148569,148571,148574,2,5,0
42379,4,1,148573,148574,148575,1,2,0
42380,3,1,148576,148576,148577,0,1,1
42381,1,1,148577,148577,148578,0,1,0
42382,4,2,148581,148581,148583,0,2,3
42383,3,1,148584,148584,148585,0,1,1
42384,6,3,148590,148590,148593,0,3,5
42385,6,2,148596,148596,148598,0,2,3
42386,4,3,148600,148600,148603,0,3,2
42387,5,3,148605,148605,148608,0,3,2
42388,1,1,148606,148608,148609,2,3,0
42389,1,1,148607,148609,148610,2,3,0
42390,6,1,148613,148613,148614,0,1,3
42391,2,3,148615,148615,148618,0,3,1
42392,3,3,148618,148618,148621,0,3,0
42393,4,3,148622,148622,148625,0,3,1
42394,2,2,148624,148625,148627,1,3,0
42395,4,3,148628,148628,148631,0,3,1
42396,5,1,148633,148633,148634,0,1,2
42397,5,1,148638,148638,148639,0,1,4
42398,1,2,148639,148639,148641,0,2,0
42399,3,1,148642,148642,148643,0,1,1
42400,3,1,148645,148645,148646,0,1,2
42401,4,3,148649,148649,148652,0,3,3
42402,1,1,148650,148652,148653,2,3,0
42403,6,1,148656,148656,148657,0,1,3
42404,4,3,148660,148660,148663,0,3,3
42405,2,2,148662,148663,148665,1,3,0
42406,2,1,148664,148665,148666,1,2,0
42407,4,1,148668,148668,148669,0,1,2
42408,5,2,148673,148673,148675,0,2,4
42409,5,1,148678,148678,148679,0,1,3
42410,5,3,148683,148683,148686,0,3,4
42411,4,2,148687,148687,148689,0,2,1
42412,2,2,148689,148689,148691,0,2,0
42413,1,3,148690,148691,148694,1,4,0
42414,4,1,148694,148694,148695,0,1,0
42415,4,2,148698,148698,148700,0,2,3
42416,5,2,148703,148703,148705,0,2,3
42417,1,2,148704,148705,148707,1,3,0
42418,1,2,148705,148707,148709,2,4,0
42419,5,1,148710,148710,148711,0,1,1
42420,5,3,148715,148715,148718,0,3,4
42421,1,1,148716,148718,148719,2,3,0
42422,2,3,148718,148719,148722,1,4,0
42423,5,1,148723,148723,148724,0,1,1
42424,2,2,148725,148725,148727,0,2,1
42425,6,3,148731,148731,148734,0,3,4
42426,4,2,148735,148735,148737,0,2,1
42427,1,2,148736,148737,148739,1,3,0
42428,5,1,148741,148741,148742,0,1,2
42429,2,1,148743,148743,148744,0,1,1
42430,3,2,148746,148746,148748,0,2,2
42431,6,1,148752,148752,148753,0,1,4
42432,3,3,148755,148755,148758,0,3,2
42433,4,1,148759,148759,148760,0,1,1
42434,6,1,148765,148765,148766,0,1,5
42435,2,1,148767,148767,148768,0,1,1
42436,3,1,148770,148770,148771,0,1,2
42437,2,2,148772,148772,148774,0,2,1
42438,6,3,148778,148778,148781,0,3,4
42439,6,3,148784,148784,148787,0,3,3
42440,5,1,148789,148789,148790,0,1,2
42441,6,2,148795,148795,148797,0,2,5
42442,6,3,148801,148801,148804,0,3,4
42443,6,3,148807,148807,148810,0,3,3
42444,1,3,148808,148810,148813,2,5,0
42445,5,1,148813,148813,148814,0,1,0
42446,3,2,148816,148816,148818,0,2,2
42447,5,1,148821,148821,148822,0,1,3
42448,3,1,148824,148824,148825,0,1,2
42449,1,2,148825,148825,148827,0,2,0
42450,3,2,148828,148828,148830,0,2,1
42451,1,1,148829,148830,148831,1,2,0
42452,5,2,148834,148834,148836,0,2,3
42453,2,2,148836,148836,148838,0,2,0
42454,4,3,148840,148840,148843,0,3,2
42455,3,3,148843,148843,148846,0,3,0
42456,4,1,148847,148847,148848,0,1,1
42457,4,3,148851,148851,148854,0,3,3
42458,4,3,148855,148855,148858,0,3,1
42459,4,3,148859,148859,148862,0,3,1
42460,4,2,148863,148863,148865,0,2,1
42461,5,2,148868,148868,148870,0,2,3
42462,3,1,148871,148871,148872,0,1,1
42463,5,3,148876,148876,148879,0,3,4
42464,1,3,148877,148879,148882,2,5,0
42465,5,3,148882,148882,148885,0,3,0
42466,1,1,148883,148885,148886,2,3,0
42467,6,2,148889,148889,148891,0,2,3
42468,1,3,148890,148891,148894,1,4,0
42469,4,3,148894,148894,148897,0,3,0
42470,4,1,148898,148898,148899,0,1,1
42471,5,1,148903,148903,148904,0,1,4
42472,2,3,148905,148905,148908,0,3,1
42473,4,3,148909,148909,148912,0,3,1
42474,4,3,148913,148913,148916,0,3,1
42475,1,1,148914,148916,148917,2,3,0
42476,5,3,148919,148919,148922,0,3,2
42477,3,3,148922,148922,148925,0,3,0
42478,4,3,148926,148926,148929,0,3,1
42479,5,1,148931,148931,148932,0,1,2
42480,3,1,148934,148934,148935,0,1,2
42481,1,2,148935,148935,148937,0,2,0
42482,1,1,148936,148937,148938,1,2,0
42483,3,3,148939,148939,148942,0,3,1
42484,3,2,148942,148942,148944,0,2,0
42485,3,1,148945,148945,148946,0,1,1
42486,4,1,148949,148949,148950,0,1,3
42487,6,1,148955,148955,148956,0,1,5
42488,5,3,148960,148960,148963,0,3,4
42489,4,3,148964,148964,148967,0,3,1
42490,3,3,148967,148967,148970,0,3,0
42491,4,3,148971,148971,148974,0,3,1
42492,4,3,148975,148975,148978,0,3,1
42493,4,3,148979,148979,148982,0,3,1
42494,3,1,148982,148982,148983,0,1,0
42495,3,3,148985,148985,148988,0,3,2
42496,5,3,148990,148990,148993,0,3,2
42497,4,3,148994,148994,148997,0,3,1
42498,2,1,148996,148997,148998,1,2,0
42499,5,2,149001,149001,149003,0,2,3
42500,1,2,149002,149003,149005,1,3,0
42501,2,1,149004,149005,149006,1,2,0
42502,3,3,149007,149007,149010,0,3,1
42503,5,2,149012,149012,149014,0,2,2
42504,6,2,149018,149018,149020,0,2,4
42505,4,2,149022,149022,149024,0,2,2
42506,2,2,149024,149024,149026,0,2,0
42507,6,1,149030,149030,149031,0,1,4
42508,6,3,149036,149036,149039,0,3,5
42509,1,1,149037,149039,149040,2,3,0
42510,1,2,149038,149040,149042,2,4,0
42511,4,1,149042,149042,149043,0,1,0
42512,1,1,149043,149043,149044,0,1,0
42513,4,1,149047,149047,149048,0,1,3
42514,6,2,149053,149053,149055,0,2,5
42515,5,1,149058,149058,149059,0,1,3
42516,2,2,149060,149060,149062,0,2,1
42517,4,2,149064,149064,149066,0,2,2
42518,2,3,149066,149066,149069,0,3,0
42519,6,3,149072,149072,149075,0,3,3
42520,2,3,149074,149075,149078,1,4,0
42521,1,2,149075,149078,149080,3,5,0
42522,3,2,149078,149080,149082,2,4,0
42523,5,1,149083,149083,149084,0,1,1
42524,6,2,149089,149089,149091,0,2,5
42525,6,3,149095,149095,149098,0,3,4
42526,1,2,149096,149098,149100,2,4,0
42527,2,3,149098,149100,149103,2,5,0
42528,6,3,149104,149104,149107,0,3,1
42529,1,1,149105,149107,149108,2,3,0
42530,5,1,149110,149110,149111,0,1,2
42531,4,3,149114,149114,149117,0,3,3
42532,3,2,149117,149117,149119,0,2,0
42533,6,1,149123,149123,149124,0,1,4
42534,5,2,149128,149128,149130,0,2,4
42535,3,3,149131,149131,149134,0,3,1
42536,6,1,149137,149137,149138,0,1,3
42537,2,2,149139,149139,149141,0,2,1
42538,2,1,149141,149141,149142,0,1,0
42539,5,1,149146,149146,149147,0,1,4
42540,1,1,149147,149147,149148,0,1,0
42541,3,3,149150,149150,149153,0,3,2
42542,3,3,149153,149153,149156,0,3,0
42543,2,1,149155,149156,149157,1,2,0
42544,4,3,149159,149159,149162,0,3,2
42545,1,2,149160,149162,149164,2,4,0
42546,3,2,149163,149164,149166,1,3,0
42547,5,3,149168,149168,149171,0,3,2
42548,6,1,149174,149174,149175,0,1,3
42549,4,2,149178,149178,149180,0,2,3
42550,4,1,149182,149182,149183,0,1,2
42551,1,1,149183,149183,149184,0,1,0
42552,2,3,149185,149185,149188,0,3,1
42553,5,2,149190,149190,149192,0,2,2
42554,3,3,149193,149193,149196,0,3,1
42555,2,2,149195,149196,149198,1,3,0
42556,2,1,149197,149198,149199,1,2,0
42557,3,1,149200,149200,149201,0,1,1
42558,6,3,149206,149206,149209,0,3,5
42559,4,1,149210,149210,149211,0,1,1
42560,3,1,149213,149213,149214,0,1,2
42561,6,2,149219,149219,149221,0,2,5
42562,2,2,149221,149221,149223,0,2,0
42563,6,2,149227,149227,149229,0,2,4
42564,2,1,149229,149229,149230,0,1,0
42565,6,2,149235,149235,149237,0,2,5
42566,4,3,149239,149239,149242,0,3,2
42567,3,2,149242,149242,149244,0,2,0
42568,2,3,149244,149244,149247,0,3,0
42569,4,3,149248,149248,149251,0,3,1
42570,2,1,149250,149251,149252,1,2,0
42571,2,2,149252,149252,149254,0,2,0
42572,4,3,149256,149256,149259,0,3,2
42573,2,2,149258,149259,149261,1,3,0
42574,4,1,149262,149262,149263,0,1,1
42575,6,3,149268,149268,149271,0,3,5
42576,6,1,149274,149274,149275,0,1,3
42577,3,3,149277,149277,149280,0,3,2
42578,5,2,149282,149282,149284,0,2,2
42579,4,3,149286,149286,149289,0,3,2
42580,2,1,149288,149289,149290,1,2,0
42581,1,2,149289,149290,149292,1,3,0
42582,1,1,149290,149292,149293,2,3,0
42583,1,3,149291,149293,149296,2,5,0
42584,6,1,149297,149297,149298,0,1,1
42585,4,3,149301,149301,149304,0,3,3
42586,2,3,149303,149304,149307,1,4,0
42587,1,1,149304,149307,149308,3,4,0
42588,2,2,149306,149308,149310,2,4,0
42589,5,3,149311,149311,149314,0,3,1
42590,5,3,149316,149316,149319,0,3,2
42591,3,3,149319,149319,149322,0,3,0
42592,3,1,149322,149322,149323,0,1,0
42593,1,3,149323,149323,149326,0,3,0
42594,2,1,149325,149326,149327,1,2,0
42595,3,3,149328,149328,149331,0,3,1
42596,4,1,149332,149332,149333,0,1,1
42597,2,2,149334,149334,149336,0,2,1
42598,1,2,149335,149336,149338,1,3,0
42599,5,3,149340,149340,149343,0,3,2
42600,6,3,149346,149346,149349,0,3,3
42601,1,3,149347,149349,149352,2,5,0
42602,3,2,149350,149352,149354,2,4,0
42603,2,2,149352,149354,149356,2,4,0
42604,4,1,149356,149356,149357,0,1,0
42605,6,3,149362,149362,149365,0,3,5
42606,4,3,149366,149366,149369,0,3,1
42607,6,2,149372,149372,149374,0,2,3
42608,4,3,149376,149376,149379,0,3,2
42609,6,2,149382,149382,149384,0,2,3
42610,4,2,149386,149386,149388,0,2,2
42611,4,3,149390,149390,149393,0,3,2
42612,6,2,149396,149396,149398,0,2,3
42613,5,2,149401,149401,149403,0,2,3
42614,2,3,149403,149403,149406,0,3,0
42615,5,2,149408,149408,149410,0,2,2
42616,5,2,149413,149413,149415,0,2,3
42617,3,3,149416,149416,149419,0,3,1
42618,5,2,149421,149421,149423,0,2,2
42619,2,2,149423,149423,149425,0,2,0
42620,6,1,149429,149429,149430,0,1,4
42621,6,3,149435,149435,149438,0,3,5
42622,1,1,149436,149438,149439,2,3,0
42623,3,2,149439,149439,149441,0,2,0
42624,2,1,149441,149441,149442,0,1,0
42625,6,2,149447,149447,149449,0,2,5
42626,5,3,149452,149452,149455,0,3,3
42627,2,1,149454,149455,149456,1,2,0
42628,2,3,149456,149456,149459,0,3,0
42629,6,2,149462,149462,149464,0,2,3
42630,3,3,149465,149465,149468,0,3,1
42631,6,3,149471,149471,149474,0,3,3
42632,5,2,149476,149476,149478,0,2,2
42633,3,2,149479,149479,149481,0,2,1
42634,4,2,149483,149483,149485,0,2,2
42635,5,2,149488,149488,149490,0,2,3
42636,2,1,149490,149490,149491,0,1,0
42637,3,2,149493,149493,149495,0,2,2
42638,5,3,149498,149498,149501,0,3,3
42639,5,1,149503,149503,149504,0,1,2
42640,2,2,149505,149505,149507,0,2,1
42641,1,1,149506,149507,149508,1,2,0
42642,3,2,149509,149509,149511,0,2,1
42643,4,2,149513,149513,149515,0,2,2
42644,5,3,149518,149518,149521,0,3,3
42645,6,2,149524,149524,149526,0,2,3
42646,1,1,149525,149526,149527,1,2,0
42647,4,2,149529,149529,149531,0,2,2
42648,2,3,149531,149531,149534,0,3,0
42649,5,3,149536,149536,149539,0,3,2
42650,2,3,149538,149539,149542,1,4,0
42651,6,2,149544,149544,149546,0,2,2
42652,3,2,149547,149547,149549,0,2,1
42653,6,3,149553,149553,149556,0,3,4
42654,2,3,149555,149556,149559,1,4,0
42655,4,3,149559,149559,149562,0,3,0
42656,3,3,149562,149562,149565,0,3,0
42657,6,1,149568,149568,149569,0,1,3
42658,6,2,149574,149574,149576,0,2,5
42659,4,3,149578,149578,149581,0,3,2
42660,3,2,149581,149581,149583,0,2,0
42661,5,1,149586,149586,149587,0,1,3
42662,6,2,149592,149592,149594,0,2,5
42663,4,1,149596,149596,149597,0,1,2
42664,5,2,149601,149601,149603,0,2,4
42665,3,1,149604,149604,149605,0,1,1
42666,4,2,149608,149608,149610,0,2,3
42667,2,1,149610,149610,149611,0,1,0
42668,5,2,149615,149615,149617,0,2,4
42669,5,3,149620,149620,149623,0,3,3
42670,3,1,149623,149623,149624,0,1,0
42671,3,1,149626,149626,149627,0,1,2
42672,6,2,149632,149632,149634,0,2,5
42673,2,2,149634,149634,149636,0,2,0
42674,6,3,149640,149640,149643,0,3,4
42675,1,1,149641,149643,149644,2,3,0
42676,6,1,149647,149647,149648,0,1,3
42677,4,3,149651,149651,149654,0,3,3
42678,5,2,149656,149656,149658,0,2,2
42679,4,2,149660,149660,149662,0,2,2
42680,1,1,149661,149662,149663,1,2,0
42681,4,1,149665,149665,149666,0,1,2
42682,6,2,149671,149671,149673,0,2,5
42683,6,1,149677,149677,149678,0,1,4
42684,6,1,149683,149683,149684,0,1,5
42685,3,2,149686,149686,149688,0,2,2
42686,5,2,149691,149691,149693,0,2,3
42687,6,1,149697,149697,149698,0,1,4
42688,1,2,149698,149698,149700,0,2,0
42689,4,1,149702,149702,149703,0,1,2
42690,4,2,149706,149706,149708,0,2,3
42691,4,1,149710,149710,149711,0,1,2
42692,4,1,149714,149714,149715,0,1,3
42693,4,1,149718,149718,149719,0,1,3
42694,6,2,149724,149724,149726,0,2,5
42695,3,2,149727,149727,149729,0,2,1
42696,2,3,149729,149729,149732,0,3,0
42697,5,2,149734,149734,149736,0,2,2
42698,6,3,149740,149740,149743,0,3,4
42699,1,1,149741,149743,149744,2,3,0
42700,1,1,149742,149744,149745,2,3,0
42701,3,3,149745,149745,149748,0,3,0
42702,4,2,149749,149749,149751,0,2,1
42703,1,3,149750,149751,149754,1,4,0
42704,5,3,149755,149755,149758,0,3,1
42705,3,2,149758,149758,149760,0,2,0
42706,1,2,149759,149760,149762,1,3,0
42707,3,1,149762,149762,149763,0,1,0
42708,2,1,149764,149764,149765,0,1,1
42709,1,1,149765,149765,149766,0,1,0
42710,4,3,149769,149769,149772,0,3,3
42711,6,3,149775,149775,149778,0,3,3
42712,5,3,149780,149780,149783,0,3,2
42713,4,2,149784,149784,149786,0,2,1
42714,4,2,149788,149788,149790,0,2,2
42715,3,3,149791,149791,149794,0,3,1
42716,1,2,149792,149794,149796,2,4,0
42717,6,1,149798,149798,149799,0,1,2
42718,3,2,149801,149801,149803,0,2,2
42719,6,3,149807,149807,149810,0,3,4
42720,6,1,149813,149813,149814,0,1,3
42721,5,3,149818,149818,149821,0,3,4
42722,6,2,149824,149824,149826,0,2,3
42723,5,2,149829,149829,149831,0,2,3
42724,5,3,149834,149834,149837,0,3,3
42725,5,3,149839,149839,149842,0,3,2
42726,3,3,149842,149842,149845,0,3,0
42727,1,3,149843,149845,149848,2,5,0
42728,4,1,149847,149848,149849,1,2,0
42729,1,1,149848,149849,149850,1,2,0
42730,4,2,149852,149852,149854,0,2,2
42731,5,2,149857,149857,149859,0,2,3
42732,3,1,149860,149860,149861,0,1,1
42733,6,2,149866,149866,149868,0,2,5
42734,3,2,149869,149869,149871,0,2,1
42735,5,2,149874,149874,149876,0,2,3
42736,1,3,149875,149876,149879,1,4,0
42737,1,1,149876,149879,149880,3,4,0
42738,3,2,149879,149880,149882,1,3,0
42739,6,2,149885,149885,149887,0,2,3
42740,5,3,149890,149890,149893,0,3,3
42741,2,3,149892,149893,149896,1,4,0
42742,4,2,149896,149896,149898,0,2,0
42743,1,3,149897,149898,149901,1,4,0
42744,1,1,149898,149901,149902,3,4,0
42745,6,2,149904,149904,149906,0,2,2
42746,6,3,149910,149910,149913,0,3,4
42747,1,3,149911,149913,149916,2,5,0
42748,4,1,149915,149916,149917,1,2,0
42749,2,1,149917,149917,149918,0,1,0
42750,6,3,149923,149923,149926,0,3,5
42751,5,3,149928,149928,149931,0,3,2
42752,6,3,149934,149934,149937,0,3,3
42753,2,2,149936,149937,149939,1,3,0
42754,3,3,149939,149939,149942,0,3,0
42755,2,1,149941,149942,149943,1,2,0
42756,1,1,149942,149943,149944,1,2,0
42757,1,3,149943,149944,149947,1,4,0
42758,3,3,149946,149947,149950,1,4,0
42759,1,2,149947,149950,149952,3,5,0
42760,1,2,149948,149952,149954,4,6,0
42761,4,3,149952,149954,149957,2,5,0
42762,2,1,149954,149957,149958,3,4,0
42763,3,2,149957,149958,149960,1,3,0
42764,2,2,149959,149960,149962,1,3,0
42765,2,2,149961,149962,149964,1,3,0
42766,3,3,149964,149964,149967,0,3,0
42767,3,3,149967,149967,149970,0,3,0
42768,4,2,149971,149971,149973,0,2,1
42769,4,3,149975,149975,149978,0,3,2
42770,6,1,149981,149981,149982,0,1,3
42771,2,1,149983,149983,149984,0,1,1
42772,2,1,149985,149985,149986,0,1,1
42773,1,1,149986,149986,149987,0,1,0
42774,2,1,149988,149988,149989,0,1,1
42775,4,1,149992,149992,149993,0,1,3
42776,5,3,149997,149997,150000,0,3,4
42777,6,1,150003,150003,150004,0,1,3
42778,6,1,150009,150009,150010,0,1,5
42779,5,2,150014,150014,150016,0,2,4
42780,5,2,150019,150019,150021,0,2,3
42781,3,3,150022,150022,150025,0,3,1
42782,2,1,150024,150025,150026,1,2,0
42783,6,2,150030,150030,150032,0,2,4
42784,5,1,150035,150035,150036,0,1,3
42785,2,2,150037,150037,150039,0,2,1
42786,2,2,150039,150039,150041,0,2,0
42787,6,2,150045,150045,150047,0,2,4
42788,3,1,150048,150048,150049,0,1,1
42789,6,3,150054,150054,150057,0,3,5
42790,5,1,150059,150059,150060,0,1,2
42791,3,3,150062,150062,150065,0,3,2
42792,5,2,150067,150067,150069,0,2,2
42793,6,3,150073,150073,150076,0,3,4
42794,4,2,150077,150077,150079,0,2,1
42795,1,1,150078,150079,150080,1,2,0
42796,4,3,150082,150082,150085,0,3,2
42797,4,2,150086,150086,150088,0,2,1
42798,6,2,150092,150092,150094,0,2,4
42799,4,2,150096,150096,150098,0,2,2
42800,3,1,150099,150099,150100,0,1,1
42801,5,3,150104,150104,150107,0,3,4
42802,4,1,150108,150108,150109,0,1,1
42803,6,2,150114,150114,150116,0,2,5
42804,6,1,150120,150120,150121,0,1,4
42805,4,2,150124,150124,150126,0,2,3
42806,4,2,150128,150128,150130,0,2,2
42807,1,1,150129,150130,150131,1,2,0
42808,6,2,150135,150135,150137,0,2,4
42809,2,1,150137,150137,150138,0,1,0
42810,6,1,150143,150143,150144,0,1,5
42811,2,3,150145,150145,150148,0,3,1
42812,2,2,150147,150148,150150,1,3,0
42813,2,1,150149,150150,150151,1,2,0
42814,5,2,150154,150154,150156,0,2,3
42815,6,1,150160,150160,150161,0,1,4
42816,4,2,150164,150164,150166,0,2,3
42817,6,3,150170,150170,150173,0,3,4
42818,4,1,150174,150174,150175,0,1,1
42819,6,1,150180,150180,150181,0,1,5
42820,1,2,150181,150181,150183,0,2,0
42821,1,2,150182,150183,150185,1,3,0
42822,5,1,150187,150187,150188,0,1,2
42823,1,3,150188,150188,150191,0,3,0
42824,1,3,150189,150191,150194,2,5,0
42825,6,2,150195,150195,150197,0,2,1
42826,4,1,150199,150199,150200,0,1,2
42827,5,3,150204,150204,150207,0,3,4
42828,6,3,150210,150210,150213,0,3,3
42829,6,3,150216,150216,150219,0,3,3
42830,6,1,150222,150222,150223,0,1,3
42831,6,2,150228,150228,150230,0,2,5
42832,3,1,150231,150231,150232,0,1,1
42833,3,2,150234,150234,150236,0,2,2
42834,4,2,150238,150238,150240,0,2,2
42835,6,3,150244,150244,150247,0,3,4
42836,2,2,150246,150247,150249,1,3,0
42837,1,2,150247,150249,150251,2,4,0
42838,6,2,150253,150253,150255,0,2,2
42839,1,3,150254,150255,150258,1,4,0
42840,2,3,150256,150258,150261,2,5,0
42841,3,3,150259,150261,150264,2,5,0
42842,4,1,150263,150264,150265,1,2,0
42843,5,3,150268,150268,150271,0,3,3
42844,1,3,150269,150271,150274,2,5,0
42845,4,1,150273,150274,150275,1,2,0
42846,5,2,150278,150278,150280,0,2,3
42847,6,2,150284,150284,150286,0,2,4
42848,6,1,150290,150290,150291,0,1,4
42849,3,2,150293,150293,150295,0,2,2
42850,1,1,150294,150295,150296,1,2,0
42851,4,1,150298,150298,150299,0,1,2
42852,4,2,150302,150302,150304,0,2,3
42853,3,1,150305,150305,150306,0,1,1
42854,3,2,150308,150308,150310,0,2,2
42855,1,1,150309,150310,150311,1,2,0
42856,1,1,150310,150311,150312,1,2,0
42857,2,3,150312,150312,150315,0,3,0
42858,5,1,150317,150317,150318,0,1,2
42859,5,3,150322,150322,150325,0,3,4
42860,6,1,150328,150328,150329,0,1,3
42861,5,3,150333,150333,150336,0,3,4
42862,2,3,150335,150336,150339,1,4,0
42863,6,1,150341,150341,150342,0,1,2
42864,5,3,150346,150346,150349,0,3,4
42865,1,2,150347,150349,150351,2,4,0
42866,2,2,150349,150351,150353,2,4,0
42867,2,3,150351,150353,150356,2,5,0
42868,5,2,150356,150356,150358,0,2,0
42869,1,2,150357,150358,150360,1,3,0
42870,4,1,150361,150361,150362,0,1,1
42871,4,2,150365,150365,150367,0,2,3
42872,4,1,150369,150369,150370,0,1,2
42873,2,1,150371,150371,150372,0,1,1
42874,2,1,150373,150373,150374,0,1,1
42875,1,1,150374,150374,150375,0,1,0
42876,2,1,150376,150376,150377,0,1,1
42877,6,1,150382,150382,150383,0,1,5
42878,1,1,150383,150383,150384,0,1,0
42879,2,2,150385,150385,150387,0,2,1
42880,5,3,150390,150390,150393,0,3,3
42881,2,2,150392,150393,150395,1,3,0
42882,1,3,150393,150395,150398,2,5,0
42883,2,2,150395,150398,150400,3,5,0
42884,5,2,150400,150400,150402,0,2,0
42885,1,1,150401,150402,150403,1,2,0
42886,6,1,150407,150407,150408,0,1,4
42887,5,1,150412,150412,150413,0,1,4
42888,6,2,150418,150418,150420,0,2,5
42889,1,1,150419,150420,150421,1,2,0
42890,2,1,150421,150421,150422,0,1,0
42891,2,1,150423,150423,150424,0,1,1
42892,3,1,150426,150426,150427,0,1,2
42893,1,2,150427,150427,150429,0,2,0
42894,5,1,150432,150432,150433,0,1,3
42895,2,2,150434,150434,150436,0,2,1
42896,5,3,150439,150439,150442,0,3,3
42897,6,3,150445,150445,150448,0,3,3
42898,3,2,150448,150448,150450,0,2,0
42899,2,1,150450,150450,150451,0,1,0
42900,2,1,150452,150452,150453,0,1,1
42901,1,1,150453,150453,150454,0,1,0
42902,5,2,150458,150458,150460,0,2,4
42903,3,3,150461,150461,150464,0,3,1
42904,2,2,150463,150464,150466,1,3,0
42905,4,1,150467,150467,150468,0,1,1
42906,3,1,150470,150470,150471,0,1,2
42907,1,3,150471,150471,150474,0,3,0
42908,6,1,150477,150477,150478,0,1,3
42909,6,2,150483,150483,150485,0,2,5
42910,5,1,150488,150488,150489,0,1,3
42911,6,2,150494,150494,150496,0,2,5
42912,2,2,150496,150496,150498,0,2,0
42913,2,1,150498,150498,150499,0,1,0
42914,5,1,150503,150503,150504,0,1,4
42915,6,3,150509,150509,150512,0,3,5
42916,1,1,150510,150512,150513,2,3,0
42917,4,3,150514,150514,150517,0,3,1
42918,4,2,150518,150518,150520,0,2,1
42919,5,3,150523,150523,150526,0,3,3
42920,4,1,150527,150527,150528,0,1,1
42921,6,3,150533,150533,150536,0,3,5
42922,6,2,150539,150539,150541,0,2,3
42923,3,2,150542,150542,150544,0,2,1
42924,5,2,150547,150547,150549,0,2,3
42925,3,2,150550,150550,150552,0,2,1
42926,2,1,150552,150552,150553,0,1,0
42927,1,3,150553,150553,150556,0,3,0
42928,4,3,150557,150557,150560,0,3,1
42929,1,3,150558,150560,150563,2,5,0
42930,1,2,150559,150563,150565,4,6,0
42931,2,3,150561,150565,150568,4,7,0
42932,3,1,150564,150568,150569,4,5,0
42933,4,3,150568,150569,150572,1,4,0
42934,4,2,150572,150572,150574,0,2,0
42935,6,2,150578,150578,150580,0,2,4
42936,4,1,150582,150582,150583,0,1,2
42937,6,3,150588,150588,150591,0,3,5
42938,4,1,150592,150592,150593,0,1,1
42939,5,3,150597,150597,150600,0,3,4
42940,2,3,150599,150600,150603,1,4,0
42941,1,2,150600,150603,150605,3,5,0
42942,2,2,150602,150605,150607,3,5,0
42943,1,2,150603,150607,150609,4,6,0
42944,6,1,150609,150609,150610,0,1,0
42945,1,1,150610,150610,150611,0,1,0
42946,6,1,150616,150616,150617,0,1,5
42947,2,3,150618,150618,150621,0,3,1
42948,3,2,150621,150621,150623,0,2,0
42949,3,1,150624,150624,150625,0,1,1
42950,2,3,150626,150626,150629,0,3,1
42951,1,2,150627,150629,150631,2,4,0
42952,2,2,150629,150631,150633,2,4,0
42953,5,1,150634,150634,150635,0,1,1
42954,4,3,150638,150638,150641,0,3,3
42955,2,1,150640,150641,150642,1,2,0
42956,2,3,150642,150642,150645,0,3,0
42957,6,1,150648,150648,150649,0,1,3
42958,1,2,150649,150649,150651,0,2,0
42959,6,2,150655,150655,150657,0,2,4
42960,4,3,150659,150659,150662,0,3,2
42961,6,2,150665,150665,150667,0,2,3
42962,2,1,150667,150667,150668,0,1,0
42963,6,3,150673,150673,150676,0,3,5
42964,1,2,150674,150676,150678,2,4,0
42965,3,1,150677,150678,150679,1,2,0
42966,1,3,150678,150679,150682,1,4,0
42967,4,1,150682,150682,150683,0,1,0
42968,4,2,150686,150686,150688,0,2,3
42969,4,2,150690,150690,150692,0,2,2
42970,2,2,150692,150692,150694,0,2,0
42971,3,1,150695,150695,150696,0,1,1
42972,4,2,150699,150699,150701,0,2,3
42973,3,1,150702,150702,150703,0,1,1
42974,4,1,150706,150706,150707,0,1,3
42975,4,2,150710,150710,150712,0,2,3
42976,5,2,150715,150715,150717,0,2,3
42977,6,2,150721,150721,150723,0,2,4
42978,1,1,150722,150723,150724,1,2,0
42979,6,1,150728,150728,150729,0,1,4
42980,2,2,150730,150730,150732,0,2,1
42981,1,3,150731,150732,150735,1,4,0
42982,3,3,150734,150735,150738,1,4,0
42983,4,1,150738,150738,150739,0,1,0
42984,6,3,150744,150744,150747,0,3,5
42985,1,3,150745,150747,150750,2,5,0
42986,2,3,150747,150750,150753,3,6,0
42987,2,1,150749,150753,150754,4,5,0
42988,2,1,150751,150754,150755,3,4,0
42989,4,2,150755,150755,150757,0,2,0
42990,1,2,150756,150757,150759,1,3,0
42991,2,2,150758,150759,150761,1,3,0
42992,4,2,150762,150762,150764,0,2,1
42993,3,3,150765,150765,150768,0,3,1
42994,3,3,150768,150768,150771,0,3,0
42995,2,3,150770,150771,150774,1,4,0
42996,2,3,150772,150774,150777,2,5,0
42997,1,2,150773,150777,150779,4,6,0
42998,1,1,150774,150779,150780,5,6,0
42999,5,3,150779,150780,150783,1,4,0
43000,3,3,150782,150783,150786,1,4,0
43001,3,3,150785,150786,150789,1,4,0
43002,5,1,150790,150790,150791,0,1,1
43003,6,1,150796,150796,150797,0,1,5
43004,6,1,150802,150802,150803,0,1,5
43005,5,3,150807,150807,150810,0,3,4
43006,1,2,150808,150810,150812,2,4,0
43007,3,3,150811,150812,150815,1,4,0
43008,2,2,150813,150815,150817,2,4,0
43009,6,1,150819,150819,150820,0,1,2
43010,4,2,150823,150823,150825,0,2,3
43011,4,2,150827,150827,150829,0,2,2
43012,5,3,150832,150832,150835,0,3,3
43013,3,3,150835,150835,150838,0,3,0
43014,1,2,150836,150838,150840,2,4,0
43015,6,2,150842,150842,150844,0,2,2
43016,4,1,150846,150846,150847,0,1,2
43017,6,3,150852,150852,150855,0,3,5
43018,4,2,150856,150856,150858,0,2,1
43019,5,3,150861,150861,150864,0,3,3
43020,4,1,150865,150865,150866,0,1,1
43021,4,1,150869,150869,150870,0,1,3
43022,3,1,150872,150872,150873,0,1,2
43023,3,1,150875,150875,150876,0,1,2
43024,6,2,150881,150881,150883,0,2,5
43025,5,3,150886,150886,150889,0,3,3
43026,1,3,150887,150889,150892,2,5,0
43027,5,1,150892,150892,150893,0,1,0
43028,6,2,150898,150898,150900,0,2,5
43029,1,1,150899,150900,150901,1,2,0
43030,2,3,150901,150901,150904,0,3,0
43031,4,3,150905,150905,150908,0,3,1
43032,3,1,150908,150908,150909,0,1,0
43033,1,2,150909,150909,150911,0,2,0
43034,4,1,150913,150913,150914,0,1,2
43035,3,3,150916,150916,150919,0,3,2
43036,3,1,150919,150919,150920,0,1,0
43037,6,3,150925,150925,150928,0,3,5
43038,5,1,150930,150930,150931,0,1,2
43039,3,3,150933,150933,150936,0,3,2
43040,1,2,150934,150936,150938,2,4,0
43041,2,1,150936,150938,150939,2,3,0
43042,5,3,150941,150941,150944,0,3,2
43043,3,1,150944,150944,150945,0,1,0
43044,2,1,150946,150946,150947,0,1,1
43045,4,2,150950,150950,150952,0,2,3
43046,5,3,150955,150955,150958,0,3,3
43047,1,3,150956,150958,150961,2,5,0
43048,1,3,150957,150961,150964,4,7,0
43049,5,2,150962,150964,150966,2,4,0
43050,2,3,150964,150966,150969,2,5,0
43051,3,1,150967,150969,150970,2,3,0
43052,4,3,150971,150971,150974,0,3,1
43053,3,3,150974,150974,150977,0,3,0
43054,3,1,150977,150977,150978,0,1,0
43055,2,2,150979,150979,150981,0,2,1
43056,4,2,150983,150983,150985,0,2,2
43057,4,1,150987,150987,150988,0,1,2
43058,4,2,150991,150991,150993,0,2,3
43059,2,2,150993,150993,150995,0,2,0
43060,2,3,150995,150995,150998,0,3,0
43061,2,1,150997,150998,150999,1,2,0
43062,6,1,151003,151003,151004,0,1,4
43063,2,2,151005,151005,151007,0,2,1
43064,1,3,151006,151007,151010,1,4,0
43065,3,3,151009,151010,151013,1,4,0
43066,1,1,151010,151013,151014,3,4,0
43067,2,3,151012,151014,151017,2,5,0
43068,5,2,151017,151017,151019,0,2,0
43069,5,3,151022,151022,151025,0,3,3
43070,4,3,151026,151026,151029,0,3,1
43071,3,3,151029,151029,151032,0,3,0
43072,6,3,151035,151035,151038,0,3,3
43073,4,1,151039,151039,151040,0,1,1
43074,1,3,151040,151040,151043,0,3,0
43075,2,1,151042,151043,151044,1,2,0
43076,3,1,151045,151045,151046,0,1,1
43077,4,3,151049,151049,151052,0,3,3
43078,6,1,151055,151055,151056,0,1,3
43079,5,1,151060,151060,151061,0,1,4
43080,4,3,151064,151064,151067,0,3,3
43081,5,1,151069,151069,151070,0,1,2
43082,1,3,151070,151070,151073,0,3,0
43083,6,3,151076,151076,151079,0,3,3
43084,1,1,151077,151079,151080,2,3,0
43085,5,1,151082,151082,151083,0,1,2
43086,1,1,151083,151083,151084,0,1,0
43087,3,1,151086,151086,151087,0,1,2
43088,5,1,151091,151091,151092,0,1,4
43089,1,2,151092,151092,151094,0,2,0
43090,4,2,151096,151096,151098,0,2,2
43091,4,3,151100,151100,151103,0,3,2
43092,2,3,151102,151103,151106,1,4,0
43093,2,1,151104,151106,151107,2,3,0
43094,5,3,151109,151109,151112,0,3,2
43095,5,1,151114,151114,151115,0,1,2
43096,1,3,151115,151115,151118,0,3,0
43097,5,3,151120,151120,151123,0,3,2
43098,3,3,151123,151123,151126,0,3,0
43099,1,2,151124,151126,151128,2,4,0
43100,6,2,151130,151130,151132,0,2,2
43101,5,3,151135,151135,151138,0,3,3
43102,4,1,151139,151139,151140,0,1,1
43103,1,3,151140,151140,151143,0,3,0
43104,3,2,151143,151143,151145,0,2,0
43105,4,1,151147,151147,151148,0,1,2
43106,1,1,151148,151148,151149,0,1,0
43107,6,2,151154,151154,151156,0,2,5
43108,5,2,151159,151159,151161,0,2,3
43109,6,1,151165,151165,151166,0,1,4
43110,3,3,151168,151168,151171,0,3,2
43111,4,1,151172,151172,151173,0,1,1
43112,5,2,151177,151177,151179,0,2,4
43113,1,1,151178,151179,151180,1,2,0
43114,3,1,151181,151181,151182,0,1,1
43115,6,2,151187,151187,151189,0,2,5
43116,4,2,151191,151191,151193,0,2,2
43117,2,3,151193,151193,151196,0,3,0
43118,1,3,151194,151196,151199,2,5,0
43119,3,3,151197,151199,151202,2,5,0
43120,1,1,151198,151202,151203,4,5,0
43121,4,1,151202,151203,151204,1,2,0
43122,4,2,151206,151206,151208,0,2,2
43123,4,3,151210,151210,151213,0,3,2
43124,5,2,151215,151215,151217,0,2,2
43125,1,3,151216,151217,151220,1,4,0
43126,1,1,151217,151220,151221,3,4,0
43127,2,2,151219,151221,151223,2,4,0
43128,3,1,151222,151223,151224,1,2,0
43129,2,2,151224,151224,151226,0,2,0
43130,5,1,151229,151229,151230,0,1,3
43131,1,3,151230,151230,151233,0,3,0
43132,4,3,151234,151234,151237,0,3,1
43133,1,1,151235,151237,151238,2,3,0
43134,1,3,151236,151238,151241,2,5,0
43135,3,3,151239,151241,151244,2,5,0
43136,3,3,151242,151244,151247,2,5,0
43137,2,2,151244,151247,151249,3,5,0
43138,4,1,151248,151249,151250,1,2,0
43139,1,3,151249,151250,151253,1,4,0
43140,1,1,151250,151253,151254,3,4,0
43141,5,1,151255,151255,151256,0,1,1
43142,1,2,151256,151256,151258,0,2,0
43143,5,2,151261,151261,151263,0,2,3
43144,2,2,151263,151263,151265,0,2,0
43145,3,3,151266,151266,151269,0,3,1
43146,2,1,151268,151269,151270,1,2,0
43147,3,3,151271,151271,151274,0,3,1
43148,3,3,151274,151274,151277,0,3,0
43149,4,3,151278,151278,151281,0,3,1
43150,6,2,151284,151284,151286,0,2,3
43151,6,3,151290,151290,151293,0,3,4
43152,4,2,151294,151294,151296,0,2,1
43153,5,2,151299,151299,151301,0,2,3
43154,5,3,151304,151304,151307,0,3,3
43155,2,1,151306,151307,151308,1,2,0
43156,2,2,151308,151308,151310,0,2,0
43157,3,3,151311,151311,151314,0,3,1
43158,5,1,151316,151316,151317,0,1,2
43159,6,3,151322,151322,151325,0,3,5
43160,2,1,151324,151325,151326,1,2,0
43161,2,3,151326,151326,151329,0,3,0
43162,3,3,151329,151329,151332,0,3,0
43163,2,1,151331,151332,151333,1,2,0
43164,1,1,151332,151333,151334,1,2,0
43165,2,2,151334,151334,151336,0,2,0
43166,1,3,151335,151336,151339,1,4,0
43167,3,2,151338,151339,151341,1,3,0
43168,2,2,151340,151341,151343,1,3,0
43169,4,1,151344,151344,151345,0,1,1
43170,4,1,151348,151348,151349,0,1,3
43171,6,1,151354,151354,151355,0,1,5
43172,2,2,151356,151356,151358,0,2,1
43173,6,3,151362,151362,151365,0,3,4
43174,6,1,151368,151368,151369,0,1,3
43175,1,1,151369,151369,151370,0,1,0
43176,2,2,151371,151371,151373,0,2,1
43177,4,2,151375,151375,151377,0,2,2
43178,1,3,151376,151377,151380,1,4,0
43179,4,2,151380,151380,151382,0,2,0
43180,6,3,151386,151386,151389,0,3,4
43181,2,3,151388,151389,151392,1,4,0
43182,3,2,151391,151392,151394,1,3,0
43183,5,3,151396,151396,151399,0,3,2
43184,2,1,151398,151399,151400,1,2,0
43185,2,3,151400,151400,151403,0,3,0
43186,3,2,151403,151403,151405,0,2,0
43187,6,1,151409,151409,151410,0,1,4
43188,3,1,151412,151412,151413,0,1,2
43189,1,1,151413,151413,151414,0,1,0
43190,4,3,151417,151417,151420,0,3,3
43191,4,2,151421,151421,151423,0,2,1
43192,2,3,151423,151423,151426,0,3,0
43193,5,1,151428,151428,151429,0,1,2
43194,4,1,151432,151432,151433,0,1,3
43195,5,3,151437,151437,151440,0,3,4
43196,2,2,151439,151440,151442,1,3,0
43197,3,2,151442,151442,151444,0,2,0
43198,4,3,151446,151446,151449,0,3,2
43199,6,3,151452,151452,151455,0,3,3
43200,5,2,151457,151457,151459,0,2,2
43201,5,3,151462,151462,151465,0,3,3
43202,4,3,151466,151466,151469,0,3,1
43203,2,3,151468,151469,151472,1,4,0
43204,4,2,151472,151472,151474,0,2,0
43205,3,1,151475,151475,151476,0,1,1
43206,2,2,151477,151477,151479,0,2,1
43207,3,1,151480,151480,151481,0,1,1
43208,3,2,151483,151483,151485,0,2,2
43209,3,1,151486,151486,151487,0,1,1
43210,5,3,151491,151491,151494,0,3,4
43211,1,1,151492,151494,151495,2,3,0
43212,4,2,151496,151496,151498,0,2,1
43213,1,3,151497,151498,151501,1,4,0
43214,1,2,151498,151501,151503,3,5,0
43215,1,1,151499,151503,151504,4,5,0
43216,1,3,151500,151504,151507,4,7,0
43217,6,3,151506,151507,151510,1,4,0
43218,2,2,151508,151510,151512,2,4,0
43219,2,2,151510,151512,151514,2,4,0
43220,3,2,151513,151514,151516,1,3,0
43221,3,3,151516,151516,151519,0,3,0
43222,2,1,151518,151519,151520,1,2,0
43223,3,3,151521,151521,151524,0,3,1
43224,4,2,151525,151525,151527,0,2,1
43225,4,3,151529,151529,151532,0,3,2
43226,3,3,151532,151532,151535,0,3,0
43227,3,3,151535,151535,151538,0,3,0
43228,5,1,151540,151540,151541,0,1,2
43229,3,1,151543,151543,151544,0,1,2
43230,6,3,151549,151549,151552,0,3,5
43231,4,2,151553,151553,151555,0,2,1
43232,3,3,151556,151556,151559,0,3,1
43233,5,1,151561,151561,151562,0,1,2
43234,6,3,151567,151567,151570,0,3,5
43235,4,3,151571,151571,151574,0,3,1
43236,6,2,151577,151577,151579,0,2,3
43237,3,2,151580,151580,151582,0,2,1
43238,3,3,151583,151583,151586,0,3,1
43239,2,1,151585,151586,151587,1,2,0
43240,5,3,151590,151590,151593,0,3,3
43241,5,1,151595,151595,151596,0,1,2
43242,4,3,151599,151599,151602,0,3,3
43243,5,2,151604,151604,151606,0,2,2
43244,3,3,151607,151607,151610,0,3,1
43245,6,2,151613,151613,151615,0,2,3
43246,1,1,151614,151615,151616,1,2,0
43247,4,1,151618,151618,151619,0,1,2
43248,6,1,151624,151624,151625,0,1,5
43249,4,2,151628,151628,151630,0,2,3
43250,2,1,151630,151630,151631,0,1,0
43251,4,3,151634,151634,151637,0,3,3
43252,5,3,151639,151639,151642,0,3,2
43253,5,2,151644,151644,151646,0,2,2
43254,2,1,151646,151646,151647,0,1,0
43255,6,3,151652,151652,151655,0,3,5
43256,5,1,151657,151657,151658,0,1,2
43257,4,3,151661,151661,151664,0,3,3
43258,3,2,151664,151664,151666,0,2,0
43259,3,1,151667,151667,151668,0,1,1
43260,6,3,151673,151673,151676,0,3,5
43261,2,3,151675,151676,151679,1,4,0
43262,6,1,151681,151681,151682,0,1,2
43263,4,3,151685,151685,151688,0,3,3
43264,5,3,151690,151690,151693,0,3,2
43265,5,2,151695,151695,151697,0,2,2
43266,2,3,151697,151697,151700,0,3,0
43267,2,1,151699,151700,151701,1,2,0
43268,2,1,151701,151701,151702,0,1,0
43269,2,3,151703,151703,151706,0,3,1
43270,3,3,151706,151706,151709,0,3,0
43271,6,2,151712,151712,151714,0,2,3
43272,6,1,151718,151718,151719,0,1,4
43273,2,1,151720,151720,151721,0,1,1
43274,3,2,151723,151723,151725,0,2,2
43275,5,2,151728,151728,151730,0,2,3
43276,1,1,151729,151730,151731,1,2,0
43277,4,1,151733,151733,151734,0,1,2
43278,3,3,151736,151736,151739,0,3,2
43279,5,1,151741,151741,151742,0,1,2
43280,6,1,151747,151747,151748,0,1,5
43281,3,3,151750,151750,151753,0,3,2
43282,4,1,151754,151754,151755,0,1,1
43283,6,2,151760,151760,151762,0,2,5
43284,4,3,151764,151764,151767,0,3,2
43285,2,1,151766,151767,151768,1,2,0
43286,1,2,151767,151768,151770,1,3,0
43287,3,2,151770,151770,151772,0,2,0
43288,6,2,151776,151776,151778,0,2,4
43289,2,3,151778,151778,151781,0,3,0
43290,6,2,151784,151784,151786,0,2,3
43291,3,3,151787,151787,151790,0,3,1
43292,1,2,151788,151790,151792,2,4,0
43293,5,1,151793,151793,151794,0,1,1
43294,1,3,151794,151794,151797,0,3,0
43295,2,2,151796,151797,151799,1,3,0
43296,4,3,151800,151800,151803,0,3,1
43297,4,1,151804,151804,151805,0,1,1
43298,3,2,151807,151807,151809,0,2,2
43299,5,3,151812,151812,151815,0,3,3
43300,3,1,151815,151815,151816,0,1,0
43301,4,3,151819,151819,151822,0,3,3
43302,1,2,151820,151822,151824,2,4,0
43303,2,1,151822,151824,151825,2,3,0
43304,4,3,151826,151826,151829,0,3,1
43305,4,1,151830,151830,151831,0,1,1
43306,5,2,151835,151835,151837,0,2,4
43307,5,1,151840,151840,151841,0,1,3
43308,6,1,151846,151846,151847,0,1,5
43309,3,2,151849,151849,151851,0,2,2
43310,1,1,151850,151851,151852,1,2,0
43311,5,2,151855,151855,151857,0,2,3
43312,1,1,151856,151857,151858,1,2,0
43313,4,2,151860,151860,151862,0,2,2
43314,1,3,151861,151862,151865,1,4,0
43315,2,1,151863,151865,151866,2,3,0
43316,6,3,151869,151869,151872,0,3,3
43317,4,1,151873,151873,151874,0,1,1
43318,5,3,151878,151878,151881,0,3,4
43319,2,3,151880,151881,151884,1,4,0
43320,6,3,151886,151886,151889,0,3,2
43321,1,2,151887,151889,151891,2,4,0
43322,5,3,151892,151892,151895,0,3,1
43323,4,2,151896,151896,151898,0,2,1
43324,6,2,151902,151902,151904,0,2,4
43325,1,3,151903,151904,151907,1,4,0
43326,5,2,151908,151908,151910,0,2,1
43327,5,3,151913,151913,151916,0,3,3
43328,5,1,151918,151918,151919,0,1,2
43329,6,1,151924,151924,151925,0,1,5
43330,6,1,151930,151930,151931,0,1,5
43331,4,2,151934,151934,151936,0,2,3
43332,5,3,151939,151939,151942,0,3,3
43333,1,3,151940,151942,151945,2,5,0
43334,1,2,151941,151945,151947,4,6,0
43335,6,3,151947,151947,151950,0,3,0
43336,6,1,151953,151953,151954,0,1,3
43337,3,3,151956,151956,151959,0,3,2
43338,4,3,151960,151960,151963,0,3,1
43339,2,3,151962,151963,151966,1,4,0
43340,5,2,151967,151967,151969,0,2,1
43341,2,3,151969,151969,151972,0,3,0
43342,5,2,151974,151974,151976,0,2,2
43343,3,1,151977,151977,151978,0,1,1
43344,5,3,151982,151982,151985,0,3,4
43345,6,1,151988,151988,151989,0,1,3
43346,5,2,151993,151993,151995,0,2,4
43347,6,3,151999,151999,152002,0,3,4
43348,5,3,152004,152004,152007,0,3,2
43349,4,2,152008,152008,152010,0,2,1
43350,6,2,152014,152014,152016,0,2,4
43351,6,3,152020,152020,152023,0,3,4
43352,6,1,152026,152026,152027,0,1,3
43353,6,3,152032,152032,152035,0,3,5
43354,4,3,152036,152036,152039,0,3,1
43355,6,3,152042,152042,152045,0,3,3
43356,4,3,152046,152046,152049,0,3,1
43357,4,2,152050,152050,152052,0,2,1
43358,6,1,152056,152056,152057,0,1,4
43359,5,1,152061,152061,152062,0,1,4
43360,5,2,152066,152066,152068,0,2,4
43361,1,1,152067,152068,152069,1,2,0
43362,1,1,152068,152069,152070,1,2,0
43363,3,1,152071,152071,152072,0,1,1
43364,6,3,152077,152077,152080,0,3,5
43365,2,1,152079,152080,152081,1,2,0
43366,4,1,152083,152083,152084,0,1,2
43367,6,2,152089,152089,152091,0,2,5
43368,6,2,152095,152095,152097,0,2,4
43369,1,3,152096,152097,152100,1,4,0
43370,3,2,152099,152100,152102,1,3,0
43371,2,3,152101,152102,152105,1,4,0
43372,4,2,152105,152105,152107,0,2,0
43373,1,3,152106,152107,152110,1,4,0
43374,5,1,152111,152111,152112,0,1,1
43375,3,2,152114,152114,152116,0,2,2
43376,5,1,152119,152119,152120,0,1,3
43377,4,2,152123,152123,152125,0,2,3
43378,5,3,152128,152128,152131,0,3,3
43379,4,2,152132,152132,152134,0,2,1
43380,4,1,152136,152136,152137,0,1,2
43381,1,3,152137,152137,152140,0,3,0
43382,3,1,152140,152140,152141,0,1,0
43383,6,1,152146,152146,152147,0,1,5
43384,3,2,152149,152149,152151,0,2,2
43385,4,2,152153,152153,152155,0,2,2
43386,4,1,152157,152157,152158,0,1,2
43387,2,2,152159,152159,152161,0,2,1
43388,3,2,152162,152162,152164,0,2,1
43389,6,3,152168,152168,152171,0,3,4
43390,5,2,152173,152173,152175,0,2,2
43391,4,1,152177,152177,152178,0,1,2
43392,2,1,152179,152179,152180,0,1,1
43393,2,2,152181,152181,152183,0,2,1
43394,3,1,152184,152184,152185,0,1,1
43395,5,3,152189,152189,152192,0,3,4
43396,3,1,152192,152192,152193,0,1,0
43397,1,3,152193,152193,152196,0,3,0
43398,4,3,152197,152197,152200,0,3,1
43399,3,2,152200,152200,152202,0,2,0
43400,5,1,152205,152205,152206,0,1,3
43401,2,1,152207,152207,152208,0,1,1
43402,5,3,152212,152212,152215,0,3,4
43403,5,2,152217,152217,152219,0,2,2
43404,1,2,152218,152219,152221,1,3,0
43405,4,1,152222,152222,152223,0,1,1
43406,5,3,152227,152227,152230,0,3,4
43407,3,1,152230,152230,152231,0,1,0
43408,6,2,152236,152236,152238,0,2,5
43409,6,3,152242,152242,152245,0,3,4
43410,6,1,152248,152248,152249,0,1,3
43411,1,3,152249,152249,152252,0,3,0
43412,5,2,152254,152254,152256,0,2,2
43413,4,1,152258,152258,152259,0,1,2
43414,1,2,152259,152259,152261,0,2,0
43415,4,2,152263,152263,152265,0,2,2
43416,6,2,152269,152269,152271,0,2,4
43417,2,3,152271,152271,152274,0,3,0
43418,6,2,152277,152277,152279,0,2,3
43419,2,1,152279,152279,152280,0,1,0
43420,6,3,152285,152285,152288,0,3,5
43421,5,1,152290,152290,152291,0,1,2
43422,2,1,152292,152292,152293,0,1,1
43423,5,3,152297,152297,152300,0,3,4
43424,5,3,152302,152302,152305,0,3,2
43425,2,1,152304,152305,152306,1,2,0
43426,5,1,152309,152309,152310,0,1,3
43427,1,2,152310,152310,152312,0,2,0
43428,1,3,152311,152312,152315,1,4,0
43429,6,3,152317,152317,152320,0,3,2
43430,5,2,152322,152322,152324,0,2,2
43431,5,3,152327,152327,152330,0,3,3
43432,2,2,152329,152330,152332,1,3,0
43433,4,1,152333,152333,152334,0,1,1
43434,2,2,152335,152335,152337,0,2,1
43435,1,3,152336,152337,152340,1,4,0
43436,4,2,152340,152340,152342,0,2,0
43437,4,3,152344,152344,152347,0,3,2
43438,1,3,152345,152347,152350,2,5,0
43439,4,1,152349,152350,152351,1,2,0
43440,5,1,152354,152354,152355,0,1,3
43441,3,1,152357,152357,152358,0,1,2
43442,3,3,152360,152360,152363,0,3,2
43443,4,2,152364,152364,152366,0,2,1
43444,4,2,152368,152368,152370,0,2,2
43445,1,3,152369,152370,152373,1,4,0
43446,6,2,152375,152375,152377,0,2,2
43447,2,3,152377,152377,152380,0,3,0
43448,1,2,152378,152380,152382,2,4,0
43449,6,1,152384,152384,152385,0,1,2
43450,1,1,152385,152385,152386,0,1,0
43451,6,2,152391,152391,152393,0,2,5
43452,6,1,152397,152397,152398,0,1,4
43453,1,3,152398,152398,152401,0,3,0
43454,3,1,152401,152401,152402,0,1,0
43455,3,2,152404,152404,152406,0,2,2
43456,5,3,152409,152409,152412,0,3,3
43457,1,1,152410,152412,152413,2,3,0
43458,6,3,152416,152416,152419,0,3,3
43459,2,2,152418,152419,152421,1,3,0
43460,1,1,152419,152421,152422,2,3,0
43461,1,1,152420,152422,152423,2,3,0
43462,4,1,152424,152424,152425,0,1,1
43463,2,1,152426,152426,152427,0,1,1
43464,6,1,152432,152432,152433,0,1,5
43465,2,3,152434,152434,152437,0,3,1
43466,6,1,152440,152440,152441,0,1,3
43467,5,3,152445,152445,152448,0,3,4
43468,4,1,152449,152449,152450,0,1,1
43469,4,2,152453,152453,152455,0,2,3
43470,2,1,152455,152455,152456,0,1,0
43471,4,1,152459,152459,152460,0,1,3
43472,2,1,152461,152461,152462,0,1,1
43473,3,2,152464,152464,152466,0,2,2
43474,3,3,152467,152467,152470,0,3,1
43475,6,1,152473,152473,152474,0,1,3
43476,1,2,152474,152474,152476,0,2,0
43477,4,2,152478,152478,152480,0,2,2
43478,2,1,152480,152480,152481,0,1,0
43479,5,3,152485,152485,152488,0,3,4
43480,1,1,152486,152488,152489,2,3,0
43481,2,1,152488,152489,152490,1,2,0
43482,3,1,152491,152491,152492,0,1,1
43483,3,3,152494,152494,152497,0,3,2
43484,4,1,152498,152498,152499,0,1,1
43485,5,3,152503,152503,152506,0,3,4
43486,2,2,152505,152506,152508,1,3,0
43487,4,2,152509,152509,152511,0,2,1
43488,5,1,152514,152514,152515,0,1,3
43489,6,3,152520,152520,152523,0,3,5
43490,5,3,152525,152525,152528,0,3,2
43491,5,1,152530,152530,152531,0,1,2
43492,5,3,152535,152535,152538,0,3,4
43493,6,1,152541,152541,152542,0,1,3
43494,2,2,152543,152543,152545,0,2,1
43495,2,3,152545,152545,152548,0,3,0
43496,1,2,152546,152548,152550,2,4,0
43497,2,3,152548,152550,152553,2,5,0
43498,1,3,152549,152553,152556,4,7,0
43499,3,3,152552,152556,152559,4,7,0
43500,3,1,152555,152559,152560,4,5,0
43501,6,1,152561,152561,152562,0,1,1
43502,1,1,152562,152562,152563,0,1,0
43503,5,2,152567,152567,152569,0,2,4
43504,4,1,152571,152571,152572,0,1,2
43505,6,3,152577,152577,152580,0,3,5
43506,2,1,152579,152580,152581,1,2,0
43507,6,1,152585,152585,152586,0,1,4
43508,4,2,152589,152589,152591,0,2,3
43509,1,3,152590,152591,152594,1,4,0
43510,3,1,152593,152594,152595,1,2,0
43511,2,3,152595,152595,152598,0,3,0
43512,6,2,152601,152601,152603,0,2,3
43513,1,1,152602,152603,152604,1,2,0
43514,3,3,152605,152605,152608,0,3,1
43515,6,3,152611,152611,152614,0,3,3
43516,4,3,152615,152615,152618,0,3,1
43517,5,3,152620,152620,152623,0,3,2
43518,6,3,152626,152626,152629,0,3,3
43519,3,2,152629,152629,152631,0,2,0
43520,3,1,152632,152632,152633,0,1,1
43521,1,2,152633,152633,152635,0,2,0
43522,2,2,152635,152635,152637,0,2,0
43523,2,1,152637,152637,152638,0,1,0
43524,6,2,152643,152643,152645,0,2,5
43525,3,2,152646,152646,152648,0,2,1
43526,1,3,152647,152648,152651,1,4,0
43527,3,2,152650,152651,152653,1,3,0
43528,5,2,152655,152655,152657,0,2,2
43529,2,1,152657,152657,152658,0,1,0
43530,5,1,152662,152662,152663,0,1,4
43531,5,2,152667,152667,152669,0,2,4
43532,1,1,152668,152669,152670,1,2,0
43533,2,3,152670,152670,152673,0,3,0
43534,5,1,152675,152675,152676,0,1,2
43535,5,2,152680,152680,152682,0,2,4
43536,1,1,152681,152682,152683,1,2,0
43537,4,2,152685,152685,152687,0,2,2
43538,5,1,152690,152690,152691,0,1,3
43539,6,2,152696,152696,152698,0,2,5
43540,3,2,152699,152699,152701,0,2,1
43541,4,1,152703,152703,152704,0,1,2
43542,3,1,152706,152706,152707,0,1,2
43543,2,3,152708,152708,152711,0,3,1
43544,3,2,152711,152711,152713,0,2,0
43545,3,3,152714,152714,152717,0,3,1
43546,1,1,152715,152717,152718,2,3,0
43547,4,2,152719,152719,152721,0,2,1
43548,6,3,152725,152725,152728,0,3,4
43549,5,3,152730,152730,152733,0,3,2
43550,2,3,152732,152733,152736,1,4,0
43551,4,3,152736,152736,152739,0,3,0
43552,6,2,152742,152742,152744,0,2,3
43553,6,3,152748,152748,152751,0,3,4
43554,6,2,152754,152754,152756,0,2,3
43555,4,1,152758,152758,152759,0,1,2
43556,3,1,152761,152761,152762,0,1,2
43557,3,2,152764,152764,152766,0,2,2
43558,2,1,152766,152766,152767,0,1,0
43559,3,2,152769,152769,152771,0,2,2
43560,4,1,152773,152773,152774,0,1,2
43561,3,2,152776,152776,152778,0,2,2
43562,5,1,152781,152781,152782,0,1,3
43563,3,3,152784,152784,152787,0,3,2
43564,2,1,152786,152787,152788,1,2,0
43565,2,3,152788,152788,152791,0,3,0
43566,5,3,152793,152793,152796,0,3,2
43567,5,2,152798,152798,152800,0,2,2
43568,2,3,152800,152800,152803,0,3,0
43569,1,3,152801,152803,152806,2,5,0
43570,3,1,152804,152806,152807,2,3,0
43571,5,2,152809,152809,152811,0,2,2
43572,3,3,152812,152812,152815,0,3,1
43573,4,2,152816,152816,152818,0,2,1
43574,4,1,152820,152820,152821,0,1,2
43575,4,3,152824,152824,152827,0,3,3
43576,2,2,152826,152827,152829,1,3,0
43577,3,2,152829,152829,152831,0,2,0
43578,6,1,152835,152835,152836,0,1,4
43579,2,2,152837,152837,152839,0,2,1
43580,5,1,152842,152842,152843,0,1,3
43581,5,3,152847,152847,152850,0,3,4
43582,6,1,152853,152853,152854,0,1,3
43583,3,3,152856,152856,152859,0,3,2
43584,6,2,152862,152862,152864,0,2,3
43585,4,2,152866,152866,152868,0,2,2
43586,4,2,152870,152870,152872,0,2,2
43587,2,2,152872,152872,152874,0,2,0
43588,1,3,152873,152874,152877,1,4,0
43589,1,1,152874,152877,152878,3,4,0
43590,3,1,152877,152878,152879,1,2,0
43591,3,3,152880,152880,152883,0,3,1
43592,5,1,152885,152885,152886,0,1,2
43593,2,1,152887,152887,152888,0,1,1
43594,2,2,152889,152889,152891,0,2,1
43595,6,2,152895,152895,152897,0,2,4
43596,4,1,152899,152899,152900,0,1,2
43597,4,3,152903,152903,152906,0,3,3
43598,5,3,152908,152908,152911,0,3,2
43599,5,3,152913,152913,152916,0,3,2
43600,6,2,152919,152919,152921,0,2,3
43601,4,3,152923,152923,152926,0,3,2
43602,6,3,152929,152929,152932,0,3,3
43603,5,3,152934,152934,152937,0,3,2
43604,2,3,152936,152937,152940,1,4,0
43605,1,1,152937,152940,152941,3,4,0
43606,1,3,152938,152941,152944,3,6,0
43607,4,3,152942,152944,152947,2,5,0
43608,2,1,152944,152947,152948,3,4,0
43609,3,3,152947,152948,152951,1,4,0
43610,4,3,152951,152951,152954,0,3,0
43611,5,2,152956,152956,152958,0,2,2
43612,3,2,152959,152959,152961,0,2,1
43613,6,1,152965,152965,152966,0,1,4
43614,6,3,152971,152971,152974,0,3,5
43615,3,2,152974,152974,152976,0,2,0
43616,3,1,152977,152977,152978,0,1,1
43617,1,3,152978,152978,152981,0,3,0
43618,5,2,152983,152983,152985,0,2,2
43619,3,2,152986,152986,152988,0,2,1
43620,6,1,152992,152992,152993,0,1,4
43621,2,3,152994,152994,152997,0,3,1
43622,1,1,152995,152997,152998,2,3,0
43623,4,2,152999,152999,153001,0,2,1
43624,6,3,153005,153005,153008,0,3,4
43625,2,2,153007,153008,153010,1,3,0
43626,1,2,153008,153010,153012,2,4,0
43627,6,3,153014,153014,153017,0,3,2
43628,4,2,153018,153018,153020,0,2,1
43629,1,2,153019,153020,153022,1,3,0
43630,1,2,153020,153022,153024,2,4,0
43631,5,1,153025,153025,153026,0,1,1
43632,3,3,153028,153028,153031,0,3,2
43633,1,3,153029,153031,153034,2,5,0
43634,3,1,153032,153034,153035,2,3,0
43635,3,3,153035,153035,153038,0,3,0
43636,4,1,153039,153039,153040,0,1,1
43637,1,1,153040,153040,153041,0,1,0
43638,1,1,153041,153041,153042,0,1,0
43639,1,2,153042,153042,153044,0,2,0
43640,4,2,153046,153046,153048,0,2,2
43641,2,2,153048,153048,153050,0,2,0
43642,3,1,153051,153051,153052,0,1,1
43643,5,3,153056,153056,153059,0,3,4
43644,1,3,153057,153059,153062,2,5,0
43645,3,1,153060,153062,153063,2,3,0
43646,6,3,153066,153066,153069,0,3,3
43647,5,3,153071,153071,153074,0,3,2
43648,5,3,153076,153076,153079,0,3,2
43649,4,1,153080,153080,153081,0,1,1
43650,5,1,153085,153085,153086,0,1,4
43651,6,3,153091,153091,153094,0,3,5
43652,3,3,153094,153094,153097,0,3,0
43653,5,2,153099,153099,153101,0,2,2
43654,5,2,153104,153104,153106,0,2,3
43655,3,3,153107,153107,153110,0,3,1
43656,1,2,153108,153110,153112,2,4,0
43657,5,1,153113,153113,153114,0,1,1
43658,3,3,153116,153116,153119,0,3,2
43659,6,1,153122,153122,153123,0,1,3
43660,1,2,153123,153123,153125,0,2,0
43661,2,2,153125,153125,153127,0,2,0
43662,5,2,153130,153130,153132,0,2,3
43663,4,3,153134,153134,153137,0,3,2
43664,6,3,153140,153140,153143,0,3,3
43665,6,3,153146,153146,153149,0,3,3
43666,4,3,153150,153150,153153,0,3,1
43667,6,2,153156,153156,153158,0,2,3
43668,2,1,153158,153158,153159,0,1,0
43669,6,2,153164,153164,153166,0,2,5
43670,1,2,153165,153166,153168,1,3,0
43671,1,2,153166,153168,153170,2,4,0
43672,4,1,153170,153170,153171,0,1,0
43673,1,3,153171,153171,153174,0,3,0
43674,3,2,153174,153174,153176,0,2,0
43675,2,3,153176,153176,153179,0,3,0
43676,6,1,153182,153182,153183,0,1,3
43677,4,2,153186,153186,153188,0,2,3
43678,3,3,153189,153189,153192,0,3,1
43679,4,3,153193,153193,153196,0,3,1
43680,3,1,153196,153196,153197,0,1,0
43681,3,3,153199,153199,153202,0,3,2
43682,2,2,153201,153202,153204,1,3,0
43683,3,2,153204,153204,153206,0,2,0
43684,5,1,153209,153209,153210,0,1,3
43685,6,2,153215,153215,153217,0,2,5
43686,5,3,153220,153220,153223,0,3,3
43687,2,3,153222,153223,153226,1,4,0
43688,2,3,153224,153226,153229,2,5,0
43689,3,1,153227,153229,153230,2,3,0
43690,1,3,153228,153230,153233,2,5,0
43691,3,3,153231,153233,153236,2,5,0
43692,6,1,153237,153237,153238,0,1,1
43693,6,3,153243,153243,153246,0,3,5
43694,5,3,153248,153248,153251,0,3,2
43695,5,1,153253,153253,153254,0,1,2
43696,2,2,153255,153255,153257,0,2,1
43697,4,3,153259,153259,153262,0,3,2
43698,5,2,153264,153264,153266,0,2,2
43699,6,1,153270,153270,153271,0,1,4
43700,4,1,153274,153274,153275,0,1,3
43701,3,2,153277,153277,153279,0,2,2
43702,3,3,153280,153280,153283,0,3,1
43703,5,2,153285,153285,153287,0,2,2
43704,5,2,153290,153290,153292,0,2,3
43705,6,3,153296,153296,153299,0,3,4
43706,3,2,153299,153299,153301,0,2,0
43707,4,2,153303,153303,153305,0,2,2
43708,1,2,153304,153305,153307,1,3,0
43709,1,3,153305,153307,153310,2,5,0
43710,3,2,153308,153310,153312,2,4,0
43711,6,2,153314,153314,153316,0,2,2
43712,3,3,153317,153317,153320,0,3,1
43713,4,1,153321,153321,153322,0,1,1
43714,3,1,153324,153324,153325,0,1,2
43715,1,3,153325,153325,153328,0,3,0
43716,4,2,153329,153329,153331,0,2,1
43717,1,2,153330,153331,153333,1,3,0
43718,1,2,153331,153333,153335,2,4,0
43719,5,3,153336,153336,153339,0,3,1
43720,1,1,153337,153339,153340,2,3,0
43721,3,2,153340,153340,153342,0,2,0
43722,3,3,153343,153343,153346,0,3,1
43723,6,2,153349,153349,153351,0,2,3
43724,6,2,153355,153355,153357,0,2,4
43725,3,3,153358,153358,153361,0,3,1
43726,4,1,153362,153362,153363,0,1,1
43727,2,3,153364,153364,153367,0,3,1
43728,5,3,153369,153369,153372,0,3,2
43729,4,3,153373,153373,153376,0,3,1
43730,1,1,153374,153376,153377,2,3,0
43731,3,3,153377,153377,153380,0,3,0
43732,6,1,153383,153383,153384,0,1,3
43733,5,3,153388,153388,153391,0,3,4
43734,3,3,153391,153391,153394,0,3,0
43735,3,3,153394,153394,153397,0,3,0
43736,1,2,153395,153397,153399,2,4,0
43737,4,2,153399,153399,153401,0,2,0
43738,2,1,153401,153401,153402,0,1,0
43739,5,1,153406,153406,153407,0,1,4
43740,5,3,153411,153411,153414,0,3,4
43741,6,3,153417,153417,153420,0,3,3
43742,3,3,153420,153420,153423,0,3,0
43743,6,1,153426,153426,153427,0,1,3
43744,1,2,153427,153427,153429,0,2,0
43745,1,3,153428,153429,153432,1,4,0
43746,5,1,153433,153433,153434,0,1,1
43747,3,1,153436,153436,153437,0,1,2
43748,6,2,153442,153442,153444,0,2,5
43749,3,3,153445,153445,153448,0,3,1
43750,2,2,153447,153448,153450,1,3,0
43751,1,3,153448,153450,153453,2,5,0
43752,1,3,153449,153453,153456,4,7,0
43753,6,1,153455,153456,153457,1,2,0
43754,1,1,153456,153457,153458,1,2,0
43755,5,3,153461,153461,153464,0,3,3
43756,6,1,153467,153467,153468,0,1,3
43757,2,3,153469,153469,153472,0,3,1
43758,2,3,153471,153472,153475,1,4,0
43759,3,1,153474,153475,153476,1,2,0
43760,1,3,153475,153476,153479,1,4,0
43761,4,3,153479,153479,153482,0,3,0
43762,1,2,153480,153482,153484,2,4,0
43763,1,3,153481,153484,153487,3,6,0
43764,5,3,153486,153487,153490,1,4,0
43765,4,2,153490,153490,153492,0,2,0
43766,5,1,153495,153495,153496,0,1,3
43767,1,2,153496,153496,153498,0,2,0
43768,2,2,153498,153498,153500,0,2,0
43769,4,1,153502,153502,153503,0,1,2
43770,3,3,153505,153505,153508,0,3,2
43771,4,3,153509,153509,153512,0,3,1
43772,2,2,153511,153512,153514,1,3,0
43773,5,2,153516,153516,153518,0,2,2
43774,5,1,153521,153521,153522,0,1,3
43775,3,1,153524,153524,153525,0,1,2
43776,1,3,153525,153525,153528,0,3,0
43777,6,2,153531,153531,153533,0,2,3
43778,3,3,153534,153534,153537,0,3,1
43779,3,1,153537,153537,153538,0,1,0
43780,1,1,153538,153538,153539,0,1,0
43781,6,3,153544,153544,153547,0,3,5
43782,5,3,153549,153549,153552,0,3,2
43783,5,3,153554,153554,153557,0,3,2
43784,1,2,153555,153557,153559,2,4,0
43785,1,2,153556,153559,153561,3,5,0
43786,2,1,153558,153561,153562,3,4,0
43787,1,3,153559,153562,153565,3,6,0
43788,6,1,153565,153565,153566,0,1,0
43789,3,3,153568,153568,153571,0,3,2
43790,5,2,153573,153573,153575,0,2,2
43791,2,3,153575,153575,153578,0,3,0
43792,3,2,153578,153578,153580,0,2,0
43793,2,2,153580,153580,153582,0,2,0
43794,3,1,153583,153583,153584,0,1,1
43795,1,3,153584,153584,153587,0,3,0
43796,3,2,153587,153587,153589,0,2,0
43797,3,1,153590,153590,153591,0,1,1
43798,5,3,153595,153595,153598,0,3,4
43799,5,3,153600,153600,153603,0,3,2
43800,6,3,153606,153606,153609,0,3,3
43801,4,1,153610,153610,153611,0,1,1
43802,3,3,153613,153613,153616,0,3,2
43803,4,3,153617,153617,153620,0,3,1
43804,2,1,153619,153620,153621,1,2,0
43805,1,3,153620,153621,153624,1,4,0
43806,6,2,153626,153626,153628,0,2,2
43807,5,1,153631,153631,153632,0,1,3
43808,1,3,153632,153632,153635,0,3,0
43809,5,2,153637,153637,153639,0,2,2
43810,5,1,153642,153642,153643,0,1,3
43811,5,3,153647,153647,153650,0,3,4
43812,1,1,153648,153650,153651,2,3,0
43813,2,3,153650,153651,153654,1,4,0
43814,5,3,153655,153655,153658,0,3,1
43815,6,3,153661,153661,153664,0,3,3
43816,5,3,153666,153666,153669,0,3,2
43817,4,2,153670,153670,153672,0,2,1
43818,4,3,153674,153674,153677,0,3,2
43819,5,2,153679,153679,153681,0,2,2
43820,6,2,153685,153685,153687,0,2,4
43821,5,1,153690,153690,153691,0,1,3
43822,3,2,153693,153693,153695,0,2,2
43823,5,3,153698,153698,153701,0,3,3
43824,1,1,153699,153701,153702,2,3,0
43825,3,1,153702,153702,153703,0,1,0
43826,2,1,153704,153704,153705,0,1,1
43827,2,2,153706,153706,153708,0,2,1
43828,6,3,153712,153712,153715,0,3,4
43829,1,1,153713,153715,153716,2,3,0
43830,2,3,153715,153716,153719,1,4,0
43831,5,2,153720,153720,153722,0,2,1
43832,5,3,153725,153725,153728,0,3,3
43833,2,2,153727,153728,153730,1,3,0
43834,2,3,153729,153730,153733,1,4,0
43835,6,2,153735,153735,153737,0,2,2
43836,6,2,153741,153741,153743,0,2,4
43837,6,3,153747,153747,153750,0,3,4
43838,5,2,153752,153752,153754,0,2,2
43839,2,1,153754,153754,153755,0,1,0
43840,1,2,153755,153755,153757,0,2,0
43841,5,1,153760,153760,153761,0,1,3
43842,3,3,153763,153763,153766,0,3,2
43843,3,2,153766,153766,153768,0,2,0
43844,5,3,153771,153771,153774,0,3,3
43845,2,2,153773,153774,153776,1,3,0
43846,1,1,153774,153776,153777,2,3,0
43847,6,2,153780,153780,153782,0,2,3
43848,6,2,153786,153786,153788,0,2,4
43849,3,2,153789,153789,153791,0,2,1
43850,2,3,153791,153791,153794,0,3,0
43851,2,2,153793,153794,153796,1,3,0
43852,1,3,153794,153796,153799,2,5,0
43853,5,3,153799,153799,153802,0,3,0
43854,5,1,153804,153804,153805,0,1,2
43855,1,2,153805,153805,153807,0,2,0
43856,6,3,153811,153811,153814,0,3,4
43857,5,3,153816,153816,153819,0,3,2
43858,1,3,153817,153819,153822,2,5,0
43859,6,1,153823,153823,153824,0,1,1
43860,4,1,153827,153827,153828,0,1,3
43861,1,1,153828,153828,153829,0,1,0
43862,4,1,153832,153832,153833,0,1,3
43863,5,1,153837,153837,153838,0,1,4
43864,2,3,153839,153839,153842,0,3,1
43865,6,2,153845,153845,153847,0,2,3
43866,1,3,153846,153847,153850,1,4,0
43867,1,2,153847,153850,153852,3,5,0
43868,4,3,153851,153852,153855,1,4,0
43869,2,1,153853,153855,153856,2,3,0
43870,4,3,153857,153857,153860,0,3,1
43871,2,2,153859,153860,153862,1,3,0
43872,6,2,153865,153865,153867,0,2,3
43873,3,2,153868,153868,153870,0,2,1
43874,3,2,153871,153871,153873,0,2,1
43875,4,2,153875,153875,153877,0,2,2
43876,5,2,153880,153880,153882,0,2,3
43877,4,2,153884,153884,153886,0,2,2
43878,4,3,153888,153888,153891,0,3,2
43879,2,2,153890,153891,153893,1,3,0
43880,2,1,153892,153893,153894,1,2,0
43881,2,1,153894,153894,153895,0,1,0
43882,1,1,153895,153895,153896,0,1,0
43883,6,3,153901,153901,153904,0,3,5
43884,1,2,153902,153904,153906,2,4,0
43885,4,1,153906,153906,153907,0,1,0
43886,6,3,153912,153912,153915,0,3,5
43887,1,1,153913,153915,153916,2,3,0
43888,2,1,153915,153916,153917,1,2,0
43889,2,3,153917,153917,153920,0,3,0
43890,4,2,153921,153921,153923,0,2,1
43891,5,2,153926,153926,153928,0,2,3
43892,1,1,153927,153928,153929,1,2,0
43893,5,3,153932,153932,153935,0,3,3
43894,5,1,153937,153937,153938,0,1,2
43895,4,3,153941,153941,153944,0,3,3
43896,1,3,153942,153944,153947,2,5,0
43897,4,2,153946,153947,153949,1,3,0
43898,3,2,153949,153949,153951,0,2,0
43899,1,1,153950,153951,153952,1,2,0
43900,1,1,153951,153952,153953,1,2,0
43901,5,3,153956,153956,153959,0,3,3
43902,6,3,153962,153962,153965,0,3,3
43903,2,2,153964,153965,153967,1,3,0
43904,2,1,153966,153967,153968,1,2,0
43905,2,2,153968,153968,153970,0,2,0
43906,6,2,153974,153974,153976,0,2,4
43907,4,2,153978,153978,153980,0,2,2
43908,2,2,153980,153980,153982,0,2,0
43909,3,1,153983,153983,153984,0,1,1
43910,3,2,153986,153986,153988,0,2,2
43911,6,3,153992,153992,153995,0,3,4
43912,1,3,153993,153995,153998,2,5,0
43913,3,1,153996,153998,153999,2,3,0
43914,4,1,154000,154000,154001,0,1,1
43915,2,2,154002,154002,154004,0,2,1
43916,6,2,154008,154008,154010,0,2,4
43917,3,3,154011,154011,154014,0,3,1
43918,5,1,154016,154016,154017,0,1,2
43919,2,2,154018,154018,154020,0,2,1
43920,3,2,154021,154021,154023,0,2,1
43921,5,1,154026,154026,154027,0,1,3
43922,1,1,154027,154027,154028,0,1,0
43923,1,3,154028,154028,154031,0,3,0
43924,1,2,154029,154031,154033,2,4,0
43925,2,1,154031,154033,154034,2,3,0
43926,6,3,154037,154037,154040,0,3,3
43927,3,2,154040,154040,154042,0,2,0
43928,3,1,154043,154043,154044,0,1,1
43929,4,1,154047,154047,154048,0,1,3
43930,2,1,154049,154049,154050,0,1,1
43931,5,3,154054,154054,154057,0,3,4
43932,3,1,154057,154057,154058,0,1,0
43933,5,1,154062,154062,154063,0,1,4
43934,6,1,154068,154068,154069,0,1,5
43935,4,3,154072,154072,154075,0,3,3
43936,1,3,154073,154075,154078,2,5,0
43937,2,1,154075,154078,154079,3,4,0
43938,5,3,154080,154080,154083,0,3,1
43939,5,1,154085,154085,154086,0,1,2
43940,5,1,154090,154090,154091,0,1,4
43941,2,3,154092,154092,154095,0,3,1
43942,2,3,154094,154095,154098,1,4,0
43943,2,1,154096,154098,154099,2,3,0
43944,2,2,154098,154099,154101,1,3,0
43945,6,2,154104,154104,154106,0,2,3
43946,2,1,154106,154106,154107,0,1,0
43947,5,2,154111,154111,154113,0,2,4
43948,3,1,154114,154114,154115,0,1,1
43949,5,3,154119,154119,154122,0,3,4
43950,5,1,154124,154124,154125,0,1,2
43951,5,3,154129,154129,154132,0,3,4
43952,5,3,154134,154134,154137,0,3,2
43953,4,2,154138,154138,154140,0,2,1
43954,2,1,154140,154140,154141,0,1,0
43955,4,1,154144,154144,154145,0,1,3
43956,5,1,154149,154149,154150,0,1,4
43957,2,2,154151,154151,154153,0,2,1
43958,3,3,154154,154154,154157,0,3,1
43959,3,2,154157,154157,154159,0,2,0
43960,5,1,154162,154162,154163,0,1,3
43961,1,2,154163,154163,154165,0,2,0
43962,3,2,154166,154166,154168,0,2,1
43963,4,1,154170,154170,154171,0,1,2
43964,3,1,154173,154173,154174,0,1,2
43965,4,3,154177,154177,154180,0,3,3
43966,5,2,154182,154182,154184,0,2,2
43967,1,3,154183,154184,154187,1,4,0
43968,6,2,154189,154189,154191,0,2,2
43969,1,2,154190,154191,154193,1,3,0
43970,1,3,154191,154193,154196,2,5,0
43971,4,2,154195,154196,154198,1,3,0
43972,2,2,154197,154198,154200,1,3,0
43973,2,3,154199,154200,154203,1,4,0
43974,1,1,154200,154203,154204,3,4,0
43975,3,2,154203,154204,154206,1,3,0
43976,2,1,154205,154206,154207,1,2,0
43977,3,3,154208,154208,154211,0,3,1
43978,1,2,154209,154211,154213,2,4,0
43979,4,2,154213,154213,154215,0,2,0
43980,3,3,154216,154216,154219,0,3,1
43981,5,1,154221,154221,154222,0,1,2
43982,3,3,154224,154224,154227,0,3,2
43983,6,2,154230,154230,154232,0,2,3
43984,3,3,154233,154233,154236,0,3,1
43985,6,2,154239,154239,154241,0,2,3
43986,5,1,154244,154244,154245,0,1,3
43987,1,3,154245,154245,154248,0,3,0
43988,6,2,154251,154251,154253,0,2,3
43989,3,1,154254,154254,154255,0,1,1
43990,5,1,154259,154259,154260,0,1,4
43991,5,2,154264,154264,154266,0,2,4
43992,1,2,154265,154266,154268,1,3,0
43993,3,3,154268,154268,154271,0,3,0
43994,6,1,154274,154274,154275,0,1,3
43995,4,3,154278,154278,154281,0,3,3
43996,1,3,154279,154281,154284,2,5,0
43997,4,1,154283,154284,154285,1,2,0
43998,5,1,154288,154288,154289,0,1,3
43999,4,3,154292,154292,154295,0,3,3
44000,4,3,154296,154296,154299,0,3,1
44001,4,1,154300,154300,154301,0,1,1
44002,1,3,154301,154301,154304,0,3,0
44003,5,1,154306,154306,154307,0,1,2
44004,3,2,154309,154309,154311,0,2,2
44005,5,3,154314,154314,154317,0,3,3
44006,4,1,154318,154318,154319,0,1,1
44007,2,3,154320,154320,154323,0,3,1
44008,3,3,154323,154323,154326,0,3,0
44009,4,1,154327,154327,154328,0,1,1
44010,5,2,154332,154332,154334,0,2,4
44011,2,3,154334,154334,154337,0,3,0
44012,1,1,154335,154337,154338,2,3,0
44013,6,1,154341,154341,154342,0,1,3
44014,4,2,154345,154345,154347,0,2,3
44015,3,3,154348,154348,154351,0,3,1
44016,5,3,154353,154353,154356,0,3,2
44017,5,2,154358,154358,154360,0,2,2
44018,2,1,154360,154360,154361,0,1,0
44019,2,2,154362,154362,154364,0,2,1
44020,3,1,154365,154365,154366,0,1,1
44021,1,1,154366,154366,154367,0,1,0
44022,3,1,154369,154369,154370,0,1,2
44023,1,3,154370,154370,154373,0,3,0
44024,2,3,154372,154373,154376,1,4,0
44025,2,3,154374,154376,154379,2,5,0
44026,5,1,154379,154379,154380,0,1,0
44027,3,3,154382,154382,154385,0,3,2
44028,2,1,154384,154385,154386,1,2,0
44029,6,2,154390,154390,154392,0,2,4
44030,6,2,154396,154396,154398,0,2,4
44031,6,3,154402,154402,154405,0,3,4
44032,3,1,154405,154405,154406,0,1,0
44033,3,1,154408,154408,154409,0,1,2
44034,2,2,154410,154410,154412,0,2,1
44035,5,3,154415,154415,154418,0,3,3
44036,1,1,154416,154418,154419,2,3,0
44037,5,2,154421,154421,154423,0,2,2
44038,3,2,154424,154424,154426,0,2,1
44039,1,1,154425,154426,154427,1,2,0
44040,5,1,154430,154430,154431,0,1,3
44041,2,3,154432,154432,154435,0,3,1
44042,4,2,154436,154436,154438,0,2,1
44043,5,2,154441,154441,154443,0,2,3
44044,6,2,154447,154447,154449,0,2,4
44045,1,1,154448,154449,154450,1,2,0
44046,2,3,154450,154450,154453,0,3,0
44047,4,3,154454,154454,154457,0,3,1
44048,5,2,154459,154459,154461,0,2,2
44049,4,3,154463,154463,154466,0,3,2
44050,4,1,154467,154467,154468,0,1,1
44051,5,2,154472,154472,154474,0,2,4
44052,1,3,154473,154474,154477,1,4,0
44053,4,3,154477,154477,154480,0,3,0
44054,6,1,154483,154483,154484,0,1,3
44055,4,1,154487,154487,154488,0,1,3
44056,5,3,154492,154492,154495,0,3,4
44057,3,2,154495,154495,154497,0,2,0
44058,2,2,154497,154497,154499,0,2,0
44059,3,2,154500,154500,154502,0,2,1
44060,6,3,154506,154506,154509,0,3,4
44061,1,3,154507,154509,154512,2,5,0
44062,1,2,154508,154512,154514,4,6,0
44063,6,3,154514,154514,154517,0,3,0
44064,3,2,154517,154517,154519,0,2,0
44065,5,2,154522,154522,154524,0,2,3
44066,1,3,154523,154524,154527,1,4,0
44067,6,2,154529,154529,154531,0,2,2
44068,3,2,154532,154532,154534,0,2,1
44069,4,3,154536,154536,154539,0,3,2
44070,3,1,154539,154539,154540,0,1,0
44071,4,1,154543,154543,154544,0,1,3
44072,3,1,154546,154546,154547,0,1,2
44073,4,2,154550,154550,154552,0,2,3
44074,2,1,154552,154552,154553,0,1,0
44075,1,2,154553,154553,154555,0,2,0
44076,1,1,154554,154555,154556,1,2,0
44077,6,3,154560,154560,154563,0,3,4
44078,4,2,154564,154564,154566,0,2,1
44079,3,3,154567,154567,154570,0,3,1
44080,1,1,154568,154570,154571,2,3,0
44081,4,2,154572,154572,154574,0,2,1
44082,2,2,154574,154574,154576,0,2,0
44083,5,3,154579,154579,154582,0,3,3
44084,5,2,154584,154584,154586,0,2,2
44085,2,2,154586,154586,154588,0,2,0
44086,4,3,154590,154590,154593,0,3,2
44087,3,1,154593,154593,154594,0,1,0
44088,3,3,154596,154596,154599,0,3,2
44089,4,3,154600,154600,154603,0,3,1
44090,4,3,154604,154604,154607,0,3,1
44091,6,1,154610,154610,154611,0,1,3
44092,6,1,154616,154616,154617,0,1,5
44093,6,2,154622,154622,154624,0,2,5
44094,5,2,154627,154627,154629,0,2,3
44095,3,1,154630,154630,154631,0,1,1
44096,2,1,154632,154632,154633,0,1,1
44097,5,3,154637,154637,154640,0,3,4
44098,3,3,154640,154640,154643,0,3,0
44099,2,3,154642,154643,154646,1,4,0
44100,3,1,154645,154646,154647,1,2,0
44101,2,2,154647,154647,154649,0,2,0
44102,1,2,154648,154649,154651,1,3,0
44103,5,2,154653,154653,154655,0,2,2
44104,1,2,154654,154655,154657,1,3,0
44105,1,2,154655,154657,154659,2,4,0
44106,4,3,154659,154659,154662,0,3,0
44107,2,1,154661,154662,154663,1,2,0
44108,5,1,154666,154666,154667,0,1,3
44109,6,1,154672,154672,154673,0,1,5
44110,2,3,154674,154674,154677,0,3,1
44111,5,2,154679,154679,154681,0,2,2
44112,3,3,154682,154682,154685,0,3,1
44113,2,1,154684,154685,154686,1,2,0
44114,6,2,154690,154690,154692,0,2,4
44115,1,1,154691,154692,154693,1,2,0
44116,1,3,154692,154693,154696,1,4,0
44117,5,2,154697,154697,154699,0,2,1
44118,3,1,154700,154700,154701,0,1,1
44119,6,2,154706,154706,154708,0,2,5
44120,1,2,154707,154708,154710,1,3,0
44121,5,2,154712,154712,154714,0,2,2
44122,4,3,154716,154716,154719,0,3,2
44123,5,2,154721,154721,154723,0,2,2
44124,4,2,154725,154725,154727,0,2,2
44125,2,1,154727,154727,154728,0,1,0
44126,3,3,154730,154730,154733,0,3,2
44127,3,2,154733,154733,154735,0,2,0
44128,3,3,154736,154736,154739,0,3,1
44129,1,1,154737,154739,154740,2,3,0
44130,1,1,154738,154740,154741,2,3,0
44131,2,3,154740,154741,154744,1,4,0
44132,3,3,154743,154744,154747,1,4,0
44133,2,1,154745,154747,154748,2,3,0
44134,5,2,154750,154750,154752,0,2,2
44135,5,3,154755,154755,154758,0,3,3
44136,5,3,154760,154760,154763,0,3,2
44137,1,3,154761,154763,154766,2,5,0
44138,1,1,154762,154766,154767,4,5,0
44139,5,2,154767,154767,154769,0,2,0
44140,5,1,154772,154772,154773,0,1,3
44141,4,1,154776,154776,154777,0,1,3
44142,5,3,154781,154781,154784,0,3,4
44143,3,3,154784,154784,154787,0,3,0
44144,4,1,154788,154788,154789,0,1,1
44145,5,2,154793,154793,154795,0,2,4
44146,5,3,154798,154798,154801,0,3,3
44147,3,2,154801,154801,154803,0,2,0
44148,2,1,154803,154803,154804,0,1,0
44149,2,2,154805,154805,154807,0,2,1
44150,4,2,154809,154809,154811,0,2,2
44151,6,2,154815,154815,154817,0,2,4
44152,6,2,154821,154821,154823,0,2,4
44153,4,1,154825,154825,154826,0,1,2
44154,5,2,154830,154830,154832,0,2,4
44155,2,3,154832,154832,154835,0,3,0
44156,2,2,154834,154835,154837,1,3,0
44157,3,1,154837,154837,154838,0,1,0
44158,5,1,154842,154842,154843,0,1,4
44159,4,3,154846,154846,154849,0,3,3
44160,4,3,154850,154850,154853,0,3,1
44161,6,1,154856,154856,154857,0,1,3
44162,4,2,154860,154860,154862,0,2,3
44163,6,1,154866,154866,154867,0,1,4
44164,2,1,154868,154868,154869,0,1,1
44165,5,2,154873,154873,154875,0,2,4
44166,1,1,154874,154875,154876,1,2,0
44167,4,1,154878,154878,154879,0,1,2
44168,2,3,154880,154880,154883,0,3,1
44169,5,2,154885,154885,154887,0,2,2
44170,3,1,154888,154888,154889,0,1,1
44171,1,2,154889,154889,154891,0,2,0
44172,1,3,154890,154891,154894,1,4,0
44173,2,3,154892,154894,154897,2,5,0
44174,4,2,154896,154897,154899,1,3,0
44175,1,2,154897,154899,154901,2,4,0
44176,1,3,154898,154901,154904,3,6,0
44177,3,2,154901,154904,154906,3,5,0
44178,6,3,154907,154907,154910,0,3,1
44179,1,2,154908,154910,154912,2,4,0
44180,3,2,154911,154912,154914,1,3,0
44181,6,3,154917,154917,154920,0,3,3
44182,5,2,154922,154922,154924,0,2,2
44183,1,3,154923,154924,154927,1,4,0
44184,1,3,154924,154927,154930,3,6,0
44185,6,1,154930,154930,154931,0,1,0
44186,2,3,154932,154932,154935,0,3,1
44187,2,1,154934,154935,154936,1,2,0
44188,1,2,154935,154936,154938,1,3,0
44189,3,3,154938,154938,154941,0,3,0
44190,1,1,154939,154941,154942,2,3,0
44191,6,3,154945,154945,154948,0,3,3
44192,1,3,154946,154948,154951,2,5,0
44193,2,3,154948,154951,154954,3,6,0
44194,1,1,154949,154954,154955,5,6,0
44195,6,3,154955,154955,154958,0,3,0
44196,1,1,154956,154958,154959,2,3,0
44197,3,1,154959,154959,154960,0,1,0
44198,3,2,154962,154962,154964,0,2,2
44199,6,2,154968,154968,154970,0,2,4
44200,4,2,154972,154972,154974,0,2,2
44201,5,3,154977,154977,154980,0,3,3
44202,5,1,154982,154982,154983,0,1,2
44203,6,2,154988,154988,154990,0,2,5
44204,4,2,154992,154992,154994,0,2,2
44205,1,2,154993,154994,154996,1,3,0
44206,1,2,154994,154996,154998,2,4,0
44207,6,1,155000,155000,155001,0,1,2
44208,1,1,155001,155001,155002,0,1,0
44209,5,3,155006,155006,155009,0,3,4
44210,4,2,155010,155010,155012,0,2,1
44211,3,1,155013,155013,155014,0,1,1
44212,4,3,155017,155017,155020,0,3,3
44213,1,2,155018,155020,155022,2,4,0
44214,6,2,155024,155024,155026,0,2,2
44215,3,3,155027,155027,155030,0,3,1
44216,1,1,155028,155030,155031,2,3,0
44217,3,1,155031,155031,155032,0,1,0
44218,6,2,155037,155037,155039,0,2,5
44219,6,2,155043,155043,155045,0,2,4
44220,3,1,155046,155046,155047,0,1,1
44221,5,1,155051,155051,155052,0,1,4
44222,4,3,155055,155055,155058,0,3,3
44223,6,3,155061,155061,155064,0,3,3
44224,5,2,155066,155066,155068,0,2,2
44225,6,2,155072,155072,155074,0,2,4
44226,3,1,155075,155075,155076,0,1,1
44227,6,1,155081,155081,155082,0,1,5
44228,4,3,155085,155085,155088,0,3,3
44229,6,2,155091,155091,155093,0,2,3
44230,4,3,155095,155095,155098,0,3,2
44231,6,2,155101,155101,155103,0,2,3
44232,4,1,155105,155105,155106,0,1,2
44233,1,3,155106,155106,155109,0,3,0
44234,3,1,155109,155109,155110,0,1,0
44235,1,2,155110,155110,155112,0,2,0
44236,2,3,155112,155112,155115,0,3,0
44237,4,1,155116,155116,155117,0,1,1
44238,1,2,155117,155117,155119,0,2,0
44239,4,1,155121,155121,155122,0,1,2
44240,5,2,155126,155126,155128,0,2,4
44241,1,3,155127,155128,155131,1,4,0
44242,5,3,155132,155132,155135,0,3,1
44243,1,3,155133,155135,155138,2,5,0
44244,5,3,155138,155138,155141,0,3,0
44245,2,1,155140,155141,155142,1,2,0
44246,2,2,155142,155142,155144,0,2,0
44247,3,1,155145,155145,155146,0,1,1
44248,6,1,155151,155151,155152,0,1,5
44249,5,3,155156,155156,155159,0,3,4
44250,6,2,155162,155162,155164,0,2,3
44251,2,1,155164,155164,155165,0,1,0
44252,1,3,155165,155165,155168,0,3,0
44253,6,3,155171,155171,155174,0,3,3
44254,6,2,155177,155177,155179,0,2,3
44255,3,2,155180,155180,155182,0,2,1
44256,3,3,155183,155183,155186,0,3,1
44257,5,1,155188,155188,155189,0,1,2
44258,3,2,155191,155191,155193,0,2,2
44259,5,1,155196,155196,155197,0,1,3
44260,6,1,155202,155202,155203,0,1,5
44261,4,2,155206,155206,155208,0,2,3
44262,1,2,155207,155208,155210,1,3,0
44263,5,1,155212,155212,155213,0,1,2
44264,2,2,155214,155214,155216,0,2,1
44265,1,3,155215,155216,155219,1,4,0
44266,3,2,155218,155219,155221,1,3,0
44267,6,3,155224,155224,155227,0,3,3
44268,6,1,155230,155230,155231,0,1,3
44269,1,2,155231,155231,155233,0,2,0
44270,2,3,155233,155233,155236,0,3,0
44271,2,1,155235,155236,155237,1,2,0
44272,5,3,155240,155240,155243,0,3,3
44273,5,1,155245,155245,155246,0,1,2
44274,6,2,155251,155251,155253,0,2,5
44275,1,1,155252,155253,155254,1,2,0
44276,3,3,155255,155255,155258,0,3,1
44277,6,1,155261,155261,155262,0,1,3
44278,4,2,155265,155265,155267,0,2,3
44279,6,2,155271,155271,155273,0,2,4
44280,2,2,155273,155273,155275,0,2,0
44281,1,2,155274,155275,155277,1,3,0
44282,2,2,155276,155277,155279,1,3,0
44283,5,2,155281,155281,155283,0,2,2
44284,3,3,155284,155284,155287,0,3,1
44285,6,1,155290,155290,155291,0,1,3
44286,5,1,155295,155295,155296,0,1,4
44287,2,2,155297,155297,155299,0,2,1
44288,6,3,155303,155303,155306,0,3,4
44289,2,2,155305,155306,155308,1,3,0
44290,3,2,155308,155308,155310,0,2,0
44291,3,2,155311,155311,155313,0,2,1
44292,2,2,155313,155313,155315,0,2,0
44293,1,3,155314,155315,155318,1,4,0
44294,3,1,155317,155318,155319,1,2,0
44295,5,1,155322,155322,155323,0,1,3
44296,6,2,155328,155328,155330,0,2,5
44297,2,2,155330,155330,155332,0,2,0
44298,6,2,155336,155336,155338,0,2,4
44299,1,1,155337,155338,155339,1,2,0
44300,4,3,155341,155341,155344,0,3,2
44301,1,3,155342,155344,155347,2,5,0
44302,3,3,155345,155347,155350,2,5,0
44303,5,1,155350,155350,155351,0,1,0
44304,2,1,155352,155352,155353,0,1,1
44305,1,3,155353,155353,155356,0,3,0
44306,1,2,155354,155356,155358,2,4,0
44307,5,3,155359,155359,155362,0,3,1
44308,5,3,155364,155364,155367,0,3,2
44309,5,3,155369,155369,155372,0,3,2
44310,4,3,155373,155373,155376,0,3,1
44311,5,2,155378,155378,155380,0,2,2
44312,5,3,155383,155383,155386,0,3,3
44313,2,2,155385,155386,155388,1,3,0
44314,1,3,155386,155388,155391,2,5,0
44315,1,2,155387,155391,155393,4,6,0
44316,4,3,155391,155393,155396,2,5,0
44317,6,2,155397,155397,155399,0,2,1
44318,2,1,155399,155399,155400,0,1,0
44319,3,1,155402,155402,155403,0,1,2
44320,6,3,155408,155408,155411,0,3,5
44321,6,2,155414,155414,155416,0,2,3
44322,3,3,155417,155417,155420,0,3,1
44323,4,3,155421,155421,155424,0,3,1
44324,4,2,155425,155425,155427,0,2,1
44325,4,2,155429,155429,155431,0,2,2
44326,3,3,155432,155432,155435,0,3,1
44327,3,1,155435,155435,155436,0,1,0
44328,1,2,155436,155436,155438,0,2,0
44329,1,3,155437,155438,155441,1,4,0
44330,2,1,155439,155441,155442,2,3,0
44331,5,3,155444,155444,155447,0,3,2
44332,5,1,155449,155449,155450,0,1,2
44333,5,3,155454,155454,155457,0,3,4
44334,6,3,155460,155460,155463,0,3,3
44335,5,2,155465,155465,155467,0,2,2
44336,6,2,155471,155471,155473,0,2,4
44337,1,3,155472,155473,155476,1,4,0
44338,4,3,155476,155476,155479,0,3,0
44339,2,1,155478,155479,155480,1,2,0
44340,1,2,155479,155480,155482,1,3,0
44341,3,2,155482,155482,155484,0,2,0
44342,1,2,155483,155484,155486,1,3,0
44343,1,1,155484,155486,155487,2,3,0
44344,5,2,155489,155489,155491,0,2,2
44345,1,3,155490,155491,155494,1,4,0
44346,6,3,155496,155496,155499,0,3,2
44347,4,1,155500,155500,155501,0,1,1
44348,2,2,155502,155502,155504,0,2,1
44349,2,2,155504,155504,155506,0,2,0
44350,3,3,155507,155507,155510,0,3,1
44351,3,3,155510,155510,155513,0,3,0
44352,3,3,155513,155513,155516,0,3,0
44353,1,2,155514,155516,155518,2,4,0
44354,1,2,155515,155518,155520,3,5,0
44355,3,2,155518,155520,155522,2,4,0
44356,4,1,155522,155522,155523,0,1,0
44357,3,2,155525,155525,155527,0,2,2
44358,4,1,155529,155529,155530,0,1,2
44359,1,1,155530,155530,155531,0,1,0
44360,5,1,155535,155535,155536,0,1,4
44361,6,1,155541,155541,155542,0,1,5
44362,1,3,155542,155542,155545,0,3,0
44363,5,2,155547,155547,155549,0,2,2
44364,6,3,155553,155553,155556,0,3,4
44365,2,3,155555,155556,155559,1,4,0
44366,4,2,155559,155559,155561,0,2,0
44367,2,2,155561,155561,155563,0,2,0
44368,3,1,155564,155564,155565,0,1,1
44369,5,2,155569,155569,155571,0,2,4
44370,1,3,155570,155571,155574,1,4,0
44371,3,1,155573,155574,155575,1,2,0
44372,2,3,155575,155575,155578,0,3,0
44373,6,1,155581,155581,155582,0,1,3
44374,2,2,155583,155583,155585,0,2,1
44375,4,2,155587,155587,155589,0,2,2
44376,6,3,155593,155593,155596,0,3,4
44377,4,3,155597,155597,155600,0,3,1
44378,4,2,155601,155601,155603,0,2,1
44379,6,2,155607,155607,155609,0,2,4
44380,5,3,155612,155612,155615,0,3,3
44381,4,3,155616,155616,155619,0,3,1
44382,6,2,155622,155622,155624,0,2,3
44383,6,1,155628,155628,155629,0,1,4
44384,4,2,155632,155632,155634,0,2,3
44385,4,3,155636,155636,155639,0,3,2
44386,4,2,155640,155640,155642,0,2,1
44387,4,2,155644,155644,155646,0,2,2
44388,1,3,155645,155646,155649,1,4,0
44389,5,2,155650,155650,155652,0,2,1
44390,4,1,155654,155654,155655,0,1,2
44391,5,2,155659,155659,155661,0,2,4
44392,5,3,155664,155664,155667,0,3,3
44393,2,3,155666,155667,155670,1,4,0
44394,2,1,155668,155670,155671,2,3,0
44395,2,2,155670,155671,155673,1,3,0
44396,1,3,155671,155673,155676,2,5,0
44397,4,3,155675,155676,155679,1,4,0
44398,4,1,155679,155679,155680,0,1,0
44399,3,3,155682,155682,155685,0,3,2
44400,1,1,155683,155685,155686,2,3,0
44401,4,2,155687,155687,155689,0,2,1
44402,4,3,155691,155691,155694,0,3,2
44403,5,2,155696,155696,155698,0,2,2
44404,5,1,155701,155701,155702,0,1,3
44405,6,3,155707,155707,155710,0,3,5
44406,1,1,155708,155710,155711,2,3,0
44407,4,2,155712,155712,155714,0,2,1
44408,2,3,155714,155714,155717,0,3,0
44409,5,2,155719,155719,155721,0,2,2
44410,6,2,155725,155725,155727,0,2,4
44411,1,1,155726,155727,155728,1,2,0
44412,4,2,155730,155730,155732,0,2,2
44413,2,3,155732,155732,155735,0,3,0
44414,6,1,155738,155738,155739,0,1,3
44415,5,2,155743,155743,155745,0,2,4
44416,4,3,155747,155747,155750,0,3,2
44417,1,1,155748,155750,155751,2,3,0
44418,4,3,155752,155752,155755,0,3,1
44419,5,1,155757,155757,155758,0,1,2
44420,1,3,155758,155758,155761,0,3,0
44421,1,1,155759,155761,155762,2,3,0
44422,6,3,155765,155765,155768,0,3,3
44423,3,3,155768,155768,155771,0,3,0
44424,3,2,155771,155771,155773,0,2,0
44425,5,2,155776,155776,155778,0,2,3
44426,5,2,155781,155781,155783,0,2,3
44427,3,3,155784,155784,155787,0,3,1
44428,3,1,155787,155787,155788,0,1,0
44429,1,1,155788,155788,155789,0,1,0
44430,2,2,155790,155790,155792,0,2,1
44431,2,3,155792,155792,155795,0,3,0
44432,4,1,155796,155796,155797,0,1,1
44433,3,2,155799,155799,155801,0,2,2
44434,5,2,155804,155804,155806,0,2,3
44435,2,1,155806,155806,155807,0,1,0
44436,5,1,155811,155811,155812,0,1,4
44437,4,3,155815,155815,155818,0,3,3
44438,1,1,155816,155818,155819,2,3,0
44439,1,2,155817,155819,155821,2,4,0
44440,6,2,155823,155823,155825,0,2,2
44441,6,1,155829,155829,155830,0,1,4
44442,4,3,155833,155833,155836,0,3,3
44443,4,2,155837,155837,155839,0,2,1
44444,6,1,155843,155843,155844,0,1,4
44445,6,1,155849,155849,155850,0,1,5
44446,5,3,155854,155854,155857,0,3,4
44447,2,3,155856,155857,155860,1,4,0
44448,2,2,155858,155860,155862,2,4,0
44449,5,1,155863,155863,155864,0,1,1
44450,5,3,155868,155868,155871,0,3,4
44451,3,2,155871,155871,155873,0,2,0
44452,4,3,155875,155875,155878,0,3,2
44453,1,2,155876,155878,155880,2,4,0
44454,4,1,155880,155880,155881,0,1,0
44455,4,1,155884,155884,155885,0,1,3
44456,5,3,155889,155889,155892,0,3,4
44457,6,1,155895,155895,155896,0,1,3
44458,4,3,155899,155899,155902,0,3,3
44459,4,1,155903,155903,155904,0,1,1
44460,1,3,155904,155904,155907,0,3,0
44461,4,1,155908,155908,155909,0,1,1
44462,3,1,155911,155911,155912,0,1,2
44463,4,2,155915,155915,155917,0,2,3
44464,1,1,155916,155917,155918,1,2,0
44465,3,3,155919,155919,155922,0,3,1
44466,1,3,155920,155922,155925,2,5,0
44467,3,2,155923,155925,155927,2,4,0
44468,3,1,155926,155927,155928,1,2,0
44469,5,2,155931,155931,155933,0,2,3
44470,2,2,155933,155933,155935,0,2,0
44471,5,3,155938,155938,155941,0,3,3
44472,1,2,155939,155941,155943,2,4,0
44473,4,3,155943,155943,155946,0,3,0
44474,1,2,155944,155946,155948,2,4,0
44475,6,3,155950,155950,155953,0,3,2
44476,3,2,155953,155953,155955,0,2,0
44477,1,1,155954,155955,155956,1,2,0
44478,1,2,155955,155956,155958,1,3,0
44479,1,3,155956,155958,155961,2,5,0
44480,2,3,155958,155961,155964,3,6,0
44481,6,2,155964,155964,155966,0,2,0
44482,2,2,155966,155966,155968,0,2,0
44483,4,2,155970,155970,155972,0,2,2
44484,1,1,155971,155972,155973,1,2,0
44485,5,1,155976,155976,155977,0,1,3
44486,6,3,155982,155982,155985,0,3,5
44487,1,2,155983,155985,155987,2,4,0
44488,1,3,155984,155987,155990,3,6,0
44489,1,3,155985,155990,155993,5,8,0
44490,6,3,155991,155993,155996,2,5,0
44491,3,1,155994,155996,155997,2,3,0
44492,4,3,155998,155998,156001,0,3,1
44493,5,3,156003,156003,156006,0,3,2
44494,4,1,156007,156007,156008,0,1,1
44495,3,2,156010,156010,156012,0,2,2
44496,5,2,156015,156015,156017,0,2,3
44497,5,3,156020,156020,156023,0,3,3
44498,2,1,156022,156023,156024,1,2,0
44499,2,3,156024,156024,156027,0,3,0
44500,5,3,156029,156029,156032,0,3,2
44501,2,1,156031,156032,156033,1,2,0
44502,5,2,156036,156036,156038,0,2,3
44503,6,1,156042,156042,156043,0,1,4
44504,3,2,156045,156045,156047,0,2,2
44505,6,2,156051,156051,156053,0,2,4
44506,6,3,156057,156057,156060,0,3,4
44507,5,2,156062,156062,156064,0,2,2
44508,1,3,156063,156064,156067,1,4,0
44509,3,3,156066,156067,156070,1,4,0
44510,2,2,156068,156070,156072,2,4,0
44511,6,3,156074,156074,156077,0,3,2
44512,5,1,156079,156079,156080,0,1,2
44513,3,3,156082,156082,156085,0,3,2
44514,4,3,156086,156086,156089,0,3,1
44515,3,1,156089,156089,156090,0,1,0
44516,4,1,156093,156093,156094,0,1,3
44517,1,1,156094,156094,156095,0,1,0
44518,2,2,156096,156096,156098,0,2,1
44519,4,1,156100,156100,156101,0,1,2
44520,2,1,156102,156102,156103,0,1,1
44521,2,2,156104,156104,156106,0,2,1
44522,2,2,156106,156106,156108,0,2,0
44523,4,3,156110,156110,156113,0,3,2
44524,1,2,156111,156113,156115,2,4,0
44525,6,3,156117,156117,156120,0,3,2
44526,4,2,156121,156121,156123,0,2,1
44527,2,3,156123,156123,156126,0,3,0
44528,2,1,156125,156126,156127,1,2,0
44529,1,1,156126,156127,156128,1,2,0
44530,2,3,156128,156128,156131,0,3,0
44531,3,1,156131,156131,156132,0,1,0
44532,5,2,156136,156136,156138,0,2,4
44533,6,2,156142,156142,156144,0,2,4
44534,4,1,156146,156146,156147,0,1,2
44535,6,3,156152,156152,156155,0,3,5
44536,2,3,156154,156155,156158,1,4,0
44537,4,2,156158,156158,156160,0,2,0
44538,5,3,156163,156163,156166,0,3,3
44539,3,3,156166,156166,156169,0,3,0
44540,1,3,156167,156169,156172,2,5,0
44541,6,2,156173,156173,156175,0,2,1
44542,3,2,156176,156176,156178,0,2,1
44543,3,1,156179,156179,156180,0,1,1
44544,5,3,156184,156184,156187,0,3,4
44545,2,2,156186,156187,156189,1,3,0
44546,5,1,156191,156191,156192,0,1,2
44547,1,1,156192,156192,156193,0,1,0
44548,6,1,156198,156198,156199,0,1,5
44549,3,1,156201,156201,156202,0,1,2
44550,6,2,156207,156207,156209,0,2,5
44551,2,2,156209,156209,156211,0,2,0
44552,2,3,156211,156211,156214,0,3,0
44553,3,2,156214,156214,156216,0,2,0
44554,5,2,156219,156219,156221,0,2,3
44555,4,3,156223,156223,156226,0,3,2
44556,5,2,156228,156228,156230,0,2,2
44557,1,3,156229,156230,156233,1,4,0
44558,3,3,156232,156233,156236,1,4,0
44559,2,2,156234,156236,156238,2,4,0
44560,5,1,156239,156239,156240,0,1,1
44561,6,1,156245,156245,156246,0,1,5
44562,5,1,156250,156250,156251,0,1,4
44563,5,3,156255,156255,156258,0,3,4
44564,6,3,156261,156261,156264,0,3,3
44565,5,2,156266,156266,156268,0,2,2
44566,5,3,156271,156271,156274,0,3,3
44567,5,1,156276,156276,156277,0,1,2
44568,1,2,156277,156277,156279,0,2,0
44569,3,3,156280,156280,156283,0,3,1
44570,3,2,156283,156283,156285,0,2,0
44571,3,3,156286,156286,156289,0,3,1
44572,6,3,156292,156292,156295,0,3,3
44573,3,2,156295,156295,156297,0,2,0
44574,1,2,156296,156297,156299,1,3,0
44575,2,1,156298,156299,156300,1,2,0
44576,1,3,156299,156300,156303,1,4,0
44577,2,2,156301,156303,156305,2,4,0
44578,2,2,156303,156305,156307,2,4,0
44579,5,3,156308,156308,156311,0,3,1
44580,6,1,156314,156314,156315,0,1,3
44581,5,3,156319,156319,156322,0,3,4
44582,3,1,156322,156322,156323,0,1,0
44583,6,1,156328,156328,156329,0,1,5
44584,6,1,156334,156334,156335,0,1,5
44585,2,1,156336,156336,156337,0,1,1
44586,2,3,156338,156338,156341,0,3,1
44587,4,2,156342,156342,156344,0,2,1
44588,1,1,156343,156344,156345,1,2,0
44589,1,2,156344,156345,156347,1,3,0
44590,1,1,156345,156347,156348,2,3,0
44591,6,2,156351,156351,156353,0,2,3
44592,1,1,156352,156353,156354,1,2,0
44593,5,3,156357,156357,156360,0,3,3
44594,1,3,156358,156360,156363,2,5,0
44595,2,2,156360,156363,156365,3,5,0
44596,4,1,156364,156365,156366,1,2,0
44597,1,2,156365,156366,156368,1,3,0
44598,6,1,156371,156371,156372,0,1,3
44599,5,3,156376,156376,156379,0,3,4
44600,5,2,156381,156381,156383,0,2,2
44601,3,1,156384,156384,156385,0,1,1
44602,2,2,156386,156386,156388,0,2,1
44603,5,1,156391,156391,156392,0,1,3
44604,6,1,156397,156397,156398,0,1,5
44605,5,1,156402,156402,156403,0,1,4
44606,6,2,156408,156408,156410,0,2,5
44607,5,1,156413,156413,156414,0,1,3
44608,1,1,156414,156414,156415,0,1,0
44609,2,2,156416,156416,156418,0,2,1
44610,4,3,156420,156420,156423,0,3,2
44611,2,1,156422,156423,156424,1,2,0
44612,3,3,156425,156425,156428,0,3,1
44613,1,1,156426,156428,156429,2,3,0
44614,3,2,156429,156429,156431,0,2,0
44615,5,1,156434,156434,156435,0,1,3
44616,1,1,156435,156435,156436,0,1,0
44617,5,1,156440,156440,156441,0,1,4
44618,5,2,156445,156445,156447,0,2,4
44619,5,1,156450,156450,156451,0,1,3
44620,3,3,156453,156453,156456,0,3,2
44621,6,3,156459,156459,156462,0,3,3
44622,3,1,156462,156462,156463,0,1,0
44623,1,3,156463,156463,156466,0,3,0
44624,6,3,156469,156469,156472,0,3,3
44625,6,2,156475,156475,156477,0,2,3
44626,4,2,156479,156479,156481,0,2,2
44627,5,3,156484,156484,156487,0,3,3
44628,1,2,156485,156487,156489,2,4,0
44629,3,1,156488,156489,156490,1,2,0
44630,3,3,156491,156491,156494,0,3,1
44631,4,3,156495,156495,156498,0,3,1
44632,4,2,156499,156499,156501,0,2,1
44633,5,1,156504,156504,156505,0,1,3
44634,3,3,156507,156507,156510,0,3,2
44635,2,2,156509,156510,156512,1,3,0
44636,5,1,156514,156514,156515,0,1,2
44637,4,2,156518,156518,156520,0,2,3
44638,6,1,156524,156524,156525,0,1,4
44639,5,1,156529,156529,156530,0,1,4
44640,2,1,156531,156531,156532,0,1,1
44641,6,2,156537,156537,156539,0,2,5
44642,1,1,156538,156539,156540,1,2,0
44643,2,2,156540,156540,156542,0,2,0
44644,6,1,156546,156546,156547,0,1,4
44645,6,1,156552,156552,156553,0,1,5
44646,1,3,156553,156553,156556,0,3,0
44647,4,1,156557,156557,156558,0,1,1
44648,2,3,156559,156559,156562,0,3,1
44649,5,1,156564,156564,156565,0,1,2
44650,3,3,156567,156567,156570,0,3,2
44651,4,2,156571,156571,156573,0,2,1
44652,5,2,156576,156576,156578,0,2,3
44653,1,3,156577,156578,156581,1,4,0
44654,2,1,156579,156581,156582,2,3,0
44655,5,3,156584,156584,156587,0,3,2
44656,5,1,156589,156589,156590,0,1,2
44657,1,1,156590,156590,156591,0,1,0
44658,4,3,156594,156594,156597,0,3,3
44659,4,1,156598,156598,156599,0,1,1
44660,5,3,156603,156603,156606,0,3,4
44661,6,2,156609,156609,156611,0,2,3
44662,6,1,156615,156615,156616,0,1,4
44663,1,2,156616,156616,156618,0,2,0
44664,6,2,156622,156622,156624,0,2,4
44665,6,2,156628,156628,156630,0,2,4
44666,5,3,156633,156633,156636,0,3,3
44667,6,3,156639,156639,156642,0,3,3
44668,3,3,156642,156642,156645,0,3,0
44669,5,1,156647,156647,156648,0,1,2
44670,4,2,156651,156651,156653,0,2,3
44671,5,1,156656,156656,156657,0,1,3
44672,5,3,156661,156661,156664,0,3,4
44673,1,1,156662,156664,156665,2,3,0
44674,5,2,156667,156667,156669,0,2,2
44675,2,3,156669,156669,156672,0,3,0
44676,5,2,156674,156674,156676,0,2,2
44677,5,3,156679,156679,156682,0,3,3
44678,2,1,156681,156682,156683,1,2,0
44679,1,2,156682,156683,156685,1,3,0
44680,1,1,156683,156685,156686,2,3,0
44681,4,3,156687,156687,156690,0,3,1
44682,4,3,156691,156691,156694,0,3,1
44683,5,1,156696,156696,156697,0,1,2
44684,2,3,156698,156698,156701,0,3,1
44685,3,1,156701,156701,156702,0,1,0
44686,2,1,156703,156703,156704,0,1,1
44687,4,1,156707,156707,156708,0,1,3
44688,3,1,156710,156710,156711,0,1,2
44689,4,2,156714,156714,156716,0,2,3
44690,5,1,156719,156719,156720,0,1,3
44691,2,1,156721,156721,156722,0,1,1
44692,4,2,156725,156725,156727,0,2,3
44693,5,3,156730,156730,156733,0,3,3
44694,1,2,156731,156733,156735,2,4,0
44695,5,3,156736,156736,156739,0,3,1
44696,1,2,156737,156739,156741,2,4,0
44697,6,2,156743,156743,156745,0,2,2
44698,4,3,156747,156747,156750,0,3,2
44699,2,1,156749,156750,156751,1,2,0
44700,1,1,156750,156751,156752,1,2,0
44701,1,1,156751,156752,156753,1,2,0
44702,3,2,156754,156754,156756,0,2,1
44703,4,2,156758,156758,156760,0,2,2
44704,4,3,156762,156762,156765,0,3,2
44705,4,1,156766,156766,156767,0,1,1
44706,3,1,156769,156769,156770,0,1,2
44707,1,1,156770,156770,156771,0,1,0
44708,2,1,156772,156772,156773,0,1,1
44709,2,3,156774,156774,156777,0,3,1
44710,3,2,156777,156777,156779,0,2,0
44711,4,2,156781,156781,156783,0,2,2
44712,6,1,156787,156787,156788,0,1,4
44713,5,3,156792,156792,156795,0,3,4
44714,1,3,156793,156795,156798,2,5,0
44715,5,1,156798,156798,156799,0,1,0
44716,2,2,156800,156800,156802,0,2,1
44717,2,2,156802,156802,156804,0,2,0
44718,1,2,156803,156804,156806,1,3,0
44719,3,1,156806,156806,156807,0,1,0
44720,2,2,156808,156808,156810,0,2,1
44721,3,1,156811,156811,156812,0,1,1
44722,5,1,156816,156816,156817,0,1,4
44723,4,1,156820,156820,156821,0,1,3
44724,5,2,156825,156825,156827,0,2,4
44725,4,3,156829,156829,156832,0,3,2
44726,2,2,156831,156832,156834,1,3,0
44727,5,3,156836,156836,156839,0,3,2
44728,3,3,156839,156839,156842,0,3,0
44729,2,3,156841,156842,156845,1,4,0
44730,5,1,156846,156846,156847,0,1,1
44731,1,3,156847,156847,156850,0,3,0
44732,2,1,156849,156850,156851,1,2,0
44733,5,3,156854,156854,156857,0,3,3
44734,1,1,156855,156857,156858,2,3,0
44735,5,3,156860,156860,156863,0,3,2
44736,5,2,156865,156865,156867,0,2,2
44737,5,2,156870,156870,156872,0,2,3
44738,6,3,156876,156876,156879,0,3,4
44739,1,1,156877,156879,156880,2,3,0
44740,2,1,156879,156880,156881,1,2,0
44741,6,3,156885,156885,156888,0,3,4
44742,6,3,156891,156891,156894,0,3,3
44743,6,3,156897,156897,156900,0,3,3
44744,5,2,156902,156902,156904,0,2,2
44745,5,1,156907,156907,156908,0,1,3
44746,6,2,156913,156913,156915,0,2,5
44747,6,2,156919,156919,156921,0,2,4
44748,3,2,156922,156922,156924,0,2,1
44749,1,3,156923,156924,156927,1,4,0
44750,6,2,156929,156929,156931,0,2,2
44751,3,3,156932,156932,156935,0,3,1
44752,1,2,156933,156935,156937,2,4,0
44753,2,2,156935,156937,156939,2,4,0
44754,2,3,156937,156939,156942,2,5,0
44755,6,2,156943,156943,156945,0,2,1
44756,2,3,156945,156945,156948,0,3,0
44757,5,1,156950,156950,156951,0,1,2
44758,2,1,156952,156952,156953,0,1,1
44759,4,1,156956,156956,156957,0,1,3
44760,3,3,156959,156959,156962,0,3,2
44761,2,3,156961,156962,156965,1,4,0
44762,2,1,156963,156965,156966,2,3,0
44763,5,3,156968,156968,156971,0,3,2
44764,3,2,156971,156971,156973,0,2,0
44765,5,3,156976,156976,156979,0,3,3
44766,6,1,156982,156982,156983,0,1,3
44767,3,1,156985,156985,156986,0,1,2
44768,4,1,156989,156989,156990,0,1,3
44769,5,3,156994,156994,156997,0,3,4
44770,4,1,156998,156998,156999,0,1,1
44771,3,2,157001,157001,157003,0,2,2
44772,3,3,157004,157004,157007,0,3,1
44773,5,1,157009,157009,157010,0,1,2
44774,3,2,157012,157012,157014,0,2,2
44775,2,3,157014,157014,157017,0,3,0
44776,3,2,157017,157017,157019,0,2,0
44777,2,3,157019,157019,157022,0,3,0
44778,4,1,157023,157023,157024,0,1,1
44779,4,2,157027,157027,157029,0,2,3
44780,2,1,157029,157029,157030,0,1,0
44781,4,3,157033,157033,157036,0,3,3
44782,5,2,157038,157038,157040,0,2,2
44783,1,1,157039,157040,157041,1,2,0
44784,1,2,157040,157041,157043,1,3,0
44785,2,3,157042,157043,157046,1,4,0
44786,2,3,157044,157046,157049,2,5,0
44787,6,3,157050,157050,157053,0,3,1
44788,3,1,157053,157053,157054,0,1,0
44789,5,3,157058,157058,157061,0,3,4
44790,4,2,157062,157062,157064,0,2,1
44791,6,1,157068,157068,157069,0,1,4
44792,2,3,157070,157070,157073,0,3,1
44793,1,2,157071,157073,157075,2,4,0
44794,6,3,157077,157077,157080,0,3,2
44795,5,3,157082,157082,157085,0,3,2
44796,2,3,157084,157085,157088,1,4,0
44797,5,3,157089,157089,157092,0,3,1
44798,6,1,157095,157095,157096,0,1,3
44799,4,3,157099,157099,157102,0,3,3
44800,3,3,157102,157102,157105,0,3,0
44801,1,3,157103,157105,157108,2,5,0
44802,3,2,157106,157108,157110,2,4,0
44803,1,3,157107,157110,157113,3,6,0
44804,2,1,157109,157113,157114,4,5,0
44805,1,2,157110,157114,157116,4,6,0
44806,1,3,157111,157116,157119,5,8,0
44807,4,1,157115,157119,157120,4,5,0
44808,5,1,157120,157120,157121,0,1,0
44809,3,2,157123,157123,157125,0,2,2
44810,1,1,157124,157125,157126,1,2,0
44811,2,3,157126,157126,157129,0,3,0
44812,4,1,157130,157130,157131,0,1,1
44813,3,3,157133,157133,157136,0,3,2
44814,2,3,157135,157136,157139,1,4,0
44815,6,2,157141,157141,157143,0,2,2
44816,5,2,157146,157146,157148,0,2,3
44817,4,3,157150,157150,157153,0,3,2
44818,4,3,157154,157154,157157,0,3,1
44819,1,2,157155,157157,157159,2,4,0
44820,1,2,157156,157159,157161,3,5,0
44821,4,3,157160,157161,157164,1,4,0
44822,1,2,157161,157164,157166,3,5,0
44823,4,3,157165,157166,157169,1,4,0
44824,3,1,157168,157169,157170,1,2,0
44825,2,1,157170,157170,157171,0,1,0
44826,5,3,157175,157175,157178,0,3,4
44827,6,2,157181,157181,157183,0,2,3
44828,2,3,157183,157183,157186,0,3,0
44829,1,1,157184,157186,157187,2,3,0
44830,3,3,157187,157187,157190,0,3,0
44831,1,1,157188,157190,157191,2,3,0
44832,6,1,157194,157194,157195,0,1,3
44833,1,2,157195,157195,157197,0,2,0
44834,6,1,157201,157201,157202,0,1,4
44835,2,3,157203,157203,157206,0,3,1
44836,2,2,157205,157206,157208,1,3,0
44837,1,2,157206,157208,157210,2,4,0
44838,5,1,157211,157211,157212,0,1,1
44839,6,1,157217,157217,157218,0,1,5
44840,4,3,157221,157221,157224,0,3,3
44841,1,1,157222,157224,157225,2,3,0
44842,3,3,157225,157225,157228,0,3,0
44843,3,2,157228,157228,157230,0,2,0
44844,2,3,157230,157230,157233,0,3,0
44845,2,3,157232,157233,157236,1,4,0
44846,4,3,157236,157236,157239,0,3,0
44847,2,2,157238,157239,157241,1,3,0
44848,1,3,157239,157241,157244,2,5,0
44849,2,1,157241,157244,157245,3,4,0
44850,4,1,157245,157245,157246,0,1,0
44851,4,2,157249,157249,157251,0,2,3
44852,3,3,157252,157252,157255,0,3,1
44853,5,1,157257,157257,157258,0,1,2
44854,5,3,157262,157262,157265,0,3,4
44855,4,2,157266,157266,157268,0,2,1
44856,5,3,157271,157271,157274,0,3,3
44857,5,3,157276,157276,157279,0,3,2
44858,5,1,157281,157281,157282,0,1,2
44859,5,1,157286,157286,157287,0,1,4
44860,2,3,157288,157288,157291,0,3,1
44861,3,3,157291,157291,157294,0,3,0
44862,2,1,157293,157294,157295,1,2,0
44863,6,2,157299,157299,157301,0,2,4
44864,4,2,157303,157303,157305,0,2,2
44865,4,1,157307,157307,157308,0,1,2
44866,5,2,157312,157312,157314,0,2,4
44867,3,3,157315,157315,157318,0,3,1
44868,1,1,157316,157318,157319,2,3,0
44869,6,3,157322,157322,157325,0,3,3
44870,3,2,157325,157325,157327,0,2,0
44871,1,1,157326,157327,157328,1,2,0
44872,5,2,157331,157331,157333,0,2,3
44873,4,3,157335,157335,157338,0,3,2
44874,2,3,157337,157338,157341,1,4,0
44875,4,3,157341,157341,157344,0,3,0
44876,5,3,157346,157346,157349,0,3,2
44877,4,3,157350,157350,157353,0,3,1
44878,4,1,157354,157354,157355,0,1,1
44879,6,3,157360,157360,157363,0,3,5
44880,4,2,157364,157364,157366,0,2,1
44881,4,3,157368,157368,157371,0,3,2
44882,6,1,157374,157374,157375,0,1,3
44883,3,1,157377,157377,157378,0,1,2
44884,5,3,157382,157382,157385,0,3,4
44885,3,3,157385,157385,157388,0,3,0
44886,2,2,157387,157388,157390,1,3,0
44887,3,3,157390,157390,157393,0,3,0
44888,4,1,157394,157394,157395,0,1,1
44889,1,3,157395,157395,157398,0,3,0
44890,6,1,157401,157401,157402,0,1,3
44891,6,2,157407,157407,157409,0,2,5
44892,6,2,157413,157413,157415,0,2,4
44893,4,3,157417,157417,157420,0,3,2
44894,6,1,157423,157423,157424,0,1,3
44895,4,3,157427,157427,157430,0,3,3
44896,3,3,157430,157430,157433,0,3,0
44897,3,2,157433,157433,157435,0,2,0
44898,2,1,157435,157435,157436,0,1,0
44899,5,2,157440,157440,157442,0,2,4
44900,4,3,157444,157444,157447,0,3,2
44901,5,2,157449,157449,157451,0,2,2
44902,4,2,157453,157453,157455,0,2,2
44903,2,1,157455,157455,157456,0,1,0
44904,4,1,157459,157459,157460,0,1,3
44905,3,2,157462,157462,157464,0,2,2
44906,4,3,157466,157466,157469,0,3,2
44907,5,2,157471,157471,157473,0,2,2
44908,1,3,157472,157473,157476,1,4,0
44909,1,3,157473,157476,157479,3,6,0
44910,4,2,157477,157479,157481,2,4,0
44911,2,3,157479,157481,157484,2,5,0
44912,6,2,157485,157485,157487,0,2,1
44913,6,1,157491,157491,157492,0,1,4
44914,5,1,157496,157496,157497,0,1,4
44915,1,2,157497,157497,157499,0,2,0
44916,6,3,157503,157503,157506,0,3,4
44917,6,3,157509,157509,157512,0,3,3
44918,1,3,157510,157512,157515,2,5,0
44919,2,1,157512,157515,157516,3,4,0
44920,6,1,157518,157518,157519,0,1,2
44921,5,2,157523,157523,157525,0,2,4
44922,3,1,157526,157526,157527,0,1,1
44923,5,3,157531,157531,157534,0,3,4
44924,4,3,157535,157535,157538,0,3,1
44925,5,1,157540,157540,157541,0,1,2
44926,4,1,157544,157544,157545,0,1,3
44927,6,1,157550,157550,157551,0,1,5
44928,4,2,157554,157554,157556,0,2,3
44929,4,2,157558,157558,157560,0,2,2
44930,2,1,157560,157560,157561,0,1,0
44931,6,1,157566,157566,157567,0,1,5
44932,1,1,157567,157567,157568,0,1,0
44933,2,1,157569,157569,157570,0,1,1
44934,6,2,157575,157575,157577,0,2,5
44935,2,1,157577,157577,157578,0,1,0
44936,3,2,157580,157580,157582,0,2,2
44937,6,2,157586,157586,157588,0,2,4
44938,3,3,157589,157589,157592,0,3,1
44939,2,1,157591,157592,157593,1,2,0
44940,2,3,157593,157593,157596,0,3,0
44941,1,2,157594,157596,157598,2,4,0
44942,2,3,157596,157598,157601,2,5,0
44943,4,1,157600,157601,157602,1,2,0
44944,4,3,157604,157604,157607,0,3,2
44945,2,2,157606,157607,157609,1,3,0
44946,1,1,157607,157609,157610,2,3,0
44947,6,2,157613,157613,157615,0,2,3
44948,2,3,157615,157615,157618,0,3,0
44949,6,3,157621,157621,157624,0,3,3
44950,3,1,157624,157624,157625,0,1,0
44951,2,1,157626,157626,157627,0,1,1
44952,1,2,157627,157627,157629,0,2,0
44953,5,2,157632,157632,157634,0,2,3
44954,5,3,157637,157637,157640,0,3,3
44955,4,1,157641,157641,157642,0,1,1
44956,2,2,157643,157643,157645,0,2,1
44957,2,3,157645,157645,157648,0,3,0
44958,2,2,157647,157648,157650,1,3,0
44959,5,3,157652,157652,157655,0,3,2
44960,1,2,157653,157655,157657,2,4,0
44961,1,1,157654,157657,157658,3,4,0
44962,6,1,157660,157660,157661,0,1,2
44963,3,1,157663,157663,157664,0,1,2
44964,3,1,157666,157666,157667,0,1,2
44965,3,1,157669,157669,157670,0,1,2
44966,6,2,157675,157675,157677,0,2,5
44967,1,3,157676,157677,157680,1,4,0
44968,1,3,157677,157680,157683,3,6,0
44969,6,2,157683,157683,157685,0,2,0
44970,2,3,157685,157685,157688,0,3,0
44971,5,1,157690,157690,157691,0,1,2
44972,4,3,157694,157694,157697,0,3,3
44973,1,1,157695,157697,157698,2,3,0
44974,3,2,157698,157698,157700,0,2,0
44975,4,2,157702,157702,157704,0,2,2
44976,6,3,157708,157708,157711,0,3,4
44977,1,1,157709,157711,157712,2,3,0
44978,5,2,157714,157714,157716,0,2,2
44979,2,3,157716,157716,157719,0,3,0
44980,5,2,157721,157721,157723,0,2,2
44981,5,2,157726,157726,157728,0,2,3
44982,4,1,157730,157730,157731,0,1,2
44983,3,3,157733,157733,157736,0,3,2
44984,2,1,157735,157736,157737,1,2,0
44985,6,3,157741,157741,157744,0,3,4
44986,2,3,157743,157744,157747,1,4,0
44987,4,2,157747,157747,157749,0,2,0
44988,5,3,157752,157752,157755,0,3,3
44989,6,1,157758,157758,157759,0,1,3
44990,4,3,157762,157762,157765,0,3,3
44991,6,1,157768,157768,157769,0,1,3
44992,2,3,157770,157770,157773,0,3,1
44993,6,3,157776,157776,157779,0,3,3
44994,3,3,157779,157779,157782,0,3,0
44995,2,2,157781,157782,157784,1,3,0
44996,2,1,157783,157784,157785,1,2,0
44997,5,3,157788,157788,157791,0,3,3
44998,2,1,157790,157791,157792,1,2,0
44999,1,2,157791,157792,157794,1,3,0
45000,2,3,157793,157794,157797,1,4,0
45001,3,1,157796,157797,157798,1,2,0
45002,4,1,157800,157800,157801,0,1,2
45003,1,1,157801,157801,157802,0,1,0
45004,6,2,157807,157807,157809,0,2,5
45005,1,3,157808,157809,157812,1,4,0
45006,3,1,157811,157812,157813,1,2,0
45007,4,1,157815,157815,157816,0,1,2
45008,2,2,157817,157817,157819,0,2,1
45009,2,2,157819,157819,157821,0,2,0
45010,2,1,157821,157821,157822,0,1,0
45011,1,2,157822,157822,157824,0,2,0
45012,2,1,157824,157824,157825,0,1,0
45013,3,3,157827,157827,157830,0,3,2
45014,3,1,157830,157830,157831,0,1,0
45015,2,3,157832,157832,157835,0,3,1
45016,4,2,157836,157836,157838,0,2,1
45017,5,1,157841,157841,157842,0,1,3
45018,2,2,157843,157843,157845,0,2,1
45019,4,2,157847,157847,157849,0,2,2
45020,1,3,157848,157849,157852,1,4,0
45021,3,3,157851,157852,157855,1,4,0
45022,2,2,157853,157855,157857,2,4,0
45023,1,1,157854,157857,157858,3,4,0
45024,4,3,157858,157858,157861,0,3,0
45025,2,2,157860,157861,157863,1,3,0
45026,6,2,157866,157866,157868,0,2,3
45027,2,2,157868,157868,157870,0,2,0
45028,5,2,157873,157873,157875,0,2,3
45029,6,1,157879,157879,157880,0,1,4
45030,4,2,157883,157883,157885,0,2,3
45031,4,1,157887,157887,157888,0,1,2
45032,1,3,157888,157888,157891,0,3,0
45033,2,1,157890,157891,157892,1,2,0
45034,6,1,157896,157896,157897,0,1,4
45035,3,1,157899,157899,157900,0,1,2
45036,5,3,157904,157904,157907,0,3,4
45037,5,2,157909,157909,157911,0,2,2
45038,2,1,157911,157911,157912,0,1,0
45039,5,2,157916,157916,157918,0,2,4
45040,3,2,157919,157919,157921,0,2,1
45041,6,3,157925,157925,157928,0,3,4
45042,1,3,157926,157928,157931,2,5,0
45043,2,1,157928,157931,157932,3,4,0
45044,1,1,157929,157932,157933,3,4,0
45045,3,2,157932,157933,157935,1,3,0
45046,4,3,157936,157936,157939,0,3,1
45047,6,1,157942,157942,157943,0,1,3
45048,1,1,157943,157943,157944,0,1,0
45049,3,2,157946,157946,157948,0,2,2
45050,3,2,157949,157949,157951,0,2,1
45051,5,1,157954,157954,157955,0,1,3
45052,5,3,157959,157959,157962,0,3,4
45053,3,3,157962,157962,157965,0,3,0
45054,3,2,157965,157965,157967,0,2,0
45055,5,2,157970,157970,157972,0,2,3
45056,2,2,157972,157972,157974,0,2,0
45057,6,2,157978,157978,157980,0,2,4
45058,1,1,157979,157980,157981,1,2,0
45059,5,1,157984,157984,157985,0,1,3
45060,5,3,157989,157989,157992,0,3,4
45061,4,1,157993,157993,157994,0,1,1
45062,5,1,157998,157998,157999,0,1,4
45063,4,3,158002,158002,158005,0,3,3
45064,3,2,158005,158005,158007,0,2,0
45065,3,3,158008,158008,158011,0,3,1
45066,5,1,158013,158013,158014,0,1,2
45067,6,3,158019,158019,158022,0,3,5
45068,6,1,158025,158025,158026,0,1,3
45069,2,3,158027,158027,158030,0,3,1
45070,6,2,158033,158033,158035,0,2,3
45071,3,2,158036,158036,158038,0,2,1
45072,4,1,158040,158040,158041,0,1,2
45073,2,1,158042,158042,158043,0,1,1
45074,4,2,158046,158046,158048,0,2,3
45075,1,1,158047,158048,158049,1,2,0
45076,1,2,158048,158049,158051,1,3,0
45077,1,3,158049,158051,158054,2,5,0
45078,3,3,158052,158054,158057,2,5,0
45079,5,3,158057,158057,158060,0,3,0
45080,5,1,158062,158062,158063,0,1,2
45081,1,3,158063,158063,158066,0,3,0
45082,2,1,158065,158066,158067,1,2,0
45083,5,2,158070,158070,158072,0,2,3
45084,6,1,158076,158076,158077,0,1,4
45085,2,1,158078,158078,158079,0,1,1
45086,2,2,158080,158080,158082,0,2,1
45087,6,2,158086,158086,158088,0,2,4
45088,3,1,158089,158089,158090,0,1,1
45089,1,2,158090,158090,158092,0,2,0
45090,5,1,158095,158095,158096,0,1,3
45091,4,3,158099,158099,158102,0,3,3
45092,2,2,158101,158102,158104,1,3,0
45093,1,3,158102,158104,158107,2,5,0
45094,5,2,158107,158107,158109,0,2,0
45095,6,1,158113,158113,158114,0,1,4
45096,2,2,158115,158115,158117,0,2,1
45097,6,1,158121,158121,158122,0,1,4
45098,2,1,158123,158123,158124,0,1,1
45099,5,2,158128,158128,158130,0,2,4
45100,2,2,158130,158130,158132,0,2,0
45101,4,3,158134,158134,158137,0,3,2
45102,6,1,158140,158140,158141,0,1,3
45103,6,2,158146,158146,158148,0,2,5
45104,6,2,158152,158152,158154,0,2,4
45105,6,1,158158,158158,158159,0,1,4
45106,1,2,158159,158159,158161,0,2,0
45107,1,2,158160,158161,158163,1,3,0
45108,5,1,158165,158165,158166,0,1,2
45109,5,1,158170,158170,158171,0,1,4
45110,1,1,158171,158171,158172,0,1,0
45111,1,1,158172,158172,158173,0,1,0
45112,1,2,158173,158173,158175,0,2,0
45113,1,3,158174,158175,158178,1,4,0
45114,4,2,158178,158178,158180,0,2,0
45115,3,3,158181,158181,158184,0,3,1
45116,1,3,158182,158184,158187,2,5,0
45117,2,2,158184,158187,158189,3,5,0
45118,5,1,158189,158189,158190,0,1,0
45119,3,3,158192,158192,158195,0,3,2
45120,2,2,158194,158195,158197,1,3,0
45121,6,2,158200,158200,158202,0,2,3
45122,1,3,158201,158202,158205,1,4,0
45123,4,1,158205,158205,158206,0,1,0
45124,3,3,158208,158208,158211,0,3,2
45125,3,3,158211,158211,158214,0,3,0
45126,3,1,158214,158214,158215,0,1,0
45127,3,3,158217,158217,158220,0,3,2
45128,3,1,158220,158220,158221,0,1,0
45129,1,3,158221,158221,158224,0,3,0
45130,5,1,158226,158226,158227,0,1,2
45131,2,1,158228,158228,158229,0,1,1
45132,1,2,158229,158229,158231,0,2,0
45133,4,2,158233,158233,158235,0,2,2
45134,3,2,158236,158236,158238,0,2,1
45135,3,3,158239,158239,158242,0,3,1
45136,5,2,158244,158244,158246,0,2,2
45137,3,3,158247,158247,158250,0,3,1
45138,4,3,158251,158251,158254,0,3,1
45139,1,1,158252,158254,158255,2,3,0
45140,5,1,158257,158257,158258,0,1,2
45141,4,3,158261,158261,158264,0,3,3
45142,4,2,158265,158265,158267,0,2,1
45143,2,2,158267,158267,158269,0,2,0
45144,2,1,158269,158269,158270,0,1,0
45145,5,2,158274,158274,158276,0,2,4
45146,2,1,158276,158276,158277,0,1,0
45147,6,3,158282,158282,158285,0,3,5
45148,6,3,158288,158288,158291,0,3,3
45149,2,1,158290,158291,158292,1,2,0
45150,6,3,158296,158296,158299,0,3,4
45151,2,3,158298,158299,158302,1,4,0
45152,2,2,158300,158302,158304,2,4,0
45153,2,3,158302,158304,158307,2,5,0
45154,4,3,158306,158307,158310,1,4,0
45155,1,1,158307,158310,158311,3,4,0
45156,2,3,158309,158311,158314,2,5,0
45157,2,2,158311,158314,158316,3,5,0
45158,1,1,158312,158316,158317,4,5,0
45159,5,2,158317,158317,158319,0,2,0
45160,1,1,158318,158319,158320,1,2,0
45161,6,2,158324,158324,158326,0,2,4
45162,5,2,158329,158329,158331,0,2,3
45163,2,2,158331,158331,158333,0,2,0
45164,5,1,158336,158336,158337,0,1,3
45165,5,3,158341,158341,158344,0,3,4
45166,3,2,158344,158344,158346,0,2,0
45167,1,1,158345,158346,158347,1,2,0
45168,1,3,158346,158347,158350,1,4,0
45169,4,2,158350,158350,158352,0,2,0
45170,1,1,158351,158352,158353,1,2,0
45171,5,1,158356,158356,158357,0,1,3
45172,5,2,158361,158361,158363,0,2,4
45173,3,2,158364,158364,158366,0,2,1
45174,3,3,158367,158367,158370,0,3,1
45175,5,3,158372,158372,158375,0,3,2
45176,3,1,158375,158375,158376,0,1,0
45177,3,2,158378,158378,158380,0,2,2
45178,4,2,158382,158382,158384,0,2,2
45179,6,2,158388,158388,158390,0,2,4
45180,3,2,158391,158391,158393,0,2,1
45181,4,1,158395,158395,158396,0,1,2
45182,4,2,158399,158399,158401,0,2,3
45183,6,1,158405,158405,158406,0,1,4
45184,5,2,158410,158410,158412,0,2,4
45185,3,2,158413,158413,158415,0,2,1
45186,1,3,158414,158415,158418,1,4,0
45187,3,2,158417,158418,158420,1,3,0
45188,6,2,158423,158423,158425,0,2,3
45189,6,2,158429,158429,158431,0,2,4
45190,3,2,158432,158432,158434,0,2,1
45191,4,1,158436,158436,158437,0,1,2
45192,1,2,158437,158437,158439,0,2,0
45193,2,2,158439,158439,158441,0,2,0
45194,4,1,158443,158443,158444,0,1,2
45195,5,2,158448,158448,158450,0,2,4
45196,3,1,158451,158451,158452,0,1,1
45197,4,2,158455,158455,158457,0,2,3
45198,5,3,158460,158460,158463,0,3,3
45199,2,1,158462,158463,158464,1,2,0
45200,4,3,158466,158466,158469,0,3,2
45201,2,1,158468,158469,158470,1,2,0
45202,6,1,158474,158474,158475,0,1,4
45203,4,1,158478,158478,158479,0,1,3
45204,1,3,158479,158479,158482,0,3,0
45205,6,3,158485,158485,158488,0,3,3
45206,4,3,158489,158489,158492,0,3,1
45207,4,3,158493,158493,158496,0,3,1
45208,5,2,158498,158498,158500,0,2,2
45209,3,1,158501,158501,158502,0,1,1
45210,4,3,158505,158505,158508,0,3,3
45211,5,2,158510,158510,158512,0,2,2
45212,5,1,158515,158515,158516,0,1,3
45213,6,1,158521,158521,158522,0,1,5
45214,5,1,158526,158526,158527,0,1,4
45215,1,1,158527,158527,158528,0,1,0
45216,3,2,158530,158530,158532,0,2,2
45217,2,1,158532,158532,158533,0,1,0
45218,2,1,158534,158534,158535,0,1,1
45219,1,2,158535,158535,158537,0,2,0
45220,6,2,158541,158541,158543,0,2,4
45221,5,2,158546,158546,158548,0,2,3
45222,1,3,158547,158548,158551,1,4,0
45223,2,1,158549,158551,158552,2,3,0
45224,2,1,158551,158552,158553,1,2,0
45225,1,2,158552,158553,158555,1,3,0
45226,2,3,158554,158555,158558,1,4,0
45227,3,3,158557,158558,158561,1,4,0
45228,5,2,158562,158562,158564,0,2,1
45229,5,2,158567,158567,158569,0,2,3
45230,5,3,158572,158572,158575,0,3,3
45231,1,1,158573,158575,158576,2,3,0
45232,1,1,158574,158576,158577,2,3,0
45233,5,2,158579,158579,158581,0,2,2
45234,1,3,158580,158581,158584,1,4,0
45235,5,3,158585,158585,158588,0,3,1
45236,6,1,158591,158591,158592,0,1,3
45237,3,2,158594,158594,158596,0,2,2
45238,6,2,158600,158600,158602,0,2,4
45239,4,3,158604,158604,158607,0,3,2
45240,4,2,158608,158608,158610,0,2,1
45241,6,1,158614,158614,158615,0,1,4
45242,4,3,158618,158618,158621,0,3,3
45243,5,2,158623,158623,158625,0,2,2
45244,1,3,158624,158625,158628,1,4,0
45245,5,3,158629,158629,158632,0,3,1
45246,4,1,158633,158633,158634,0,1,1
45247,6,3,158639,158639,158642,0,3,5
45248,5,2,158644,158644,158646,0,2,2
45249,5,2,158649,158649,158651,0,2,3
45250,3,1,158652,158652,158653,0,1,1
45251,2,3,158654,158654,158657,0,3,1
45252,5,1,158659,158659,158660,0,1,2
45253,3,1,158662,158662,158663,0,1,2
45254,1,3,158663,158663,158666,0,3,0
45255,1,2,158664,158666,158668,2,4,0
45256,2,3,158666,158668,158671,2,5,0
45257,1,3,158667,158671,158674,4,7,0
45258,5,1,158672,158674,158675,2,3,0
45259,1,3,158673,158675,158678,2,5,0
45260,4,3,158677,158678,158681,1,4,0
45261,3,2,158680,158681,158683,1,3,0
45262,3,3,158683,158683,158686,0,3,0
45263,2,2,158685,158686,158688,1,3,0
45264,6,2,158691,158691,158693,0,2,3
45265,1,3,158692,158693,158696,1,4,0
45266,2,2,158694,158696,158698,2,4,0
45267,2,1,158696,158698,158699,2,3,0
45268,5,1,158701,158701,158702,0,1,2
45269,5,3,158706,158706,158709,0,3,4
45270,2,1,158708,158709,158710,1,2,0
45271,1,1,158709,158710,158711,1,2,0
45272,3,1,158712,158712,158713,0,1,1
45273,2,1,158714,158714,158715,0,1,1
45274,4,3,158718,158718,158721,0,3,3
45275,2,1,158720,158721,158722,1,2,0
45276,3,1,158723,158723,158724,0,1,1
45277,2,3,158725,158725,158728,0,3,1
45278,1,3,158726,158728,158731,2,5,0
45279,1,1,158727,158731,158732,4,5,0
45280,5,2,158732,158732,158734,0,2,0
45281,2,2,158734,158734,158736,0,2,0
45282,3,2,158737,158737,158739,0,2,1
45283,2,2,158739,158739,158741,0,2,0
45284,4,2,158743,158743,158745,0,2,2
45285,2,2,158745,158745,158747,0,2,0
45286,5,3,158750,158750,158753,0,3,3
45287,4,1,158754,158754,158755,0,1,1
45288,5,3,158759,158759,158762,0,3,4
45289,5,3,158764,158764,158767,0,3,2
45290,2,3,158766,158767,158770,1,4,0
45291,4,3,158770,158770,158773,0,3,0
45292,4,1,158774,158774,158775,0,1,1
45293,3,1,158777,158777,158778,0,1,2
45294,1,3,158778,158778,158781,0,3,0
45295,1,3,158779,158781,158784,2,5,0
45296,5,2,158784,158784,158786,0,2,0
45297,2,3,158786,158786,158789,0,3,0
45298,5,1,158791,158791,158792,0,1,2
45299,3,2,158794,158794,158796,0,2,2
45300,6,1,158800,158800,158801,0,1,4
45301,4,3,158804,158804,158807,0,3,3
45302,2,1,158806,158807,158808,1,2,0
45303,3,2,158809,158809,158811,0,2,1
45304,4,1,158813,158813,158814,0,1,2
45305,1,3,158814,158814,158817,0,3,0
45306,4,2,158818,158818,158820,0,2,1
45307,1,2,158819,158820,158822,1,3,0
45308,5,3,158824,158824,158827,0,3,2
45309,2,1,158826,158827,158828,1,2,0
45310,5,3,158831,158831,158834,0,3,3
45311,3,2,158834,158834,158836,0,2,0
45312,2,1,158836,158836,158837,0,1,0
45313,5,2,158841,158841,158843,0,2,4
45314,2,2,158843,158843,158845,0,2,0
45315,6,3,158849,158849,158852,0,3,4
45316,4,2,158853,158853,158855,0,2,1
45317,2,1,158855,158855,158856,0,1,0
45318,4,1,158859,158859,158860,0,1,3
45319,5,1,158864,158864,158865,0,1,4
45320,3,2,158867,158867,158869,0,2,2
45321,4,1,158871,158871,158872,0,1,2
45322,4,2,158875,158875,158877,0,2,3
45323,3,2,158878,158878,158880,0,2,1
45324,4,2,158882,158882,158884,0,2,2
45325,6,3,158888,158888,158891,0,3,4
45326,5,1,158893,158893,158894,0,1,2
45327,5,2,158898,158898,158900,0,2,4
45328,4,3,158902,158902,158905,0,3,2
45329,6,2,158908,158908,158910,0,2,3
45330,5,1,158913,158913,158914,0,1,3
45331,1,3,158914,158914,158917,0,3,0
45332,6,1,158920,158920,158921,0,1,3
45333,6,2,158926,158926,158928,0,2,5
45334,5,2,158931,158931,158933,0,2,3
45335,3,3,158934,158934,158937,0,3,1
45336,2,2,158936,158937,158939,1,3,0
45337,1,2,158937,158939,158941,2,4,0
45338,2,2,158939,158941,158943,2,4,0
45339,2,3,158941,158943,158946,2,5,0
45340,1,2,158942,158946,158948,4,6,0
45341,2,2,158944,158948,158950,4,6,0
45342,4,2,158948,158950,158952,2,4,0
45343,6,1,158954,158954,158955,0,1,2
45344,6,2,158960,158960,158962,0,2,5
45345,4,2,158964,158964,158966,0,2,2
45346,6,2,158970,158970,158972,0,2,4
45347,3,1,158973,158973,158974,0,1,1
45348,2,2,158975,158975,158977,0,2,1
45349,5,2,158980,158980,158982,0,2,3
45350,2,1,158982,158982,158983,0,1,0
45351,2,1,158984,158984,158985,0,1,1
45352,5,2,158989,158989,158991,0,2,4
45353,6,1,158995,158995,158996,0,1,4
45354,6,1,159001,159001,159002,0,1,5
45355,4,1,159005,159005,159006,0,1,3
45356,6,2,159011,159011,159013,0,2,5
45357,3,2,159014,159014,159016,0,2,1
45358,6,3,159020,159020,159023,0,3,4
45359,6,2,159026,159026,159028,0,2,3
45360,2,3,159028,159028,159031,0,3,0
45361,4,3,159032,159032,159035,0,3,1
45362,6,3,159038,159038,159041,0,3,3
45363,2,3,159040,159041,159044,1,4,0
45364,5,3,159045,159045,159048,0,3,1
45365,3,3,159048,159048,159051,0,3,0
45366,2,3,159050,159051,159054,1,4,0
45367,6,1,159056,159056,159057,0,1,2
45368,5,3,159061,159061,159064,0,3,4
45369,3,1,159064,159064,159065,0,1,0
45370,4,1,159068,159068,159069,0,1,3
45371,3,2,159071,159071,159073,0,2,2
45372,2,2,159073,159073,159075,0,2,0
45373,5,1,159078,159078,159079,0,1,3
45374,3,1,159081,159081,159082,0,1,2
45375,6,2,159087,159087,159089,0,2,5
45376,2,3,159089,159089,159092,0,3,0
45377,2,3,159091,159092,159095,1,4,0
45378,3,3,159094,159095,159098,1,4,0
45379,3,1,159097,159098,159099,1,2,0
45380,6,2,159103,159103,159105,0,2,4
45381,5,1,159108,159108,159109,0,1,3
45382,4,1,159112,159112,159113,0,1,3
45383,2,1,159114,159114,159115,0,1,1
45384,1,3,159115,159115,159118,0,3,0
45385,2,2,159117,159118,159120,1,3,0
45386,2,3,159119,159120,159123,1,4,0
45387,6,3,159125,159125,159128,0,3,2
45388,3,3,159128,159128,159131,0,3,0
45389,3,1,159131,159131,159132,0,1,0
45390,4,3,159135,159135,159138,0,3,3
45391,1,2,159136,159138,159140,2,4,0
45392,4,2,159140,159140,159142,0,2,0
45393,3,3,159143,159143,159146,0,3,1
45394,6,2,159149,159149,159151,0,2,3
45395,1,1,159150,159151,159152,1,2,0
45396,3,2,159153,159153,159155,0,2,1
45397,6,2,159159,159159,159161,0,2,4
45398,3,1,159162,159162,159163,0,1,1
45399,1,3,159163,159163,159166,0,3,0
45400,5,1,159168,159168,159169,0,1,2
45401,1,2,159169,159169,159171,0,2,0
45402,3,1,159172,159172,159173,0,1,1
45403,4,2,159176,159176,159178,0,2,3
45404,2,2,159178,159178,159180,0,2,0
45405,5,2,159183,159183,159185,0,2,3
45406,6,3,159189,159189,159192,0,3,4
45407,4,2,159193,159193,159195,0,2,1
45408,5,3,159198,159198,159201,0,3,3
45409,3,3,159201,159201,159204,0,3,0
45410,6,1,159207,159207,159208,0,1,3
45411,1,3,159208,159208,159211,0,3,0
45412,5,2,159213,159213,159215,0,2,2
45413,1,1,159214,159215,159216,1,2,0
45414,3,1,159217,159217,159218,0,1,1
45415,2,3,159219,159219,159222,0,3,1
45416,6,2,159225,159225,159227,0,2,3
45417,6,3,159231,159231,159234,0,3,4
45418,1,3,159232,159234,159237,2,5,0
45419,4,1,159236,159237,159238,1,2,0
45420,6,3,159242,159242,159245,0,3,4
45421,6,2,159248,159248,159250,0,2,3
45422,5,2,159253,159253,159255,0,2,3
45423,1,1,159254,159255,159256,1,2,0
45424,2,2,159256,159256,159258,0,2,0
45425,2,3,159258,159258,159261,0,3,0
45426,6,2,159264,159264,159266,0,2,3
45427,1,2,159265,159266,159268,1,3,0
45428,1,3,159266,159268,159271,2,5,0
45429,3,2,159269,159271,159273,2,4,0
45430,2,3,159271,159273,159276,2,5,0
45431,3,2,159274,159276,159278,2,4,0
45432,6,3,159280,159280,159283,0,3,2
45433,4,2,159284,159284,159286,0,2,1
45434,1,3,159285,159286,159289,1,4,0
45435,3,1,159288,159289,159290,1,2,0
45436,4,2,159292,159292,159294,0,2,2
45437,2,2,159294,159294,159296,0,2,0
45438,5,3,159299,159299,159302,0,3,3
45439,6,1,159305,159305,159306,0,1,3
45440,1,3,159306,159306,159309,0,3,0
45441,4,1,159310,159310,159311,0,1,1
45442,1,1,159311,159311,159312,0,1,0
45443,4,3,159315,159315,159318,0,3,3
45444,3,2,159318,159318,159320,0,2,0
45445,5,3,159323,159323,159326,0,3,3
45446,6,3,159329,159329,159332,0,3,3
45447,2,3,159331,159332,159335,1,4,0
45448,2,1,159333,159335,159336,2,3,0
45449,1,1,159334,159336,159337,2,3,0
45450,6,2,159340,159340,159342,0,2,3
45451,2,2,159342,159342,159344,0,2,0
45452,2,1,159344,159344,159345,0,1,0
45453,4,2,159348,159348,159350,0,2,3
45454,1,1,159349,159350,159351,1,2,0
45455,1,3,159350,159351,159354,1,4,0
45456,2,2,159352,159354,159356,2,4,0
45457,1,3,159353,159356,159359,3,6,0
45458,6,2,159359,159359,159361,0,2,0
45459,4,1,159363,159363,159364,0,1,2
45460,3,1,159366,159366,159367,0,1,2
45461,3,1,159369,159369,159370,0,1,2
45462,4,2,159373,159373,159375,0,2,3
45463,4,2,159377,159377,159379,0,2,2
45464,2,3,159379,159379,159382,0,3,0
45465,3,3,159382,159382,159385,0,3,0
45466,1,3,159383,159385,159388,2,5,0
45467,5,1,159388,159388,159389,0,1,0
45468,5,3,159393,159393,159396,0,3,4
45469,1,2,159394,159396,159398,2,4,0
45470,2,1,159396,159398,159399,2,3,0
45471,5,1,159401,159401,159402,0,1,2
45472,4,1,159405,159405,159406,0,1,3
45473,5,1,159410,159410,159411,0,1,4
45474,3,1,159413,159413,159414,0,1,2
45475,3,1,159416,159416,159417,0,1,2
45476,3,2,159419,159419,159421,0,2,2
45477,5,1,159424,159424,159425,0,1,3
45478,4,1,159428,159428,159429,0,1,3
45479,4,1,159432,159432,159433,0,1,3
45480,1,3,159433,159433,159436,0,3,0
45481,6,3,159439,159439,159442,0,3,3
45482,3,2,159442,159442,159444,0,2,0
45483,1,1,159443,159444,159445,1,2,0
45484,3,1,159446,159446,159447,0,1,1
45485,3,1,159449,159449,159450,0,1,2
45486,5,2,159454,159454,159456,0,2,4
45487,6,1,159460,159460,159461,0,1,4
45488,3,1,159463,159463,159464,0,1,2
45489,6,3,159469,159469,159472,0,3,5
45490,2,3,159471,159472,159475,1,4,0
45491,1,3,159472,159475,159478,3,6,0
45492,6,2,159478,159478,159480,0,2,0
45493,4,2,159482,159482,159484,0,2,2
45494,6,1,159488,159488,159489,0,1,4
45495,2,2,159490,159490,159492,0,2,1
45496,6,2,159496,159496,159498,0,2,4
45497,6,1,159502,159502,159503,0,1,4
45498,3,2,159505,159505,159507,0,2,2
45499,1,3,159506,159507,159510,1,4,0
45500,5,1,159511,159511,159512,0,1,1
45501,4,3,159515,159515,159518,0,3,3
45502,3,2,159518,159518,159520,0,2,0
45503,2,1,159520,159520,159521,0,1,0
45504,3,3,159523,159523,159526,0,3,2
45505,6,2,159529,159529,159531,0,2,3
45506,3,2,159532,159532,159534,0,2,1
45507,4,1,159536,159536,159537,0,1,2
45508,3,2,159539,159539,159541,0,2,2
45509,6,1,159545,159545,159546,0,1,4
45510,4,1,159549,159549,159550,0,1,3
45511,1,3,159550,159550,159553,0,3,0
45512,4,3,159554,159554,159557,0,3,1
45513,1,1,159555,159557,159558,2,3,0
45514,6,3,159561,159561,159564,0,3,3
45515,6,1,159567,159567,159568,0,1,3
45516,2,2,159569,159569,159571,0,2,1
45517,2,2,159571,159571,159573,0,2,0
45518,6,3,159577,159577,159580,0,3,4
45519,6,2,159583,159583,159585,0,2,3
45520,3,3,159586,159586,159589,0,3,1
45521,4,2,159590,159590,159592,0,2,1
45522,2,3,159592,159592,159595,0,3,0
45523,2,1,159594,159595,159596,1,2,0
45524,6,3,159600,159600,159603,0,3,4
45525,6,3,159606,159606,159609,0,3,3
45526,4,2,159610,159610,159612,0,2,1
45527,3,2,159613,159613,159615,0,2,1
45528,2,1,159615,159615,159616,0,1,0
45529,6,2,159621,159621,159623,0,2,5
45530,1,1,159622,159623,159624,1,2,0
45531,4,3,159626,159626,159629,0,3,2
45532,4,1,159630,159630,159631,0,1,1
45533,1,2,159631,159631,159633,0,2,0
45534,1,2,159632,159633,159635,1,3,0
45535,1,2,159633,159635,159637,2,4,0
45536,6,3,159639,159639,159642,0,3,2
45537,2,1,159641,159642,159643,1,2,0
45538,4,2,159645,159645,159647,0,2,2
45539,5,2,159650,159650,159652,0,2,3
45540,6,2,159656,159656,159658,0,2,4
45541,1,1,159657,159658,159659,1,2,0
45542,4,3,159661,159661,159664,0,3,2
45543,5,3,159666,159666,159669,0,3,2
45544,6,3,159672,159672,159675,0,3,3
45545,6,3,159678,159678,159681,0,3,3
45546,6,2,159684,159684,159686,0,2,3
45547,2,3,159686,159686,159689,0,3,0
45548,4,3,159690,159690,159693,0,3,1
45549,3,3,159693,159693,159696,0,3,0
45550,5,2,159698,159698,159700,0,2,2
45551,2,2,159700,159700,159702,0,2,0
45552,5,1,159705,159705,159706,0,1,3
45553,2,1,159707,159707,159708,0,1,1
45554,1,1,159708,159708,159709,0,1,0
45555,3,3,159711,159711,159714,0,3,2
45556,6,2,159717,159717,159719,0,2,3
45557,4,1,159721,159721,159722,0,1,2
45558,6,1,159727,159727,159728,0,1,5
45559,3,2,159730,159730,159732,0,2,2
45560,2,2,159732,159732,159734,0,2,0
45561,2,1,159734,159734,159735,0,1,0
45562,3,2,159737,159737,159739,0,2,2
45563,1,2,159738,159739,159741,1,3,0
45564,2,2,159740,159741,159743,1,3,0
45565,5,3,159745,159745,159748,0,3,2
45566,2,2,159747,159748,159750,1,3,0
45567,6,1,159753,159753,159754,0,1,3
45568,1,3,159754,159754,159757,0,3,0
45569,2,1,159756,159757,159758,1,2,0
45570,3,3,159759,159759,159762,0,3,1
45571,4,2,159763,159763,159765,0,2,1
45572,1,1,159764,159765,159766,1,2,0
45573,5,1,159769,159769,159770,0,1,3
45574,5,3,159774,159774,159777,0,3,4
45575,5,2,159779,159779,159781,0,2,2
45576,1,2,159780,159781,159783,1,3,0
45577,3,1,159783,159783,159784,0,1,0
45578,6,2,159789,159789,159791,0,2,5
45579,4,3,159793,159793,159796,0,3,2
45580,2,3,159795,159796,159799,1,4,0
45581,5,3,159800,159800,159803,0,3,1
45582,3,3,159803,159803,159806,0,3,0
45583,6,3,159809,159809,159812,0,3,3
45584,2,1,159811,159812,159813,1,2,0
45585,4,2,159815,159815,159817,0,2,2
45586,2,2,159817,159817,159819,0,2,0
45587,4,1,159821,159821,159822,0,1,2
45588,1,3,159822,159822,159825,0,3,0
45589,5,3,159827,159827,159830,0,3,2
45590,2,1,159829,159830,159831,1,2,0
45591,4,2,159833,159833,159835,0,2,2
45592,1,3,159834,159835,159838,1,4,0
45593,6,1,159840,159840,159841,0,1,2
45594,6,3,159846,159846,159849,0,3,5
45595,4,3,159850,159850,159853,0,3,1
45596,1,1,159851,159853,159854,2,3,0
45597,5,3,159856,159856,159859,0,3,2
45598,3,2,159859,159859,159861,0,2,0
45599,4,2,159863,159863,159865,0,2,2
45600,1,2,159864,159865,159867,1,3,0
45601,3,3,159867,159867,159870,0,3,0
45602,4,1,159871,159871,159872,0,1,1
45603,1,3,159872,159872,159875,0,3,0
45604,3,2,159875,159875,159877,0,2,0
45605,5,3,159880,159880,159883,0,3,3
45606,4,1,159884,159884,159885,0,1,1
45607,6,1,159890,159890,159891,0,1,5
45608,5,1,159895,159895,159896,0,1,4
45609,6,3,159901,159901,159904,0,3,5
45610,6,3,159907,159907,159910,0,3,3
45611,6,2,159913,159913,159915,0,2,3
45612,4,1,159917,159917,159918,0,1,2
45613,2,1,159919,159919,159920,0,1,1
45614,3,1,159922,159922,159923,0,1,2
45615,3,1,159925,159925,159926,0,1,2
45616,4,3,159929,159929,159932,0,3,3
45617,1,1,159930,159932,159933,2,3,0
45618,5,1,159935,159935,159936,0,1,2
45619,1,2,159936,159936,159938,0,2,0
45620,2,3,159938,159938,159941,0,3,0
45621,3,3,159941,159941,159944,0,3,0
45622,4,2,159945,159945,159947,0,2,1
45623,5,1,159950,159950,159951,0,1,3
45624,2,3,159952,159952,159955,0,3,1
45625,4,1,159956,159956,159957,0,1,1
45626,4,3,159960,159960,159963,0,3,3
45627,4,3,159964,159964,159967,0,3,1
45628,1,1,159965,159967,159968,2,3,0
45629,4,3,159969,159969,159972,0,3,1
45630,1,3,159970,159972,159975,2,5,0
45631,2,2,159972,159975,159977,3,5,0
45632,3,2,159975,159977,159979,2,4,0
45633,4,3,159979,159979,159982,0,3,0
45634,4,1,159983,159983,159984,0,1,1
45635,5,1,159988,159988,159989,0,1,4
45636,4,1,159992,159992,159993,0,1,3
45637,1,3,159993,159993,159996,0,3,0
45638,1,3,159994,159996,159999,2,5,0
45639,4,1,159998,159999,160000,1,2,0
45640,4,1,160002,160002,160003,0,1,2
45641,3,3,160005,160005,160008,0,3,2
45642,6,1,160011,160011,160012,0,1,3
45643,4,1,160015,160015,160016,0,1,3
45644,5,1,160020,160020,160021,0,1,4
45645,6,1,160026,160026,160027,0,1,5
45646,4,1,160030,160030,160031,0,1,3
45647,1,3,160031,160031,160034,0,3,0
45648,6,2,160037,160037,160039,0,2,3
45649,3,1,160040,160040,160041,0,1,1
45650,1,2,160041,160041,160043,0,2,0
45651,2,3,160043,160043,160046,0,3,0
45652,1,1,160044,160046,160047,2,3,0
45653,2,3,160046,160047,160050,1,4,0
45654,2,2,160048,160050,160052,2,4,0
45655,3,3,160051,160052,160055,1,4,0
45656,4,2,160055,160055,160057,0,2,0
45657,4,3,160059,160059,160062,0,3,2
45658,3,1,160062,160062,160063,0,1,0
45659,4,2,160066,160066,160068,0,2,3
45660,5,1,160071,160071,160072,0,1,3
45661,6,1,160077,160077,160078,0,1,5
45662,4,2,160081,160081,160083,0,2,3
45663,6,1,160087,160087,160088,0,1,4
45664,3,3,160090,160090,160093,0,3,2
45665,5,2,160095,160095,160097,0,2,2
45666,1,1,160096,160097,160098,1,2,0
45667,3,3,160099,160099,160102,0,3,1
45668,2,2,160101,160102,160104,1,3,0
45669,2,2,160103,160104,160106,1,3,0
45670,4,1,160107,160107,160108,0,1,1
45671,2,1,160109,160109,160110,0,1,1
45672,5,3,160114,160114,160117,0,3,4
45673,2,2,160116,160117,160119,1,3,0
45674,2,1,160118,160119,160120,1,2,0
45675,5,1,160123,160123,160124,0,1,3
45676,5,2,160128,160128,160130,0,2,4
45677,2,3,160130,160130,160133,0,3,0
45678,4,2,160134,160134,160136,0,2,1
45679,5,1,160139,160139,160140,0,1,3
45680,5,3,160144,160144,160147,0,3,4
45681,6,1,160150,160150,160151,0,1,3
45682,5,3,160155,160155,160158,0,3,4
45683,2,2,160157,160158,160160,1,3,0
45684,5,3,160162,160162,160165,0,3,2
45685,3,1,160165,160165,160166,0,1,0
45686,2,3,160167,160167,160170,0,3,1
45687,2,2,160169,160170,160172,1,3,0
45688,6,1,160175,160175,160176,0,1,3
45689,5,2,160180,160180,160182,0,2,4
45690,2,1,160182,160182,160183,0,1,0
45691,1,2,160183,160183,160185,0,2,0
45692,1,3,160184,160185,160188,1,4,0
45693,2,2,160186,160188,160190,2,4,0
45694,6,1,160192,160192,160193,0,1,2
45695,2,2,160194,160194,160196,0,2,1
45696,1,1,160195,160196,160197,1,2,0
45697,4,3,160199,160199,160202,0,3,2
45698,5,1,160204,160204,160205,0,1,2
45699,2,1,160206,160206,160207,0,1,1
45700,6,1,160212,160212,160213,0,1,5
45701,4,1,160216,160216,160217,0,1,3
45702,1,3,160217,160217,160220,0,3,0
45703,2,1,160219,160220,160221,1,2,0
45704,1,3,160220,160221,160224,1,4,0
45705,5,1,160225,160225,160226,0,1,1
45706,5,3,160230,160230,160233,0,3,4
45707,5,3,160235,160235,160238,0,3,2
45708,4,3,160239,160239,160242,0,3,1
45709,3,1,160242,160242,160243,0,1,0
45710,5,2,160247,160247,160249,0,2,4
45711,2,3,160249,160249,160252,0,3,0
45712,6,1,160255,160255,160256,0,1,3
45713,2,1,160257,160257,160258,0,1,1
45714,4,3,160261,160261,160264,0,3,3
45715,5,3,160266,160266,160269,0,3,2
45716,1,3,160267,160269,160272,2,5,0
45717,1,3,160268,160272,160275,4,7,0
45718,4,3,160272,160275,160278,3,6,0
45719,4,3,160276,160278,160281,2,5,0
45720,2,1,160278,160281,160282,3,4,0
45721,1,3,160279,160282,160285,3,6,0
45722,3,2,160282,160285,160287,3,5,0
45723,2,3,160284,160287,160290,3,6,0
45724,6,3,160290,160290,160293,0,3,0
45725,5,1,160295,160295,160296,0,1,2
45726,1,3,160296,160296,160299,0,3,0
45727,1,1,160297,160299,160300,2,3,0
45728,2,2,160299,160300,160302,1,3,0
45729,6,1,160305,160305,160306,0,1,3
45730,4,3,160309,160309,160312,0,3,3
45731,6,3,160315,160315,160318,0,3,3
45732,3,3,160318,160318,160321,0,3,0
45733,4,3,160322,160322,160325,0,3,1
45734,6,2,160328,160328,160330,0,2,3
45735,5,2,160333,160333,160335,0,2,3
45736,3,3,160336,160336,160339,0,3,1
45737,5,3,160341,160341,160344,0,3,2
45738,3,1,160344,160344,160345,0,1,0
45739,4,1,160348,160348,160349,0,1,3
45740,3,3,160351,160351,160354,0,3,2
45741,1,1,160352,160354,160355,2,3,0
45742,3,3,160355,160355,160358,0,3,0
45743,4,1,160359,160359,160360,0,1,1
45744,2,2,160361,160361,160363,0,2,1
45745,5,2,160366,160366,160368,0,2,3
45746,4,3,160370,160370,160373,0,3,2
45747,6,2,160376,160376,160378,0,2,3
45748,5,2,160381,160381,160383,0,2,3
45749,3,2,160384,160384,160386,0,2,1
45750,2,2,160386,160386,160388,0,2,0
45751,5,1,160391,160391,160392,0,1,3
45752,3,2,160394,160394,160396,0,2,2
45753,4,1,160398,160398,160399,0,1,2
45754,6,1,160404,160404,160405,0,1,5
45755,2,1,160406,160406,160407,0,1,1
45756,4,1,160410,160410,160411,0,1,3
45757,5,3,160415,160415,160418,0,3,4
45758,4,3,160419,160419,160422,0,3,1
45759,1,2,160420,160422,160424,2,4,0
45760,2,2,160422,160424,160426,2,4,0
45761,6,3,160428,160428,160431,0,3,2
45762,6,2,160434,160434,160436,0,2,3
45763,2,2,160436,160436,160438,0,2,0
45764,2,3,160438,160438,160441,0,3,0
45765,1,2,160439,160441,160443,2,4,0
45766,2,2,160441,160443,160445,2,4,0
45767,3,1,160444,160445,160446,1,2,0
45768,3,1,160447,160447,160448,0,1,1
45769,1,2,160448,160448,160450,0,2,0
45770,3,2,160451,160451,160453,0,2,1
45771,3,2,160454,160454,160456,0,2,1
45772,3,1,160457,160457,160458,0,1,1
45773,6,3,160463,160463,160466,0,3,5
45774,4,2,160467,160467,160469,0,2,1
45775,5,2,160472,160472,160474,0,2,3
45776,3,1,160475,160475,160476,0,1,1
45777,1,2,160476,160476,160478,0,2,0
45778,1,1,160477,160478,160479,1,2,0
45779,4,3,160481,160481,160484,0,3,2
45780,2,2,160483,160484,160486,1,3,0
45781,6,2,160489,160489,160491,0,2,3
45782,2,2,160491,160491,160493,0,2,0
45783,4,3,160495,160495,160498,0,3,2
45784,2,2,160497,160498,160500,1,3,0
45785,1,1,160498,160500,160501,2,3,0
45786,4,2,160502,160502,160504,0,2,1
45787,2,1,160504,160504,160505,0,1,0
45788,6,2,160510,160510,160512,0,2,5
45789,5,3,160515,160515,160518,0,3,3
45790,3,1,160518,160518,160519,0,1,0
45791,2,1,160520,160520,160521,0,1,1
45792,6,3,160526,160526,160529,0,3,5
45793,6,3,160532,160532,160535,0,3,3
45794,4,2,160536,160536,160538,0,2,1
45795,3,3,160539,160539,160542,0,3,1
45796,2,1,160541,160542,160543,1,2,0
45797,5,3,160546,160546,160549,0,3,3
45798,1,2,160547,160549,160551,2,4,0
45799,1,1,160548,160551,160552,3,4,0
45800,5,3,160553,160553,160556,0,3,1
45801,6,2,160559,160559,160561,0,2,3
45802,2,1,160561,160561,160562,0,1,0
45803,6,2,160567,160567,160569,0,2,5
45804,3,2,160570,160570,160572,0,2,1
45805,5,1,160575,160575,160576,0,1,3
45806,4,2,160579,160579,160581,0,2,3
45807,2,3,160581,160581,160584,0,3,0
45808,6,1,160587,160587,160588,0,1,3
45809,1,3,160588,160588,160591,0,3,0
45810,6,1,160594,160594,160595,0,1,3
45811,2,3,160596,160596,160599,0,3,1
45812,6,3,160602,160602,160605,0,3,3
45813,4,3,160606,160606,160609,0,3,1
45814,5,1,160611,160611,160612,0,1,2
45815,6,1,160617,160617,160618,0,1,5
45816,6,3,160623,160623,160626,0,3,5
45817,5,3,160628,160628,160631,0,3,2
45818,4,2,160632,160632,160634,0,2,1
45819,1,3,160633,160634,160637,1,4,0
45820,3,3,160636,160637,160640,1,4,0
45821,5,3,160641,160641,160644,0,3,1
45822,1,3,160642,160644,160647,2,5,0
45823,4,1,160646,160647,160648,1,2,0
45824,3,2,160649,160649,160651,0,2,1
45825,2,2,160651,160651,160653,0,2,0
45826,5,3,160656,160656,160659,0,3,3
45827,1,2,160657,160659,160661,2,4,0
45828,5,3,160662,160662,160665,0,3,1
45829,3,3,160665,160665,160668,0,3,0
45830,2,2,160667,160668,160670,1,3,0
45831,4,3,160671,160671,160674,0,3,1
45832,6,2,160677,160677,160679,0,2,3
45833,2,3,160679,160679,160682,0,3,0
45834,6,1,160685,160685,160686,0,1,3
45835,3,2,160688,160688,160690,0,2,2
45836,1,1,160689,160690,160691,1,2,0
45837,5,2,160694,160694,160696,0,2,3
45838,4,1,160698,160698,160699,0,1,2
45839,3,1,160701,160701,160702,0,1,2
45840,6,2,160707,160707,160709,0,2,5
45841,3,1,160710,160710,160711,0,1,1
45842,3,3,160713,160713,160716,0,3,2
45843,4,3,160717,160717,160720,0,3,1
45844,1,1,160718,160720,160721,2,3,0
45845,1,2,160719,160721,160723,2,4,0
45846,5,3,160724,160724,160727,0,3,1
45847,2,3,160726,160727,160730,1,4,0
45848,3,1,160729,160730,160731,1,2,0
45849,1,2,160730,160731,160733,1,3,0
45850,3,1,160733,160733,160734,0,1,0
45851,2,3,160735,160735,160738,0,3,1
45852,3,2,160738,160738,160740,0,2,0
45853,6,1,160744,160744,160745,0,1,4
45854,4,2,160748,160748,160750,0,2,3
45855,6,1,160754,160754,160755,0,1,4
45856,4,1,160758,160758,160759,0,1,3
45857,2,1,160760,160760,160761,0,1,1
45858,6,3,160766,160766,160769,0,3,5
45859,5,3,160771,160771,160774,0,3,2
45860,5,2,160776,160776,160778,0,2,2
45861,3,3,160779,160779,160782,0,3,1
45862,5,2,160784,160784,160786,0,2,2
45863,6,2,160790,160790,160792,0,2,4
45864,2,2,160792,160792,160794,0,2,0
45865,3,2,160795,160795,160797,0,2,1
45866,6,2,160801,160801,160803,0,2,4
45867,6,2,160807,160807,160809,0,2,4
45868,1,1,160808,160809,160810,1,2,0
45869,2,1,160810,160810,160811,0,1,0
45870,5,2,160815,160815,160817,0,2,4
45871,2,1,160817,160817,160818,0,1,0
45872,1,2,160818,160818,160820,0,2,0
45873,2,2,160820,160820,160822,0,2,0
45874,4,1,160824,160824,160825,0,1,2
45875,4,1,160828,160828,160829,0,1,3
45876,6,2,160834,160834,160836,0,2,5
45877,5,3,160839,160839,160842,0,3,3
45878,4,3,160843,160843,160846,0,3,1
45879,4,3,160847,160847,160850,0,3,1
45880,3,1,160850,160850,160851,0,1,0
45881,4,2,160854,160854,160856,0,2,3
45882,1,3,160855,160856,160859,1,4,0
45883,5,2,160860,160860,160862,0,2,1
45884,3,1,160863,160863,160864,0,1,1
45885,2,2,160865,160865,160867,0,2,1
45886,6,3,160871,160871,160874,0,3,4
45887,5,2,160876,160876,160878,0,2,2
45888,1,3,160877,160878,160881,1,4,0
45889,4,2,160881,160881,160883,0,2,0
45890,2,3,160883,160883,160886,0,3,0
45891,6,3,160889,160889,160892,0,3,3
45892,3,3,160892,160892,160895,0,3,0
45893,3,1,160895,160895,160896,0,1,0
45894,5,1,160900,160900,160901,0,1,4
45895,1,1,160901,160901,160902,0,1,0
45896,3,1,160904,160904,160905,0,1,2
45897,6,3,160910,160910,160913,0,3,5
45898,1,2,160911,160913,160915,2,4,0
45899,4,1,160915,160915,160916,0,1,0
45900,3,2,160918,160918,160920,0,2,2
45901,5,3,160923,160923,160926,0,3,3
45902,1,2,160924,160926,160928,2,4,0
45903,1,3,160925,160928,160931,3,6,0
45904,5,1,160930,160931,160932,1,2,0
45905,4,3,160934,160934,160937,0,3,2
45906,3,1,160937,160937,160938,0,1,0
45907,4,3,160941,160941,160944,0,3,3
45908,5,3,160946,160946,160949,0,3,2
45909,4,3,160950,160950,160953,0,3,1
45910,6,2,160956,160956,160958,0,2,3
45911,2,1,160958,160958,160959,0,1,0
45912,6,3,160964,160964,160967,0,3,5
45913,1,2,160965,160967,160969,2,4,0
45914,4,1,160969,160969,160970,0,1,0
45915,5,3,160974,160974,160977,0,3,4
45916,5,3,160979,160979,160982,0,3,2
45917,1,2,160980,160982,160984,2,4,0
45918,2,3,160982,160984,160987,2,5,0
45919,2,3,160984,160987,160990,3,6,0
45920,6,3,160990,160990,160993,0,3,0
45921,5,1,160995,160995,160996,0,1,2
45922,1,3,160996,160996,160999,0,3,0
45923,1,2,160997,160999,161001,2,4,0
45924,5,2,161002,161002,161004,0,2,1
45925,3,2,161005,161005,161007,0,2,1
45926,3,3,161008,161008,161011,0,3,1
45927,6,3,161014,161014,161017,0,3,3
45928,4,3,161018,161018,161021,0,3,1
45929,4,3,161022,161022,161025,0,3,1
45930,4,1,161026,161026,161027,0,1,1
45931,5,3,161031,161031,161034,0,3,4
45932,2,2,161033,161034,161036,1,3,0
45933,6,3,161039,161039,161042,0,3,3
45934,5,2,161044,161044,161046,0,2,2
45935,6,3,161050,161050,161053,0,3,4
45936,3,1,161053,161053,161054,0,1,0
45937,3,1,161056,161056,161057,0,1,2
45938,5,2,161061,161061,161063,0,2,4
45939,6,1,161067,161067,161068,0,1,4
45940,1,3,161068,161068,161071,0,3,0
45941,4,2,161072,161072,161074,0,2,1
45942,2,1,161074,161074,161075,0,1,0
45943,5,3,161079,161079,161082,0,3,4
45944,2,2,161081,161082,161084,1,3,0
45945,4,1,161085,161085,161086,0,1,1
45946,1,3,161086,161086,161089,0,3,0
45947,1,2,161087,161089,161091,2,4,0
45948,5,1,161092,161092,161093,0,1,1
45949,6,2,161098,161098,161100,0,2,5
45950,1,1,161099,161100,161101,1,2,0
45951,1,2,161100,161101,161103,1,3,0
45952,5,1,161105,161105,161106,0,1,2
45953,2,3,161107,161107,161110,0,3,1
45954,5,2,161112,161112,161114,0,2,2
45955,4,2,161116,161116,161118,0,2,2
45956,5,3,161121,161121,161124,0,3,3
45957,3,3,161124,161124,161127,0,3,0
45958,3,2,161127,161127,161129,0,2,0
45959,1,1,161128,161129,161130,1,2,0
45960,1,2,161129,161130,161132,1,3,0
45961,6,3,161135,161135,161138,0,3,3
45962,2,3,161137,161138,161141,1,4,0
45963,2,3,161139,161141,161144,2,5,0
45964,5,3,161144,161144,161147,0,3,0
45965,1,2,161145,161147,161149,2,4,0
45966,4,3,161149,161149,161152,0,3,0
45967,3,1,161152,161152,161153,0,1,0
45968,1,1,161153,161153,161154,0,1,0
45969,6,1,161159,161159,161160,0,1,5
45970,4,2,161163,161163,161165,0,2,3
45971,1,1,161164,161165,161166,1,2,0
45972,4,1,161168,161168,161169,0,1,2
45973,3,1,161171,161171,161172,0,1,2
45974,1,3,161172,161172,161175,0,3,0
45975,5,1,161177,161177,161178,0,1,2
45976,2,1,161179,161179,161180,0,1,1
45977,2,2,161181,161181,161183,0,2,1
45978,6,1,161187,161187,161188,0,1,4
45979,1,2,161188,161188,161190,0,2,0
45980,4,2,161192,161192,161194,0,2,2
45981,1,1,161193,161194,161195,1,2,0
45982,2,1,161195,161195,161196,0,1,0
45983,5,3,161200,161200,161203,0,3,4
45984,6,2,161206,161206,161208,0,2,3
45985,4,2,161210,161210,161212,0,2,2
45986,5,3,161215,161215,161218,0,3,3
45987,1,1,161216,161218,161219,2,3,0
45988,5,3,161221,161221,161224,0,3,2
45989,2,2,161223,161224,161226,1,3,0
45990,2,1,161225,161226,161227,1,2,0
45991,1,1,161226,161227,161228,1,2,0
45992,1,1,161227,161228,161229,1,2,0
45993,6,2,161233,161233,161235,0,2,4
45994,3,3,161236,161236,161239,0,3,1
45995,3,3,161239,161239,161242,0,3,0
45996,4,1,161243,161243,161244,0,1,1
45997,2,2,161245,161245,161247,0,2,1
45998,2,2,161247,161247,161249,0,2,0
45999,1,1,161248,161249,161250,1,2,0
46000,6,3,161254,161254,161257,0,3,4
46001,2,3,161256,161257,161260,1,4,0
46002,5,1,161261,161261,161262,0,1,1
46003,6,1,161267,161267,161268,0,1,5
46004,1,2,161268,161268,161270,0,2,0
46005,4,2,161272,161272,161274,0,2,2
46006,3,2,161275,161275,161277,0,2,1
46007,5,1,161280,161280,161281,0,1,3
46008,2,2,161282,161282,161284,0,2,1
46009,5,3,161287,161287,161290,0,3,3
46010,6,1,161293,161293,161294,0,1,3
46011,5,3,161298,161298,161301,0,3,4
46012,5,2,161303,161303,161305,0,2,2
46013,4,2,161307,161307,161309,0,2,2
46014,4,2,161311,161311,161313,0,2,2
46015,5,3,161316,161316,161319,0,3,3
46016,4,1,161320,161320,161321,0,1,1
46017,4,2,161324,161324,161326,0,2,3
46018,4,2,161328,161328,161330,0,2,2
46019,6,1,161334,161334,161335,0,1,4
46020,2,1,161336,161336,161337,0,1,1
46021,4,3,161340,161340,161343,0,3,3
46022,1,1,161341,161343,161344,2,3,0
46023,1,1,161342,161344,161345,2,3,0
46024,3,3,161345,161345,161348,0,3,0
46025,4,1,161349,161349,161350,0,1,1
46026,6,1,161355,161355,161356,0,1,5
46027,3,1,161358,161358,161359,0,1,2
46028,4,2,161362,161362,161364,0,2,3
46029,3,3,161365,161365,161368,0,3,1
46030,1,1,161366,161368,161369,2,3,0
46031,2,3,161368,161369,161372,1,4,0
46032,2,2,161370,161372,161374,2,4,0
46033,4,3,161374,161374,161377,0,3,0
46034,6,1,161380,161380,161381,0,1,3
46035,3,1,161383,161383,161384,0,1,2
46036,1,1,161384,161384,161385,0,1,0
46037,6,3,161390,161390,161393,0,3,5
46038,6,3,161396,161396,161399,0,3,3
46039,4,3,161400,161400,161403,0,3,1
46040,2,1,161402,161403,161404,1,2,0
46041,6,1,161408,161408,161409,0,1,4
46042,6,3,161414,161414,161417,0,3,5
46043,2,2,161416,161417,161419,1,3,0
46044,1,2,161417,161419,161421,2,4,0
46045,1,3,161418,161421,161424,3,6,0
46046,2,3,161420,161424,161427,4,7,0
46047,2,2,161422,161427,161429,5,7,0
46048,6,2,161428,161429,161431,1,3,0
46049,3,2,161431,161431,161433,0,2,0
46050,4,3,161435,161435,161438,0,3,2
46051,5,1,161440,161440,161441,0,1,2
46052,2,1,161442,161442,161443,0,1,1
46053,1,2,161443,161443,161445,0,2,0
46054,4,3,161447,161447,161450,0,3,2
46055,5,2,161452,161452,161454,0,2,2
46056,1,2,161453,161454,161456,1,3,0
46057,5,1,161458,161458,161459,0,1,2
46058,2,3,161460,161460,161463,0,3,1
46059,1,1,161461,161463,161464,2,3,0
46060,2,1,161463,161464,161465,1,2,0
46061,5,1,161468,161468,161469,0,1,3
46062,6,1,161474,161474,161475,0,1,5
46063,4,3,161478,161478,161481,0,3,3
46064,1,1,161479,161481,161482,2,3,0
46065,2,2,161481,161482,161484,1,3,0
46066,1,3,161482,161484,161487,2,5,0
46067,3,1,161485,161487,161488,2,3,0
46068,1,3,161486,161488,161491,2,5,0
46069,4,2,161490,161491,161493,1,3,0
46070,4,2,161494,161494,161496,0,2,1
46071,5,1,161499,161499,161500,0,1,3
46072,4,2,161503,161503,161505,0,2,3
46073,3,2,161506,161506,161508,0,2,1
46074,3,3,161509,161509,161512,0,3,1
46075,1,3,161510,161512,161515,2,5,0
46076,4,2,161514,161515,161517,1,3,0
46077,5,3,161519,161519,161522,0,3,2
46078,2,1,161521,161522,161523,1,2,0
46079,6,2,161527,161527,161529,0,2,4
46080,5,2,161532,161532,161534,0,2,3
46081,6,3,161538,161538,161541,0,3,4
46082,3,2,161541,161541,161543,0,2,0
46083,2,1,161543,161543,161544,0,1,0
46084,3,2,161546,161546,161548,0,2,2
46085,5,3,161551,161551,161554,0,3,3
46086,5,2,161556,161556,161558,0,2,2
46087,5,1,161561,161561,161562,0,1,3
46088,5,1,161566,161566,161567,0,1,4
46089,5,2,161571,161571,161573,0,2,4
46090,3,3,161574,161574,161577,0,3,1
46091,2,3,161576,161577,161580,1,4,0
46092,1,2,161577,161580,161582,3,5,0
46093,6,1,161583,161583,161584,0,1,1
46094,4,3,161587,161587,161590,0,3,3
46095,3,2,161590,161590,161592,0,2,0
46096,1,2,161591,161592,161594,1,3,0
46097,1,3,161592,161594,161597,2,5,0
46098,5,2,161597,161597,161599,0,2,0
46099,1,1,161598,161599,161600,1,2,0
46100,3,2,161601,161601,161603,0,2,1
46101,2,1,161603,161603,161604,0,1,0
46102,4,2,161607,161607,161609,0,2,3
46103,6,3,161613,161613,161616,0,3,4
46104,3,2,161616,161616,161618,0,2,0
46105,4,2,161620,161620,161622,0,2,2
46106,3,1,161623,161623,161624,0,1,1
46107,2,3,161625,161625,161628,0,3,1
46108,2,3,161627,161628,161631,1,4,0
46109,4,2,161631,161631,161633,0,2,0
46110,1,1,161632,161633,161634,1,2,0
46111,3,3,161635,161635,161638,0,3,1
46112,3,1,161638,161638,161639,0,1,0
46113,2,2,161640,161640,161642,0,2,1
46114,4,3,161644,161644,161647,0,3,2
46115,2,3,161646,161647,161650,1,4,0
46116,2,1,161648,161650,161651,2,3,0
46117,6,2,161654,161654,161656,0,2,3
46118,2,2,161656,161656,161658,0,2,0
46119,6,2,161662,161662,161664,0,2,4
46120,1,2,161663,161664,161666,1,3,0
46121,4,3,161667,161667,161670,0,3,1
46122,2,2,161669,161670,161672,1,3,0
46123,5,3,161674,161674,161677,0,3,2
46124,2,3,161676,161677,161680,1,4,0
46125,4,1,161680,161680,161681,0,1,0
46126,1,1,161681,161681,161682,0,1,0
46127,2,1,161683,161683,161684,0,1,1
46128,6,2,161689,161689,161691,0,2,5
46129,6,3,161695,161695,161698,0,3,4
46130,3,1,161698,161698,161699,0,1,0
46131,1,2,161699,161699,161701,0,2,0
46132,6,2,161705,161705,161707,0,2,4
46133,1,1,161706,161707,161708,1,2,0
46134,2,2,161708,161708,161710,0,2,0
46135,4,3,161712,161712,161715,0,3,2
46136,4,3,161716,161716,161719,0,3,1
46137,3,1,161719,161719,161720,0,1,0
46138,4,3,161723,161723,161726,0,3,3
46139,3,1,161726,161726,161727,0,1,0
46140,1,3,161727,161727,161730,0,3,0
46141,2,2,161729,161730,161732,1,3,0
46142,6,1,161735,161735,161736,0,1,3
46143,5,3,161740,161740,161743,0,3,4
46144,5,2,161745,161745,161747,0,2,2
46145,3,2,161748,161748,161750,0,2,1
46146,2,2,161750,161750,161752,0,2,0
46147,4,1,161754,161754,161755,0,1,2
46148,5,3,161759,161759,161762,0,3,4
46149,1,2,161760,161762,161764,2,4,0
46150,1,2,161761,161764,161766,3,5,0
46151,2,1,161763,161766,161767,3,4,0
46152,5,1,161768,161768,161769,0,1,1
46153,1,1,161769,161769,161770,0,1,0
46154,4,1,161773,161773,161774,0,1,3
46155,2,1,161775,161775,161776,0,1,1
46156,5,3,161780,161780,161783,0,3,4
46157,6,3,161786,161786,161789,0,3,3
46158,5,1,161791,161791,161792,0,1,2
46159,6,3,161797,161797,161800,0,3,5
46160,4,1,161801,161801,161802,0,1,1
46161,3,2,161804,161804,161806,0,2,2
46162,6,2,161810,161810,161812,0,2,4
46163,2,1,161812,161812,161813,0,1,0
46164,3,2,161815,161815,161817,0,2,2
46165,5,2,161820,161820,161822,0,2,3
46166,2,2,161822,161822,161824,0,2,0
46167,3,2,161825,161825,161827,0,2,1
46168,2,2,161827,161827,161829,0,2,0
46169,5,1,161832,161832,161833,0,1,3
46170,4,2,161836,161836,161838,0,2,3
46171,5,2,161841,161841,161843,0,2,3
46172,2,3,161843,161843,161846,0,3,0
46173,4,2,161847,161847,161849,0,2,1
46174,4,2,161851,161851,161853,0,2,2
46175,1,2,161852,161853,161855,1,3,0
46176,1,3,161853,161855,161858,2,5,0
46177,6,1,161859,161859,161860,0,1,1
46178,1,1,161860,161860,161861,0,1,0
46179,1,1,161861,161861,161862,0,1,0
46180,2,1,161863,161863,161864,0,1,1
46181,6,1,161869,161869,161870,0,1,5
46182,6,3,161875,161875,161878,0,3,5
46183,5,3,161880,161880,161883,0,3,2
46184,4,3,161884,161884,161887,0,3,1
46185,3,1,161887,161887,161888,0,1,0
46186,6,2,161893,161893,161895,0,2,5
46187,3,1,161896,161896,161897,0,1,1
46188,1,1,161897,161897,161898,0,1,0
46189,3,3,161900,161900,161903,0,3,2
46190,4,3,161904,161904,161907,0,3,1
46191,4,3,161908,161908,161911,0,3,1
46192,2,2,161910,161911,161913,1,3,0
46193,4,3,161914,161914,161917,0,3,1
46194,5,1,161919,161919,161920,0,1,2
46195,5,1,161924,161924,161925,0,1,4
46196,1,2,161925,161925,161927,0,2,0
46197,6,2,161931,161931,161933,0,2,4
46198,4,1,161935,161935,161936,0,1,2
46199,3,1,161938,161938,161939,0,1,2
46200,4,3,161942,161942,161945,0,3,3
46201,4,2,161946,161946,161948,0,2,1
46202,5,2,161951,161951,161953,0,2,3
46203,1,3,161952,161953,161956,1,4,0
46204,6,2,161958,161958,161960,0,2,2
46205,4,3,161962,161962,161965,0,3,2
46206,1,1,161963,161965,161966,2,3,0
46207,1,2,161964,161966,161968,2,4,0
46208,2,2,161966,161968,161970,2,4,0
46209,4,3,161970,161970,161973,0,3,0
46210,3,3,161973,161973,161976,0,3,0
46211,2,3,161975,161976,161979,1,4,0
46212,6,1,161981,161981,161982,0,1,2
46213,1,1,161982,161982,161983,0,1,0
46214,6,2,161988,161988,161990,0,2,5
46215,6,3,161994,161994,161997,0,3,4
46216,2,1,161996,161997,161998,1,2,0
46217,3,3,161999,161999,162002,0,3,1
46218,4,1,162003,162003,162004,0,1,1
46219,5,1,162008,162008,162009,0,1,4
46220,6,3,162014,162014,162017,0,3,5
46221,2,2,162016,162017,162019,1,3,0
46222,3,2,162019,162019,162021,0,2,0
46223,6,1,162025,162025,162026,0,1,4
46224,6,2,162031,162031,162033,0,2,5
46225,2,1,162033,162033,162034,0,1,0
46226,3,3,162036,162036,162039,0,3,2
46227,4,3,162040,162040,162043,0,3,1
46228,2,1,162042,162043,162044,1,2,0
46229,5,1,162047,162047,162048,0,1,3
46230,5,2,162052,162052,162054,0,2,4
46231,1,2,162053,162054,162056,1,3,0
46232,2,2,162055,162056,162058,1,3,0
46233,6,1,162061,162061,162062,0,1,3
46234,3,3,162064,162064,162067,0,3,2
46235,3,3,162067,162067,162070,0,3,0
46236,3,3,162070,162070,162073,0,3,0
46237,6,2,162076,162076,162078,0,2,3
46238,6,2,162082,162082,162084,0,2,4
46239,1,3,162083,162084,162087,1,4,0
46240,6,2,162089,162089,162091,0,2,2
46241,4,3,162093,162093,162096,0,3,2
46242,6,2,162099,162099,162101,0,2,3
46243,2,3,162101,162101,162104,0,3,0
46244,1,3,162102,162104,162107,2,5,0
46245,3,3,162105,162107,162110,2,5,0
46246,1,1,162106,162110,162111,4,5,0
46247,5,3,162111,162111,162114,0,3,0
46248,6,3,162117,162117,162120,0,3,3
46249,2,3,162119,162120,162123,1,4,0
46250,6,3,162125,162125,162128,0,3,2
46251,4,1,162129,162129,162130,0,1,1
46252,6,2,162135,162135,162137,0,2,5
46253,3,2,162138,162138,162140,0,2,1
46254,3,1,162141,162141,162142,0,1,1
46255,5,2,162146,162146,162148,0,2,4
46256,3,2,162149,162149,162151,0,2,1
46257,2,3,162151,162151,162154,0,3,0
46258,6,1,162157,162157,162158,0,1,3
46259,3,1,162160,162160,162161,0,1,2
46260,3,1,162163,162163,162164,0,1,2
46261,6,2,162169,162169,162171,0,2,5
46262,1,2,162170,162171,162173,1,3,0
46263,6,2,162176,162176,162178,0,2,3
46264,2,1,162178,162178,162179,0,1,0
46265,5,1,162183,162183,162184,0,1,4
46266,4,1,162187,162187,162188,0,1,3
46267,1,3,162188,162188,162191,0,3,0
46268,5,2,162193,162193,162195,0,2,2
46269,4,3,162197,162197,162200,0,3,2
46270,4,3,162201,162201,162204,0,3,1
46271,2,1,162203,162204,162205,1,2,0
46272,3,2,162206,162206,162208,0,2,1
46273,5,3,162211,162211,162214,0,3,3
46274,2,3,162213,162214,162217,1,4,0
46275,3,2,162216,162217,162219,1,3,0
46276,3,2,162219,162219,162221,0,2,0
46277,2,3,162221,162221,162224,0,3,0
46278,4,3,162225,162225,162228,0,3,1
46279,4,2,162229,162229,162231,0,2,1
46280,4,2,162233,162233,162235,0,2,2
46281,5,2,162238,162238,162240,0,2,3
46282,3,2,162241,162241,162243,0,2,1
46283,6,2,162247,162247,162249,0,2,4
46284,6,1,162253,162253,162254,0,1,4
46285,2,2,162255,162255,162257,0,2,1
46286,4,2,162259,162259,162261,0,2,2
46287,4,1,162263,162263,162264,0,1,2
46288,3,1,162266,162266,162267,0,1,2
46289,1,3,162267,162267,162270,0,3,0
46290,3,3,162270,162270,162273,0,3,0
46291,5,3,162275,162275,162278,0,3,2
46292,3,2,162278,162278,162280,0,2,0
46293,2,2,162280,162280,162282,0,2,0
46294,3,1,162283,162283,162284,0,1,1
46295,3,3,162286,162286,162289,0,3,2
46296,1,2,162287,162289,162291,2,4,0
46297,4,1,162291,162291,162292,0,1,0
46298,3,2,162294,162294,162296,0,2,2
46299,1,3,162295,162296,162299,1,4,0
46300,1,3,162296,162299,162302,3,6,0
46301,3,3,162299,162302,162305,3,6,0
46302,2,1,162301,162305,162306,4,5,0
46303,4,1,162305,162306,162307,1,2,0
46304,3,2,162308,162308,162310,0,2,1
46305,4,3,162312,162312,162315,0,3,2
46306,3,3,162315,162315,162318,0,3,0
46307,6,2,162321,162321,162323,0,2,3
46308,5,2,162326,162326,162328,0,2,3
46309,3,3,162329,162329,162332,0,3,1
46310,3,3,162332,162332,162335,0,3,0
46311,2,1,162334,162335,162336,1,2,0
46312,2,3,162336,162336,162339,0,3,0
46313,2,3,162338,162339,162342,1,4,0
46314,6,2,162344,162344,162346,0,2,2
46315,6,2,162350,162350,162352,0,2,4
46316,1,1,162351,162352,162353,1,2,0
46317,5,1,162356,162356,162357,0,1,3
46318,1,3,162357,162357,162360,0,3,0
46319,2,2,162359,162360,162362,1,3,0
46320,5,2,162364,162364,162366,0,2,2
46321,3,1,162367,162367,162368,0,1,1
46322,1,1,162368,162368,162369,0,1,0
46323,4,1,162372,162372,162373,0,1,3
46324,2,1,162374,162374,162375,0,1,1
46325,4,3,162378,162378,162381,0,3,3
46326,2,2,162380,162381,162383,1,3,0
46327,5,1,162385,162385,162386,0,1,2
46328,2,1,162387,162387,162388,0,1,1
46329,4,2,162391,162391,162393,0,2,3
46330,4,2,162395,162395,162397,0,2,2
46331,2,1,162397,162397,162398,0,1,0
46332,6,1,162403,162403,162404,0,1,5
46333,6,1,162409,162409,162410,0,1,5
46334,5,1,162414,162414,162415,0,1,4
46335,1,2,162415,162415,162417,0,2,0
46336,3,1,162418,162418,162419,0,1,1
46337,3,2,162421,162421,162423,0,2,2
46338,4,2,162425,162425,162427,0,2,2
46339,6,3,162431,162431,162434,0,3,4
46340,1,3,162432,162434,162437,2,5,0
46341,5,3,162437,162437,162440,0,3,0
46342,5,3,162442,162442,162445,0,3,2
46343,1,1,162443,162445,162446,2,3,0
46344,2,2,162445,162446,162448,1,3,0
46345,1,3,162446,162448,162451,2,5,0
46346,5,2,162451,162451,162453,0,2,0
46347,4,3,162455,162455,162458,0,3,2
46348,6,3,162461,162461,162464,0,3,3
46349,6,2,162467,162467,162469,0,2,3
46350,6,3,162473,162473,162476,0,3,4
46351,4,2,162477,162477,162479,0,2,1
46352,1,1,162478,162479,162480,1,2,0
46353,2,3,162480,162480,162483,0,3,0
46354,1,2,162481,162483,162485,2,4,0
46355,6,2,162487,162487,162489,0,2,2
46356,2,1,162489,162489,162490,0,1,0
46357,6,1,162495,162495,162496,0,1,5
46358,3,1,162498,162498,162499,0,1,2
46359,6,3,162504,162504,162507,0,3,5
46360,1,2,162505,162507,162509,2,4,0
46361,5,2,162510,162510,162512,0,2,1
46362,5,2,162515,162515,162517,0,2,3
46363,5,1,162520,162520,162521,0,1,3
46364,6,2,162526,162526,162528,0,2,5
46365,4,1,162530,162530,162531,0,1,2
46366,5,2,162535,162535,162537,0,2,4
46367,3,1,162538,162538,162539,0,1,1
46368,2,1,162540,162540,162541,0,1,1
46369,2,3,162542,162542,162545,0,3,1
46370,1,3,162543,162545,162548,2,5,0
46371,1,2,162544,162548,162550,4,6,0
46372,1,2,162545,162550,162552,5,7,0
46373,1,2,162546,162552,162554,6,8,0
46374,4,2,162550,162554,162556,4,6,0
46375,6,1,162556,162556,162557,0,1,0
46376,1,1,162557,162557,162558,0,1,0
46377,1,3,162558,162558,162561,0,3,0
46378,4,2,162562,162562,162564,0,2,1
46379,3,2,162565,162565,162567,0,2,1
46380,4,1,162569,162569,162570,0,1,2
46381,6,2,162575,162575,162577,0,2,5
46382,1,1,162576,162577,162578,1,2,0
46383,2,2,162578,162578,162580,0,2,0
46384,6,1,162584,162584,162585,0,1,4
46385,4,1,162588,162588,162589,0,1,3
46386,4,2,162592,162592,162594,0,2,3
46387,5,2,162597,162597,162599,0,2,3
46388,1,2,162598,162599,162601,1,3,0
46389,2,3,162600,162601,162604,1,4,0
46390,6,1,162606,162606,162607,0,1,2
46391,6,1,162612,162612,162613,0,1,5
46392,4,2,162616,162616,162618,0,2,3
46393,3,1,162619,162619,162620,0,1,1
46394,4,1,162623,162623,162624,0,1,3
46395,5,2,162628,162628,162630,0,2,4
46396,5,1,162633,162633,162634,0,1,3
46397,6,1,162639,162639,162640,0,1,5
46398,5,2,162644,162644,162646,0,2,4
46399,5,2,162649,162649,162651,0,2,3
46400,2,3,162651,162651,162654,0,3,0
46401,6,1,162657,162657,162658,0,1,3
46402,3,3,162660,162660,162663,0,3,2
46403,2,1,162662,162663,162664,1,2,0
46404,1,3,162663,162664,162667,1,4,0
46405,2,2,162665,162667,162669,2,4,0
46406,4,3,162669,162669,162672,0,3,0
46407,3,2,162672,162672,162674,0,2,0
46408,3,1,162675,162675,162676,0,1,1
46409,3,1,162678,162678,162679,0,1,2
46410,5,3,162683,162683,162686,0,3,4
46411,2,3,162685,162686,162689,1,4,0
46412,5,1,162690,162690,162691,0,1,1
46413,6,2,162696,162696,162698,0,2,5
46414,3,1,162699,162699,162700,0,1,1
46415,3,3,162702,162702,162705,0,3,2
46416,4,1,162706,162706,162707,0,1,1
46417,3,1,162709,162709,162710,0,1,2
46418,1,3,162710,162710,162713,0,3,0
46419,2,1,162712,162713,162714,1,2,0
46420,6,1,162718,162718,162719,0,1,4
46421,4,1,162722,162722,162723,0,1,3
46422,1,2,162723,162723,162725,0,2,0
46423,6,3,162729,162729,162732,0,3,4
46424,3,3,162732,162732,162735,0,3,0
46425,2,2,162734,162735,162737,1,3,0
46426,4,1,162738,162738,162739,0,1,1
46427,2,3,162740,162740,162743,0,3,1
46428,6,1,162746,162746,162747,0,1,3
46429,2,3,162748,162748,162751,0,3,1
46430,5,2,162753,162753,162755,0,2,2
46431,4,2,162757,162757,162759,0,2,2
46432,6,2,162763,162763,162765,0,2,4
46433,4,3,162767,162767,162770,0,3,2
46434,2,1,162769,162770,162771,1,2,0
46435,1,1,162770,162771,162772,1,2,0
46436,5,1,162775,162775,162776,0,1,3
46437,1,1,162776,162776,162777,0,1,0
46438,3,3,162779,162779,162782,0,3,2
46439,6,1,162785,162785,162786,0,1,3
46440,5,3,162790,162790,162793,0,3,4
46441,1,3,162791,162793,162796,2,5,0
46442,5,1,162796,162796,162797,0,1,0
46443,3,3,162799,162799,162802,0,3,2
46444,5,3,162804,162804,162807,0,3,2
46445,2,3,162806,162807,162810,1,4,0
46446,2,3,162808,162810,162813,2,5,0
46447,3,3,162811,162813,162816,2,5,0
46448,3,3,162814,162816,162819,2,5,0
46449,5,1,162819,162819,162820,0,1,0
46450,1,2,162820,162820,162822,0,2,0
46451,2,1,162822,162822,162823,0,1,0
46452,3,2,162825,162825,162827,0,2,2
46453,3,2,162828,162828,162830,0,2,1
46454,1,1,162829,162830,162831,1,2,0
46455,3,1,162832,162832,162833,0,1,1
46456,6,3,162838,162838,162841,0,3,5
46457,1,3,162839,162841,162844,2,5,0
46458,6,3,162845,162845,162848,0,3,1
46459,6,2,162851,162851,162853,0,2,3
46460,1,1,162852,162853,162854,1,2,0
46461,2,3,162854,162854,162857,0,3,0
46462,6,2,162860,162860,162862,0,2,3
46463,1,1,162861,162862,162863,1,2,0
46464,4,3,162865,162865,162868,0,3,2
46465,1,2,162866,162868,162870,2,4,0
46466,4,3,162870,162870,162873,0,3,0
46467,4,1,162874,162874,162875,0,1,1
46468,1,1,162875,162875,162876,0,1,0
46469,3,1,162878,162878,162879,0,1,2
46470,2,1,162880,162880,162881,0,1,1
46471,1,3,162881,162881,162884,0,3,0
46472,5,3,162886,162886,162889,0,3,2
46473,2,1,162888,162889,162890,1,2,0
46474,3,2,162891,162891,162893,0,2,1
46475,6,2,162897,162897,162899,0,2,4
46476,5,3,162902,162902,162905,0,3,3
46477,3,1,162905,162905,162906,0,1,0
46478,3,2,162908,162908,162910,0,2,2
46479,2,3,162910,162910,162913,0,3,0
46480,1,2,162911,162913,162915,2,4,0
46481,2,2,162913,162915,162917,2,4,0
46482,6,2,162919,162919,162921,0,2,2
46483,3,2,162922,162922,162924,0,2,1
46484,1,2,162923,162924,162926,1,3,0
46485,1,3,162924,162926,162929,2,5,0
46486,6,1,162930,162930,162931,0,1,1
46487,1,3,162931,162931,162934,0,3,0
46488,6,3,162937,162937,162940,0,3,3
46489,6,1,162943,162943,162944,0,1,3
46490,4,3,162947,162947,162950,0,3,3
46491,2,1,162949,162950,162951,1,2,0
46492,6,1,162955,162955,162956,0,1,4
46493,6,2,162961,162961,162963,0,2,5
46494,5,3,162966,162966,162969,0,3,3
46495,2,3,162968,162969,162972,1,4,0
46496,1,3,162969,162972,162975,3,6,0
46497,5,1,162974,162975,162976,1,2,0
46498,2,3,162976,162976,162979,0,3,0
46499,3,3,162979,162979,162982,0,3,0
46500,4,1,162983,162983,162984,0,1,1
46501,4,3,162987,162987,162990,0,3,3
46502,3,2,162990,162990,162992,0,2,0
46503,3,2,162993,162993,162995,0,2,1
46504,1,1,162994,162995,162996,1,2,0
46505,1,1,162995,162996,162997,1,2,0
46506,5,2,163000,163000,163002,0,2,3
46507,1,3,163001,163002,163005,1,4,0
46508,4,2,163005,163005,163007,0,2,0
46509,6,2,163011,163011,163013,0,2,4
46510,5,2,163016,163016,163018,0,2,3
46511,6,1,163022,163022,163023,0,1,4
46512,1,2,163023,163023,163025,0,2,0
46513,4,2,163027,163027,163029,0,2,2
46514,3,2,163030,163030,163032,0,2,1
46515,4,1,163034,163034,163035,0,1,2
46516,2,1,163036,163036,163037,0,1,1
46517,6,3,163042,163042,163045,0,3,5
46518,2,2,163044,163045,163047,1,3,0
46519,5,1,163049,163049,163050,0,1,2
46520,5,1,163054,163054,163055,0,1,4
46521,2,3,163056,163056,163059,0,3,1
46522,5,3,163061,163061,163064,0,3,2
46523,2,2,163063,163064,163066,1,3,0
46524,3,1,163066,163066,163067,0,1,0
46525,3,1,163069,163069,163070,0,1,2
46526,6,3,163075,163075,163078,0,3,5
46527,5,3,163080,163080,163083,0,3,2
46528,4,2,163084,163084,163086,0,2,1
46529,1,3,163085,163086,163089,1,4,0
46530,1,1,163086,163089,163090,3,4,0
46531,1,1,163087,163090,163091,3,4,0
46532,6,2,163093,163093,163095,0,2,2
46533,4,2,163097,163097,163099,0,2,2
46534,1,1,163098,163099,163100,1,2,0
46535,1,2,163099,163100,163102,1,3,0
46536,2,1,163101,163102,163103,1,2,0
46537,1,1,163102,163103,163104,1,2,0
46538,2,2,163104,163104,163106,0,2,0
46539,6,3,163110,163110,163113,0,3,4
46540,3,2,163113,163113,163115,0,2,0
46541,2,2,163115,163115,163117,0,2,0
46542,5,2,163120,163120,163122,0,2,3
46543,5,3,163125,163125,163128,0,3,3
46544,1,3,163126,163128,163131,2,5,0
46545,1,3,163127,163131,163134,4,7,0
46546,1,2,163128,163134,163136,6,8,0
46547,1,1,163129,163136,163137,7,8,0
46548,3,3,163132,163137,163140,5,8,0
46549,1,2,163133,163140,163142,7,9,0
46550,1,3,163134,163142,163145,8,11,0
46551,6,1,163140,163145,163146,5,6,0
46552,2,3,163142,163146,163149,4,7,0
46553,2,1,163144,163149,163150,5,6,0
46554,4,2,163148,163150,163152,2,4,0
46555,4,1,163152,163152,163153,0,1,0
46556,4,2,163156,163156,163158,0,2,3
46557,4,3,163160,163160,163163,0,3,2
46558,3,1,163163,163163,163164,0,1,0
46559,1,1,163164,163164,163165,0,1,0
46560,5,1,163169,163169,163170,0,1,4
46561,5,2,163174,163174,163176,0,2,4
46562,1,2,163175,163176,163178,1,3,0
46563,6,2,163181,163181,163183,0,2,3
46564,5,1,163186,163186,163187,0,1,3
46565,6,1,163192,163192,163193,0,1,5
46566,6,1,163198,163198,163199,0,1,5
46567,4,2,163202,163202,163204,0,2,3
46568,2,3,163204,163204,163207,0,3,0
46569,3,1,163207,163207,163208,0,1,0
46570,1,3,163208,163208,163211,0,3,0
46571,6,2,163214,163214,163216,0,2,3
46572,5,1,163219,163219,163220,0,1,3
46573,3,3,163222,163222,163225,0,3,2
46574,4,2,163226,163226,163228,0,2,1
46575,5,3,163231,163231,163234,0,3,3
46576,4,3,163235,163235,163238,0,3,1
46577,4,1,163239,163239,163240,0,1,1
46578,2,2,163241,163241,163243,0,2,1
46579,6,3,163247,163247,163250,0,3,4
46580,4,3,163251,163251,163254,0,3,1
46581,2,3,163253,163254,163257,1,4,0
46582,6,1,163259,163259,163260,0,1,2
46583,2,1,163261,163261,163262,0,1,1
46584,1,1,163262,163262,163263,0,1,0
46585,1,1,163263,163263,163264,0,1,0
46586,4,1,163267,163267,163268,0,1,3
46587,3,3,163270,163270,163273,0,3,2
46588,2,2,163272,163273,163275,1,3,0
46589,2,3,163274,163275,163278,1,4,0
46590,6,2,163280,163280,163282,0,2,2
46591,1,1,163281,163282,163283,1,2,0
46592,4,1,163285,163285,163286,0,1,2
46593,2,2,163287,163287,163289,0,2,1
46594,1,3,163288,163289,163292,1,4,0
46595,1,3,163289,163292,163295,3,6,0
46596,5,3,163294,163295,163298,1,4,0
46597,5,2,163299,163299,163301,0,2,1
46598,6,3,163305,163305,163308,0,3,4
46599,6,2,163311,163311,163313,0,2,3
46600,4,2,163315,163315,163317,0,2,2
46601,3,2,163318,163318,163320,0,2,1
46602,2,2,163320,163320,163322,0,2,0
46603,5,3,163325,163325,163328,0,3,3
46604,5,1,163330,163330,163331,0,1,2
46605,3,3,163333,163333,163336,0,3,2
46606,6,1,163339,163339,163340,0,1,3
46607,2,2,163341,163341,163343,0,2,1
46608,5,1,163346,163346,163347,0,1,3
46609,2,3,163348,163348,163351,0,3,1
46610,2,1,163350,163351,163352,1,2,0
46611,6,1,163356,163356,163357,0,1,4
46612,4,1,163360,163360,163361,0,1,3
46613,4,1,163364,163364,163365,0,1,3
46614,4,1,163368,163368,163369,0,1,3
46615,5,1,163373,163373,163374,0,1,4
46616,5,3,163378,163378,163381,0,3,4
46617,3,1,163381,163381,163382,0,1,0
46618,1,2,163382,163382,163384,0,2,0
46619,3,1,163385,163385,163386,0,1,1
46620,1,1,163386,163386,163387,0,1,0
46621,4,3,163390,163390,163393,0,3,3
46622,3,1,163393,163393,163394,0,1,0
46623,6,3,163399,163399,163402,0,3,5
46624,6,3,163405,163405,163408,0,3,3
46625,2,1,163407,163408,163409,1,2,0
46626,4,2,163411,163411,163413,0,2,2
46627,5,1,163416,163416,163417,0,1,3
46628,3,3,163419,163419,163422,0,3,2
46629,3,1,163422,163422,163423,0,1,0
46630,4,3,163426,163426,163429,0,3,3
46631,4,2,163430,163430,163432,0,2,1
46632,6,1,163436,163436,163437,0,1,4
46633,4,1,163440,163440,163441,0,1,3
46634,3,2,163443,163443,163445,0,2,2
46635,4,3,163447,163447,163450,0,3,2
46636,6,2,163453,163453,163455,0,2,3
46637,6,3,163459,163459,163462,0,3,4
46638,3,1,163462,163462,163463,0,1,0
46639,2,1,163464,163464,163465,0,1,1
46640,2,2,163466,163466,163468,0,2,1
46641,2,3,163468,163468,163471,0,3,0
46642,4,3,163472,163472,163475,0,3,1
46643,5,2,163477,163477,163479,0,2,2
46644,3,3,163480,163480,163483,0,3,1
46645,5,1,163485,163485,163486,0,1,2
46646,4,1,163489,163489,163490,0,1,3
46647,5,3,163494,163494,163497,0,3,4
46648,4,2,163498,163498,163500,0,2,1
46649,6,3,163504,163504,163507,0,3,4
46650,1,3,163505,163507,163510,2,5,0
46651,6,2,163511,163511,163513,0,2,1
46652,5,1,163516,163516,163517,0,1,3
46653,1,2,163517,163517,163519,0,2,0
46654,3,1,163520,163520,163521,0,1,1
46655,4,2,163524,163524,163526,0,2,3
46656,5,2,163529,163529,163531,0,2,3
46657,1,1,163530,163531,163532,1,2,0
46658,1,3,163531,163532,163535,1,4,0
46659,6,1,163537,163537,163538,0,1,2
46660,4,1,163541,163541,163542,0,1,3
46661,2,1,163543,163543,163544,0,1,1
46662,6,1,163549,163549,163550,0,1,5
46663,2,3,163551,163551,163554,0,3,1
46664,3,2,163554,163554,163556,0,2,0
46665,3,1,163557,163557,163558,0,1,1
46666,3,3,163560,163560,163563,0,3,2
46667,5,1,163565,163565,163566,0,1,2
46668,1,3,163566,163566,163569,0,3,0
46669,3,3,163569,163569,163572,0,3,0
46670,6,1,163575,163575,163576,0,1,3
46671,5,2,163580,163580,163582,0,2,4
46672,1,2,163581,163582,163584,1,3,0
46673,5,1,163586,163586,163587,0,1,2
46674,5,2,163591,163591,163593,0,2,4
46675,6,3,163597,163597,163600,0,3,4
46676,4,1,163601,163601,163602,0,1,1
46677,3,1,163604,163604,163605,0,1,2
46678,5,2,163609,163609,163611,0,2,4
46679,5,2,163614,163614,163616,0,2,3
46680,5,3,163619,163619,163622,0,3,3
46681,1,3,163620,163622,163625,2,5,0
46682,5,3,163625,163625,163628,0,3,0
46683,1,2,163626,163628,163630,2,4,0
46684,3,2,163629,163630,163632,1,3,0
46685,5,1,163634,163634,163635,0,1,2
46686,3,3,163637,163637,163640,0,3,2
46687,1,3,163638,163640,163643,2,5,0
46688,4,3,163642,163643,163646,1,4,0
46689,5,1,163647,163647,163648,0,1,1
46690,1,2,163648,163648,163650,0,2,0
46691,5,3,163653,163653,163656,0,3,3
46692,3,1,163656,163656,163657,0,1,0
46693,6,1,163662,163662,163663,0,1,5
46694,2,3,163664,163664,163667,0,3,1
46695,1,1,163665,163667,163668,2,3,0
46696,3,1,163668,163668,163669,0,1,0
46697,4,1,163672,163672,163673,0,1,3
46698,3,3,163675,163675,163678,0,3,2
46699,6,1,163681,163681,163682,0,1,3
46700,4,2,163685,163685,163687,0,2,3
46701,5,2,163690,163690,163692,0,2,3
46702,3,1,163693,163693,163694,0,1,1
46703,6,2,163699,163699,163701,0,2,5
46704,2,2,163701,163701,163703,0,2,0
46705,4,3,163705,163705,163708,0,3,2
46706,1,3,163706,163708,163711,2,5,0
46707,5,2,163711,163711,163713,0,2,0
46708,1,1,163712,163713,163714,1,2,0
46709,1,3,163713,163714,163717,1,4,0
46710,4,2,163717,163717,163719,0,2,0
46711,6,1,163723,163723,163724,0,1,4
46712,2,2,163725,163725,163727,0,2,1
46713,6,3,163731,163731,163734,0,3,4
46714,1,1,163732,163734,163735,2,3,0
46715,5,1,163737,163737,163738,0,1,2
46716,6,3,163743,163743,163746,0,3,5
46717,1,3,163744,163746,163749,2,5,0
46718,5,1,163749,163749,163750,0,1,0
46719,2,2,163751,163751,163753,0,2,1
46720,2,3,163753,163753,163756,0,3,0
46721,5,2,163758,163758,163760,0,2,2
46722,1,1,163759,163760,163761,1,2,0
46723,2,2,163761,163761,163763,0,2,0
46724,2,1,163763,163763,163764,0,1,0
46725,5,2,163768,163768,163770,0,2,4
46726,6,3,163774,163774,163777,0,3,4
46727,4,1,163778,163778,163779,0,1,1
46728,6,1,163784,163784,163785,0,1,5
46729,4,2,163788,163788,163790,0,2,3
46730,2,3,163790,163790,163793,0,3,0
46731,5,3,163795,163795,163798,0,3,2
46732,5,2,163800,163800,163802,0,2,2
46733,6,3,163806,163806,163809,0,3,4
46734,1,1,163807,163809,163810,2,3,0
46735,2,1,163809,163810,163811,1,2,0
46736,3,1,163812,163812,163813,0,1,1
46737,4,2,163816,163816,163818,0,2,3
46738,3,2,163819,163819,163821,0,2,1
46739,5,1,163824,163824,163825,0,1,3
46740,6,2,163830,163830,163832,0,2,5
46741,4,3,163834,163834,163837,0,3,2
46742,5,3,163839,163839,163842,0,3,2
46743,5,3,163844,163844,163847,0,3,2
46744,6,3,163850,163850,163853,0,3,3
46745,5,1,163855,163855,163856,0,1,2
46746,4,1,163859,163859,163860,0,1,3
46747,1,3,163860,163860,163863,0,3,0
46748,4,1,163864,163864,163865,0,1,1
46749,5,1,163869,163869,163870,0,1,4
46750,6,3,163875,163875,163878,0,3,5
46751,2,2,163877,163878,163880,1,3,0
46752,1,2,163878,163880,163882,2,4,0
46753,6,2,163884,163884,163886,0,2,2
46754,6,2,163890,163890,163892,0,2,4
46755,5,3,163895,163895,163898,0,3,3
46756,5,1,163900,163900,163901,0,1,2
46757,2,3,163902,163902,163905,0,3,1
46758,5,3,163907,163907,163910,0,3,2
46759,1,3,163908,163910,163913,2,5,0
46760,2,2,163910,163913,163915,3,5,0
46761,5,1,163915,163915,163916,0,1,0
46762,1,2,163916,163916,163918,0,2,0
46763,4,2,163920,163920,163922,0,2,2
46764,4,1,163924,163924,163925,0,1,2
46765,4,1,163928,163928,163929,0,1,3
46766,4,1,163932,163932,163933,0,1,3
46767,1,2,163933,163933,163935,0,2,0
46768,2,2,163935,163935,163937,0,2,0
46769,4,3,163939,163939,163942,0,3,2
46770,1,3,163940,163942,163945,2,5,0
46771,5,3,163945,163945,163948,0,3,0
46772,6,1,163951,163951,163952,0,1,3
46773,6,3,163957,163957,163960,0,3,5
46774,5,1,163962,163962,163963,0,1,2
46775,2,1,163964,163964,163965,0,1,1
46776,3,1,163967,163967,163968,0,1,2
46777,4,1,163971,163971,163972,0,1,3
46778,1,3,163972,163972,163975,0,3,0
46779,2,1,163974,163975,163976,1,2,0
46780,2,2,163976,163976,163978,0,2,0
46781,2,2,163978,163978,163980,0,2,0
46782,4,2,163982,163982,163984,0,2,2
46783,5,2,163987,163987,163989,0,2,3
46784,6,1,163993,163993,163994,0,1,4
46785,5,3,163998,163998,164001,0,3,4
46786,3,2,164001,164001,164003,0,2,0
46787,2,1,164003,164003,164004,0,1,0
46788,6,1,164009,164009,164010,0,1,5
46789,6,3,164015,164015,164018,0,3,5
46790,1,3,164016,164018,164021,2,5,0
46791,2,2,164018,164021,164023,3,5,0
46792,3,3,164021,164023,164026,2,5,0
46793,3,2,164024,164026,164028,2,4,0
46794,5,2,164029,164029,164031,0,2,1
46795,5,2,164034,164034,164036,0,2,3
46796,2,2,164036,164036,164038,0,2,0
46797,1,2,164037,164038,164040,1,3,0
46798,5,3,164042,164042,164045,0,3,2
46799,2,3,164044,164045,164048,1,4,0
46800,1,2,164045,164048,164050,3,5,0
46801,6,2,164051,164051,164053,0,2,1
46802,3,1,164054,164054,164055,0,1,1
46803,2,1,164056,164056,164057,0,1,1
46804,3,1,164059,164059,164060,0,1,2
46805,1,3,164060,164060,164063,0,3,0
46806,4,3,164064,164064,164067,0,3,1
46807,4,3,164068,164068,164071,0,3,1
46808,3,3,164071,164071,164074,0,3,0
46809,6,2,164077,164077,164079,0,2,3
46810,6,2,164083,164083,164085,0,2,4
46811,1,2,164084,164085,164087,1,3,0
46812,1,1,164085,164087,164088,2,3,0
46813,1,2,164086,164088,164090,2,4,0
46814,1,1,164087,164090,164091,3,4,0
46815,2,3,164089,164091,164094,2,5,0
46816,5,1,164094,164094,164095,0,1,0
46817,6,2,164100,164100,164102,0,2,5
46818,6,1,164106,164106,164107,0,1,4
46819,3,1,164109,164109,164110,0,1,2
46820,6,3,164115,164115,164118,0,3,5
46821,2,1,164117,164118,164119,1,2,0
46822,4,1,164121,164121,164122,0,1,2
46823,4,1,164125,164125,164126,0,1,3
46824,6,2,164131,164131,164133,0,2,5
46825,2,1,164133,164133,164134,0,1,0
46826,2,1,164135,164135,164136,0,1,1
46827,3,2,164138,164138,164140,0,2,2
46828,6,1,164144,164144,164145,0,1,4
46829,3,1,164147,164147,164148,0,1,2
46830,3,1,164150,164150,164151,0,1,2
46831,1,2,164151,164151,164153,0,2,0
46832,4,1,164155,164155,164156,0,1,2
46833,3,2,164158,164158,164160,0,2,2
46834,3,2,164161,164161,164163,0,2,1
46835,3,1,164164,164164,164165,0,1,1
46836,6,3,164170,164170,164173,0,3,5
46837,6,3,164176,164176,164179,0,3,3
46838,5,2,164181,164181,164183,0,2,2
46839,1,1,164182,164183,164184,1,2,0
46840,3,1,164185,164185,164186,0,1,1
46841,1,3,164186,164186,164189,0,3,0
46842,5,1,164191,164191,164192,0,1,2
46843,6,2,164197,164197,164199,0,2,5
46844,3,2,164200,164200,164202,0,2,1
46845,3,1,164203,164203,164204,0,1,1
46846,2,1,164205,164205,164206,0,1,1
46847,3,2,164208,164208,164210,0,2,2
46848,6,2,164214,164214,164216,0,2,4
46849,2,3,164216,164216,164219,0,3,0
46850,1,2,164217,164219,164221,2,4,0
46851,5,2,164222,164222,164224,0,2,1
46852,5,2,164227,164227,164229,0,2,3
46853,4,1,164231,164231,164232,0,1,2
46854,4,3,164235,164235,164238,0,3,3
46855,6,3,164241,164241,164244,0,3,3
46856,4,2,164245,164245,164247,0,2,1
46857,5,3,164250,164250,164253,0,3,3
46858,3,1,164253,164253,164254,0,1,0
46859,1,1,164254,164254,164255,0,1,0
46860,2,1,164256,164256,164257,0,1,1
46861,4,2,164260,164260,164262,0,2,3
46862,2,1,164262,164262,164263,0,1,0
46863,3,3,164265,164265,164268,0,3,2
46864,1,3,164266,164268,164271,2,5,0
46865,2,3,164268,164271,164274,3,6,0
46866,1,1,164269,164274,164275,5,6,0
46867,4,1,164273,164275,164276,2,3,0
46868,5,3,164278,164278,164281,0,3,2
46869,5,1,164283,164283,164284,0,1,2
46870,6,2,164289,164289,164291,0,2,5
46871,1,3,164290,164291,164294,1,4,0
46872,2,3,164292,164294,164297,2,5,0
46873,6,1,164298,164298,164299,0,1,1
46874,4,1,164302,164302,164303,0,1,3
46875,1,1,164303,164303,164304,0,1,0
46876,2,2,164305,164305,164307,0,2,1
46877,5,2,164310,164310,164312,0,2,3
46878,1,3,164311,164312,164315,1,4,0
46879,1,1,164312,164315,164316,3,4,0
46880,1,2,164313,164316,164318,3,5,0
46881,1,2,164314,164318,164320,4,6,0
46882,3,1,164317,164320,164321,3,4,0
46883,2,1,164319,164321,164322,2,3,0
46884,5,1,164324,164324,164325,0,1,2
46885,1,2,164325,164325,164327,0,2,0
46886,4,2,164329,164329,164331,0,2,2
46887,4,3,164333,164333,164336,0,3,2
46888,5,2,164338,164338,164340,0,2,2
46889,4,1,164342,164342,164343,0,1,2
46890,1,2,164343,164343,164345,0,2,0
46891,3,1,164346,164346,164347,0,1,1
46892,5,2,164351,164351,164353,0,2,4
46893,6,3,164357,164357,164360,0,3,4
46894,4,3,164361,164361,164364,0,3,1
46895,5,1,164366,164366,164367,0,1,2
46896,2,1,164368,164368,164369,0,1,1
46897,3,1,164371,164371,164372,0,1,2
46898,4,1,164375,164375,164376,0,1,3
46899,3,3,164378,164378,164381,0,3,2
46900,2,2,164380,164381,164383,1,3,0
46901,3,3,164383,164383,164386,0,3,0
46902,4,3,164387,164387,164390,0,3,1
46903,2,2,164389,164390,164392,1,3,0
46904,2,1,164391,164392,164393,1,2,0
46905,1,2,164392,164393,164395,1,3,0
46906,2,3,164394,164395,164398,1,4,0
46907,1,1,164395,164398,164399,3,4,0
46908,4,2,164399,164399,164401,0,2,0
46909,3,3,164402,164402,164405,0,3,1
46910,5,1,164407,164407,164408,0,1,2
46911,1,3,164408,164408,164411,0,3,0
46912,1,2,164409,164411,164413,2,4,0
46913,3,1,164412,164413,164414,1,2,0
46914,3,2,164415,164415,164417,0,2,1
46915,2,3,164417,164417,164420,0,3,0
46916,3,1,164420,164420,164421,0,1,0
46917,3,3,164423,164423,164426,0,3,2
46918,1,1,164424,164426,164427,2,3,0
46919,3,3,164427,164427,164430,0,3,0
46920,2,3,164429,164430,164433,1,4,0
46921,6,3,164435,164435,164438,0,3,2
46922,2,1,164437,164438,164439,1,2,0
46923,3,2,164440,164440,164442,0,2,1
46924,6,2,164446,164446,164448,0,2,4
46925,1,3,164447,164448,164451,1,4,0
46926,3,1,164450,164451,164452,1,2,0
46927,3,2,164453,164453,164455,0,2,1
46928,5,1,164458,164458,164459,0,1,3
46929,3,3,164461,164461,164464,0,3,2
46930,4,3,164465,164465,164468,0,3,1
46931,2,3,164467,164468,164471,1,4,0
46932,4,3,164471,164471,164474,0,3,0
46933,6,3,164477,164477,164480,0,3,3
46934,2,3,164479,164480,164483,1,4,0
46935,1,3,164480,164483,164486,3,6,0
46936,1,1,164481,164486,164487,5,6,0
46937,4,1,164485,164487,164488,2,3,0
46938,5,3,164490,164490,164493,0,3,2
46939,2,2,164492,164493,164495,1,3,0
46940,2,2,164494,164495,164497,1,3,0
46941,4,1,164498,164498,164499,0,1,1
46942,6,3,164504,164504,164507,0,3,5
46943,6,1,164510,164510,164511,0,1,3
46944,3,3,164513,164513,164516,0,3,2
46945,2,2,164515,164516,164518,1,3,0
46946,3,3,164518,164518,164521,0,3,0
46947,2,3,164520,164521,164524,1,4,0
46948,1,1,164521,164524,164525,3,4,0
46949,1,2,164522,164525,164527,3,5,0
46950,3,2,164525,164527,164529,2,4,0
46951,6,2,164531,164531,164533,0,2,2
46952,4,3,164535,164535,164538,0,3,2
46953,6,3,164541,164541,164544,0,3,3
46954,2,1,164543,164544,164545,1,2,0
46955,6,1,164549,164549,164550,0,1,4
46956,4,1,164553,164553,164554,0,1,3
46957,5,1,164558,164558,164559,0,1,4
46958,4,2,164562,164562,164564,0,2,3
46959,1,1,164563,164564,164565,1,2,0
46960,3,1,164566,164566,164567,0,1,1
46961,4,3,164570,164570,164573,0,3,3
46962,6,1,164576,164576,164577,0,1,3
46963,5,3,164581,164581,164584,0,3,4
46964,6,2,164587,164587,164589,0,2,3
46965,1,3,164588,164589,164592,1,4,0
46966,3,2,164591,164592,164594,1,3,0
46967,3,2,164594,164594,164596,0,2,0
46968,2,2,164596,164596,164598,0,2,0
46969,5,3,164601,164601,164604,0,3,3
46970,6,2,164607,164607,164609,0,2,3
46971,1,1,164608,164609,164610,1,2,0
46972,5,3,164613,164613,164616,0,3,3
46973,6,1,164619,164619,164620,0,1,3
46974,4,1,164623,164623,164624,0,1,3
46975,2,3,164625,164625,164628,0,3,1
46976,3,2,164628,164628,164630,0,2,0
46977,2,2,164630,164630,164632,0,2,0
46978,6,3,164636,164636,164639,0,3,4
46979,5,2,164641,164641,164643,0,2,2
46980,1,1,164642,164643,164644,1,2,0
46981,4,3,164646,164646,164649,0,3,2
46982,3,3,164649,164649,164652,0,3,0
46983,2,3,164651,164652,164655,1,4,0
46984,2,2,164653,164655,164657,2,4,0
46985,4,2,164657,164657,164659,0,2,0
46986,6,3,164663,164663,164666,0,3,4
46987,6,2,164669,164669,164671,0,2,3
46988,6,1,164675,164675,164676,0,1,4
46989,3,3,164678,164678,164681,0,3,2
46990,3,2,164681,164681,164683,0,2,0
46991,3,1,164684,164684,164685,0,1,1
46992,6,3,164690,164690,164693,0,3,5
46993,1,1,164691,164693,164694,2,3,0
46994,3,3,164694,164694,164697,0,3,0
46995,6,3,164700,164700,164703,0,3,3
46996,1,1,164701,164703,164704,2,3,0
46997,2,1,164703,164704,164705,1,2,0
46998,2,2,164705,164705,164707,0,2,0
46999,1,2,164706,164707,164709,1,3,0
47000,6,3,164712,164712,164715,0,3,3
47001,2,2,164714,164715,164717,1,3,0
47002,4,3,164718,164718,164721,0,3,1
47003,4,3,164722,164722,164725,0,3,1
47004,6,3,164728,164728,164731,0,3,3
47005,3,3,164731,164731,164734,0,3,0
47006,4,3,164735,164735,164738,0,3,1
47007,5,2,164740,164740,164742,0,2,2
47008,1,3,164741,164742,164745,1,4,0
47009,4,1,164745,164745,164746,0,1,0
47010,3,1,164748,164748,164749,0,1,2
47011,1,3,164749,164749,164752,0,3,0
47012,2,2,164751,164752,164754,1,3,0
47013,6,3,164757,164757,164760,0,3,3
47014,3,1,164760,164760,164761,0,1,0
47015,5,1,164765,164765,164766,0,1,4
47016,2,2,164767,164767,164769,0,2,1
47017,1,2,164768,164769,164771,1,3,0
47018,6,3,164774,164774,164777,0,3,3
47019,6,1,164780,164780,164781,0,1,3
47020,1,3,164781,164781,164784,0,3,0
47021,2,2,164783,164784,164786,1,3,0
47022,4,3,164787,164787,164790,0,3,1
47023,2,2,164789,164790,164792,1,3,0
47024,1,3,164790,164792,164795,2,5,0
47025,3,2,164793,164795,164797,2,4,0
47026,3,1,164796,164797,164798,1,2,0
47027,2,3,164798,164798,164801,0,3,0
47028,6,3,164804,164804,164807,0,3,3
47029,5,3,164809,164809,164812,0,3,2
47030,3,1,164812,164812,164813,0,1,0
47031,5,3,164817,164817,164820,0,3,4
47032,3,3,164820,164820,164823,0,3,0
47033,4,3,164824,164824,164827,0,3,1
47034,2,2,164826,164827,164829,1,3,0
47035,2,3,164828,164829,164832,1,4,0
47036,4,3,164832,164832,164835,0,3,0
47037,3,2,164835,164835,164837,0,2,0
47038,6,3,164841,164841,164844,0,3,4
47039,6,1,164847,164847,164848,0,1,3
47040,6,2,164853,164853,164855,0,2,5
47041,3,3,164856,164856,164859,0,3,1
47042,4,1,164860,164860,164861,0,1,1
47043,2,2,164862,164862,164864,0,2,1
47044,5,3,164867,164867,164870,0,3,3
47045,3,2,164870,164870,164872,0,2,0
47046,2,2,164872,164872,164874,0,2,0
47047,5,3,164877,164877,164880,0,3,3
47048,6,1,164883,164883,164884,0,1,3
47049,5,2,164888,164888,164890,0,2,4
47050,5,3,164893,164893,164896,0,3,3
47051,3,2,164896,164896,164898,0,2,0
47052,1,2,164897,164898,164900,1,3,0
47053,2,3,164899,164900,164903,1,4,0
47054,6,3,164905,164905,164908,0,3,2
47055,1,3,164906,164908,164911,2,5,0
47056,1,2,164907,164911,164913,4,6,0
47057,6,2,164913,164913,164915,0,2,0
47058,4,2,164917,164917,164919,0,2,2
47059,2,2,164919,164919,164921,0,2,0
47060,4,2,164923,164923,164925,0,2,2
47061,5,1,164928,164928,164929,0,1,3
47062,6,3,164934,164934,164937,0,3,5
47063,6,3,164940,164940,164943,0,3,3
47064,1,1,164941,164943,164944,2,3,0
47065,1,2,164942,164944,164946,2,4,0
47066,2,2,164944,164946,164948,2,4,0
47067,5,3,164949,164949,164952,0,3,1
47068,3,1,164952,164952,164953,0,1,0
47069,6,1,164958,164958,164959,0,1,5
47070,6,1,164964,164964,164965,0,1,5
47071,3,1,164967,164967,164968,0,1,2
47072,1,1,164968,164968,164969,0,1,0
47073,6,3,164974,164974,164977,0,3,5
47074,2,1,164976,164977,164978,1,2,0
47075,4,1,164980,164980,164981,0,1,2
47076,1,1,164981,164981,164982,0,1,0
47077,1,3,164982,164982,164985,0,3,0
47078,4,3,164986,164986,164989,0,3,1
47079,6,1,164992,164992,164993,0,1,3
47080,5,1,164997,164997,164998,0,1,4
47081,2,3,164999,164999,165002,0,3,1
47082,1,3,165000,165002,165005,2,5,0
47083,6,2,165006,165006,165008,0,2,1
47084,2,2,165008,165008,165010,0,2,0
47085,5,2,165013,165013,165015,0,2,3
47086,6,1,165019,165019,165020,0,1,4
47087,5,1,165024,165024,165025,0,1,4
47088,1,2,165025,165025,165027,0,2,0
47089,3,2,165028,165028,165030,0,2,1
47090,1,3,165029,165030,165033,1,4,0
47091,4,3,165033,165033,165036,0,3,0
47092,1,1,165034,165036,165037,2,3,0
47093,2,2,165036,165037,165039,1,3,0
47094,6,1,165042,165042,165043,0,1,3
47095,2,3,165044,165044,165047,0,3,1
47096,2,2,165046,165047,165049,1,3,0
47097,4,3,165050,165050,165053,0,3,1
47098,3,3,165053,165053,165056,0,3,0
47099,3,3,165056,165056,165059,0,3,0
47100,4,2,165060,165060,165062,0,2,1
47101,1,3,165061,165062,165065,1,4,0
47102,6,2,165067,165067,165069,0,2,2
47103,6,1,165073,165073,165074,0,1,4
47104,2,2,165075,165075,165077,0,2,1
47105,3,1,165078,165078,165079,0,1,1
47106,1,3,165079,165079,165082,0,3,0
47107,4,3,165083,165083,165086,0,3,1
47108,1,2,165084,165086,165088,2,4,0
47109,6,3,165090,165090,165093,0,3,2
47110,5,3,165095,165095,165098,0,3,2
47111,3,2,165098,165098,165100,0,2,0
47112,5,1,165103,165103,165104,0,1,3
47113,5,3,165108,165108,165111,0,3,4
47114,6,3,165114,165114,165117,0,3,3
47115,1,2,165115,165117,165119,2,4,0
47116,3,2,165118,165119,165121,1,3,0
47117,3,3,165121,165121,165124,0,3,0
47118,1,1,165122,165124,165125,2,3,0
47119,5,2,165127,165127,165129,0,2,2
47120,3,2,165130,165130,165132,0,2,1
47121,5,1,165135,165135,165136,0,1,3
47122,2,1,165137,165137,165138,0,1,1
47123,5,3,165142,165142,165145,0,3,4
47124,5,1,165147,165147,165148,0,1,2
47125,3,2,165150,165150,165152,0,2,2
47126,6,3,165156,165156,165159,0,3,4
47127,6,2,165162,165162,165164,0,2,3
47128,3,1,165165,165165,165166,0,1,1
47129,3,3,165168,165168,165171,0,3,2
47130,3,2,165171,165171,165173,0,2,0
47131,2,2,165173,165173,165175,0,2,0
47132,3,2,165176,165176,165178,0,2,1
47133,1,3,165177,165178,165181,1,4,0
47134,1,2,165178,165181,165183,3,5,0
47135,2,3,165180,165183,165186,3,6,0
47136,3,1,165183,165186,165187,3,4,0
47137,2,1,165185,165187,165188,2,3,0
47138,2,1,165187,165188,165189,1,2,0
47139,3,1,165190,165190,165191,0,1,1
47140,2,2,165192,165192,165194,0,2,1
47141,2,3,165194,165194,165197,0,3,0
47142,2,1,165196,165197,165198,1,2,0
47143,2,1,165198,165198,165199,0,1,0
47144,3,1,165201,165201,165202,0,1,2
47145,6,2,165207,165207,165209,0,2,5
47146,5,1,165212,165212,165213,0,1,3
47147,4,2,165216,165216,165218,0,2,3
47148,3,1,165219,165219,165220,0,1,1
47149,3,2,165222,165222,165224,0,2,2
47150,3,1,165225,165225,165226,0,1,1
47151,1,1,165226,165226,165227,0,1,0
47152,6,3,165232,165232,165235,0,3,5
47153,2,1,165234,165235,165236,1,2,0
47154,1,1,165235,165236,165237,1,2,0
47155,1,1,165236,165237,165238,1,2,0
47156,3,1,165239,165239,165240,0,1,1
47157,5,3,165244,165244,165247,0,3,4
47158,4,3,165248,165248,165251,0,3,1
47159,1,3,165249,165251,165254,2,5,0
47160,4,1,165253,165254,165255,1,2,0
47161,3,3,165256,165256,165259,0,3,1
47162,4,1,165260,165260,165261,0,1,1
47163,5,1,165265,165265,165266,0,1,4
47164,2,3,165267,165267,165270,0,3,1
47165,6,2,165273,165273,165275,0,2,3
47166,4,2,165277,165277,165279,0,2,2
47167,1,1,165278,165279,165280,1,2,0
47168,3,3,165281,165281,165284,0,3,1
47169,2,2,165283,165284,165286,1,3,0
47170,5,1,165288,165288,165289,0,1,2
47171,4,1,165292,165292,165293,0,1,3
47172,5,2,165297,165297,165299,0,2,4
47173,3,1,165300,165300,165301,0,1,1
47174,2,3,165302,165302,165305,0,3,1
47175,6,3,165308,165308,165311,0,3,3
47176,2,2,165310,165311,165313,1,3,0
47177,5,1,165315,165315,165316,0,1,2
47178,2,1,165317,165317,165318,0,1,1
47179,2,3,165319,165319,165322,0,3,1
47180,2,2,165321,165322,165324,1,3,0
47181,4,2,165325,165325,165327,0,2,1
47182,6,2,165331,165331,165333,0,2,4
47183,6,3,165337,165337,165340,0,3,4
47184,3,2,165340,165340,165342,0,2,0
47185,3,1,165343,165343,165344,0,1,1
47186,4,3,165347,165347,165350,0,3,3
47187,5,2,165352,165352,165354,0,2,2
47188,4,2,165356,165356,165358,0,2,2
47189,5,2,165361,165361,165363,0,2,3
47190,5,3,165366,165366,165369,0,3,3
47191,4,3,165370,165370,165373,0,3,1
47192,5,1,165375,165375,165376,0,1,2
47193,6,2,165381,165381,165383,0,2,5
47194,5,3,165386,165386,165389,0,3,3
47195,2,2,165388,165389,165391,1,3,0
47196,6,3,165394,165394,165397,0,3,3
47197,4,3,165398,165398,165401,0,3,1
47198,3,2,165401,165401,165403,0,2,0
47199,6,3,165407,165407,165410,0,3,4
47200,1,2,165408,165410,165412,2,4,0
47201,4,1,165412,165412,165413,0,1,0
47202,5,1,165417,165417,165418,0,1,4
47203,4,1,165421,165421,165422,0,1,3
47204,4,1,165425,165425,165426,0,1,3
47205,6,1,165431,165431,165432,0,1,5
47206,4,1,165435,165435,165436,0,1,3
47207,5,3,165440,165440,165443,0,3,4
47208,5,3,165445,165445,165448,0,3,2
47209,2,3,165447,165448,165451,1,4,0
47210,1,3,165448,165451,165454,3,6,0
47211,4,1,165452,165454,165455,2,3,0
47212,5,3,165457,165457,165460,0,3,2
47213,5,2,165462,165462,165464,0,2,2
47214,6,3,165468,165468,165471,0,3,4
47215,1,1,165469,165471,165472,2,3,0
47216,6,2,165475,165475,165477,0,2,3
47217,3,3,165478,165478,165481,0,3,1
47218,5,1,165483,165483,165484,0,1,2
47219,2,1,165485,165485,165486,0,1,1
47220,2,3,165487,165487,165490,0,3,1
47221,1,3,165488,165490,165493,2,5,0
47222,5,2,165493,165493,165495,0,2,0
47223,1,2,165494,165495,165497,1,3,0
47224,3,2,165497,165497,165499,0,2,0
47225,2,1,165499,165499,165500,0,1,0
47226,2,1,165501,165501,165502,0,1,1
47227,4,1,165505,165505,165506,0,1,3
47228,1,2,165506,165506,165508,0,2,0
47229,2,1,165508,165508,165509,0,1,0
47230,5,3,165513,165513,165516,0,3,4
47231,3,2,165516,165516,165518,0,2,0
47232,1,3,165517,165518,165521,1,4,0
47233,1,1,165518,165521,165522,3,4,0
47234,3,3,165521,165522,165525,1,4,0
47235,1,2,165522,165525,165527,3,5,0
47236,1,3,165523,165527,165530,4,7,0
47237,2,2,165525,165530,165532,5,7,0
47238,6,3,165531,165532,165535,1,4,0
47239,3,1,165534,165535,165536,1,2,0
47240,1,3,165535,165536,165539,1,4,0
47241,6,2,165541,165541,165543,0,2,2
47242,2,3,165543,165543,165546,0,3,0
47243,2,1,165545,165546,165547,1,2,0
47244,4,2,165549,165549,165551,0,2,2
47245,3,3,165552,165552,165555,0,3,1
47246,3,1,165555,165555,165556,0,1,0
47247,4,2,165559,165559,165561,0,2,3
47248,1,1,165560,165561,165562,1,2,0
47249,2,3,165562,165562,165565,0,3,0
47250,1,3,165563,165565,165568,2,5,0
47251,4,3,165567,165568,165571,1,4,0
47252,5,3,165572,165572,165575,0,3,1
47253,5,3,165577,165577,165580,0,3,2
47254,4,3,165581,165581,165584,0,3,1
47255,2,3,165583,165584,165587,1,4,0
47256,3,1,165586,165587,165588,1,2,0
47257,3,1,165589,165589,165590,0,1,1
47258,3,1,165592,165592,165593,0,1,2
47259,4,2,165596,165596,165598,0,2,3
47260,5,2,165601,165601,165603,0,2,3
47261,4,2,165605,165605,165607,0,2,2
47262,4,1,165609,165609,165610,0,1,2
47263,3,2,165612,165612,165614,0,2,2
47264,5,2,165617,165617,165619,0,2,3
47265,6,2,165623,165623,165625,0,2,4
47266,6,1,165629,165629,165630,0,1,4
47267,4,2,165633,165633,165635,0,2,3
47268,3,2,165636,165636,165638,0,2,1
47269,1,1,165637,165638,165639,1,2,0
47270,6,1,165643,165643,165644,0,1,4
47271,4,1,165647,165647,165648,0,1,3
47272,4,1,165651,165651,165652,0,1,3
47273,2,1,165653,165653,165654,0,1,1
47274,5,1,165658,165658,165659,0,1,4
47275,3,3,165661,165661,165664,0,3,2
47276,6,1,165667,165667,165668,0,1,3
47277,5,1,165672,165672,165673,0,1,4
47278,3,3,165675,165675,165678,0,3,2
47279,2,1,165677,165678,165679,1,2,0
47280,2,3,165679,165679,165682,0,3,0
47281,4,2,165683,165683,165685,0,2,1
47282,6,3,165689,165689,165692,0,3,4
47283,1,2,165690,165692,165694,2,4,0
47284,1,1,165691,165694,165695,3,4,0
47285,1,2,165692,165695,165697,3,5,0
47286,6,2,165698,165698,165700,0,2,1
47287,6,3,165704,165704,165707,0,3,4
47288,5,3,165709,165709,165712,0,3,2
47289,4,2,165713,165713,165715,0,2,1
47290,2,3,165715,165715,165718,0,3,0
47291,3,2,165718,165718,165720,0,2,0
47292,5,1,165723,165723,165724,0,1,3
47293,2,3,165725,165725,165728,0,3,1
47294,5,1,165730,165730,165731,0,1,2
47295,5,1,165735,165735,165736,0,1,4
47296,3,1,165738,165738,165739,0,1,2
47297,3,3,165741,165741,165744,0,3,2
47298,2,1,165743,165744,165745,1,2,0
47299,4,3,165747,165747,165750,0,3,2
47300,3,1,165750,165750,165751,0,1,0
47301,4,2,165754,165754,165756,0,2,3
47302,1,1,165755,165756,165757,1,2,0
47303,4,2,165759,165759,165761,0,2,2
47304,4,3,165763,165763,165766,0,3,2
47305,6,3,165769,165769,165772,0,3,3
47306,3,2,165772,165772,165774,0,2,0
47307,6,2,165778,165778,165780,0,2,4
47308,3,2,165781,165781,165783,0,2,1
47309,6,3,165787,165787,165790,0,3,4
47310,4,1,165791,165791,165792,0,1,1
47311,2,3,165793,165793,165796,0,3,1
47312,1,3,165794,165796,165799,2,5,0
47313,6,2,165800,165800,165802,0,2,1
47314,3,2,165803,165803,165805,0,2,1
47315,4,1,165807,165807,165808,0,1,2
47316,5,3,165812,165812,165815,0,3,4
47317,6,1,165818,165818,165819,0,1,3
47318,2,2,165820,165820,165822,0,2,1
47319,2,2,165822,165822,165824,0,2,0
47320,5,3,165827,165827,165830,0,3,3
47321,3,1,165830,165830,165831,0,1,0
47322,3,2,165833,165833,165835,0,2,2
47323,4,1,165837,165837,165838,0,1,2
47324,4,3,165841,165841,165844,0,3,3
47325,4,3,165845,165845,165848,0,3,1
47326,4,3,165849,165849,165852,0,3,1
47327,2,2,165851,165852,165854,1,3,0
47328,4,3,165855,165855,165858,0,3,1
47329,6,3,165861,165861,165864,0,3,3
47330,2,1,165863,165864,165865,1,2,0
47331,3,3,165866,165866,165869,0,3,1
47332,4,3,165870,165870,165873,0,3,1
47333,4,3,165874,165874,165877,0,3,1
47334,1,3,165875,165877,165880,2,5,0
47335,2,3,165877,165880,165883,3,6,0
47336,2,2,165879,165883,165885,4,6,0
47337,3,3,165882,165885,165888,3,6,0
47338,6,3,165888,165888,165891,0,3,0
47339,2,1,165890,165891,165892,1,2,0
47340,3,3,165893,165893,165896,0,3,1
47341,5,3,165898,165898,165901,0,3,2
47342,2,1,165900,165901,165902,1,2,0
47343,2,1,165902,165902,165903,0,1,0
47344,3,1,165905,165905,165906,0,1,2
47345,6,1,165911,165911,165912,0,1,5
47346,6,3,165917,165917,165920,0,3,5
47347,5,3,165922,165922,165925,0,3,2
47348,6,3,165928,165928,165931,0,3,3
47349,4,3,165932,165932,165935,0,3,1
47350,1,1,165933,165935,165936,2,3,0
47351,5,3,165938,165938,165941,0,3,2
47352,1,1,165939,165941,165942,2,3,0
47353,3,3,165942,165942,165945,0,3,0
47354,2,3,165944,165945,165948,1,4,0
47355,6,2,165950,165950,165952,0,2,2
47356,2,3,165952,165952,165955,0,3,0
47357,1,1,165953,165955,165956,2,3,0
47358,6,1,165959,165959,165960,0,1,3
47359,4,2,165963,165963,165965,0,2,3
47360,6,1,165969,165969,165970,0,1,4
47361,3,1,165972,165972,165973,0,1,2
47362,5,2,165977,165977,165979,0,2,4
47363,1,3,165978,165979,165982,1,4,0
47364,6,3,165984,165984,165987,0,3,2
47365,4,3,165988,165988,165991,0,3,1
47366,2,1,165990,165991,165992,1,2,0
47367,6,1,165996,165996,165997,0,1,4
47368,6,2,166002,166002,166004,0,2,5
47369,3,2,166005,166005,166007,0,2,1
47370,6,3,166011,166011,166014,0,3,4
47371,2,3,166013,166014,166017,1,4,0
47372,3,1,166016,166017,166018,1,2,0
47373,1,2,166017,166018,166020,1,3,0
47374,2,2,166019,166020,166022,1,3,0
47375,4,3,166023,166023,166026,0,3,1
47376,3,3,166026,166026,166029,0,3,0
47377,2,1,166028,166029,166030,1,2,0
47378,1,1,166029,166030,166031,1,2,0
47379,3,1,166032,166032,166033,0,1,1
47380,5,2,166037,166037,166039,0,2,4
47381,2,3,166039,166039,166042,0,3,0
47382,4,1,166043,166043,166044,0,1,1
47383,5,1,166048,166048,166049,0,1,4
47384,6,3,166054,166054,166057,0,3,5
47385,2,2,166056,166057,166059,1,3,0
47386,5,1,166061,166061,166062,0,1,2
47387,3,1,166064,166064,166065,0,1,2
47388,2,1,166066,166066,166067,0,1,1
47389,6,3,166072,166072,166075,0,3,5
47390,5,1,166077,166077,166078,0,1,2
47391,6,3,166083,166083,166086,0,3,5
47392,5,3,166088,166088,166091,0,3,2
47393,4,2,166092,166092,166094,0,2,1
47394,6,2,166098,166098,166100,0,2,4
47395,2,1,166100,166100,166101,0,1,0
47396,1,3,166101,166101,166104,0,3,0
47397,6,1,166107,166107,166108,0,1,3
47398,4,1,166111,166111,166112,0,1,3
47399,5,1,166116,166116,166117,0,1,4
47400,4,1,166120,166120,166121,0,1,3
47401,3,3,166123,166123,166126,0,3,2
47402,1,3,166124,166126,166129,2,5,0
47403,1,3,166125,166129,166132,4,7,0
47404,5,1,166130,166132,166133,2,3,0
47405,2,2,166132,166133,166135,1,3,0
47406,3,1,166135,166135,166136,0,1,0
47407,2,2,166137,166137,166139,0,2,1
47408,6,3,166143,166143,166146,0,3,4
47409,6,2,166149,166149,166151,0,2,3
47410,2,2,166151,166151,166153,0,2,0
47411,5,2,166156,166156,166158,0,2,3
47412,4,3,166160,166160,166163,0,3,2
47413,2,3,166162,166163,166166,1,4,0
47414,5,1,166167,166167,166168,0,1,1
47415,1,3,166168,166168,166171,0,3,0
47416,3,3,166171,166171,166174,0,3,0
47417,1,1,166172,166174,166175,2,3,0
47418,6,3,166178,166178,166181,0,3,3
47419,2,3,166180,166181,166184,1,4,0
47420,1,2,166181,166184,166186,3,5,0
47421,2,1,166183,166186,166187,3,4,0
47422,4,2,166187,166187,166189,0,2,0
47423,2,1,166189,166189,166190,0,1,0
47424,1,2,166190,166190,166192,0,2,0
47425,5,1,166195,166195,166196,0,1,3
47426,6,2,166201,166201,166203,0,2,5
47427,1,1,166202,166203,166204,1,2,0
47428,6,2,166208,166208,166210,0,2,4
47429,5,1,166213,166213,166214,0,1,3
47430,6,2,166219,166219,166221,0,2,5
47431,1,3,166220,166221,166224,1,4,0
47432,2,2,166222,166224,166226,2,4,0
47433,5,1,166227,166227,166228,0,1,1
47434,6,2,166233,166233,166235,0,2,5
47435,6,2,166239,166239,166241,0,2,4
47436,5,2,166244,166244,166246,0,2,3
47437,3,3,166247,166247,166250,0,3,1
47438,5,3,166252,166252,166255,0,3,2
47439,6,3,166258,166258,166261,0,3,3
47440,6,3,166264,166264,166267,0,3,3
47441,1,1,166265,166267,166268,2,3,0
47442,4,1,166269,166269,166270,0,1,1
47443,5,3,166274,166274,166277,0,3,4
47444,6,3,166280,166280,166283,0,3,3
47445,4,1,166284,166284,166285,0,1,1
47446,2,3,166286,166286,166289,0,3,1
47447,6,2,166292,166292,166294,0,2,3
47448,6,3,166298,166298,166301,0,3,4
47449,5,2,166303,166303,166305,0,2,2
47450,5,3,166308,166308,166311,0,3,3
47451,4,3,166312,166312,166315,0,3,1
47452,5,1,166317,166317,166318,0,1,2
47453,1,3,166318,166318,166321,0,3,0
47454,6,1,166324,166324,166325,0,1,3
47455,4,2,166328,166328,166330,0,2,3
47456,4,2,166332,166332,166334,0,2,2
47457,3,3,166335,166335,166338,0,3,1
47458,1,2,166336,166338,166340,2,4,0
47459,1,1,166337,166340,166341,3,4,0
47460,4,3,166341,166341,166344,0,3,0
47461,1,3,166342,166344,166347,2,5,0
47462,1,1,166343,166347,166348,4,5,0
47463,2,1,166345,166348,166349,3,4,0
47464,1,2,166346,166349,166351,3,5,0
47465,3,3,166349,166351,166354,2,5,0
47466,3,3,166352,166354,166357,2,5,0
47467,3,3,166355,166357,166360,2,5,0
47468,1,1,166356,166360,166361,4,5,0
47469,1,2,166357,166361,166363,4,6,0
47470,6,1,166363,166363,166364,0,1,0
47471,6,2,166369,166369,166371,0,2,5
47472,2,1,166371,166371,166372,0,1,0
47473,6,1,166377,166377,166378,0,1,5
47474,6,2,166383,166383,166385,0,2,5
47475,6,1,166389,166389,166390,0,1,4
47476,5,1,166394,166394,166395,0,1,4
47477,6,1,166400,166400,166401,0,1,5
47478,6,3,166406,166406,166409,0,3,5
47479,6,3,166412,166412,166415,0,3,3
47480,6,1,166418,166418,166419,0,1,3
47481,3,2,166421,166421,166423,0,2,2
47482,3,1,166424,166424,166425,0,1,1
47483,2,2,166426,166426,166428,0,2,1
47484,4,2,166430,166430,166432,0,2,2
47485,2,2,166432,166432,166434,0,2,0
47486,2,3,166434,166434,166437,0,3,0
47487,4,1,166438,166438,166439,0,1,1
47488,2,3,166440,166440,166443,0,3,1
47489,2,3,166442,166443,166446,1,4,0
47490,5,1,166447,166447,166448,0,1,1
47491,2,2,166449,166449,166451,0,2,1
47492,4,1,166453,166453,166454,0,1,2
47493,6,1,166459,166459,166460,0,1,5
47494,6,2,166465,166465,166467,0,2,5
47495,2,2,166467,166467,166469,0,2,0
47496,5,3,166472,166472,166475,0,3,3
47497,4,3,166476,166476,166479,0,3,1
47498,2,2,166478,166479,166481,1,3,0
47499,6,3,166484,166484,166487,0,3,3
47500,4,2,166488,166488,166490,0,2,1
47501,1,2,166489,166490,166492,1,3,0
47502,6,3,166495,166495,166498,0,3,3
47503,6,3,166501,166501,166504,0,3,3
47504,2,3,166503,166504,166507,1,4,0
47505,4,3,166507,166507,166510,0,3,0
47506,2,2,166509,166510,166512,1,3,0
47507,3,3,166512,166512,166515,0,3,0
47508,5,1,166517,166517,166518,0,1,2
47509,4,3,166521,166521,166524,0,3,3
47510,5,1,166526,166526,166527,0,1,2
47511,6,3,166532,166532,166535,0,3,5
47512,4,2,166536,166536,166538,0,2,1
47513,5,3,166541,166541,166544,0,3,3
47514,4,2,166545,166545,166547,0,2,1
47515,1,2,166546,166547,166549,1,3,0
47516,2,3,166548,166549,166552,1,4,0
47517,2,1,166550,166552,166553,2,3,0
47518,6,1,166556,166556,166557,0,1,3
47519,2,3,166558,166558,166561,0,3,1
47520,3,1,166561,166561,166562,0,1,0
47521,5,3,166566,166566,166569,0,3,4
47522,4,3,166570,166570,166573,0,3,1
47523,4,1,166574,166574,166575,0,1,1
47524,4,2,166578,166578,166580,0,2,3
47525,3,2,166581,166581,166583,0,2,1
47526,3,3,166584,166584,166587,0,3,1
47527,3,1,166587,166587,166588,0,1,0
47528,1,1,166588,166588,166589,0,1,0
47529,2,3,166590,166590,166593,0,3,1
47530,5,3,166595,166595,166598,0,3,2
47531,5,3,166600,166600,166603,0,3,2
47532,3,2,166603,166603,166605,0,2,0
47533,2,3,166605,166605,166608,0,3,0
47534,6,2,166611,166611,166613,0,2,3
47535,3,2,166614,166614,166616,0,2,1
47536,4,1,166618,166618,166619,0,1,2
47537,2,3,166620,166620,166623,0,3,1
47538,3,2,166623,166623,166625,0,2,0
47539,5,1,166628,166628,166629,0,1,3
47540,3,2,166631,166631,166633,0,2,2
47541,2,3,166633,166633,166636,0,3,0
47542,4,2,166637,166637,166639,0,2,1
47543,2,1,166639,166639,166640,0,1,0
47544,6,1,166645,166645,166646,0,1,5
47545,1,1,166646,166646,166647,0,1,0
47546,2,3,166648,166648,166651,0,3,1
47547,4,3,166652,166652,166655,0,3,1
47548,1,2,166653,166655,166657,2,4,0
47549,4,1,166657,166657,166658,0,1,0
47550,1,3,166658,166658,166661,0,3,0
47551,1,1,166659,166661,166662,2,3,0
47552,3,2,166662,166662,166664,0,2,0
47553,4,2,166666,166666,166668,0,2,2
47554,1,1,166667,166668,166669,1,2,0
47555,2,2,166669,166669,166671,0,2,0
47556,6,2,166675,166675,166677,0,2,4
47557,2,2,166677,166677,166679,0,2,0
47558,6,3,166683,166683,166686,0,3,4
47559,6,3,166689,166689,166692,0,3,3
47560,3,1,166692,166692,166693,0,1,0
47561,3,1,166695,166695,166696,0,1,2
47562,5,3,166700,166700,166703,0,3,4
47563,4,1,166704,166704,166705,0,1,1
47564,6,2,166710,166710,166712,0,2,5
47565,1,3,166711,166712,166715,1,4,0
47566,4,2,166715,166715,166717,0,2,0
47567,5,3,166720,166720,166723,0,3,3
47568,6,2,166726,166726,166728,0,2,3
47569,2,1,166728,166728,166729,0,1,0
47570,2,1,166730,166730,166731,0,1,1
47571,1,1,166731,166731,166732,0,1,0
47572,2,1,166733,166733,166734,0,1,1
47573,3,2,166736,166736,166738,0,2,2
47574,5,2,166741,166741,166743,0,2,3
47575,3,2,166744,166744,166746,0,2,1
47576,5,3,166749,166749,166752,0,3,3
47577,5,3,166754,166754,166757,0,3,2
47578,6,1,166760,166760,166761,0,1,3
47579,2,2,166762,166762,166764,0,2,1
47580,5,3,166767,166767,166770,0,3,3
47581,5,3,166772,166772,166775,0,3,2
47582,4,2,166776,166776,166778,0,2,1
47583,6,3,166782,166782,166785,0,3,4
47584,2,3,166784,166785,166788,1,4,0
47585,6,2,166790,166790,166792,0,2,2
47586,6,3,166796,166796,166799,0,3,4
47587,1,2,166797,166799,166801,2,4,0
47588,1,2,166798,166801,166803,3,5,0
47589,2,3,166800,166803,166806,3,6,0
47590,1,1,166801,166806,166807,5,6,0
47591,1,3,166802,166807,166810,5,8,0
47592,2,2,166804,166810,166812,6,8,0
47593,6,3,166810,166812,166815,2,5,0
47594,2,1,166812,166815,166816,3,4,0
47595,2,1,166814,166816,166817,2,3,0
47596,1,3,166815,166817,166820,2,5,0
47597,4,2,166819,166820,166822,1,3,0
47598,5,1,166824,166824,166825,0,1,2
47599,5,2,166829,166829,166831,0,2,4
47600,1,2,166830,166831,166833,1,3,0
47601,4,2,166834,166834,166836,0,2,1
47602,5,2,166839,166839,166841,0,2,3
47603,6,3,166845,166845,166848,0,3,4
47604,6,1,166851,166851,166852,0,1,3
47605,3,3,166854,166854,166857,0,3,2
47606,5,1,166859,166859,166860,0,1,2
47607,4,1,166863,166863,166864,0,1,3
47608,3,3,166866,166866,166869,0,3,2
47609,5,3,166871,166871,166874,0,3,2
47610,4,3,166875,166875,166878,0,3,1
47611,6,2,166881,166881,166883,0,2,3
47612,1,3,166882,166883,166886,1,4,0
47613,2,3,166884,166886,166889,2,5,0
47614,6,2,166890,166890,166892,0,2,1
47615,6,2,166896,166896,166898,0,2,4
47616,2,1,166898,166898,166899,0,1,0
47617,5,1,166903,166903,166904,0,1,4
47618,6,3,166909,166909,166912,0,3,5
47619,3,2,166912,166912,166914,0,2,0
47620,2,1,166914,166914,166915,0,1,0
47621,4,3,166918,166918,166921,0,3,3
47622,2,1,166920,166921,166922,1,2,0
47623,5,1,166925,166925,166926,0,1,3
47624,2,1,166927,166927,166928,0,1,1
47625,3,2,166930,166930,166932,0,2,2
47626,3,3,166933,166933,166936,0,3,1
47627,4,2,166937,166937,166939,0,2,1
47628,6,1,166943,166943,166944,0,1,4
47629,1,3,166944,166944,166947,0,3,0
47630,4,1,166948,166948,166949,0,1,1
47631,1,2,166949,166949,166951,0,2,0
47632,1,1,166950,166951,166952,1,2,0
47633,2,1,166952,166952,166953,0,1,0
47634,5,2,166957,166957,166959,0,2,4
47635,6,3,166963,166963,166966,0,3,4
47636,6,1,166969,166969,166970,0,1,3
47637,2,2,166971,166971,166973,0,2,1
47638,1,1,166972,166973,166974,1,2,0
47639,6,1,166978,166978,166979,0,1,4
47640,2,1,166980,166980,166981,0,1,1
47641,2,1,166982,166982,166983,0,1,1
47642,1,1,166983,166983,166984,0,1,0
47643,4,2,166987,166987,166989,0,2,3
47644,4,2,166991,166991,166993,0,2,2
47645,3,2,166994,166994,166996,0,2,1
47646,6,3,167000,167000,167003,0,3,4
47647,6,2,167006,167006,167008,0,2,3
47648,6,3,167012,167012,167015,0,3,4
47649,3,1,167015,167015,167016,0,1,0
47650,2,2,167017,167017,167019,0,2,1
47651,6,1,167023,167023,167024,0,1,4
47652,3,1,167026,167026,167027,0,1,2
47653,4,3,167030,167030,167033,0,3,3
47654,4,2,167034,167034,167036,0,2,1
47655,4,2,167038,167038,167040,0,2,2
47656,3,2,167041,167041,167043,0,2,1
47657,2,2,167043,167043,167045,0,2,0
47658,3,1,167046,167046,167047,0,1,1
47659,3,3,167049,167049,167052,0,3,2
47660,1,2,167050,167052,167054,2,4,0
47661,3,3,167053,167054,167057,1,4,0
47662,3,2,167056,167057,167059,1,3,0
47663,6,3,167062,167062,167065,0,3,3
47664,4,1,167066,167066,167067,0,1,1
47665,2,2,167068,167068,167070,0,2,1
47666,2,2,167070,167070,167072,0,2,0
47667,3,1,167073,167073,167074,0,1,1
47668,6,2,167079,167079,167081,0,2,5
47669,1,2,167080,167081,167083,1,3,0
47670,1,1,167081,167083,167084,2,3,0
47671,6,3,167087,167087,167090,0,3,3
47672,5,1,167092,167092,167093,0,1,2
47673,6,2,167098,167098,167100,0,2,5
47674,1,3,167099,167100,167103,1,4,0
47675,5,3,167104,167104,167107,0,3,1
47676,3,3,167107,167107,167110,0,3,0
47677,6,3,167113,167113,167116,0,3,3
47678,4,3,167117,167117,167120,0,3,1
47679,5,2,167122,167122,167124,0,2,2
47680,2,2,167124,167124,167126,0,2,0
47681,4,2,167128,167128,167130,0,2,2
47682,3,2,167131,167131,167133,0,2,1
47683,1,3,167132,167133,167136,1,4,0
47684,6,3,167138,167138,167141,0,3,2
47685,4,3,167142,167142,167145,0,3,1
47686,2,3,167144,167145,167148,1,4,0
47687,5,3,167149,167149,167152,0,3,1
47688,3,3,167152,167152,167155,0,3,0
47689,4,2,167156,167156,167158,0,2,1
47690,6,3,167162,167162,167165,0,3,4
47691,2,2,167164,167165,167167,1,3,0
47692,2,2,167166,167167,167169,1,3,0
47693,6,1,167172,167172,167173,0,1,3
47694,6,3,167178,167178,167181,0,3,5
47695,4,3,167182,167182,167185,0,3,1
47696,4,3,167186,167186,167189,0,3,1
47697,5,2,167191,167191,167193,0,2,2
47698,4,2,167195,167195,167197,0,2,2
47699,2,1,167197,167197,167198,0,1,0
47700,1,3,167198,167198,167201,0,3,0
47701,4,1,167202,167202,167203,0,1,1
47702,1,1,167203,167203,167204,0,1,0
47703,6,3,167209,167209,167212,0,3,5
47704,2,3,167211,167212,167215,1,4,0
47705,1,2,167212,167215,167217,3,5,0
47706,5,3,167217,167217,167220,0,3,0
47707,2,1,167219,167220,167221,1,2,0
47708,4,3,167223,167223,167226,0,3,2
47709,1,3,167224,167226,167229,2,5,0
47710,3,1,167227,167229,167230,2,3,0
47711,3,3,167230,167230,167233,0,3,0
47712,2,1,167232,167233,167234,1,2,0
47713,1,1,167233,167234,167235,1,2,0
47714,5,2,167238,167238,167240,0,2,3
47715,4,1,167242,167242,167243,0,1,2
47716,1,2,167243,167243,167245,0,2,0
47717,3,2,167246,167246,167248,0,2,1
47718,1,3,167247,167248,167251,1,4,0
47719,2,2,167249,167251,167253,2,4,0
47720,3,3,167252,167253,167256,1,4,0
47721,3,1,167255,167256,167257,1,2,0
47722,4,1,167259,167259,167260,0,1,2
47723,4,1,167263,167263,167264,0,1,3
47724,6,1,167269,167269,167270,0,1,5
47725,5,1,167274,167274,167275,0,1,4
47726,4,2,167278,167278,167280,0,2,3
47727,4,3,167282,167282,167285,0,3,2
47728,6,2,167288,167288,167290,0,2,3
47729,5,1,167293,167293,167294,0,1,3
47730,2,1,167295,167295,167296,0,1,1
47731,6,3,167301,167301,167304,0,3,5
47732,3,1,167304,167304,167305,0,1,0
47733,6,3,167310,167310,167313,0,3,5
47734,1,1,167311,167313,167314,2,3,0
47735,1,2,167312,167314,167316,2,4,0
47736,3,3,167315,167316,167319,1,4,0
47737,5,3,167320,167320,167323,0,3,1
47738,3,3,167323,167323,167326,0,3,0
47739,5,1,167328,167328,167329,0,1,2
47740,3,3,167331,167331,167334,0,3,2
47741,6,2,167337,167337,167339,0,2,3
47742,1,3,167338,167339,167342,1,4,0
47743,6,1,167344,167344,167345,0,1,2
47744,6,1,167350,167350,167351,0,1,5
47745,1,2,167351,167351,167353,0,2,0
47746,4,2,167355,167355,167357,0,2,2
47747,1,2,167356,167357,167359,1,3,0
47748,1,1,167357,167359,167360,2,3,0
47749,1,1,167358,167360,167361,2,3,0
47750,5,1,167363,167363,167364,0,1,2
47751,3,3,167366,167366,167369,0,3,2
47752,5,2,167371,167371,167373,0,2,2
47753,3,1,167374,167374,167375,0,1,1
47754,5,1,167379,167379,167380,0,1,4
47755,4,3,167383,167383,167386,0,3,3
47756,1,1,167384,167386,167387,2,3,0
47757,2,2,167386,167387,167389,1,3,0
47758,5,2,167391,167391,167393,0,2,2
47759,5,2,167396,167396,167398,0,2,3
47760,1,3,167397,167398,167401,1,4,0
47761,1,3,167398,167401,167404,3,6,0
47762,6,3,167404,167404,167407,0,3,0
47763,5,3,167409,167409,167412,0,3,2
47764,6,3,167415,167415,167418,0,3,3
47765,3,3,167418,167418,167421,0,3,0
47766,2,3,167420,167421,167424,1,4,0
47767,4,1,167424,167424,167425,0,1,0
47768,3,3,167427,167427,167430,0,3,2
47769,6,1,167433,167433,167434,0,1,3
47770,1,2,167434,167434,167436,0,2,0
47771,3,2,167437,167437,167439,0,2,1
47772,2,1,167439,167439,167440,0,1,0
47773,4,2,167443,167443,167445,0,2,3
47774,3,3,167446,167446,167449,0,3,1
47775,3,2,167449,167449,167451,0,2,0
47776,6,2,167455,167455,167457,0,2,4
47777,1,2,167456,167457,167459,1,3,0
47778,5,2,167461,167461,167463,0,2,2
47779,6,1,167467,167467,167468,0,1,4
47780,3,3,167470,167470,167473,0,3,2
47781,4,2,167474,167474,167476,0,2,1
47782,1,3,167475,167476,167479,1,4,0
47783,1,1,167476,167479,167480,3,4,0
47784,3,1,167479,167480,167481,1,2,0
47785,4,3,167483,167483,167486,0,3,2
47786,3,1,167486,167486,167487,0,1,0
47787,1,1,167487,167487,167488,0,1,0
47788,2,2,167489,167489,167491,0,2,1
47789,5,1,167494,167494,167495,0,1,3
47790,2,1,167496,167496,167497,0,1,1
47791,3,2,167499,167499,167501,0,2,2
47792,3,1,167502,167502,167503,0,1,1
47793,2,2,167504,167504,167506,0,2,1
47794,6,2,167510,167510,167512,0,2,4
47795,6,3,167516,167516,167519,0,3,4
47796,6,1,167522,167522,167523,0,1,3
47797,6,1,167528,167528,167529,0,1,5
47798,3,1,167531,167531,167532,0,1,2
47799,2,1,167533,167533,167534,0,1,1
47800,1,1,167534,167534,167535,0,1,0
47801,5,1,167539,167539,167540,0,1,4
47802,3,2,167542,167542,167544,0,2,2
47803,5,3,167547,167547,167550,0,3,3
47804,3,1,167550,167550,167551,0,1,0
47805,3,3,167553,167553,167556,0,3,2
47806,6,1,167559,167559,167560,0,1,3
47807,1,3,167560,167560,167563,0,3,0
47808,2,2,167562,167563,167565,1,3,0
47809,1,2,167563,167565,167567,2,4,0
47810,3,2,167566,167567,167569,1,3,0
47811,3,2,167569,167569,167571,0,2,0
47812,2,1,167571,167571,167572,0,1,0
47813,2,1,167573,167573,167574,0,1,1
47814,6,1,167579,167579,167580,0,1,5
47815,2,1,167581,167581,167582,0,1,1
47816,1,1,167582,167582,167583,0,1,0
47817,2,3,167584,167584,167587,0,3,1
47818,3,3,167587,167587,167590,0,3,0
47819,3,1,167590,167590,167591,0,1,0
47820,2,1,167592,167592,167593,0,1,1
47821,3,3,167595,167595,167598,0,3,2
47822,1,3,167596,167598,167601,2,5,0
47823,1,3,167597,167601,167604,4,7,0
47824,6,2,167603,167604,167606,1,3,0
47825,1,3,167604,167606,167609,2,5,0
47826,2,2,167606,167609,167611,3,5,0
47827,6,2,167612,167612,167614,0,2,1
47828,6,1,167618,167618,167619,0,1,4
47829,3,2,167621,167621,167623,0,2,2
47830,6,2,167627,167627,167629,0,2,4
47831,2,3,167629,167629,167632,0,3,0
47832,3,3,167632,167632,167635,0,3,0
47833,6,1,167638,167638,167639,0,1,3
47834,3,2,167641,167641,167643,0,2,2
47835,6,2,167647,167647,167649,0,2,4
47836,5,3,167652,167652,167655,0,3,3
47837,4,3,167656,167656,167659,0,3,1
47838,5,1,167661,167661,167662,0,1,2
47839,3,3,167664,167664,167667,0,3,2
47840,1,1,167665,167667,167668,2,3,0
47841,5,1,167670,167670,167671,0,1,2
47842,3,1,167673,167673,167674,0,1,2
47843,5,3,167678,167678,167681,0,3,4
47844,1,3,167679,167681,167684,2,5,0
47845,3,2,167682,167684,167686,2,4,0
47846,4,3,167686,167686,167689,0,3,0
47847,6,2,167692,167692,167694,0,2,3
47848,6,2,167698,167698,167700,0,2,4
47849,5,2,167703,167703,167705,0,2,3
47850,3,1,167706,167706,167707,0,1,1
47851,6,2,167712,167712,167714,0,2,5
47852,6,1,167718,167718,167719,0,1,4
47853,6,1,167724,167724,167725,0,1,5
47854,2,2,167726,167726,167728,0,2,1
47855,3,3,167729,167729,167732,0,3,1
47856,5,1,167734,167734,167735,0,1,2
47857,6,1,167740,167740,167741,0,1,5
47858,3,3,167743,167743,167746,0,3,2
47859,1,2,167744,167746,167748,2,4,0
47860,1,3,167745,167748,167751,3,6,0
47861,5,1,167750,167751,167752,1,2,0
47862,6,2,167756,167756,167758,0,2,4
47863,2,2,167758,167758,167760,0,2,0
47864,6,2,167764,167764,167766,0,2,4
47865,2,3,167766,167766,167769,0,3,0
47866,3,1,167769,167769,167770,0,1,0
47867,6,2,167775,167775,167777,0,2,5
47868,4,3,167779,167779,167782,0,3,2
47869,1,1,167780,167782,167783,2,3,0
47870,6,3,167786,167786,167789,0,3,3
47871,2,2,167788,167789,167791,1,3,0
47872,6,2,167794,167794,167796,0,2,3
47873,4,1,167798,167798,167799,0,1,2
47874,4,3,167802,167802,167805,0,3,3
47875,4,2,167806,167806,167808,0,2,1
47876,6,1,167812,167812,167813,0,1,4
47877,5,1,167817,167817,167818,0,1,4
47878,3,1,167820,167820,167821,0,1,2
47879,1,1,167821,167821,167822,0,1,0
47880,1,1,167822,167822,167823,0,1,0
47881,2,3,167824,167824,167827,0,3,1
47882,2,3,167826,167827,167830,1,4,0
47883,6,1,167832,167832,167833,0,1,2
47884,4,1,167836,167836,167837,0,1,3
47885,1,2,167837,167837,167839,0,2,0
47886,1,3,167838,167839,167842,1,4,0
47887,3,2,167841,167842,167844,1,3,0
47888,5,2,167846,167846,167848,0,2,2
47889,6,1,167852,167852,167853,0,1,4
47890,1,2,167853,167853,167855,0,2,0
47891,6,3,167859,167859,167862,0,3,4
47892,2,2,167861,167862,167864,1,3,0
47893,1,3,167862,167864,167867,2,5,0
47894,5,3,167867,167867,167870,0,3,0
47895,6,1,167873,167873,167874,0,1,3
47896,6,2,167879,167879,167881,0,2,5
47897,6,3,167885,167885,167888,0,3,4
47898,5,2,167890,167890,167892,0,2,2
47899,3,3,167893,167893,167896,0,3,1
47900,1,3,167894,167896,167899,2,5,0
47901,3,2,167897,167899,167901,2,4,0
47902,3,3,167900,167901,167904,1,4,0
47903,3,3,167903,167904,167907,1,4,0
47904,1,1,167904,167907,167908,3,4,0
47905,3,1,167907,167908,167909,1,2,0
47906,2,3,167909,167909,167912,0,3,0
47907,3,3,167912,167912,167915,0,3,0
47908,1,1,167913,167915,167916,2,3,0
47909,6,2,167919,167919,167921,0,2,3
47910,1,3,167920,167921,167924,1,4,0
47911,6,2,167926,167926,167928,0,2,2
47912,5,2,167931,167931,167933,0,2,3
47913,6,3,167937,167937,167940,0,3,4
47914,5,1,167942,167942,167943,0,1,2
47915,5,1,167947,167947,167948,0,1,4
47916,1,1,167948,167948,167949,0,1,0
47917,4,1,167952,167952,167953,0,1,3
47918,3,2,167955,167955,167957,0,2,2
47919,2,3,167957,167957,167960,0,3,0
47920,6,2,167963,167963,167965,0,2,3
47921,1,2,167964,167965,167967,1,3,0
47922,6,1,167970,167970,167971,0,1,3
47923,6,2,167976,167976,167978,0,2,5
47924,6,3,167982,167982,167985,0,3,4
47925,2,2,167984,167985,167987,1,3,0
47926,3,1,167987,167987,167988,0,1,0
47927,1,1,167988,167988,167989,0,1,0
47928,5,1,167993,167993,167994,0,1,4
47929,1,2,167994,167994,167996,0,2,0
47930,5,3,167999,167999,168002,0,3,3
47931,6,1,168005,168005,168006,0,1,3
47932,6,2,168011,168011,168013,0,2,5
47933,1,2,168012,168013,168015,1,3,0
47934,2,3,168014,168015,168018,1,4,0
47935,4,3,168018,168018,168021,0,3,0
47936,4,2,168022,168022,168024,0,2,1
47937,5,3,168027,168027,168030,0,3,3
47938,6,1,168033,168033,168034,0,1,3
47939,6,3,168039,168039,168042,0,3,5
47940,1,3,168040,168042,168045,2,5,0
47941,4,2,168044,168045,168047,1,3,0
47942,2,1,168046,168047,168048,1,2,0
47943,2,2,168048,168048,168050,0,2,0
47944,2,1,168050,168050,168051,0,1,0
47945,1,1,168051,168051,168052,0,1,0
47946,2,2,168053,168053,168055,0,2,1
47947,1,1,168054,168055,168056,1,2,0
47948,1,1,168055,168056,168057,1,2,0
47949,6,3,168061,168061,168064,0,3,4
47950,4,3,168065,168065,168068,0,3,1
47951,3,2,168068,168068,168070,0,2,0
47952,2,3,168070,168070,168073,0,3,0
47953,1,2,168071,168073,168075,2,4,0
47954,3,1,168074,168075,168076,1,2,0
47955,2,3,168076,168076,168079,0,3,0
47956,4,3,168080,168080,168083,0,3,1
47957,3,3,168083,168083,168086,0,3,0
47958,4,2,168087,168087,168089,0,2,1
47959,3,3,168090,168090,168093,0,3,1
47960,5,3,168095,168095,168098,0,3,2
47961,6,2,168101,168101,168103,0,2,3
47962,5,2,168106,168106,168108,0,2,3
47963,3,1,168109,168109,168110,0,1,1
47964,1,1,168110,168110,168111,0,1,0
47965,4,1,168114,168114,168115,0,1,3
47966,4,2,168118,168118,168120,0,2,3
47967,5,2,168123,168123,168125,0,2,3
47968,3,3,168126,168126,168129,0,3,1
47969,4,1,168130,168130,168131,0,1,1
47970,4,3,168134,168134,168137,0,3,3
47971,3,2,168137,168137,168139,0,2,0
47972,1,3,168138,168139,168142,1,4,0
47973,1,2,168139,168142,168144,3,5,0
47974,4,2,168143,168144,168146,1,3,0
47975,4,1,168147,168147,168148,0,1,1
47976,5,3,168152,168152,168155,0,3,4
47977,6,2,168158,168158,168160,0,2,3
47978,5,2,168163,168163,168165,0,2,3
47979,1,3,168164,168165,168168,1,4,0
47980,3,2,168167,168168,168170,1,3,0
47981,4,2,168171,168171,168173,0,2,1
47982,2,2,168173,168173,168175,0,2,0
47983,3,1,168176,168176,168177,0,1,1
47984,3,2,168179,168179,168181,0,2,2
47985,4,3,168183,168183,168186,0,3,2
47986,2,1,168185,168186,168187,1,2,0
47987,5,1,168190,168190,168191,0,1,3
47988,5,1,168195,168195,168196,0,1,4
47989,6,1,168201,168201,168202,0,1,5
47990,2,2,168203,168203,168205,0,2,1
47991,5,2,168208,168208,168210,0,2,3
47992,2,2,168210,168210,168212,0,2,0
47993,3,2,168213,168213,168215,0,2,1
47994,1,1,168214,168215,168216,1,2,0
47995,4,2,168218,168218,168220,0,2,2
47996,1,3,168219,168220,168223,1,4,0
47997,2,1,168221,168223,168224,2,3,0
47998,3,1,168224,168224,168225,0,1,0
47999,6,1,168230,168230,168231,0,1,5
48000,5,3,168235,168235,168238,0,3,4
48001,2,1,168237,168238,168239,1,2,0
48002,3,1,168240,168240,168241,0,1,1
48003,2,3,168242,168242,168245,0,3,1
48004,4,1,168246,168246,168247,0,1,1
48005,5,2,168251,168251,168253,0,2,4
48006,3,3,168254,168254,168257,0,3,1
48007,4,2,168258,168258,168260,0,2,1
48008,5,3,168263,168263,168266,0,3,3
48009,2,3,168265,168266,168269,1,4,0
48010,4,2,168269,168269,168271,0,2,0
48011,2,3,168271,168271,168274,0,3,0
48012,1,3,168272,168274,168277,2,5,0
48013,6,3,168278,168278,168281,0,3,1
48014,4,2,168282,168282,168284,0,2,1
48015,1,1,168283,168284,168285,1,2,0
48016,1,3,168284,168285,168288,1,4,0
48017,4,3,168288,168288,168291,0,3,0
48018,4,2,168292,168292,168294,0,2,1
48019,5,3,168297,168297,168300,0,3,3
48020,3,3,168300,168300,168303,0,3,0
48021,4,2,168304,168304,168306,0,2,1
48022,3,1,168307,168307,168308,0,1,1
48023,3,3,168310,168310,168313,0,3,2
48024,4,1,168314,168314,168315,0,1,1
48025,1,1,168315,168315,168316,0,1,0
48026,3,2,168318,168318,168320,0,2,2
48027,1,1,168319,168320,168321,1,2,0
48028,5,3,168324,168324,168327,0,3,3
48029,2,1,168326,168327,168328,1,2,0
48030,4,2,168330,168330,168332,0,2,2
48031,4,1,168334,168334,168335,0,1,2
48032,6,1,168340,168340,168341,0,1,5
48033,3,1,168343,168343,168344,0,1,2
48034,1,1,168344,168344,168345,0,1,0
48035,1,2,168345,168345,168347,0,2,0
48036,4,3,168349,168349,168352,0,3,2
48037,3,2,168352,168352,168354,0,2,0
48038,4,1,168356,168356,168357,0,1,2
48039,1,3,168357,168357,168360,0,3,0
48040,1,3,168358,168360,168363,2,5,0
48041,1,2,168359,168363,168365,4,6,0
48042,4,3,168363,168365,168368,2,5,0
48043,3,3,168366,168368,168371,2,5,0
48044,4,3,168370,168371,168374,1,4,0
48045,1,2,168371,168374,168376,3,5,0
48046,1,2,168372,168376,168378,4,6,0
48047,5,3,168377,168378,168381,1,4,0
48048,3,2,168380,168381,168383,1,3,0
48049,4,3,168384,168384,168387,0,3,1
48050,2,3,168386,168387,168390,1,4,0
48051,5,2,168391,168391,168393,0,2,1
48052,5,1,168396,168396,168397,0,1,3
48053,1,2,168397,168397,168399,0,2,0
48054,3,3,168400,168400,168403,0,3,1
48055,5,1,168405,168405,168406,0,1,2
48056,1,1,168406,168406,168407,0,1,0
48057,2,1,168408,168408,168409,0,1,1
48058,6,2,168414,168414,168416,0,2,5
48059,1,1,168415,168416,168417,1,2,0
48060,5,1,168420,168420,168421,0,1,3
48061,1,1,168421,168421,168422,0,1,0
48062,1,3,168422,168422,168425,0,3,0
48063,5,1,168427,168427,168428,0,1,2
48064,3,2,168430,168430,168432,0,2,2
48065,1,3,168431,168432,168435,1,4,0
48066,1,2,168432,168435,168437,3,5,0
48067,6,1,168438,168438,168439,0,1,1
48068,2,2,168440,168440,168442,0,2,1
48069,4,3,168444,168444,168447,0,3,2
48070,6,2,168450,168450,168452,0,2,3
48071,1,1,168451,168452,168453,1,2,0
48072,2,3,168453,168453,168456,0,3,0
48073,4,2,168457,168457,168459,0,2,1
48074,6,2,168463,168463,168465,0,2,4
48075,4,1,168467,168467,168468,0,1,2
48076,4,2,168471,168471,168473,0,2,3
48077,6,1,168477,168477,168478,0,1,4
48078,6,2,168483,168483,168485,0,2,5
48079,3,3,168486,168486,168489,0,3,1
48080,1,3,168487,168489,168492,2,5,0
48081,5,2,168492,168492,168494,0,2,0
48082,2,1,168494,168494,168495,0,1,0
48083,2,1,168496,168496,168497,0,1,1
48084,6,2,168502,168502,168504,0,2,5
48085,2,3,168504,168504,168507,0,3,0
48086,3,3,168507,168507,168510,0,3,0
48087,2,2,168509,168510,168512,1,3,0
48088,1,3,168510,168512,168515,2,5,0
48089,2,3,168512,168515,168518,3,6,0
48090,5,1,168517,168518,168519,1,2,0
48091,4,3,168521,168521,168524,0,3,2
48092,5,1,168526,168526,168527,0,1,2
48093,3,2,168529,168529,168531,0,2,2
48094,1,3,168530,168531,168534,1,4,0
48095,1,1,168531,168534,168535,3,4,0
48096,5,1,168536,168536,168537,0,1,1
48097,5,2,168541,168541,168543,0,2,4
48098,1,3,168542,168543,168546,1,4,0
48099,1,2,168543,168546,168548,3,5,0
48100,5,2,168548,168548,168550,0,2,0
48101,4,2,168552,168552,168554,0,2,2
48102,1,1,168553,168554,168555,1,2,0
48103,4,3,168557,168557,168560,0,3,2
48104,3,2,168560,168560,168562,0,2,0
48105,3,1,168563,168563,168564,0,1,1
48106,5,2,168568,168568,168570,0,2,4
48107,4,3,168572,168572,168575,0,3,2
48108,2,2,168574,168575,168577,1,3,0
48109,4,3,168578,168578,168581,0,3,1
48110,6,3,168584,168584,168587,0,3,3
48111,6,1,168590,168590,168591,0,1,3
48112,1,1,168591,168591,168592,0,1,0
48113,5,3,168596,168596,168599,0,3,4
48114,2,2,168598,168599,168601,1,3,0
48115,6,2,168604,168604,168606,0,2,3
48116,4,1,168608,168608,168609,0,1,2
48117,5,2,168613,168613,168615,0,2,4
48118,2,1,168615,168615,168616,0,1,0
48119,3,3,168618,168618,168621,0,3,2
48120,3,2,168621,168621,168623,0,2,0
48121,5,3,168626,168626,168629,0,3,3
48122,2,3,168628,168629,168632,1,4,0
48123,6,3,168634,168634,168637,0,3,2
48124,6,2,168640,168640,168642,0,2,3
48125,6,3,168646,168646,168649,0,3,4
48126,3,3,168649,168649,168652,0,3,0
48127,2,2,168651,168652,168654,1,3,0
48128,3,1,168654,168654,168655,0,1,0
48129,3,3,168657,168657,168660,0,3,2
48130,2,2,168659,168660,168662,1,3,0
48131,1,1,168660,168662,168663,2,3,0
48132,5,1,168665,168665,168666,0,1,2
48133,6,2,168671,168671,168673,0,2,5
48134,1,3,168672,168673,168676,1,4,0
48135,1,3,168673,168676,168679,3,6,0
48136,1,2,168674,168679,168681,5,7,0
48137,6,1,168680,168681,168682,1,2,0
48138,2,3,168682,168682,168685,0,3,0
48139,6,1,168688,168688,168689,0,1,3
48140,6,1,168694,168694,168695,0,1,5
48141,4,2,168698,168698,168700,0,2,3
48142,4,1,168702,168702,168703,0,1,2
48143,3,2,168705,168705,168707,0,2,2
48144,1,3,168706,168707,168710,1,4,0
48145,4,3,168710,168710,168713,0,3,0
48146,3,2,168713,168713,168715,0,2,0
48147,3,1,168716,168716,168717,0,1,1
48148,5,3,168721,168721,168724,0,3,4
48149,4,1,168725,168725,168726,0,1,1
48150,2,2,168727,168727,168729,0,2,1
48151,5,2,168732,168732,168734,0,2,3
48152,1,2,168733,168734,168736,1,3,0
48153,2,1,168735,168736,168737,1,2,0
48154,1,2,168736,168737,168739,1,3,0
48155,4,2,168740,168740,168742,0,2,1
48156,4,3,168744,168744,168747,0,3,2
48157,1,3,168745,168747,168750,2,5,0
48158,4,1,168749,168750,168751,1,2,0
48159,2,1,168751,168751,168752,0,1,0
48160,2,1,168753,168753,168754,0,1,1
48161,3,3,168756,168756,168759,0,3,2
48162,1,2,168757,168759,168761,2,4,0
48163,4,2,168761,168761,168763,0,2,0
48164,5,1,168766,168766,168767,0,1,3
48165,4,1,168770,168770,168771,0,1,3
48166,4,2,168774,168774,168776,0,2,3
48167,1,2,168775,168776,168778,1,3,0
48168,5,3,168780,168780,168783,0,3,2
48169,1,1,168781,168783,168784,2,3,0
48170,3,2,168784,168784,168786,0,2,0
48171,2,1,168786,168786,168787,0,1,0
48172,5,1,168791,168791,168792,0,1,4
48173,5,3,168796,168796,168799,0,3,4
48174,3,2,168799,168799,168801,0,2,0
48175,2,3,168801,168801,168804,0,3,0
48176,6,3,168807,168807,168810,0,3,3
48177,1,1,168808,168810,168811,2,3,0
48178,6,3,168814,168814,168817,0,3,3
48179,5,2,168819,168819,168821,0,2,2
48180,6,2,168825,168825,168827,0,2,4
48181,1,2,168826,168827,168829,1,3,0
48182,6,1,168832,168832,168833,0,1,3
48183,4,1,168836,168836,168837,0,1,3
48184,6,2,168842,168842,168844,0,2,5
48185,2,3,168844,168844,168847,0,3,0
48186,5,3,168849,168849,168852,0,3,2
48187,6,1,168855,168855,168856,0,1,3
48188,2,3,168857,168857,168860,0,3,1
48189,6,1,168863,168863,168864,0,1,3
48190,5,3,168868,168868,168871,0,3,4
48191,6,1,168874,168874,168875,0,1,3
48192,3,3,168877,168877,168880,0,3,2
48193,6,1,168883,168883,168884,0,1,3
48194,3,2,168886,168886,168888,0,2,2
48195,6,1,168892,168892,168893,0,1,4
48196,6,2,168898,168898,168900,0,2,5
48197,2,2,168900,168900,168902,0,2,0
48198,4,2,168904,168904,168906,0,2,2
48199,2,3,168906,168906,168909,0,3,0
48200,2,2,168908,168909,168911,1,3,0
48201,3,3,168911,168911,168914,0,3,0
48202,3,2,168914,168914,168916,0,2,0
48203,4,3,168918,168918,168921,0,3,2
48204,3,3,168921,168921,168924,0,3,0
48205,5,2,168926,168926,168928,0,2,2
48206,6,1,168932,168932,168933,0,1,4
48207,1,2,168933,168933,168935,0,2,0
48208,3,1,168936,168936,168937,0,1,1
48209,1,1,168937,168937,168938,0,1,0
48210,4,1,168941,168941,168942,0,1,3
48211,4,1,168945,168945,168946,0,1,3
48212,2,2,168947,168947,168949,0,2,1
48213,2,1,168949,168949,168950,0,1,0
48214,1,2,168950,168950,168952,0,2,0
48215,4,2,168954,168954,168956,0,2,2
48216,6,2,168960,168960,168962,0,2,4
48217,3,3,168963,168963,168966,0,3,1
48218,6,2,168969,168969,168971,0,2,3
48219,6,1,168975,168975,168976,0,1,4
48220,6,3,168981,168981,168984,0,3,5
48221,2,2,168983,168984,168986,1,3,0
48222,6,2,168989,168989,168991,0,2,3
48223,3,1,168992,168992,168993,0,1,1
48224,2,2,168994,168994,168996,0,2,1
48225,5,3,168999,168999,169002,0,3,3
48226,5,2,169004,169004,169006,0,2,2
48227,1,3,169005,169006,169009,1,4,0
48228,1,3,169006,169009,169012,3,6,0
48229,1,1,169007,169012,169013,5,6,0
48230,3,3,169010,169013,169016,3,6,0
48231,2,1,169012,169016,169017,4,5,0
48232,2,2,169014,169017,169019,3,5,0
48233,5,1,169019,169019,169020,0,1,0
48234,4,1,169023,169023,169024,0,1,3
48235,5,2,169028,169028,169030,0,2,4
48236,5,2,169033,169033,169035,0,2,3
48237,3,3,169036,169036,169039,0,3,1
48238,5,1,169041,169041,169042,0,1,2
48239,4,3,169045,169045,169048,0,3,3
48240,5,1,169050,169050,169051,0,1,2
48241,6,1,169056,169056,169057,0,1,5
48242,6,1,169062,169062,169063,0,1,5
48243,5,1,169067,169067,169068,0,1,4
48244,1,3,169068,169068,169071,0,3,0
48245,1,1,169069,169071,169072,2,3,0
48246,4,2,169073,169073,169075,0,2,1
48247,3,2,169076,169076,169078,0,2,1
48248,5,2,169081,169081,169083,0,2,3
48249,4,2,169085,169085,169087,0,2,2
48250,1,1,169086,169087,169088,1,2,0
48251,5,3,169091,169091,169094,0,3,3
48252,6,3,169097,169097,169100,0,3,3
48253,3,2,169100,169100,169102,0,2,0
48254,1,2,169101,169102,169104,1,3,0
48255,1,2,169102,169104,169106,2,4,0
48256,2,1,169104,169106,169107,2,3,0
48257,2,2,169106,169107,169109,1,3,0
48258,6,3,169112,169112,169115,0,3,3
48259,3,3,169115,169115,169118,0,3,0
48260,1,1,169116,169118,169119,2,3,0
48261,6,1,169122,169122,169123,0,1,3
48262,3,3,169125,169125,169128,0,3,2
48263,2,2,169127,169128,169130,1,3,0
48264,5,1,169132,169132,169133,0,1,2
48265,4,1,169136,169136,169137,0,1,3
48266,2,1,169138,169138,169139,0,1,1
48267,4,3,169142,169142,169145,0,3,3
48268,2,2,169144,169145,169147,1,3,0
48269,6,1,169150,169150,169151,0,1,3
48270,5,2,169155,169155,169157,0,2,4
48271,2,1,169157,169157,169158,0,1,0
48272,2,2,169159,169159,169161,0,2,1
48273,2,3,169161,169161,169164,0,3,0
48274,4,1,169165,169165,169166,0,1,1
48275,5,3,169170,169170,169173,0,3,4
48276,3,3,169173,169173,169176,0,3,0
48277,6,2,169179,169179,169181,0,2,3
48278,5,2,169184,169184,169186,0,2,3
48279,4,3,169188,169188,169191,0,3,2
48280,4,1,169192,169192,169193,0,1,1
48281,3,1,169195,169195,169196,0,1,2
48282,6,2,169201,169201,169203,0,2,5
48283,2,2,169203,169203,169205,0,2,0
48284,3,3,169206,169206,169209,0,3,1
48285,2,3,169208,169209,169212,1,4,0
48286,4,3,169212,169212,169215,0,3,0
48287,3,2,169215,169215,169217,0,2,0
48288,4,3,169219,169219,169222,0,3,2
48289,6,3,169225,169225,169228,0,3,3
48290,6,2,169231,169231,169233,0,2,3
48291,2,3,169233,169233,169236,0,3,0
48292,1,1,169234,169236,169237,2,3,0
48293,5,1,169239,169239,169240,0,1,2
48294,1,3,169240,169240,169243,0,3,0
48295,4,3,169244,169244,169247,0,3,1
48296,2,2,169246,169247,169249,1,3,0
48297,1,3,169247,169249,169252,2,5,0
48298,3,2,169250,169252,169254,2,4,0
48299,1,3,169251,169254,169257,3,6,0
48300,2,1,169253,169257,169258,4,5,0
48301,3,1,169256,169258,169259,2,3,0
48302,4,3,169260,169260,169263,0,3,1
48303,4,3,169264,169264,169267,0,3,1
48304,2,2,169266,169267,169269,1,3,0
48305,4,1,169270,169270,169271,0,1,1
48306,2,1,169272,169272,169273,0,1,1
48307,5,3,169277,169277,169280,0,3,4
48308,4,2,169281,169281,169283,0,2,1
48309,3,2,169284,169284,169286,0,2,1
48310,2,3,169286,169286,169289,0,3,0
48311,1,1,169287,169289,169290,2,3,0
48312,3,3,169290,169290,169293,0,3,0
48313,5,3,169295,169295,169298,0,3,2
48314,6,1,169301,169301,169302,0,1,3
48315,5,3,169306,169306,169309,0,3,4
48316,1,2,169307,169309,169311,2,4,0
48317,4,3,169311,169311,169314,0,3,0
48318,4,1,169315,169315,169316,0,1,1
48319,6,2,169321,169321,169323,0,2,5
48320,2,1,169323,169323,169324,0,1,0
48321,4,3,169327,169327,169330,0,3,3
48322,3,1,169330,169330,169331,0,1,0
48323,5,2,169335,169335,169337,0,2,4
48324,2,1,169337,169337,169338,0,1,0
48325,3,3,169340,169340,169343,0,3,2
48326,6,1,169346,169346,169347,0,1,3
48327,2,3,169348,169348,169351,0,3,1
48328,6,3,169354,169354,169357,0,3,3
48329,4,3,169358,169358,169361,0,3,1
48330,6,1,169364,169364,169365,0,1,3
48331,4,1,169368,169368,169369,0,1,3
48332,6,2,169374,169374,169376,0,2,5
48333,5,1,169379,169379,169380,0,1,3
48334,2,2,169381,169381,169383,0,2,1
48335,2,1,169383,169383,169384,0,1,0
48336,6,1,169389,169389,169390,0,1,5
48337,6,2,169395,169395,169397,0,2,5
48338,4,3,169399,169399,169402,0,3,2
48339,3,1,169402,169402,169403,0,1,0
48340,1,2,169403,169403,169405,0,2,0
48341,4,2,169407,169407,169409,0,2,2
48342,6,3,169413,169413,169416,0,3,4
48343,6,2,169419,169419,169421,0,2,3
48344,4,1,169423,169423,169424,0,1,2
48345,3,2,169426,169426,169428,0,2,2
48346,6,1,169432,169432,169433,0,1,4
48347,4,1,169436,169436,169437,0,1,3
48348,4,3,169440,169440,169443,0,3,3
48349,1,1,169441,169443,169444,2,3,0
48350,1,2,169442,169444,169446,2,4,0
48351,1,1,169443,169446,169447,3,4,0
48352,1,1,169444,169447,169448,3,4,0
48353,5,3,169449,169449,169452,0,3,1
48354,1,1,169450,169452,169453,2,3,0
48355,3,2,169453,169453,169455,0,2,0
48356,1,2,169454,169455,169457,1,3,0
48357,1,1,169455,169457,169458,2,3,0
48358,4,2,169459,169459,169461,0,2,1
48359,1,3,169460,169461,169464,1,4,0
48360,2,1,169462,169464,169465,2,3,0
48361,5,2,169467,169467,169469,0,2,2
48362,4,3,169471,169471,169474,0,3,2
48363,2,2,169473,169474,169476,1,3,0
48364,2,3,169475,169476,169479,1,4,0
48365,6,3,169481,169481,169484,0,3,2
48366,2,2,169483,169484,169486,1,3,0
48367,2,3,169485,169486,169489,1,4,0
48368,5,1,169490,169490,169491,0,1,1
48369,6,1,169496,169496,169497,0,1,5
48370,6,1,169502,169502,169503,0,1,5
48371,1,3,169503,169503,169506,0,3,0
48372,3,2,169506,169506,169508,0,2,0
48373,2,1,169508,169508,169509,0,1,0
48374,3,2,169511,169511,169513,0,2,2
48375,4,1,169515,169515,169516,0,1,2
48376,6,1,169521,169521,169522,0,1,5
48377,1,3,169522,169522,169525,0,3,0
48378,6,2,169528,169528,169530,0,2,3
48379,3,1,169531,169531,169532,0,1,1
48380,4,2,169535,169535,169537,0,2,3
48381,2,3,169537,169537,169540,0,3,0
48382,2,2,169539,169540,169542,1,3,0
48383,1,1,169540,169542,169543,2,3,0
48384,2,3,169542,169543,169546,1,4,0
48385,5,2,169547,169547,169549,0,2,1
48386,4,2,169551,169551,169553,0,2,2
48387,3,3,169554,169554,169557,0,3,1
48388,4,2,169558,169558,169560,0,2,1
48389,1,2,169559,169560,169562,1,3,0
48390,4,3,169563,169563,169566,0,3,1
48391,6,3,169569,169569,169572,0,3,3
48392,3,3,169572,169572,169575,0,3,0
48393,2,3,169574,169575,169578,1,4,0
48394,2,3,169576,169578,169581,2,5,0
48395,5,1,169581,169581,169582,0,1,0
48396,1,2,169582,169582,169584,0,2,0
48397,6,1,169588,169588,169589,0,1,4
48398,6,1,169594,169594,169595,0,1,5
48399,4,3,169598,169598,169601,0,3,3
48400,5,1,169603,169603,169604,0,1,2
48401,1,2,169604,169604,169606,0,2,0
48402,4,2,169608,169608,169610,0,2,2
48403,5,3,169613,169613,169616,0,3,3
48404,2,2,169615,169616,169618,1,3,0
48405,2,1,169617,169618,169619,1,2,0
48406,6,1,169623,169623,169624,0,1,4
48407,4,3,169627,169627,169630,0,3,3
48408,3,2,169630,169630,169632,0,2,0
48409,3,3,169633,169633,169636,0,3,1
48410,6,1,169639,169639,169640,0,1,3
48411,1,1,169640,169640,169641,0,1,0
48412,3,2,169643,169643,169645,0,2,2
48413,3,1,169646,169646,169647,0,1,1
48414,4,1,169650,169650,169651,0,1,3
48415,4,3,169654,169654,169657,0,3,3
48416,2,2,169656,169657,169659,1,3,0
48417,6,2,169662,169662,169664,0,2,3
48418,6,2,169668,169668,169670,0,2,4
48419,5,2,169673,169673,169675,0,2,3
48420,4,1,169677,169677,169678,0,1,2
48421,1,1,169678,169678,169679,0,1,0
48422,1,1,169679,169679,169680,0,1,0
48423,6,2,169685,169685,169687,0,2,5
48424,6,2,169691,169691,169693,0,2,4
48425,1,2,169692,169693,169695,1,3,0
48426,4,1,169696,169696,169697,0,1,1
48427,2,2,169698,169698,169700,0,2,1
48428,1,3,169699,169700,169703,1,4,0
48429,5,2,169704,169704,169706,0,2,1
48430,2,1,169706,169706,169707,0,1,0
48431,3,1,169709,169709,169710,0,1,2
48432,4,3,169713,169713,169716,0,3,3
48433,5,3,169718,169718,169721,0,3,2
48434,4,3,169722,169722,169725,0,3,1
48435,1,2,169723,169725,169727,2,4,0
48436,4,2,169727,169727,169729,0,2,0
48437,3,2,169730,169730,169732,0,2,1
48438,6,3,169736,169736,169739,0,3,4
48439,6,2,169742,169742,169744,0,2,3
48440,3,2,169745,169745,169747,0,2,1
48441,4,1,169749,169749,169750,0,1,2
48442,4,3,169753,169753,169756,0,3,3
48443,6,3,169759,169759,169762,0,3,3
48444,4,3,169763,169763,169766,0,3,1
48445,3,3,169766,169766,169769,0,3,0
48446,5,3,169771,169771,169774,0,3,2
48447,6,2,169777,169777,169779,0,2,3
48448,2,2,169779,169779,169781,0,2,0
48449,2,1,169781,169781,169782,0,1,0
48450,3,1,169784,169784,169785,0,1,2
48451,3,1,169787,169787,169788,0,1,2
48452,4,3,169791,169791,169794,0,3,3
48453,2,2,169793,169794,169796,1,3,0
48454,6,2,169799,169799,169801,0,2,3
48455,4,2,169803,169803,169805,0,2,2
48456,3,3,169806,169806,169809,0,3,1
48457,1,2,169807,169809,169811,2,4,0
48458,5,2,169812,169812,169814,0,2,1
48459,1,2,169813,169814,169816,1,3,0
48460,4,3,169817,169817,169820,0,3,1
48461,6,1,169823,169823,169824,0,1,3
48462,5,3,169828,169828,169831,0,3,4
48463,5,3,169833,169833,169836,0,3,2
48464,2,1,169835,169836,169837,1,2,0
48465,6,2,169841,169841,169843,0,2,4
48466,4,3,169845,169845,169848,0,3,2
48467,4,3,169849,169849,169852,0,3,1
48468,2,3,169851,169852,169855,1,4,0
48469,4,1,169855,169855,169856,0,1,0
48470,4,3,169859,169859,169862,0,3,3
48471,5,1,169864,169864,169865,0,1,2
48472,4,2,169868,169868,169870,0,2,3
48473,2,1,169870,169870,169871,0,1,0
48474,4,1,169874,169874,169875,0,1,3
48475,4,2,169878,169878,169880,0,2,3
48476,1,1,169879,169880,169881,1,2,0
48477,5,3,169884,169884,169887,0,3,3
48478,4,2,169888,169888,169890,0,2,1
48479,1,2,169889,169890,169892,1,3,0
48480,4,1,169893,169893,169894,0,1,1
48481,3,1,169896,169896,169897,0,1,2
48482,4,2,169900,169900,169902,0,2,3
48483,1,2,169901,169902,169904,1,3,0
48484,6,3,169907,169907,169910,0,3,3
48485,1,3,169908,169910,169913,2,5,0
48486,5,1,169913,169913,169914,0,1,0
48487,5,2,169918,169918,169920,0,2,4
48488,4,2,169922,169922,169924,0,2,2
48489,3,2,169925,169925,169927,0,2,1
48490,4,1,169929,169929,169930,0,1,2
48491,3,3,169932,169932,169935,0,3,2
48492,4,3,169936,169936,169939,0,3,1
48493,2,1,169938,169939,169940,1,2,0
48494,4,1,169942,169942,169943,0,1,2
48495,4,3,169946,169946,169949,0,3,3
48496,2,3,169948,169949,169952,1,4,0
48497,4,3,169952,169952,169955,0,3,0
48498,1,3,169953,169955,169958,2,5,0
48499,3,1,169956,169958,169959,2,3,0
48500,6,2,169962,169962,169964,0,2,3
48501,4,1,169966,169966,169967,0,1,2
48502,2,2,169968,169968,169970,0,2,1
48503,5,1,169973,169973,169974,0,1,3
48504,6,2,169979,169979,169981,0,2,5
48505,6,2,169985,169985,169987,0,2,4
48506,4,2,169989,169989,169991,0,2,2
48507,5,1,169994,169994,169995,0,1,3
48508,4,1,169998,169998,169999,0,1,3
48509,6,2,170004,170004,170006,0,2,5
48510,4,1,170008,170008,170009,0,1,2
48511,6,2,170014,170014,170016,0,2,5
48512,5,1,170019,170019,170020,0,1,3
48513,1,1,170020,170020,170021,0,1,0
48514,4,2,170024,170024,170026,0,2,3
48515,6,2,170030,170030,170032,0,2,4
48516,3,1,170033,170033,170034,0,1,1
48517,6,2,170039,170039,170041,0,2,5
48518,4,2,170043,170043,170045,0,2,2
48519,3,1,170046,170046,170047,0,1,1
48520,2,3,170048,170048,170051,0,3,1
48521,2,3,170050,170051,170054,1,4,0
48522,6,1,170056,170056,170057,0,1,2
48523,5,2,170061,170061,170063,0,2,4
48524,3,1,170064,170064,170065,0,1,1
48525,1,1,170065,170065,170066,0,1,0
48526,5,2,170070,170070,170072,0,2,4
48527,2,3,170072,170072,170075,0,3,0
48528,5,3,170077,170077,170080,0,3,2
48529,6,1,170083,170083,170084,0,1,3
48530,4,1,170087,170087,170088,0,1,3
48531,5,1,170092,170092,170093,0,1,4
48532,2,1,170094,170094,170095,0,1,1
48533,6,3,170100,170100,170103,0,3,5
48534,4,1,170104,170104,170105,0,1,1
48535,5,3,170109,170109,170112,0,3,4
48536,3,1,170112,170112,170113,0,1,0
48537,1,1,170113,170113,170114,0,1,0
48538,2,3,170115,170115,170118,0,3,1
48539,6,3,170121,170121,170124,0,3,3
48540,1,1,170122,170124,170125,2,3,0
48541,4,2,170126,170126,170128,0,2,1
48542,3,2,170129,170129,170131,0,2,1
48543,5,1,170134,170134,170135,0,1,3
48544,2,3,170136,170136,170139,0,3,1
48545,5,1,170141,170141,170142,0,1,2
48546,4,2,170145,170145,170147,0,2,3
48547,3,1,170148,170148,170149,0,1,1
48548,2,2,170150,170150,170152,0,2,1
48549,1,1,170151,170152,170153,1,2,0
48550,1,1,170152,170153,170154,1,2,0
48551,2,1,170154,170154,170155,0,1,0
48552,1,1,170155,170155,170156,0,1,0
48553,3,2,170158,170158,170160,0,2,2
48554,3,3,170161,170161,170164,0,3,1
48555,5,2,170166,170166,170168,0,2,2
48556,6,2,170172,170172,170174,0,2,4
48557,4,1,170176,170176,170177,0,1,2
48558,5,1,170181,170181,170182,0,1,4
48559,3,2,170184,170184,170186,0,2,2
48560,3,3,170187,170187,170190,0,3,1
48561,3,3,170190,170190,170193,0,3,0
48562,1,2,170191,170193,170195,2,4,0
48563,6,1,170197,170197,170198,0,1,2
48564,2,3,170199,170199,170202,0,3,1
48565,1,3,170200,170202,170205,2,5,0
48566,3,1,170203,170205,170206,2,3,0
48567,1,1,170204,170206,170207,2,3,0
48568,2,2,170206,170207,170209,1,3,0
48569,5,2,170211,170211,170213,0,2,2
48570,1,3,170212,170213,170216,1,4,0
48571,2,3,170214,170216,170219,2,5,0
48572,1,1,170215,170219,170220,4,5,0
48573,4,1,170219,170220,170221,1,2,0
48574,1,2,170220,170221,170223,1,3,0
48575,6,3,170226,170226,170229,0,3,3
48576,1,2,170227,170229,170231,2,4,0
48577,4,3,170231,170231,170234,0,3,0
48578,3,3,170234,170234,170237,0,3,0
48579,6,3,170240,170240,170243,0,3,3
48580,4,3,170244,170244,170247,0,3,1
48581,6,1,170250,170250,170251,0,1,3
48582,5,1,170255,170255,170256,0,1,4
48583,2,3,170257,170257,170260,0,3,1
48584,6,3,170263,170263,170266,0,3,3
48585,4,2,170267,170267,170269,0,2,1
48586,1,1,170268,170269,170270,1,2,0
48587,2,2,170270,170270,170272,0,2,0
48588,5,1,170275,170275,170276,0,1,3
48589,6,3,170281,170281,170284,0,3,5
48590,4,3,170285,170285,170288,0,3,1
48591,1,1,170286,170288,170289,2,3,0
48592,5,3,170291,170291,170294,0,3,2
48593,4,3,170295,170295,170298,0,3,1
48594,5,2,170300,170300,170302,0,2,2
48595,1,2,170301,170302,170304,1,3,0
48596,3,2,170304,170304,170306,0,2,0
48597,4,2,170308,170308,170310,0,2,2
48598,6,3,170314,170314,170317,0,3,4
48599,6,2,170320,170320,170322,0,2,3
48600,6,2,170326,170326,170328,0,2,4
48601,1,2,170327,170328,170330,1,3,0
48602,3,3,170330,170330,170333,0,3,0
48603,2,2,170332,170333,170335,1,3,0
48604,3,1,170335,170335,170336,0,1,0
48605,4,2,170339,170339,170341,0,2,3
48606,4,2,170343,170343,170345,0,2,2
48607,5,3,170348,170348,170351,0,3,3
48608,2,1,170350,170351,170352,1,2,0
48609,3,3,170353,170353,170356,0,3,1
48610,5,1,170358,170358,170359,0,1,2
48611,1,3,170359,170359,170362,0,3,0
48612,5,2,170364,170364,170366,0,2,2
48613,3,3,170367,170367,170370,0,3,1
48614,4,1,170371,170371,170372,0,1,1
48615,3,2,170374,170374,170376,0,2,2
48616,4,3,170378,170378,170381,0,3,2
48617,4,2,170382,170382,170384,0,2,1
48618,3,2,170385,170385,170387,0,2,1
48619,3,3,170388,170388,170391,0,3,1
48620,5,1,170393,170393,170394,0,1,2
48621,6,3,170399,170399,170402,0,3,5
48622,1,1,170400,170402,170403,2,3,0
48623,2,3,170402,170403,170406,1,4,0
48624,2,2,170404,170406,170408,2,4,0
48625,4,2,170408,170408,170410,0,2,0
48626,6,2,170414,170414,170416,0,2,4
48627,4,1,170418,170418,170419,0,1,2
48628,2,3,170420,170420,170423,0,3,1
48629,5,3,170425,170425,170428,0,3,2
48630,1,2,170426,170428,170430,2,4,0
48631,6,2,170432,170432,170434,0,2,2
48632,4,3,170436,170436,170439,0,3,2
48633,1,3,170437,170439,170442,2,5,0
48634,4,3,170441,170442,170445,1,4,0
48635,2,1,170443,170445,170446,2,3,0
48636,1,2,170444,170446,170448,2,4,0
48637,3,3,170447,170448,170451,1,4,0
48638,4,3,170451,170451,170454,0,3,0
48639,1,2,170452,170454,170456,2,4,0
48640,5,2,170457,170457,170459,0,2,1
48641,2,2,170459,170459,170461,0,2,0
48642,6,2,170465,170465,170467,0,2,4
48643,3,2,170468,170468,170470,0,2,1
48644,2,3,170470,170470,170473,0,3,0
48645,1,2,170471,170473,170475,2,4,0
48646,5,2,170476,170476,170478,0,2,1
48647,3,3,170479,170479,170482,0,3,1
48648,6,1,170485,170485,170486,0,1,3
48649,6,2,170491,170491,170493,0,2,5
48650,3,1,170494,170494,170495,0,1,1
48651,3,3,170497,170497,170500,0,3,2
48652,2,2,170499,170500,170502,1,3,0
48653,5,1,170504,170504,170505,0,1,2
48654,5,1,170509,170509,170510,0,1,4
48655,3,3,170512,170512,170515,0,3,2
48656,1,2,170513,170515,170517,2,4,0
48657,2,2,170515,170517,170519,2,4,0
48658,4,3,170519,170519,170522,0,3,0
48659,2,2,170521,170522,170524,1,3,0
48660,6,3,170527,170527,170530,0,3,3
48661,4,3,170531,170531,170534,0,3,1
48662,2,1,170533,170534,170535,1,2,0
48663,5,1,170538,170538,170539,0,1,3
48664,6,3,170544,170544,170547,0,3,5
48665,3,1,170547,170547,170548,0,1,0
48666,6,1,170553,170553,170554,0,1,5
48667,4,3,170557,170557,170560,0,3,3
48668,5,2,170562,170562,170564,0,2,2
48669,4,2,170566,170566,170568,0,2,2
48670,5,1,170571,170571,170572,0,1,3
48671,1,2,170572,170572,170574,0,2,0
48672,3,3,170575,170575,170578,0,3,1
48673,2,3,170577,170578,170581,1,4,0
48674,2,1,170579,170581,170582,2,3,0
48675,3,2,170582,170582,170584,0,2,0
48676,1,3,170583,170584,170587,1,4,0
48677,1,2,170584,170587,170589,3,5,0
48678,3,3,170587,170589,170592,2,5,0
48679,1,2,170588,170592,170594,4,6,0
48680,1,1,170589,170594,170595,5,6,0
48681,2,1,170591,170595,170596,4,5,0
48682,6,3,170597,170597,170600,0,3,1
48683,2,2,170599,170600,170602,1,3,0
48684,6,1,170605,170605,170606,0,1,3
48685,2,1,170607,170607,170608,0,1,1
48686,5,1,170612,170612,170613,0,1,4
48687,6,1,170618,170618,170619,0,1,5
48688,2,2,170620,170620,170622,0,2,1
48689,5,2,170625,170625,170627,0,2,3
48690,4,3,170629,170629,170632,0,3,2
48691,1,3,170630,170632,170635,2,5,0
48692,4,3,170634,170635,170638,1,4,0
48693,6,3,170640,170640,170643,0,3,2
48694,3,2,170643,170643,170645,0,2,0
48695,1,1,170644,170645,170646,1,2,0
48696,6,2,170650,170650,170652,0,2,4
48697,4,3,170654,170654,170657,0,3,2
48698,1,2,170655,170657,170659,2,4,0
48699,1,1,170656,170659,170660,3,4,0
48700,2,2,170658,170660,170662,2,4,0
48701,1,2,170659,170662,170664,3,5,0
48702,6,1,170665,170665,170666,0,1,1
48703,3,2,170668,170668,170670,0,2,2
48704,6,3,170674,170674,170677,0,3,4
48705,1,2,170675,170677,170679,2,4,0
48706,2,3,170677,170679,170682,2,5,0
48707,5,2,170682,170682,170684,0,2,0
48708,5,1,170687,170687,170688,0,1,3
48709,4,3,170691,170691,170694,0,3,3
48710,1,2,170692,170694,170696,2,4,0
48711,1,2,170693,170696,170698,3,5,0
48712,2,1,170695,170698,170699,3,4,0
48713,3,3,170698,170699,170702,1,4,0
48714,5,3,170703,170703,170706,0,3,1
48715,4,2,170707,170707,170709,0,2,1
48716,4,3,170711,170711,170714,0,3,2
48717,4,2,170715,170715,170717,0,2,1
48718,1,1,170716,170717,170718,1,2,0
48719,6,3,170722,170722,170725,0,3,4
48720,4,1,170726,170726,170727,0,1,1
48721,4,2,170730,170730,170732,0,2,3
48722,1,3,170731,170732,170735,1,4,0
48723,1,2,170732,170735,170737,3,5,0
48724,4,2,170736,170737,170739,1,3,0
48725,6,1,170742,170742,170743,0,1,3
48726,3,1,170745,170745,170746,0,1,2
48727,3,2,170748,170748,170750,0,2,2
48728,4,2,170752,170752,170754,0,2,2
48729,3,1,170755,170755,170756,0,1,1
48730,5,3,170760,170760,170763,0,3,4
48731,3,1,170763,170763,170764,0,1,0
48732,3,1,170766,170766,170767,0,1,2
48733,1,3,170767,170767,170770,0,3,0
48734,6,2,170773,170773,170775,0,2,3
48735,3,2,170776,170776,170778,0,2,1
48736,3,2,170779,170779,170781,0,2,1
48737,1,2,170780,170781,170783,1,3,0
48738,6,3,170786,170786,170789,0,3,3
48739,3,2,170789,170789,170791,0,2,0
48740,5,1,170794,170794,170795,0,1,3
48741,5,3,170799,170799,170802,0,3,4
48742,1,2,170800,170802,170804,2,4,0
48743,3,3,170803,170804,170807,1,4,0
48744,3,1,170806,170807,170808,1,2,0
48745,3,1,170809,170809,170810,0,1,1
48746,2,3,170811,170811,170814,0,3,1
48747,5,3,170816,170816,170819,0,3,2
48748,2,3,170818,170819,170822,1,4,0
48749,2,2,170820,170822,170824,2,4,0
48750,6,2,170826,170826,170828,0,2,2
48751,2,3,170828,170828,170831,0,3,0
48752,1,2,170829,170831,170833,2,4,0
48753,3,1,170832,170833,170834,1,2,0
48754,1,3,170833,170834,170837,1,4,0
48755,6,1,170839,170839,170840,0,1,2
48756,1,2,170840,170840,170842,0,2,0
48757,5,3,170845,170845,170848,0,3,3
48758,1,3,170846,170848,170851,2,5,0
48759,1,1,170847,170851,170852,4,5,0
48760,2,1,170849,170852,170853,3,4,0
48761,3,1,170852,170853,170854,1,2,0
48762,6,3,170858,170858,170861,0,3,4
48763,5,2,170863,170863,170865,0,2,2
48764,5,2,170868,170868,170870,0,2,3
48765,2,2,170870,170870,170872,0,2,0
48766,5,3,170875,170875,170878,0,3,3
48767,1,1,170876,170878,170879,2,3,0
48768,5,1,170881,170881,170882,0,1,2
48769,6,3,170887,170887,170890,0,3,5
48770,4,1,170891,170891,170892,0,1,1
48771,1,2,170892,170892,170894,0,2,0
48772,5,3,170897,170897,170900,0,3,3
48773,5,1,170902,170902,170903,0,1,2
48774,6,1,170908,170908,170909,0,1,5
48775,5,1,170913,170913,170914,0,1,4
48776,3,1,170916,170916,170917,0,1,2
48777,3,1,170919,170919,170920,0,1,2
48778,5,3,170924,170924,170927,0,3,4
48779,1,3,170925,170927,170930,2,5,0
48780,2,1,170927,170930,170931,3,4,0
48781,2,3,170929,170931,170934,2,5,0
48782,6,3,170935,170935,170938,0,3,1
48783,2,3,170937,170938,170941,1,4,0
48784,1,1,170938,170941,170942,3,4,0
48785,6,2,170944,170944,170946,0,2,2
48786,1,3,170945,170946,170949,1,4,0
48787,5,1,170950,170950,170951,0,1,1
48788,3,2,170953,170953,170955,0,2,2
48789,6,1,170959,170959,170960,0,1,4
48790,3,1,170962,170962,170963,0,1,2
48791,3,2,170965,170965,170967,0,2,2
48792,5,1,170970,170970,170971,0,1,3
48793,6,2,170976,170976,170978,0,2,5
48794,5,1,170981,170981,170982,0,1,3
48795,4,3,170985,170985,170988,0,3,3
48796,6,3,170991,170991,170994,0,3,3
48797,3,3,170994,170994,170997,0,3,0
48798,6,2,171000,171000,171002,0,2,3
48799,5,3,171005,171005,171008,0,3,3
48800,1,3,171006,171008,171011,2,5,0
48801,1,2,171007,171011,171013,4,6,0
48802,4,1,171011,171013,171014,2,3,0
48803,6,3,171017,171017,171020,0,3,3
48804,5,3,171022,171022,171025,0,3,2
48805,6,2,171028,171028,171030,0,2,3
48806,5,1,171033,171033,171034,0,1,3
48807,3,1,171036,171036,171037,0,1,2
48808,6,2,171042,171042,171044,0,2,5
48809,1,1,171043,171044,171045,1,2,0
48810,4,2,171047,171047,171049,0,2,2
48811,5,1,171052,171052,171053,0,1,3
48812,5,2,171057,171057,171059,0,2,4
48813,2,3,171059,171059,171062,0,3,0
48814,3,3,171062,171062,171065,0,3,0
48815,1,1,171063,171065,171066,2,3,0
48816,2,3,171065,171066,171069,1,4,0
48817,3,3,171068,171069,171072,1,4,0
48818,3,2,171071,171072,171074,1,3,0
48819,6,2,171077,171077,171079,0,2,3
48820,5,3,171082,171082,171085,0,3,3
48821,5,1,171087,171087,171088,0,1,2
48822,6,1,171093,171093,171094,0,1,5
48823,1,2,171094,171094,171096,0,2,0
48824,6,1,171100,171100,171101,0,1,4
48825,6,1,171106,171106,171107,0,1,5
48826,6,2,171112,171112,171114,0,2,5
48827,3,2,171115,171115,171117,0,2,1
48828,5,2,171120,171120,171122,0,2,3
48829,1,2,171121,171122,171124,1,3,0
48830,4,2,171125,171125,171127,0,2,1
48831,6,1,171131,171131,171132,0,1,4
48832,3,1,171134,171134,171135,0,1,2
48833,6,2,171140,171140,171142,0,2,5
48834,2,3,171142,171142,171145,0,3,0
48835,5,1,171147,171147,171148,0,1,2
48836,1,3,171148,171148,171151,0,3,0
48837,4,1,171152,171152,171153,0,1,1
48838,5,2,171157,171157,171159,0,2,4
48839,2,3,171159,171159,171162,0,3,0
48840,2,2,171161,171162,171164,1,3,0
48841,5,3,171166,171166,171169,0,3,2
48842,1,1,171167,171169,171170,2,3,0
48843,1,2,171168,171170,171172,2,4,0
48844,6,1,171174,171174,171175,0,1,2
48845,4,1,171178,171178,171179,0,1,3
48846,6,2,171184,171184,171186,0,2,5
48847,5,3,171189,171189,171192,0,3,3
48848,3,3,171192,171192,171195,0,3,0
48849,5,1,171197,171197,171198,0,1,2
48850,6,1,171203,171203,171204,0,1,5
48851,1,2,171204,171204,171206,0,2,0
48852,5,3,171209,171209,171212,0,3,3
48853,4,2,171213,171213,171215,0,2,1
48854,1,3,171214,171215,171218,1,4,0
48855,1,3,171215,171218,171221,3,6,0
48856,1,3,171216,171221,171224,5,8,0
48857,5,2,171221,171224,171226,3,5,0
48858,6,3,171227,171227,171230,0,3,1
48859,1,2,171228,171230,171232,2,4,0
48860,4,2,171232,171232,171234,0,2,0
48861,6,3,171238,171238,171241,0,3,4
48862,5,1,171243,171243,171244,0,1,2
48863,4,3,171247,171247,171250,0,3,3
48864,4,2,171251,171251,171253,0,2,1
48865,3,1,171254,171254,171255,0,1,1
48866,3,3,171257,171257,171260,0,3,2
48867,5,2,171262,171262,171264,0,2,2
48868,2,1,171264,171264,171265,0,1,0
48869,6,1,171270,171270,171271,0,1,5
48870,6,1,171276,171276,171277,0,1,5
48871,6,1,171282,171282,171283,0,1,5
48872,1,1,171283,171283,171284,0,1,0
48873,2,1,171285,171285,171286,0,1,1
48874,1,3,171286,171286,171289,0,3,0
48875,2,3,171288,171289,171292,1,4,0
48876,6,1,171294,171294,171295,0,1,2
48877,1,3,171295,171295,171298,0,3,0
48878,3,1,171298,171298,171299,0,1,0
48879,5,1,171303,171303,171304,0,1,4
48880,3,1,171306,171306,171307,0,1,2
48881,1,2,171307,171307,171309,0,2,0
48882,2,3,171309,171309,171312,0,3,0
48883,5,2,171314,171314,171316,0,2,2
48884,5,2,171319,171319,171321,0,2,3
48885,4,2,171323,171323,171325,0,2,2
48886,3,2,171326,171326,171328,0,2,1
48887,2,1,171328,171328,171329,0,1,0
48888,1,2,171329,171329,171331,0,2,0
48889,2,2,171331,171331,171333,0,2,0
48890,6,1,171337,171337,171338,0,1,4
48891,2,3,171339,171339,171342,0,3,1
48892,5,3,171344,171344,171347,0,3,2
48893,4,3,171348,171348,171351,0,3,1
48894,4,3,171352,171352,171355,0,3,1
48895,4,2,171356,171356,171358,0,2,1
48896,6,1,171362,171362,171363,0,1,4
48897,2,3,171364,171364,171367,0,3,1
48898,2,2,171366,171367,171369,1,3,0
48899,3,1,171369,171369,171370,0,1,0
48900,6,3,171375,171375,171378,0,3,5
48901,5,2,171380,171380,171382,0,2,2
48902,2,2,171382,171382,171384,0,2,0
48903,3,3,171385,171385,171388,0,3,1
48904,5,2,171390,171390,171392,0,2,2
48905,5,2,171395,171395,171397,0,2,3
48906,3,1,171398,171398,171399,0,1,1
48907,2,3,171400,171400,171403,0,3,1
48908,4,1,171404,171404,171405,0,1,1
48909,3,3,171407,171407,171410,0,3,2
48910,4,1,171411,171411,171412,0,1,1
48911,5,1,171416,171416,171417,0,1,4
48912,2,1,171418,171418,171419,0,1,1
48913,5,2,171423,171423,171425,0,2,4
48914,4,1,171427,171427,171428,0,1,2
48915,6,1,171433,171433,171434,0,1,5
48916,5,1,171438,171438,171439,0,1,4
48917,3,1,171441,171441,171442,0,1,2
48918,3,1,171444,171444,171445,0,1,2
48919,3,2,171447,171447,171449,0,2,2
48920,3,2,171450,171450,171452,0,2,1
48921,1,1,171451,171452,171453,1,2,0
48922,4,2,171455,171455,171457,0,2,2
48923,2,3,171457,171457,171460,0,3,0
48924,2,1,171459,171460,171461,1,2,0
48925,1,3,171460,171461,171464,1,4,0
48926,2,1,171462,171464,171465,2,3,0
48927,3,3,171465,171465,171468,0,3,0
48928,1,1,171466,171468,171469,2,3,0
48929,1,3,171467,171469,171472,2,5,0
48930,6,3,171473,171473,171476,0,3,1
48931,5,3,171478,171478,171481,0,3,2
48932,1,1,171479,171481,171482,2,3,0
48933,2,3,171481,171482,171485,1,4,0
48934,4,2,171485,171485,171487,0,2,0
48935,6,1,171491,171491,171492,0,1,4
48936,6,3,171497,171497,171500,0,3,5
48937,1,1,171498,171500,171501,2,3,0
48938,5,1,171503,171503,171504,0,1,2
48939,5,1,171508,171508,171509,0,1,4
48940,6,2,171514,171514,171516,0,2,5
48941,1,3,171515,171516,171519,1,4,0
48942,2,3,171517,171519,171522,2,5,0
48943,4,1,171521,171522,171523,1,2,0
48944,2,2,171523,171523,171525,0,2,0
48945,1,1,171524,171525,171526,1,2,0
48946,4,3,171528,171528,171531,0,3,2
48947,3,1,171531,171531,171532,0,1,0
48948,1,3,171532,171532,171535,0,3,0
48949,2,2,171534,171535,171537,1,3,0
48950,1,1,171535,171537,171538,2,3,0
48951,3,2,171538,171538,171540,0,2,0
48952,6,3,171544,171544,171547,0,3,4
48953,3,1,171547,171547,171548,0,1,0
48954,1,3,171548,171548,171551,0,3,0
48955,2,1,171550,171551,171552,1,2,0
48956,5,3,171555,171555,171558,0,3,3
48957,6,2,171561,171561,171563,0,2,3
48958,3,2,171564,171564,171566,0,2,1
48959,3,3,171567,171567,171570,0,3,1
48960,5,2,171572,171572,171574,0,2,2
48961,4,2,171576,171576,171578,0,2,2
48962,3,3,171579,171579,171582,0,3,1
48963,2,1,171581,171582,171583,1,2,0
48964,5,2,171586,171586,171588,0,2,3
48965,6,3,171592,171592,171595,0,3,4
48966,5,2,171597,171597,171599,0,2,2
48967,4,2,171601,171601,171603,0,2,2
48968,3,2,171604,171604,171606,0,2,1
48969,6,3,171610,171610,171613,0,3,4
48970,3,3,171613,171613,171616,0,3,0
48971,1,2,171614,171616,171618,2,4,0
48972,3,2,171617,171618,171620,1,3,0
48973,3,3,171620,171620,171623,0,3,0
48974,6,3,171626,171626,171629,0,3,3
48975,2,1,171628,171629,171630,1,2,0
48976,5,2,171633,171633,171635,0,2,3
48977,3,1,171636,171636,171637,0,1,1
48978,3,1,171639,171639,171640,0,1,2
48979,6,1,171645,171645,171646,0,1,5
48980,3,2,171648,171648,171650,0,2,2
48981,2,2,171650,171650,171652,0,2,0
48982,4,2,171654,171654,171656,0,2,2
48983,4,1,171658,171658,171659,0,1,2
48984,2,2,171660,171660,171662,0,2,1
48985,4,2,171664,171664,171666,0,2,2
48986,3,1,171667,171667,171668,0,1,1
48987,6,1,171673,171673,171674,0,1,5
48988,4,3,171677,171677,171680,0,3,3
48989,2,1,171679,171680,171681,1,2,0
48990,5,3,171684,171684,171687,0,3,3
48991,1,3,171685,171687,171690,2,5,0
48992,6,3,171691,171691,171694,0,3,1
48993,4,2,171695,171695,171697,0,2,1
48994,6,2,171701,171701,171703,0,2,4
48995,4,3,171705,171705,171708,0,3,2
48996,2,2,171707,171708,171710,1,3,0
48997,3,2,171710,171710,171712,0,2,0
48998,1,1,171711,171712,171713,1,2,0
48999,1,3,171712,171713,171716,1,4,0
49000,5,3,171717,171717,171720,0,3,1
49001,5,1,171722,171722,171723,0,1,2
49002,5,3,171727,171727,171730,0,3,4
49003,3,3,171730,171730,171733,0,3,0
49004,6,2,171736,171736,171738,0,2,3
49005,3,3,171739,171739,171742,0,3,1
49006,2,1,171741,171742,171743,1,2,0
49007,1,3,171742,171743,171746,1,4,0
49008,1,3,171743,171746,171749,3,6,0
49009,2,3,171745,171749,171752,4,7,0
49010,2,2,171747,171752,171754,5,7,0
49011,1,3,171748,171754,171757,6,9,0
49012,1,2,171749,171757,171759,8,10,0
49013,3,2,171752,171759,171761,7,9,0
49014,1,1,171753,171761,171762,8,9,0
49015,6,3,171759,171762,171765,3,6,0
49016,1,1,171760,171765,171766,5,6,0
49017,1,3,171761,171766,171769,5,8,0
49018,6,3,171767,171769,171772,2,5,0
49019,3,1,171770,171772,171773,2,3,0
49020,3,2,171773,171773,171775,0,2,0
49021,5,2,171778,171778,171780,0,2,3
49022,5,3,171783,171783,171786,0,3,3
49023,2,1,171785,171786,171787,1,2,0
49024,3,3,171788,171788,171791,0,3,1
49025,2,3,171790,171791,171794,1,4,0
49026,3,2,171793,171794,171796,1,3,0
49027,3,3,171796,171796,171799,0,3,0
49028,6,3,171802,171802,171805,0,3,3
49029,1,1,171803,171805,171806,2,3,0
49030,4,2,171807,171807,171809,0,2,1
49031,2,1,171809,171809,171810,0,1,0
49032,5,1,171814,171814,171815,0,1,4
49033,2,2,171816,171816,171818,0,2,1
49034,3,1,171819,171819,171820,0,1,1
49035,1,1,171820,171820,171821,0,1,0
49036,3,2,171823,171823,171825,0,2,2
49037,3,2,171826,171826,171828,0,2,1
49038,4,2,171830,171830,171832,0,2,2
49039,4,3,171834,171834,171837,0,3,2
49040,3,3,171837,171837,171840,0,3,0
49041,2,1,171839,171840,171841,1,2,0
49042,3,2,171842,171842,171844,0,2,1
49043,6,2,171848,171848,171850,0,2,4
49044,6,2,171854,171854,171856,0,2,4
49045,6,1,171860,171860,171861,0,1,4
49046,6,1,171866,171866,171867,0,1,5
49047,3,3,171869,171869,171872,0,3,2
49048,3,2,171872,171872,171874,0,2,0
49049,4,2,171876,171876,171878,0,2,2
49050,5,2,171881,171881,171883,0,2,3
49051,2,1,171883,171883,171884,0,1,0
49052,5,1,171888,171888,171889,0,1,4
49053,3,3,171891,171891,171894,0,3,2
49054,2,2,171893,171894,171896,1,3,0
49055,5,3,171898,171898,171901,0,3,2
49056,4,1,171902,171902,171903,0,1,1
49057,4,3,171906,171906,171909,0,3,3
49058,6,1,171912,171912,171913,0,1,3
49059,4,1,171916,171916,171917,0,1,3
49060,6,1,171922,171922,171923,0,1,5
49061,6,3,171928,171928,171931,0,3,5
49062,1,3,171929,171931,171934,2,5,0
49063,3,1,171932,171934,171935,2,3,0
49064,3,1,171935,171935,171936,0,1,0
49065,5,3,171940,171940,171943,0,3,4
49066,5,1,171945,171945,171946,0,1,2
49067,5,1,171950,171950,171951,0,1,4
49068,1,2,171951,171951,171953,0,2,0
49069,3,2,171954,171954,171956,0,2,1
49070,3,3,171957,171957,171960,0,3,1
49071,6,3,171963,171963,171966,0,3,3
49072,3,2,171966,171966,171968,0,2,0
49073,5,3,171971,171971,171974,0,3,3
49074,4,3,171975,171975,171978,0,3,1
49075,1,1,171976,171978,171979,2,3,0
49076,2,1,171978,171979,171980,1,2,0
49077,1,2,171979,171980,171982,1,3,0
49078,1,1,171980,171982,171983,2,3,0
49079,4,1,171984,171984,171985,0,1,1
49080,4,3,171988,171988,171991,0,3,3
49081,5,1,171993,171993,171994,0,1,2
49082,3,3,171996,171996,171999,0,3,2
49083,1,1,171997,171999,172000,2,3,0
49084,2,3,171999,172000,172003,1,4,0
49085,3,2,172002,172003,172005,1,3,0
49086,4,3,172006,172006,172009,0,3,1
49087,2,2,172008,172009,172011,1,3,0
49088,6,1,172014,172014,172015,0,1,3
49089,4,2,172018,172018,172020,0,2,3
49090,1,1,172019,172020,172021,1,2,0
49091,2,3,172021,172021,172024,0,3,0
49092,3,3,172024,172024,172027,0,3,0
49093,3,2,172027,172027,172029,0,2,0
49094,2,2,172029,172029,172031,0,2,0
49095,5,1,172034,172034,172035,0,1,3
49096,4,2,172038,172038,172040,0,2,3
49097,6,2,172044,172044,172046,0,2,4
49098,1,3,172045,172046,172049,1,4,0
49099,6,1,172051,172051,172052,0,1,2
49100,4,2,172055,172055,172057,0,2,3
49101,1,1,172056,172057,172058,1,2,0
49102,6,1,172062,172062,172063,0,1,4
49103,5,2,172067,172067,172069,0,2,4
49104,6,2,172073,172073,172075,0,2,4
49105,4,1,172077,172077,172078,0,1,2
49106,5,1,172082,172082,172083,0,1,4
49107,1,1,172083,172083,172084,0,1,0
49108,1,3,172084,172084,172087,0,3,0
49109,1,1,172085,172087,172088,2,3,0
49110,6,3,172091,172091,172094,0,3,3
49111,5,2,172096,172096,172098,0,2,2
49112,2,1,172098,172098,172099,0,1,0
49113,3,2,172101,172101,172103,0,2,2
49114,4,1,172105,172105,172106,0,1,2
49115,3,2,172108,172108,172110,0,2,2
49116,5,3,172113,172113,172116,0,3,3
49117,2,3,172115,172116,172119,1,4,0
49118,3,1,172118,172119,172120,1,2,0
49119,6,1,172124,172124,172125,0,1,4
49120,5,1,172129,172129,172130,0,1,4
49121,1,3,172130,172130,172133,0,3,0
49122,5,2,172135,172135,172137,0,2,2
49123,6,1,172141,172141,172142,0,1,4
49124,5,3,172146,172146,172149,0,3,4
49125,4,2,172150,172150,172152,0,2,1
49126,1,2,172151,172152,172154,1,3,0
49127,2,3,172153,172154,172157,1,4,0
49128,2,1,172155,172157,172158,2,3,0
49129,6,1,172161,172161,172162,0,1,3
49130,2,3,172163,172163,172166,0,3,1
49131,6,3,172169,172169,172172,0,3,3
49132,3,1,172172,172172,172173,0,1,0
49133,4,3,172176,172176,172179,0,3,3
49134,1,3,172177,172179,172182,2,5,0
49135,6,3,172183,172183,172186,0,3,1
49136,2,1,172185,172186,172187,1,2,0
49137,3,3,172188,172188,172191,0,3,1
49138,2,1,172190,172191,172192,1,2,0
49139,3,3,172193,172193,172196,0,3,1
49140,3,1,172196,172196,172197,0,1,0
49141,3,1,172199,172199,172200,0,1,2
49142,4,3,172203,172203,172206,0,3,3
49143,4,3,172207,172207,172210,0,3,1
49144,1,3,172208,172210,172213,2,5,0
49145,2,2,172210,172213,172215,3,5,0
49146,3,3,172213,172215,172218,2,5,0
49147,3,2,172216,172218,172220,2,4,0
49148,6,3,172222,172222,172225,0,3,2
49149,4,1,172226,172226,172227,0,1,1
49150,4,1,172230,172230,172231,0,1,3
49151,3,2,172233,172233,172235,0,2,2
49152,3,3,172236,172236,172239,0,3,1
49153,3,3,172239,172239,172242,0,3,0
49154,2,3,172241,172242,172245,1,4,0
49155,5,2,172246,172246,172248,0,2,1
49156,3,3,172249,172249,172252,0,3,1
49157,1,1,172250,172252,172253,2,3,0
49158,4,1,172254,172254,172255,0,1,1
49159,2,3,172256,172256,172259,0,3,1
49160,5,3,172261,172261,172264,0,3,2
49161,2,3,172263,172264,172267,1,4,0
49162,6,1,172269,172269,172270,0,1,2
49163,6,2,172275,172275,172277,0,2,5
49164,5,2,172280,172280,172282,0,2,3
49165,2,2,172282,172282,172284,0,2,0
49166,3,1,172285,172285,172286,0,1,1
49167,2,1,172287,172287,172288,0,1,1
49168,3,2,172290,172290,172292,0,2,2
49169,3,2,172293,172293,172295,0,2,1
49170,5,1,172298,172298,172299,0,1,3
49171,4,1,172302,172302,172303,0,1,3
49172,1,2,172303,172303,172305,0,2,0
49173,4,1,172307,172307,172308,0,1,2
49174,4,2,172311,172311,172313,0,2,3
49175,4,3,172315,172315,172318,0,3,2
49176,5,2,172320,172320,172322,0,2,2
49177,5,2,172325,172325,172327,0,2,3
49178,1,2,172326,172327,172329,1,3,0
49179,5,1,172331,172331,172332,0,1,2
49180,3,2,172334,172334,172336,0,2,2
49181,2,3,172336,172336,172339,0,3,0
49182,3,1,172339,172339,172340,0,1,0
49183,3,2,172342,172342,172344,0,2,2
49184,6,3,172348,172348,172351,0,3,4
49185,6,2,172354,172354,172356,0,2,3
49186,4,1,172358,172358,172359,0,1,2
49187,6,2,172364,172364,172366,0,2,5
49188,3,1,172367,172367,172368,0,1,1
49189,3,3,172370,172370,172373,0,3,2
49190,1,3,172371,172373,172376,2,5,0
49191,3,2,172374,172376,172378,2,4,0
49192,4,3,172378,172378,172381,0,3,0
49193,5,3,172383,172383,172386,0,3,2
49194,1,2,172384,172386,172388,2,4,0
49195,5,2,172389,172389,172391,0,2,1
49196,6,1,172395,172395,172396,0,1,4
49197,3,1,172398,172398,172399,0,1,2
49198,1,3,172399,172399,172402,0,3,0
49199,5,3,172404,172404,172407,0,3,2
49200,5,1,172409,172409,172410,0,1,2
49201,5,3,172414,172414,172417,0,3,4
49202,4,2,172418,172418,172420,0,2,1
49203,4,2,172422,172422,172424,0,2,2
49204,1,2,172423,172424,172426,1,3,0
49205,5,1,172428,172428,172429,0,1,2
49206,5,1,172433,172433,172434,0,1,4
49207,3,2,172436,172436,172438,0,2,2
49208,1,3,172437,172438,172441,1,4,0
49209,3,2,172440,172441,172443,1,3,0
49210,3,1,172443,172443,172444,0,1,0
49211,6,2,172449,172449,172451,0,2,5
49212,2,1,172451,172451,172452,0,1,0
49213,3,2,172454,172454,172456,0,2,2
49214,4,2,172458,172458,172460,0,2,2
49215,2,3,172460,172460,172463,0,3,0
49216,3,2,172463,172463,172465,0,2,0
49217,3,1,172466,172466,172467,0,1,1
49218,3,3,172469,172469,172472,0,3,2
49219,3,1,172472,172472,172473,0,1,0
49220,6,2,172478,172478,172480,0,2,5
49221,5,1,172483,172483,172484,0,1,3
49222,4,2,172487,172487,172489,0,2,3
49223,3,1,172490,172490,172491,0,1,1
49224,2,3,172492,172492,172495,0,3,1
49225,1,2,172493,172495,172497,2,4,0
49226,6,2,172499,172499,172501,0,2,2
49227,1,3,172500,172501,172504,1,4,0
49228,2,2,172502,172504,172506,2,4,0
49229,6,2,172508,172508,172510,0,2,2
49230,6,3,172514,172514,172517,0,3,4
49231,4,2,172518,172518,172520,0,2,1
49232,6,1,172524,172524,172525,0,1,4
49233,5,1,172529,172529,172530,0,1,4
49234,4,1,172533,172533,172534,0,1,3
49235,3,1,172536,172536,172537,0,1,2
49236,4,1,172540,172540,172541,0,1,3
49237,4,3,172544,172544,172547,0,3,3
49238,5,1,172549,172549,172550,0,1,2
49239,2,3,172551,172551,172554,0,3,1
49240,5,3,172556,172556,172559,0,3,2
49241,3,2,172559,172559,172561,0,2,0
49242,5,1,172564,172564,172565,0,1,3
49243,5,3,172569,172569,172572,0,3,4
49244,6,1,172575,172575,172576,0,1,3
49245,1,1,172576,172576,172577,0,1,0
49246,1,2,172577,172577,172579,0,2,0
49247,1,2,172578,172579,172581,1,3,0
49248,2,1,172580,172581,172582,1,2,0
49249,2,1,172582,172582,172583,0,1,0
49250,5,1,172587,172587,172588,0,1,4
49251,5,1,172592,172592,172593,0,1,4
49252,1,1,172593,172593,172594,0,1,0
49253,3,2,172596,172596,172598,0,2,2
49254,3,3,172599,172599,172602,0,3,1
49255,4,3,172603,172603,172606,0,3,1
49256,2,3,172605,172606,172609,1,4,0
49257,5,3,172610,172610,172613,0,3,1
49258,1,3,172611,172613,172616,2,5,0
49259,6,3,172617,172617,172620,0,3,1
49260,6,3,172623,172623,172626,0,3,3
49261,3,1,172626,172626,172627,0,1,0
49262,2,1,172628,172628,172629,0,1,1
49263,4,1,172632,172632,172633,0,1,3
49264,4,2,172636,172636,172638,0,2,3
49265,2,1,172638,172638,172639,0,1,0
49266,2,1,172640,172640,172641,0,1,1
49267,4,1,172644,172644,172645,0,1,3
49268,3,3,172647,172647,172650,0,3,2
49269,3,1,172650,172650,172651,0,1,0
49270,1,1,172651,172651,172652,0,1,0
49271,6,3,172657,172657,172660,0,3,5
49272,6,1,172663,172663,172664,0,1,3
49273,1,3,172664,172664,172667,0,3,0
49274,1,1,172665,172667,172668,2,3,0
49275,1,3,172666,172668,172671,2,5,0
49276,3,2,172669,172671,172673,2,4,0
49277,6,2,172675,172675,172677,0,2,2
49278,1,3,172676,172677,172680,1,4,0
49279,2,1,172678,172680,172681,2,3,0
49280,2,2,172680,172681,172683,1,3,0
49281,2,2,172682,172683,172685,1,3,0
49282,6,3,172688,172688,172691,0,3,3
49283,5,2,172693,172693,172695,0,2,2
49284,5,3,172698,172698,172701,0,3,3
49285,4,2,172702,172702,172704,0,2,1
49286,6,1,172708,172708,172709,0,1,4
49287,5,3,172713,172713,172716,0,3,4
49288,3,2,172716,172716,172718,0,2,0
49289,4,1,172720,172720,172721,0,1,2
49290,3,1,172723,172723,172724,0,1,2
49291,4,1,172727,172727,172728,0,1,3
49292,3,3,172730,172730,172733,0,3,2
49293,4,3,172734,172734,172737,0,3,1
49294,1,1,172735,172737,172738,2,3,0
49295,4,2,172739,172739,172741,0,2,1
49296,5,2,172744,172744,172746,0,2,3
49297,1,2,172745,172746,172748,1,3,0
49298,1,1,172746,172748,172749,2,3,0
49299,4,3,172750,172750,172753,0,3,1
49300,5,1,172755,172755,172756,0,1,2
49301,3,2,172758,172758,172760,0,2,2
49302,4,1,172762,172762,172763,0,1,2
49303,4,2,172766,172766,172768,0,2,3
49304,1,2,172767,172768,172770,1,3,0
49305,1,2,172768,172770,172772,2,4,0
49306,2,3,172770,172772,172775,2,5,0
49307,3,1,172773,172775,172776,2,3,0
49308,6,2,172779,172779,172781,0,2,3
49309,1,2,172780,172781,172783,1,3,0
49310,2,2,172782,172783,172785,1,3,0
49311,2,2,172784,172785,172787,1,3,0
49312,4,1,172788,172788,172789,0,1,1
49313,1,1,172789,172789,172790,0,1,0
49314,3,3,172792,172792,172795,0,3,2
49315,4,2,172796,172796,172798,0,2,1
49316,3,2,172799,172799,172801,0,2,1
49317,6,2,172805,172805,172807,0,2,4
49318,1,3,172806,172807,172810,1,4,0
49319,5,2,172811,172811,172813,0,2,1
49320,3,2,172814,172814,172816,0,2,1
49321,2,2,172816,172816,172818,0,2,0
49322,2,2,172818,172818,172820,0,2,0
49323,5,3,172823,172823,172826,0,3,3
49324,6,3,172829,172829,172832,0,3,3
49325,5,2,172834,172834,172836,0,2,2
49326,4,1,172838,172838,172839,0,1,2
49327,4,3,172842,172842,172845,0,3,3
49328,3,1,172845,172845,172846,0,1,0
49329,6,1,172851,172851,172852,0,1,5
49330,6,1,172857,172857,172858,0,1,5
49331,3,1,172860,172860,172861,0,1,2
49332,5,3,172865,172865,172868,0,3,4
49333,4,1,172869,172869,172870,0,1,1
49334,4,3,172873,172873,172876,0,3,3
49335,3,1,172876,172876,172877,0,1,0
49336,2,3,172878,172878,172881,0,3,1
49337,2,2,172880,172881,172883,1,3,0
49338,6,3,172886,172886,172889,0,3,3
49339,2,3,172888,172889,172892,1,4,0
49340,6,3,172894,172894,172897,0,3,2
49341,3,3,172897,172897,172900,0,3,0
49342,4,3,172901,172901,172904,0,3,1
49343,2,2,172903,172904,172906,1,3,0
49344,4,1,172907,172907,172908,0,1,1
49345,5,1,172912,172912,172913,0,1,4
49346,6,1,172918,172918,172919,0,1,5
49347,1,1,172919,172919,172920,0,1,0
49348,3,1,172922,172922,172923,0,1,2
49349,1,3,172923,172923,172926,0,3,0
49350,6,2,172929,172929,172931,0,2,3
49351,5,3,172934,172934,172937,0,3,3
49352,2,1,172936,172937,172938,1,2,0
49353,5,1,172941,172941,172942,0,1,3
49354,1,3,172942,172942,172945,0,3,0
49355,4,3,172946,172946,172949,0,3,1
49356,3,3,172949,172949,172952,0,3,0
49357,2,3,172951,172952,172955,1,4,0
49358,3,3,172954,172955,172958,1,4,0
49359,1,2,172955,172958,172960,3,5,0
49360,3,1,172958,172960,172961,2,3,0
49361,6,2,172964,172964,172966,0,2,3
49362,1,3,172965,172966,172969,1,4,0
49363,3,2,172968,172969,172971,1,3,0
49364,3,3,172971,172971,172974,0,3,0
49365,6,3,172977,172977,172980,0,3,3
49366,5,3,172982,172982,172985,0,3,2
49367,1,3,172983,172985,172988,2,5,0
49368,3,2,172986,172988,172990,2,4,0
49369,5,1,172991,172991,172992,0,1,1
49370,5,1,172996,172996,172997,0,1,4
49371,1,2,172997,172997,172999,0,2,0
49372,3,1,173000,173000,173001,0,1,1
49373,5,1,173005,173005,173006,0,1,4
49374,5,1,173010,173010,173011,0,1,4
49375,5,3,173015,173015,173018,0,3,4
49376,5,2,173020,173020,173022,0,2,2
49377,4,1,173024,173024,173025,0,1,2
49378,4,1,173028,173028,173029,0,1,3
49379,5,2,173033,173033,173035,0,2,4
49380,3,1,173036,173036,173037,0,1,1
49381,5,1,173041,173041,173042,0,1,4
49382,3,1,173044,173044,173045,0,1,2
49383,6,3,173050,173050,173053,0,3,5
49384,3,3,173053,173053,173056,0,3,0
49385,4,3,173057,173057,173060,0,3,1
49386,2,1,173059,173060,173061,1,2,0
49387,4,3,173063,173063,173066,0,3,2
49388,5,3,173068,173068,173071,0,3,2
49389,3,3,173071,173071,173074,0,3,0
49390,6,1,173077,173077,173078,0,1,3
49391,5,2,173082,173082,173084,0,2,4
49392,1,1,173083,173084,173085,1,2,0
49393,1,1,173084,173085,173086,1,2,0
49394,3,3,173087,173087,173090,0,3,1
49395,6,3,173093,173093,173096,0,3,3
49396,4,2,173097,173097,173099,0,2,1
49397,6,1,173103,173103,173104,0,1,4
49398,4,3,173107,173107,173110,0,3,3
49399,4,3,173111,173111,173114,0,3,1
49400,2,3,173113,173114,173117,1,4,0
49401,3,2,173116,173117,173119,1,3,0
49402,4,3,173120,173120,173123,0,3,1
49403,6,3,173126,173126,173129,0,3,3
49404,3,3,173129,173129,173132,0,3,0
49405,6,3,173135,173135,173138,0,3,3
49406,4,2,173139,173139,173141,0,2,1
49407,4,2,173143,173143,173145,0,2,2
49408,2,3,173145,173145,173148,0,3,0
49409,3,3,173148,173148,173151,0,3,0
49410,6,2,173154,173154,173156,0,2,3
49411,6,1,173160,173160,173161,0,1,4
49412,4,3,173164,173164,173167,0,3,3
49413,6,1,173170,173170,173171,0,1,3
49414,2,2,173172,173172,173174,0,2,1
49415,4,1,173176,173176,173177,0,1,2
49416,1,1,173177,173177,173178,0,1,0
49417,2,1,173179,173179,173180,0,1,1
49418,5,2,173184,173184,173186,0,2,4
49419,4,2,173188,173188,173190,0,2,2
49420,2,1,173190,173190,173191,0,1,0
49421,6,3,173196,173196,173199,0,3,5
49422,3,1,173199,173199,173200,0,1,0
49423,5,2,173204,173204,173206,0,2,4
49424,3,1,173207,173207,173208,0,1,1
49425,5,3,173212,173212,173215,0,3,4
49426,4,1,173216,173216,173217,0,1,1
49427,6,2,173222,173222,173224,0,2,5
49428,3,2,173225,173225,173227,0,2,1
49429,4,3,173229,173229,173232,0,3,2
49430,2,3,173231,173232,173235,1,4,0
49431,5,3,173236,173236,173239,0,3,1
49432,5,1,173241,173241,173242,0,1,2
49433,5,2,173246,173246,173248,0,2,4
49434,6,1,173252,173252,173253,0,1,4
49435,4,3,173256,173256,173259,0,3,3
49436,1,2,173257,173259,173261,2,4,0
49437,1,2,173258,173261,173263,3,5,0
49438,4,1,173262,173263,173264,1,2,0
49439,4,2,173266,173266,173268,0,2,2
49440,1,2,173267,173268,173270,1,3,0
49441,1,2,173268,173270,173272,2,4,0
49442,6,2,173274,173274,173276,0,2,2
49443,3,3,173277,173277,173280,0,3,1
49444,1,3,173278,173280,173283,2,5,0
49445,4,1,173282,173283,173284,1,2,0
49446,2,1,173284,173284,173285,0,1,0
49447,1,2,173285,173285,173287,0,2,0
49448,5,1,173290,173290,173291,0,1,3
49449,3,2,173293,173293,173295,0,2,2
49450,3,1,173296,173296,173297,0,1,1
49451,2,2,173298,173298,173300,0,2,1
49452,4,1,173302,173302,173303,0,1,2
49453,6,2,173308,173308,173310,0,2,5
49454,1,2,173309,173310,173312,1,3,0
49455,1,2,173310,173312,173314,2,4,0
49456,4,1,173314,173314,173315,0,1,0
49457,2,2,173316,173316,173318,0,2,1
49458,6,1,173322,173322,173323,0,1,4
49459,4,1,173326,173326,173327,0,1,3
49460,5,1,173331,173331,173332,0,1,4
49461,5,3,173336,173336,173339,0,3,4
49462,1,3,173337,173339,173342,2,5,0
49463,5,3,173342,173342,173345,0,3,0
49464,3,3,173345,173345,173348,0,3,0
49465,3,1,173348,173348,173349,0,1,0
49466,5,2,173353,173353,173355,0,2,4
49467,3,3,173356,173356,173359,0,3,1
49468,1,2,173357,173359,173361,2,4,0
49469,3,3,173360,173361,173364,1,4,0
49470,6,1,173366,173366,173367,0,1,2
49471,2,2,173368,173368,173370,0,2,1
49472,1,1,173369,173370,173371,1,2,0
49473,4,3,173373,173373,173376,0,3,2
49474,5,2,173378,173378,173380,0,2,2
49475,5,3,173383,173383,173386,0,3,3
49476,5,1,173388,173388,173389,0,1,2
49477,1,3,173389,173389,173392,0,3,0
49478,4,3,173393,173393,173396,0,3,1
49479,4,3,173397,173397,173400,0,3,1
49480,3,2,173400,173400,173402,0,2,0
49481,1,3,173401,173402,173405,1,4,0
49482,5,2,173406,173406,173408,0,2,1
49483,2,3,173408,173408,173411,0,3,0
49484,4,2,173412,173412,173414,0,2,1
49485,3,3,173415,173415,173418,0,3,1
49486,2,1,173417,173418,173419,1,2,0
49487,2,3,173419,173419,173422,0,3,0
49488,5,2,173424,173424,173426,0,2,2
49489,6,3,173430,173430,173433,0,3,4
49490,3,1,173433,173433,173434,0,1,0
49491,6,2,173439,173439,173441,0,2,5
49492,5,1,173444,173444,173445,0,1,3
49493,4,3,173448,173448,173451,0,3,3
49494,2,3,173450,173451,173454,1,4,0
49495,4,3,173454,173454,173457,0,3,0
49496,5,2,173459,173459,173461,0,2,2
49497,2,2,173461,173461,173463,0,2,0
49498,5,2,173466,173466,173468,0,2,3
49499,2,3,173468,173468,173471,0,3,0
49500,3,3,173471,173471,173474,0,3,0
49501,6,1,173477,173477,173478,0,1,3
49502,4,2,173481,173481,173483,0,2,3
49503,6,3,173487,173487,173490,0,3,4
49504,2,2,173489,173490,173492,1,3,0
49505,3,3,173492,173492,173495,0,3,0
49506,4,3,173496,173496,173499,0,3,1
49507,3,3,173499,173499,173502,0,3,0
49508,6,2,173505,173505,173507,0,2,3
49509,1,2,173506,173507,173509,1,3,0
49510,3,2,173509,173509,173511,0,2,0
49511,2,3,173511,173511,173514,0,3,0
49512,4,2,173515,173515,173517,0,2,1
49513,3,3,173518,173518,173521,0,3,1
49514,1,1,173519,173521,173522,2,3,0
49515,1,2,173520,173522,173524,2,4,0
49516,6,1,173526,173526,173527,0,1,2
49517,2,2,173528,173528,173530,0,2,1
49518,4,1,173532,173532,173533,0,1,2
49519,4,1,173536,173536,173537,0,1,3
49520,2,2,173538,173538,173540,0,2,1
49521,2,3,173540,173540,173543,0,3,0
49522,1,3,173541,173543,173546,2,5,0
49523,2,1,173543,173546,173547,3,4,0
49524,3,2,173546,173547,173549,1,3,0
49525,6,3,173552,173552,173555,0,3,3
49526,6,2,173558,173558,173560,0,2,3
49527,5,3,173563,173563,173566,0,3,3
49528,2,1,173565,173566,173567,1,2,0
49529,4,3,173569,173569,173572,0,3,2
49530,3,2,173572,173572,173574,0,2,0
49531,4,2,173576,173576,173578,0,2,2
49532,5,2,173581,173581,173583,0,2,3
49533,2,3,173583,173583,173586,0,3,0
49534,4,1,173587,173587,173588,0,1,1
49535,6,2,173593,173593,173595,0,2,5
49536,5,1,173598,173598,173599,0,1,3
49537,5,1,173603,173603,173604,0,1,4
49538,4,1,173607,173607,173608,0,1,3
49539,1,3,173608,173608,173611,0,3,0
49540,4,1,173612,173612,173613,0,1,1
49541,3,2,173615,173615,173617,0,2,2
49542,3,2,173618,173618,173620,0,2,1
49543,6,2,173624,173624,173626,0,2,4
49544,6,3,173630,173630,173633,0,3,4
49545,4,3,173634,173634,173637,0,3,1
49546,5,2,173639,173639,173641,0,2,2
49547,5,3,173644,173644,173647,0,3,3
49548,5,1,173649,173649,173650,0,1,2
49549,2,3,173651,173651,173654,0,3,1
49550,1,1,173652,173654,173655,2,3,0
49551,4,1,173656,173656,173657,0,1,1
49552,6,1,173662,173662,173663,0,1,5
49553,2,1,173664,173664,173665,0,1,1
49554,5,1,173669,173669,173670,0,1,4
49555,2,3,173671,173671,173674,0,3,1
49556,1,2,173672,173674,173676,2,4,0
49557,4,1,173676,173676,173677,0,1,0
49558,5,3,173681,173681,173684,0,3,4
49559,1,2,173682,173684,173686,2,4,0
49560,3,2,173685,173686,173688,1,3,0
49561,6,2,173691,173691,173693,0,2,3
49562,1,3,173692,173693,173696,1,4,0
49563,6,2,173698,173698,173700,0,2,2
49564,5,2,173703,173703,173705,0,2,3
49565,4,2,173707,173707,173709,0,2,2
49566,4,3,173711,173711,173714,0,3,2
49567,2,2,173713,173714,173716,1,3,0
49568,4,1,173717,173717,173718,0,1,1
49569,2,2,173719,173719,173721,0,2,1
49570,1,3,173720,173721,173724,1,4,0
49571,6,2,173726,173726,173728,0,2,2
49572,5,1,173731,173731,173732,0,1,3
49573,2,2,173733,173733,173735,0,2,1
49574,6,1,173739,173739,173740,0,1,4
49575,6,3,173745,173745,173748,0,3,5
49576,2,3,173747,173748,173751,1,4,0
49577,2,3,173749,173751,173754,2,5,0
49578,4,1,173753,173754,173755,1,2,0
49579,4,3,173757,173757,173760,0,3,2
49580,2,2,173759,173760,173762,1,3,0
49581,1,1,173760,173762,173763,2,3,0
49582,3,1,173763,173763,173764,0,1,0
49583,1,1,173764,173764,173765,0,1,0
49584,2,2,173766,173766,173768,0,2,1
49585,4,2,173770,173770,173772,0,2,2
49586,2,1,173772,173772,173773,0,1,0
49587,1,2,173773,173773,173775,0,2,0
49588,2,1,173775,173775,173776,0,1,0
49589,5,2,173780,173780,173782,0,2,4
49590,1,2,173781,173782,173784,1,3,0
49591,4,2,173785,173785,173787,0,2,1
49592,2,2,173787,173787,173789,0,2,0
49593,1,2,173788,173789,173791,1,3,0
49594,4,2,173792,173792,173794,0,2,1
49595,3,1,173795,173795,173796,0,1,1
49596,3,2,173798,173798,173800,0,2,2
49597,3,3,173801,173801,173804,0,3,1
49598,3,3,173804,173804,173807,0,3,0
49599,5,1,173809,173809,173810,0,1,2
49600,3,2,173812,173812,173814,0,2,2
49601,5,1,173817,173817,173818,0,1,3
49602,6,1,173823,173823,173824,0,1,5
49603,4,2,173827,173827,173829,0,2,3
49604,6,3,173833,173833,173836,0,3,4
49605,6,1,173839,173839,173840,0,1,3
49606,5,1,173844,173844,173845,0,1,4
49607,6,3,173850,173850,173853,0,3,5
49608,2,1,173852,173853,173854,1,2,0
49609,1,1,173853,173854,173855,1,2,0
49610,3,1,173856,173856,173857,0,1,1
49611,1,3,173857,173857,173860,0,3,0
49612,5,2,173862,173862,173864,0,2,2
49613,6,1,173868,173868,173869,0,1,4
49614,6,3,173874,173874,173877,0,3,5
49615,5,3,173879,173879,173882,0,3,2
49616,5,1,173884,173884,173885,0,1,2
49617,4,3,173888,173888,173891,0,3,3
49618,2,3,173890,173891,173894,1,4,0
49619,6,3,173896,173896,173899,0,3,2
49620,5,2,173901,173901,173903,0,2,2
49621,1,1,173902,173903,173904,1,2,0
49622,2,2,173904,173904,173906,0,2,0
49623,6,3,173910,173910,173913,0,3,4
49624,1,2,173911,173913,173915,2,4,0
49625,2,2,173913,173915,173917,2,4,0
49626,5,1,173918,173918,173919,0,1,1
49627,1,3,173919,173919,173922,0,3,0
49628,4,2,173923,173923,173925,0,2,1
49629,5,2,173928,173928,173930,0,2,3
49630,3,1,173931,173931,173932,0,1,1
49631,4,1,173935,173935,173936,0,1,3
49632,2,2,173937,173937,173939,0,2,1
49633,2,2,173939,173939,173941,0,2,0
49634,1,2,173940,173941,173943,1,3,0
49635,1,3,173941,173943,173946,2,5,0
49636,4,2,173945,173946,173948,1,3,0
49637,5,2,173950,173950,173952,0,2,2
49638,4,3,173954,173954,173957,0,3,2
49639,6,1,173960,173960,173961,0,1,3
49640,3,3,173963,173963,173966,0,3,2
49641,5,3,173968,173968,173971,0,3,2
49642,4,2,173972,173972,173974,0,2,1
49643,4,3,173976,173976,173979,0,3,2
49644,4,1,173980,173980,173981,0,1,1
49645,3,2,173983,173983,173985,0,2,2
49646,5,1,173988,173988,173989,0,1,3
49647,5,3,173993,173993,173996,0,3,4
49648,5,2,173998,173998,174000,0,2,2
49649,1,3,173999,174000,174003,1,4,0
49650,1,1,174000,174003,174004,3,4,0
49651,2,3,174002,174004,174007,2,5,0
49652,1,1,174003,174007,174008,4,5,0
49653,6,3,174009,174009,174012,0,3,1
49654,1,2,174010,174012,174014,2,4,0
49655,2,3,174012,174014,174017,2,5,0
49656,2,2,174014,174017,174019,3,5,0
49657,5,2,174019,174019,174021,0,2,0
49658,3,3,174022,174022,174025,0,3,1
49659,5,1,174027,174027,174028,0,1,2
49660,6,1,174033,174033,174034,0,1,5
49661,3,2,174036,174036,174038,0,2,2
49662,3,1,174039,174039,174040,0,1,1
49663,4,2,174043,174043,174045,0,2,3
49664,4,1,174047,174047,174048,0,1,2
49665,4,2,174051,174051,174053,0,2,3
49666,1,2,174052,174053,174055,1,3,0
49667,2,2,174054,174055,174057,1,3,0
49668,2,3,174056,174057,174060,1,4,0
49669,5,1,174061,174061,174062,0,1,1
49670,3,3,174064,174064,174067,0,3,2
49671,3,3,174067,174067,174070,0,3,0
49672,2,2,174069,174070,174072,1,3,0
49673,4,1,174073,174073,174074,0,1,1
49674,2,1,174075,174075,174076,0,1,1
49675,1,3,174076,174076,174079,0,3,0
49676,4,1,174080,174080,174081,0,1,1
49677,4,1,174084,174084,174085,0,1,3
49678,6,1,174090,174090,174091,0,1,5
49679,1,3,174091,174091,174094,0,3,0
49680,3,1,174094,174094,174095,0,1,0
49681,1,1,174095,174095,174096,0,1,0
49682,1,2,174096,174096,174098,0,2,0
49683,1,1,174097,174098,174099,1,2,0
49684,2,3,174099,174099,174102,0,3,0
49685,2,1,174101,174102,174103,1,2,0
49686,3,3,174104,174104,174107,0,3,1
49687,5,1,174109,174109,174110,0,1,2
49688,6,2,174115,174115,174117,0,2,5
49689,2,3,174117,174117,174120,0,3,0
49690,5,1,174122,174122,174123,0,1,2
49691,1,1,174123,174123,174124,0,1,0
49692,3,1,174126,174126,174127,0,1,2
49693,1,3,174127,174127,174130,0,3,0
49694,2,2,174129,174130,174132,1,3,0
49695,3,2,174132,174132,174134,0,2,0
49696,6,3,174138,174138,174141,0,3,4
49697,6,1,174144,174144,174145,0,1,3
49698,3,3,174147,174147,174150,0,3,2
49699,6,3,174153,174153,174156,0,3,3
49700,5,3,174158,174158,174161,0,3,2
49701,4,1,174162,174162,174163,0,1,1
49702,3,3,174165,174165,174168,0,3,2
49703,3,1,174168,174168,174169,0,1,0
49704,3,3,174171,174171,174174,0,3,2
49705,1,2,174172,174174,174176,2,4,0
49706,4,1,174176,174176,174177,0,1,0
49707,4,2,174180,174180,174182,0,2,3
49708,5,3,174185,174185,174188,0,3,3
49709,6,1,174191,174191,174192,0,1,3
49710,3,3,174194,174194,174197,0,3,2
49711,4,3,174198,174198,174201,0,3,1
49712,2,1,174200,174201,174202,1,2,0
49713,6,3,174206,174206,174209,0,3,4
49714,1,1,174207,174209,174210,2,3,0
49715,6,1,174213,174213,174214,0,1,3
49716,5,2,174218,174218,174220,0,2,4
49717,6,3,174224,174224,174227,0,3,4
49718,1,2,174225,174227,174229,2,4,0
49719,5,3,174230,174230,174233,0,3,1
49720,6,2,174236,174236,174238,0,2,3
49721,4,2,174240,174240,174242,0,2,2
49722,5,3,174245,174245,174248,0,3,3
49723,2,3,174247,174248,174251,1,4,0
49724,4,2,174251,174251,174253,0,2,0
49725,4,2,174255,174255,174257,0,2,2
49726,2,2,174257,174257,174259,0,2,0
49727,5,2,174262,174262,174264,0,2,3
49728,4,1,174266,174266,174267,0,1,2
49729,5,2,174271,174271,174273,0,2,4
49730,3,3,174274,174274,174277,0,3,1
49731,2,2,174276,174277,174279,1,3,0
49732,3,2,174279,174279,174281,0,2,0
49733,4,1,174283,174283,174284,0,1,2
49734,4,3,174287,174287,174290,0,3,3
49735,6,2,174293,174293,174295,0,2,3
49736,2,2,174295,174295,174297,0,2,0
49737,5,3,174300,174300,174303,0,3,3
49738,6,3,174306,174306,174309,0,3,3
49739,5,1,174311,174311,174312,0,1,2
49740,5,1,174316,174316,174317,0,1,4
49741,1,1,174317,174317,174318,0,1,0
49742,2,1,174319,174319,174320,0,1,1
49743,1,1,174320,174320,174321,0,1,0
49744,4,1,174324,174324,174325,0,1,3
49745,3,2,174327,174327,174329,0,2,2
49746,4,1,174331,174331,174332,0,1,2
49747,1,2,174332,174332,174334,0,2,0
49748,1,1,174333,174334,174335,1,2,0
49749,3,3,174336,174336,174339,0,3,1
49750,5,1,174341,174341,174342,0,1,2
49751,5,1,174346,174346,174347,0,1,4
49752,6,1,174352,174352,174353,0,1,5
49753,3,2,174355,174355,174357,0,2,2
49754,3,2,174358,174358,174360,0,2,1
49755,4,2,174362,174362,174364,0,2,2
49756,5,1,174367,174367,174368,0,1,3
49757,5,2,174372,174372,174374,0,2,4
49758,5,2,174377,174377,174379,0,2,3
49759,4,1,174381,174381,174382,0,1,2
49760,2,3,174383,174383,174386,0,3,1
49761,3,3,174386,174386,174389,0,3,0
49762,1,3,174387,174389,174392,2,5,0
49763,3,3,174390,174392,174395,2,5,0
49764,3,1,174393,174395,174396,2,3,0
49765,5,3,174398,174398,174401,0,3,2
49766,1,3,174399,174401,174404,2,5,0
49767,3,1,174402,174404,174405,2,3,0
49768,1,2,174403,174405,174407,2,4,0
49769,5,2,174408,174408,174410,0,2,1
49770,4,3,174412,174412,174415,0,3,2
49771,6,1,174418,174418,174419,0,1,3
49772,5,2,174423,174423,174425,0,2,4
49773,3,3,174426,174426,174429,0,3,1
49774,1,2,174427,174429,174431,2,4,0
49775,1,1,174428,174431,174432,3,4,0
49776,4,2,174432,174432,174434,0,2,0
49777,6,2,174438,174438,174440,0,2,4
49778,3,3,174441,174441,174444,0,3,1
49779,3,3,174444,174444,174447,0,3,0
49780,4,1,174448,174448,174449,0,1,1
49781,5,1,174453,174453,174454,0,1,4
49782,1,2,174454,174454,174456,0,2,0
49783,5,3,174459,174459,174462,0,3,3
49784,1,1,174460,174462,174463,2,3,0
49785,4,2,174464,174464,174466,0,2,1
49786,4,3,174468,174468,174471,0,3,2
49787,2,3,174470,174471,174474,1,4,0
49788,1,1,174471,174474,174475,3,4,0
49789,4,1,174475,174475,174476,0,1,0
49790,2,1,174477,174477,174478,0,1,1
49791,5,3,174482,174482,174485,0,3,4
49792,1,3,174483,174485,174488,2,5,0
49793,2,1,174485,174488,174489,3,4,0
49794,6,3,174491,174491,174494,0,3,2
49795,1,1,174492,174494,174495,2,3,0
49796,6,2,174498,174498,174500,0,2,3
49797,6,1,174504,174504,174505,0,1,4
49798,1,3,174505,174505,174508,0,3,0
49799,1,2,174506,174508,174510,2,4,0
49800,6,3,174512,174512,174515,0,3,2
49801,5,3,174517,174517,174520,0,3,2
49802,1,1,174518,174520,174521,2,3,0
49803,5,2,174523,174523,174525,0,2,2
49804,5,1,174528,174528,174529,0,1,3
49805,1,2,174529,174529,174531,0,2,0
49806,4,2,174533,174533,174535,0,2,2
49807,5,2,174538,174538,174540,0,2,3
49808,4,2,174542,174542,174544,0,2,2
49809,5,3,174547,174547,174550,0,3,3
49810,2,2,174549,174550,174552,1,3,0
49811,5,3,174554,174554,174557,0,3,2
49812,2,3,174556,174557,174560,1,4,0
49813,4,1,174560,174560,174561,0,1,0
49814,6,3,174566,174566,174569,0,3,5
49815,3,1,174569,174569,174570,0,1,0
49816,1,3,174570,174570,174573,0,3,0
49817,1,1,174571,174573,174574,2,3,0
49818,5,1,174576,174576,174577,0,1,2
49819,1,2,174577,174577,174579,0,2,0
49820,2,3,174579,174579,174582,0,3,0
49821,1,1,174580,174582,174583,2,3,0
49822,6,2,174586,174586,174588,0,2,3
49823,1,2,174587,174588,174590,1,3,0
49824,6,2,174593,174593,174595,0,2,3
49825,3,2,174596,174596,174598,0,2,1
49826,1,1,174597,174598,174599,1,2,0
49827,6,1,174603,174603,174604,0,1,4
49828,2,2,174605,174605,174607,0,2,1
49829,6,2,174611,174611,174613,0,2,4
49830,2,1,174613,174613,174614,0,1,0
49831,1,2,174614,174614,174616,0,2,0
49832,2,2,174616,174616,174618,0,2,0
49833,2,2,174618,174618,174620,0,2,0
49834,4,1,174622,174622,174623,0,1,2
49835,3,1,174625,174625,174626,0,1,2
49836,2,2,174627,174627,174629,0,2,1
49837,2,2,174629,174629,174631,0,2,0
49838,5,1,174634,174634,174635,0,1,3
49839,2,2,174636,174636,174638,0,2,1
49840,4,2,174640,174640,174642,0,2,2
49841,6,1,174646,174646,174647,0,1,4
49842,2,1,174648,174648,174649,0,1,1
49843,3,2,174651,174651,174653,0,2,2
49844,1,3,174652,174653,174656,1,4,0
49845,3,2,174655,174656,174658,1,3,0
49846,1,1,174656,174658,174659,2,3,0
49847,4,2,174660,174660,174662,0,2,1
49848,6,2,174666,174666,174668,0,2,4
49849,6,2,174672,174672,174674,0,2,4
49850,6,3,174678,174678,174681,0,3,4
49851,3,3,174681,174681,174684,0,3,0
49852,4,2,174685,174685,174687,0,2,1
49853,1,2,174686,174687,174689,1,3,0
49854,4,1,174690,174690,174691,0,1,1
49855,5,1,174695,174695,174696,0,1,4
49856,5,3,174700,174700,174703,0,3,4
49857,5,2,174705,174705,174707,0,2,2
49858,1,3,174706,174707,174710,1,4,0
49859,1,1,174707,174710,174711,3,4,0
49860,2,2,174709,174711,174713,2,4,0
49861,1,3,174710,174713,174716,3,6,0
49862,6,3,174716,174716,174719,0,3,0
49863,1,1,174717,174719,174720,2,3,0
49864,3,1,174720,174720,174721,0,1,0
49865,3,1,174723,174723,174724,0,1,2
49866,1,3,174724,174724,174727,0,3,0
49867,1,1,174725,174727,174728,2,3,0
49868,1,2,174726,174728,174730,2,4,0
49869,1,1,174727,174730,174731,3,4,0
49870,5,3,174732,174732,174735,0,3,1
49871,6,1,174738,174738,174739,0,1,3
49872,1,1,174739,174739,174740,0,1,0
49873,5,1,174744,174744,174745,0,1,4
49874,6,3,174750,174750,174753,0,3,5
49875,1,3,174751,174753,174756,2,5,0
49876,6,2,174757,174757,174759,0,2,1
49877,4,1,174761,174761,174762,0,1,2
49878,6,3,174767,174767,174770,0,3,5
49879,3,1,174770,174770,174771,0,1,0
49880,5,3,174775,174775,174778,0,3,4
49881,6,2,174781,174781,174783,0,2,3
49882,3,2,174784,174784,174786,0,2,1
49883,6,3,174790,174790,174793,0,3,4
49884,4,3,174794,174794,174797,0,3,1
49885,3,1,174797,174797,174798,0,1,0
49886,4,3,174801,174801,174804,0,3,3
49887,3,3,174804,174804,174807,0,3,0
49888,5,1,174809,174809,174810,0,1,2
49889,2,1,174811,174811,174812,0,1,1
49890,5,3,174816,174816,174819,0,3,4
49891,4,3,174820,174820,174823,0,3,1
49892,6,3,174826,174826,174829,0,3,3
49893,4,2,174830,174830,174832,0,2,1
49894,1,3,174831,174832,174835,1,4,0
49895,4,1,174835,174835,174836,0,1,0
49896,1,1,174836,174836,174837,0,1,0
49897,6,1,174842,174842,174843,0,1,5
49898,3,2,174845,174845,174847,0,2,2
49899,1,2,174846,174847,174849,1,3,0
49900,6,1,174852,174852,174853,0,1,3
49901,1,3,174853,174853,174856,0,3,0
49902,2,1,174855,174856,174857,1,2,0
49903,5,1,174860,174860,174861,0,1,3
49904,6,3,174866,174866,174869,0,3,5
49905,3,1,174869,174869,174870,0,1,0
49906,3,2,174872,174872,174874,0,2,2
49907,1,3,174873,174874,174877,1,4,0
49908,6,2,174879,174879,174881,0,2,2
49909,2,2,174881,174881,174883,0,2,0
49910,3,2,174884,174884,174886,0,2,1
49911,2,2,174886,174886,174888,0,2,0
49912,4,2,174890,174890,174892,0,2,2
49913,4,1,174894,174894,174895,0,1,2
49914,4,1,174898,174898,174899,0,1,3
49915,2,3,174900,174900,174903,0,3,1
49916,4,3,174904,174904,174907,0,3,1
49917,2,2,174906,174907,174909,1,3,0
49918,6,3,174912,174912,174915,0,3,3
49919,2,2,174914,174915,174917,1,3,0
49920,1,3,174915,174917,174920,2,5,0
49921,2,1,174917,174920,174921,3,4,0
49922,4,3,174921,174921,174924,0,3,0
49923,1,1,174922,174924,174925,2,3,0
49924,6,3,174928,174928,174931,0,3,3
49925,4,1,174932,174932,174933,0,1,1
49926,4,3,174936,174936,174939,0,3,3
49927,6,3,174942,174942,174945,0,3,3
49928,3,1,174945,174945,174946,0,1,0
49929,1,1,174946,174946,174947,0,1,0
49930,1,1,174947,174947,174948,0,1,0
49931,5,2,174952,174952,174954,0,2,4
49932,2,1,174954,174954,174955,0,1,0
49933,4,3,174958,174958,174961,0,3,3
49934,2,2,174960,174961,174963,1,3,0
49935,6,1,174966,174966,174967,0,1,3
49936,2,3,174968,174968,174971,0,3,1
49937,1,2,174969,174971,174973,2,4,0
49938,4,1,174973,174973,174974,0,1,0
49939,5,3,174978,174978,174981,0,3,4
49940,5,1,174983,174983,174984,0,1,2
49941,2,3,174985,174985,174988,0,3,1
49942,5,1,174990,174990,174991,0,1,2
49943,4,2,174994,174994,174996,0,2,3
49944,2,1,174996,174996,174997,0,1,0
49945,1,1,174997,174997,174998,0,1,0
49946,2,3,174999,174999,175002,0,3,1
49947,5,3,175004,175004,175007,0,3,2
49948,1,3,175005,175007,175010,2,5,0
49949,6,1,175011,175011,175012,0,1,1
49950,2,1,175013,175013,175014,0,1,1
49951,5,3,175018,175018,175021,0,3,4
49952,2,1,175020,175021,175022,1,2,0
49953,6,1,175026,175026,175027,0,1,4
49954,2,2,175028,175028,175030,0,2,1
49955,4,1,175032,175032,175033,0,1,2
49956,4,2,175036,175036,175038,0,2,3
49957,2,1,175038,175038,175039,0,1,0
49958,4,2,175042,175042,175044,0,2,3
49959,5,2,175047,175047,175049,0,2,3
49960,2,3,175049,175049,175052,0,3,0
49961,4,1,175053,175053,175054,0,1,1
49962,2,1,175055,175055,175056,0,1,1
49963,5,3,175060,175060,175063,0,3,4
49964,3,3,175063,175063,175066,0,3,0
49965,5,3,175068,175068,175071,0,3,2
49966,5,2,175073,175073,175075,0,2,2
49967,2,3,175075,175075,175078,0,3,0
49968,6,2,175081,175081,175083,0,2,3
49969,6,1,175087,175087,175088,0,1,4
49970,4,3,175091,175091,175094,0,3,3
49971,3,2,175094,175094,175096,0,2,0
49972,5,2,175099,175099,175101,0,2,3
49973,6,3,175105,175105,175108,0,3,4
49974,3,1,175108,175108,175109,0,1,0
49975,4,2,175112,175112,175114,0,2,3
49976,2,3,175114,175114,175117,0,3,0
49977,5,1,175119,175119,175120,0,1,2
49978,6,2,175125,175125,175127,0,2,5
49979,6,1,175131,175131,175132,0,1,4
49980,2,2,175133,175133,175135,0,2,1
49981,3,1,175136,175136,175137,0,1,1
49982,3,3,175139,175139,175142,0,3,2
49983,4,3,175143,175143,175146,0,3,1
49984,4,2,175147,175147,175149,0,2,1
49985,3,1,175150,175150,175151,0,1,1
49986,6,1,175156,175156,175157,0,1,5
49987,2,1,175158,175158,175159,0,1,1
49988,1,1,175159,175159,175160,0,1,0
49989,1,3,175160,175160,175163,0,3,0
49990,4,1,175164,175164,175165,0,1,1
49991,5,2,175169,175169,175171,0,2,4
49992,2,2,175171,175171,175173,0,2,0
49993,3,1,175174,175174,175175,0,1,1
49994,1,1,175175,175175,175176,0,1,0
49995,3,3,175178,175178,175181,0,3,2
49996,3,1,175181,175181,175182,0,1,0
49997,1,3,175182,175182,175185,0,3,0
49998,1,3,175183,175185,175188,2,5,0
49999,1,2,175184,175188,175190,4,6,0
50000,4,1,175188,175190,175191,2,3,0
50001,4,3,175192,175192,175195,0,3,1
50002,5,2,175197,175197,175199,0,2,2
50003,1,1,175198,175199,175200,1,2,0
50004,3,3,175201,175201,175204,0,3,1
50005,6,1,175207,175207,175208,0,1,3
50006,4,2,175211,175211,175213,0,2,3
50007,3,2,175214,175214,175216,0,2,1
50008,6,1,175220,175220,175221,0,1,4
50009,4,2,175224,175224,175226,0,2,3
50010,2,1,175226,175226,175227,0,1,0
50011,6,3,175232,175232,175235,0,3,5
50012,4,2,175236,175236,175238,0,2,1
50013,2,1,175238,175238,175239,0,1,0
50014,4,2,175242,175242,175244,0,2,3
50015,5,3,175247,175247,175250,0,3,3
50016,3,1,175250,175250,175251,0,1,0
50017,5,2,175255,175255,175257,0,2,4
50018,1,1,175256,175257,175258,1,2,0
50019,2,2,175258,175258,175260,0,2,0
50020,3,3,175261,175261,175264,0,3,1
50021,3,1,175264,175264,175265,0,1,0
50022,2,2,175266,175266,175268,0,2,1
50023,6,1,175272,175272,175273,0,1,4
50024,2,1,175274,175274,175275,0,1,1
50025,4,1,175278,175278,175279,0,1,3
50026,6,2,175284,175284,175286,0,2,5
50027,1,3,175285,175286,175289,1,4,0
50028,1,3,175286,175289,175292,3,6,0
50029,5,3,175291,175292,175295,1,4,0
50030,4,3,175295,175295,175298,0,3,0
50031,4,1,175299,175299,175300,0,1,1
50032,4,2,175303,175303,175305,0,2,3
50033,4,2,175307,175307,175309,0,2,2
50034,6,2,175313,175313,175315,0,2,4
50035,1,2,175314,175315,175317,1,3,0
50036,3,1,175317,175317,175318,0,1,0
50037,5,2,175322,175322,175324,0,2,4
50038,6,1,175328,175328,175329,0,1,4
50039,2,1,175330,175330,175331,0,1,1
50040,4,2,175334,175334,175336,0,2,3
50041,1,1,175335,175336,175337,1,2,0
50042,4,2,175339,175339,175341,0,2,2
50043,1,2,175340,175341,175343,1,3,0
50044,6,2,175346,175346,175348,0,2,3
50045,6,2,175352,175352,175354,0,2,4
50046,4,3,175356,175356,175359,0,3,2
50047,4,1,175360,175360,175361,0,1,1
50048,3,2,175363,175363,175365,0,2,2
50049,2,3,175365,175365,175368,0,3,0
50050,3,1,175368,175368,175369,0,1,0
50051,4,3,175372,175372,175375,0,3,3
50052,6,3,175378,175378,175381,0,3,3
50053,3,3,175381,175381,175384,0,3,0
50054,1,2,175382,175384,175386,2,4,0
50055,1,3,175383,175386,175389,3,6,0
50056,5,2,175388,175389,175391,1,3,0
50057,4,2,175392,175392,175394,0,2,1
50058,6,1,175398,175398,175399,0,1,4
50059,1,2,175399,175399,175401,0,2,0
50060,6,3,175405,175405,175408,0,3,4
50061,4,2,175409,175409,175411,0,2,1
50062,2,3,175411,175411,175414,0,3,0
50063,3,3,175414,175414,175417,0,3,0
50064,5,1,175419,175419,175420,0,1,2
50065,3,2,175422,175422,175424,0,2,2
50066,6,3,175428,175428,175431,0,3,4
50067,2,3,175430,175431,175434,1,4,0
50068,3,3,175433,175434,175437,1,4,0
50069,2,3,175435,175437,175440,2,5,0
50070,3,3,175438,175440,175443,2,5,0
50071,5,3,175443,175443,175446,0,3,0
50072,2,1,175445,175446,175447,1,2,0
50073,1,2,175446,175447,175449,1,3,0
50074,5,2,175451,175451,175453,0,2,2
50075,2,1,175453,175453,175454,0,1,0
50076,6,2,175459,175459,175461,0,2,5
50077,5,2,175464,175464,175466,0,2,3
50078,1,1,175465,175466,175467,1,2,0
50079,1,1,175466,175467,175468,1,2,0
50080,4,2,175470,175470,175472,0,2,2
50081,2,3,175472,175472,175475,0,3,0
50082,3,3,175475,175475,175478,0,3,0
50083,6,3,175481,175481,175484,0,3,3
50084,6,1,175487,175487,175488,0,1,3
50085,6,3,175493,175493,175496,0,3,5
50086,2,3,175495,175496,175499,1,4,0
50087,5,1,175500,175500,175501,0,1,1
50088,2,1,175502,175502,175503,0,1,1
50089,6,2,175508,175508,175510,0,2,5
50090,3,1,175511,175511,175512,0,1,1
50091,1,3,175512,175512,175515,0,3,0
50092,2,2,175514,175515,175517,1,3,0
50093,5,2,175519,175519,175521,0,2,2
50094,3,3,175522,175522,175525,0,3,1
50095,2,2,175524,175525,175527,1,3,0
50096,2,3,175526,175527,175530,1,4,0
50097,2,2,175528,175530,175532,2,4,0
50098,3,2,175531,175532,175534,1,3,0
50099,3,2,175534,175534,175536,0,2,0
50100,2,1,175536,175536,175537,0,1,0
50101,6,3,175542,175542,175545,0,3,5
50102,5,1,175547,175547,175548,0,1,2
50103,2,3,175549,175549,175552,0,3,1
50104,6,1,175555,175555,175556,0,1,3
50105,6,3,175561,175561,175564,0,3,5
50106,3,2,175564,175564,175566,0,2,0
50107,5,1,175569,175569,175570,0,1,3
50108,1,1,175570,175570,175571,0,1,0
50109,5,1,175575,175575,175576,0,1,4
50110,2,3,175577,175577,175580,0,3,1
50111,3,3,175580,175580,175583,0,3,0
50112,1,1,175581,175583,175584,2,3,0
50113,3,1,175584,175584,175585,0,1,0
50114,3,1,175587,175587,175588,0,1,2
50115,2,1,175589,175589,175590,0,1,1
50116,2,3,175591,175591,175594,0,3,1
50117,4,1,175595,175595,175596,0,1,1
50118,4,3,175599,175599,175602,0,3,3
50119,4,3,175603,175603,175606,0,3,1
50120,1,2,175604,175606,175608,2,4,0
50121,5,2,175609,175609,175611,0,2,1
50122,3,1,175612,175612,175613,0,1,1
50123,4,2,175616,175616,175618,0,2,3
50124,5,2,175621,175621,175623,0,2,3
50125,3,3,175624,175624,175627,0,3,1
50126,1,2,175625,175627,175629,2,4,0
50127,6,2,175631,175631,175633,0,2,2
50128,4,3,175635,175635,175638,0,3,2
50129,1,1,175636,175638,175639,2,3,0
50130,2,2,175638,175639,175641,1,3,0
50131,2,3,175640,175641,175644,1,4,0
50132,5,2,175645,175645,175647,0,2,1
50133,6,2,175651,175651,175653,0,2,4
50134,4,3,175655,175655,175658,0,3,2
50135,1,3,175656,175658,175661,2,5,0
50136,2,2,175658,175661,175663,3,5,0
50137,4,2,175662,175663,175665,1,3,0
50138,1,2,175663,175665,175667,2,4,0
50139,3,2,175666,175667,175669,1,3,0
50140,2,1,175668,175669,175670,1,2,0
50141,5,1,175673,175673,175674,0,1,3
50142,2,2,175675,175675,175677,0,2,1
50143,3,3,175678,175678,175681,0,3,1
50144,5,2,175683,175683,175685,0,2,2
50145,5,1,175688,175688,175689,0,1,3
50146,1,2,175689,175689,175691,0,2,0
50147,2,3,175691,175691,175694,0,3,0
50148,5,1,175696,175696,175697,0,1,2
50149,2,3,175698,175698,175701,0,3,1
50150,5,3,175703,175703,175706,0,3,2
50151,2,1,175705,175706,175707,1,2,0
50152,2,3,175707,175707,175710,0,3,0
50153,5,1,175712,175712,175713,0,1,2
50154,2,3,175714,175714,175717,0,3,1
50155,6,1,175720,175720,175721,0,1,3
50156,1,3,175721,175721,175724,0,3,0
50157,4,1,175725,175725,175726,0,1,1
50158,4,1,175729,175729,175730,0,1,3
50159,1,2,175730,175730,175732,0,2,0
50160,3,2,175733,175733,175735,0,2,1
50161,6,1,175739,175739,175740,0,1,4
50162,6,3,175745,175745,175748,0,3,5
50163,6,2,175751,175751,175753,0,2,3
50164,2,2,175753,175753,175755,0,2,0
50165,4,2,175757,175757,175759,0,2,2
50166,2,1,175759,175759,175760,0,1,0
50167,5,1,175764,175764,175765,0,1,4
50168,4,2,175768,175768,175770,0,2,3
50169,6,3,175774,175774,175777,0,3,4
50170,3,2,175777,175777,175779,0,2,0
50171,5,1,175782,175782,175783,0,1,3
50172,5,1,175787,175787,175788,0,1,4
50173,5,2,175792,175792,175794,0,2,4
50174,4,1,175796,175796,175797,0,1,2
50175,2,3,175798,175798,175801,0,3,1
50176,2,1,175800,175801,175802,1,2,0
50177,3,1,175803,175803,175804,0,1,1
50178,3,2,175806,175806,175808,0,2,2
50179,3,3,175809,175809,175812,0,3,1
50180,1,3,175810,175812,175815,2,5,0
50181,2,2,175812,175815,175817,3,5,0
50182,2,3,175814,175817,175820,3,6,0
50183,4,3,175818,175820,175823,2,5,0
50184,3,1,175821,175823,175824,2,3,0
50185,6,2,175827,175827,175829,0,2,3
50186,2,1,175829,175829,175830,0,1,0
50187,6,1,175835,175835,175836,0,1,5
50188,5,3,175840,175840,175843,0,3,4
50189,3,3,175843,175843,175846,0,3,0
50190,6,3,175849,175849,175852,0,3,3
50191,2,3,175851,175852,175855,1,4,0
50192,3,3,175854,175855,175858,1,4,0
50193,5,1,175859,175859,175860,0,1,1
50194,5,3,175864,175864,175867,0,3,4
50195,4,3,175868,175868,175871,0,3,1
50196,3,2,175871,175871,175873,0,2,0
50197,5,2,175876,175876,175878,0,2,3
50198,4,1,175880,175880,175881,0,1,2
50199,2,3,175882,175882,175885,0,3,1
50200,3,3,175885,175885,175888,0,3,0
50201,1,2,175886,175888,175890,2,4,0
50202,1,1,175887,175890,175891,3,4,0
50203,6,1,175893,175893,175894,0,1,2
50204,6,3,175899,175899,175902,0,3,5
50205,5,1,175904,175904,175905,0,1,2
50206,1,2,175905,175905,175907,0,2,0
50207,1,1,175906,175907,175908,1,2,0
50208,4,1,175910,175910,175911,0,1,2
50209,3,2,175913,175913,175915,0,2,2
50210,1,3,175914,175915,175918,1,4,0
50211,2,2,175916,175918,175920,2,4,0
50212,4,3,175920,175920,175923,0,3,0
50213,1,3,175921,175923,175926,2,5,0
50214,5,1,175926,175926,175927,0,1,0
50215,4,1,175930,175930,175931,0,1,3
50216,3,1,175933,175933,175934,0,1,2
50217,4,1,175937,175937,175938,0,1,3
50218,3,3,175940,175940,175943,0,3,2
50219,3,2,175943,175943,175945,0,2,0
50220,3,1,175946,175946,175947,0,1,1
50221,5,1,175951,175951,175952,0,1,4
50222,4,3,175955,175955,175958,0,3,3
50223,2,2,175957,175958,175960,1,3,0
50224,4,3,175961,175961,175964,0,3,1
50225,4,1,175965,175965,175966,0,1,1
50226,2,1,175967,175967,175968,0,1,1
50227,1,2,175968,175968,175970,0,2,0
50228,1,3,175969,175970,175973,1,4,0
50229,2,2,175971,175973,175975,2,4,0
50230,5,3,175976,175976,175979,0,3,1
50231,1,2,175977,175979,175981,2,4,0
50232,5,1,175982,175982,175983,0,1,1
50233,5,2,175987,175987,175989,0,2,4
50234,6,2,175993,175993,175995,0,2,4
50235,1,3,175994,175995,175998,1,4,0
50236,5,2,175999,175999,176001,0,2,1
50237,6,3,176005,176005,176008,0,3,4
50238,4,3,176009,176009,176012,0,3,1
50239,5,3,176014,176014,176017,0,3,2
50240,4,1,176018,176018,176019,0,1,1
50241,5,3,176023,176023,176026,0,3,4
50242,3,3,176026,176026,176029,0,3,0
50243,4,2,176030,176030,176032,0,2,1
50244,3,3,176033,176033,176036,0,3,1
50245,4,1,176037,176037,176038,0,1,1
50246,6,2,176043,176043,176045,0,2,5
50247,1,1,176044,176045,176046,1,2,0
50248,6,1,176050,176050,176051,0,1,4
50249,1,2,176051,176051,176053,0,2,0
50250,6,3,176057,176057,176060,0,3,4
50251,1,2,176058,176060,176062,2,4,0
50252,6,1,176064,176064,176065,0,1,2
50253,2,1,176066,176066,176067,0,1,1
50254,2,1,176068,176068,176069,0,1,1
50255,2,2,176070,176070,176072,0,2,1
50256,2,1,176072,176072,176073,0,1,0
50257,6,1,176078,176078,176079,0,1,5
50258,2,1,176080,176080,176081,0,1,1
50259,2,2,176082,176082,176084,0,2,1
50260,4,1,176086,176086,176087,0,1,2
50261,1,3,176087,176087,176090,0,3,0
50262,1,1,176088,176090,176091,2,3,0
50263,2,3,176090,176091,176094,1,4,0
50264,2,2,176092,176094,176096,2,4,0
50265,5,1,176097,176097,176098,0,1,1
50266,5,1,176102,176102,176103,0,1,4
50267,6,1,176108,176108,176109,0,1,5
50268,4,3,176112,176112,176115,0,3,3
50269,5,2,176117,176117,176119,0,2,2
50270,2,3,176119,176119,176122,0,3,0
50271,2,1,176121,176122,176123,1,2,0
50272,2,2,176123,176123,176125,0,2,0
50273,6,2,176129,176129,176131,0,2,4
50274,4,3,176133,176133,176136,0,3,2
50275,6,2,176139,176139,176141,0,2,3
50276,3,2,176142,176142,176144,0,2,1
50277,2,1,176144,176144,176145,0,1,0
50278,2,3,176146,176146,176149,0,3,1
50279,3,1,176149,176149,176150,0,1,0
50280,1,1,176150,176150,176151,0,1,0
50281,1,2,176151,176151,176153,0,2,0
50282,4,2,176155,176155,176157,0,2,2
50283,2,2,176157,176157,176159,0,2,0
50284,3,3,176160,176160,176163,0,3,1
50285,2,3,176162,176163,176166,1,4,0
50286,5,3,176167,176167,176170,0,3,1
50287,5,3,176172,176172,176175,0,3,2
50288,5,3,176177,176177,176180,0,3,2
50289,6,1,176183,176183,176184,0,1,3
50290,5,1,176188,176188,176189,0,1,4
50291,2,3,176190,176190,176193,0,3,1
50292,1,1,176191,176193,176194,2,3,0
50293,5,1,176196,176196,176197,0,1,2
50294,5,2,176201,176201,176203,0,2,4
50295,5,2,176206,176206,176208,0,2,3
50296,3,1,176209,176209,176210,0,1,1
50297,2,1,176211,176211,176212,0,1,1
50298,4,1,176215,176215,176216,0,1,3
50299,4,3,176219,176219,176222,0,3,3
50300,2,3,176221,176222,176225,1,4,0
50301,4,3,176225,176225,176228,0,3,0
50302,5,2,176230,176230,176232,0,2,2
50303,5,3,176235,176235,176238,0,3,3
50304,2,2,176237,176238,176240,1,3,0
50305,6,2,176243,176243,176245,0,2,3
50306,2,2,176245,176245,176247,0,2,0
50307,6,2,176251,176251,176253,0,2,4
50308,6,3,176257,176257,176260,0,3,4
50309,3,2,176260,176260,176262,0,2,0
50310,5,1,176265,176265,176266,0,1,3
50311,3,2,176268,176268,176270,0,2,2
50312,6,1,176274,176274,176275,0,1,4
50313,2,2,176276,176276,176278,0,2,1
50314,5,3,176281,176281,176284,0,3,3
50315,1,1,176282,176284,176285,2,3,0
50316,5,1,176287,176287,176288,0,1,2
50317,3,1,176290,176290,176291,0,1,2
50318,5,3,176295,176295,176298,0,3,4
50319,2,1,176297,176298,176299,1,2,0
50320,4,3,176301,176301,176304,0,3,2
50321,5,3,176306,176306,176309,0,3,2
50322,2,2,176308,176309,176311,1,3,0
50323,5,2,176313,176313,176315,0,2,2
50324,6,2,176319,176319,176321,0,2,4
50325,5,2,176324,176324,176326,0,2,3
50326,4,2,176328,176328,176330,0,2,2
50327,2,1,176330,176330,176331,0,1,0
50328,1,1,176331,176331,176332,0,1,0
50329,3,2,176334,176334,176336,0,2,2
50330,2,1,176336,176336,176337,0,1,0
50331,3,2,176339,176339,176341,0,2,2
50332,3,2,176342,176342,176344,0,2,1
50333,4,2,176346,176346,176348,0,2,2
50334,5,3,176351,176351,176354,0,3,3
50335,3,3,176354,176354,176357,0,3,0
50336,4,1,176358,176358,176359,0,1,1
50337,6,3,176364,176364,176367,0,3,5
50338,2,3,176366,176367,176370,1,4,0
50339,6,3,176372,176372,176375,0,3,2
50340,6,2,176378,176378,176380,0,2,3
50341,5,1,176383,176383,176384,0,1,3
50342,1,3,176384,176384,176387,0,3,0
50343,1,1,176385,176387,176388,2,3,0
50344,5,3,176390,176390,176393,0,3,2
50345,6,2,176396,176396,176398,0,2,3
50346,6,1,176402,176402,176403,0,1,4
50347,2,1,176404,176404,176405,0,1,1
50348,1,1,176405,176405,176406,0,1,0
50349,6,2,176411,176411,176413,0,2,5
50350,1,1,176412,176413,176414,1,2,0
50351,4,3,176416,176416,176419,0,3,2
50352,6,3,176422,176422,176425,0,3,3
50353,4,2,176426,176426,176428,0,2,1
50354,2,2,176428,176428,176430,0,2,0
50355,6,1,176434,176434,176435,0,1,4
50356,3,3,176437,176437,176440,0,3,2
50357,1,2,176438,176440,176442,2,4,0
50358,5,1,176443,176443,176444,0,1,1
50359,4,2,176447,176447,176449,0,2,3
50360,6,2,176453,176453,176455,0,2,4
50361,6,1,176459,176459,176460,0,1,4
50362,5,1,176464,176464,176465,0,1,4
50363,6,1,176470,176470,176471,0,1,5
50364,6,3,176476,176476,176479,0,3,5
50365,3,2,176479,176479,176481,0,2,0
50366,1,2,176480,176481,176483,1,3,0
50367,5,2,176485,176485,176487,0,2,2
50368,3,3,176488,176488,176491,0,3,1
50369,6,3,176494,176494,176497,0,3,3
50370,4,1,176498,176498,176499,0,1,1
50371,2,3,176500,176500,176503,0,3,1
50372,5,3,176505,176505,176508,0,3,2
50373,2,3,176507,176508,176511,1,4,0
50374,6,2,176513,176513,176515,0,2,2
50375,4,3,176517,176517,176520,0,3,2
50376,1,2,176518,176520,176522,2,4,0
50377,1,2,176519,176522,176524,3,5,0
50378,5,3,176524,176524,176527,0,3,0
50379,5,3,176529,176529,176532,0,3,2
50380,3,3,176532,176532,176535,0,3,0
50381,4,2,176536,176536,176538,0,2,1
50382,2,2,176538,176538,176540,0,2,0
50383,2,2,176540,176540,176542,0,2,0
50384,1,2,176541,176542,176544,1,3,0
50385,5,2,176546,176546,176548,0,2,2
50386,6,2,176552,176552,176554,0,2,4
50387,6,2,176558,176558,176560,0,2,4
50388,2,1,176560,176560,176561,0,1,0
50389,4,1,176564,176564,176565,0,1,3
50390,2,3,176566,176566,176569,0,3,1
50391,1,2,176567,176569,176571,2,4,0
50392,3,1,176570,176571,176572,1,2,0
50393,1,3,176571,176572,176575,1,4,0
50394,4,1,176575,176575,176576,0,1,0
50395,5,2,176580,176580,176582,0,2,4
50396,2,1,176582,176582,176583,0,1,0
50397,3,2,176585,176585,176587,0,2,2
50398,3,2,176588,176588,176590,0,2,1
50399,1,2,176589,176590,176592,1,3,0
50400,4,2,176593,176593,176595,0,2,1
50401,3,2,176596,176596,176598,0,2,1
50402,5,3,176601,176601,176604,0,3,3
50403,5,2,176606,176606,176608,0,2,2
50404,4,2,176610,176610,176612,0,2,2
50405,5,2,176615,176615,176617,0,2,3
50406,1,3,176616,176617,176620,1,4,0
50407,2,2,176618,176620,176622,2,4,0
50408,6,2,176624,176624,176626,0,2,2
50409,6,1,176630,176630,176631,0,1,4
50410,1,1,176631,176631,176632,0,1,0
50411,1,1,176632,176632,176633,0,1,0
50412,3,3,176635,176635,176638,0,3,2
50413,1,3,176636,176638,176641,2,5,0
50414,6,3,176642,176642,176645,0,3,1
50415,4,3,176646,176646,176649,0,3,1
50416,4,3,176650,176650,176653,0,3,1
50417,2,3,176652,176653,176656,1,4,0
50418,3,1,176655,176656,176657,1,2,0
50419,6,1,176661,176661,176662,0,1,4
50420,1,2,176662,176662,176664,0,2,0
50421,3,1,176665,176665,176666,0,1,1
50422,4,1,176669,176669,176670,0,1,3
50423,3,3,176672,176672,176675,0,3,2
50424,3,2,176675,176675,176677,0,2,0
50425,2,1,176677,176677,176678,0,1,0
50426,5,3,176682,176682,176685,0,3,4
50427,5,1,176687,176687,176688,0,1,2
50428,5,3,176692,176692,176695,0,3,4
50429,2,1,176694,176695,176696,1,2,0
50430,4,3,176698,176698,176701,0,3,2
50431,4,3,176702,176702,176705,0,3,1
50432,5,2,176707,176707,176709,0,2,2
50433,4,3,176711,176711,176714,0,3,2
50434,4,3,176715,176715,176718,0,3,1
50435,6,1,176721,176721,176722,0,1,3
50436,1,2,176722,176722,176724,0,2,0
50437,4,1,176726,176726,176727,0,1,2
50438,5,1,176731,176731,176732,0,1,4
50439,3,1,176734,176734,176735,0,1,2
50440,4,3,176738,176738,176741,0,3,3
50441,6,3,176744,176744,176747,0,3,3
50442,2,2,176746,176747,176749,1,3,0
50443,6,3,176752,176752,176755,0,3,3
50444,1,3,176753,176755,176758,2,5,0
50445,2,3,176755,176758,176761,3,6,0
50446,5,2,176760,176761,176763,1,3,0
50447,3,3,176763,176763,176766,0,3,0
50448,2,2,176765,176766,176768,1,3,0
50449,6,3,176771,176771,176774,0,3,3
50450,5,2,176776,176776,176778,0,2,2
50451,4,2,176780,176780,176782,0,2,2
50452,1,2,176781,176782,176784,1,3,0
50453,3,3,176784,176784,176787,0,3,0
50454,4,3,176788,176788,176791,0,3,1
50455,1,2,176789,176791,176793,2,4,0
50456,1,3,176790,176793,176796,3,6,0
50457,3,3,176793,176796,176799,3,6,0
50458,2,1,176795,176799,176800,4,5,0
50459,5,3,176800,176800,176803,0,3,0
50460,4,2,176804,176804,176806,0,2,1
50461,2,2,176806,176806,176808,0,2,0
50462,2,1,176808,176808,176809,0,1,0
50463,4,1,176812,176812,176813,0,1,3
50464,4,1,176816,176816,176817,0,1,3
50465,4,1,176820,176820,176821,0,1,3
50466,2,1,176822,176822,176823,0,1,1
50467,1,3,176823,176823,176826,0,3,0
50468,5,1,176828,176828,176829,0,1,2
50469,6,1,176834,176834,176835,0,1,5
50470,3,1,176837,176837,176838,0,1,2
50471,5,1,176842,176842,176843,0,1,4
50472,3,3,176845,176845,176848,0,3,2
50473,4,2,176849,176849,176851,0,2,1
50474,2,1,176851,176851,176852,0,1,0
50475,5,2,176856,176856,176858,0,2,4
50476,1,2,176857,176858,176860,1,3,0
50477,1,1,176858,176860,176861,2,3,0
50478,6,3,176864,176864,176867,0,3,3
50479,3,2,176867,176867,176869,0,2,0
50480,4,2,176871,176871,176873,0,2,2
50481,5,1,176876,176876,176877,0,1,3
50482,1,1,176877,176877,176878,0,1,0
50483,6,1,176883,176883,176884,0,1,5
50484,4,3,176887,176887,176890,0,3,3
50485,6,2,176893,176893,176895,0,2,3
50486,1,3,176894,176895,176898,1,4,0
50487,3,2,176897,176898,176900,1,3,0
50488,3,2,176900,176900,176902,0,2,0
50489,3,3,176903,176903,176906,0,3,1
50490,1,3,176904,176906,176909,2,5,0
50491,3,1,176907,176909,176910,2,3,0
50492,5,2,176912,176912,176914,0,2,2
50493,2,3,176914,176914,176917,0,3,0
50494,3,1,176917,176917,176918,0,1,0
50495,6,1,176923,176923,176924,0,1,5
50496,1,2,176924,176924,176926,0,2,0
50497,6,2,176930,176930,176932,0,2,4
50498,6,2,176936,176936,176938,0,2,4
50499,4,1,176940,176940,176941,0,1,2
50500,5,2,176945,176945,176947,0,2,4
50501,2,1,176947,176947,176948,0,1,0
50502,1,1,176948,176948,176949,0,1,0
50503,2,3,176950,176950,176953,0,3,1
50504,4,3,176954,176954,176957,0,3,1
50505,6,1,176960,176960,176961,0,1,3
50506,4,1,176964,176964,176965,0,1,3
50507,4,1,176968,176968,176969,0,1,3
50508,1,2,176969,176969,176971,0,2,0
50509,3,2,176972,176972,176974,0,2,1
50510,6,3,176978,176978,176981,0,3,4
50511,5,2,176983,176983,176985,0,2,2
50512,3,2,176986,176986,176988,0,2,1
50513,2,3,176988,176988,176991,0,3,0
50514,5,3,176993,176993,176996,0,3,2
50515,5,1,176998,176998,176999,0,1,2
50516,2,2,177000,177000,177002,0,2,1
50517,4,3,177004,177004,177007,0,3,2
50518,6,1,177010,177010,177011,0,1,3
50519,5,2,177015,177015,177017,0,2,4
50520,5,1,177020,177020,177021,0,1,3
50521,6,1,177026,177026,177027,0,1,5
50522,4,3,177030,177030,177033,0,3,3
50523,6,3,177036,177036,177039,0,3,3
50524,3,2,177039,177039,177041,0,2,0
50525,3,3,177042,177042,177045,0,3,1
50526,2,3,177044,177045,177048,1,4,0
50527,1,3,177045,177048,177051,3,6,0
50528,1,2,177046,177051,177053,5,7,0
50529,6,3,177052,177053,177056,1,4,0
50530,2,2,177054,177056,177058,2,4,0
50531,1,1,177055,177058,177059,3,4,0
50532,4,2,177059,177059,177061,0,2,0
50533,5,3,177064,177064,177067,0,3,3
50534,3,3,177067,177067,177070,0,3,0
50535,5,2,177072,177072,177074,0,2,2
50536,6,1,177078,177078,177079,0,1,4
50537,3,1,177081,177081,177082,0,1,2
50538,1,3,177082,177082,177085,0,3,0
50539,6,2,177088,177088,177090,0,2,3
50540,4,2,177092,177092,177094,0,2,2
50541,3,2,177095,177095,177097,0,2,1
50542,6,1,177101,177101,177102,0,1,4
50543,3,3,177104,177104,177107,0,3,2
50544,5,3,177109,177109,177112,0,3,2
50545,4,3,177113,177113,177116,0,3,1
50546,1,3,177114,177116,177119,2,5,0
50547,2,2,177116,177119,177121,3,5,0
50548,4,3,177120,177121,177124,1,4,0
50549,1,1,177121,177124,177125,3,4,0
50550,3,2,177124,177125,177127,1,3,0
50551,2,3,177126,177127,177130,1,4,0
50552,3,3,177129,177130,177133,1,4,0
50553,2,1,177131,177133,177134,2,3,0
50554,6,3,177137,177137,177140,0,3,3
50555,4,2,177141,177141,177143,0,2,1
50556,3,1,177144,177144,177145,0,1,1
50557,6,3,177150,177150,177153,0,3,5
50558,1,3,177151,177153,177156,2,5,0
50559,4,2,177155,177156,177158,1,3,0
50560,3,1,177158,177158,177159,0,1,0
50561,1,3,177159,177159,177162,0,3,0
50562,6,2,177165,177165,177167,0,2,3
50563,2,3,177167,177167,177170,0,3,0
50564,3,3,177170,177170,177173,0,3,0
50565,1,3,177171,177173,177176,2,5,0
50566,2,2,177173,177176,177178,3,5,0
50567,2,2,177175,177178,177180,3,5,0
50568,3,3,177178,177180,177183,2,5,0
50569,2,3,177180,177183,177186,3,6,0
50570,6,3,177186,177186,177189,0,3,0
50571,5,1,177191,177191,177192,0,1,2
50572,5,2,177196,177196,177198,0,2,4
50573,5,3,177201,177201,177204,0,3,3
50574,6,3,177207,177207,177210,0,3,3
50575,3,2,177210,177210,177212,0,2,0
50576,1,1,177211,177212,177213,1,2,0
50577,1,3,177212,177213,177216,1,4,0
50578,3,2,177215,177216,177218,1,3,0
50579,6,3,177221,177221,177224,0,3,3
50580,4,2,177225,177225,177227,0,2,1
50581,1,3,177226,177227,177230,1,4,0
50582,3,2,177229,177230,177232,1,3,0
50583,5,2,177234,177234,177236,0,2,2
50584,3,1,177237,177237,177238,0,1,1
50585,3,1,177240,177240,177241,0,1,2
50586,3,1,177243,177243,177244,0,1,2
50587,6,1,177249,177249,177250,0,1,5
50588,3,3,177252,177252,177255,0,3,2
50589,6,2,177258,177258,177260,0,2,3
50590,2,1,177260,177260,177261,0,1,0
50591,2,3,177262,177262,177265,0,3,1
50592,1,1,177263,177265,177266,2,3,0
50593,4,3,177267,177267,177270,0,3,1
50594,5,3,177272,177272,177275,0,3,2
50595,4,2,177276,177276,177278,0,2,1
50596,1,1,177277,177278,177279,1,2,0
50597,5,1,177282,177282,177283,0,1,3
50598,3,1,177285,177285,177286,0,1,2
50599,1,2,177286,177286,177288,0,2,0
50600,6,2,177292,177292,177294,0,2,4
50601,4,2,177296,177296,177298,0,2,2
50602,3,3,177299,177299,177302,0,3,1
50603,3,1,177302,177302,177303,0,1,0
50604,4,3,177306,177306,177309,0,3,3
50605,6,3,177312,177312,177315,0,3,3
50606,2,1,177314,177315,177316,1,2,0
50607,6,1,177320,177320,177321,0,1,4
50608,1,3,177321,177321,177324,0,3,0
50609,2,2,177323,177324,177326,1,3,0
50610,5,3,177328,177328,177331,0,3,2
50611,6,1,177334,177334,177335,0,1,3
50612,1,1,177335,177335,177336,0,1,0
50613,3,2,177338,177338,177340,0,2,2
50614,2,2,177340,177340,177342,0,2,0
50615,6,1,177346,177346,177347,0,1,4
50616,6,3,177352,177352,177355,0,3,5
50617,3,3,177355,177355,177358,0,3,0
50618,1,1,177356,177358,177359,2,3,0
50619,6,2,177362,177362,177364,0,2,3
50620,6,3,177368,177368,177371,0,3,4
50621,2,2,177370,177371,177373,1,3,0
50622,3,1,177373,177373,177374,0,1,0
50623,3,1,177376,177376,177377,0,1,2
50624,2,2,177378,177378,177380,0,2,1
50625,4,2,177382,177382,177384,0,2,2
50626,6,3,177388,177388,177391,0,3,4
50627,6,2,177394,177394,177396,0,2,3
50628,4,1,177398,177398,177399,0,1,2
50629,5,2,177403,177403,177405,0,2,4
50630,4,1,177407,177407,177408,0,1,2
50631,5,3,177412,177412,177415,0,3,4
50632,1,2,177413,177415,177417,2,4,0
50633,3,2,177416,177417,177419,1,3,0
50634,2,2,177418,177419,177421,1,3,0
50635,1,2,177419,177421,177423,2,4,0
50636,2,2,177421,177423,177425,2,4,0
50637,6,3,177427,177427,177430,0,3,2
50638,1,1,177428,177430,177431,2,3,0
50639,2,2,177430,177431,177433,1,3,0
50640,3,2,177433,177433,177435,0,2,0
50641,2,2,177435,177435,177437,0,2,0
50642,4,2,177439,177439,177441,0,2,2
50643,4,3,177443,177443,177446,0,3,2
50644,4,1,177447,177447,177448,0,1,1
50645,2,1,177449,177449,177450,0,1,1
50646,3,3,177452,177452,177455,0,3,2
50647,3,3,177455,177455,177458,0,3,0
50648,1,1,177456,177458,177459,2,3,0
50649,3,2,177459,177459,177461,0,2,0
50650,4,1,177463,177463,177464,0,1,2
50651,1,2,177464,177464,177466,0,2,0
50652,1,1,177465,177466,177467,1,2,0
50653,2,2,177467,177467,177469,0,2,0
50654,1,1,177468,177469,177470,1,2,0
50655,2,3,177470,177470,177473,0,3,0
50656,4,2,177474,177474,177476,0,2,1
50657,3,3,177477,177477,177480,0,3,1
50658,2,3,177479,177480,177483,1,4,0
50659,3,2,177482,177483,177485,1,3,0
50660,4,2,177486,177486,177488,0,2,1
50661,3,2,177489,177489,177491,0,2,1
50662,3,3,177492,177492,177495,0,3,1
50663,2,2,177494,177495,177497,1,3,0
50664,2,1,177496,177497,177498,1,2,0
50665,2,2,177498,177498,177500,0,2,0
50666,2,1,177500,177500,177501,0,1,0
50667,2,3,177502,177502,177505,0,3,1
50668,5,3,177507,177507,177510,0,3,2
50669,2,1,177509,177510,177511,1,2,0
50670,1,1,177510,177511,177512,1,2,0
50671,6,2,177516,177516,177518,0,2,4
50672,6,1,177522,177522,177523,0,1,4
50673,5,2,177527,177527,177529,0,2,4
50674,3,1,177530,177530,177531,0,1,1
50675,6,3,177536,177536,177539,0,3,5
50676,1,1,177537,177539,177540,2,3,0
50677,3,2,177540,177540,177542,0,2,0
50678,4,2,177544,177544,177546,0,2,2
50679,1,3,177545,177546,177549,1,4,0
50680,5,1,177550,177550,177551,0,1,1
50681,6,2,177556,177556,177558,0,2,5
50682,6,1,177562,177562,177563,0,1,4
50683,5,3,177567,177567,177570,0,3,4
50684,6,2,177573,177573,177575,0,2,3
50685,3,2,177576,177576,177578,0,2,1
50686,4,1,177580,177580,177581,0,1,2
50687,5,1,177585,177585,177586,0,1,4
50688,1,2,177586,177586,177588,0,2,0
50689,1,3,177587,177588,177591,1,4,0
50690,6,2,177593,177593,177595,0,2,2
50691,6,3,177599,177599,177602,0,3,4
50692,6,3,177605,177605,177608,0,3,3
50693,3,3,177608,177608,177611,0,3,0
50694,5,2,177613,177613,177615,0,2,2
50695,6,1,177619,177619,177620,0,1,4
50696,3,2,177622,177622,177624,0,2,2
50697,2,1,177624,177624,177625,0,1,0
50698,2,1,177626,177626,177627,0,1,1
50699,2,1,177628,177628,177629,0,1,1
50700,5,3,177633,177633,177636,0,3,4
50701,1,2,177634,177636,177638,2,4,0
50702,3,2,177637,177638,177640,1,3,0
50703,1,3,177638,177640,177643,2,5,0
50704,5,2,177643,177643,177645,0,2,0
50705,5,3,177648,177648,177651,0,3,3
50706,5,3,177653,177653,177656,0,3,2
50707,5,1,177658,177658,177659,0,1,2
50708,6,3,177664,177664,177667,0,3,5
50709,3,2,177667,177667,177669,0,2,0
50710,4,3,177671,177671,177674,0,3,2
50711,6,3,177677,177677,177680,0,3,3
50712,6,3,177683,177683,177686,0,3,3
50713,2,2,177685,177686,177688,1,3,0
50714,2,3,177687,177688,177691,1,4,0
50715,6,3,177693,177693,177696,0,3,2
50716,1,1,177694,177696,177697,2,3,0
50717,1,1,177695,177697,177698,2,3,0
50718,3,2,177698,177698,177700,0,2,0
50719,3,1,177701,177701,177702,0,1,1
50720,6,1,177707,177707,177708,0,1,5
50721,3,1,177710,177710,177711,0,1,2
50722,1,2,177711,177711,177713,0,2,0
50723,2,1,177713,177713,177714,0,1,0
50724,4,1,177717,177717,177718,0,1,3
50725,4,1,177721,177721,177722,0,1,3
50726,1,2,177722,177722,177724,0,2,0
50727,1,1,177723,177724,177725,1,2,0
50728,1,2,177724,177725,177727,1,3,0
50729,5,1,177729,177729,177730,0,1,2
50730,4,2,177733,177733,177735,0,2,3
50731,5,3,177738,177738,177741,0,3,3
50732,3,1,177741,177741,177742,0,1,0
50733,5,1,177746,177746,177747,0,1,4
50734,4,2,177750,177750,177752,0,2,3
50735,1,3,177751,177752,177755,1,4,0
50736,6,1,177757,177757,177758,0,1,2
50737,1,3,177758,177758,177761,0,3,0
50738,4,1,177762,177762,177763,0,1,1
50739,6,1,177768,177768,177769,0,1,5
50740,3,2,177771,177771,177773,0,2,2
50741,1,3,177772,177773,177776,1,4,0
50742,1,1,177773,177776,177777,3,4,0
50743,5,3,177778,177778,177781,0,3,1
50744,6,1,177784,177784,177785,0,1,3
50745,5,2,177789,177789,177791,0,2,4
50746,5,1,177794,177794,177795,0,1,3
50747,3,2,177797,177797,177799,0,2,2
50748,1,1,177798,177799,177800,1,2,0
50749,2,1,177800,177800,177801,0,1,0
50750,2,3,177802,177802,177805,0,3,1
50751,4,1,177806,177806,177807,0,1,1
50752,4,2,177810,177810,177812,0,2,3
50753,1,1,177811,177812,177813,1,2,0
50754,5,1,177816,177816,177817,0,1,3
50755,1,3,177817,177817,177820,0,3,0
50756,6,1,177823,177823,177824,0,1,3
50757,1,1,177824,177824,177825,0,1,0
50758,5,1,177829,177829,177830,0,1,4
50759,4,1,177833,177833,177834,0,1,3
50760,2,2,177835,177835,177837,0,2,1
50761,3,3,177838,177838,177841,0,3,1
50762,5,3,177843,177843,177846,0,3,2
50763,2,3,177845,177846,177849,1,4,0
50764,5,2,177850,177850,177852,0,2,1
50765,2,3,177852,177852,177855,0,3,0
50766,5,2,177857,177857,177859,0,2,2
50767,4,1,177861,177861,177862,0,1,2
50768,2,3,177863,177863,177866,0,3,1
50769,5,2,177868,177868,177870,0,2,2
50770,4,1,177872,177872,177873,0,1,2
50771,1,1,177873,177873,177874,0,1,0
50772,3,3,177876,177876,177879,0,3,2
50773,4,3,177880,177880,177883,0,3,1
50774,3,1,177883,177883,177884,0,1,0
50775,4,3,177887,177887,177890,0,3,3
50776,5,2,177892,177892,177894,0,2,2
50777,4,1,177896,177896,177897,0,1,2
50778,5,1,177901,177901,177902,0,1,4
50779,6,3,177907,177907,177910,0,3,5
50780,1,2,177908,177910,177912,2,4,0
50781,2,2,177910,177912,177914,2,4,0
50782,4,2,177914,177914,177916,0,2,0
50783,3,1,177917,177917,177918,0,1,1
50784,5,2,177922,177922,177924,0,2,4
50785,2,3,177924,177924,177927,0,3,0
50786,6,3,177930,177930,177933,0,3,3
50787,5,3,177935,177935,177938,0,3,2
50788,2,1,177937,177938,177939,1,2,0
50789,4,3,177941,177941,177944,0,3,2
50790,3,2,177944,177944,177946,0,2,0
50791,4,1,177948,177948,177949,0,1,2
50792,1,3,177949,177949,177952,0,3,0
50793,5,3,177954,177954,177957,0,3,2
50794,3,2,177957,177957,177959,0,2,0
50795,3,1,177960,177960,177961,0,1,1
50796,2,3,177962,177962,177965,0,3,1
50797,5,3,177967,177967,177970,0,3,2
50798,1,2,177968,177970,177972,2,4,0
50799,1,3,177969,177972,177975,3,6,0
50800,1,3,177970,177975,177978,5,8,0
50801,3,1,177973,177978,177979,5,6,0
50802,6,1,177979,177979,177980,0,1,0
50803,5,2,177984,177984,177986,0,2,4
50804,5,2,177989,177989,177991,0,2,3
50805,3,2,177992,177992,177994,0,2,1
50806,4,3,177996,177996,177999,0,3,2
50807,2,2,177998,177999,178001,1,3,0
50808,1,2,177999,178001,178003,2,4,0
50809,4,1,178003,178003,178004,0,1,0
50810,4,1,178007,178007,178008,0,1,3
50811,5,3,178012,178012,178015,0,3,4
50812,4,1,178016,178016,178017,0,1,1
50813,5,3,178021,178021,178024,0,3,4
50814,6,3,178027,178027,178030,0,3,3
50815,1,1,178028,178030,178031,2,3,0
50816,6,2,178034,178034,178036,0,2,3
50817,2,3,178036,178036,178039,0,3,0
50818,3,2,178039,178039,178041,0,2,0
50819,1,2,178040,178041,178043,1,3,0
50820,2,3,178042,178043,178046,1,4,0
50821,1,1,178043,178046,178047,3,4,0
50822,5,3,178048,178048,178051,0,3,1
50823,2,3,178050,178051,178054,1,4,0
50824,4,3,178054,178054,178057,0,3,0
50825,2,2,178056,178057,178059,1,3,0
50826,2,1,178058,178059,178060,1,2,0
50827,1,3,178059,178060,178063,1,4,0
50828,5,1,178064,178064,178065,0,1,1
50829,5,3,178069,178069,178072,0,3,4
50830,3,3,178072,178072,178075,0,3,0
50831,6,1,178078,178078,178079,0,1,3
50832,6,3,178084,178084,178087,0,3,5
50833,6,1,178090,178090,178091,0,1,3
50834,5,1,178095,178095,178096,0,1,4
50835,5,1,178100,178100,178101,0,1,4
50836,6,2,178106,178106,178108,0,2,5
50837,1,2,178107,178108,178110,1,3,0
50838,6,2,178113,178113,178115,0,2,3
50839,5,1,178118,178118,178119,0,1,3
50840,2,1,178120,178120,178121,0,1,1
50841,3,3,178123,178123,178126,0,3,2
50842,1,3,178124,178126,178129,2,5,0
50843,4,3,178128,178129,178132,1,4,0
50844,4,2,178132,178132,178134,0,2,0
50845,5,3,178137,178137,178140,0,3,3
50846,6,3,178143,178143,178146,0,3,3
50847,3,1,178146,178146,178147,0,1,0
50848,2,2,178148,178148,178150,0,2,1
50849,4,2,178152,178152,178154,0,2,2
50850,3,3,178155,178155,178158,0,3,1
50851,4,1,178159,178159,178160,0,1,1
50852,3,3,178162,178162,178165,0,3,2
50853,6,1,178168,178168,178169,0,1,3
50854,4,3,178172,178172,178175,0,3,3
50855,2,3,178174,178175,178178,1,4,0
50856,1,1,178175,178178,178179,3,4,0
50857,3,2,178178,178179,178181,1,3,0
50858,2,3,178180,178181,178184,1,4,0
50859,2,3,178182,178184,178187,2,5,0
50860,2,2,178184,178187,178189,3,5,0
50861,3,1,178187,178189,178190,2,3,0
50862,5,2,178192,178192,178194,0,2,2
50863,2,3,178194,178194,178197,0,3,0
50864,1,2,178195,178197,178199,2,4,0
50865,5,1,178200,178200,178201,0,1,1
50866,5,3,178205,178205,178208,0,3,4
50867,1,1,178206,178208,178209,2,3,0
50868,6,2,178212,178212,178214,0,2,3
50869,6,2,178218,178218,178220,0,2,4
50870,1,2,178219,178220,178222,1,3,0
50871,4,3,178223,178223,178226,0,3,1
50872,3,1,178226,178226,178227,0,1,0
50873,4,3,178230,178230,178233,0,3,3
50874,2,2,178232,178233,178235,1,3,0
50875,5,1,178237,178237,178238,0,1,2
50876,2,1,178239,178239,178240,0,1,1
50877,5,2,178244,178244,178246,0,2,4
50878,5,1,178249,178249,178250,0,1,3
50879,6,2,178255,178255,178257,0,2,5
50880,3,1,178258,178258,178259,0,1,1
50881,4,2,178262,178262,178264,0,2,3
50882,3,2,178265,178265,178267,0,2,1
50883,4,1,178269,178269,178270,0,1,2
50884,3,1,178272,178272,178273,0,1,2
50885,1,1,178273,178273,178274,0,1,0
50886,3,2,178276,178276,178278,0,2,2
50887,4,3,178280,178280,178283,0,3,2
50888,4,3,178284,178284,178287,0,3,1
50889,3,1,178287,178287,178288,0,1,0
50890,6,3,178293,178293,178296,0,3,5
50891,1,3,178294,178296,178299,2,5,0
50892,2,1,178296,178299,178300,3,4,0
50893,2,1,178298,178300,178301,2,3,0
50894,4,3,178302,178302,178305,0,3,1
50895,2,2,178304,178305,178307,1,3,0
50896,6,3,178310,178310,178313,0,3,3
50897,2,2,178312,178313,178315,1,3,0
50898,4,1,178316,178316,178317,0,1,1
50899,3,2,178319,178319,178321,0,2,2
50900,5,3,178324,178324,178327,0,3,3
50901,6,1,178330,178330,178331,0,1,3
50902,3,1,178333,178333,178334,0,1,2
50903,3,3,178336,178336,178339,0,3,2
50904,4,2,178340,178340,178342,0,2,1
50905,5,3,178345,178345,178348,0,3,3
50906,6,1,178351,178351,178352,0,1,3
50907,5,2,178356,178356,178358,0,2,4
50908,2,1,178358,178358,178359,0,1,0
50909,2,2,178360,178360,178362,0,2,1
50910,3,2,178363,178363,178365,0,2,1
50911,3,2,178366,178366,178368,0,2,1
50912,3,2,178369,178369,178371,0,2,1
50913,2,1,178371,178371,178372,0,1,0
50914,6,1,178377,178377,178378,0,1,5
50915,1,1,178378,178378,178379,0,1,0
50916,1,3,178379,178379,178382,0,3,0
50917,3,3,178382,178382,178385,0,3,0
50918,6,3,178388,178388,178391,0,3,3
50919,6,1,178394,178394,178395,0,1,3
50920,6,2,178400,178400,178402,0,2,5
50921,1,3,178401,178402,178405,1,4,0
50922,6,2,178407,178407,178409,0,2,2
50923,6,3,178413,178413,178416,0,3,4
50924,5,1,178418,178418,178419,0,1,2
50925,1,3,178419,178419,178422,0,3,0
50926,4,2,178423,178423,178425,0,2,1
50927,2,2,178425,178425,178427,0,2,0
50928,1,3,178426,178427,178430,1,4,0
50929,1,2,178427,178430,178432,3,5,0
50930,3,3,178430,178432,178435,2,5,0
50931,4,1,178434,178435,178436,1,2,0
50932,6,2,178440,178440,178442,0,2,4
50933,1,1,178441,178442,178443,1,2,0
50934,6,1,178447,178447,178448,0,1,4
50935,5,1,178452,178452,178453,0,1,4
50936,4,1,178456,178456,178457,0,1,3
50937,2,3,178458,178458,178461,0,3,1
50938,4,3,178462,178462,178465,0,3,1
50939,5,3,178467,178467,178470,0,3,2
50940,5,3,178472,178472,178475,0,3,2
50941,3,3,178475,178475,178478,0,3,0
50942,1,1,178476,178478,178479,2,3,0
50943,4,2,178480,178480,178482,0,2,1
50944,3,3,178483,178483,178486,0,3,1
50945,5,3,178488,178488,178491,0,3,2
50946,2,2,178490,178491,178493,1,3,0
50947,3,3,178493,178493,178496,0,3,0
50948,4,2,178497,178497,178499,0,2,1
50949,3,3,178500,178500,178503,0,3,1
50950,1,1,178501,178503,178504,2,3,0
50951,6,2,178507,178507,178509,0,2,3
50952,3,1,178510,178510,178511,0,1,1
50953,5,2,178515,178515,178517,0,2,4
50954,6,3,178521,178521,178524,0,3,4
50955,3,1,178524,178524,178525,0,1,0
50956,4,3,178528,178528,178531,0,3,3
50957,4,2,178532,178532,178534,0,2,1
50958,5,3,178537,178537,178540,0,3,3
50959,3,2,178540,178540,178542,0,2,0
50960,1,2,178541,178542,178544,1,3,0
50961,5,1,178546,178546,178547,0,1,2
50962,4,2,178550,178550,178552,0,2,3
50963,6,2,178556,178556,178558,0,2,4
50964,1,3,178557,178558,178561,1,4,0
50965,3,3,178560,178561,178564,1,4,0
50966,6,2,178566,178566,178568,0,2,2
50967,2,3,178568,178568,178571,0,3,0
50968,3,1,178571,178571,178572,0,1,0
50969,2,1,178573,178573,178574,0,1,1
50970,1,3,178574,178574,178577,0,3,0
50971,6,3,178580,178580,178583,0,3,3
50972,5,3,178585,178585,178588,0,3,2
50973,3,1,178588,178588,178589,0,1,0
50974,6,1,178594,178594,178595,0,1,5
50975,5,1,178599,178599,178600,0,1,4
50976,4,3,178603,178603,178606,0,3,3
50977,6,1,178609,178609,178610,0,1,3
50978,4,3,178613,178613,178616,0,3,3
50979,1,1,178614,178616,178617,2,3,0
50980,1,3,178615,178617,178620,2,5,0
50981,5,3,178620,178620,178623,0,3,0
50982,2,1,178622,178623,178624,1,2,0
50983,3,1,178625,178625,178626,0,1,1
50984,3,1,178628,178628,178629,0,1,2
50985,3,1,178631,178631,178632,0,1,2
50986,5,1,178636,178636,178637,0,1,4
50987,5,1,178641,178641,178642,0,1,4
50988,5,3,178646,178646,178649,0,3,4
50989,3,2,178649,178649,178651,0,2,0
50990,2,2,178651,178651,178653,0,2,0
50991,6,1,178657,178657,178658,0,1,4
50992,6,3,178663,178663,178666,0,3,5
50993,5,1,178668,178668,178669,0,1,2
50994,2,3,178670,178670,178673,0,3,1
50995,5,3,178675,178675,178678,0,3,2
50996,1,3,178676,178678,178681,2,5,0
50997,2,1,178678,178681,178682,3,4,0
50998,4,2,178682,178682,178684,0,2,0
50999,4,1,178686,178686,178687,0,1,2
51000,4,1,178690,178690,178691,0,1,3
51001,4,1,178694,178694,178695,0,1,3
51002,5,1,178699,178699,178700,0,1,4
51003,1,3,178700,178700,178703,0,3,0
51004,5,2,178705,178705,178707,0,2,2
51005,1,3,178706,178707,178710,1,4,0
51006,5,3,178711,178711,178714,0,3,1
51007,4,1,178715,178715,178716,0,1,1
51008,6,3,178721,178721,178724,0,3,5
51009,6,2,178727,178727,178729,0,2,3
51010,3,2,178730,178730,178732,0,2,1
51011,2,2,178732,178732,178734,0,2,0
51012,5,1,178737,178737,178738,0,1,3
51013,5,2,178742,178742,178744,0,2,4
51014,6,1,178748,178748,178749,0,1,4
51015,5,1,178753,178753,178754,0,1,4
51016,6,3,178759,178759,178762,0,3,5
51017,5,2,178764,178764,178766,0,2,2
51018,5,1,178769,178769,178770,0,1,3
51019,1,2,178770,178770,178772,0,2,0
51020,3,1,178773,178773,178774,0,1,1
51021,6,3,178779,178779,178782,0,3,5
51022,4,3,178783,178783,178786,0,3,1
51023,2,1,178785,178786,178787,1,2,0
51024,4,3,178789,178789,178792,0,3,2
51025,4,3,178793,178793,178796,0,3,1
51026,2,2,178795,178796,178798,1,3,0
51027,3,2,178798,178798,178800,0,2,0
51028,3,1,178801,178801,178802,0,1,1
51029,3,1,178804,178804,178805,0,1,2
51030,4,2,178808,178808,178810,0,2,3
51031,3,2,178811,178811,178813,0,2,1
51032,5,1,178816,178816,178817,0,1,3
51033,5,1,178821,178821,178822,0,1,4
51034,4,1,178825,178825,178826,0,1,3
51035,3,3,178828,178828,178831,0,3,2
51036,4,1,178832,178832,178833,0,1,1
51037,2,3,178834,178834,178837,0,3,1
51038,1,2,178835,178837,178839,2,4,0
51039,2,1,178837,178839,178840,2,3,0
51040,4,2,178841,178841,178843,0,2,1
51041,3,1,178844,178844,178845,0,1,1
51042,3,2,178847,178847,178849,0,2,2
51043,3,1,178850,178850,178851,0,1,1
51044,5,3,178855,178855,178858,0,3,4
51045,3,1,178858,178858,178859,0,1,0
51046,2,3,178860,178860,178863,0,3,1
51047,1,3,178861,178863,178866,2,5,0
51048,1,2,178862,178866,178868,4,6,0
51049,6,3,178868,178868,178871,0,3,0
51050,4,2,178872,178872,178874,0,2,1
51051,3,3,178875,178875,178878,0,3,1
51052,4,2,178879,178879,178881,0,2,1
51053,2,2,178881,178881,178883,0,2,0
51054,5,3,178886,178886,178889,0,3,3
51055,5,2,178891,178891,178893,0,2,2
51056,3,2,178894,178894,178896,0,2,1
51057,3,1,178897,178897,178898,0,1,1
51058,2,1,178899,178899,178900,0,1,1
51059,6,1,178905,178905,178906,0,1,5
51060,3,3,178908,178908,178911,0,3,2
51061,6,3,178914,178914,178917,0,3,3
51062,5,1,178919,178919,178920,0,1,2
51063,6,3,178925,178925,178928,0,3,5
51064,3,1,178928,178928,178929,0,1,0
51065,1,2,178929,178929,178931,0,2,0
51066,3,2,178932,178932,178934,0,2,1
51067,4,1,178936,178936,178937,0,1,2
51068,5,2,178941,178941,178943,0,2,4
51069,2,2,178943,178943,178945,0,2,0
51070,4,1,178947,178947,178948,0,1,2
51071,5,3,178952,178952,178955,0,3,4
51072,5,1,178957,178957,178958,0,1,2
51073,6,1,178963,178963,178964,0,1,5
51074,2,1,178965,178965,178966,0,1,1
51075,5,2,178970,178970,178972,0,2,4
51076,3,2,178973,178973,178975,0,2,1
51077,5,2,178978,178978,178980,0,2,3
51078,3,2,178981,178981,178983,0,2,1
51079,5,3,178986,178986,178989,0,3,3
51080,6,1,178992,178992,178993,0,1,3
51081,4,3,178996,178996,178999,0,3,3
51082,2,2,178998,178999,179001,1,3,0
51083,4,2,179002,179002,179004,0,2,1
51084,6,3,179008,179008,179011,0,3,4
51085,1,2,179009,179011,179013,2,4,0
51086,5,2,179014,179014,179016,0,2,1
51087,6,2,179020,179020,179022,0,2,4
51088,6,1,179026,179026,179027,0,1,4
51089,4,3,179030,179030,179033,0,3,3
51090,2,1,179032,179033,179034,1,2,0
51091,3,1,179035,179035,179036,0,1,1
51092,5,2,179040,179040,179042,0,2,4
51093,3,1,179043,179043,179044,0,1,1
51094,5,2,179048,179048,179050,0,2,4
51095,4,3,179052,179052,179055,0,3,2
51096,3,3,179055,179055,179058,0,3,0
51097,5,3,179060,179060,179063,0,3,2
51098,1,2,179061,179063,179065,2,4,0
51099,4,2,179065,179065,179067,0,2,0
51100,4,1,179069,179069,179070,0,1,2
51101,1,1,179070,179070,179071,0,1,0
51102,5,3,179075,179075,179078,0,3,4
51103,5,1,179080,179080,179081,0,1,2
51104,6,1,179086,179086,179087,0,1,5
51105,6,3,179092,179092,179095,0,3,5
51106,2,1,179094,179095,179096,1,2,0
51107,6,3,179100,179100,179103,0,3,4
51108,2,3,179102,179103,179106,1,4,0
51109,2,2,179104,179106,179108,2,4,0
51110,2,2,179106,179108,179110,2,4,0
51111,5,2,179111,179111,179113,0,2,1
51112,2,3,179113,179113,179116,0,3,0
51113,1,3,179114,179116,179119,2,5,0
51114,5,3,179119,179119,179122,0,3,0
51115,4,1,179123,179123,179124,0,1,1
51116,3,3,179126,179126,179129,0,3,2
51117,6,3,179132,179132,179135,0,3,3
51118,2,2,179134,179135,179137,1,3,0
51119,3,2,179137,179137,179139,0,2,0
51120,1,3,179138,179139,179142,1,4,0
51121,6,2,179144,179144,179146,0,2,2
51122,2,3,179146,179146,179149,0,3,0
51123,1,2,179147,179149,179151,2,4,0
51124,3,2,179150,179151,179153,1,3,0
51125,5,1,179155,179155,179156,0,1,2
51126,2,2,179157,179157,179159,0,2,1
51127,4,1,179161,179161,179162,0,1,2
51128,2,3,179163,179163,179166,0,3,1
51129,5,3,179168,179168,179171,0,3,2
51130,1,1,179169,179171,179172,2,3,0
51131,3,2,179172,179172,179174,0,2,0
51132,5,1,179177,179177,179178,0,1,3
51133,6,3,179183,179183,179186,0,3,5
51134,3,2,179186,179186,179188,0,2,0
51135,4,3,179190,179190,179193,0,3,2
51136,4,3,179194,179194,179197,0,3,1
51137,4,3,179198,179198,179201,0,3,1
51138,1,2,179199,179201,179203,2,4,0
51139,4,2,179203,179203,179205,0,2,0
51140,1,3,179204,179205,179208,1,4,0
51141,6,3,179210,179210,179213,0,3,2
51142,5,1,179215,179215,179216,0,1,2
51143,4,3,179219,179219,179222,0,3,3
51144,3,1,179222,179222,179223,0,1,0
51145,6,1,179228,179228,179229,0,1,5
51146,6,2,179234,179234,179236,0,2,5
51147,5,3,179239,179239,179242,0,3,3
51148,3,3,179242,179242,179245,0,3,0
51149,1,2,179243,179245,179247,2,4,0
51150,1,3,179244,179247,179250,3,6,0
51151,2,3,179246,179250,179253,4,7,0
51152,4,1,179250,179253,179254,3,4,0
51153,4,1,179254,179254,179255,0,1,0
51154,6,3,179260,179260,179263,0,3,5
51155,3,1,179263,179263,179264,0,1,0
51156,2,2,179265,179265,179267,0,2,1
51157,1,3,179266,179267,179270,1,4,0
51158,3,3,179269,179270,179273,1,4,0
51159,4,2,179273,179273,179275,0,2,0
51160,4,3,179277,179277,179280,0,3,2
51161,4,3,179281,179281,179284,0,3,1
51162,1,2,179282,179284,179286,2,4,0
51163,3,2,179285,179286,179288,1,3,0
51164,6,1,179291,179291,179292,0,1,3
51165,4,2,179295,179295,179297,0,2,3
51166,3,2,179298,179298,179300,0,2,1
51167,1,2,179299,179300,179302,1,3,0
51168,4,3,179303,179303,179306,0,3,1
51169,2,1,179305,179306,179307,1,2,0
51170,6,3,179311,179311,179314,0,3,4
51171,1,1,179312,179314,179315,2,3,0
51172,2,2,179314,179315,179317,1,3,0
51173,3,1,179317,179317,179318,0,1,0
51174,3,3,179320,179320,179323,0,3,2
51175,2,3,179322,179323,179326,1,4,0
51176,3,3,179325,179326,179329,1,4,0
51177,6,2,179331,179331,179333,0,2,2
51178,5,2,179336,179336,179338,0,2,3
51179,4,3,179340,179340,179343,0,3,2
51180,4,1,179344,179344,179345,0,1,1
51181,2,3,179346,179346,179349,0,3,1
51182,1,3,179347,179349,179352,2,5,0
51183,5,2,179352,179352,179354,0,2,0
51184,1,3,179353,179354,179357,1,4,0
51185,6,2,179359,179359,179361,0,2,2
51186,2,3,179361,179361,179364,0,3,0
51187,3,2,179364,179364,179366,0,2,0
51188,5,1,179369,179369,179370,0,1,3
51189,1,2,179370,179370,179372,0,2,0
51190,4,2,179374,179374,179376,0,2,2
51191,5,2,179379,179379,179381,0,2,3
51192,2,1,179381,179381,179382,0,1,0
51193,2,2,179383,179383,179385,0,2,1
51194,6,3,179389,179389,179392,0,3,4
51195,3,3,179392,179392,179395,0,3,0
51196,3,1,179395,179395,179396,0,1,0
51197,3,1,179398,179398,179399,0,1,2
51198,4,1,179402,179402,179403,0,1,3
51199,5,2,179407,179407,179409,0,2,4
51200,1,1,179408,179409,179410,1,2,0
51201,1,2,179409,179410,179412,1,3,0
51202,6,3,179415,179415,179418,0,3,3
51203,6,2,179421,179421,179423,0,2,3
51204,6,1,179427,179427,179428,0,1,4
51205,4,1,179431,179431,179432,0,1,3
51206,4,1,179435,179435,179436,0,1,3
51207,6,2,179441,179441,179443,0,2,5
51208,1,1,179442,179443,179444,1,2,0
51209,6,2,179448,179448,179450,0,2,4
51210,6,1,179454,179454,179455,0,1,4
51211,5,1,179459,179459,179460,0,1,4
51212,3,3,179462,179462,179465,0,3,2
51213,1,3,179463,179465,179468,2,5,0
51214,1,1,179464,179468,179469,4,5,0
51215,3,2,179467,179469,179471,2,4,0
51216,2,1,179469,179471,179472,2,3,0
51217,4,2,179473,179473,179475,0,2,1
51218,1,3,179474,179475,179478,1,4,0
51219,4,2,179478,179478,179480,0,2,0
51220,4,1,179482,179482,179483,0,1,2
51221,4,3,179486,179486,179489,0,3,3
51222,1,2,179487,179489,179491,2,4,0
51223,2,3,179489,179491,179494,2,5,0
51224,6,3,179495,179495,179498,0,3,1
51225,2,1,179497,179498,179499,1,2,0
51226,4,3,179501,179501,179504,0,3,2
51227,4,1,179505,179505,179506,0,1,1
51228,3,1,179508,179508,179509,0,1,2
51229,1,3,179509,179509,179512,0,3,0
51230,3,2,179512,179512,179514,0,2,0
51231,2,3,179514,179514,179517,0,3,0
51232,2,1,179516,179517,179518,1,2,0
51233,2,2,179518,179518,179520,0,2,0
51234,6,1,179524,179524,179525,0,1,4
51235,1,2,179525,179525,179527,0,2,0
51236,6,1,179531,179531,179532,0,1,4
51237,4,1,179535,179535,179536,0,1,3
51238,3,3,179538,179538,179541,0,3,2
51239,3,2,179541,179541,179543,0,2,0
51240,3,2,179544,179544,179546,0,2,1
51241,3,1,179547,179547,179548,0,1,1
51242,2,1,179549,179549,179550,0,1,1
51243,5,2,179554,179554,179556,0,2,4
51244,4,3,179558,179558,179561,0,3,2
51245,1,1,179559,179561,179562,2,3,0
51246,3,2,179562,179562,179564,0,2,0
51247,3,2,179565,179565,179567,0,2,1
51248,5,2,179570,179570,179572,0,2,3
51249,2,2,179572,179572,179574,0,2,0
51250,5,1,179577,179577,179578,0,1,3
51251,1,3,179578,179578,179581,0,3,0
51252,3,2,179581,179581,179583,0,2,0
51253,4,2,179585,179585,179587,0,2,2
51254,5,1,179590,179590,179591,0,1,3
51255,1,1,179591,179591,179592,0,1,0
51256,5,2,179596,179596,179598,0,2,4
51257,2,3,179598,179598,179601,0,3,0
51258,1,2,179599,179601,179603,2,4,0
51259,2,2,179601,179603,179605,2,4,0
51260,2,3,179603,179605,179608,2,5,0
51261,3,1,179606,179608,179609,2,3,0
51262,2,2,179608,179609,179611,1,3,0
51263,1,1,179609,179611,179612,2,3,0
51264,2,3,179611,179612,179615,1,4,0
51265,5,1,179616,179616,179617,0,1,1
51266,1,1,179617,179617,179618,0,1,0
51267,3,2,179620,179620,179622,0,2,2
51268,5,3,179625,179625,179628,0,3,3
51269,2,2,179627,179628,179630,1,3,0
51270,6,2,179633,179633,179635,0,2,3
51271,6,2,179639,179639,179641,0,2,4
51272,3,2,179642,179642,179644,0,2,1
51273,3,2,179645,179645,179647,0,2,1
51274,4,2,179649,179649,179651,0,2,2
51275,6,2,179655,179655,179657,0,2,4
51276,6,3,179661,179661,179664,0,3,4
51277,6,2,179667,179667,179669,0,2,3
51278,1,2,179668,179669,179671,1,3,0
51279,2,3,179670,179671,179674,1,4,0
51280,4,1,179674,179674,179675,0,1,0
51281,2,2,179676,179676,179678,0,2,1
51282,6,3,179682,179682,179685,0,3,4
51283,3,2,179685,179685,179687,0,2,0
51284,3,3,179688,179688,179691,0,3,1
51285,1,3,179689,179691,179694,2,5,0
51286,1,2,179690,179694,179696,4,6,0
51287,3,2,179693,179696,179698,3,5,0
51288,2,3,179695,179698,179701,3,6,0
51289,2,3,179697,179701,179704,4,7,0
51290,6,1,179703,179704,179705,1,2,0
51291,2,1,179705,179705,179706,0,1,0
51292,5,2,179710,179710,179712,0,2,4
51293,1,2,179711,179712,179714,1,3,0
51294,4,3,179715,179715,179718,0,3,1
51295,4,3,179719,179719,179722,0,3,1
51296,3,1,179722,179722,179723,0,1,0
51297,5,1,179727,179727,179728,0,1,4
51298,3,2,179730,179730,179732,0,2,2
51299,4,1,179734,179734,179735,0,1,2
51300,2,2,179736,179736,179738,0,2,1
51301,4,3,179740,179740,179743,0,3,2
51302,1,2,179741,179743,179745,2,4,0
51303,1,2,179742,179745,179747,3,5,0
51304,3,2,179745,179747,179749,2,4,0
51305,5,3,179750,179750,179753,0,3,1
51306,4,1,179754,179754,179755,0,1,1
51307,3,1,179757,179757,179758,0,1,2
51308,5,3,179762,179762,179765,0,3,4
51309,5,1,179767,179767,179768,0,1,2
51310,1,3,179768,179768,179771,0,3,0
51311,1,3,179769,179771,179774,2,5,0
51312,2,2,179771,179774,179776,3,5,0
51313,4,1,179775,179776,179777,1,2,0
51314,5,3,179780,179780,179783,0,3,3
51315,3,2,179783,179783,179785,0,2,0
51316,1,1,179784,179785,179786,1,2,0
51317,6,3,179790,179790,179793,0,3,4
51318,5,2,179795,179795,179797,0,2,2
51319,4,2,179799,179799,179801,0,2,2
51320,1,3,179800,179801,179804,1,4,0
51321,3,3,179803,179804,179807,1,4,0
51322,3,1,179806,179807,179808,1,2,0
51323,3,3,179809,179809,179812,0,3,1
51324,4,1,179813,179813,179814,0,1,1
51325,1,3,179814,179814,179817,0,3,0
51326,4,1,179818,179818,179819,0,1,1
51327,2,2,179820,179820,179822,0,2,1
51328,4,2,179824,179824,179826,0,2,2
51329,5,1,179829,179829,179830,0,1,3
51330,3,2,179832,179832,179834,0,2,2
51331,5,3,179837,179837,179840,0,3,3
51332,1,2,179838,179840,179842,2,4,0
51333,5,3,179843,179843,179846,0,3,1
51334,6,3,179849,179849,179852,0,3,3
51335,5,3,179854,179854,179857,0,3,2
51336,6,3,179860,179860,179863,0,3,3
51337,2,3,179862,179863,179866,1,4,0
51338,5,1,179867,179867,179868,0,1,1
51339,5,1,179872,179872,179873,0,1,4
51340,5,2,179877,179877,179879,0,2,4
51341,4,1,179881,179881,179882,0,1,2
51342,4,3,179885,179885,179888,0,3,3
51343,2,3,179887,179888,179891,1,4,0
51344,2,3,179889,179891,179894,2,5,0
51345,6,1,179895,179895,179896,0,1,1
51346,1,1,179896,179896,179897,0,1,0
51347,6,3,179902,179902,179905,0,3,5
51348,6,2,179908,179908,179910,0,2,3
51349,1,2,179909,179910,179912,1,3,0
51350,5,1,179914,179914,179915,0,1,2
51351,3,1,179917,179917,179918,0,1,2
51352,6,3,179923,179923,179926,0,3,5
51353,1,2,179924,179926,179928,2,4,0
51354,6,1,179930,179930,179931,0,1,2
51355,2,1,179932,179932,179933,0,1,1
51356,3,2,179935,179935,179937,0,2,2
51357,5,1,179940,179940,179941,0,1,3
51358,1,3,179941,179941,179944,0,3,0
51359,2,1,179943,179944,179945,1,2,0
51360,2,3,179945,179945,179948,0,3,0
51361,3,1,179948,179948,179949,0,1,0
51362,5,3,179953,179953,179956,0,3,4
51363,3,2,179956,179956,179958,0,2,0
51364,6,1,179962,179962,179963,0,1,4
51365,6,3,179968,179968,179971,0,3,5
51366,1,3,179969,179971,179974,2,5,0
51367,5,2,179974,179974,179976,0,2,0
51368,5,3,179979,179979,179982,0,3,3
51369,2,3,179981,179982,179985,1,4,0
51370,6,1,179987,179987,179988,0,1,2
51371,6,1,179993,179993,179994,0,1,5
51372,4,2,179997,179997,179999,0,2,3
51373,3,1,180000,180000,180001,0,1,1
51374,2,1,180002,180002,180003,0,1,1
51375,5,3,180007,180007,180010,0,3,4
51376,6,1,180013,180013,180014,0,1,3
51377,5,1,180018,180018,180019,0,1,4
51378,3,3,180021,180021,180024,0,3,2
51379,1,2,180022,180024,180026,2,4,0
51380,1,2,180023,180026,180028,3,5,0
51381,5,1,180028,180028,180029,0,1,0
51382,6,2,180034,180034,180036,0,2,5
51383,3,3,180037,180037,180040,0,3,1
51384,5,3,180042,180042,180045,0,3,2
51385,2,1,180044,180045,180046,1,2,0
51386,5,3,180049,180049,180052,0,3,3
51387,3,2,180052,180052,180054,0,2,0
51388,3,3,180055,180055,180058,0,3,1
51389,3,2,180058,180058,180060,0,2,0
51390,3,3,180061,180061,180064,0,3,1
51391,1,2,180062,180064,180066,2,4,0
51392,2,3,180064,180066,180069,2,5,0
51393,4,3,180068,180069,180072,1,4,0
51394,2,3,180070,180072,180075,2,5,0
51395,2,2,180072,180075,180077,3,5,0
51396,4,2,180076,180077,180079,1,3,0
51397,6,2,180082,180082,180084,0,2,3
51398,6,3,180088,180088,180091,0,3,4
51399,3,1,180091,180091,180092,0,1,0
51400,3,2,180094,180094,180096,0,2,2
51401,3,2,180097,180097,180099,0,2,1
51402,2,2,180099,180099,180101,0,2,0
51403,5,2,180104,180104,180106,0,2,3
51404,3,3,180107,180107,180110,0,3,1
51405,5,3,180112,180112,180115,0,3,2
51406,1,3,180113,180115,180118,2,5,0
51407,6,2,180119,180119,180121,0,2,1
51408,3,2,180122,180122,180124,0,2,1
51409,2,1,180124,180124,180125,0,1,0
51410,5,1,180129,180129,180130,0,1,4
51411,4,2,180133,180133,180135,0,2,3
51412,4,3,180137,180137,180140,0,3,2
51413,1,1,180138,180140,180141,2,3,0
51414,6,2,180144,180144,180146,0,2,3
51415,5,3,180149,180149,180152,0,3,3
51416,2,1,180151,180152,180153,1,2,0
51417,4,1,180155,180155,180156,0,1,2
51418,3,2,180158,180158,180160,0,2,2
51419,4,3,180162,180162,180165,0,3,2
51420,5,2,180167,180167,180169,0,2,2
51421,5,1,180172,180172,180173,0,1,3
51422,6,1,180178,180178,180179,0,1,5
51423,5,1,180183,180183,180184,0,1,4
51424,4,2,180187,180187,180189,0,2,3
51425,6,2,180193,180193,180195,0,2,4
51426,6,2,180199,180199,180201,0,2,4
51427,6,1,180205,180205,180206,0,1,4
51428,1,1,180206,180206,180207,0,1,0
51429,2,2,180208,180208,180210,0,2,1
51430,2,2,180210,180210,180212,0,2,0
51431,4,1,180214,180214,180215,0,1,2
51432,4,3,180218,180218,180221,0,3,3
51433,4,3,180222,180222,180225,0,3,1
51434,4,1,180226,180226,180227,0,1,1
51435,1,3,180227,180227,180230,0,3,0
51436,2,3,180229,180230,180233,1,4,0
51437,3,3,180232,180233,180236,1,4,0
51438,2,1,180234,180236,180237,2,3,0
51439,6,3,180240,180240,180243,0,3,3
51440,3,2,180243,180243,180245,0,2,0
51441,1,1,180244,180245,180246,1,2,0
51442,2,1,180246,180246,180247,0,1,0
51443,3,3,180249,180249,180252,0,3,2
51444,4,1,180253,180253,180254,0,1,1
51445,2,3,180255,180255,180258,0,3,1
51446,6,1,180261,180261,180262,0,1,3
51447,6,2,180267,180267,180269,0,2,5
51448,6,1,180273,180273,180274,0,1,4
51449,4,3,180277,180277,180280,0,3,3
51450,6,1,180283,180283,180284,0,1,3
51451,1,3,180284,180284,180287,0,3,0
51452,6,1,180290,180290,180291,0,1,3
51453,6,2,180296,180296,180298,0,2,5
51454,4,2,180300,180300,180302,0,2,2
51455,6,1,180306,180306,180307,0,1,4
51456,4,3,180310,180310,180313,0,3,3
51457,4,1,180314,180314,180315,0,1,1
51458,5,1,180319,180319,180320,0,1,4
51459,3,2,180322,180322,180324,0,2,2
51460,3,3,180325,180325,180328,0,3,1
51461,1,1,180326,180328,180329,2,3,0
51462,3,3,180329,180329,180332,0,3,0
51463,2,2,180331,180332,180334,1,3,0
51464,6,3,180337,180337,180340,0,3,3
51465,6,1,180343,180343,180344,0,1,3
51466,5,3,180348,180348,180351,0,3,4
51467,6,3,180354,180354,180357,0,3,3
51468,1,3,180355,180357,180360,2,5,0
51469,2,2,180357,180360,180362,3,5,0
51470,1,2,180358,180362,180364,4,6,0
51471,1,3,180359,180364,180367,5,8,0
51472,1,1,180360,180367,180368,7,8,0
51473,2,3,180362,180368,180371,6,9,0
51474,4,2,180366,180371,180373,5,7,0
51475,2,3,180368,180373,180376,5,8,0
51476,6,3,180374,180376,180379,2,5,0
51477,5,3,180379,180379,180382,0,3,0
51478,2,1,180381,180382,180383,1,2,0
51479,2,1,180383,180383,180384,0,1,0
51480,1,2,180384,180384,180386,0,2,0
51481,6,3,180390,180390,180393,0,3,4
51482,4,1,180394,180394,180395,0,1,1
51483,6,3,180400,180400,180403,0,3,5
51484,6,2,180406,180406,180408,0,2,3
51485,6,3,180412,180412,180415,0,3,4
51486,3,1,180415,180415,180416,0,1,0
51487,3,1,180418,180418,180419,0,1,2
51488,1,2,180419,180419,180421,0,2,0
51489,2,3,180421,180421,180424,0,3,0
51490,5,3,180426,180426,180429,0,3,2
51491,1,1,180427,180429,180430,2,3,0
51492,5,2,180432,180432,180434,0,2,2
51493,3,3,180435,180435,180438,0,3,1
51494,5,1,180440,180440,180441,0,1,2
51495,1,1,180441,180441,180442,0,1,0
51496,2,2,180443,180443,180445,0,2,1
51497,6,2,180449,180449,180451,0,2,4
51498,4,3,180453,180453,180456,0,3,2
51499,2,1,180455,180456,180457,1,2,0
51500,5,1,180460,180460,180461,0,1,3
51501,5,1,180465,180465,180466,0,1,4
51502,5,1,180470,180470,180471,0,1,4
51503,1,3,180471,180471,180474,0,3,0
51504,5,3,180476,180476,180479,0,3,2
51505,2,1,180478,180479,180480,1,2,0
51506,4,1,180482,180482,180483,0,1,2
51507,1,2,180483,180483,180485,0,2,0
51508,6,3,180489,180489,180492,0,3,4
51509,4,3,180493,180493,180496,0,3,1
51510,3,3,180496,180496,180499,0,3,0
51511,2,1,180498,180499,180500,1,2,0
51512,2,2,180500,180500,180502,0,2,0
51513,6,2,180506,180506,180508,0,2,4
51514,2,3,180508,180508,180511,0,3,0
51515,2,1,180510,180511,180512,1,2,0
51516,5,3,180515,180515,180518,0,3,3
51517,3,3,180518,180518,180521,0,3,0
51518,1,3,180519,180521,180524,2,5,0
51519,1,1,180520,180524,180525,4,5,0
51520,2,1,180522,180525,180526,3,4,0
51521,6,3,180528,180528,180531,0,3,2
51522,4,1,180532,180532,180533,0,1,1
51523,5,1,180537,180537,180538,0,1,4
51524,4,3,180541,180541,180544,0,3,3
51525,2,2,180543,180544,180546,1,3,0
51526,1,3,180544,180546,180549,2,5,0
51527,2,3,180546,180549,180552,3,6,0
51528,1,1,180547,180552,180553,5,6,0
51529,5,2,180552,180553,180555,1,3,0
51530,5,3,180557,180557,180560,0,3,2
51531,3,1,180560,180560,180561,0,1,0
51532,1,3,180561,180561,180564,0,3,0
51533,1,2,180562,180564,180566,2,4,0
51534,1,2,180563,180566,180568,3,5,0
51535,3,2,180566,180568,180570,2,4,0
51536,5,2,180571,180571,180573,0,2,1
51537,2,2,180573,180573,180575,0,2,0
51538,5,1,180578,180578,180579,0,1,3
51539,2,3,180580,180580,180583,0,3,1
51540,3,2,180583,180583,180585,0,2,0
51541,6,1,180589,180589,180590,0,1,4
51542,5,2,180594,180594,180596,0,2,4
51543,6,3,180600,180600,180603,0,3,4
51544,2,1,180602,180603,180604,1,2,0
51545,5,3,180607,180607,180610,0,3,3
51546,4,3,180611,180611,180614,0,3,1
51547,1,2,180612,180614,180616,2,4,0
51548,3,1,180615,180616,180617,1,2,0
51549,4,2,180619,180619,180621,0,2,2
51550,4,1,180623,180623,180624,0,1,2
51551,1,1,180624,180624,180625,0,1,0
51552,3,2,180627,180627,180629,0,2,2
51553,6,2,180633,180633,180635,0,2,4
51554,2,3,180635,180635,180638,0,3,0
51555,6,2,180641,180641,180643,0,2,3
51556,6,3,180647,180647,180650,0,3,4
51557,1,1,180648,180650,180651,2,3,0
51558,4,2,180652,180652,180654,0,2,1
51559,3,2,180655,180655,180657,0,2,1
51560,3,3,180658,180658,180661,0,3,1
51561,4,1,180662,180662,180663,0,1,1
51562,2,3,180664,180664,180667,0,3,1
51563,3,3,180667,180667,180670,0,3,0
51564,5,1,180672,180672,180673,0,1,2
51565,1,2,180673,180673,180675,0,2,0
51566,2,2,180675,180675,180677,0,2,0
51567,4,3,180679,180679,180682,0,3,2
51568,4,3,180683,180683,180686,0,3,1
51569,6,1,180689,180689,180690,0,1,3
51570,2,1,180691,180691,180692,0,1,1
51571,6,1,180697,180697,180698,0,1,5
51572,4,3,180701,180701,180704,0,3,3
51573,2,2,180703,180704,180706,1,3,0
51574,4,3,180707,180707,180710,0,3,1
51575,1,1,180708,180710,180711,2,3,0
51576,5,2,180713,180713,180715,0,2,2
51577,4,3,180717,180717,180720,0,3,2
51578,6,3,180723,180723,180726,0,3,3
51579,3,2,180726,180726,180728,0,2,0
51580,2,2,180728,180728,180730,0,2,0
51581,3,3,180731,180731,180734,0,3,1
51582,6,1,180737,180737,180738,0,1,3
51583,2,1,180739,180739,180740,0,1,1
51584,2,3,180741,180741,180744,0,3,1
51585,5,3,180746,180746,180749,0,3,2
51586,6,3,180752,180752,180755,0,3,3
51587,4,1,180756,180756,180757,0,1,1
51588,4,3,180760,180760,180763,0,3,3
51589,2,1,180762,180763,180764,1,2,0
51590,2,3,180764,180764,180767,0,3,0
51591,6,3,180770,180770,180773,0,3,3
51592,2,3,180772,180773,180776,1,4,0
51593,6,3,180778,180778,180781,0,3,2
51594,5,2,180783,180783,180785,0,2,2
51595,1,3,180784,180785,180788,1,4,0
51596,3,2,180787,180788,180790,1,3,0
51597,3,1,180790,180790,180791,0,1,0
51598,5,2,180795,180795,180797,0,2,4
51599,6,2,180801,180801,180803,0,2,4
51600,5,1,180806,180806,180807,0,1,3
51601,6,1,180812,180812,180813,0,1,5
51602,2,2,180814,180814,180816,0,2,1
51603,1,1,180815,180816,180817,1,2,0
51604,6,1,180821,180821,180822,0,1,4
51605,4,2,180825,180825,180827,0,2,3
51606,5,1,180830,180830,180831,0,1,3
51607,4,3,180834,180834,180837,0,3,3
51608,4,1,180838,180838,180839,0,1,1
51609,6,2,180844,180844,180846,0,2,5
51610,4,2,180848,180848,180850,0,2,2
51611,5,2,180853,180853,180855,0,2,3
51612,3,1,180856,180856,180857,0,1,1
51613,5,2,180861,180861,180863,0,2,4
51614,2,2,180863,180863,180865,0,2,0
51615,6,1,180869,180869,180870,0,1,4
51616,2,2,180871,180871,180873,0,2,1
51617,6,2,180877,180877,180879,0,2,4
51618,3,1,180880,180880,180881,0,1,1
51619,3,1,180883,180883,180884,0,1,2
51620,6,3,180889,180889,180892,0,3,5
51621,4,3,180893,180893,180896,0,3,1
51622,5,2,180898,180898,180900,0,2,2
51623,5,2,180903,180903,180905,0,2,3
51624,1,2,180904,180905,180907,1,3,0
51625,3,1,180907,180907,180908,0,1,0
51626,3,2,180910,180910,180912,0,2,2
51627,5,3,180915,180915,180918,0,3,3
51628,2,1,180917,180918,180919,1,2,0
51629,4,1,180921,180921,180922,0,1,2
51630,6,2,180927,180927,180929,0,2,5
51631,6,1,180933,180933,180934,0,1,4
51632,4,2,180937,180937,180939,0,2,3
51633,6,3,180943,180943,180946,0,3,4
51634,6,1,180949,180949,180950,0,1,3
51635,5,1,180954,180954,180955,0,1,4
51636,6,3,180960,180960,180963,0,3,5
51637,5,2,180965,180965,180967,0,2,2
51638,4,3,180969,180969,180972,0,3,2
51639,6,3,180975,180975,180978,0,3,3
51640,4,3,180979,180979,180982,0,3,1
51641,3,3,180982,180982,180985,0,3,0
51642,4,3,180986,180986,180989,0,3,1
51643,1,1,180987,180989,180990,2,3,0
51644,5,3,180992,180992,180995,0,3,2
51645,5,2,180997,180997,180999,0,2,2
51646,6,2,181003,181003,181005,0,2,4
51647,1,1,181004,181005,181006,1,2,0
51648,2,1,181006,181006,181007,0,1,0
51649,3,1,181009,181009,181010,0,1,2
51650,6,2,181015,181015,181017,0,2,5
51651,5,2,181020,181020,181022,0,2,3
51652,1,2,181021,181022,181024,1,3,0
51653,2,2,181023,181024,181026,1,3,0
51654,5,1,181028,181028,181029,0,1,2
51655,1,2,181029,181029,181031,0,2,0
51656,2,3,181031,181031,181034,0,3,0
51657,2,1,181033,181034,181035,1,2,0
51658,2,1,181035,181035,181036,0,1,0
51659,3,3,181038,181038,181041,0,3,2
51660,3,1,181041,181041,181042,0,1,0
51661,1,2,181042,181042,181044,0,2,0
51662,2,1,181044,181044,181045,0,1,0
51663,1,1,181045,181045,181046,0,1,0
51664,1,2,181046,181046,181048,0,2,0
51665,4,2,181050,181050,181052,0,2,2
51666,1,3,181051,181052,181055,1,4,0
51667,4,1,181055,181055,181056,0,1,0
51668,6,3,181061,181061,181064,0,3,5
51669,6,1,181067,181067,181068,0,1,3
51670,6,2,181073,181073,181075,0,2,5
51671,2,3,181075,181075,181078,0,3,0
51672,4,1,181079,181079,181080,0,1,1
51673,1,1,181080,181080,181081,0,1,0
51674,2,3,181082,181082,181085,0,3,1
51675,1,1,181083,181085,181086,2,3,0
51676,1,3,181084,181086,181089,2,5,0
51677,1,1,181085,181089,181090,4,5,0
51678,6,3,181091,181091,181094,0,3,1
51679,2,1,181093,181094,181095,1,2,0
51680,3,1,181096,181096,181097,0,1,1
51681,4,3,181100,181100,181103,0,3,3
51682,4,3,181104,181104,181107,0,3,1
51683,1,2,181105,181107,181109,2,4,0
51684,5,3,181110,181110,181113,0,3,1
51685,3,2,181113,181113,181115,0,2,0
51686,3,2,181116,181116,181118,0,2,1
51687,1,3,181117,181118,181121,1,4,0
51688,6,2,181123,181123,181125,0,2,2
51689,3,1,181126,181126,181127,0,1,1
51690,5,3,181131,181131,181134,0,3,4
51691,5,2,181136,181136,181138,0,2,2
51692,3,3,181139,181139,181142,0,3,1
51693,3,3,181142,181142,181145,0,3,0
51694,4,3,181146,181146,181149,0,3,1
51695,5,1,181151,181151,181152,0,1,2
51696,4,2,181155,181155,181157,0,2,3
51697,3,1,181158,181158,181159,0,1,1
51698,6,1,181164,181164,181165,0,1,5
51699,1,2,181165,181165,181167,0,2,0
51700,6,3,181171,181171,181174,0,3,4
51701,6,2,181177,181177,181179,0,2,3
51702,6,1,181183,181183,181184,0,1,4
51703,1,3,181184,181184,181187,0,3,0
51704,1,1,181185,181187,181188,2,3,0
51705,6,3,181191,181191,181194,0,3,3
51706,1,2,181192,181194,181196,2,4,0
51707,5,2,181197,181197,181199,0,2,1
51708,2,1,181199,181199,181200,0,1,0
51709,4,2,181203,181203,181205,0,2,3
51710,3,3,181206,181206,181209,0,3,1
51711,5,1,181211,181211,181212,0,1,2
51712,1,2,181212,181212,181214,0,2,0
51713,1,2,181213,181214,181216,1,3,0
51714,6,3,181219,181219,181222,0,3,3
51715,6,3,181225,181225,181228,0,3,3
51716,4,1,181229,181229,181230,0,1,1
51717,6,1,181235,181235,181236,0,1,5
51718,3,3,181238,181238,181241,0,3,2
51719,6,3,181244,181244,181247,0,3,3
51720,3,2,181247,181247,181249,0,2,0
51721,4,2,181251,181251,181253,0,2,2
51722,1,1,181252,181253,181254,1,2,0
51723,1,3,181253,181254,181257,1,4,0
51724,6,1,181259,181259,181260,0,1,2
51725,3,1,181262,181262,181263,0,1,2
51726,6,2,181268,181268,181270,0,2,5
51727,1,1,181269,181270,181271,1,2,0
51728,5,2,181274,181274,181276,0,2,3
51729,1,2,181275,181276,181278,1,3,0
51730,6,3,181281,181281,181284,0,3,3
51731,4,1,181285,181285,181286,0,1,1
51732,4,1,181289,181289,181290,0,1,3
51733,4,1,181293,181293,181294,0,1,3
51734,4,1,181297,181297,181298,0,1,3
51735,4,2,181301,181301,181303,0,2,3
51736,2,3,181303,181303,181306,0,3,0
51737,1,2,181304,181306,181308,2,4,0
51738,3,1,181307,181308,181309,1,2,0
51739,5,1,181312,181312,181313,0,1,3
51740,1,1,181313,181313,181314,0,1,0
51741,2,1,181315,181315,181316,0,1,1
51742,2,2,181317,181317,181319,0,2,1
51743,1,1,181318,181319,181320,1,2,0
51744,2,3,181320,181320,181323,0,3,0
51745,2,2,181322,181323,181325,1,3,0
51746,2,3,181324,181325,181328,1,4,0
51747,4,3,181328,181328,181331,0,3,0
51748,2,3,181330,181331,181334,1,4,0
51749,1,2,181331,181334,181336,3,5,0
51750,6,2,181337,181337,181339,0,2,1
51751,6,2,181343,181343,181345,0,2,4
51752,6,2,181349,181349,181351,0,2,4
51753,6,3,181355,181355,181358,0,3,4
51754,5,1,181360,181360,181361,0,1,2
51755,6,2,181366,181366,181368,0,2,5
51756,5,3,181371,181371,181374,0,3,3
51757,6,1,181377,181377,181378,0,1,3
51758,6,1,181383,181383,181384,0,1,5
51759,2,3,181385,181385,181388,0,3,1
51760,5,2,181390,181390,181392,0,2,2
51761,3,2,181393,181393,181395,0,2,1
51762,3,3,181396,181396,181399,0,3,1
51763,1,2,181397,181399,181401,2,4,0
51764,3,1,181400,181401,181402,1,2,0
51765,3,1,181403,181403,181404,0,1,1
51766,3,3,181406,181406,181409,0,3,2
51767,5,3,181411,181411,181414,0,3,2
51768,5,3,181416,181416,181419,0,3,2
51769,3,2,181419,181419,181421,0,2,0
51770,4,3,181423,181423,181426,0,3,2
51771,1,1,181424,181426,181427,2,3,0
51772,2,2,181426,181427,181429,1,3,0
51773,5,1,181431,181431,181432,0,1,2
51774,2,3,181433,181433,181436,0,3,1
51775,3,3,181436,181436,181439,0,3,0
51776,1,2,181437,181439,181441,2,4,0
51777,1,2,181438,181441,181443,3,5,0
51778,4,1,181442,181443,181444,1,2,0
51779,1,2,181443,181444,181446,1,3,0
51780,4,1,181447,181447,181448,0,1,1
51781,2,2,181449,181449,181451,0,2,1
51782,5,2,181454,181454,181456,0,2,3
51783,4,2,181458,181458,181460,0,2,2
51784,2,1,181460,181460,181461,0,1,0
51785,6,1,181466,181466,181467,0,1,5
51786,3,3,181469,181469,181472,0,3,2
51787,2,2,181471,181472,181474,1,3,0
51788,2,2,181473,181474,181476,1,3,0
51789,4,2,181477,181477,181479,0,2,1
51790,3,3,181480,181480,181483,0,3,1
51791,2,1,181482,181483,181484,1,2,0
51792,2,3,181484,181484,181487,0,3,0
51793,6,3,181490,181490,181493,0,3,3
51794,5,3,181495,181495,181498,0,3,2
51795,6,2,181501,181501,181503,0,2,3
51796,6,2,181507,181507,181509,0,2,4
51797,3,3,181510,181510,181513,0,3,1
51798,4,1,181514,181514,181515,0,1,1
51799,4,1,181518,181518,181519,0,1,3
51800,1,2,181519,181519,181521,0,2,0
51801,2,2,181521,181521,181523,0,2,0
51802,5,2,181526,181526,181528,0,2,3
51803,2,3,181528,181528,181531,0,3,0
51804,4,2,181532,181532,181534,0,2,1
51805,5,1,181537,181537,181538,0,1,3
51806,1,1,181538,181538,181539,0,1,0
51807,5,3,181543,181543,181546,0,3,4
51808,3,2,181546,181546,181548,0,2,0
51809,5,1,181551,181551,181552,0,1,3
51810,5,3,181556,181556,181559,0,3,4
51811,1,1,181557,181559,181560,2,3,0
51812,5,3,181562,181562,181565,0,3,2
51813,2,3,181564,181565,181568,1,4,0
51814,1,2,181565,181568,181570,3,5,0
51815,3,1,181568,181570,181571,2,3,0
51816,3,1,181571,181571,181572,0,1,0
51817,6,1,181577,181577,181578,0,1,5
51818,2,2,181579,181579,181581,0,2,1
51819,2,3,181581,181581,181584,0,3,0
51820,1,3,181582,181584,181587,2,5,0
51821,5,2,181587,181587,181589,0,2,0
51822,3,2,181590,181590,181592,0,2,1
51823,4,3,181594,181594,181597,0,3,2
51824,2,1,181596,181597,181598,1,2,0
51825,1,2,181597,181598,181600,1,3,0
51826,2,2,181599,181600,181602,1,3,0
51827,2,2,181601,181602,181604,1,3,0
51828,3,1,181604,181604,181605,0,1,0
51829,2,1,181606,181606,181607,0,1,1
51830,2,2,181608,181608,181610,0,2,1
51831,4,2,181612,181612,181614,0,2,2
51832,6,3,181618,181618,181621,0,3,4
51833,6,2,181624,181624,181626,0,2,3
51834,1,2,181625,181626,181628,1,3,0
51835,4,3,181629,181629,181632,0,3,1
51836,6,2,181635,181635,181637,0,2,3
51837,1,1,181636,181637,181638,1,2,0
51838,4,3,181640,181640,181643,0,3,2
51839,2,1,181642,181643,181644,1,2,0
51840,3,2,181645,181645,181647,0,2,1
51841,3,1,181648,181648,181649,0,1,1
51842,5,1,181653,181653,181654,0,1,4
51843,1,2,181654,181654,181656,0,2,0
51844,2,2,181656,181656,181658,0,2,0
51845,6,3,181662,181662,181665,0,3,4
51846,5,3,181667,181667,181670,0,3,2
51847,6,1,181673,181673,181674,0,1,3
51848,2,3,181675,181675,181678,0,3,1
51849,5,3,181680,181680,181683,0,3,2
51850,2,1,181682,181683,181684,1,2,0
51851,6,2,181688,181688,181690,0,2,4
51852,1,1,181689,181690,181691,1,2,0
51853,6,3,181695,181695,181698,0,3,4
51854,3,3,181698,181698,181701,0,3,0
51855,2,2,181700,181701,181703,1,3,0
51856,5,2,181705,181705,181707,0,2,2
51857,2,2,181707,181707,181709,0,2,0
51858,5,2,181712,181712,181714,0,2,3
51859,2,1,181714,181714,181715,0,1,0
51860,3,2,181717,181717,181719,0,2,2
51861,1,1,181718,181719,181720,1,2,0
51862,1,2,181719,181720,181722,1,3,0
51863,5,3,181724,181724,181727,0,3,2
51864,4,2,181728,181728,181730,0,2,1
51865,5,3,181733,181733,181736,0,3,3
51866,1,3,181734,181736,181739,2,5,0
51867,4,3,181738,181739,181742,1,4,0
51868,3,2,181741,181742,181744,1,3,0
51869,1,3,181742,181744,181747,2,5,0
51870,2,2,181744,181747,181749,3,5,0
51871,1,1,181745,181749,181750,4,5,0
51872,1,2,181746,181750,181752,4,6,0
51873,1,1,181747,181752,181753,5,6,0
51874,5,3,181752,181753,181756,1,4,0
51875,4,3,181756,181756,181759,0,3,0
51876,3,2,181759,181759,181761,0,2,0
51877,3,1,181762,181762,181763,0,1,1
51878,1,2,181763,181763,181765,0,2,0
51879,5,3,181768,181768,181771,0,3,3
51880,2,1,181770,181771,181772,1,2,0
51881,3,2,181773,181773,181775,0,2,1
51882,4,1,181777,181777,181778,0,1,2
51883,3,1,181780,181780,181781,0,1,2
51884,3,2,181783,181783,181785,0,2,2
51885,2,2,181785,181785,181787,0,2,0
51886,6,1,181791,181791,181792,0,1,4
51887,4,2,181795,181795,181797,0,2,3
51888,1,2,181796,181797,181799,1,3,0
51889,6,1,181802,181802,181803,0,1,3
51890,5,2,181807,181807,181809,0,2,4
51891,2,1,181809,181809,181810,0,1,0
51892,3,2,181812,181812,181814,0,2,2
51893,6,2,181818,181818,181820,0,2,4
51894,5,3,181823,181823,181826,0,3,3
51895,5,1,181828,181828,181829,0,1,2
51896,6,1,181834,181834,181835,0,1,5
51897,5,1,181839,181839,181840,0,1,4
51898,4,1,181843,181843,181844,0,1,3
51899,5,2,181848,181848,181850,0,2,4
51900,3,2,181851,181851,181853,0,2,1
51901,5,1,181856,181856,181857,0,1,3
51902,1,1,181857,181857,181858,0,1,0
51903,1,3,181858,181858,181861,0,3,0
51904,6,1,181864,181864,181865,0,1,3
51905,6,2,181870,181870,181872,0,2,5
51906,4,2,181874,181874,181876,0,2,2
51907,6,3,181880,181880,181883,0,3,4
51908,5,3,181885,181885,181888,0,3,2
51909,2,3,181887,181888,181891,1,4,0
51910,6,1,181893,181893,181894,0,1,2
51911,5,3,181898,181898,181901,0,3,4
51912,3,2,181901,181901,181903,0,2,0
51913,2,3,181903,181903,181906,0,3,0
51914,1,1,181904,181906,181907,2,3,0
51915,3,2,181907,181907,181909,0,2,0
51916,5,1,181912,181912,181913,0,1,3
51917,1,1,181913,181913,181914,0,1,0
51918,6,2,181919,181919,181921,0,2,5
51919,5,2,181924,181924,181926,0,2,3
51920,6,1,181930,181930,181931,0,1,4
51921,2,3,181932,181932,181935,0,3,1
51922,2,2,181934,181935,181937,1,3,0
51923,2,3,181936,181937,181940,1,4,0
51924,6,2,181942,181942,181944,0,2,2
51925,6,2,181948,181948,181950,0,2,4
51926,4,2,181952,181952,181954,0,2,2
51927,1,3,181953,181954,181957,1,4,0
51928,2,3,181955,181957,181960,2,5,0
51929,5,2,181960,181960,181962,0,2,0
51930,3,1,181963,181963,181964,0,1,1
51931,4,1,181967,181967,181968,0,1,3
51932,5,3,181972,181972,181975,0,3,4
51933,5,1,181977,181977,181978,0,1,2
51934,5,2,181982,181982,181984,0,2,4
51935,6,3,181988,181988,181991,0,3,4
51936,5,3,181993,181993,181996,0,3,2
51937,6,2,181999,181999,182001,0,2,3
51938,1,3,182000,182001,182004,1,4,0
51939,5,1,182005,182005,182006,0,1,1
51940,5,3,182010,182010,182013,0,3,4
51941,2,3,182012,182013,182016,1,4,0
51942,5,3,182017,182017,182020,0,3,1
51943,4,2,182021,182021,182023,0,2,1
51944,5,3,182026,182026,182029,0,3,3
51945,1,3,182027,182029,182032,2,5,0
51946,5,1,182032,182032,182033,0,1,0
51947,6,3,182038,182038,182041,0,3,5
51948,3,2,182041,182041,182043,0,2,0
51949,3,1,182044,182044,182045,0,1,1
51950,1,3,182045,182045,182048,0,3,0
51951,1,2,182046,182048,182050,2,4,0
51952,2,1,182048,182050,182051,2,3,0
51953,4,1,182052,182052,182053,0,1,1
51954,3,1,182055,182055,182056,0,1,2
51955,6,3,182061,182061,182064,0,3,5
51956,2,3,182063,182064,182067,1,4,0
51957,6,2,182069,182069,182071,0,2,2
51958,2,2,182071,182071,182073,0,2,0
51959,4,1,182075,182075,182076,0,1,2
51960,4,1,182079,182079,182080,0,1,3
51961,5,3,182084,182084,182087,0,3,4
51962,4,2,182088,182088,182090,0,2,1
51963,4,1,182092,182092,182093,0,1,2
51964,4,2,182096,182096,182098,0,2,3
51965,6,2,182102,182102,182104,0,2,4
51966,2,1,182104,182104,182105,0,1,0
51967,4,2,182108,182108,182110,0,2,3
51968,2,1,182110,182110,182111,0,1,0
51969,4,3,182114,182114,182117,0,3,3
51970,3,2,182117,182117,182119,0,2,0
51971,4,2,182121,182121,182123,0,2,2
51972,3,2,182124,182124,182126,0,2,1
51973,6,1,182130,182130,182131,0,1,4
51974,5,2,182135,182135,182137,0,2,4
51975,1,2,182136,182137,182139,1,3,0
51976,3,2,182139,182139,182141,0,2,0
51977,4,3,182143,182143,182146,0,3,2
51978,4,3,182147,182147,182150,0,3,1
51979,5,2,182152,182152,182154,0,2,2
51980,4,2,182156,182156,182158,0,2,2
51981,3,1,182159,182159,182160,0,1,1
51982,2,3,182161,182161,182164,0,3,1
51983,3,2,182164,182164,182166,0,2,0
51984,2,3,182166,182166,182169,0,3,0
51985,6,2,182172,182172,182174,0,2,3
51986,3,2,182175,182175,182177,0,2,1
51987,3,3,182178,182178,182181,0,3,1
51988,6,3,182184,182184,182187,0,3,3
51989,5,3,182189,182189,182192,0,3,2
51990,2,3,182191,182192,182195,1,4,0
51991,4,2,182195,182195,182197,0,2,0
51992,5,1,182200,182200,182201,0,1,3
51993,2,3,182202,182202,182205,0,3,1
51994,5,2,182207,182207,182209,0,2,2
51995,4,2,182211,182211,182213,0,2,2
51996,4,1,182215,182215,182216,0,1,2
51997,3,2,182218,182218,182220,0,2,2
51998,4,3,182222,182222,182225,0,3,2
51999,3,3,182225,182225,182228,0,3,0
52000,6,2,182231,182231,182233,0,2,3
52001,2,2,182233,182233,182235,0,2,0
52002,6,1,182239,182239,182240,0,1,4
52003,4,1,182243,182243,182244,0,1,3
52004,4,1,182247,182247,182248,0,1,3
52005,6,2,182253,182253,182255,0,2,5
52006,4,2,182257,182257,182259,0,2,2
52007,3,1,182260,182260,182261,0,1,1
52008,6,2,182266,182266,182268,0,2,5
52009,6,3,182272,182272,182275,0,3,4
52010,1,3,182273,182275,182278,2,5,0
52011,1,2,182274,182278,182280,4,6,0
52012,1,1,182275,182280,182281,5,6,0
52013,1,2,182276,182281,182283,5,7,0
52014,4,2,182280,182283,182285,3,5,0
52015,5,1,182285,182285,182286,0,1,0
52016,6,1,182291,182291,182292,0,1,5
52017,4,2,182295,182295,182297,0,2,3
52018,3,2,182298,182298,182300,0,2,1
52019,6,3,182304,182304,182307,0,3,4
52020,6,2,182310,182310,182312,0,2,3
52021,5,3,182315,182315,182318,0,3,3
52022,1,3,182316,182318,182321,2,5,0
52023,4,1,182320,182321,182322,1,2,0
52024,4,1,182324,182324,182325,0,1,2
52025,4,2,182328,182328,182330,0,2,3
52026,6,2,182334,182334,182336,0,2,4
52027,5,2,182339,182339,182341,0,2,3
52028,2,2,182341,182341,182343,0,2,0
52029,2,1,182343,182343,182344,0,1,0
52030,1,3,182344,182344,182347,0,3,0
52031,3,2,182347,182347,182349,0,2,0
52032,5,2,182352,182352,182354,0,2,3
52033,4,1,182356,182356,182357,0,1,2
52034,2,3,182358,182358,182361,0,3,1
52035,5,1,182363,182363,182364,0,1,2
52036,1,3,182364,182364,182367,0,3,0
52037,6,2,182370,182370,182372,0,2,3
52038,5,1,182375,182375,182376,0,1,3
52039,6,3,182381,182381,182384,0,3,5
52040,6,1,182387,182387,182388,0,1,3
52041,2,2,182389,182389,182391,0,2,1
52042,4,1,182393,182393,182394,0,1,2
52043,1,1,182394,182394,182395,0,1,0
52044,4,3,182398,182398,182401,0,3,3
52045,1,1,182399,182401,182402,2,3,0
52046,1,1,182400,182402,182403,2,3,0
52047,3,2,182403,182403,182405,0,2,0
52048,3,1,182406,182406,182407,0,1,1
52049,1,3,182407,182407,182410,0,3,0
52050,2,2,182409,182410,182412,1,3,0
52051,6,3,182415,182415,182418,0,3,3
52052,5,3,182420,182420,182423,0,3,2
52053,6,1,182426,182426,182427,0,1,3
52054,6,1,182432,182432,182433,0,1,5
52055,1,3,182433,182433,182436,0,3,0
52056,4,2,182437,182437,182439,0,2,1
52057,3,2,182440,182440,182442,0,2,1
52058,3,1,182443,182443,182444,0,1,1
52059,5,3,182448,182448,182451,0,3,4
52060,5,2,182453,182453,182455,0,2,2
52061,2,3,182455,182455,182458,0,3,0
52062,1,1,182456,182458,182459,2,3,0
52063,4,3,182460,182460,182463,0,3,1
52064,1,1,182461,182463,182464,2,3,0
52065,1,1,182462,182464,182465,2,3,0
52066,3,3,182465,182465,182468,0,3,0
52067,3,2,182468,182468,182470,0,2,0
52068,5,2,182473,182473,182475,0,2,3
52069,6,3,182479,182479,182482,0,3,4
52070,5,3,182484,182484,182487,0,3,2
52071,2,1,182486,182487,182488,1,2,0
52072,3,1,182489,182489,182490,0,1,1
52073,4,3,182493,182493,182496,0,3,3
52074,2,3,182495,182496,182499,1,4,0
52075,6,1,182501,182501,182502,0,1,2
52076,4,2,182505,182505,182507,0,2,3
52077,4,3,182509,182509,182512,0,3,2
52078,1,3,182510,182512,182515,2,5,0
52079,5,1,182515,182515,182516,0,1,0
52080,6,2,182521,182521,182523,0,2,5
52081,5,1,182526,182526,182527,0,1,3
52082,1,3,182527,182527,182530,0,3,0
52083,6,2,182533,182533,182535,0,2,3
52084,1,2,182534,182535,182537,1,3,0
52085,5,3,182539,182539,182542,0,3,2
52086,3,1,182542,182542,182543,0,1,0
52087,1,2,182543,182543,182545,0,2,0
52088,2,2,182545,182545,182547,0,2,0
52089,5,1,182550,182550,182551,0,1,3
52090,5,1,182555,182555,182556,0,1,4
52091,1,2,182556,182556,182558,0,2,0
52092,5,2,182561,182561,182563,0,2,3
52093,1,3,182562,182563,182566,1,4,0
52094,6,1,182568,182568,182569,0,1,2
52095,4,1,182572,182572,182573,0,1,3
52096,4,2,182576,182576,182578,0,2,3
52097,3,1,182579,182579,182580,0,1,1
52098,3,1,182582,182582,182583,0,1,2
52099,1,1,182583,182583,182584,0,1,0
52100,2,1,182585,182585,182586,0,1,1
52101,3,1,182588,182588,182589,0,1,2
52102,4,3,182592,182592,182595,0,3,3
52103,1,2,182593,182595,182597,2,4,0
52104,4,3,182597,182597,182600,0,3,0
52105,2,1,182599,182600,182601,1,2,0
52106,6,2,182605,182605,182607,0,2,4
52107,5,1,182610,182610,182611,0,1,3
52108,5,2,182615,182615,182617,0,2,4
52109,3,3,182618,182618,182621,0,3,1
52110,1,1,182619,182621,182622,2,3,0
52111,4,3,182623,182623,182626,0,3,1
52112,5,2,182628,182628,182630,0,2,2
52113,4,1,182632,182632,182633,0,1,2
52114,2,1,182634,182634,182635,0,1,1
52115,1,2,182635,182635,182637,0,2,0
52116,1,3,182636,182637,182640,1,4,0
52117,1,3,182637,182640,182643,3,6,0
52118,5,3,182642,182643,182646,1,4,0
52119,4,2,182646,182646,182648,0,2,0
52120,5,1,182651,182651,182652,0,1,3
52121,5,1,182656,182656,182657,0,1,4
52122,4,3,182660,182660,182663,0,3,3
52123,6,2,182666,182666,182668,0,2,3
52124,6,2,182672,182672,182674,0,2,4
52125,3,1,182675,182675,182676,0,1,1
52126,1,2,182676,182676,182678,0,2,0
52127,5,1,182681,182681,182682,0,1,3
52128,1,3,182682,182682,182685,0,3,0
52129,3,3,182685,182685,182688,0,3,0
52130,5,1,182690,182690,182691,0,1,2
52131,6,2,182696,182696,182698,0,2,5
52132,5,1,182701,182701,182702,0,1,3
52133,5,3,182706,182706,182709,0,3,4
52134,2,1,182708,182709,182710,1,2,0
52135,5,3,182713,182713,182716,0,3,3
52136,4,1,182717,182717,182718,0,1,1
52137,1,2,182718,182718,182720,0,2,0
52138,1,2,182719,182720,182722,1,3,0
52139,2,1,182721,182722,182723,1,2,0
52140,4,3,182725,182725,182728,0,3,2
52141,3,1,182728,182728,182729,0,1,0
52142,3,3,182731,182731,182734,0,3,2
52143,5,3,182736,182736,182739,0,3,2
52144,6,3,182742,182742,182745,0,3,3
52145,1,1,182743,182745,182746,2,3,0
52146,6,1,182749,182749,182750,0,1,3
52147,4,1,182753,182753,182754,0,1,3
52148,3,3,182756,182756,182759,0,3,2
52149,4,2,182760,182760,182762,0,2,1
52150,2,1,182762,182762,182763,0,1,0
52151,5,2,182767,182767,182769,0,2,4
52152,2,3,182769,182769,182772,0,3,0
52153,6,3,182775,182775,182778,0,3,3
52154,4,3,182779,182779,182782,0,3,1
52155,2,1,182781,182782,182783,1,2,0
52156,4,3,182785,182785,182788,0,3,2
52157,2,1,182787,182788,182789,1,2,0
52158,6,1,182793,182793,182794,0,1,4
52159,5,3,182798,182798,182801,0,3,4
52160,4,3,182802,182802,182805,0,3,1
52161,2,3,182804,182805,182808,1,4,0
52162,1,1,182805,182808,182809,3,4,0
52163,5,3,182810,182810,182813,0,3,1
52164,6,2,182816,182816,182818,0,2,3
52165,3,2,182819,182819,182821,0,2,1
52166,4,1,182823,182823,182824,0,1,2
52167,1,3,182824,182824,182827,0,3,0
52168,5,2,182829,182829,182831,0,2,2
52169,3,1,182832,182832,182833,0,1,1
52170,6,2,182838,182838,182840,0,2,5
52171,2,2,182840,182840,182842,0,2,0
52172,6,1,182846,182846,182847,0,1,4
52173,6,3,182852,182852,182855,0,3,5
52174,1,2,182853,182855,182857,2,4,0
52175,2,3,182855,182857,182860,2,5,0
52176,3,2,182858,182860,182862,2,4,0
52177,6,1,182864,182864,182865,0,1,2
52178,3,1,182867,182867,182868,0,1,2
52179,3,3,182870,182870,182873,0,3,2
52180,5,2,182875,182875,182877,0,2,2
52181,2,2,182877,182877,182879,0,2,0
52182,5,3,182882,182882,182885,0,3,3
52183,4,2,182886,182886,182888,0,2,1
52184,1,1,182887,182888,182889,1,2,0
52185,6,1,182893,182893,182894,0,1,4
52186,6,3,182899,182899,182902,0,3,5
52187,6,3,182905,182905,182908,0,3,3
52188,6,2,182911,182911,182913,0,2,3
52189,6,3,182917,182917,182920,0,3,4
52190,4,1,182921,182921,182922,0,1,1
52191,2,2,182923,182923,182925,0,2,1
52192,1,1,182924,182925,182926,1,2,0
52193,3,3,182927,182927,182930,0,3,1
52194,1,1,182928,182930,182931,2,3,0
52195,2,1,182930,182931,182932,1,2,0
52196,1,1,182931,182932,182933,1,2,0
52197,3,2,182934,182934,182936,0,2,1
52198,1,3,182935,182936,182939,1,4,0
52199,2,1,182937,182939,182940,2,3,0
52200,1,3,182938,182940,182943,2,5,0
52201,3,2,182941,182943,182945,2,4,0
52202,2,1,182943,182945,182946,2,3,0
52203,6,3,182949,182949,182952,0,3,3
52204,4,1,182953,182953,182954,0,1,1
52205,6,2,182959,182959,182961,0,2,5
52206,1,1,182960,182961,182962,1,2,0
52207,5,1,182965,182965,182966,0,1,3
52208,4,2,182969,182969,182971,0,2,3
52209,4,2,182973,182973,182975,0,2,2
52210,5,2,182978,182978,182980,0,2,3
52211,1,2,182979,182980,182982,1,3,0
52212,3,1,182982,182982,182983,0,1,0
52213,1,3,182983,182983,182986,0,3,0
52214,5,3,182988,182988,182991,0,3,2
52215,6,1,182994,182994,182995,0,1,3
52216,5,3,182999,182999,183002,0,3,4
52217,1,3,183000,183002,183005,2,5,0
52218,1,2,183001,183005,183007,4,6,0
52219,4,3,183005,183007,183010,2,5,0
52220,6,3,183011,183011,183014,0,3,1
52221,6,2,183017,183017,183019,0,2,3
52222,3,1,183020,183020,183021,0,1,1
52223,1,1,183021,183021,183022,0,1,0
52224,4,1,183025,183025,183026,0,1,3
52225,1,1,183026,183026,183027,0,1,0
52226,5,2,183031,183031,183033,0,2,4
52227,2,1,183033,183033,183034,0,1,0
52228,1,2,183034,183034,183036,0,2,0
52229,4,2,183038,183038,183040,0,2,2
52230,6,2,183044,183044,183046,0,2,4
52231,6,3,183050,183050,183053,0,3,4
52232,1,3,183051,183053,183056,2,5,0
52233,5,1,183056,183056,183057,0,1,0
52234,1,3,183057,183057,183060,0,3,0
52235,6,2,183063,183063,183065,0,2,3
52236,6,2,183069,183069,183071,0,2,4
52237,4,3,183073,183073,183076,0,3,2
52238,6,2,183079,183079,183081,0,2,3
52239,1,3,183080,183081,183084,1,4,0
52240,3,3,183083,183084,183087,1,4,0
52241,3,1,183086,183087,183088,1,2,0
52242,2,2,183088,183088,183090,0,2,0
52243,5,1,183093,183093,183094,0,1,3
52244,4,2,183097,183097,183099,0,2,3
52245,3,3,183100,183100,183103,0,3,1
52246,6,3,183106,183106,183109,0,3,3
52247,1,1,183107,183109,183110,2,3,0
52248,5,1,183112,183112,183113,0,1,2
52249,3,2,183115,183115,183117,0,2,2
52250,1,2,183116,183117,183119,1,3,0
52251,1,1,183117,183119,183120,2,3,0
52252,4,3,183121,183121,183124,0,3,1
52253,2,2,183123,183124,183126,1,3,0
52254,6,1,183129,183129,183130,0,1,3
52255,6,3,183135,183135,183138,0,3,5
52256,1,1,183136,183138,183139,2,3,0
52257,6,1,183142,183142,183143,0,1,3
52258,4,1,183146,183146,183147,0,1,3
52259,6,1,183152,183152,183153,0,1,5
52260,5,1,183157,183157,183158,0,1,4
52261,5,1,183162,183162,183163,0,1,4
52262,6,3,183168,183168,183171,0,3,5
52263,2,2,183170,183171,183173,1,3,0
52264,6,1,183176,183176,183177,0,1,3
52265,6,3,183182,183182,183185,0,3,5
52266,5,3,183187,183187,183190,0,3,2
52267,5,1,183192,183192,183193,0,1,2
52268,2,3,183194,183194,183197,0,3,1
52269,1,2,183195,183197,183199,2,4,0
52270,4,3,183199,183199,183202,0,3,0
52271,1,2,183200,183202,183204,2,4,0
52272,6,3,183206,183206,183209,0,3,2
52273,1,3,183207,183209,183212,2,5,0
52274,1,1,183208,183212,183213,4,5,0
52275,4,2,183212,183213,183215,1,3,0
52276,2,2,183214,183215,183217,1,3,0
52277,4,2,183218,183218,183220,0,2,1
52278,2,2,183220,183220,183222,0,2,0
52279,2,1,183222,183222,183223,0,1,0
52280,4,2,183226,183226,183228,0,2,3
52281,5,1,183231,183231,183232,0,1,3
52282,6,1,183237,183237,183238,0,1,5
52283,5,1,183242,183242,183243,0,1,4
52284,2,3,183244,183244,183247,0,3,1
52285,4,1,183248,183248,183249,0,1,1
52286,4,3,183252,183252,183255,0,3,3
52287,2,2,183254,183255,183257,1,3,0
52288,1,1,183255,183257,183258,2,3,0
52289,5,2,183260,183260,183262,0,2,2
52290,4,3,183264,183264,183267,0,3,2
52291,2,1,183266,183267,183268,1,2,0
52292,1,1,183267,183268,183269,1,2,0
52293,6,2,183273,183273,183275,0,2,4
52294,1,1,183274,183275,183276,1,2,0
52295,1,3,183275,183276,183279,1,4,0
52296,6,1,183281,183281,183282,0,1,2
52297,3,1,183284,183284,183285,0,1,2
52298,4,1,183288,183288,183289,0,1,3
52299,5,1,183293,183293,183294,0,1,4
52300,1,1,183294,183294,183295,0,1,0
52301,5,2,183299,183299,183301,0,2,4
52302,2,3,183301,183301,183304,0,3,0
52303,4,2,183305,183305,183307,0,2,1
52304,3,3,183308,183308,183311,0,3,1
52305,2,3,183310,183311,183314,1,4,0
52306,1,1,183311,183314,183315,3,4,0
52307,3,3,183314,183315,183318,1,4,0
52308,6,3,183320,183320,183323,0,3,2
52309,3,1,183323,183323,183324,0,1,0
52310,3,3,183326,183326,183329,0,3,2
52311,5,3,183331,183331,183334,0,3,2
52312,5,2,183336,183336,183338,0,2,2
52313,1,1,183337,183338,183339,1,2,0
52314,5,1,183342,183342,183343,0,1,3
52315,3,1,183345,183345,183346,0,1,2
52316,6,2,183351,183351,183353,0,2,5
52317,5,2,183356,183356,183358,0,2,3
52318,3,3,183359,183359,183362,0,3,1
52319,5,3,183364,183364,183367,0,3,2
52320,2,2,183366,183367,183369,1,3,0
52321,4,2,183370,183370,183372,0,2,1
52322,3,3,183373,183373,183376,0,3,1
52323,1,1,183374,183376,183377,2,3,0
52324,6,3,183380,183380,183383,0,3,3
52325,5,1,183385,183385,183386,0,1,2
52326,5,2,183390,183390,183392,0,2,4
52327,6,2,183396,183396,183398,0,2,4
52328,1,3,183397,183398,183401,1,4,0
52329,6,2,183403,183403,183405,0,2,2
52330,3,3,183406,183406,183409,0,3,1
52331,6,2,183412,183412,183414,0,2,3
52332,2,2,183414,183414,183416,0,2,0
52333,4,2,183418,183418,183420,0,2,2
52334,3,1,183421,183421,183422,0,1,1
52335,4,1,183425,183425,183426,0,1,3
52336,6,2,183431,183431,183433,0,2,5
52337,2,2,183433,183433,183435,0,2,0
52338,3,3,183436,183436,183439,0,3,1
52339,2,1,183438,183439,183440,1,2,0
52340,3,2,183441,183441,183443,0,2,1
52341,1,2,183442,183443,183445,1,3,0
52342,3,2,183445,183445,183447,0,2,0
52343,1,3,183446,183447,183450,1,4,0
52344,2,3,183448,183450,183453,2,5,0
52345,2,3,183450,183453,183456,3,6,0
52346,5,3,183455,183456,183459,1,4,0
52347,5,1,183460,183460,183461,0,1,1
52348,1,2,183461,183461,183463,0,2,0
52349,5,2,183466,183466,183468,0,2,3
52350,1,2,183467,183468,183470,1,3,0
52351,2,2,183469,183470,183472,1,3,0
52352,4,3,183473,183473,183476,0,3,1
52353,2,1,183475,183476,183477,1,2,0
52354,5,1,183480,183480,183481,0,1,3
52355,3,3,183483,183483,183486,0,3,2
52356,4,2,183487,183487,183489,0,2,1
52357,4,2,183491,183491,183493,0,2,2
52358,6,3,183497,183497,183500,0,3,4
52359,6,2,183503,183503,183505,0,2,3
52360,2,2,183505,183505,183507,0,2,0
52361,3,1,183508,183508,183509,0,1,1
52362,6,2,183514,183514,183516,0,2,5
52363,5,1,183519,183519,183520,0,1,3
52364,5,2,183524,183524,183526,0,2,4
52365,2,1,183526,183526,183527,0,1,0
52366,2,2,183528,183528,183530,0,2,1
52367,2,2,183530,183530,183532,0,2,0
52368,5,3,183535,183535,183538,0,3,3
52369,1,3,183536,183538,183541,2,5,0
52370,4,1,183540,183541,183542,1,2,0
52371,5,1,183545,183545,183546,0,1,3
52372,3,3,183548,183548,183551,0,3,2
52373,4,3,183552,183552,183555,0,3,1
52374,1,2,183553,183555,183557,2,4,0
52375,4,3,183557,183557,183560,0,3,0
52376,6,1,183563,183563,183564,0,1,3
52377,4,2,183567,183567,183569,0,2,3
52378,5,1,183572,183572,183573,0,1,3
52379,1,3,183573,183573,183576,0,3,0
52380,4,2,183577,183577,183579,0,2,1
52381,5,3,183582,183582,183585,0,3,3
52382,2,3,183584,183585,183588,1,4,0
52383,5,1,183589,183589,183590,0,1,1
52384,6,3,183595,183595,183598,0,3,5
52385,3,2,183598,183598,183600,0,2,0
52386,5,3,183603,183603,183606,0,3,3
52387,2,3,183605,183606,183609,1,4,0
52388,6,3,183611,183611,183614,0,3,2
52389,5,3,183616,183616,183619,0,3,2
52390,5,1,183621,183621,183622,0,1,2
52391,6,1,183627,183627,183628,0,1,5
52392,1,3,183628,183628,183631,0,3,0
52393,3,1,183631,183631,183632,0,1,0
52394,4,3,183635,183635,183638,0,3,3
52395,1,3,183636,183638,183641,2,5,0
52396,1,1,183637,183641,183642,4,5,0
52397,3,2,183640,183642,183644,2,4,0
52398,4,2,183644,183644,183646,0,2,0
52399,6,3,183650,183650,183653,0,3,4
52400,2,2,183652,183653,183655,1,3,0
52401,6,3,183658,183658,183661,0,3,3
52402,4,2,183662,183662,183664,0,2,1
52403,6,2,183668,183668,183670,0,2,4
52404,3,2,183671,183671,183673,0,2,1
52405,2,2,183673,183673,183675,0,2,0
52406,5,1,183678,183678,183679,0,1,3
52407,3,1,183681,183681,183682,0,1,2
52408,5,2,183686,183686,183688,0,2,4
52409,2,3,183688,183688,183691,0,3,0
52410,1,1,183689,183691,183692,2,3,0
52411,5,3,183694,183694,183697,0,3,2
52412,3,2,183697,183697,183699,0,2,0
52413,5,2,183702,183702,183704,0,2,3
52414,6,1,183708,183708,183709,0,1,4
52415,5,3,183713,183713,183716,0,3,4
52416,2,3,183715,183716,183719,1,4,0
52417,2,3,183717,183719,183722,2,5,0
52418,6,2,183723,183723,183725,0,2,1
52419,2,1,183725,183725,183726,0,1,0
52420,6,2,183731,183731,183733,0,2,5
52421,3,3,183734,183734,183737,0,3,1
52422,1,1,183735,183737,183738,2,3,0
52423,6,3,183741,183741,183744,0,3,3
52424,5,2,183746,183746,183748,0,2,2
52425,5,2,183751,183751,183753,0,2,3
52426,4,1,183755,183755,183756,0,1,2
52427,5,3,183760,183760,183763,0,3,4
52428,2,2,183762,183763,183765,1,3,0
52429,6,3,183768,183768,183771,0,3,3
52430,5,1,183773,183773,183774,0,1,2
52431,1,2,183774,183774,183776,0,2,0
52432,4,3,183778,183778,183781,0,3,2
52433,2,2,183780,183781,183783,1,3,0
52434,6,1,183786,183786,183787,0,1,3
52435,5,1,183791,183791,183792,0,1,4
52436,3,1,183794,183794,183795,0,1,2
52437,5,1,183799,183799,183800,0,1,4
52438,1,3,183800,183800,183803,0,3,0
52439,6,2,183806,183806,183808,0,2,3
52440,5,2,183811,183811,183813,0,2,3
52441,6,1,183817,183817,183818,0,1,4
52442,4,2,183821,183821,183823,0,2,3
52443,6,3,183827,183827,183830,0,3,4
52444,6,2,183833,183833,183835,0,2,3
52445,2,1,183835,183835,183836,0,1,0
52446,4,2,183839,183839,183841,0,2,3
52447,3,1,183842,183842,183843,0,1,1
52448,2,3,183844,183844,183847,0,3,1
52449,6,3,183850,183850,183853,0,3,3
52450,2,1,183852,183853,183854,1,2,0
52451,3,1,183855,183855,183856,0,1,1
52452,1,2,183856,183856,183858,0,2,0
52453,2,3,183858,183858,183861,0,3,0
52454,1,3,183859,183861,183864,2,5,0
52455,6,1,183865,183865,183866,0,1,1
52456,6,3,183871,183871,183874,0,3,5
52457,4,1,183875,183875,183876,0,1,1
52458,2,1,183877,183877,183878,0,1,1
52459,1,1,183878,183878,183879,0,1,0
52460,1,1,183879,183879,183880,0,1,0
52461,1,2,183880,183880,183882,0,2,0
52462,3,2,183883,183883,183885,0,2,1
52463,6,3,183889,183889,183892,0,3,4
52464,3,2,183892,183892,183894,0,2,0
52465,1,2,183893,183894,183896,1,3,0
52466,2,2,183895,183896,183898,1,3,0
52467,2,1,183897,183898,183899,1,2,0
52468,1,1,183898,183899,183900,1,2,0
52469,3,3,183901,183901,183904,0,3,1
52470,4,2,183905,183905,183907,0,2,1
52471,4,3,183909,183909,183912,0,3,2
52472,1,3,183910,183912,183915,2,5,0
52473,2,2,183912,183915,183917,3,5,0
52474,5,2,183917,183917,183919,0,2,0
52475,2,1,183919,183919,183920,0,1,0
52476,3,1,183922,183922,183923,0,1,2
52477,4,2,183926,183926,183928,0,2,3
52478,4,3,183930,183930,183933,0,3,2
52479,4,1,183934,183934,183935,0,1,1
52480,5,2,183939,183939,183941,0,2,4
52481,4,2,183943,183943,183945,0,2,2
52482,6,1,183949,183949,183950,0,1,4
52483,6,2,183955,183955,183957,0,2,5
52484,1,1,183956,183957,183958,1,2,0
52485,4,1,183960,183960,183961,0,1,2
52486,5,2,183965,183965,183967,0,2,4
52487,4,3,183969,183969,183972,0,3,2
52488,3,2,183972,183972,183974,0,2,0
52489,2,1,183974,183974,183975,0,1,0
52490,6,2,183980,183980,183982,0,2,5
52491,1,3,183981,183982,183985,1,4,0
52492,4,3,183985,183985,183988,0,3,0
52493,1,1,183986,183988,183989,2,3,0
52494,4,2,183990,183990,183992,0,2,1
52495,1,1,183991,183992,183993,1,2,0
52496,2,2,183993,183993,183995,0,2,0
52497,4,1,183997,183997,183998,0,1,2
52498,5,2,184002,184002,184004,0,2,4
52499,6,2,184008,184008,184010,0,2,4
52500,5,1,184013,184013,184014,0,1,3
52501,3,3,184016,184016,184019,0,3,2
52502,1,3,184017,184019,184022,2,5,0
52503,6,3,184023,184023,184026,0,3,1
52504,5,1,184028,184028,184029,0,1,2
52505,1,1,184029,184029,184030,0,1,0
52506,6,2,184035,184035,184037,0,2,5
52507,2,2,184037,184037,184039,0,2,0
52508,3,1,184040,184040,184041,0,1,1
52509,1,1,184041,184041,184042,0,1,0
52510,5,1,184046,184046,184047,0,1,4
52511,5,2,184051,184051,184053,0,2,4
52512,6,3,184057,184057,184060,0,3,4
52513,3,2,184060,184060,184062,0,2,0
52514,4,1,184064,184064,184065,0,1,2
52515,5,1,184069,184069,184070,0,1,4
52516,6,1,184075,184075,184076,0,1,5
52517,3,3,184078,184078,184081,0,3,2
52518,4,1,184082,184082,184083,0,1,1
52519,3,3,184085,184085,184088,0,3,2
52520,2,2,184087,184088,184090,1,3,0
52521,3,1,184090,184090,184091,0,1,0
52522,5,3,184095,184095,184098,0,3,4
52523,5,2,184100,184100,184102,0,2,2
52524,4,1,184104,184104,184105,0,1,2
52525,1,3,184105,184105,184108,0,3,0
52526,4,3,184109,184109,184112,0,3,1
52527,2,3,184111,184112,184115,1,4,0
52528,6,3,184117,184117,184120,0,3,2
52529,3,2,184120,184120,184122,0,2,0
52530,4,3,184124,184124,184127,0,3,2
52531,4,3,184128,184128,184131,0,3,1
52532,5,1,184133,184133,184134,0,1,2
52533,5,1,184138,184138,184139,0,1,4
52534,2,3,184140,184140,184143,0,3,1
52535,5,1,184145,184145,184146,0,1,2
52536,3,2,184148,184148,184150,0,2,2
52537,2,2,184150,184150,184152,0,2,0
52538,5,2,184155,184155,184157,0,2,3
52539,2,1,184157,184157,184158,0,1,0
52540,2,2,184159,184159,184161,0,2,1
52541,4,1,184163,184163,184164,0,1,2
52542,4,2,184167,184167,184169,0,2,3
52543,4,1,184171,184171,184172,0,1,2
52544,4,2,184175,184175,184177,0,2,3
52545,1,3,184176,184177,184180,1,4,0
52546,6,1,184182,184182,184183,0,1,2
52547,1,3,184183,184183,184186,0,3,0
52548,6,1,184189,184189,184190,0,1,3
52549,2,1,184191,184191,184192,0,1,1
52550,6,3,184197,184197,184200,0,3,5
52551,6,1,184203,184203,184204,0,1,3
52552,1,3,184204,184204,184207,0,3,0
52553,4,3,184208,184208,184211,0,3,1
52554,2,3,184210,184211,184214,1,4,0
52555,3,3,184213,184214,184217,1,4,0
52556,2,2,184215,184217,184219,2,4,0
52557,2,1,184217,184219,184220,2,3,0
52558,3,2,184220,184220,184222,0,2,0
52559,5,2,184225,184225,184227,0,2,3
52560,2,1,184227,184227,184228,0,1,0
52561,2,1,184229,184229,184230,0,1,1
52562,3,2,184232,184232,184234,0,2,2
52563,6,3,184238,184238,184241,0,3,4
52564,1,3,184239,184241,184244,2,5,0
52565,3,2,184242,184244,184246,2,4,0
52566,1,1,184243,184246,184247,3,4,0
52567,3,2,184246,184247,184249,1,3,0
52568,1,1,184247,184249,184250,2,3,0
52569,2,3,184249,184250,184253,1,4,0
52570,6,2,184255,184255,184257,0,2,2
52571,1,3,184256,184257,184260,1,4,0
52572,1,2,184257,184260,184262,3,5,0
52573,3,3,184260,184262,184265,2,5,0
52574,1,2,184261,184265,184267,4,6,0
52575,2,3,184263,184267,184270,4,7,0
52576,5,3,184268,184270,184273,2,5,0
52577,4,1,184272,184273,184274,1,2,0
52578,4,2,184276,184276,184278,0,2,2
52579,3,3,184279,184279,184282,0,3,1
52580,2,1,184281,184282,184283,1,2,0
52581,5,3,184286,184286,184289,0,3,3
52582,6,2,184292,184292,184294,0,2,3
52583,5,1,184297,184297,184298,0,1,3
52584,4,3,184301,184301,184304,0,3,3
52585,4,2,184305,184305,184307,0,2,1
52586,4,3,184309,184309,184312,0,3,2
52587,5,1,184314,184314,184315,0,1,2
52588,3,3,184317,184317,184320,0,3,2
52589,2,2,184319,184320,184322,1,3,0
52590,3,1,184322,184322,184323,0,1,0
52591,1,3,184323,184323,184326,0,3,0
52592,2,3,184325,184326,184329,1,4,0
52593,3,2,184328,184329,184331,1,3,0
52594,6,1,184334,184334,184335,0,1,3
52595,3,2,184337,184337,184339,0,2,2
52596,2,3,184339,184339,184342,0,3,0
52597,5,3,184344,184344,184347,0,3,2
52598,4,2,184348,184348,184350,0,2,1
52599,5,2,184353,184353,184355,0,2,3
52600,6,3,184359,184359,184362,0,3,4
52601,5,3,184364,184364,184367,0,3,2
52602,6,1,184370,184370,184371,0,1,3
52603,1,2,184371,184371,184373,0,2,0
52604,3,3,184374,184374,184377,0,3,1
52605,4,1,184378,184378,184379,0,1,1
52606,6,3,184384,184384,184387,0,3,5
52607,6,3,184390,184390,184393,0,3,3
52608,6,1,184396,184396,184397,0,1,3
52609,3,2,184399,184399,184401,0,2,2
52610,1,2,184400,184401,184403,1,3,0
52611,4,3,184404,184404,184407,0,3,1
52612,4,2,184408,184408,184410,0,2,1
52613,6,2,184414,184414,184416,0,2,4
52614,6,1,184420,184420,184421,0,1,4
52615,1,3,184421,184421,184424,0,3,0
52616,4,3,184425,184425,184428,0,3,1
52617,3,2,184428,184428,184430,0,2,0
52618,2,1,184430,184430,184431,0,1,0
52619,3,1,184433,184433,184434,0,1,2
52620,4,1,184437,184437,184438,0,1,3
52621,5,1,184442,184442,184443,0,1,4
52622,6,3,184448,184448,184451,0,3,5
52623,5,1,184453,184453,184454,0,1,2
52624,6,2,184459,184459,184461,0,2,5
52625,5,3,184464,184464,184467,0,3,3
52626,3,2,184467,184467,184469,0,2,0
52627,6,3,184473,184473,184476,0,3,4
52628,6,2,184479,184479,184481,0,2,3
52629,2,1,184481,184481,184482,0,1,0
52630,2,3,184483,184483,184486,0,3,1
52631,4,3,184487,184487,184490,0,3,1
52632,5,2,184492,184492,184494,0,2,2
52633,2,2,184494,184494,184496,0,2,0
52634,5,1,184499,184499,184500,0,1,3
52635,4,1,184503,184503,184504,0,1,3
52636,6,3,184509,184509,184512,0,3,5
52637,2,3,184511,184512,184515,1,4,0
52638,1,1,184512,184515,184516,3,4,0
52639,6,2,184518,184518,184520,0,2,2
52640,5,3,184523,184523,184526,0,3,3
52641,6,2,184529,184529,184531,0,2,3
52642,2,3,184531,184531,184534,0,3,0
52643,6,1,184537,184537,184538,0,1,3
52644,4,1,184541,184541,184542,0,1,3
52645,4,1,184545,184545,184546,0,1,3
52646,3,1,184548,184548,184549,0,1,2
52647,5,2,184553,184553,184555,0,2,4
52648,5,3,184558,184558,184561,0,3,3
52649,3,2,184561,184561,184563,0,2,0
52650,4,1,184565,184565,184566,0,1,2
52651,2,3,184567,184567,184570,0,3,1
52652,1,1,184568,184570,184571,2,3,0
52653,3,3,184571,184571,184574,0,3,0
52654,3,2,184574,184574,184576,0,2,0
52655,4,2,184578,184578,184580,0,2,2
52656,3,1,184581,184581,184582,0,1,1
52657,6,2,184587,184587,184589,0,2,5
52658,5,1,184592,184592,184593,0,1,3
52659,2,1,184594,184594,184595,0,1,1
52660,4,3,184598,184598,184601,0,3,3
52661,5,3,184603,184603,184606,0,3,2
52662,6,2,184609,184609,184611,0,2,3
52663,2,3,184611,184611,184614,0,3,0
52664,2,3,184613,184614,184617,1,4,0
52665,6,3,184619,184619,184622,0,3,2
52666,6,2,184625,184625,184627,0,2,3
52667,3,2,184628,184628,184630,0,2,1
52668,6,2,184634,184634,184636,0,2,4
52669,6,3,184640,184640,184643,0,3,4
52670,6,3,184646,184646,184649,0,3,3
52671,4,1,184650,184650,184651,0,1,1
52672,3,3,184653,184653,184656,0,3,2
52673,6,1,184659,184659,184660,0,1,3
52674,6,2,184665,184665,184667,0,2,5
52675,5,2,184670,184670,184672,0,2,3
52676,6,1,184676,184676,184677,0,1,4
52677,3,1,184679,184679,184680,0,1,2
52678,6,2,184685,184685,184687,0,2,5
52679,3,3,184688,184688,184691,0,3,1
52680,1,1,184689,184691,184692,2,3,0
52681,1,3,184690,184692,184695,2,5,0
52682,2,2,184692,184695,184697,3,5,0
52683,5,1,184697,184697,184698,0,1,0
52684,4,1,184701,184701,184702,0,1,3
52685,5,3,184706,184706,184709,0,3,4
52686,6,1,184712,184712,184713,0,1,3
52687,2,3,184714,184714,184717,0,3,1
52688,5,1,184719,184719,184720,0,1,2
52689,6,1,184725,184725,184726,0,1,5
52690,5,2,184730,184730,184732,0,2,4
52691,1,2,184731,184732,184734,1,3,0
52692,4,2,184735,184735,184737,0,2,1
52693,4,3,184739,184739,184742,0,3,2
52694,1,3,184740,184742,184745,2,5,0
52695,6,1,184746,184746,184747,0,1,1
52696,6,3,184752,184752,184755,0,3,5
52697,6,3,184758,184758,184761,0,3,3
52698,5,2,184763,184763,184765,0,2,2
52699,4,1,184767,184767,184768,0,1,2
52700,2,3,184769,184769,184772,0,3,1
52701,5,1,184774,184774,184775,0,1,2
52702,1,1,184775,184775,184776,0,1,0
52703,6,1,184781,184781,184782,0,1,5
52704,4,1,184785,184785,184786,0,1,3
52705,3,1,184788,184788,184789,0,1,2
52706,6,2,184794,184794,184796,0,2,5
52707,5,1,184799,184799,184800,0,1,3
52708,5,1,184804,184804,184805,0,1,4
52709,4,2,184808,184808,184810,0,2,3
52710,2,3,184810,184810,184813,0,3,0
52711,2,1,184812,184813,184814,1,2,0
52712,2,2,184814,184814,184816,0,2,0
52713,3,1,184817,184817,184818,0,1,1
52714,5,1,184822,184822,184823,0,1,4
52715,2,2,184824,184824,184826,0,2,1
52716,2,2,184826,184826,184828,0,2,0
52717,3,3,184829,184829,184832,0,3,1
52718,3,1,184832,184832,184833,0,1,0
52719,2,1,184834,184834,184835,0,1,1
52720,2,1,184836,184836,184837,0,1,1
52721,2,2,184838,184838,184840,0,2,1
52722,5,2,184843,184843,184845,0,2,3
52723,6,3,184849,184849,184852,0,3,4
52724,2,2,184851,184852,184854,1,3,0
52725,4,2,184855,184855,184857,0,2,1
52726,2,2,184857,184857,184859,0,2,0
52727,4,1,184861,184861,184862,0,1,2
52728,3,3,184864,184864,184867,0,3,2
52729,3,1,184867,184867,184868,0,1,0
52730,3,3,184870,184870,184873,0,3,2
52731,3,2,184873,184873,184875,0,2,0
52732,6,2,184879,184879,184881,0,2,4
52733,4,2,184883,184883,184885,0,2,2
52734,4,2,184887,184887,184889,0,2,2
52735,5,1,184892,184892,184893,0,1,3
52736,3,2,184895,184895,184897,0,2,2
52737,5,1,184900,184900,184901,0,1,3
52738,1,3,184901,184901,184904,0,3,0
52739,5,3,184906,184906,184909,0,3,2
52740,6,3,184912,184912,184915,0,3,3
52741,6,2,184918,184918,184920,0,2,3
52742,5,2,184923,184923,184925,0,2,3
52743,1,2,184924,184925,184927,1,3,0
52744,4,1,184928,184928,184929,0,1,1
52745,6,3,184934,184934,184937,0,3,5
52746,5,1,184939,184939,184940,0,1,2
52747,2,3,184941,184941,184944,0,3,1
52748,3,3,184944,184944,184947,0,3,0
52749,2,1,184946,184947,184948,1,2,0
52750,1,2,184947,184948,184950,1,3,0
52751,2,2,184949,184950,184952,1,3,0
52752,6,1,184955,184955,184956,0,1,3
52753,2,1,184957,184957,184958,0,1,1
52754,3,1,184960,184960,184961,0,1,2
52755,4,3,184964,184964,184967,0,3,3
52756,1,1,184965,184967,184968,2,3,0
52757,2,1,184967,184968,184969,1,2,0
52758,2,2,184969,184969,184971,0,2,0
52759,3,3,184972,184972,184975,0,3,1
52760,3,3,184975,184975,184978,0,3,0
52761,5,2,184980,184980,184982,0,2,2
52762,2,3,184982,184982,184985,0,3,0
52763,2,2,184984,184985,184987,1,3,0
52764,6,2,184990,184990,184992,0,2,3
52765,2,2,184992,184992,184994,0,2,0
52766,1,3,184993,184994,184997,1,4,0
52767,1,2,184994,184997,184999,3,5,0
52768,1,3,184995,184999,185002,4,7,0
52769,5,2,185000,185002,185004,2,4,0
52770,6,2,185006,185006,185008,0,2,2
52771,2,3,185008,185008,185011,0,3,0
52772,3,3,185011,185011,185014,0,3,0
52773,1,2,185012,185014,185016,2,4,0
52774,2,3,185014,185016,185019,2,5,0
52775,3,1,185017,185019,185020,2,3,0
52776,2,2,185019,185020,185022,1,3,0
52777,5,2,185024,185024,185026,0,2,2
52778,5,1,185029,185029,185030,0,1,3
52779,6,3,185035,185035,185038,0,3,5
52780,1,3,185036,185038,185041,2,5,0
52781,3,2,185039,185041,185043,2,4,0
52782,1,2,185040,185043,185045,3,5,0
52783,6,3,185046,185046,185049,0,3,1
52784,2,2,185048,185049,185051,1,3,0
52785,5,1,185053,185053,185054,0,1,2
52786,2,3,185055,185055,185058,0,3,1
52787,1,3,185056,185058,185061,2,5,0
52788,2,3,185058,185061,185064,3,6,0
52789,3,2,185061,185064,185066,3,5,0
52790,2,3,185063,185066,185069,3,6,0
52791,6,3,185069,185069,185072,0,3,0
52792,4,3,185073,185073,185076,0,3,1
52793,6,2,185079,185079,185081,0,2,3
52794,1,1,185080,185081,185082,1,2,0
52795,5,3,185085,185085,185088,0,3,3
52796,3,1,185088,185088,185089,0,1,0
52797,4,3,185092,185092,185095,0,3,3
52798,2,1,185094,185095,185096,1,2,0
52799,5,3,185099,185099,185102,0,3,3
52800,1,2,185100,185102,185104,2,4,0
52801,6,2,185106,185106,185108,0,2,2
52802,1,3,185107,185108,185111,1,4,0
52803,1,1,185108,185111,185112,3,4,0
52804,1,1,185109,185112,185113,3,4,0
52805,3,3,185112,185113,185116,1,4,0
52806,4,2,185116,185116,185118,0,2,0
52807,6,1,185122,185122,185123,0,1,4
52808,5,1,185127,185127,185128,0,1,4
52809,3,2,185130,185130,185132,0,2,2
52810,2,2,185132,185132,185134,0,2,0
52811,3,1,185135,185135,185136,0,1,1
52812,6,3,185141,185141,185144,0,3,5
52813,3,3,185144,185144,185147,0,3,0
52814,2,3,185146,185147,185150,1,4,0
52815,4,1,185150,185150,185151,0,1,0
52816,6,3,185156,185156,185159,0,3,5
52817,4,3,185160,185160,185163,0,3,1
52818,3,2,185163,185163,185165,0,2,0
52819,5,2,185168,185168,185170,0,2,3
52820,4,2,185172,185172,185174,0,2,2
52821,3,3,185175,185175,185178,0,3,1
52822,5,1,185180,185180,185181,0,1,2
52823,1,3,185181,185181,185184,0,3,0
52824,5,2,185186,185186,185188,0,2,2
52825,1,1,185187,185188,185189,1,2,0
52826,6,1,185193,185193,185194,0,1,4
52827,3,1,185196,185196,185197,0,1,2
52828,2,2,185198,185198,185200,0,2,1
52829,4,2,185202,185202,185204,0,2,2
52830,6,3,185208,185208,185211,0,3,4
52831,4,1,185212,185212,185213,0,1,1
52832,6,1,185218,185218,185219,0,1,5
52833,4,3,185222,185222,185225,0,3,3
52834,1,3,185223,185225,185228,2,5,0
52835,6,3,185229,185229,185232,0,3,1
52836,4,2,185233,185233,185235,0,2,1
52837,6,1,185239,185239,185240,0,1,4
52838,2,2,185241,185241,185243,0,2,1
52839,4,3,185245,185245,185248,0,3,2
52840,4,2,185249,185249,185251,0,2,1
52841,1,2,185250,185251,185253,1,3,0
52842,5,3,185255,185255,185258,0,3,2
52843,2,3,185257,185258,185261,1,4,0
52844,6,3,185263,185263,185266,0,3,2
52845,3,3,185266,185266,185269,0,3,0
52846,3,1,185269,185269,185270,0,1,0
52847,6,3,185275,185275,185278,0,3,5
52848,2,2,185277,185278,185280,1,3,0
52849,2,1,185279,185280,185281,1,2,0
52850,5,3,185284,185284,185287,0,3,3
52851,2,1,185286,185287,185288,1,2,0
52852,5,1,185291,185291,185292,0,1,3
52853,6,2,185297,185297,185299,0,2,5
52854,1,1,185298,185299,185300,1,2,0
52855,2,3,185300,185300,185303,0,3,0
52856,2,2,185302,185303,185305,1,3,0
52857,6,2,185308,185308,185310,0,2,3
52858,1,2,185309,185310,185312,1,3,0
52859,5,1,185314,185314,185315,0,1,2
52860,4,3,185318,185318,185321,0,3,3
52861,4,1,185322,185322,185323,0,1,1
52862,5,1,185327,185327,185328,0,1,4
52863,3,3,185330,185330,185333,0,3,2
52864,5,1,185335,185335,185336,0,1,2
52865,2,3,185337,185337,185340,0,3,1
52866,3,1,185340,185340,185341,0,1,0
52867,1,1,185341,185341,185342,0,1,0
52868,2,3,185343,185343,185346,0,3,1
52869,3,1,185346,185346,185347,0,1,0
52870,3,3,185349,185349,185352,0,3,2
52871,5,1,185354,185354,185355,0,1,2
52872,5,2,185359,185359,185361,0,2,4
52873,4,1,185363,185363,185364,0,1,2
52874,6,2,185369,185369,185371,0,2,5
52875,5,1,185374,185374,185375,0,1,3
52876,6,1,185380,185380,185381,0,1,5
52877,2,3,185382,185382,185385,0,3,1
52878,5,3,185387,185387,185390,0,3,2
52879,5,2,185392,185392,185394,0,2,2
52880,1,3,185393,185394,185397,1,4,0
52881,5,2,185398,185398,185400,0,2,1
52882,1,3,185399,185400,185403,1,4,0
52883,4,3,185403,185403,185406,0,3,0
52884,6,3,185409,185409,185412,0,3,3
52885,4,3,185413,185413,185416,0,3,1
52886,2,1,185415,185416,185417,1,2,0
52887,2,2,185417,185417,185419,0,2,0
52888,6,2,185423,185423,185425,0,2,4
52889,2,1,185425,185425,185426,0,1,0
52890,4,3,185429,185429,185432,0,3,3
52891,1,3,185430,185432,185435,2,5,0
52892,4,2,185434,185435,185437,1,3,0
52893,6,3,185440,185440,185443,0,3,3
52894,5,3,185445,185445,185448,0,3,2
52895,3,2,185448,185448,185450,0,2,0
52896,5,2,185453,185453,185455,0,2,3
52897,5,3,185458,185458,185461,0,3,3
52898,2,1,185460,185461,185462,1,2,0
52899,1,1,185461,185462,185463,1,2,0
52900,6,3,185467,185467,185470,0,3,4
52901,3,3,185470,185470,185473,0,3,0
52902,2,1,185472,185473,185474,1,2,0
52903,1,2,185473,185474,185476,1,3,0
52904,4,3,185477,185477,185480,0,3,1
52905,6,2,185483,185483,185485,0,2,3
52906,3,1,185486,185486,185487,0,1,1
52907,5,2,185491,185491,185493,0,2,4
52908,1,2,185492,185493,185495,1,3,0
52909,1,1,185493,185495,185496,2,3,0
52910,2,2,185495,185496,185498,1,3,0
52911,5,1,185500,185500,185501,0,1,2
52912,2,1,185502,185502,185503,0,1,1
52913,4,1,185506,185506,185507,0,1,3
52914,5,3,185511,185511,185514,0,3,4
52915,3,3,185514,185514,185517,0,3,0
52916,4,1,185518,185518,185519,0,1,1
52917,2,3,185520,185520,185523,0,3,1
52918,3,1,185523,185523,185524,0,1,0
52919,2,2,185525,185525,185527,0,2,1
52920,5,1,185530,185530,185531,0,1,3
52921,4,1,185534,185534,185535,0,1,3
52922,4,3,185538,185538,185541,0,3,3
52923,1,1,185539,185541,185542,2,3,0
52924,2,3,185541,185542,185545,1,4,0
52925,1,1,185542,185545,185546,3,4,0
52926,2,3,185544,185546,185549,2,5,0
52927,5,2,185549,185549,185551,0,2,0
52928,2,3,185551,185551,185554,0,3,0
52929,3,2,185554,185554,185556,0,2,0
52930,1,1,185555,185556,185557,1,2,0
52931,4,2,185559,185559,185561,0,2,2
52932,4,3,185563,185563,185566,0,3,2
52933,1,2,185564,185566,185568,2,4,0
52934,5,2,185569,185569,185571,0,2,1
52935,5,3,185574,185574,185577,0,3,3
52936,1,2,185575,185577,185579,2,4,0
52937,3,1,185578,185579,185580,1,2,0
52938,1,2,185579,185580,185582,1,3,0
52939,5,3,185584,185584,185587,0,3,2
52940,5,2,185589,185589,185591,0,2,2
52941,4,1,185593,185593,185594,0,1,2
52942,4,1,185597,185597,185598,0,1,3
52943,3,3,185600,185600,185603,0,3,2
52944,1,1,185601,185603,185604,2,3,0
52945,6,1,185607,185607,185608,0,1,3
52946,1,2,185608,185608,185610,0,2,0
52947,5,2,185613,185613,185615,0,2,3
52948,5,2,185618,185618,185620,0,2,3
52949,5,2,185623,185623,185625,0,2,3
52950,6,3,185629,185629,185632,0,3,4
52951,3,2,185632,185632,185634,0,2,0
52952,6,1,185638,185638,185639,0,1,4
52953,5,1,185643,185643,185644,0,1,4
52954,1,2,185644,185644,185646,0,2,0
52955,6,3,185650,185650,185653,0,3,4
52956,4,1,185654,185654,185655,0,1,1
52957,3,3,185657,185657,185660,0,3,2
52958,1,1,185658,185660,185661,2,3,0
52959,2,3,185660,185661,185664,1,4,0
52960,3,1,185663,185664,185665,1,2,0
52961,1,1,185664,185665,185666,1,2,0
52962,5,3,185669,185669,185672,0,3,3
52963,1,2,185670,185672,185674,2,4,0
52964,6,1,185676,185676,185677,0,1,2
52965,3,2,185679,185679,185681,0,2,2
52966,6,2,185685,185685,185687,0,2,4
52967,6,2,185691,185691,185693,0,2,4
52968,6,3,185697,185697,185700,0,3,4
52969,2,1,185699,185700,185701,1,2,0
52970,3,1,185702,185702,185703,0,1,1
52971,1,1,185703,185703,185704,0,1,0
52972,2,1,185705,185705,185706,0,1,1
52973,6,2,185711,185711,185713,0,2,5
52974,5,2,185716,185716,185718,0,2,3
52975,6,1,185722,185722,185723,0,1,4
52976,5,3,185727,185727,185730,0,3,4
52977,3,1,185730,185730,185731,0,1,0
52978,5,3,185735,185735,185738,0,3,4
52979,1,1,185736,185738,185739,2,3,0
52980,4,3,185740,185740,185743,0,3,1
52981,6,1,185746,185746,185747,0,1,3
52982,4,2,185750,185750,185752,0,2,3
52983,2,3,185752,185752,185755,0,3,0
52984,4,3,185756,185756,185759,0,3,1
52985,4,3,185760,185760,185763,0,3,1
52986,1,1,185761,185763,185764,2,3,0
52987,2,2,185763,185764,185766,1,3,0
52988,6,1,185769,185769,185770,0,1,3
52989,2,1,185771,185771,185772,0,1,1
52990,3,2,185774,185774,185776,0,2,2
52991,1,2,185775,185776,185778,1,3,0
52992,5,3,185780,185780,185783,0,3,2
52993,6,1,185786,185786,185787,0,1,3
52994,1,1,185787,185787,185788,0,1,0
52995,2,3,185789,185789,185792,0,3,1
52996,5,1,185794,185794,185795,0,1,2
52997,1,1,185795,185795,185796,0,1,0
52998,3,1,185798,185798,185799,0,1,2
52999,3,3,185801,185801,185804,0,3,2
53000,1,3,185802,185804,185807,2,5,0
53001,4,3,185806,185807,185810,1,4,0
53002,3,2,185809,185810,185812,1,3,0
53003,6,1,185815,185815,185816,0,1,3
53004,4,3,185819,185819,185822,0,3,3
53005,4,1,185823,185823,185824,0,1,1
53006,4,1,185827,185827,185828,0,1,3
53007,1,3,185828,185828,185831,0,3,0
53008,5,1,185833,185833,185834,0,1,2
53009,5,2,185838,185838,185840,0,2,4
53010,5,3,185843,185843,185846,0,3,3
53011,4,3,185847,185847,185850,0,3,1
53012,3,1,185850,185850,185851,0,1,0
53013,1,2,185851,185851,185853,0,2,0
53014,1,1,185852,185853,185854,1,2,0
53015,3,2,185855,185855,185857,0,2,1
53016,5,1,185860,185860,185861,0,1,3
53017,2,3,185862,185862,185865,0,3,1
53018,5,1,185867,185867,185868,0,1,2
53019,2,3,185869,185869,185872,0,3,1
53020,6,2,185875,185875,185877,0,2,3
53021,2,3,185877,185877,185880,0,3,0
53022,4,3,185881,185881,185884,0,3,1
53023,4,3,185885,185885,185888,0,3,1
53024,2,1,185887,185888,185889,1,2,0
53025,3,1,185890,185890,185891,0,1,1
53026,2,3,185892,185892,185895,0,3,1
53027,5,3,185897,185897,185900,0,3,2
53028,3,1,185900,185900,185901,0,1,0
53029,5,2,185905,185905,185907,0,2,4
53030,4,2,185909,185909,185911,0,2,2
53031,1,3,185910,185911,185914,1,4,0
53032,3,2,185913,185914,185916,1,3,0
53033,6,2,185919,185919,185921,0,2,3
53034,1,3,185920,185921,185924,1,4,0
53035,1,2,185921,185924,185926,3,5,0
53036,2,3,185923,185926,185929,3,6,0
53037,5,1,185928,185929,185930,1,2,0
53038,5,1,185933,185933,185934,0,1,3
53039,4,2,185937,185937,185939,0,2,3
53040,4,2,185941,185941,185943,0,2,2
53041,6,2,185947,185947,185949,0,2,4
53042,3,3,185950,185950,185953,0,3,1
53043,4,1,185954,185954,185955,0,1,1
53044,4,1,185958,185958,185959,0,1,3
53045,4,3,185962,185962,185965,0,3,3
53046,2,3,185964,185965,185968,1,4,0
53047,6,2,185970,185970,185972,0,2,2
53048,5,2,185975,185975,185977,0,2,3
53049,4,3,185979,185979,185982,0,3,2
53050,3,2,185982,185982,185984,0,2,0
53051,2,3,185984,185984,185987,0,3,0
53052,4,1,185988,185988,185989,0,1,1
53053,6,1,185994,185994,185995,0,1,5
53054,6,3,186000,186000,186003,0,3,5
53055,2,3,186002,186003,186006,1,4,0
53056,1,2,186003,186006,186008,3,5,0
53057,2,3,186005,186008,186011,3,6,0
53058,4,1,186009,186011,186012,2,3,0
53059,1,2,186010,186012,186014,2,4,0
53060,6,2,186016,186016,186018,0,2,2
53061,5,3,186021,186021,186024,0,3,3
53062,5,3,186026,186026,186029,0,3,2
53063,3,2,186029,186029,186031,0,2,0
53064,2,2,186031,186031,186033,0,2,0
53065,4,3,186035,186035,186038,0,3,2
53066,4,1,186039,186039,186040,0,1,1
53067,6,3,186045,186045,186048,0,3,5
53068,3,3,186048,186048,186051,0,3,0
53069,5,2,186053,186053,186055,0,2,2
53070,4,1,186057,186057,186058,0,1,2
53071,1,1,186058,186058,186059,0,1,0
53072,5,1,186063,186063,186064,0,1,4
53073,6,2,186069,186069,186071,0,2,5
53074,6,3,186075,186075,186078,0,3,4
53075,5,1,186080,186080,186081,0,1,2
53076,6,1,186086,186086,186087,0,1,5
53077,6,2,186092,186092,186094,0,2,5
53078,4,2,186096,186096,186098,0,2,2
53079,3,1,186099,186099,186100,0,1,1
53080,4,2,186103,186103,186105,0,2,3
53081,6,1,186109,186109,186110,0,1,4
53082,5,1,186114,186114,186115,0,1,4
53083,3,1,186117,186117,186118,0,1,2
53084,6,3,186123,186123,186126,0,3,5
53085,6,3,186129,186129,186132,0,3,3
53086,5,3,186134,186134,186137,0,3,2
53087,5,3,186139,186139,186142,0,3,2
53088,3,1,186142,186142,186143,0,1,0
53089,6,3,186148,186148,186151,0,3,5
53090,4,2,186152,186152,186154,0,2,1
53091,1,2,186153,186154,186156,1,3,0
53092,6,1,186159,186159,186160,0,1,3
53093,2,2,186161,186161,186163,0,2,1
53094,2,2,186163,186163,186165,0,2,0
53095,1,2,186164,186165,186167,1,3,0
53096,6,1,186170,186170,186171,0,1,3
53097,5,2,186175,186175,186177,0,2,4
53098,2,2,186177,186177,186179,0,2,0
53099,2,2,186179,186179,186181,0,2,0
53100,1,2,186180,186181,186183,1,3,0
53101,2,3,186182,186183,186186,1,4,0
53102,5,2,186187,186187,186189,0,2,1
53103,4,2,186191,186191,186193,0,2,2
53104,4,1,186195,186195,186196,0,1,2
53105,4,3,186199,186199,186202,0,3,3
53106,6,1,186205,186205,186206,0,1,3
53107,6,2,186211,186211,186213,0,2,5
53108,3,3,186214,186214,186217,0,3,1
53109,3,3,186217,186217,186220,0,3,0
53110,4,3,186221,186221,186224,0,3,1
53111,4,1,186225,186225,186226,0,1,1
53112,1,1,186226,186226,186227,0,1,0
53113,4,2,186230,186230,186232,0,2,3
53114,2,2,186232,186232,186234,0,2,0
53115,3,3,186235,186235,186238,0,3,1
53116,3,2,186238,186238,186240,0,2,0
53117,6,2,186244,186244,186246,0,2,4
53118,4,3,186248,186248,186251,0,3,2
53119,5,1,186253,186253,186254,0,1,2
53120,2,1,186255,186255,186256,0,1,1
53121,5,1,186260,186260,186261,0,1,4
53122,6,2,186266,186266,186268,0,2,5
53123,3,3,186269,186269,186272,0,3,1
53124,1,2,186270,186272,186274,2,4,0
53125,1,2,186271,186274,186276,3,5,0
53126,6,2,186277,186277,186279,0,2,1
53127,5,3,186282,186282,186285,0,3,3
53128,1,2,186283,186285,186287,2,4,0
53129,1,3,186284,186287,186290,3,6,0
53130,1,1,186285,186290,186291,5,6,0
53131,1,2,186286,186291,186293,5,7,0
53132,4,1,186290,186293,186294,3,4,0
53133,3,1,186293,186294,186295,1,2,0
53134,1,3,186294,186295,186298,1,4,0
53135,3,1,186297,186298,186299,1,2,0
53136,5,3,186302,186302,186305,0,3,3
53137,4,3,186306,186306,186309,0,3,1
53138,5,1,186311,186311,186312,0,1,2
53139,3,1,186314,186314,186315,0,1,2
53140,5,1,186319,186319,186320,0,1,4
53141,5,3,186324,186324,186327,0,3,4
53142,4,2,186328,186328,186330,0,2,1
53143,4,1,186332,186332,186333,0,1,2
53144,2,2,186334,186334,186336,0,2,1
53145,4,3,186338,186338,186341,0,3,2
53146,4,3,186342,186342,186345,0,3,1
53147,1,3,186343,186345,186348,2,5,0
53148,3,2,186346,186348,186350,2,4,0
53149,6,2,186352,186352,186354,0,2,2
53150,3,3,186355,186355,186358,0,3,1
53151,3,3,186358,186358,186361,0,3,0
53152,2,2,186360,186361,186363,1,3,0
53153,1,1,186361,186363,186364,2,3,0
53154,1,1,186362,186364,186365,2,3,0
53155,3,2,186365,186365,186367,0,2,0
53156,3,3,186368,186368,186371,0,3,1
53157,1,2,186369,186371,186373,2,4,0
53158,5,3,186374,186374,186377,0,3,1
53159,6,1,186380,186380,186381,0,1,3
53160,2,2,186382,186382,186384,0,2,1
53161,3,1,186385,186385,186386,0,1,1
53162,1,2,186386,186386,186388,0,2,0
53163,6,1,186392,186392,186393,0,1,4
53164,3,2,186395,186395,186397,0,2,2
53165,3,2,186398,186398,186400,0,2,1
53166,6,1,186404,186404,186405,0,1,4
53167,1,2,186405,186405,186407,0,2,0
53168,1,3,186406,186407,186410,1,4,0
53169,3,3,186409,186410,186413,1,4,0
53170,5,2,186414,186414,186416,0,2,1
53171,5,3,186419,186419,186422,0,3,3
53172,1,3,186420,186422,186425,2,5,0
53173,6,3,186426,186426,186429,0,3,1
53174,5,2,186431,186431,186433,0,2,2
53175,2,3,186433,186433,186436,0,3,0
53176,4,2,186437,186437,186439,0,2,1
53177,2,3,186439,186439,186442,0,3,0
53178,1,3,186440,186442,186445,2,5,0
53179,1,1,186441,186445,186446,4,5,0
53180,2,3,186443,186446,186449,3,6,0
53181,6,3,186449,186449,186452,0,3,0
53182,2,1,186451,186452,186453,1,2,0
53183,4,1,186455,186455,186456,0,1,2
53184,1,3,186456,186456,186459,0,3,0
53185,6,3,186462,186462,186465,0,3,3
53186,4,3,186466,186466,186469,0,3,1
53187,5,1,186471,186471,186472,0,1,2
53188,1,2,186472,186472,186474,0,2,0
53189,4,3,186476,186476,186479,0,3,2
53190,3,3,186479,186479,186482,0,3,0
53191,5,1,186484,186484,186485,0,1,2
53192,4,1,186488,186488,186489,0,1,3
53193,2,1,186490,186490,186491,0,1,1
53194,1,2,186491,186491,186493,0,2,0
53195,6,3,186497,186497,186500,0,3,4
53196,1,1,186498,186500,186501,2,3,0
53197,4,3,186502,186502,186505,0,3,1
53198,4,3,186506,186506,186509,0,3,1
53199,5,1,186511,186511,186512,0,1,2
53200,3,3,186514,186514,186517,0,3,2
53201,4,3,186518,186518,186521,0,3,1
53202,6,3,186524,186524,186527,0,3,3
53203,5,3,186529,186529,186532,0,3,2
53204,6,3,186535,186535,186538,0,3,3
53205,1,1,186536,186538,186539,2,3,0
53206,5,1,186541,186541,186542,0,1,2
53207,6,3,186547,186547,186550,0,3,5
53208,3,1,186550,186550,186551,0,1,0
53209,6,3,186556,186556,186559,0,3,5
53210,5,1,186561,186561,186562,0,1,2
53211,1,3,186562,186562,186565,0,3,0
53212,2,1,186564,186565,186566,1,2,0
53213,1,2,186565,186566,186568,1,3,0
53214,2,1,186567,186568,186569,1,2,0
53215,2,3,186569,186569,186572,0,3,0
53216,4,1,186573,186573,186574,0,1,1
53217,2,2,186575,186575,186577,0,2,1
53218,6,2,186581,186581,186583,0,2,4
53219,1,3,186582,186583,186586,1,4,0
53220,5,3,186587,186587,186590,0,3,1
53221,6,3,186593,186593,186596,0,3,3
53222,1,1,186594,186596,186597,2,3,0
53223,5,1,186599,186599,186600,0,1,2
53224,2,3,186601,186601,186604,0,3,1
53225,1,3,186602,186604,186607,2,5,0
53226,1,2,186603,186607,186609,4,6,0
53227,3,1,186606,186609,186610,3,4,0
53228,2,2,186608,186610,186612,2,4,0
53229,1,3,186609,186612,186615,3,6,0
53230,1,3,186610,186615,186618,5,8,0
53231,6,1,186616,186618,186619,2,3,0
53232,2,1,186618,186619,186620,1,2,0
53233,5,1,186623,186623,186624,0,1,3
53234,4,1,186627,186627,186628,0,1,3
53235,2,2,186629,186629,186631,0,2,1
53236,5,1,186634,186634,186635,0,1,3
53237,5,3,186639,186639,186642,0,3,4
53238,4,1,186643,186643,186644,0,1,1
53239,5,1,186648,186648,186649,0,1,4
53240,5,1,186653,186653,186654,0,1,4
53241,4,1,186657,186657,186658,0,1,3
53242,2,2,186659,186659,186661,0,2,1
53243,6,2,186665,186665,186667,0,2,4
53244,5,1,186670,186670,186671,0,1,3
53245,6,2,186676,186676,186678,0,2,5
53246,6,3,186682,186682,186685,0,3,4
53247,1,3,186683,186685,186688,2,5,0
53248,1,3,186684,186688,186691,4,7,0
53249,1,1,186685,186691,186692,6,7,0
53250,6,2,186691,186692,186694,1,3,0
53251,1,1,186692,186694,186695,2,3,0
53252,3,3,186695,186695,186698,0,3,0
53253,4,3,186699,186699,186702,0,3,1
53254,4,3,186703,186703,186706,0,3,1
53255,2,1,186705,186706,186707,1,2,0
53256,1,1,186706,186707,186708,1,2,0
53257,4,2,186710,186710,186712,0,2,2
53258,5,2,186715,186715,186717,0,2,3
53259,5,1,186720,186720,186721,0,1,3
53260,4,1,186724,186724,186725,0,1,3
53261,1,2,186725,186725,186727,0,2,0
53262,2,3,186727,186727,186730,0,3,0
53263,3,3,186730,186730,186733,0,3,0
53264,2,1,186732,186733,186734,1,2,0
53265,2,2,186734,186734,186736,0,2,0
53266,5,3,186739,186739,186742,0,3,3
53267,1,1,186740,186742,186743,2,3,0
53268,5,2,186745,186745,186747,0,2,2
53269,1,2,186746,186747,186749,1,3,0
53270,4,1,186750,186750,186751,0,1,1
53271,2,3,186752,186752,186755,0,3,1
53272,4,3,186756,186756,186759,0,3,1
53273,4,1,186760,186760,186761,0,1,1
53274,5,3,186765,186765,186768,0,3,4
53275,5,3,186770,186770,186773,0,3,2
53276,6,2,186776,186776,186778,0,2,3
53277,2,2,186778,186778,186780,0,2,0
53278,3,2,186781,186781,186783,0,2,1
53279,3,2,186784,186784,186786,0,2,1
53280,6,2,186790,186790,186792,0,2,4
53281,4,2,186794,186794,186796,0,2,2
53282,6,1,186800,186800,186801,0,1,4
53283,3,1,186803,186803,186804,0,1,2
53284,3,2,186806,186806,186808,0,2,2
53285,5,2,186811,186811,186813,0,2,3
53286,6,1,186817,186817,186818,0,1,4
53287,3,3,186820,186820,186823,0,3,2
53288,3,1,186823,186823,186824,0,1,0
53289,2,3,186825,186825,186828,0,3,1
53290,2,3,186827,186828,186831,1,4,0
53291,2,1,186829,186831,186832,2,3,0
53292,3,2,186832,186832,186834,0,2,0
53293,5,2,186837,186837,186839,0,2,3
53294,6,1,186843,186843,186844,0,1,4
53295,3,1,186846,186846,186847,0,1,2
53296,4,1,186850,186850,186851,0,1,3
53297,4,2,186854,186854,186856,0,2,3
53298,4,2,186858,186858,186860,0,2,2
53299,6,1,186864,186864,186865,0,1,4
53300,2,1,186866,186866,186867,0,1,1
53301,3,2,186869,186869,186871,0,2,2
53302,1,1,186870,186871,186872,1,2,0
53303,1,1,186871,186872,186873,1,2,0
53304,5,2,186876,186876,186878,0,2,3
53305,4,3,186880,186880,186883,0,3,2
53306,2,3,186882,186883,186886,1,4,0
53307,3,3,186885,186886,186889,1,4,0
53308,6,2,186891,186891,186893,0,2,2
53309,6,3,186897,186897,186900,0,3,4
53310,6,2,186903,186903,186905,0,2,3
53311,6,2,186909,186909,186911,0,2,4
53312,5,3,186914,186914,186917,0,3,3
53313,4,1,186918,186918,186919,0,1,1
53314,3,2,186921,186921,186923,0,2,2
53315,3,1,186924,186924,186925,0,1,1
53316,2,1,186926,186926,186927,0,1,1
53317,4,1,186930,186930,186931,0,1,3
53318,6,1,186936,186936,186937,0,1,5
53319,5,1,186941,186941,186942,0,1,4
53320,3,1,186944,186944,186945,0,1,2
53321,5,2,186949,186949,186951,0,2,4
53322,1,1,186950,186951,186952,1,2,0
53323,5,1,186955,186955,186956,0,1,3
53324,2,2,186957,186957,186959,0,2,1
53325,1,1,186958,186959,186960,1,2,0
53326,4,3,186962,186962,186965,0,3,2
53327,2,2,186964,186965,186967,1,3,0
53328,4,2,186968,186968,186970,0,2,1
53329,3,2,186971,186971,186973,0,2,1
53330,4,3,186975,186975,186978,0,3,2
53331,1,2,186976,186978,186980,2,4,0
53332,1,3,186977,186980,186983,3,6,0
53333,4,1,186981,186983,186984,2,3,0
53334,6,1,186987,186987,186988,0,1,3
53335,3,3,186990,186990,186993,0,3,2
53336,5,1,186995,186995,186996,0,1,2
53337,1,2,186996,186996,186998,0,2,0
53338,5,2,187001,187001,187003,0,2,3
53339,6,2,187007,187007,187009,0,2,4
53340,5,2,187012,187012,187014,0,2,3
53341,1,1,187013,187014,187015,1,2,0
53342,4,3,187017,187017,187020,0,3,2
53343,2,1,187019,187020,187021,1,2,0
53344,2,2,187021,187021,187023,0,2,0
53345,5,3,187026,187026,187029,0,3,3
53346,4,3,187030,187030,187033,0,3,1
53347,3,3,187033,187033,187036,0,3,0
53348,5,3,187038,187038,187041,0,3,2
53349,5,2,187043,187043,187045,0,2,2
53350,6,1,187049,187049,187050,0,1,4
53351,2,3,187051,187051,187054,0,3,1
53352,3,1,187054,187054,187055,0,1,0
53353,3,1,187057,187057,187058,0,1,2
53354,3,1,187060,187060,187061,0,1,2
53355,1,2,187061,187061,187063,0,2,0
53356,2,3,187063,187063,187066,0,3,0
53357,6,2,187069,187069,187071,0,2,3
53358,1,1,187070,187071,187072,1,2,0
53359,2,1,187072,187072,187073,0,1,0
53360,2,3,187074,187074,187077,0,3,1
53361,3,1,187077,187077,187078,0,1,0
53362,1,3,187078,187078,187081,0,3,0
53363,6,1,187084,187084,187085,0,1,3
53364,5,3,187089,187089,187092,0,3,4
53365,3,3,187092,187092,187095,0,3,0
53366,4,2,187096,187096,187098,0,2,1
53367,3,1,187099,187099,187100,0,1,1
53368,5,2,187104,187104,187106,0,2,4
53369,2,1,187106,187106,187107,0,1,0
53370,4,2,187110,187110,187112,0,2,3
53371,6,2,187116,187116,187118,0,2,4
53372,4,3,187120,187120,187123,0,3,2
53373,2,1,187122,187123,187124,1,2,0
53374,2,1,187124,187124,187125,0,1,0
53375,1,2,187125,187125,187127,0,2,0
53376,5,1,187130,187130,187131,0,1,3
53377,4,2,187134,187134,187136,0,2,3
53378,3,2,187137,187137,187139,0,2,1
53379,2,2,187139,187139,187141,0,2,0
53380,6,2,187145,187145,187147,0,2,4
53381,6,3,187151,187151,187154,0,3,4
53382,3,1,187154,187154,187155,0,1,0
53383,4,1,187158,187158,187159,0,1,3
53384,1,1,187159,187159,187160,0,1,0
53385,1,3,187160,187160,187163,0,3,0
53386,4,2,187164,187164,187166,0,2,1
53387,5,3,187169,187169,187172,0,3,3
53388,1,2,187170,187172,187174,2,4,0
53389,2,2,187172,187174,187176,2,4,0
53390,2,1,187174,187176,187177,2,3,0
53391,5,3,187179,187179,187182,0,3,2
53392,4,1,187183,187183,187184,0,1,1
53393,6,1,187189,187189,187190,0,1,5
53394,2,3,187191,187191,187194,0,3,1
53395,3,1,187194,187194,187195,0,1,0
53396,4,3,187198,187198,187201,0,3,3
53397,2,2,187200,187201,187203,1,3,0
53398,6,1,187206,187206,187207,0,1,3
53399,1,3,187207,187207,187210,0,3,0
53400,4,3,187211,187211,187214,0,3,1
53401,3,1,187214,187214,187215,0,1,0
53402,4,2,187218,187218,187220,0,2,3
53403,6,3,187224,187224,187227,0,3,4
53404,4,3,187228,187228,187231,0,3,1
53405,5,2,187233,187233,187235,0,2,2
53406,3,3,187236,187236,187239,0,3,1
53407,4,1,187240,187240,187241,0,1,1
53408,5,1,187245,187245,187246,0,1,4
53409,2,1,187247,187247,187248,0,1,1
53410,3,1,187250,187250,187251,0,1,2
53411,5,2,187255,187255,187257,0,2,4
53412,5,2,187260,187260,187262,0,2,3
53413,1,2,187261,187262,187264,1,3,0
53414,1,2,187262,187264,187266,2,4,0
53415,1,1,187263,187266,187267,3,4,0
53416,4,2,187267,187267,187269,0,2,0
53417,6,2,187273,187273,187275,0,2,4
53418,6,2,187279,187279,187281,0,2,4
53419,2,2,187281,187281,187283,0,2,0
53420,5,2,187286,187286,187288,0,2,3
53421,3,2,187289,187289,187291,0,2,1
53422,2,3,187291,187291,187294,0,3,0
53423,3,3,187294,187294,187297,0,3,0
53424,6,2,187300,187300,187302,0,2,3
53425,5,1,187305,187305,187306,0,1,3
53426,3,1,187308,187308,187309,0,1,2
53427,3,3,187311,187311,187314,0,3,2
53428,3,3,187314,187314,187317,0,3,0
53429,6,3,187320,187320,187323,0,3,3
53430,4,2,187324,187324,187326,0,2,1
53431,3,3,187327,187327,187330,0,3,1
53432,2,3,187329,187330,187333,1,4,0
53433,5,3,187334,187334,187337,0,3,1
53434,2,3,187336,187337,187340,1,4,0
53435,6,3,187342,187342,187345,0,3,2
53436,4,1,187346,187346,187347,0,1,1
53437,6,1,187352,187352,187353,0,1,5
53438,2,3,187354,187354,187357,0,3,1
53439,5,1,187359,187359,187360,0,1,2
53440,6,2,187365,187365,187367,0,2,5
53441,2,1,187367,187367,187368,0,1,0
53442,6,3,187373,187373,187376,0,3,5
53443,1,2,187374,187376,187378,2,4,0
53444,2,3,187376,187378,187381,2,5,0
53445,6,2,187382,187382,187384,0,2,1
53446,3,3,187385,187385,187388,0,3,1
53447,2,1,187387,187388,187389,1,2,0
53448,2,3,187389,187389,187392,0,3,0
53449,3,1,187392,187392,187393,0,1,0
53450,6,1,187398,187398,187399,0,1,5
53451,5,2,187403,187403,187405,0,2,4
53452,5,2,187408,187408,187410,0,2,3
53453,6,1,187414,187414,187415,0,1,4
53454,6,2,187420,187420,187422,0,2,5
53455,6,2,187426,187426,187428,0,2,4
53456,3,3,187429,187429,187432,0,3,1
53457,3,3,187432,187432,187435,0,3,0
53458,6,2,187438,187438,187440,0,2,3
53459,2,2,187440,187440,187442,0,2,0
53460,4,1,187444,187444,187445,0,1,2
53461,2,1,187446,187446,187447,0,1,1
53462,5,2,187451,187451,187453,0,2,4
53463,2,2,187453,187453,187455,0,2,0
53464,3,2,187456,187456,187458,0,2,1
53465,3,1,187459,187459,187460,0,1,1
53466,4,2,187463,187463,187465,0,2,3
53467,6,3,187469,187469,187472,0,3,4
53468,4,3,187473,187473,187476,0,3,1
53469,3,1,187476,187476,187477,0,1,0
53470,2,1,187478,187478,187479,0,1,1
53471,6,2,187484,187484,187486,0,2,5
53472,5,1,187489,187489,187490,0,1,3
53473,4,3,187493,187493,187496,0,3,3
53474,6,2,187499,187499,187501,0,2,3
53475,2,2,187501,187501,187503,0,2,0
53476,5,1,187506,187506,187507,0,1,3
53477,6,3,187512,187512,187515,0,3,5
53478,6,2,187518,187518,187520,0,2,3
53479,4,3,187522,187522,187525,0,3,2
53480,1,1,187523,187525,187526,2,3,0
53481,4,3,187527,187527,187530,0,3,1
53482,3,2,187530,187530,187532,0,2,0
53483,4,2,187534,187534,187536,0,2,2
53484,4,3,187538,187538,187541,0,3,2
53485,2,2,187540,187541,187543,1,3,0
53486,1,1,187541,187543,187544,2,3,0
53487,4,3,187545,187545,187548,0,3,1
53488,4,2,187549,187549,187551,0,2,1
53489,2,2,187551,187551,187553,0,2,0
53490,2,3,187553,187553,187556,0,3,0
53491,3,3,187556,187556,187559,0,3,0
53492,1,2,187557,187559,187561,2,4,0
53493,5,2,187562,187562,187564,0,2,1
53494,1,1,187563,187564,187565,1,2,0
53495,5,1,187568,187568,187569,0,1,3
53496,3,1,187571,187571,187572,0,1,2
53497,2,2,187573,187573,187575,0,2,1
53498,3,1,187576,187576,187577,0,1,1
53499,1,2,187577,187577,187579,0,2,0
53500,3,3,187580,187580,187583,0,3,1
53501,5,3,187585,187585,187588,0,3,2
53502,2,1,187587,187588,187589,1,2,0
53503,4,3,187591,187591,187594,0,3,2
53504,5,1,187596,187596,187597,0,1,2
53505,1,2,187597,187597,187599,0,2,0
53506,6,2,187603,187603,187605,0,2,4
53507,4,2,187607,187607,187609,0,2,2
53508,3,2,187610,187610,187612,0,2,1
53509,2,2,187612,187612,187614,0,2,0
53510,1,1,187613,187614,187615,1,2,0
53511,4,3,187617,187617,187620,0,3,2
53512,3,2,187620,187620,187622,0,2,0
53513,3,3,187623,187623,187626,0,3,1
53514,6,1,187629,187629,187630,0,1,3
53515,2,3,187631,187631,187634,0,3,1
53516,1,3,187632,187634,187637,2,5,0
53517,4,3,187636,187637,187640,1,4,0
53518,3,2,187639,187640,187642,1,3,0
53519,2,1,187641,187642,187643,1,2,0
53520,6,2,187647,187647,187649,0,2,4
53521,1,1,187648,187649,187650,1,2,0
53522,2,2,187650,187650,187652,0,2,0
53523,5,1,187655,187655,187656,0,1,3
53524,2,2,187657,187657,187659,0,2,1
53525,1,1,187658,187659,187660,1,2,0
53526,2,1,187660,187660,187661,0,1,0
53527,1,3,187661,187661,187664,0,3,0
53528,4,3,187665,187665,187668,0,3,1
53529,6,2,187671,187671,187673,0,2,3
53530,1,1,187672,187673,187674,1,2,0
53531,2,1,187674,187674,187675,0,1,0
53532,3,2,187677,187677,187679,0,2,2
53533,6,3,187683,187683,187686,0,3,4
53534,4,2,187687,187687,187689,0,2,1
53535,3,1,187690,187690,187691,0,1,1
53536,2,1,187692,187692,187693,0,1,1
53537,3,2,187695,187695,187697,0,2,2
53538,4,3,187699,187699,187702,0,3,2
53539,5,3,187704,187704,187707,0,3,2
53540,4,2,187708,187708,187710,0,2,1
53541,2,3,187710,187710,187713,0,3,0
53542,2,3,187712,187713,187716,1,4,0
53543,4,1,187716,187716,187717,0,1,0
53544,3,3,187719,187719,187722,0,3,2
53545,3,3,187722,187722,187725,0,3,0
53546,6,1,187728,187728,187729,0,1,3
53547,5,1,187733,187733,187734,0,1,4
53548,3,1,187736,187736,187737,0,1,2
53549,4,3,187740,187740,187743,0,3,3
53550,2,2,187742,187743,187745,1,3,0
53551,5,3,187747,187747,187750,0,3,2
53552,4,1,187751,187751,187752,0,1,1
53553,4,3,187755,187755,187758,0,3,3
53554,5,3,187760,187760,187763,0,3,2
53555,2,3,187762,187763,187766,1,4,0
53556,5,1,187767,187767,187768,0,1,1
53557,6,3,187773,187773,187776,0,3,5
53558,3,1,187776,187776,187777,0,1,0
53559,1,1,187777,187777,187778,0,1,0
53560,2,3,187779,187779,187782,0,3,1
53561,4,1,187783,187783,187784,0,1,1
53562,2,3,187785,187785,187788,0,3,1
53563,1,1,187786,187788,187789,2,3,0
53564,3,1,187789,187789,187790,0,1,0
53565,6,3,187795,187795,187798,0,3,5
53566,1,1,187796,187798,187799,2,3,0
53567,6,1,187802,187802,187803,0,1,3
53568,3,3,187805,187805,187808,0,3,2
53569,2,3,187807,187808,187811,1,4,0
53570,2,3,187809,187811,187814,2,5,0
53571,3,1,187812,187814,187815,2,3,0
53572,2,1,187814,187815,187816,1,2,0
53573,5,3,187819,187819,187822,0,3,3
53574,2,3,187821,187822,187825,1,4,0
53575,3,1,187824,187825,187826,1,2,0
53576,1,2,187825,187826,187828,1,3,0
53577,1,2,187826,187828,187830,2,4,0
53578,3,2,187829,187830,187832,1,3,0
53579,6,3,187835,187835,187838,0,3,3
53580,3,1,187838,187838,187839,0,1,0
53581,6,2,187844,187844,187846,0,2,5
53582,5,2,187849,187849,187851,0,2,3
53583,4,2,187853,187853,187855,0,2,2
53584,1,1,187854,187855,187856,1,2,0
53585,6,1,187860,187860,187861,0,1,4
53586,1,1,187861,187861,187862,0,1,0
53587,2,3,187863,187863,187866,0,3,1
53588,3,1,187866,187866,187867,0,1,0
53589,4,2,187870,187870,187872,0,2,3
53590,4,2,187874,187874,187876,0,2,2
53591,2,2,187876,187876,187878,0,2,0
53592,4,2,187880,187880,187882,0,2,2
53593,1,1,187881,187882,187883,1,2,0
53594,4,3,187885,187885,187888,0,3,2
53595,6,1,187891,187891,187892,0,1,3
53596,6,1,187897,187897,187898,0,1,5
53597,6,2,187903,187903,187905,0,2,5
53598,2,2,187905,187905,187907,0,2,0
53599,6,3,187911,187911,187914,0,3,4
53600,6,1,187917,187917,187918,0,1,3
53601,3,2,187920,187920,187922,0,2,2
53602,3,1,187923,187923,187924,0,1,1
53603,4,3,187927,187927,187930,0,3,3
53604,4,1,187931,187931,187932,0,1,1
53605,6,3,187937,187937,187940,0,3,5
53606,2,1,187939,187940,187941,1,2,0
53607,3,3,187942,187942,187945,0,3,1
53608,2,2,187944,187945,187947,1,3,0
53609,5,1,187949,187949,187950,0,1,2
53610,4,1,187953,187953,187954,0,1,3
53611,5,3,187958,187958,187961,0,3,4
53612,4,2,187962,187962,187964,0,2,1
53613,4,2,187966,187966,187968,0,2,2
53614,5,1,187971,187971,187972,0,1,3
53615,3,3,187974,187974,187977,0,3,2
53616,3,1,187977,187977,187978,0,1,0
53617,5,1,187982,187982,187983,0,1,4
53618,4,1,187986,187986,187987,0,1,3
53619,1,3,187987,187987,187990,0,3,0
53620,6,1,187993,187993,187994,0,1,3
53621,2,2,187995,187995,187997,0,2,1
53622,6,2,188001,188001,188003,0,2,4
53623,6,3,188007,188007,188010,0,3,4
53624,1,3,188008,188010,188013,2,5,0
53625,6,2,188014,188014,188016,0,2,1
53626,3,1,188017,188017,188018,0,1,1
53627,5,3,188022,188022,188025,0,3,4
53628,5,1,188027,188027,188028,0,1,2
53629,3,2,188030,188030,188032,0,2,2
53630,1,3,188031,188032,188035,1,4,0
53631,2,1,188033,188035,188036,2,3,0
53632,2,2,188035,188036,188038,1,3,0
53633,5,2,188040,188040,188042,0,2,2
53634,2,1,188042,188042,188043,0,1,0
53635,3,2,188045,188045,188047,0,2,2
53636,1,2,188046,188047,188049,1,3,0
53637,2,3,188048,188049,188052,1,4,0
53638,3,1,188051,188052,188053,1,2,0
53639,6,1,188057,188057,188058,0,1,4
53640,2,3,188059,188059,188062,0,3,1
53641,1,1,188060,188062,188063,2,3,0
53642,5,3,188065,188065,188068,0,3,2
53643,4,2,188069,188069,188071,0,2,1
53644,4,2,188073,188073,188075,0,2,2
53645,4,1,188077,188077,188078,0,1,2
53646,4,2,188081,188081,188083,0,2,3
53647,5,1,188086,188086,188087,0,1,3
53648,3,1,188089,188089,188090,0,1,2
53649,1,1,188090,188090,188091,0,1,0
53650,2,3,188092,188092,188095,0,3,1
53651,3,2,188095,188095,188097,0,2,0
53652,2,2,188097,188097,188099,0,2,0
53653,3,1,188100,188100,188101,0,1,1
53654,6,2,188106,188106,188108,0,2,5
53655,3,1,188109,188109,188110,0,1,1
53656,4,3,188113,188113,188116,0,3,3
53657,6,2,188119,188119,188121,0,2,3
53658,2,1,188121,188121,188122,0,1,0
53659,2,1,188123,188123,188124,0,1,1
53660,3,3,188126,188126,188129,0,3,2
53661,4,3,188130,188130,188133,0,3,1
53662,1,3,188131,188133,188136,2,5,0
53663,2,3,188133,188136,188139,3,6,0
53664,3,3,188136,188139,188142,3,6,0
53665,3,3,188139,188142,188145,3,6,0
53666,1,2,188140,188145,188147,5,7,0
53667,5,1,188145,188147,188148,2,3,0
53668,4,2,188149,188149,188151,0,2,1
53669,3,1,188152,188152,188153,0,1,1
53670,3,2,188155,188155,188157,0,2,2
53671,6,1,188161,188161,188162,0,1,4
53672,6,1,188167,188167,188168,0,1,5
53673,6,3,188173,188173,188176,0,3,5
53674,4,1,188177,188177,188178,0,1,1
53675,6,2,188183,188183,188185,0,2,5
53676,4,2,188187,188187,188189,0,2,2
53677,5,2,188192,188192,188194,0,2,3
53678,3,2,188195,188195,188197,0,2,1
53679,4,2,188199,188199,188201,0,2,2
53680,5,3,188204,188204,188207,0,3,3
53681,4,2,188208,188208,188210,0,2,1
53682,5,3,188213,188213,188216,0,3,3
53683,2,2,188215,188216,188218,1,3,0
53684,3,2,188218,188218,188220,0,2,0
53685,5,1,188223,188223,188224,0,1,3
53686,6,3,188229,188229,188232,0,3,5
53687,4,3,188233,188233,188236,0,3,1
53688,5,1,188238,188238,188239,0,1,2
53689,4,3,188242,188242,188245,0,3,3
53690,1,1,188243,188245,188246,2,3,0
53691,4,2,188247,188247,188249,0,2,1
53692,4,3,188251,188251,188254,0,3,2
53693,1,1,188252,188254,188255,2,3,0
53694,6,2,188258,188258,188260,0,2,3
53695,6,2,188264,188264,188266,0,2,4
53696,3,3,188267,188267,188270,0,3,1
53697,4,2,188271,188271,188273,0,2,1
53698,3,2,188274,188274,188276,0,2,1
53699,3,2,188277,188277,188279,0,2,1
53700,1,3,188278,188279,188282,1,4,0
53701,1,1,188279,188282,188283,3,4,0
53702,3,3,188282,188283,188286,1,4,0
53703,5,3,188287,188287,188290,0,3,1
53704,2,3,188289,188290,188293,1,4,0
53705,3,3,188292,188293,188296,1,4,0
53706,4,1,188296,188296,188297,0,1,0
53707,2,1,188298,188298,188299,0,1,1
53708,3,2,188301,188301,188303,0,2,2
53709,5,3,188306,188306,188309,0,3,3
53710,4,3,188310,188310,188313,0,3,1
53711,1,1,188311,188313,188314,2,3,0
53712,4,2,188315,188315,188317,0,2,1
53713,6,3,188321,188321,188324,0,3,4
53714,6,1,188327,188327,188328,0,1,3
53715,4,1,188331,188331,188332,0,1,3
53716,6,2,188337,188337,188339,0,2,5
53717,2,3,188339,188339,188342,0,3,0
53718,5,1,188344,188344,188345,0,1,2
53719,6,3,188350,188350,188353,0,3,5
53720,1,3,188351,188353,188356,2,5,0
53721,3,2,188354,188356,188358,2,4,0
53722,5,2,188359,188359,188361,0,2,1
53723,5,1,188364,188364,188365,0,1,3
53724,6,2,188370,188370,188372,0,2,5
53725,4,1,188374,188374,188375,0,1,2
53726,4,3,188378,188378,188381,0,3,3
53727,2,3,188380,188381,188384,1,4,0
53728,2,3,188382,188384,188387,2,5,0
53729,6,1,188388,188388,188389,0,1,1
53730,6,3,188394,188394,188397,0,3,5
53731,2,1,188396,188397,188398,1,2,0
53732,5,2,188401,188401,188403,0,2,3
53733,1,2,188402,188403,188405,1,3,0
53734,6,1,188408,188408,188409,0,1,3
53735,6,2,188414,188414,188416,0,2,5
53736,5,3,188419,188419,188422,0,3,3
53737,2,2,188421,188422,188424,1,3,0
53738,6,2,188427,188427,188429,0,2,3
53739,3,1,188430,188430,188431,0,1,1
53740,3,3,188433,188433,188436,0,3,2
53741,2,2,188435,188436,188438,1,3,0
53742,6,3,188441,188441,188444,0,3,3
53743,3,1,188444,188444,188445,0,1,0
53744,5,1,188449,188449,188450,0,1,4
53745,2,3,188451,188451,188454,0,3,1
53746,4,1,188455,188455,188456,0,1,1
53747,2,2,188457,188457,188459,0,2,1
53748,2,1,188459,188459,188460,0,1,0
53749,5,2,188464,188464,188466,0,2,4
53750,6,3,188470,188470,188473,0,3,4
53751,1,3,188471,188473,188476,2,5,0
53752,2,2,188473,188476,188478,3,5,0
53753,2,2,188475,188478,188480,3,5,0
53754,2,3,188477,188480,188483,3,6,0
53755,2,3,188479,188483,188486,4,7,0
53756,2,3,188481,188486,188489,5,8,0
53757,2,3,188483,188489,188492,6,9,0
53758,5,3,188488,188492,188495,4,7,0
53759,2,1,188490,188495,188496,5,6,0
53760,5,1,188495,188496,188497,1,2,0
53761,1,2,188496,188497,188499,1,3,0
53762,2,2,188498,188499,188501,1,3,0
53763,3,1,188501,188501,188502,0,1,0
53764,3,2,188504,188504,188506,0,2,2
53765,4,2,188508,188508,188510,0,2,2
53766,3,3,188511,188511,188514,0,3,1
53767,5,1,188516,188516,188517,0,1,2
53768,1,2,188517,188517,188519,0,2,0
53769,2,2,188519,188519,188521,0,2,0
53770,3,3,188522,188522,188525,0,3,1
53771,3,2,188525,188525,188527,0,2,0
53772,3,1,188528,188528,188529,0,1,1
53773,4,3,188532,188532,188535,0,3,3
53774,4,1,188536,188536,188537,0,1,1
53775,4,3,188540,188540,188543,0,3,3
53776,2,2,188542,188543,188545,1,3,0
53777,6,3,188548,188548,188551,0,3,3
53778,4,2,188552,188552,188554,0,2,1
53779,5,3,188557,188557,188560,0,3,3
53780,1,1,188558,188560,188561,2,3,0
53781,3,2,188561,188561,188563,0,2,0
53782,2,2,188563,188563,188565,0,2,0
53783,4,3,188567,188567,188570,0,3,2
53784,6,1,188573,188573,188574,0,1,3
53785,6,3,188579,188579,188582,0,3,5
53786,4,3,188583,188583,188586,0,3,1
53787,4,1,188587,188587,188588,0,1,1
53788,3,2,188590,188590,188592,0,2,2
53789,1,3,188591,188592,188595,1,4,0
53790,1,1,188592,188595,188596,3,4,0
53791,2,3,188594,188596,188599,2,5,0
53792,3,1,188597,188599,188600,2,3,0
53793,3,2,188600,188600,188602,0,2,0
53794,2,2,188602,188602,188604,0,2,0
53795,3,3,188605,188605,188608,0,3,1
53796,2,1,188607,188608,188609,1,2,0
53797,6,1,188613,188613,188614,0,1,4
53798,1,2,188614,188614,188616,0,2,0
53799,2,3,188616,188616,188619,0,3,0
53800,6,1,188622,188622,188623,0,1,3
53801,3,1,188625,188625,188626,0,1,2
53802,6,3,188631,188631,188634,0,3,5
53803,4,1,188635,188635,188636,0,1,1
53804,5,2,188640,188640,188642,0,2,4
53805,5,3,188645,188645,188648,0,3,3
53806,2,2,188647,188648,188650,1,3,0
53807,4,3,188651,188651,188654,0,3,1
53808,6,2,188657,188657,188659,0,2,3
53809,2,3,188659,188659,188662,0,3,0
53810,1,1,188660,188662,188663,2,3,0
53811,2,1,188662,188663,188664,1,2,0
53812,2,1,188664,188664,188665,0,1,0
53813,5,1,188669,188669,188670,0,1,4
53814,2,2,188671,188671,188673,0,2,1
53815,3,3,188674,188674,188677,0,3,1
53816,6,1,188680,188680,188681,0,1,3
53817,2,3,188682,188682,188685,0,3,1
53818,2,3,188684,188685,188688,1,4,0
53819,4,1,188688,188688,188689,0,1,0
53820,3,1,188691,188691,188692,0,1,2
53821,1,1,188692,188692,188693,0,1,0
53822,5,1,188697,188697,188698,0,1,4
53823,6,3,188703,188703,188706,0,3,5
53824,3,2,188706,188706,188708,0,2,0
53825,4,1,188710,188710,188711,0,1,2
53826,4,2,188714,188714,188716,0,2,3
53827,1,3,188715,188716,188719,1,4,0
53828,5,2,188720,188720,188722,0,2,1
53829,1,2,188721,188722,188724,1,3,0
53830,3,2,188724,188724,188726,0,2,0
53831,5,1,188729,188729,188730,0,1,3
53832,4,2,188733,188733,188735,0,2,3
53833,1,3,188734,188735,188738,1,4,0
53834,1,2,188735,188738,188740,3,5,0
53835,5,2,188740,188740,188742,0,2,0
53836,2,1,188742,188742,188743,0,1,0
53837,3,3,188745,188745,188748,0,3,2
53838,4,3,188749,188749,188752,0,3,1
53839,3,3,188752,188752,188755,0,3,0
53840,2,3,188754,188755,188758,1,4,0
53841,1,3,188755,188758,188761,3,6,0
53842,6,2,188761,188761,188763,0,2,0
53843,5,3,188766,188766,188769,0,3,3
53844,6,3,188772,188772,188775,0,3,3
53845,1,2,188773,188775,188777,2,4,0
53846,4,1,188777,188777,188778,0,1,0
53847,4,1,188781,188781,188782,0,1,3
53848,4,3,188785,188785,188788,0,3,3
53849,4,2,188789,188789,188791,0,2,1
53850,6,2,188795,188795,188797,0,2,4
53851,2,2,188797,188797,188799,0,2,0
53852,1,2,188798,188799,188801,1,3,0
53853,2,3,188800,188801,188804,1,4,0
53854,1,1,188801,188804,188805,3,4,0
53855,2,3,188803,188805,188808,2,5,0
53856,3,2,188806,188808,188810,2,4,0
53857,6,1,188812,188812,188813,0,1,2
53858,2,3,188814,188814,188817,0,3,1
53859,2,3,188816,188817,188820,1,4,0
53860,2,1,188818,188820,188821,2,3,0
53861,4,2,188822,188822,188824,0,2,1
53862,4,2,188826,188826,188828,0,2,2
53863,2,2,188828,188828,188830,0,2,0
53864,3,2,188831,188831,188833,0,2,1
53865,3,3,188834,188834,188837,0,3,1
53866,5,2,188839,188839,188841,0,2,2
53867,3,1,188842,188842,188843,0,1,1
53868,2,1,188844,188844,188845,0,1,1
53869,3,1,188847,188847,188848,0,1,2
53870,2,2,188849,188849,188851,0,2,1
53871,6,2,188855,188855,188857,0,2,4
53872,6,3,188861,188861,188864,0,3,4
53873,2,1,188863,188864,188865,1,2,0
53874,6,1,188869,188869,188870,0,1,4
53875,4,1,188873,188873,188874,0,1,3
53876,2,2,188875,188875,188877,0,2,1
53877,2,1,188877,188877,188878,0,1,0
53878,6,3,188883,188883,188886,0,3,5
53879,3,2,188886,188886,188888,0,2,0
53880,1,2,188887,188888,188890,1,3,0
53881,3,3,188890,188890,188893,0,3,0
53882,3,2,188893,188893,188895,0,2,0
53883,3,1,188896,188896,188897,0,1,1
53884,4,1,188900,188900,188901,0,1,3
53885,6,1,188906,188906,188907,0,1,5
53886,6,1,188912,188912,188913,0,1,5
53887,1,1,188913,188913,188914,0,1,0
53888,6,2,188919,188919,188921,0,2,5
53889,2,1,188921,188921,188922,0,1,0
53890,2,3,188923,188923,188926,0,3,1
53891,2,3,188925,188926,188929,1,4,0
53892,6,3,188931,188931,188934,0,3,2
53893,6,2,188937,188937,188939,0,2,3
53894,2,1,188939,188939,188940,0,1,0
53895,2,2,188941,188941,188943,0,2,1
53896,4,2,188945,188945,188947,0,2,2
53897,1,2,188946,188947,188949,1,3,0
53898,3,3,188949,188949,188952,0,3,0
53899,4,1,188953,188953,188954,0,1,1
53900,1,1,188954,188954,188955,0,1,0
53901,1,1,188955,188955,188956,0,1,0
53902,6,1,188961,188961,188962,0,1,5
53903,4,2,188965,188965,188967,0,2,3
53904,5,1,188970,188970,188971,0,1,3
53905,3,3,188973,188973,188976,0,3,2
53906,1,2,188974,188976,188978,2,4,0
53907,4,3,188978,188978,188981,0,3,0
53908,3,2,188981,188981,188983,0,2,0
53909,5,3,188986,188986,188989,0,3,3
53910,2,1,188988,188989,188990,1,2,0
53911,5,3,188993,188993,188996,0,3,3
53912,4,2,188997,188997,188999,0,2,1
53913,3,2,189000,189000,189002,0,2,1
53914,6,2,189006,189006,189008,0,2,4
53915,4,3,189010,189010,189013,0,3,2
53916,1,2,189011,189013,189015,2,4,0
53917,6,3,189017,189017,189020,0,3,2
53918,3,1,189020,189020,189021,0,1,0
53919,2,3,189022,189022,189025,0,3,1
53920,5,3,189027,189027,189030,0,3,2
53921,3,2,189030,189030,189032,0,2,0
53922,6,2,189036,189036,189038,0,2,4
53923,5,2,189041,189041,189043,0,2,3
53924,5,2,189046,189046,189048,0,2,3
53925,6,1,189052,189052,189053,0,1,4
53926,1,2,189053,189053,189055,0,2,0
53927,1,2,189054,189055,189057,1,3,0
53928,3,2,189057,189057,189059,0,2,0
53929,5,3,189062,189062,189065,0,3,3
53930,6,2,189068,189068,189070,0,2,3
53931,5,2,189073,189073,189075,0,2,3
53932,2,2,189075,189075,189077,0,2,0
53933,2,2,189077,189077,189079,0,2,0
53934,1,3,189078,189079,189082,1,4,0
53935,4,3,189082,189082,189085,0,3,0
53936,2,2,189084,189085,189087,1,3,0
53937,1,3,189085,189087,189090,2,5,0
53938,1,3,189086,189090,189093,4,7,0
53939,5,3,189091,189093,189096,2,5,0
53940,2,2,189093,189096,189098,3,5,0
53941,5,1,189098,189098,189099,0,1,0
53942,4,2,189102,189102,189104,0,2,3
53943,2,1,189104,189104,189105,0,1,0
53944,4,2,189108,189108,189110,0,2,3
53945,1,3,189109,189110,189113,1,4,0
53946,2,2,189111,189113,189115,2,4,0
53947,4,3,189115,189115,189118,0,3,0
53948,4,2,189119,189119,189121,0,2,1
53949,5,3,189124,189124,189127,0,3,3
53950,3,3,189127,189127,189130,0,3,0
53951,3,1,189130,189130,189131,0,1,0
53952,6,3,189136,189136,189139,0,3,5
53953,2,3,189138,189139,189142,1,4,0
53954,6,2,189144,189144,189146,0,2,2
53955,2,1,189146,189146,189147,0,1,0
53956,4,1,189150,189150,189151,0,1,3
53957,4,3,189154,189154,189157,0,3,3
53958,4,2,189158,189158,189160,0,2,1
53959,6,3,189164,189164,189167,0,3,4
53960,6,2,189170,189170,189172,0,2,3
53961,6,3,189176,189176,189179,0,3,4
53962,6,3,189182,189182,189185,0,3,3
53963,5,3,189187,189187,189190,0,3,2
53964,5,1,189192,189192,189193,0,1,2
53965,1,2,189193,189193,189195,0,2,0
53966,2,1,189195,189195,189196,0,1,0
53967,6,2,189201,189201,189203,0,2,5
53968,6,2,189207,189207,189209,0,2,4
53969,3,2,189210,189210,189212,0,2,1
53970,2,3,189212,189212,189215,0,3,0
53971,6,1,189218,189218,189219,0,1,3
53972,1,1,189219,189219,189220,0,1,0
53973,5,2,189224,189224,189226,0,2,4
53974,4,1,189228,189228,189229,0,1,2
53975,4,3,189232,189232,189235,0,3,3
53976,4,2,189236,189236,189238,0,2,1
53977,4,2,189240,189240,189242,0,2,2
53978,2,3,189242,189242,189245,0,3,0
53979,3,2,189245,189245,189247,0,2,0
53980,5,2,189250,189250,189252,0,2,3
53981,6,3,189256,189256,189259,0,3,4
53982,2,1,189258,189259,189260,1,2,0
53983,4,2,189262,189262,189264,0,2,2
53984,3,1,189265,189265,189266,0,1,1
53985,2,1,189267,189267,189268,0,1,1
53986,1,3,189268,189268,189271,0,3,0
53987,4,2,189272,189272,189274,0,2,1
53988,1,2,189273,189274,189276,1,3,0
53989,5,3,189278,189278,189281,0,3,2
53990,1,2,189279,189281,189283,2,4,0
53991,4,1,189283,189283,189284,0,1,0
53992,3,3,189286,189286,189289,0,3,2
53993,5,1,189291,189291,189292,0,1,2
53994,4,3,189295,189295,189298,0,3,3
53995,2,2,189297,189298,189300,1,3,0
53996,6,3,189303,189303,189306,0,3,3
53997,6,3,189309,189309,189312,0,3,3
53998,4,3,189313,189313,189316,0,3,1
53999,1,3,189314,189316,189319,2,5,0
54000,2,2,189316,189319,189321,3,5,0
54001,3,3,189319,189321,189324,2,5,0
54002,4,2,189323,189324,189326,1,3,0
54003,1,1,189324,189326,189327,2,3,0
54004,2,2,189326,189327,189329,1,3,0
54005,4,1,189330,189330,189331,0,1,1
54006,3,2,189333,189333,189335,0,2,2
54007,3,1,189336,189336,189337,0,1,1
54008,6,2,189342,189342,189344,0,2,5
54009,3,1,189345,189345,189346,0,1,1
54010,2,1,189347,189347,189348,0,1,1
54011,3,1,189350,189350,189351,0,1,2
54012,3,1,189353,189353,189354,0,1,2
54013,2,2,189355,189355,189357,0,2,1
54014,2,2,189357,189357,189359,0,2,0
54015,4,3,189361,189361,189364,0,3,2
54016,4,1,189365,189365,189366,0,1,1
54017,2,1,189367,189367,189368,0,1,1
54018,4,3,189371,189371,189374,0,3,3
54019,1,2,189372,189374,189376,2,4,0
54020,5,1,189377,189377,189378,0,1,1
54021,4,3,189381,189381,189384,0,3,3
54022,6,3,189387,189387,189390,0,3,3
54023,3,1,189390,189390,189391,0,1,0
54024,3,3,189393,189393,189396,0,3,2
54025,6,2,189399,189399,189401,0,2,3
54026,4,1,189403,189403,189404,0,1,2
54027,3,1,189406,189406,189407,0,1,2
54028,4,1,189410,189410,189411,0,1,3
54029,5,2,189415,189415,189417,0,2,4
54030,3,3,189418,189418,189421,0,3,1
54031,2,2,189420,189421,189423,1,3,0
54032,4,1,189424,189424,189425,0,1,1
54033,3,1,189427,189427,189428,0,1,2
54034,2,3,189429,189429,189432,0,3,1
54035,6,2,189435,189435,189437,0,2,3
54036,2,3,189437,189437,189440,0,3,0
54037,5,1,189442,189442,189443,0,1,2
54038,1,2,189443,189443,189445,0,2,0
54039,6,1,189449,189449,189450,0,1,4
54040,4,3,189453,189453,189456,0,3,3
54041,6,2,189459,189459,189461,0,2,3
54042,3,1,189462,189462,189463,0,1,1
54043,5,3,189467,189467,189470,0,3,4
54044,5,1,189472,189472,189473,0,1,2
54045,3,3,189475,189475,189478,0,3,2
54046,1,1,189476,189478,189479,2,3,0
54047,6,1,189482,189482,189483,0,1,3
54048,6,1,189488,189488,189489,0,1,5
54049,1,3,189489,189489,189492,0,3,0
54050,1,2,189490,189492,189494,2,4,0
54051,5,1,189495,189495,189496,0,1,1
54052,2,3,189497,189497,189500,0,3,1
54053,6,3,189503,189503,189506,0,3,3
54054,4,1,189507,189507,189508,0,1,1
54055,6,3,189513,189513,189516,0,3,5
54056,4,3,189517,189517,189520,0,3,1
54057,4,2,189521,189521,189523,0,2,1
54058,5,1,189526,189526,189527,0,1,3
54059,1,3,189527,189527,189530,0,3,0
54060,1,2,189528,189530,189532,2,4,0
54061,5,2,189533,189533,189535,0,2,1
54062,1,2,189534,189535,189537,1,3,0
54063,1,2,189535,189537,189539,2,4,0
54064,2,3,189537,189539,189542,2,5,0
54065,2,3,189539,189542,189545,3,6,0
54066,5,3,189544,189545,189548,1,4,0
54067,2,3,189546,189548,189551,2,5,0
54068,1,1,189547,189551,189552,4,5,0
54069,2,2,189549,189552,189554,3,5,0
54070,1,1,189550,189554,189555,4,5,0
54071,6,2,189556,189556,189558,0,2,1
54072,4,1,189560,189560,189561,0,1,2
54073,5,3,189565,189565,189568,0,3,4
54074,2,3,189567,189568,189571,1,4,0
54075,6,1,189573,189573,189574,0,1,2
54076,1,2,189574,189574,189576,0,2,0
54077,4,3,189578,189578,189581,0,3,2
54078,6,2,189584,189584,189586,0,2,3
54079,1,2,189585,189586,189588,1,3,0
54080,1,1,189586,189588,189589,2,3,0
54081,6,3,189592,189592,189595,0,3,3
54082,6,3,189598,189598,189601,0,3,3
54083,6,2,189604,189604,189606,0,2,3
54084,2,2,189606,189606,189608,0,2,0
54085,1,1,189607,189608,189609,1,2,0
54086,5,3,189612,189612,189615,0,3,3
54087,3,1,189615,189615,189616,0,1,0
54088,1,3,189616,189616,189619,0,3,0
54089,4,3,189620,189620,189623,0,3,1
54090,5,3,189625,189625,189628,0,3,2
54091,5,2,189630,189630,189632,0,2,2
54092,2,1,189632,189632,189633,0,1,0
54093,5,2,189637,189637,189639,0,2,4
54094,1,1,189638,189639,189640,1,2,0
54095,5,2,189643,189643,189645,0,2,3
54096,6,2,189649,189649,189651,0,2,4
54097,4,3,189653,189653,189656,0,3,2
54098,2,2,189655,189656,189658,1,3,0
54099,1,1,189656,189658,189659,2,3,0
54100,1,2,189657,189659,189661,2,4,0
54101,4,1,189661,189661,189662,0,1,0
54102,4,2,189665,189665,189667,0,2,3
54103,6,3,189671,189671,189674,0,3,4
54104,4,2,189675,189675,189677,0,2,1
54105,1,2,189676,189677,189679,1,3,0
54106,1,2,189677,189679,189681,2,4,0
54107,1,2,189678,189681,189683,3,5,0
54108,4,3,189682,189683,189686,1,4,0
54109,6,1,189688,189688,189689,0,1,2
54110,6,1,189694,189694,189695,0,1,5
54111,2,1,189696,189696,189697,0,1,1
54112,3,2,189699,189699,189701,0,2,2
54113,5,2,189704,189704,189706,0,2,3
54114,2,2,189706,189706,189708,0,2,0
54115,2,2,189708,189708,189710,0,2,0
54116,2,2,189710,189710,189712,0,2,0
54117,4,1,189714,189714,189715,0,1,2
54118,5,1,189719,189719,189720,0,1,4
54119,1,1,189720,189720,189721,0,1,0
54120,4,3,189724,189724,189727,0,3,3
54121,5,1,189729,189729,189730,0,1,2
54122,4,2,189733,189733,189735,0,2,3
54123,5,2,189738,189738,189740,0,2,3
54124,2,1,189740,189740,189741,0,1,0
54125,1,2,189741,189741,189743,0,2,0
54126,6,2,189747,189747,189749,0,2,4
54127,4,1,189751,189751,189752,0,1,2
54128,5,3,189756,189756,189759,0,3,4
54129,4,3,189760,189760,189763,0,3,1
54130,1,1,189761,189763,189764,2,3,0
54131,3,2,189764,189764,189766,0,2,0
54132,6,1,189770,189770,189771,0,1,4
54133,2,3,189772,189772,189775,0,3,1
54134,5,1,189777,189777,189778,0,1,2
54135,1,3,189778,189778,189781,0,3,0
54136,2,2,189780,189781,189783,1,3,0
54137,4,3,189784,189784,189787,0,3,1
54138,5,2,189789,189789,189791,0,2,2
54139,2,1,189791,189791,189792,0,1,0
54140,3,1,189794,189794,189795,0,1,2
54141,4,3,189798,189798,189801,0,3,3
54142,5,3,189803,189803,189806,0,3,2
54143,6,3,189809,189809,189812,0,3,3
54144,4,3,189813,189813,189816,0,3,1
54145,3,3,189816,189816,189819,0,3,0
54146,4,2,189820,189820,189822,0,2,1
54147,6,1,189826,189826,189827,0,1,4
54148,5,1,189831,189831,189832,0,1,4
54149,2,3,189833,189833,189836,0,3,1
54150,4,3,189837,189837,189840,0,3,1
54151,5,3,189842,189842,189845,0,3,2
54152,2,3,189844,189845,189848,1,4,0
54153,3,1,189847,189848,189849,1,2,0
54154,4,2,189851,189851,189853,0,2,2
54155,1,2,189852,189853,189855,1,3,0
54156,3,2,189855,189855,189857,0,2,0
54157,3,3,189858,189858,189861,0,3,1
54158,5,3,189863,189863,189866,0,3,2
54159,5,1,189868,189868,189869,0,1,2
54160,5,3,189873,189873,189876,0,3,4
54161,4,3,189877,189877,189880,0,3,1
54162,2,2,189879,189880,189882,1,3,0
54163,4,2,189883,189883,189885,0,2,1
54164,5,1,189888,189888,189889,0,1,3
54165,5,1,189893,189893,189894,0,1,4
54166,5,2,189898,189898,189900,0,2,4
54167,1,2,189899,189900,189902,1,3,0
54168,3,2,189902,189902,189904,0,2,0
54169,6,2,189908,189908,189910,0,2,4
54170,2,1,189910,189910,189911,0,1,0
54171,6,2,189916,189916,189918,0,2,5
54172,4,2,189920,189920,189922,0,2,2
54173,5,3,189925,189925,189928,0,3,3
54174,1,2,189926,189928,189930,2,4,0
54175,6,2,189932,189932,189934,0,2,2
54176,4,2,189936,189936,189938,0,2,2
54177,4,3,189940,189940,189943,0,3,2
54178,4,3,189944,189944,189947,0,3,1
54179,1,1,189945,189947,189948,2,3,0
54180,6,1,189951,189951,189952,0,1,3
54181,3,3,189954,189954,189957,0,3,2
54182,5,1,189959,189959,189960,0,1,2
54183,4,2,189963,189963,189965,0,2,3
54184,2,3,189965,189965,189968,0,3,0
54185,2,1,189967,189968,189969,1,2,0
54186,2,3,189969,189969,189972,0,3,0
54187,6,3,189975,189975,189978,0,3,3
54188,2,2,189977,189978,189980,1,3,0
54189,5,2,189982,189982,189984,0,2,2
54190,4,1,189986,189986,189987,0,1,2
54191,2,2,189988,189988,189990,0,2,1
54192,2,1,189990,189990,189991,0,1,0
54193,2,2,189992,189992,189994,0,2,1
54194,6,3,189998,189998,190001,0,3,4
54195,6,1,190004,190004,190005,0,1,3
54196,1,2,190005,190005,190007,0,2,0
54197,6,3,190011,190011,190014,0,3,4
54198,5,3,190016,190016,190019,0,3,2
54199,1,3,190017,190019,190022,2,5,0
54200,2,3,190019,190022,190025,3,6,0
54201,2,1,190021,190025,190026,4,5,0
54202,5,2,190026,190026,190028,0,2,0
54203,2,3,190028,190028,190031,0,3,0
54204,3,2,190031,190031,190033,0,2,0
54205,1,2,190032,190033,190035,1,3,0
54206,2,3,190034,190035,190038,1,4,0
54207,5,3,190039,190039,190042,0,3,1
54208,4,2,190043,190043,190045,0,2,1
54209,2,2,190045,190045,190047,0,2,0
54210,2,3,190047,190047,190050,0,3,0
54211,5,1,190052,190052,190053,0,1,2
54212,2,3,190054,190054,190057,0,3,1
54213,2,1,190056,190057,190058,1,2,0
54214,1,2,190057,190058,190060,1,3,0
54215,1,2,190058,190060,190062,2,4,0
54216,1,3,190059,190062,190065,3,6,0
54217,2,2,190061,190065,190067,4,6,0
54218,5,1,190066,190067,190068,1,2,0
54219,2,1,190068,190068,190069,0,1,0
54220,3,3,190071,190071,190074,0,3,2
54221,6,3,190077,190077,190080,0,3,3
54222,5,3,190082,190082,190085,0,3,2
54223,5,1,190087,190087,190088,0,1,2
54224,6,2,190093,190093,190095,0,2,5
54225,6,2,190099,190099,190101,0,2,4
54226,3,3,190102,190102,190105,0,3,1
54227,6,2,190108,190108,190110,0,2,3
54228,1,1,190109,190110,190111,1,2,0
54229,4,2,190113,190113,190115,0,2,2
54230,3,1,190116,190116,190117,0,1,1
54231,3,2,190119,190119,190121,0,2,2
54232,5,3,190124,190124,190127,0,3,3
54233,2,2,190126,190127,190129,1,3,0
54234,5,3,190131,190131,190134,0,3,2
54235,1,3,190132,190134,190137,2,5,0
54236,6,3,190138,190138,190141,0,3,1
54237,2,1,190140,190141,190142,1,2,0
54238,3,2,190143,190143,190145,0,2,1
54239,4,3,190147,190147,190150,0,3,2
54240,1,3,190148,190150,190153,2,5,0
54241,6,3,190154,190154,190157,0,3,1
54242,2,2,190156,190157,190159,1,3,0
54243,2,3,190158,190159,190162,1,4,0
54244,5,1,190163,190163,190164,0,1,1
54245,5,1,190168,190168,190169,0,1,4
54246,4,2,190172,190172,190174,0,2,3
54247,2,1,190174,190174,190175,0,1,0
54248,6,2,190180,190180,190182,0,2,5
54249,1,1,190181,190182,190183,1,2,0
54250,2,3,190183,190183,190186,0,3,0
54251,2,2,190185,190186,190188,1,3,0
54252,3,2,190188,190188,190190,0,2,0
54253,1,2,190189,190190,190192,1,3,0
54254,2,2,190191,190192,190194,1,3,0
54255,3,1,190194,190194,190195,0,1,0
54256,4,3,190198,190198,190201,0,3,3
54257,5,2,190203,190203,190205,0,2,2
54258,6,3,190209,190209,190212,0,3,4
54259,3,2,190212,190212,190214,0,2,0
54260,6,1,190218,190218,190219,0,1,4
54261,2,1,190220,190220,190221,0,1,1
54262,6,1,190226,190226,190227,0,1,5
54263,3,2,190229,190229,190231,0,2,2
54264,6,1,190235,190235,190236,0,1,4
54265,1,3,190236,190236,190239,0,3,0
54266,4,2,190240,190240,190242,0,2,1
54267,4,3,190244,190244,190247,0,3,2
54268,6,2,190250,190250,190252,0,2,3
54269,4,2,190254,190254,190256,0,2,2
54270,4,3,190258,190258,190261,0,3,2
54271,1,3,190259,190261,190264,2,5,0
54272,2,2,190261,190264,190266,3,5,0
54273,4,1,190265,190266,190267,1,2,0
54274,6,1,190271,190271,190272,0,1,4
54275,4,2,190275,190275,190277,0,2,3
54276,2,3,190277,190277,190280,0,3,0
54277,3,1,190280,190280,190281,0,1,0
54278,2,2,190282,190282,190284,0,2,1
54279,4,3,190286,190286,190289,0,3,2
54280,6,1,190292,190292,190293,0,1,3
54281,1,3,190293,190293,190296,0,3,0
54282,2,1,190295,190296,190297,1,2,0
54283,4,3,190299,190299,190302,0,3,2
54284,1,1,190300,190302,190303,2,3,0
54285,1,3,190301,190303,190306,2,5,0
54286,6,1,190307,190307,190308,0,1,1
54287,5,3,190312,190312,190315,0,3,4
54288,5,1,190317,190317,190318,0,1,2
54289,2,3,190319,190319,190322,0,3,1
54290,3,2,190322,190322,190324,0,2,0
54291,4,3,190326,190326,190329,0,3,2
54292,5,3,190331,190331,190334,0,3,2
54293,5,2,190336,190336,190338,0,2,2
54294,6,3,190342,190342,190345,0,3,4
54295,3,2,190345,190345,190347,0,2,0
54296,2,3,190347,190347,190350,0,3,0
54297,3,3,190350,190350,190353,0,3,0
54298,6,2,190356,190356,190358,0,2,3
54299,4,1,190360,190360,190361,0,1,2
54300,3,3,190363,190363,190366,0,3,2
54301,2,3,190365,190366,190369,1,4,0
54302,5,2,190370,190370,190372,0,2,1
54303,6,1,190376,190376,190377,0,1,4
54304,3,1,190379,190379,190380,0,1,2
54305,2,1,190381,190381,190382,0,1,1
54306,1,2,190382,190382,190384,0,2,0
54307,2,2,190384,190384,190386,0,2,0
54308,4,2,190388,190388,190390,0,2,2
54309,6,2,190394,190394,190396,0,2,4
54310,3,2,190397,190397,190399,0,2,1
54311,4,3,190401,190401,190404,0,3,2
54312,5,1,190406,190406,190407,0,1,2
54313,1,1,190407,190407,190408,0,1,0
54314,6,2,190413,190413,190415,0,2,5
54315,4,3,190417,190417,190420,0,3,2
54316,4,3,190421,190421,190424,0,3,1
54317,5,2,190426,190426,190428,0,2,2
54318,6,3,190432,190432,190435,0,3,4
54319,3,1,190435,190435,190436,0,1,0
54320,1,2,190436,190436,190438,0,2,0
54321,5,1,190441,190441,190442,0,1,3
54322,1,2,190442,190442,190444,0,2,0
54323,1,3,190443,190444,190447,1,4,0
54324,4,2,190447,190447,190449,0,2,0
54325,1,3,190448,190449,190452,1,4,0
54326,6,1,190454,190454,190455,0,1,2
54327,1,2,190455,190455,190457,0,2,0
54328,4,2,190459,190459,190461,0,2,2
54329,5,2,190464,190464,190466,0,2,3
54330,5,2,190469,190469,190471,0,2,3
54331,1,3,190470,190471,190474,1,4,0
54332,5,2,190475,190475,190477,0,2,1
54333,3,3,190478,190478,190481,0,3,1
54334,4,1,190482,190482,190483,0,1,1
54335,5,2,190487,190487,190489,0,2,4
54336,5,1,190492,190492,190493,0,1,3
54337,5,1,190497,190497,190498,0,1,4
54338,3,1,190500,190500,190501,0,1,2
54339,4,3,190504,190504,190507,0,3,3
54340,1,1,190505,190507,190508,2,3,0
54341,2,3,190507,190508,190511,1,4,0
54342,1,3,190508,190511,190514,3,6,0
54343,1,2,190509,190514,190516,5,7,0
54344,6,3,190515,190516,190519,1,4,0
54345,3,1,190518,190519,190520,1,2,0
54346,6,3,190524,190524,190527,0,3,4
54347,4,2,190528,190528,190530,0,2,1
54348,1,3,190529,190530,190533,1,4,0
54349,1,1,190530,190533,190534,3,4,0
54350,5,2,190535,190535,190537,0,2,1
54351,5,2,190540,190540,190542,0,2,3
54352,2,1,190542,190542,190543,0,1,0
54353,5,2,190547,190547,190549,0,2,4
54354,6,1,190553,190553,190554,0,1,4
54355,2,3,190555,190555,190558,0,3,1
54356,1,1,190556,190558,190559,2,3,0
54357,5,3,190561,190561,190564,0,3,2
54358,5,3,190566,190566,190569,0,3,2
54359,5,1,190571,190571,190572,0,1,2
54360,3,3,190574,190574,190577,0,3,2
54361,3,2,190577,190577,190579,0,2,0
54362,3,2,190580,190580,190582,0,2,1
54363,2,3,190582,190582,190585,0,3,0
54364,5,1,190587,190587,190588,0,1,2
54365,1,2,190588,190588,190590,0,2,0
54366,1,1,190589,190590,190591,1,2,0
54367,2,3,190591,190591,190594,0,3,0
54368,1,3,190592,190594,190597,2,5,0
54369,4,3,190596,190597,190600,1,4,0
54370,5,3,190601,190601,190604,0,3,1
54371,1,3,190602,190604,190607,2,5,0
54372,5,2,190607,190607,190609,0,2,0
54373,3,2,190610,190610,190612,0,2,1
54374,4,2,190614,190614,190616,0,2,2
54375,6,1,190620,190620,190621,0,1,4
54376,4,2,190624,190624,190626,0,2,3
54377,1,1,190625,190626,190627,1,2,0
54378,1,1,190626,190627,190628,1,2,0
54379,1,1,190627,190628,190629,1,2,0
54380,4,2,190631,190631,190633,0,2,2
54381,3,1,190634,190634,190635,0,1,1
54382,4,3,190638,190638,190641,0,3,3
54383,2,2,190640,190641,190643,1,3,0
54384,6,3,190646,190646,190649,0,3,3
54385,6,2,190652,190652,190654,0,2,3
54386,2,2,190654,190654,190656,0,2,0
54387,2,3,190656,190656,190659,0,3,0
54388,1,3,190657,190659,190662,2,5,0
54389,4,2,190661,190662,190664,1,3,0
54390,1,1,190662,190664,190665,2,3,0
54391,5,2,190667,190667,190669,0,2,2
54392,2,3,190669,190669,190672,0,3,0
54393,3,3,190672,190672,190675,0,3,0
54394,6,1,190678,190678,190679,0,1,3
54395,3,2,190681,190681,190683,0,2,2
54396,6,2,190687,190687,190689,0,2,4
54397,6,3,190693,190693,190696,0,3,4
54398,2,3,190695,190696,190699,1,4,0
54399,2,1,190697,190699,190700,2,3,0
54400,3,1,190700,190700,190701,0,1,0
54401,4,2,190704,190704,190706,0,2,3
54402,1,1,190705,190706,190707,1,2,0
54403,4,2,190709,190709,190711,0,2,2
54404,2,3,190711,190711,190714,0,3,0
54405,3,3,190714,190714,190717,0,3,0
54406,4,2,190718,190718,190720,0,2,1
54407,6,1,190724,190724,190725,0,1,4
54408,6,1,190730,190730,190731,0,1,5
54409,5,1,190735,190735,190736,0,1,4
54410,5,2,190740,190740,190742,0,2,4
54411,6,2,190746,190746,190748,0,2,4
54412,1,1,190747,190748,190749,1,2,0
54413,2,2,190749,190749,190751,0,2,0
54414,2,1,190751,190751,190752,0,1,0
54415,5,1,190756,190756,190757,0,1,4
54416,3,3,190759,190759,190762,0,3,2
54417,1,1,190760,190762,190763,2,3,0
54418,5,1,190765,190765,190766,0,1,2
54419,6,1,190771,190771,190772,0,1,5
54420,6,3,190777,190777,190780,0,3,5
54421,6,3,190783,190783,190786,0,3,3
54422,3,3,190786,190786,190789,0,3,0
54423,1,2,190787,190789,190791,2,4,0
54424,4,2,190791,190791,190793,0,2,0
54425,1,3,190792,190793,190796,1,4,0
54426,2,1,190794,190796,190797,2,3,0
54427,5,3,190799,190799,190802,0,3,2
54428,3,3,190802,190802,190805,0,3,0
54429,6,3,190808,190808,190811,0,3,3
54430,3,3,190811,190811,190814,0,3,0
54431,6,1,190817,190817,190818,0,1,3
54432,3,3,190820,190820,190823,0,3,2
54433,4,3,190824,190824,190827,0,3,1
54434,4,2,190828,190828,190830,0,2,1
54435,3,1,190831,190831,190832,0,1,1
54436,5,2,190836,190836,190838,0,2,4
54437,2,2,190838,190838,190840,0,2,0
54438,3,3,190841,190841,190844,0,3,1
54439,6,2,190847,190847,190849,0,2,3
54440,5,3,190852,190852,190855,0,3,3
54441,1,2,190853,190855,190857,2,4,0
54442,4,2,190857,190857,190859,0,2,0
54443,3,2,190860,190860,190862,0,2,1
54444,4,2,190864,190864,190866,0,2,2
54445,5,1,190869,190869,190870,0,1,3
54446,2,2,190871,190871,190873,0,2,1
54447,4,3,190875,190875,190878,0,3,2
54448,2,1,190877,190878,190879,1,2,0
54449,2,3,190879,190879,190882,0,3,0
54450,2,2,190881,190882,190884,1,3,0
54451,5,2,190886,190886,190888,0,2,2
54452,3,1,190889,190889,190890,0,1,1
54453,3,2,190892,190892,190894,0,2,2
54454,5,1,190897,190897,190898,0,1,3
54455,1,1,190898,190898,190899,0,1,0
54456,1,3,190899,190899,190902,0,3,0
54457,3,3,190902,190902,190905,0,3,0
54458,2,2,190904,190905,190907,1,3,0
54459,4,2,190908,190908,190910,0,2,1
54460,1,1,190909,190910,190911,1,2,0
54461,3,3,190912,190912,190915,0,3,1
54462,5,1,190917,190917,190918,0,1,2
54463,3,2,190920,190920,190922,0,2,2
54464,6,3,190926,190926,190929,0,3,4
54465,5,1,190931,190931,190932,0,1,2
54466,2,3,190933,190933,190936,0,3,1
54467,1,3,190934,190936,190939,2,5,0
54468,3,2,190937,190939,190941,2,4,0
54469,1,3,190938,190941,190944,3,6,0
54470,2,2,190940,190944,190946,4,6,0
54471,5,3,190945,190946,190949,1,4,0
54472,5,3,190950,190950,190953,0,3,1
54473,6,3,190956,190956,190959,0,3,3
54474,5,1,190961,190961,190962,0,1,2
54475,3,2,190964,190964,190966,0,2,2
54476,2,2,190966,190966,190968,0,2,0
54477,4,2,190970,190970,190972,0,2,2
54478,5,3,190975,190975,190978,0,3,3
54479,2,2,190977,190978,190980,1,3,0
54480,4,1,190981,190981,190982,0,1,1
54481,5,2,190986,190986,190988,0,2,4
54482,6,1,190992,190992,190993,0,1,4
54483,1,2,190993,190993,190995,0,2,0
54484,4,3,190997,190997,191000,0,3,2
54485,2,1,190999,191000,191001,1,2,0
54486,1,1,191000,191001,191002,1,2,0
54487,5,2,191005,191005,191007,0,2,3
54488,5,2,191010,191010,191012,0,2,3
54489,3,2,191013,191013,191015,0,2,1
54490,3,1,191016,191016,191017,0,1,1
54491,3,3,191019,191019,191022,0,3,2
54492,1,3,191020,191022,191025,2,5,0
54493,3,1,191023,191025,191026,2,3,0
54494,3,1,191026,191026,191027,0,1,0
54495,1,3,191027,191027,191030,0,3,0
54496,6,3,191033,191033,191036,0,3,3
54497,1,1,191034,191036,191037,2,3,0
54498,1,2,191035,191037,191039,2,4,0
54499,2,2,191037,191039,191041,2,4,0
54500,5,1,191042,191042,191043,0,1,1
54501,3,3,191045,191045,191048,0,3,2
54502,3,2,191048,191048,191050,0,2,0
54503,3,2,191051,191051,191053,0,2,1
54504,6,3,191057,191057,191060,0,3,4
54505,1,3,191058,191060,191063,2,5,0
54506,3,2,191061,191063,191065,2,4,0
54507,5,3,191066,191066,191069,0,3,1
54508,4,3,191070,191070,191073,0,3,1
54509,6,1,191076,191076,191077,0,1,3
54510,5,3,191081,191081,191084,0,3,4
54511,4,3,191085,191085,191088,0,3,1
54512,1,2,191086,191088,191090,2,4,0
54513,5,2,191091,191091,191093,0,2,1
54514,5,2,191096,191096,191098,0,2,3
54515,4,2,191100,191100,191102,0,2,2
54516,3,1,191103,191103,191104,0,1,1
54517,4,2,191107,191107,191109,0,2,3
54518,4,3,191111,191111,191114,0,3,2
54519,2,2,191113,191114,191116,1,3,0
54520,5,2,191118,191118,191120,0,2,2
54521,2,2,191120,191120,191122,0,2,0
54522,2,2,191122,191122,191124,0,2,0
54523,3,3,191125,191125,191128,0,3,1
54524,6,2,191131,191131,191133,0,2,3
54525,3,2,191134,191134,191136,0,2,1
54526,2,2,191136,191136,191138,0,2,0
54527,1,3,191137,191138,191141,1,4,0
54528,6,1,191143,191143,191144,0,1,2
54529,3,1,191146,191146,191147,0,1,2
54530,1,2,191147,191147,191149,0,2,0
54531,5,2,191152,191152,191154,0,2,3
54532,4,1,191156,191156,191157,0,1,2
54533,4,3,191160,191160,191163,0,3,3
54534,6,1,191166,191166,191167,0,1,3
54535,4,1,191170,191170,191171,0,1,3
54536,5,2,191175,191175,191177,0,2,4
54537,2,1,191177,191177,191178,0,1,0
54538,5,1,191182,191182,191183,0,1,4
54539,5,1,191187,191187,191188,0,1,4
54540,5,2,191192,191192,191194,0,2,4
54541,3,2,191195,191195,191197,0,2,1
54542,5,3,191200,191200,191203,0,3,3
54543,2,1,191202,191203,191204,1,2,0
54544,3,1,191205,191205,191206,0,1,1
54545,3,3,191208,191208,191211,0,3,2
54546,4,3,191212,191212,191215,0,3,1
54547,1,2,191213,191215,191217,2,4,0
54548,5,1,191218,191218,191219,0,1,1
54549,6,2,191224,191224,191226,0,2,5
54550,4,1,191228,191228,191229,0,1,2
54551,5,1,191233,191233,191234,0,1,4
54552,1,2,191234,191234,191236,0,2,0
54553,2,1,191236,191236,191237,0,1,0
54554,3,3,191239,191239,191242,0,3,2
54555,4,3,191243,191243,191246,0,3,1
54556,5,3,191248,191248,191251,0,3,2
54557,5,1,191253,191253,191254,0,1,2
54558,1,3,191254,191254,191257,0,3,0
54559,4,2,191258,191258,191260,0,2,1
54560,6,3,191264,191264,191267,0,3,4
54561,4,3,191268,191268,191271,0,3,1
54562,3,3,191271,191271,191274,0,3,0
54563,5,1,191276,191276,191277,0,1,2
54564,1,2,191277,191277,191279,0,2,0
54565,1,1,191278,191279,191280,1,2,0
54566,6,1,191284,191284,191285,0,1,4
54567,3,1,191287,191287,191288,0,1,2
54568,5,3,191292,191292,191295,0,3,4
54569,6,3,191298,191298,191301,0,3,3
54570,2,1,191300,191301,191302,1,2,0
54571,5,1,191305,191305,191306,0,1,3
54572,5,3,191310,191310,191313,0,3,4
54573,3,3,191313,191313,191316,0,3,0
54574,6,3,191319,191319,191322,0,3,3
54575,4,3,191323,191323,191326,0,3,1
54576,1,2,191324,191326,191328,2,4,0
54577,3,1,191327,191328,191329,1,2,0
54578,1,3,191328,191329,191332,1,4,0
54579,4,2,191332,191332,191334,0,2,0
54580,6,2,191338,191338,191340,0,2,4
54581,2,2,191340,191340,191342,0,2,0
54582,4,1,191344,191344,191345,0,1,2
54583,2,1,191346,191346,191347,0,1,1
54584,1,2,191347,191347,191349,0,2,0
54585,3,2,191350,191350,191352,0,2,1
54586,2,2,191352,191352,191354,0,2,0
54587,1,1,191353,191354,191355,1,2,0
54588,4,2,191357,191357,191359,0,2,2
54589,4,2,191361,191361,191363,0,2,2
54590,1,2,191362,191363,191365,1,3,0
54591,2,1,191364,191365,191366,1,2,0
54592,3,2,191367,191367,191369,0,2,1
54593,2,2,191369,191369,191371,0,2,0
54594,6,2,191375,191375,191377,0,2,4
54595,1,3,191376,191377,191380,1,4,0
54596,4,1,191380,191380,191381,0,1,0
54597,6,3,191386,191386,191389,0,3,5
54598,6,2,191392,191392,191394,0,2,3
54599,1,3,191393,191394,191397,1,4,0
54600,1,1,191394,191397,191398,3,4,0
54601,5,3,191399,191399,191402,0,3,1
54602,6,3,191405,191405,191408,0,3,3
54603,2,1,191407,191408,191409,1,2,0
54604,4,3,191411,191411,191414,0,3,2
54605,5,1,191416,191416,191417,0,1,2
54606,3,3,191419,191419,191422,0,3,2
54607,2,1,191421,191422,191423,1,2,0
54608,4,2,191425,191425,191427,0,2,2
54609,3,2,191428,191428,191430,0,2,1
54610,3,1,191431,191431,191432,0,1,1
54611,2,3,191433,191433,191436,0,3,1
54612,6,2,191439,191439,191441,0,2,3
54613,5,2,191444,191444,191446,0,2,3
54614,2,3,191446,191446,191449,0,3,0
54615,5,2,191451,191451,191453,0,2,2
54616,2,1,191453,191453,191454,0,1,0
54617,1,3,191454,191454,191457,0,3,0
54618,5,3,191459,191459,191462,0,3,2
54619,2,1,191461,191462,191463,1,2,0
54620,1,3,191462,191463,191466,1,4,0
54621,4,3,191466,191466,191469,0,3,0
54622,3,2,191469,191469,191471,0,2,0
54623,6,3,191475,191475,191478,0,3,4
54624,2,1,191477,191478,191479,1,2,0
54625,5,1,191482,191482,191483,0,1,3
54626,5,2,191487,191487,191489,0,2,4
54627,3,3,191490,191490,191493,0,3,1
54628,6,1,191496,191496,191497,0,1,3
54629,2,1,191498,191498,191499,0,1,1
54630,6,2,191504,191504,191506,0,2,5
54631,5,2,191509,191509,191511,0,2,3
54632,3,2,191512,191512,191514,0,2,1
54633,6,1,191518,191518,191519,0,1,4
54634,5,3,191523,191523,191526,0,3,4
54635,1,3,191524,191526,191529,2,5,0
54636,5,3,191529,191529,191532,0,3,0
54637,2,3,191531,191532,191535,1,4,0
54638,6,1,191537,191537,191538,0,1,2
54639,4,1,191541,191541,191542,0,1,3
54640,2,2,191543,191543,191545,0,2,1
54641,5,1,191548,191548,191549,0,1,3
54642,2,1,191550,191550,191551,0,1,1
54643,1,1,191551,191551,191552,0,1,0
54644,6,1,191557,191557,191558,0,1,5
54645,3,1,191560,191560,191561,0,1,2
54646,2,3,191562,191562,191565,0,3,1
54647,5,2,191567,191567,191569,0,2,2
54648,6,1,191573,191573,191574,0,1,4
54649,1,3,191574,191574,191577,0,3,0
54650,1,3,191575,191577,191580,2,5,0
54651,1,2,191576,191580,191582,4,6,0
54652,3,2,191579,191582,191584,3,5,0
54653,3,1,191582,191584,191585,2,3,0
54654,4,3,191586,191586,191589,0,3,1
54655,2,2,191588,191589,191591,1,3,0
54656,1,3,191589,191591,191594,2,5,0
54657,3,1,191592,191594,191595,2,3,0
54658,2,3,191594,191595,191598,1,4,0
54659,5,2,191599,191599,191601,0,2,1
54660,3,3,191602,191602,191605,0,3,1
54661,3,1,191605,191605,191606,0,1,0
54662,3,3,191608,191608,191611,0,3,2
54663,6,2,191614,191614,191616,0,2,3
54664,6,3,191620,191620,191623,0,3,4
54665,6,1,191626,191626,191627,0,1,3
54666,3,3,191629,191629,191632,0,3,2
54667,1,2,191630,191632,191634,2,4,0
54668,4,3,191634,191634,191637,0,3,0
54669,5,1,191639,191639,191640,0,1,2
54670,4,3,191643,191643,191646,0,3,3
54671,3,1,191646,191646,191647,0,1,0
54672,4,2,191650,191650,191652,0,2,3
54673,3,1,191653,191653,191654,0,1,1
54674,5,3,191658,191658,191661,0,3,4
54675,2,1,191660,191661,191662,1,2,0
54676,1,2,191661,191662,191664,1,3,0
54677,4,3,191665,191665,191668,0,3,1
54678,3,2,191668,191668,191670,0,2,0
54679,2,2,191670,191670,191672,0,2,0
54680,4,3,191674,191674,191677,0,3,2
54681,6,3,191680,191680,191683,0,3,3
54682,6,2,191686,191686,191688,0,2,3
54683,6,1,191692,191692,191693,0,1,4
54684,3,1,191695,191695,191696,0,1,2
54685,6,1,191701,191701,191702,0,1,5
54686,6,1,191707,191707,191708,0,1,5
54687,1,1,191708,191708,191709,0,1,0
54688,4,3,191712,191712,191715,0,3,3
54689,2,2,191714,191715,191717,1,3,0
54690,1,2,191715,191717,191719,2,4,0
54691,1,3,191716,191719,191722,3,6,0
54692,1,1,191717,191722,191723,5,6,0
54693,5,2,191722,191723,191725,1,3,0
54694,1,3,191723,191725,191728,2,5,0
54695,2,3,191725,191728,191731,3,6,0
54696,1,1,191726,191731,191732,5,6,0
54697,2,2,191728,191732,191734,4,6,0
54698,3,2,191731,191734,191736,3,5,0
54699,5,1,191736,191736,191737,0,1,0
54700,2,3,191738,191738,191741,0,3,1
54701,6,1,191744,191744,191745,0,1,3
54702,1,2,191745,191745,191747,0,2,0
54703,5,1,191750,191750,191751,0,1,3
54704,2,1,191752,191752,191753,0,1,1
54705,6,2,191758,191758,191760,0,2,5
54706,5,3,191763,191763,191766,0,3,3
54707,5,2,191768,191768,191770,0,2,2
54708,2,2,191770,191770,191772,0,2,0
54709,4,2,191774,191774,191776,0,2,2
54710,2,3,191776,191776,191779,0,3,0
54711,2,1,191778,191779,191780,1,2,0
54712,4,3,191782,191782,191785,0,3,2
54713,6,2,191788,191788,191790,0,2,3
54714,6,3,191794,191794,191797,0,3,4
54715,1,3,191795,191797,191800,2,5,0
54716,1,3,191796,191800,191803,4,7,0
54717,4,1,191800,191803,191804,3,4,0
54718,2,3,191802,191804,191807,2,5,0
54719,2,3,191804,191807,191810,3,6,0
54720,3,1,191807,191810,191811,3,4,0
54721,4,2,191811,191811,191813,0,2,0
54722,4,2,191815,191815,191817,0,2,2
54723,5,3,191820,191820,191823,0,3,3
54724,6,3,191826,191826,191829,0,3,3
54725,3,1,191829,191829,191830,0,1,0
54726,5,3,191834,191834,191837,0,3,4
54727,4,3,191838,191838,191841,0,3,1
54728,1,1,191839,191841,191842,2,3,0
54729,4,3,191843,191843,191846,0,3,1
54730,5,2,191848,191848,191850,0,2,2
54731,3,3,191851,191851,191854,0,3,1
54732,2,2,191853,191854,191856,1,3,0
54733,1,1,191854,191856,191857,2,3,0
54734,1,3,191855,191857,191860,2,5,0
54735,5,1,191860,191860,191861,0,1,0
54736,1,3,191861,191861,191864,0,3,0
54737,3,1,191864,191864,191865,0,1,0
54738,4,1,191868,191868,191869,0,1,3
54739,3,3,191871,191871,191874,0,3,2
54740,5,3,191876,191876,191879,0,3,2
54741,5,2,191881,191881,191883,0,2,2
54742,4,2,191885,191885,191887,0,2,2
54743,3,1,191888,191888,191889,0,1,1
54744,2,2,191890,191890,191892,0,2,1
54745,5,3,191895,191895,191898,0,3,3
54746,1,3,191896,191898,191901,2,5,0
54747,4,2,191900,191901,191903,1,3,0
54748,2,1,191902,191903,191904,1,2,0
54749,5,3,191907,191907,191910,0,3,3
54750,1,1,191908,191910,191911,2,3,0
54751,6,3,191914,191914,191917,0,3,3
54752,1,2,191915,191917,191919,2,4,0
54753,6,1,191921,191921,191922,0,1,2
54754,4,1,191925,191925,191926,0,1,3
54755,2,3,191927,191927,191930,0,3,1
54756,1,1,191928,191930,191931,2,3,0
54757,3,1,191931,191931,191932,0,1,0
54758,2,2,191933,191933,191935,0,2,1
54759,4,3,191937,191937,191940,0,3,2
54760,6,3,191943,191943,191946,0,3,3
54761,5,2,191948,191948,191950,0,2,2
54762,2,3,191950,191950,191953,0,3,0
54763,3,2,191953,191953,191955,0,2,0
54764,3,1,191956,191956,191957,0,1,1
54765,6,2,191962,191962,191964,0,2,5
54766,6,2,191968,191968,191970,0,2,4
54767,1,1,191969,191970,191971,1,2,0
54768,6,3,191975,191975,191978,0,3,4
54769,6,2,191981,191981,191983,0,2,3
54770,1,3,191982,191983,191986,1,4,0
54771,1,1,191983,191986,191987,3,4,0
54772,2,1,191985,191987,191988,2,3,0
54773,6,1,191991,191991,191992,0,1,3
54774,4,1,191995,191995,191996,0,1,3
54775,2,2,191997,191997,191999,0,2,1
54776,1,2,191998,191999,192001,1,3,0
54777,2,2,192000,192001,192003,1,3,0
54778,2,1,192002,192003,192004,1,2,0
54779,3,1,192005,192005,192006,0,1,1
54780,1,3,192006,192006,192009,0,3,0
54781,4,3,192010,192010,192013,0,3,1
54782,6,2,192016,192016,192018,0,2,3
54783,2,1,192018,192018,192019,0,1,0
54784,4,1,192022,192022,192023,0,1,3
54785,6,1,192028,192028,192029,0,1,5
54786,5,2,192033,192033,192035,0,2,4
54787,5,3,192038,192038,192041,0,3,3
54788,6,1,192044,192044,192045,0,1,3
54789,6,1,192050,192050,192051,0,1,5
54790,2,2,192052,192052,192054,0,2,1
54791,4,3,192056,192056,192059,0,3,2
54792,5,2,192061,192061,192063,0,2,2
54793,2,3,192063,192063,192066,0,3,0
54794,1,2,192064,192066,192068,2,4,0
54795,2,3,192066,192068,192071,2,5,0
54796,2,2,192068,192071,192073,3,5,0
54797,4,2,192072,192073,192075,1,3,0
54798,4,2,192076,192076,192078,0,2,1
54799,3,2,192079,192079,192081,0,2,1
54800,5,2,192084,192084,192086,0,2,3
54801,5,1,192089,192089,192090,0,1,3
54802,1,1,192090,192090,192091,0,1,0
54803,4,2,192094,192094,192096,0,2,3
54804,3,3,192097,192097,192100,0,3,1
54805,4,1,192101,192101,192102,0,1,1
54806,6,2,192107,192107,192109,0,2,5
54807,4,3,192111,192111,192114,0,3,2
54808,6,2,192117,192117,192119,0,2,3
54809,1,3,192118,192119,192122,1,4,0
54810,5,3,192123,192123,192126,0,3,1
54811,5,3,192128,192128,192131,0,3,2
54812,1,1,192129,192131,192132,2,3,0
54813,4,2,192133,192133,192135,0,2,1
54814,6,2,192139,192139,192141,0,2,4
54815,4,3,192143,192143,192146,0,3,2
54816,3,1,192146,192146,192147,0,1,0
54817,1,2,192147,192147,192149,0,2,0
54818,6,3,192153,192153,192156,0,3,4
54819,3,1,192156,192156,192157,0,1,0
54820,1,1,192157,192157,192158,0,1,0
54821,5,1,192162,192162,192163,0,1,4
54822,4,1,192166,192166,192167,0,1,3
54823,4,2,192170,192170,192172,0,2,3
54824,3,3,192173,192173,192176,0,3,1
54825,4,2,192177,192177,192179,0,2,1
54826,4,2,192181,192181,192183,0,2,2
54827,6,1,192187,192187,192188,0,1,4
54828,6,2,192193,192193,192195,0,2,5
54829,5,1,192198,192198,192199,0,1,3
54830,3,3,192201,192201,192204,0,3,2
54831,5,3,192206,192206,192209,0,3,2
54832,3,3,192209,192209,192212,0,3,0
54833,1,1,192210,192212,192213,2,3,0
54834,3,2,192213,192213,192215,0,2,0
54835,6,1,192219,192219,192220,0,1,4
54836,6,3,192225,192225,192228,0,3,5
54837,3,1,192228,192228,192229,0,1,0
54838,3,2,192231,192231,192233,0,2,2
54839,1,2,192232,192233,192235,1,3,0
54840,1,1,192233,192235,192236,2,3,0
54841,4,2,192237,192237,192239,0,2,1
54842,1,3,192238,192239,192242,1,4,0
54843,5,3,192243,192243,192246,0,3,1
54844,5,1,192248,192248,192249,0,1,2
54845,3,3,192251,192251,192254,0,3,2
54846,2,2,192253,192254,192256,1,3,0
54847,1,1,192254,192256,192257,2,3,0
54848,3,3,192257,192257,192260,0,3,0
54849,1,2,192258,192260,192262,2,4,0
54850,6,3,192264,192264,192267,0,3,2
54851,3,3,192267,192267,192270,0,3,0
54852,1,3,192268,192270,192273,2,5,0
54853,5,1,192273,192273,192274,0,1,0
54854,2,1,192275,192275,192276,0,1,1
54855,1,3,192276,192276,192279,0,3,0
54856,4,2,192280,192280,192282,0,2,1
54857,5,3,192285,192285,192288,0,3,3
54858,5,1,192290,192290,192291,0,1,2
54859,2,2,192292,192292,192294,0,2,1
54860,6,1,192298,192298,192299,0,1,4
54861,4,1,192302,192302,192303,0,1,3
54862,2,3,192304,192304,192307,0,3,1
54863,6,2,192310,192310,192312,0,2,3
54864,6,3,192316,192316,192319,0,3,4
54865,5,3,192321,192321,192324,0,3,2
54866,6,3,192327,192327,192330,0,3,3
54867,3,2,192330,192330,192332,0,2,0
54868,5,1,192335,192335,192336,0,1,3
54869,1,3,192336,192336,192339,0,3,0
54870,2,2,192338,192339,192341,1,3,0
54871,4,3,192342,192342,192345,0,3,1
54872,4,1,192346,192346,192347,0,1,1
54873,3,2,192349,192349,192351,0,2,2
54874,6,2,192355,192355,192357,0,2,4
54875,5,3,192360,192360,192363,0,3,3
54876,2,1,192362,192363,192364,1,2,0
54877,6,2,192368,192368,192370,0,2,4
54878,5,2,192373,192373,192375,0,2,3
54879,6,2,192379,192379,192381,0,2,4
54880,1,3,192380,192381,192384,1,4,0
54881,4,1,192384,192384,192385,0,1,0
54882,4,3,192388,192388,192391,0,3,3
54883,1,3,192389,192391,192394,2,5,0
54884,1,3,192390,192394,192397,4,7,0
54885,1,1,192391,192397,192398,6,7,0
54886,6,3,192397,192398,192401,1,4,0
54887,2,1,192399,192401,192402,2,3,0
54888,4,1,192403,192403,192404,0,1,1
54889,3,1,192406,192406,192407,0,1,2
54890,1,2,192407,192407,192409,0,2,0
54891,4,3,192411,192411,192414,0,3,2
54892,5,2,192416,192416,192418,0,2,2
54893,5,3,192421,192421,192424,0,3,3
54894,3,1,192424,192424,192425,0,1,0
54895,5,1,192429,192429,192430,0,1,4
54896,6,2,192435,192435,192437,0,2,5
54897,2,2,192437,192437,192439,0,2,0
54898,4,2,192441,192441,192443,0,2,2
54899,3,3,192444,192444,192447,0,3,1
54900,2,3,192446,192447,192450,1,4,0
54901,1,2,192447,192450,192452,3,5,0
54902,2,1,192449,192452,192453,3,4,0
54903,3,2,192452,192453,192455,1,3,0
54904,1,3,192453,192455,192458,2,5,0
54905,6,3,192459,192459,192462,0,3,1
54906,6,2,192465,192465,192467,0,2,3
54907,2,1,192467,192467,192468,0,1,0
54908,1,1,192468,192468,192469,0,1,0
54909,5,3,192473,192473,192476,0,3,4
54910,1,1,192474,192476,192477,2,3,0
54911,4,3,192478,192478,192481,0,3,1
54912,2,2,192480,192481,192483,1,3,0
54913,4,2,192484,192484,192486,0,2,1
54914,2,2,192486,192486,192488,0,2,0
54915,6,2,192492,192492,192494,0,2,4
54916,6,3,192498,192498,192501,0,3,4
54917,1,1,192499,192501,192502,2,3,0
54918,4,3,192503,192503,192506,0,3,1
54919,1,3,192504,192506,192509,2,5,0
54920,2,3,192506,192509,192512,3,6,0
54921,4,3,192510,192512,192515,2,5,0
54922,3,2,192513,192515,192517,2,4,0
54923,4,2,192517,192517,192519,0,2,0
54924,3,1,192520,192520,192521,0,1,1
54925,6,2,192526,192526,192528,0,2,5
54926,1,3,192527,192528,192531,1,4,0
54927,6,3,192533,192533,192536,0,3,2
54928,3,3,192536,192536,192539,0,3,0
54929,2,2,192538,192539,192541,1,3,0
54930,5,1,192543,192543,192544,0,1,2
54931,3,2,192546,192546,192548,0,2,2
54932,1,1,192547,192548,192549,1,2,0
54933,3,3,192550,192550,192553,0,3,1
54934,6,3,192556,192556,192559,0,3,3
54935,5,3,192561,192561,192564,0,3,2
54936,4,2,192565,192565,192567,0,2,1
54937,4,1,192569,192569,192570,0,1,2
54938,5,1,192574,192574,192575,0,1,4
54939,1,3,192575,192575,192578,0,3,0
54940,6,1,192581,192581,192582,0,1,3
54941,1,3,192582,192582,192585,0,3,0
54942,3,3,192585,192585,192588,0,3,0
54943,1,3,192586,192588,192591,2,5,0
54944,4,3,192590,192591,192594,1,4,0
54945,6,3,192596,192596,192599,0,3,2
54946,5,1,192601,192601,192602,0,1,2
54947,3,2,192604,192604,192606,0,2,2
54948,5,2,192609,192609,192611,0,2,3
54949,1,2,192610,192611,192613,1,3,0
54950,3,3,192613,192613,192616,0,3,0
54951,1,1,192614,192616,192617,2,3,0
54952,3,2,192617,192617,192619,0,2,0
54953,6,3,192623,192623,192626,0,3,4
54954,2,3,192625,192626,192629,1,4,0
54955,4,2,192629,192629,192631,0,2,0
54956,5,2,192634,192634,192636,0,2,3
54957,4,2,192638,192638,192640,0,2,2
54958,2,3,192640,192640,192643,0,3,0
54959,1,1,192641,192643,192644,2,3,0
54960,2,2,192643,192644,192646,1,3,0
54961,6,1,192649,192649,192650,0,1,3
54962,1,1,192650,192650,192651,0,1,0
54963,6,1,192656,192656,192657,0,1,5
54964,2,2,192658,192658,192660,0,2,1
54965,2,2,192660,192660,192662,0,2,0
54966,3,1,192663,192663,192664,0,1,1
54967,4,1,192667,192667,192668,0,1,3
54968,4,3,192671,192671,192674,0,3,3
54969,6,1,192677,192677,192678,0,1,3
54970,6,3,192683,192683,192686,0,3,5
54971,1,3,192684,192686,192689,2,5,0
54972,2,1,192686,192689,192690,3,4,0
54973,6,1,192692,192692,192693,0,1,2
54974,3,2,192695,192695,192697,0,2,2
54975,5,1,192700,192700,192701,0,1,3
54976,5,1,192705,192705,192706,0,1,4
54977,1,1,192706,192706,192707,0,1,0
54978,1,3,192707,192707,192710,0,3,0
54979,5,1,192712,192712,192713,0,1,2
54980,4,3,192716,192716,192719,0,3,3
54981,1,1,192717,192719,192720,2,3,0
54982,3,2,192720,192720,192722,0,2,0
54983,5,2,192725,192725,192727,0,2,3
54984,1,3,192726,192727,192730,1,4,0
54985,2,3,192728,192730,192733,2,5,0
54986,5,2,192733,192733,192735,0,2,0
54987,6,3,192739,192739,192742,0,3,4
54988,5,1,192744,192744,192745,0,1,2
54989,1,3,192745,192745,192748,0,3,0
54990,5,1,192750,192750,192751,0,1,2
54991,2,1,192752,192752,192753,0,1,1
54992,1,3,192753,192753,192756,0,3,0
54993,5,2,192758,192758,192760,0,2,2
54994,1,2,192759,192760,192762,1,3,0
54995,2,1,192761,192762,192763,1,2,0
54996,1,3,192762,192763,192766,1,4,0
54997,5,3,192767,192767,192770,0,3,1
54998,4,1,192771,192771,192772,0,1,1
54999,4,2,192775,192775,192777,0,2,3
55000,5,3,192780,192780,192783,0,3,3
55001,1,2,192781,192783,192785,2,4,0
55002,1,1,192782,192785,192786,3,4,0
55003,6,3,192788,192788,192791,0,3,2
55004,4,3,192792,192792,192795,0,3,1
55005,4,3,192796,192796,192799,0,3,1
55006,4,3,192800,192800,192803,0,3,1
55007,1,3,192801,192803,192806,2,5,0
55008,5,3,192806,192806,192809,0,3,0
55009,3,2,192809,192809,192811,0,2,0
55010,6,3,192815,192815,192818,0,3,4
55011,6,2,192821,192821,192823,0,2,3
55012,4,2,192825,192825,192827,0,2,2
55013,1,1,192826,192827,192828,1,2,0
55014,5,2,192831,192831,192833,0,2,3
55015,4,1,192835,192835,192836,0,1,2
55016,4,2,192839,192839,192841,0,2,3
55017,1,2,192840,192841,192843,1,3,0
55018,1,2,192841,192843,192845,2,4,0
55019,2,1,192843,192845,192846,2,3,0
55020,5,2,192848,192848,192850,0,2,2
55021,3,1,192851,192851,192852,0,1,1
55022,5,1,192856,192856,192857,0,1,4
55023,3,3,192859,192859,192862,0,3,2
55024,6,1,192865,192865,192866,0,1,3
55025,3,1,192868,192868,192869,0,1,2
55026,6,3,192874,192874,192877,0,3,5
55027,4,1,192878,192878,192879,0,1,1
55028,6,1,192884,192884,192885,0,1,5
55029,4,2,192888,192888,192890,0,2,3
55030,1,2,192889,192890,192892,1,3,0
55031,1,2,192890,192892,192894,2,4,0
55032,6,2,192896,192896,192898,0,2,2
55033,6,3,192902,192902,192905,0,3,4
55034,1,3,192903,192905,192908,2,5,0
55035,1,2,192904,192908,192910,4,6,0
55036,2,1,192906,192910,192911,4,5,0
55037,1,3,192907,192911,192914,4,7,0
55038,3,2,192910,192914,192916,4,6,0
55039,1,2,192911,192916,192918,5,7,0
55040,3,3,192914,192918,192921,4,7,0
55041,2,1,192916,192921,192922,5,6,0
55042,4,2,192920,192922,192924,2,4,0
55043,5,3,192925,192925,192928,0,3,1
55044,5,3,192930,192930,192933,0,3,2
55045,1,3,192931,192933,192936,2,5,0
55046,6,1,192937,192937,192938,0,1,1
55047,2,2,192939,192939,192941,0,2,1
55048,2,3,192941,192941,192944,0,3,0
55049,2,2,192943,192944,192946,1,3,0
55050,5,1,192948,192948,192949,0,1,2
55051,2,3,192950,192950,192953,0,3,1
55052,6,1,192956,192956,192957,0,1,3
55053,1,2,192957,192957,192959,0,2,0
55054,2,1,192959,192959,192960,0,1,0
55055,3,1,192962,192962,192963,0,1,2
55056,6,3,192968,192968,192971,0,3,5
55057,2,3,192970,192971,192974,1,4,0
55058,5,1,192975,192975,192976,0,1,1
55059,4,3,192979,192979,192982,0,3,3
55060,6,2,192985,192985,192987,0,2,3
55061,6,2,192991,192991,192993,0,2,4
55062,6,3,192997,192997,193000,0,3,4
55063,4,2,193001,193001,193003,0,2,1
55064,1,2,193002,193003,193005,1,3,0
55065,3,1,193005,193005,193006,0,1,0
55066,6,3,193011,193011,193014,0,3,5
55067,4,2,193015,193015,193017,0,2,1
55068,5,3,193020,193020,193023,0,3,3
55069,6,2,193026,193026,193028,0,2,3
55070,5,3,193031,193031,193034,0,3,3
55071,3,1,193034,193034,193035,0,1,0
55072,2,2,193036,193036,193038,0,2,1
55073,6,1,193042,193042,193043,0,1,4
55074,1,2,193043,193043,193045,0,2,0
55075,6,3,193049,193049,193052,0,3,4
55076,2,3,193051,193052,193055,1,4,0
55077,2,3,193053,193055,193058,2,5,0
55078,1,1,193054,193058,193059,4,5,0
55079,2,3,193056,193059,193062,3,6,0
55080,2,2,193058,193062,193064,4,6,0
55081,5,3,193063,193064,193067,1,4,0
55082,2,2,193065,193067,193069,2,4,0
55083,1,2,193066,193069,193071,3,5,0
55084,5,3,193071,193071,193074,0,3,0
55085,3,2,193074,193074,193076,0,2,0
55086,3,3,193077,193077,193080,0,3,1
55087,3,1,193080,193080,193081,0,1,0
55088,6,3,193086,193086,193089,0,3,5
55089,2,1,193088,193089,193090,1,2,0
55090,4,2,193092,193092,193094,0,2,2
55091,2,2,193094,193094,193096,0,2,0
55092,6,3,193100,193100,193103,0,3,4
55093,2,3,193102,193103,193106,1,4,0
55094,2,1,193104,193106,193107,2,3,0
55095,4,3,193108,193108,193111,0,3,1
55096,6,3,193114,193114,193117,0,3,3
55097,6,1,193120,193120,193121,0,1,3
55098,6,3,193126,193126,193129,0,3,5
55099,2,1,193128,193129,193130,1,2,0
55100,4,1,193132,193132,193133,0,1,2
55101,4,1,193136,193136,193137,0,1,3
55102,3,3,193139,193139,193142,0,3,2
55103,1,3,193140,193142,193145,2,5,0
55104,2,1,193142,193145,193146,3,4,0
55105,1,3,193143,193146,193149,3,6,0
55106,2,3,193145,193149,193152,4,7,0
55107,2,3,193147,193152,193155,5,8,0
55108,4,2,193151,193155,193157,4,6,0
55109,6,3,193157,193157,193160,0,3,0
55110,1,1,193158,193160,193161,2,3,0
55111,5,3,193163,193163,193166,0,3,2
55112,1,3,193164,193166,193169,2,5,0
55113,6,3,193170,193170,193173,0,3,1
55114,4,3,193174,193174,193177,0,3,1
55115,3,3,193177,193177,193180,0,3,0
55116,2,1,193179,193180,193181,1,2,0
55117,6,1,193185,193185,193186,0,1,4
55118,4,3,193189,193189,193192,0,3,3
55119,6,3,193195,193195,193198,0,3,3
55120,2,2,193197,193198,193200,1,3,0
55121,5,3,193202,193202,193205,0,3,2
55122,3,1,193205,193205,193206,0,1,0
55123,3,3,193208,193208,193211,0,3,2
55124,5,1,193213,193213,193214,0,1,2
55125,2,2,193215,193215,193217,0,2,1
55126,4,3,193219,193219,193222,0,3,2
55127,3,2,193222,193222,193224,0,2,0
55128,4,2,193226,193226,193228,0,2,2
55129,3,1,193229,193229,193230,0,1,1
55130,2,3,193231,193231,193234,0,3,1
55131,1,3,193232,193234,193237,2,5,0
55132,5,1,193237,193237,193238,0,1,0
55133,6,2,193243,193243,193245,0,2,5
55134,2,2,193245,193245,193247,0,2,0
55135,1,3,193246,193247,193250,1,4,0
55136,5,2,193251,193251,193253,0,2,1
55137,4,3,193255,193255,193258,0,3,2
55138,1,3,193256,193258,193261,2,5,0
55139,5,3,193261,193261,193264,0,3,0
55140,4,1,193265,193265,193266,0,1,1
55141,1,3,193266,193266,193269,0,3,0
55142,5,1,193271,193271,193272,0,1,2
55143,5,1,193276,193276,193277,0,1,4
55144,4,2,193280,193280,193282,0,2,3
55145,2,3,193282,193282,193285,0,3,0
55146,3,3,193285,193285,193288,0,3,0
55147,1,1,193286,193288,193289,2,3,0
55148,1,1,193287,193289,193290,2,3,0
55149,1,2,193288,193290,193292,2,4,0
55150,4,1,193292,193292,193293,0,1,0
55151,6,2,193298,193298,193300,0,2,5
55152,3,2,193301,193301,193303,0,2,1
55153,5,3,193306,193306,193309,0,3,3
55154,4,2,193310,193310,193312,0,2,1
55155,4,2,193314,193314,193316,0,2,2
55156,5,2,193319,193319,193321,0,2,3
55157,3,3,193322,193322,193325,0,3,1
55158,5,1,193327,193327,193328,0,1,2
55159,5,2,193332,193332,193334,0,2,4
55160,5,2,193337,193337,193339,0,2,3
55161,2,3,193339,193339,193342,0,3,0
55162,3,2,193342,193342,193344,0,2,0
55163,2,1,193344,193344,193345,0,1,0
55164,5,1,193349,193349,193350,0,1,4
55165,2,1,193351,193351,193352,0,1,1
55166,3,1,193354,193354,193355,0,1,2
55167,3,3,193357,193357,193360,0,3,2
55168,5,1,193362,193362,193363,0,1,2
55169,4,3,193366,193366,193369,0,3,3
55170,1,3,193367,193369,193372,2,5,0
55171,3,3,193370,193372,193375,2,5,0
55172,6,1,193376,193376,193377,0,1,1
55173,6,2,193382,193382,193384,0,2,5
55174,4,1,193386,193386,193387,0,1,2
55175,2,2,193388,193388,193390,0,2,1
55176,4,1,193392,193392,193393,0,1,2
55177,3,2,193395,193395,193397,0,2,2
55178,2,2,193397,193397,193399,0,2,0
55179,6,1,193403,193403,193404,0,1,4
55180,1,1,193404,193404,193405,0,1,0
55181,6,1,193410,193410,193411,0,1,5
55182,5,1,193415,193415,193416,0,1,4
55183,3,3,193418,193418,193421,0,3,2
55184,4,2,193422,193422,193424,0,2,1
55185,5,2,193427,193427,193429,0,2,3
55186,1,3,193428,193429,193432,1,4,0
55187,3,2,193431,193432,193434,1,3,0
55188,1,3,193432,193434,193437,2,5,0
55189,3,3,193435,193437,193440,2,5,0
55190,1,1,193436,193440,193441,4,5,0
55191,6,3,193442,193442,193445,0,3,1
55192,5,2,193447,193447,193449,0,2,2
55193,3,3,193450,193450,193453,0,3,1
55194,4,1,193454,193454,193455,0,1,1
55195,3,2,193457,193457,193459,0,2,2
55196,2,2,193459,193459,193461,0,2,0
55197,3,2,193462,193462,193464,0,2,1
55198,5,3,193467,193467,193470,0,3,3
55199,2,2,193469,193470,193472,1,3,0
55200,6,2,193475,193475,193477,0,2,3
55201,6,2,193481,193481,193483,0,2,4
55202,2,1,193483,193483,193484,0,1,0
55203,2,1,193485,193485,193486,0,1,1
55204,4,3,193489,193489,193492,0,3,3
55205,2,1,193491,193492,193493,1,2,0
55206,3,3,193494,193494,193497,0,3,1
55207,6,3,193500,193500,193503,0,3,3
55208,3,1,193503,193503,193504,0,1,0
55209,6,3,193509,193509,193512,0,3,5
55210,6,2,193515,193515,193517,0,2,3
55211,4,1,193519,193519,193520,0,1,2
55212,6,1,193525,193525,193526,0,1,5
55213,3,2,193528,193528,193530,0,2,2
55214,3,3,193531,193531,193534,0,3,1
55215,5,2,193536,193536,193538,0,2,2
55216,5,3,193541,193541,193544,0,3,3
55217,6,1,193547,193547,193548,0,1,3
55218,6,3,193553,193553,193556,0,3,5
55219,1,3,193554,193556,193559,2,5,0
55220,3,2,193557,193559,193561,2,4,0
55221,4,3,193561,193561,193564,0,3,0
55222,5,2,193566,193566,193568,0,2,2
55223,1,1,193567,193568,193569,1,2,0
55224,2,2,193569,193569,193571,0,2,0
55225,1,3,193570,193571,193574,1,4,0
55226,5,1,193575,193575,193576,0,1,1
55227,5,3,193580,193580,193583,0,3,4
55228,4,3,193584,193584,193587,0,3,1
55229,5,1,193589,193589,193590,0,1,2
55230,4,3,193593,193593,193596,0,3,3
55231,2,1,193595,193596,193597,1,2,0
55232,3,1,193598,193598,193599,0,1,1
55233,1,1,193599,193599,193600,0,1,0
55234,5,3,193604,193604,193607,0,3,4
55235,6,3,193610,193610,193613,0,3,3
55236,5,2,193615,193615,193617,0,2,2
55237,5,1,193620,193620,193621,0,1,3
55238,2,1,193622,193622,193623,0,1,1
55239,4,1,193626,193626,193627,0,1,3
55240,2,1,193628,193628,193629,0,1,1
55241,1,2,193629,193629,193631,0,2,0
55242,6,2,193635,193635,193637,0,2,4
55243,4,1,193639,193639,193640,0,1,2
55244,2,1,193641,193641,193642,0,1,1
55245,1,3,193642,193642,193645,0,3,0
55246,2,3,193644,193645,193648,1,4,0
55247,6,2,193650,193650,193652,0,2,2
55248,1,2,193651,193652,193654,1,3,0
55249,4,3,193655,193655,193658,0,3,1
55250,3,1,193658,193658,193659,0,1,0
55251,6,1,193664,193664,193665,0,1,5
55252,6,2,193670,193670,193672,0,2,5
55253,1,1,193671,193672,193673,1,2,0
55254,2,3,193673,193673,193676,0,3,0
55255,1,3,193674,193676,193679,2,5,0
55256,4,2,193678,193679,193681,1,3,0
55257,2,3,193680,193681,193684,1,4,0
55258,1,1,193681,193684,193685,3,4,0
55259,5,2,193686,193686,193688,0,2,1
55260,1,2,193687,193688,193690,1,3,0
55261,2,2,193689,193690,193692,1,3,0
55262,2,3,193691,193692,193695,1,4,0
55263,1,3,193692,193695,193698,3,6,0
55264,6,1,193698,193698,193699,0,1,0
55265,5,2,193703,193703,193705,0,2,4
55266,4,2,193707,193707,193709,0,2,2
55267,2,2,193709,193709,193711,0,2,0
55268,1,1,193710,193711,193712,1,2,0
55269,4,2,193714,193714,193716,0,2,2
55270,4,2,193718,193718,193720,0,2,2
55271,6,2,193724,193724,193726,0,2,4
55272,5,2,193729,193729,193731,0,2,3
55273,4,1,193733,193733,193734,0,1,2
55274,1,2,193734,193734,193736,0,2,0
55275,2,1,193736,193736,193737,0,1,0
55276,3,2,193739,193739,193741,0,2,2
55277,4,2,193743,193743,193745,0,2,2
55278,6,1,193749,193749,193750,0,1,4
55279,1,1,193750,193750,193751,0,1,0
55280,6,2,193756,193756,193758,0,2,5
55281,1,3,193757,193758,193761,1,4,0
55282,6,1,193763,193763,193764,0,1,2
55283,1,3,193764,193764,193767,0,3,0
55284,2,1,193766,193767,193768,1,2,0
55285,4,3,193770,193770,193773,0,3,2
55286,6,3,193776,193776,193779,0,3,3
55287,6,3,193782,193782,193785,0,3,3
55288,6,1,193788,193788,193789,0,1,3
55289,5,1,193793,193793,193794,0,1,4
55290,6,2,193799,193799,193801,0,2,5
55291,1,2,193800,193801,193803,1,3,0
55292,1,3,193801,193803,193806,2,5,0
55293,3,2,193804,193806,193808,2,4,0
55294,1,1,193805,193808,193809,3,4,0
55295,3,1,193808,193809,193810,1,2,0
55296,3,2,193811,193811,193813,0,2,1
55297,4,3,193815,193815,193818,0,3,2
55298,5,2,193820,193820,193822,0,2,2
55299,6,1,193826,193826,193827,0,1,4
55300,4,1,193830,193830,193831,0,1,3
55301,4,1,193834,193834,193835,0,1,3
55302,6,2,193840,193840,193842,0,2,5
55303,6,1,193846,193846,193847,0,1,4
55304,3,2,193849,193849,193851,0,2,2
55305,3,2,193852,193852,193854,0,2,1
55306,1,3,193853,193854,193857,1,4,0
55307,6,1,193859,193859,193860,0,1,2
55308,5,2,193864,193864,193866,0,2,4
55309,3,1,193867,193867,193868,0,1,1
55310,4,2,193871,193871,193873,0,2,3
55311,2,2,193873,193873,193875,0,2,0
55312,6,2,193879,193879,193881,0,2,4
55313,3,2,193882,193882,193884,0,2,1
55314,5,3,193887,193887,193890,0,3,3
55315,5,3,193892,193892,193895,0,3,2
55316,6,3,193898,193898,193901,0,3,3
55317,1,1,193899,193901,193902,2,3,0
55318,3,3,193902,193902,193905,0,3,0
55319,4,3,193906,193906,193909,0,3,1
55320,6,1,193912,193912,193913,0,1,3
55321,4,2,193916,193916,193918,0,2,3
55322,4,1,193920,193920,193921,0,1,2
55323,3,3,193923,193923,193926,0,3,2
55324,3,3,193926,193926,193929,0,3,0
55325,3,3,193929,193929,193932,0,3,0
55326,1,1,193930,193932,193933,2,3,0
55327,6,3,193936,193936,193939,0,3,3
55328,1,1,193937,193939,193940,2,3,0
55329,3,1,193940,193940,193941,0,1,0
55330,4,2,193944,193944,193946,0,2,3
55331,3,1,193947,193947,193948,0,1,1
55332,6,1,193953,193953,193954,0,1,5
55333,6,3,193959,193959,193962,0,3,5
55334,4,3,193963,193963,193966,0,3,1
55335,3,1,193966,193966,193967,0,1,0
55336,4,1,193970,193970,193971,0,1,3
55337,3,3,193973,193973,193976,0,3,2
55338,2,2,193975,193976,193978,1,3,0
55339,1,2,193976,193978,193980,2,4,0
55340,2,1,193978,193980,193981,2,3,0
55341,6,3,193984,193984,193987,0,3,3
55342,5,1,193989,193989,193990,0,1,2
55343,2,3,193991,193991,193994,0,3,1
55344,1,1,193992,193994,193995,2,3,0
55345,5,1,193997,193997,193998,0,1,2
55346,1,2,193998,193998,194000,0,2,0
55347,5,1,194003,194003,194004,0,1,3
55348,6,1,194009,194009,194010,0,1,5
55349,6,1,194015,194015,194016,0,1,5
55350,6,3,194021,194021,194024,0,3,5
55351,5,1,194026,194026,194027,0,1,2
55352,2,2,194028,194028,194030,0,2,1
55353,2,1,194030,194030,194031,0,1,0
55354,2,2,194032,194032,194034,0,2,1
55355,1,1,194033,194034,194035,1,2,0
55356,2,3,194035,194035,194038,0,3,0
55357,6,1,194041,194041,194042,0,1,3
55358,6,2,194047,194047,194049,0,2,5
55359,1,1,194048,194049,194050,1,2,0
55360,5,2,194053,194053,194055,0,2,3
55361,5,2,194058,194058,194060,0,2,3
55362,5,2,194063,194063,194065,0,2,3
55363,1,3,194064,194065,194068,1,4,0
55364,6,3,194070,194070,194073,0,3,2
55365,4,3,194074,194074,194077,0,3,1
55366,3,2,194077,194077,194079,0,2,0
55367,1,3,194078,194079,194082,1,4,0
55368,4,1,194082,194082,194083,0,1,0
55369,4,3,194086,194086,194089,0,3,3
55370,4,3,194090,194090,194093,0,3,1
55371,1,2,194091,194093,194095,2,4,0
55372,4,1,194095,194095,194096,0,1,0
55373,2,1,194097,194097,194098,0,1,1
55374,4,2,194101,194101,194103,0,2,3
55375,3,2,194104,194104,194106,0,2,1
55376,5,2,194109,194109,194111,0,2,3
55377,1,2,194110,194111,194113,1,3,0
55378,1,3,194111,194113,194116,2,5,0
55379,1,1,194112,194116,194117,4,5,0
55380,2,1,194114,194117,194118,3,4,0
55381,4,3,194118,194118,194121,0,3,0
55382,3,1,194121,194121,194122,0,1,0
55383,2,3,194123,194123,194126,0,3,1
55384,5,3,194128,194128,194131,0,3,2
55385,1,2,194129,194131,194133,2,4,0
55386,3,3,194132,194133,194136,1,4,0
55387,6,3,194138,194138,194141,0,3,2
55388,4,3,194142,194142,194145,0,3,1
55389,5,2,194147,194147,194149,0,2,2
55390,5,2,194152,194152,194154,0,2,3
55391,5,1,194157,194157,194158,0,1,3
55392,6,3,194163,194163,194166,0,3,5
55393,1,3,194164,194166,194169,2,5,0
55394,1,1,194165,194169,194170,4,5,0
55395,5,3,194170,194170,194173,0,3,0
55396,6,2,194176,194176,194178,0,2,3
55397,6,3,194182,194182,194185,0,3,4
55398,2,1,194184,194185,194186,1,2,0
55399,3,1,194187,194187,194188,0,1,1
55400,3,1,194190,194190,194191,0,1,2
55401,3,3,194193,194193,194196,0,3,2
55402,3,3,194196,194196,194199,0,3,0
55403,3,2,194199,194199,194201,0,2,0
55404,3,3,194202,194202,194205,0,3,1
55405,5,1,194207,194207,194208,0,1,2
55406,3,1,194210,194210,194211,0,1,2
55407,1,1,194211,194211,194212,0,1,0
55408,1,3,194212,194212,194215,0,3,0
55409,5,2,194217,194217,194219,0,2,2
55410,4,1,194221,194221,194222,0,1,2
55411,2,2,194223,194223,194225,0,2,1
55412,1,2,194224,194225,194227,1,3,0
55413,4,3,194228,194228,194231,0,3,1
55414,2,3,194230,194231,194234,1,4,0
55415,2,1,194232,194234,194235,2,3,0
55416,5,3,194237,194237,194240,0,3,2
55417,5,1,194242,194242,194243,0,1,2
55418,5,3,194247,194247,194250,0,3,4
55419,3,1,194250,194250,194251,0,1,0
55420,4,2,194254,194254,194256,0,2,3
55421,1,3,194255,194256,194259,1,4,0
55422,1,3,194256,194259,194262,3,6,0
55423,6,2,194262,194262,194264,0,2,0
55424,5,3,194267,194267,194270,0,3,3
55425,4,1,194271,194271,194272,0,1,1
55426,1,2,194272,194272,194274,0,2,0
55427,1,3,194273,194274,194277,1,4,0
55428,4,3,194277,194277,194280,0,3,0
55429,3,1,194280,194280,194281,0,1,0
55430,2,1,194282,194282,194283,0,1,1
55431,5,2,194287,194287,194289,0,2,4
55432,3,1,194290,194290,194291,0,1,1
55433,1,3,194291,194291,194294,0,3,0
55434,5,3,194296,194296,194299,0,3,2
55435,4,2,194300,194300,194302,0,2,1
55436,2,3,194302,194302,194305,0,3,0
55437,6,2,194308,194308,194310,0,2,3
55438,5,3,194313,194313,194316,0,3,3
55439,2,2,194315,194316,194318,1,3,0
55440,4,1,194319,194319,194320,0,1,1
55441,5,2,194324,194324,194326,0,2,4
55442,1,3,194325,194326,194329,1,4,0
55443,2,3,194327,194329,194332,2,5,0
55444,5,1,194332,194332,194333,0,1,0
55445,4,2,194336,194336,194338,0,2,3
55446,5,1,194341,194341,194342,0,1,3
55447,3,2,194344,194344,194346,0,2,2
55448,4,3,194348,194348,194351,0,3,2
55449,6,1,194354,194354,194355,0,1,3
55450,2,3,194356,194356,194359,0,3,1
55451,3,1,194359,194359,194360,0,1,0
55452,2,3,194361,194361,194364,0,3,1
55453,1,3,194362,194364,194367,2,5,0
55454,2,2,194364,194367,194369,3,5,0
55455,4,1,194368,194369,194370,1,2,0
55456,2,3,194370,194370,194373,0,3,0
55457,5,1,194375,194375,194376,0,1,2
55458,3,1,194378,194378,194379,0,1,2
55459,2,2,194380,194380,194382,0,2,1
55460,2,1,194382,194382,194383,0,1,0
55461,1,1,194383,194383,194384,0,1,0
55462,6,3,194389,194389,194392,0,3,5
55463,1,3,194390,194392,194395,2,5,0
55464,4,3,194394,194395,194398,1,4,0
55465,6,2,194400,194400,194402,0,2,2
55466,4,2,194404,194404,194406,0,2,2
55467,1,1,194405,194406,194407,1,2,0
55468,6,2,194411,194411,194413,0,2,4
55469,3,1,194414,194414,194415,0,1,1
55470,4,2,194418,194418,194420,0,2,3
55471,4,2,194422,194422,194424,0,2,2
55472,2,2,194424,194424,194426,0,2,0
55473,2,2,194426,194426,194428,0,2,0
55474,5,1,194431,194431,194432,0,1,3
55475,4,2,194435,194435,194437,0,2,3
55476,5,2,194440,194440,194442,0,2,3
55477,1,1,194441,194442,194443,1,2,0
55478,3,1,194444,194444,194445,0,1,1
55479,5,1,194449,194449,194450,0,1,4
55480,4,3,194453,194453,194456,0,3,3
55481,6,2,194459,194459,194461,0,2,3
55482,5,1,194464,194464,194465,0,1,3
55483,6,2,194470,194470,194472,0,2,5
55484,3,1,194473,194473,194474,0,1,1
55485,5,1,194478,194478,194479,0,1,4
55486,4,3,194482,194482,194485,0,3,3
55487,1,3,194483,194485,194488,2,5,0
55488,6,1,194489,194489,194490,0,1,1
55489,5,1,194494,194494,194495,0,1,4
55490,4,3,194498,194498,194501,0,3,3
55491,5,1,194503,194503,194504,0,1,2
55492,5,3,194508,194508,194511,0,3,4
55493,3,2,194511,194511,194513,0,2,0
55494,3,2,194514,194514,194516,0,2,1
55495,6,1,194520,194520,194521,0,1,4
55496,6,3,194526,194526,194529,0,3,5
55497,2,1,194528,194529,194530,1,2,0
55498,1,1,194529,194530,194531,1,2,0
55499,1,3,194530,194531,194534,1,4,0
55500,1,2,194531,194534,194536,3,5,0
55501,5,2,194536,194536,194538,0,2,0
55502,4,2,194540,194540,194542,0,2,2
55503,3,1,194543,194543,194544,0,1,1
55504,6,1,194549,194549,194550,0,1,5
55505,5,2,194554,194554,194556,0,2,4
55506,4,2,194558,194558,194560,0,2,2
55507,3,2,194561,194561,194563,0,2,1
55508,6,1,194567,194567,194568,0,1,4
55509,2,2,194569,194569,194571,0,2,1
55510,2,2,194571,194571,194573,0,2,0
55511,4,2,194575,194575,194577,0,2,2
55512,1,2,194576,194577,194579,1,3,0
55513,6,3,194582,194582,194585,0,3,3
55514,2,2,194584,194585,194587,1,3,0
55515,1,2,194585,194587,194589,2,4,0
55516,1,1,194586,194589,194590,3,4,0
55517,5,3,194591,194591,194594,0,3,1
55518,2,2,194593,194594,194596,1,3,0
55519,2,2,194595,194596,194598,1,3,0
55520,4,3,194599,194599,194602,0,3,1
55521,4,3,194603,194603,194606,0,3,1
55522,5,3,194608,194608,194611,0,3,2
55523,4,3,194612,194612,194615,0,3,1
55524,1,1,194613,194615,194616,2,3,0
55525,3,1,194616,194616,194617,0,1,0
55526,4,3,194620,194620,194623,0,3,3
55527,2,1,194622,194623,194624,1,2,0
55528,2,1,194624,194624,194625,0,1,0
55529,1,2,194625,194625,194627,0,2,0
55530,2,1,194627,194627,194628,0,1,0
55531,6,2,194633,194633,194635,0,2,5
55532,3,1,194636,194636,194637,0,1,1
55533,1,1,194637,194637,194638,0,1,0
55534,2,2,194639,194639,194641,0,2,1
55535,2,1,194641,194641,194642,0,1,0
55536,6,2,194647,194647,194649,0,2,5
55537,2,1,194649,194649,194650,0,1,0
55538,1,3,194650,194650,194653,0,3,0
55539,5,2,194655,194655,194657,0,2,2
55540,3,2,194658,194658,194660,0,2,1
55541,3,2,194661,194661,194663,0,2,1
55542,6,1,194667,194667,194668,0,1,4
55543,2,2,194669,194669,194671,0,2,1
55544,1,3,194670,194671,194674,1,4,0
55545,3,2,194673,194674,194676,1,3,0
55546,1,2,194674,194676,194678,2,4,0
55547,6,3,194680,194680,194683,0,3,2
55548,3,3,194683,194683,194686,0,3,0
55549,3,1,194686,194686,194687,0,1,0
55550,4,3,194690,194690,194693,0,3,3
55551,1,3,194691,194693,194696,2,5,0
55552,5,2,194696,194696,194698,0,2,0
55553,5,2,194701,194701,194703,0,2,3
55554,4,2,194705,194705,194707,0,2,2
55555,5,3,194710,194710,194713,0,3,3
55556,5,1,194715,194715,194716,0,1,2
55557,2,2,194717,194717,194719,0,2,1
55558,4,3,194721,194721,194724,0,3,2
55559,4,1,194725,194725,194726,0,1,1
55560,6,1,194731,194731,194732,0,1,5
55561,3,1,194734,194734,194735,0,1,2
55562,2,1,194736,194736,194737,0,1,1
55563,5,2,194741,194741,194743,0,2,4
55564,1,1,194742,194743,194744,1,2,0
55565,6,1,194748,194748,194749,0,1,4
55566,1,3,194749,194749,194752,0,3,0
55567,1,2,194750,194752,194754,2,4,0
55568,3,1,194753,194754,194755,1,2,0
55569,3,1,194756,194756,194757,0,1,1
55570,5,3,194761,194761,194764,0,3,4
55571,2,3,194763,194764,194767,1,4,0
55572,4,1,194767,194767,194768,0,1,0
55573,5,2,194772,194772,194774,0,2,4
55574,4,3,194776,194776,194779,0,3,2
55575,2,3,194778,194779,194782,1,4,0
55576,5,2,194783,194783,194785,0,2,1
55577,5,2,194788,194788,194790,0,2,3
55578,1,1,194789,194790,194791,1,2,0
55579,1,3,194790,194791,194794,1,4,0
55580,4,3,194794,194794,194797,0,3,0
55581,2,1,194796,194797,194798,1,2,0
55582,5,3,194801,194801,194804,0,3,3
55583,5,3,194806,194806,194809,0,3,2
55584,1,1,194807,194809,194810,2,3,0
55585,3,2,194810,194810,194812,0,2,0
55586,3,1,194813,194813,194814,0,1,1
55587,6,2,194819,194819,194821,0,2,5
55588,3,2,194822,194822,194824,0,2,1
55589,5,3,194827,194827,194830,0,3,3
55590,3,2,194830,194830,194832,0,2,0
55591,5,1,194835,194835,194836,0,1,3
55592,4,1,194839,194839,194840,0,1,3
55593,5,1,194844,194844,194845,0,1,4
55594,6,3,194850,194850,194853,0,3,5
55595,3,2,194853,194853,194855,0,2,0
55596,4,1,194857,194857,194858,0,1,2
55597,4,2,194861,194861,194863,0,2,3
55598,4,3,194865,194865,194868,0,3,2
55599,1,2,194866,194868,194870,2,4,0
55600,5,3,194871,194871,194874,0,3,1
55601,2,1,194873,194874,194875,1,2,0
55602,4,1,194877,194877,194878,0,1,2
55603,5,2,194882,194882,194884,0,2,4
55604,2,3,194884,194884,194887,0,3,0
55605,5,1,194889,194889,194890,0,1,2
55606,3,1,194892,194892,194893,0,1,2
55607,2,3,194894,194894,194897,0,3,1
55608,6,3,194900,194900,194903,0,3,3
55609,5,2,194905,194905,194907,0,2,2
55610,5,1,194910,194910,194911,0,1,3
55611,3,1,194913,194913,194914,0,1,2
55612,3,2,194916,194916,194918,0,2,2
55613,2,3,194918,194918,194921,0,3,0
55614,2,3,194920,194921,194924,1,4,0
55615,4,3,194924,194924,194927,0,3,0
55616,3,1,194927,194927,194928,0,1,0
55617,3,2,194930,194930,194932,0,2,2
55618,1,1,194931,194932,194933,1,2,0
55619,6,1,194937,194937,194938,0,1,4
55620,6,3,194943,194943,194946,0,3,5
55621,1,1,194944,194946,194947,2,3,0
55622,6,3,194950,194950,194953,0,3,3
55623,1,2,194951,194953,194955,2,4,0
55624,6,3,194957,194957,194960,0,3,2
55625,1,1,194958,194960,194961,2,3,0
55626,2,1,194960,194961,194962,1,2,0
55627,3,3,194963,194963,194966,0,3,1
55628,6,3,194969,194969,194972,0,3,3
55629,6,1,194975,194975,194976,0,1,3
55630,2,1,194977,194977,194978,0,1,1
55631,2,1,194979,194979,194980,0,1,1
55632,6,3,194985,194985,194988,0,3,5
55633,4,1,194989,194989,194990,0,1,1
55634,4,1,194993,194993,194994,0,1,3
55635,4,2,194997,194997,194999,0,2,3
55636,4,2,195001,195001,195003,0,2,2
55637,6,3,195007,195007,195010,0,3,4
55638,1,3,195008,195010,195013,2,5,0
55639,2,1,195010,195013,195014,3,4,0
55640,1,2,195011,195014,195016,3,5,0
55641,3,3,195014,195016,195019,2,5,0
55642,1,3,195015,195019,195022,4,7,0
55643,1,1,195016,195022,195023,6,7,0
55644,1,2,195017,195023,195025,6,8,0
55645,2,2,195019,195025,195027,6,8,0
55646,1,1,195020,195027,195028,7,8,0
55647,6,3,195026,195028,195031,2,5,0
55648,4,1,195030,195031,195032,1,2,0
55649,5,3,195035,195035,195038,0,3,3
55650,1,2,195036,195038,195040,2,4,0
55651,1,3,195037,195040,195043,3,6,0
55652,2,1,195039,195043,195044,4,5,0
55653,6,2,195045,195045,195047,0,2,1
55654,5,2,195050,195050,195052,0,2,3
55655,6,2,195056,195056,195058,0,2,4
55656,4,1,195060,195060,195061,0,1,2
55657,3,1,195063,195063,195064,0,1,2
55658,4,3,195067,195067,195070,0,3,3
55659,3,3,195070,195070,195073,0,3,0
55660,1,3,195071,195073,195076,2,5,0
55661,3,1,195074,195076,195077,2,3,0
55662,5,3,195079,195079,195082,0,3,2
55663,6,2,195085,195085,195087,0,2,3
55664,6,1,195091,195091,195092,0,1,4
55665,1,1,195092,195092,195093,0,1,0
55666,1,2,195093,195093,195095,0,2,0
55667,2,3,195095,195095,195098,0,3,0
55668,2,1,195097,195098,195099,1,2,0
55669,6,3,195103,195103,195106,0,3,4
55670,5,3,195108,195108,195111,0,3,2
55671,3,2,195111,195111,195113,0,2,0
55672,2,3,195113,195113,195116,0,3,0
55673,3,1,195116,195116,195117,0,1,0
55674,2,1,195118,195118,195119,0,1,1
55675,2,3,195120,195120,195123,0,3,1
55676,5,3,195125,195125,195128,0,3,2
55677,2,1,195127,195128,195129,1,2,0
55678,5,2,195132,195132,195134,0,2,3
55679,2,1,195134,195134,195135,0,1,0
55680,2,2,195136,195136,195138,0,2,1
55681,6,1,195142,195142,195143,0,1,4
55682,4,3,195146,195146,195149,0,3,3
55683,3,1,195149,195149,195150,0,1,0
55684,3,1,195152,195152,195153,0,1,2
55685,4,3,195156,195156,195159,0,3,3
55686,3,2,195159,195159,195161,0,2,0
55687,5,1,195164,195164,195165,0,1,3
55688,6,1,195170,195170,195171,0,1,5
55689,4,3,195174,195174,195177,0,3,3
55690,2,1,195176,195177,195178,1,2,0
55691,3,1,195179,195179,195180,0,1,1
55692,5,3,195184,195184,195187,0,3,4
55693,1,3,195185,195187,195190,2,5,0
55694,2,3,195187,195190,195193,3,6,0
55695,1,1,195188,195193,195194,5,6,0
55696,5,2,195193,195194,195196,1,3,0
55697,6,2,195199,195199,195201,0,2,3
55698,3,2,195202,195202,195204,0,2,1
55699,5,1,195207,195207,195208,0,1,3
55700,3,2,195210,195210,195212,0,2,2
55701,5,3,195215,195215,195218,0,3,3
55702,5,3,195220,195220,195223,0,3,2
55703,6,3,195226,195226,195229,0,3,3
55704,2,3,195228,195229,195232,1,4,0
55705,3,1,195231,195232,195233,1,2,0
55706,5,3,195236,195236,195239,0,3,3
55707,6,1,195242,195242,195243,0,1,3
55708,2,2,195244,195244,195246,0,2,1
55709,3,1,195247,195247,195248,0,1,1
55710,3,1,195250,195250,195251,0,1,2
55711,1,1,195251,195251,195252,0,1,0
55712,1,1,195252,195252,195253,0,1,0
55713,1,3,195253,195253,195256,0,3,0
55714,2,1,195255,195256,195257,1,2,0
55715,5,1,195260,195260,195261,0,1,3
55716,2,3,195262,195262,195265,0,3,1
55717,4,1,195266,195266,195267,0,1,1
55718,2,3,195268,195268,195271,0,3,1
55719,5,3,195273,195273,195276,0,3,2
55720,2,1,195275,195276,195277,1,2,0
55721,5,3,195280,195280,195283,0,3,3
55722,2,1,195282,195283,195284,1,2,0
55723,3,2,195285,195285,195287,0,2,1
55724,2,3,195287,195287,195290,0,3,0
55725,2,3,195289,195290,195293,1,4,0
55726,6,3,195295,195295,195298,0,3,2
55727,4,1,195299,195299,195300,0,1,1
55728,4,1,195303,195303,195304,0,1,3
55729,6,1,195309,195309,195310,0,1,5
55730,3,1,195312,195312,195313,0,1,2
55731,3,2,195315,195315,195317,0,2,2
55732,4,2,195319,195319,195321,0,2,2
55733,4,3,195323,195323,195326,0,3,2
55734,5,3,195328,195328,195331,0,3,2
55735,6,2,195334,195334,195336,0,2,3
55736,4,2,195338,195338,195340,0,2,2
55737,3,1,195341,195341,195342,0,1,1
55738,3,1,195344,195344,195345,0,1,2
55739,2,2,195346,195346,195348,0,2,1
55740,3,2,195349,195349,195351,0,2,1
55741,5,2,195354,195354,195356,0,2,3
55742,1,2,195355,195356,195358,1,3,0
55743,6,2,195361,195361,195363,0,2,3
55744,3,2,195364,195364,195366,0,2,1
55745,6,2,195370,195370,195372,0,2,4
55746,3,2,195373,195373,195375,0,2,1
55747,5,1,195378,195378,195379,0,1,3
55748,5,1,195383,195383,195384,0,1,4
55749,5,2,195388,195388,195390,0,2,4
55750,1,2,195389,195390,195392,1,3,0
55751,2,3,195391,195392,195395,1,4,0
55752,5,1,195396,195396,195397,0,1,1
55753,1,3,195397,195397,195400,0,3,0
55754,4,1,195401,195401,195402,0,1,1
55755,3,2,195404,195404,195406,0,2,2
55756,4,2,195408,195408,195410,0,2,2
55757,1,3,195409,195410,195413,1,4,0
55758,6,3,195415,195415,195418,0,3,2
55759,3,1,195418,195418,195419,0,1,0
55760,4,2,195422,195422,195424,0,2,3
55761,6,2,195428,195428,195430,0,2,4
55762,5,1,195433,195433,195434,0,1,3
55763,1,1,195434,195434,195435,0,1,0
55764,3,1,195437,195437,195438,0,1,2
55765,6,2,195443,195443,195445,0,2,5
55766,3,3,195446,195446,195449,0,3,1
55767,6,3,195452,195452,195455,0,3,3
55768,2,2,195454,195455,195457,1,3,0
55769,5,2,195459,195459,195461,0,2,2
55770,6,2,195465,195465,195467,0,2,4
55771,2,1,195467,195467,195468,0,1,0
55772,1,3,195468,195468,195471,0,3,0
55773,5,2,195473,195473,195475,0,2,2
55774,5,3,195478,195478,195481,0,3,3
55775,1,1,195479,195481,195482,2,3,0
55776,6,2,195485,195485,195487,0,2,3
55777,6,2,195491,195491,195493,0,2,4
55778,2,3,195493,195493,195496,0,3,0
55779,5,3,195498,195498,195501,0,3,2
55780,1,2,195499,195501,195503,2,4,0
55781,4,2,195503,195503,195505,0,2,0
55782,2,2,195505,195505,195507,0,2,0
55783,5,2,195510,195510,195512,0,2,3
55784,3,1,195513,195513,195514,0,1,1
55785,5,3,195518,195518,195521,0,3,4
55786,3,1,195521,195521,195522,0,1,0
55787,1,3,195522,195522,195525,0,3,0
55788,2,1,195524,195525,195526,1,2,0
55789,5,2,195529,195529,195531,0,2,3
55790,2,2,195531,195531,195533,0,2,0
55791,5,2,195536,195536,195538,0,2,3
55792,5,1,195541,195541,195542,0,1,3
55793,1,2,195542,195542,195544,0,2,0
55794,1,2,195543,195544,195546,1,3,0
55795,6,3,195549,195549,195552,0,3,3
55796,1,3,195550,195552,195555,2,5,0
55797,1,1,195551,195555,195556,4,5,0
55798,6,1,195557,195557,195558,0,1,1
55799,1,2,195558,195558,195560,0,2,0
55800,5,1,195563,195563,195564,0,1,3
55801,5,1,195568,195568,195569,0,1,4
55802,1,2,195569,195569,195571,0,2,0
55803,3,3,195572,195572,195575,0,3,1
55804,1,1,195573,195575,195576,2,3,0
55805,4,1,195577,195577,195578,0,1,1
55806,3,2,195580,195580,195582,0,2,2
55807,2,2,195582,195582,195584,0,2,0
55808,4,3,195586,195586,195589,0,3,2
55809,5,3,195591,195591,195594,0,3,2
55810,2,3,195593,195594,195597,1,4,0
55811,2,2,195595,195597,195599,2,4,0
55812,1,1,195596,195599,195600,3,4,0
55813,1,3,195597,195600,195603,3,6,0
55814,1,2,195598,195603,195605,5,7,0
55815,6,3,195604,195605,195608,1,4,0
55816,3,2,195607,195608,195610,1,3,0
55817,5,1,195612,195612,195613,0,1,2
55818,3,3,195615,195615,195618,0,3,2
55819,6,3,195621,195621,195624,0,3,3
55820,3,1,195624,195624,195625,0,1,0
55821,3,2,195627,195627,195629,0,2,2
55822,4,3,195631,195631,195634,0,3,2
55823,6,3,195637,195637,195640,0,3,3
55824,1,2,195638,195640,195642,2,4,0
55825,4,2,195642,195642,195644,0,2,0
55826,1,1,195643,195644,195645,1,2,0
55827,2,1,195645,195645,195646,0,1,0
55828,6,1,195651,195651,195652,0,1,5
55829,3,3,195654,195654,195657,0,3,2
55830,5,3,195659,195659,195662,0,3,2
55831,5,2,195664,195664,195666,0,2,2
55832,6,2,195670,195670,195672,0,2,4
55833,4,3,195674,195674,195677,0,3,2
55834,1,2,195675,195677,195679,2,4,0
55835,4,2,195679,195679,195681,0,2,0
55836,4,1,195683,195683,195684,0,1,2
55837,1,2,195684,195684,195686,0,2,0
55838,1,1,195685,195686,195687,1,2,0
55839,5,2,195690,195690,195692,0,2,3
55840,5,1,195695,195695,195696,0,1,3
55841,4,1,195699,195699,195700,0,1,3
55842,1,2,195700,195700,195702,0,2,0
55843,1,1,195701,195702,195703,1,2,0
55844,6,3,195707,195707,195710,0,3,4
55845,1,3,195708,195710,195713,2,5,0
55846,2,1,195710,195713,195714,3,4,0
55847,3,1,195713,195714,195715,1,2,0
55848,6,2,195719,195719,195721,0,2,4
55849,5,1,195724,195724,195725,0,1,3
55850,6,1,195730,195730,195731,0,1,5
55851,4,3,195734,195734,195737,0,3,3
55852,3,3,195737,195737,195740,0,3,0
55853,6,1,195743,195743,195744,0,1,3
55854,1,3,195744,195744,195747,0,3,0
55855,3,1,195747,195747,195748,0,1,0
55856,6,1,195753,195753,195754,0,1,5
55857,4,2,195757,195757,195759,0,2,3
55858,2,3,195759,195759,195762,0,3,0
55859,1,1,195760,195762,195763,2,3,0
55860,1,3,195761,195763,195766,2,5,0
55861,6,2,195767,195767,195769,0,2,1
55862,1,1,195768,195769,195770,1,2,0
55863,5,1,195773,195773,195774,0,1,3
55864,5,3,195778,195778,195781,0,3,4
55865,3,1,195781,195781,195782,0,1,0
55866,4,1,195785,195785,195786,0,1,3
55867,4,1,195789,195789,195790,0,1,3
55868,4,1,195793,195793,195794,0,1,3
55869,1,3,195794,195794,195797,0,3,0
55870,5,2,195799,195799,195801,0,2,2
55871,3,1,195802,195802,195803,0,1,1
55872,3,3,195805,195805,195808,0,3,2
55873,3,2,195808,195808,195810,0,2,0
55874,1,1,195809,195810,195811,1,2,0
55875,1,1,195810,195811,195812,1,2,0
55876,5,1,195815,195815,195816,0,1,3
55877,6,1,195821,195821,195822,0,1,5
55878,6,2,195827,195827,195829,0,2,5
55879,1,2,195828,195829,195831,1,3,0
55880,6,1,195834,195834,195835,0,1,3
55881,4,3,195838,195838,195841,0,3,3
55882,2,2,195840,195841,195843,1,3,0
55883,2,2,195842,195843,195845,1,3,0
55884,3,3,195845,195845,195848,0,3,0
55885,1,1,195846,195848,195849,2,3,0
55886,6,3,195852,195852,195855,0,3,3
55887,6,3,195858,195858,195861,0,3,3
55888,6,1,195864,195864,195865,0,1,3
55889,2,3,195866,195866,195869,0,3,1
55890,1,2,195867,195869,195871,2,4,0
55891,3,2,195870,195871,195873,1,3,0
55892,1,2,195871,195873,195875,2,4,0
55893,1,2,195872,195875,195877,3,5,0
55894,2,1,195874,195877,195878,3,4,0
55895,2,2,195876,195878,195880,2,4,0
55896,3,1,195879,195880,195881,1,2,0
55897,5,2,195884,195884,195886,0,2,3
55898,2,3,195886,195886,195889,0,3,0
55899,6,1,195892,195892,195893,0,1,3
55900,2,1,195894,195894,195895,0,1,1
55901,5,1,195899,195899,195900,0,1,4
55902,2,1,195901,195901,195902,0,1,1
55903,5,2,195906,195906,195908,0,2,4
55904,5,1,195911,195911,195912,0,1,3
55905,4,2,195915,195915,195917,0,2,3
55906,3,1,195918,195918,195919,0,1,1
55907,2,3,195920,195920,195923,0,3,1
55908,5,1,195925,195925,195926,0,1,2
55909,3,1,195928,195928,195929,0,1,2
55910,2,1,195930,195930,195931,0,1,1
55911,2,1,195932,195932,195933,0,1,1
55912,3,2,195935,195935,195937,0,2,2
55913,4,3,195939,195939,195942,0,3,2
55914,2,2,195941,195942,195944,1,3,0
55915,1,2,195942,195944,195946,2,4,0
55916,6,2,195948,195948,195950,0,2,2
55917,4,2,195952,195952,195954,0,2,2
55918,6,2,195958,195958,195960,0,2,4
55919,5,2,195963,195963,195965,0,2,3
55920,6,1,195969,195969,195970,0,1,4
55921,3,1,195972,195972,195973,0,1,2
55922,1,3,195973,195973,195976,0,3,0
55923,2,2,195975,195976,195978,1,3,0
55924,6,2,195981,195981,195983,0,2,3
55925,3,3,195984,195984,195987,0,3,1
55926,2,3,195986,195987,195990,1,4,0
55927,3,2,195989,195990,195992,1,3,0
55928,3,3,195992,195992,195995,0,3,0
55929,2,3,195994,195995,195998,1,4,0
55930,6,1,196000,196000,196001,0,1,2
55931,6,1,196006,196006,196007,0,1,5
55932,2,2,196008,196008,196010,0,2,1
55933,1,1,196009,196010,196011,1,2,0
55934,1,2,196010,196011,196013,1,3,0
55935,5,2,196015,196015,196017,0,2,2
55936,2,3,196017,196017,196020,0,3,0
55937,1,3,196018,196020,196023,2,5,0
55938,2,3,196020,196023,196026,3,6,0
55939,1,1,196021,196026,196027,5,6,0
55940,4,1,196025,196027,196028,2,3,0
55941,6,2,196031,196031,196033,0,2,3
55942,3,1,196034,196034,196035,0,1,1
55943,1,2,196035,196035,196037,0,2,0
55944,2,3,196037,196037,196040,0,3,0
55945,1,3,196038,196040,196043,2,5,0
55946,6,3,196044,196044,196047,0,3,1
55947,3,2,196047,196047,196049,0,2,0
55948,2,2,196049,196049,196051,0,2,0
55949,5,1,196054,196054,196055,0,1,3
55950,2,2,196056,196056,196058,0,2,1
55951,6,1,196062,196062,196063,0,1,4
55952,2,3,196064,196064,196067,0,3,1
55953,4,3,196068,196068,196071,0,3,1
55954,3,2,196071,196071,196073,0,2,0
55955,2,1,196073,196073,196074,0,1,0
55956,3,3,196076,196076,196079,0,3,2
55957,6,3,196082,196082,196085,0,3,3
55958,5,3,196087,196087,196090,0,3,2
55959,1,3,196088,196090,196093,2,5,0
55960,6,3,196094,196094,196097,0,3,1
55961,2,2,196096,196097,196099,1,3,0
55962,6,3,196102,196102,196105,0,3,3
55963,3,2,196105,196105,196107,0,2,0
55964,6,3,196111,196111,196114,0,3,4
55965,3,1,196114,196114,196115,0,1,0
55966,1,3,196115,196115,196118,0,3,0
55967,2,3,196117,196118,196121,1,4,0
55968,4,3,196121,196121,196124,0,3,0
55969,6,2,196127,196127,196129,0,2,3
55970,5,2,196132,196132,196134,0,2,3
55971,2,2,196134,196134,196136,0,2,0
55972,3,1,196137,196137,196138,0,1,1
55973,1,3,196138,196138,196141,0,3,0
55974,3,3,196141,196141,196144,0,3,0
55975,5,2,196146,196146,196148,0,2,2
55976,2,2,196148,196148,196150,0,2,0
55977,1,3,196149,196150,196153,1,4,0
55978,6,1,196155,196155,196156,0,1,2
55979,1,1,196156,196156,196157,0,1,0
55980,1,3,196157,196157,196160,0,3,0
55981,5,1,196162,196162,196163,0,1,2
55982,2,1,196164,196164,196165,0,1,1
55983,6,1,196170,196170,196171,0,1,5
55984,5,2,196175,196175,196177,0,2,4
55985,2,1,196177,196177,196178,0,1,0
55986,4,3,196181,196181,196184,0,3,3
55987,3,3,196184,196184,196187,0,3,0
55988,1,1,196185,196187,196188,2,3,0
55989,2,3,196187,196188,196191,1,4,0
55990,2,2,196189,196191,196193,2,4,0
55991,3,2,196192,196193,196195,1,3,0
55992,5,1,196197,196197,196198,0,1,2
55993,1,2,196198,196198,196200,0,2,0
55994,5,2,196203,196203,196205,0,2,3
55995,2,1,196205,196205,196206,0,1,0
55996,4,2,196209,196209,196211,0,2,3
55997,6,3,196215,196215,196218,0,3,4
55998,5,2,196220,196220,196222,0,2,2
55999,6,2,196226,196226,196228,0,2,4
56000,3,1,196229,196229,196230,0,1,1
56001,1,1,196230,196230,196231,0,1,0
56002,5,3,196235,196235,196238,0,3,4
56003,2,2,196237,196238,196240,1,3,0
56004,6,3,196243,196243,196246,0,3,3
56005,3,3,196246,196246,196249,0,3,0
56006,3,1,196249,196249,196250,0,1,0
56007,1,3,196250,196250,196253,0,3,0
56008,5,3,196255,196255,196258,0,3,2
56009,1,3,196256,196258,196261,2,5,0
56010,6,1,196262,196262,196263,0,1,1
56011,2,2,196264,196264,196266,0,2,1
56012,5,1,196269,196269,196270,0,1,3
56013,5,3,196274,196274,196277,0,3,4
56014,3,1,196277,196277,196278,0,1,0
56015,6,2,196283,196283,196285,0,2,5
56016,5,3,196288,196288,196291,0,3,3
56017,6,3,196294,196294,196297,0,3,3
56018,1,2,196295,196297,196299,2,4,0
56019,2,2,196297,196299,196301,2,4,0
56020,1,1,196298,196301,196302,3,4,0
56021,2,3,196300,196302,196305,2,5,0
56022,4,2,196304,196305,196307,1,3,0
56023,1,3,196305,196307,196310,2,5,0
56024,2,1,196307,196310,196311,3,4,0
56025,6,2,196313,196313,196315,0,2,2
56026,1,3,196314,196315,196318,1,4,0
56027,4,1,196318,196318,196319,0,1,0
56028,1,3,196319,196319,196322,0,3,0
56029,5,3,196324,196324,196327,0,3,2
56030,1,3,196325,196327,196330,2,5,0
56031,2,2,196327,196330,196332,3,5,0
56032,5,2,196332,196332,196334,0,2,0
56033,2,2,196334,196334,196336,0,2,0
56034,6,2,196340,196340,196342,0,2,4
56035,4,2,196344,196344,196346,0,2,2
56036,5,2,196349,196349,196351,0,2,3
56037,1,3,196350,196351,196354,1,4,0
56038,5,1,196355,196355,196356,0,1,1
56039,1,1,196356,196356,196357,0,1,0
56040,1,2,196357,196357,196359,0,2,0
56041,4,1,196361,196361,196362,0,1,2
56042,5,3,196366,196366,196369,0,3,4
56043,4,3,196370,196370,196373,0,3,1
56044,3,3,196373,196373,196376,0,3,0
56045,6,1,196379,196379,196380,0,1,3
56046,1,2,196380,196380,196382,0,2,0
56047,1,2,196381,196382,196384,1,3,0
56048,5,1,196386,196386,196387,0,1,2
56049,3,3,196389,196389,196392,0,3,2
56050,2,2,196391,196392,196394,1,3,0
56051,2,1,196393,196394,196395,1,2,0
56052,6,2,196399,196399,196401,0,2,4
56053,2,2,196401,196401,196403,0,2,0
56054,4,1,196405,196405,196406,0,1,2
56055,2,3,196407,196407,196410,0,3,1
56056,4,2,196411,196411,196413,0,2,1
56057,1,1,196412,196413,196414,1,2,0
56058,4,3,196416,196416,196419,0,3,2
56059,1,3,196417,196419,196422,2,5,0
56060,1,1,196418,196422,196423,4,5,0
56061,4,2,196422,196423,196425,1,3,0
56062,1,2,196423,196425,196427,2,4,0
56063,6,2,196429,196429,196431,0,2,2
56064,3,3,196432,196432,196435,0,3,1
56065,1,3,196433,196435,196438,2,5,0
56066,3,1,196436,196438,196439,2,3,0
56067,1,3,196437,196439,196442,2,5,0
56068,5,3,196442,196442,196445,0,3,0
56069,2,3,196444,196445,196448,1,4,0
56070,4,2,196448,196448,196450,0,2,0
56071,5,2,196453,196453,196455,0,2,3
56072,2,1,196455,196455,196456,0,1,0
56073,1,2,196456,196456,196458,0,2,0
56074,1,1,196457,196458,196459,1,2,0
56075,2,1,196459,196459,196460,0,1,0
56076,1,2,196460,196460,196462,0,2,0
56077,5,2,196465,196465,196467,0,2,3
56078,2,3,196467,196467,196470,0,3,0
56079,1,2,196468,196470,196472,2,4,0
56080,3,1,196471,196472,196473,1,2,0
56081,5,2,196476,196476,196478,0,2,3
56082,3,1,196479,196479,196480,0,1,1
56083,3,3,196482,196482,196485,0,3,2
56084,4,1,196486,196486,196487,0,1,1
56085,3,2,196489,196489,196491,0,2,2
56086,2,1,196491,196491,196492,0,1,0
56087,4,2,196495,196495,196497,0,2,3
56088,1,1,196496,196497,196498,1,2,0
56089,5,1,196501,196501,196502,0,1,3
56090,2,2,196503,196503,196505,0,2,1
56091,3,2,196506,196506,196508,0,2,1
56092,1,1,196507,196508,196509,1,2,0
56093,5,2,196512,196512,196514,0,2,3
56094,4,3,196516,196516,196519,0,3,2
56095,1,3,196517,196519,196522,2,5,0
56096,5,2,196522,196522,196524,0,2,0
56097,3,3,196525,196525,196528,0,3,1
56098,2,2,196527,196528,196530,1,3,0
56099,1,3,196528,196530,196533,2,5,0
56100,3,1,196531,196533,196534,2,3,0
56101,3,3,196534,196534,196537,0,3,0
56102,2,1,196536,196537,196538,1,2,0
56103,6,1,196542,196542,196543,0,1,4
56104,2,1,196544,196544,196545,0,1,1
56105,4,2,196548,196548,196550,0,2,3
56106,4,2,196552,196552,196554,0,2,2
56107,5,2,196557,196557,196559,0,2,3
56108,1,1,196558,196559,196560,1,2,0
56109,6,1,196564,196564,196565,0,1,4
56110,2,1,196566,196566,196567,0,1,1
56111,6,2,196572,196572,196574,0,2,5
56112,2,1,196574,196574,196575,0,1,0
56113,1,3,196575,196575,196578,0,3,0
56114,3,3,196578,196578,196581,0,3,0
56115,6,1,196584,196584,196585,0,1,3
56116,3,1,196587,196587,196588,0,1,2
56117,5,3,196592,196592,196595,0,3,4
56118,3,1,196595,196595,196596,0,1,0
56119,6,2,196601,196601,196603,0,2,5
56120,2,2,196603,196603,196605,0,2,0
56121,3,2,196606,196606,196608,0,2,1
56122,2,1,196608,196608,196609,0,1,0
56123,3,2,196611,196611,196613,0,2,2
56124,6,1,196617,196617,196618,0,1,4
56125,6,1,196623,196623,196624,0,1,5
56126,1,2,196624,196624,196626,0,2,0
56127,4,1,196628,196628,196629,0,1,2
56128,2,3,196630,196630,196633,0,3,1
56129,5,3,196635,196635,196638,0,3,2
56130,2,2,196637,196638,196640,1,3,0
56131,6,1,196643,196643,196644,0,1,3
56132,3,1,196646,196646,196647,0,1,2
56133,6,2,196652,196652,196654,0,2,5
56134,3,2,196655,196655,196657,0,2,1
56135,1,1,196656,196657,196658,1,2,0
56136,2,1,196658,196658,196659,0,1,0
56137,5,3,196663,196663,196666,0,3,4
56138,1,2,196664,196666,196668,2,4,0
56139,5,1,196669,196669,196670,0,1,1
56140,5,2,196674,196674,196676,0,2,4
56141,1,3,196675,196676,196679,1,4,0
56142,4,2,196679,196679,196681,0,2,0
56143,2,3,196681,196681,196684,0,3,0
56144,2,2,196683,196684,196686,1,3,0
56145,5,2,196688,196688,196690,0,2,2
56146,2,3,196690,196690,196693,0,3,0
56147,5,2,196695,196695,196697,0,2,2
56148,5,3,196700,196700,196703,0,3,3
56149,5,2,196705,196705,196707,0,2,2
56150,5,1,196710,196710,196711,0,1,3
56151,2,3,196712,196712,196715,0,3,1
56152,2,3,196714,196715,196718,1,4,0
56153,5,3,196719,196719,196722,0,3,1
56154,1,3,196720,196722,196725,2,5,0
56155,6,3,196726,196726,196729,0,3,1
56156,6,1,196732,196732,196733,0,1,3
56157,4,1,196736,196736,196737,0,1,3
56158,4,2,196740,196740,196742,0,2,3
56159,3,2,196743,196743,196745,0,2,1
56160,4,2,196747,196747,196749,0,2,2
56161,6,1,196753,196753,196754,0,1,4
56162,5,1,196758,196758,196759,0,1,4
56163,2,2,196760,196760,196762,0,2,1
56164,2,1,196762,196762,196763,0,1,0
56165,1,3,196763,196763,196766,0,3,0
56166,2,3,196765,196766,196769,1,4,0
56167,2,2,196767,196769,196771,2,4,0
56168,5,2,196772,196772,196774,0,2,1
56169,1,3,196773,196774,196777,1,4,0
56170,4,2,196777,196777,196779,0,2,0
56171,5,1,196782,196782,196783,0,1,3
56172,1,3,196783,196783,196786,0,3,0
56173,1,3,196784,196786,196789,2,5,0
56174,3,3,196787,196789,196792,2,5,0
56175,3,2,196790,196792,196794,2,4,0
56176,5,2,196795,196795,196797,0,2,1
56177,3,2,196798,196798,196800,0,2,1
56178,5,3,196803,196803,196806,0,3,3
56179,5,2,196808,196808,196810,0,2,2
56180,5,2,196813,196813,196815,0,2,3
56181,2,2,196815,196815,196817,0,2,0
56182,3,1,196818,196818,196819,0,1,1
56183,6,1,196824,196824,196825,0,1,5
56184,3,2,196827,196827,196829,0,2,2
56185,1,3,196828,196829,196832,1,4,0
56186,6,1,196834,196834,196835,0,1,2
56187,6,1,196840,196840,196841,0,1,5
56188,2,1,196842,196842,196843,0,1,1
56189,5,2,196847,196847,196849,0,2,4
56190,3,1,196850,196850,196851,0,1,1
56191,1,3,196851,196851,196854,0,3,0
56192,6,3,196857,196857,196860,0,3,3
56193,3,3,196860,196860,196863,0,3,0
56194,5,2,196865,196865,196867,0,2,2
56195,2,2,196867,196867,196869,0,2,0
56196,2,3,196869,196869,196872,0,3,0
56197,1,2,196870,196872,196874,2,4,0
56198,4,1,196874,196874,196875,0,1,0
56199,3,1,196877,196877,196878,0,1,2
56200,2,1,196879,196879,196880,0,1,1
56201,4,2,196883,196883,196885,0,2,3
56202,5,3,196888,196888,196891,0,3,3
56203,2,2,196890,196891,196893,1,3,0
56204,3,1,196893,196893,196894,0,1,0
56205,5,2,196898,196898,196900,0,2,4
56206,3,3,196901,196901,196904,0,3,1
56207,5,3,196906,196906,196909,0,3,2
56208,6,3,196912,196912,196915,0,3,3
56209,5,1,196917,196917,196918,0,1,2
56210,5,3,196922,196922,196925,0,3,4
56211,1,3,196923,196925,196928,2,5,0
56212,4,1,196927,196928,196929,1,2,0
56213,1,2,196928,196929,196931,1,3,0
56214,3,3,196931,196931,196934,0,3,0
56215,5,1,196936,196936,196937,0,1,2
56216,3,1,196939,196939,196940,0,1,2
56217,4,3,196943,196943,196946,0,3,3
56218,4,1,196947,196947,196948,0,1,1
56219,2,2,196949,196949,196951,0,2,1
56220,2,1,196951,196951,196952,0,1,0
56221,6,3,196957,196957,196960,0,3,5
56222,3,2,196960,196960,196962,0,2,0
56223,6,2,196966,196966,196968,0,2,4
56224,4,2,196970,196970,196972,0,2,2
56225,2,1,196972,196972,196973,0,1,0
56226,4,3,196976,196976,196979,0,3,3
56227,4,3,196980,196980,196983,0,3,1
56228,4,3,196984,196984,196987,0,3,1
56229,3,1,196987,196987,196988,0,1,0
56230,1,2,196988,196988,196990,0,2,0
56231,1,1,196989,196990,196991,1,2,0
56232,6,3,196995,196995,196998,0,3,4
56233,1,1,196996,196998,196999,2,3,0
56234,3,3,196999,196999,197002,0,3,0
56235,5,1,197004,197004,197005,0,1,2
56236,4,2,197008,197008,197010,0,2,3
56237,5,3,197013,197013,197016,0,3,3
56238,1,1,197014,197016,197017,2,3,0
56239,3,2,197017,197017,197019,0,2,0
56240,5,1,197022,197022,197023,0,1,3
56241,4,1,197026,197026,197027,0,1,3
56242,6,1,197032,197032,197033,0,1,5
56243,6,3,197038,197038,197041,0,3,5
56244,1,3,197039,197041,197044,2,5,0
56245,5,3,197044,197044,197047,0,3,0
56246,3,3,197047,197047,197050,0,3,0
56247,2,1,197049,197050,197051,1,2,0
56248,3,3,197052,197052,197055,0,3,1
56249,3,3,197055,197055,197058,0,3,0
56250,3,3,197058,197058,197061,0,3,0
56251,6,2,197064,197064,197066,0,2,3
56252,4,3,197068,197068,197071,0,3,2
56253,2,2,197070,197071,197073,1,3,0
56254,2,3,197072,197073,197076,1,4,0
56255,1,1,197073,197076,197077,3,4,0
56256,1,2,197074,197077,197079,3,5,0
56257,5,3,197079,197079,197082,0,3,0
56258,6,2,197085,197085,197087,0,2,3
56259,6,3,197091,197091,197094,0,3,4
56260,6,1,197097,197097,197098,0,1,3
56261,4,2,197101,197101,197103,0,2,3
56262,5,2,197106,197106,197108,0,2,3
56263,5,3,197111,197111,197114,0,3,3
56264,6,3,197117,197117,197120,0,3,3
56265,2,2,197119,197120,197122,1,3,0
56266,1,3,197120,197122,197125,2,5,0
56267,2,2,197122,197125,197127,3,5,0
56268,1,3,197123,197127,197130,4,7,0
56269,5,2,197128,197130,197132,2,4,0
56270,1,1,197129,197132,197133,3,4,0
56271,5,1,197134,197134,197135,0,1,1
56272,4,2,197138,197138,197140,0,2,3
56273,6,3,197144,197144,197147,0,3,4
56274,3,2,197147,197147,197149,0,2,0
56275,3,2,197150,197150,197152,0,2,1
56276,4,2,197154,197154,197156,0,2,2
56277,1,1,197155,197156,197157,1,2,0
56278,1,1,197156,197157,197158,1,2,0
56279,4,3,197160,197160,197163,0,3,2
56280,5,2,197165,197165,197167,0,2,2
56281,2,3,197167,197167,197170,0,3,0
56282,4,3,197171,197171,197174,0,3,1
56283,4,1,197175,197175,197176,0,1,1
56284,2,3,197177,197177,197180,0,3,1
56285,1,2,197178,197180,197182,2,4,0
56286,3,3,197181,197182,197185,1,4,0
56287,2,3,197183,197185,197188,2,5,0
56288,5,2,197188,197188,197190,0,2,0
56289,3,2,197191,197191,197193,0,2,1
56290,4,2,197195,197195,197197,0,2,2
56291,5,2,197200,197200,197202,0,2,3
56292,4,1,197204,197204,197205,0,1,2
56293,5,1,197209,197209,197210,0,1,4
56294,1,2,197210,197210,197212,0,2,0
56295,1,2,197211,197212,197214,1,3,0
56296,2,2,197213,197214,197216,1,3,0
56297,5,2,197218,197218,197220,0,2,2
56298,4,1,197222,197222,197223,0,1,2
56299,5,3,197227,197227,197230,0,3,4
56300,3,2,197230,197230,197232,0,2,0
56301,5,1,197235,197235,197236,0,1,3
56302,5,1,197240,197240,197241,0,1,4
56303,3,3,197243,197243,197246,0,3,2
56304,3,2,197246,197246,197248,0,2,0
56305,2,3,197248,197248,197251,0,3,0
56306,4,3,197252,197252,197255,0,3,1
56307,6,2,197258,197258,197260,0,2,3
56308,1,1,197259,197260,197261,1,2,0
56309,2,1,197261,197261,197262,0,1,0
56310,6,2,197267,197267,197269,0,2,5
56311,2,3,197269,197269,197272,0,3,0
56312,5,2,197274,197274,197276,0,2,2
56313,2,2,197276,197276,197278,0,2,0
56314,5,1,197281,197281,197282,0,1,3
56315,3,2,197284,197284,197286,0,2,2
56316,6,1,197290,197290,197291,0,1,4
56317,3,3,197293,197293,197296,0,3,2
56318,3,2,197296,197296,197298,0,2,0
56319,4,3,197300,197300,197303,0,3,2
56320,3,1,197303,197303,197304,0,1,0
56321,1,1,197304,197304,197305,0,1,0
56322,3,2,197307,197307,197309,0,2,2
56323,1,2,197308,197309,197311,1,3,0
56324,3,1,197311,197311,197312,0,1,0
56325,6,2,197317,197317,197319,0,2,5
56326,2,3,197319,197319,197322,0,3,0
56327,6,1,197325,197325,197326,0,1,3
56328,6,2,197331,197331,197333,0,2,5
56329,3,3,197334,197334,197337,0,3,1
56330,3,2,197337,197337,197339,0,2,0
56331,4,2,197341,197341,197343,0,2,2
56332,1,1,197342,197343,197344,1,2,0
56333,4,3,197346,197346,197349,0,3,2
56334,6,2,197352,197352,197354,0,2,3
56335,3,2,197355,197355,197357,0,2,1
56336,4,3,197359,197359,197362,0,3,2
56337,4,3,197363,197363,197366,0,3,1
56338,2,2,197365,197366,197368,1,3,0
56339,1,3,197366,197368,197371,2,5,0
56340,4,3,197370,197371,197374,1,4,0
56341,2,2,197372,197374,197376,2,4,0
56342,4,2,197376,197376,197378,0,2,0
56343,5,2,197381,197381,197383,0,2,3
56344,2,2,197383,197383,197385,0,2,0
56345,2,1,197385,197385,197386,0,1,0
56346,4,2,197389,197389,197391,0,2,3
56347,4,2,197393,197393,197395,0,2,2
56348,6,1,197399,197399,197400,0,1,4
56349,6,1,197405,197405,197406,0,1,5
56350,3,3,197408,197408,197411,0,3,2
56351,5,3,197413,197413,197416,0,3,2
56352,2,1,197415,197416,197417,1,2,0
56353,2,1,197417,197417,197418,0,1,0
56354,1,3,197418,197418,197421,0,3,0
56355,3,3,197421,197421,197424,0,3,0
56356,2,2,197423,197424,197426,1,3,0
56357,2,1,197425,197426,197427,1,2,0
56358,3,1,197428,197428,197429,0,1,1
56359,6,2,197434,197434,197436,0,2,5
56360,3,1,197437,197437,197438,0,1,1
56361,6,2,197443,197443,197445,0,2,5
56362,4,2,197447,197447,197449,0,2,2
56363,3,2,197450,197450,197452,0,2,1
56364,1,3,197451,197452,197455,1,4,0
56365,6,2,197457,197457,197459,0,2,2
56366,2,3,197459,197459,197462,0,3,0
56367,3,1,197462,197462,197463,0,1,0
56368,2,1,197464,197464,197465,0,1,1
56369,4,1,197468,197468,197469,0,1,3
56370,1,3,197469,197469,197472,0,3,0
56371,4,1,197473,197473,197474,0,1,1
56372,6,3,197479,197479,197482,0,3,5
56373,3,2,197482,197482,197484,0,2,0
56374,4,1,197486,197486,197487,0,1,2
56375,1,1,197487,197487,197488,0,1,0
56376,1,3,197488,197488,197491,0,3,0
56377,3,1,197491,197491,197492,0,1,0
56378,5,3,197496,197496,197499,0,3,4
56379,5,1,197501,197501,197502,0,1,2
56380,2,2,197503,197503,197505,0,2,1
56381,4,3,197507,197507,197510,0,3,2
56382,6,1,197513,197513,197514,0,1,3
56383,5,2,197518,197518,197520,0,2,4
56384,1,2,197519,197520,197522,1,3,0
56385,2,2,197521,197522,197524,1,3,0
56386,3,1,197524,197524,197525,0,1,0
56387,3,1,197527,197527,197528,0,1,2
56388,2,1,197529,197529,197530,0,1,1
56389,2,1,197531,197531,197532,0,1,1
56390,6,1,197537,197537,197538,0,1,5
56391,3,1,197540,197540,197541,0,1,2
56392,6,2,197546,197546,197548,0,2,5
56393,1,2,197547,197548,197550,1,3,0
56394,5,1,197552,197552,197553,0,1,2
56395,2,3,197554,197554,197557,0,3,1
56396,1,1,197555,197557,197558,2,3,0
56397,1,1,197556,197558,197559,2,3,0
56398,5,2,197561,197561,197563,0,2,2
56399,5,2,197566,197566,197568,0,2,3
56400,6,2,197572,197572,197574,0,2,4
56401,3,1,197575,197575,197576,0,1,1
56402,2,1,197577,197577,197578,0,1,1
56403,1,2,197578,197578,197580,0,2,0
56404,4,2,197582,197582,197584,0,2,2
56405,2,2,197584,197584,197586,0,2,0
56406,2,3,197586,197586,197589,0,3,0
56407,3,2,197589,197589,197591,0,2,0
56408,4,2,197593,197593,197595,0,2,2
56409,2,2,197595,197595,197597,0,2,0
56410,1,3,197596,197597,197600,1,4,0
56411,5,2,197601,197601,197603,0,2,1
56412,3,3,197604,197604,197607,0,3,1
56413,2,1,197606,197607,197608,1,2,0
56414,4,3,197610,197610,197613,0,3,2
56415,4,2,197614,197614,197616,0,2,1
56416,1,1,197615,197616,197617,1,2,0
56417,1,3,197616,197617,197620,1,4,0
56418,5,2,197621,197621,197623,0,2,1
56419,1,2,197622,197623,197625,1,3,0
56420,4,2,197626,197626,197628,0,2,1
56421,3,1,197629,197629,197630,0,1,1
56422,4,1,197633,197633,197634,0,1,3
56423,1,3,197634,197634,197637,0,3,0
56424,4,3,197638,197638,197641,0,3,1
56425,1,3,197639,197641,197644,2,5,0
56426,2,1,197641,197644,197645,3,4,0
56427,1,2,197642,197645,197647,3,5,0
56428,1,1,197643,197647,197648,4,5,0
56429,5,2,197648,197648,197650,0,2,0
56430,3,1,197651,197651,197652,0,1,1
56431,5,1,197656,197656,197657,0,1,4
56432,2,3,197658,197658,197661,0,3,1
56433,5,1,197663,197663,197664,0,1,2
56434,5,2,197668,197668,197670,0,2,4
56435,4,1,197672,197672,197673,0,1,2
56436,4,1,197676,197676,197677,0,1,3
56437,4,2,197680,197680,197682,0,2,3
56438,5,1,197685,197685,197686,0,1,3
56439,1,3,197686,197686,197689,0,3,0
56440,6,1,197692,197692,197693,0,1,3
56441,3,1,197695,197695,197696,0,1,2
56442,6,3,197701,197701,197704,0,3,5
56443,6,2,197707,197707,197709,0,2,3
56444,2,3,197709,197709,197712,0,3,0
56445,6,1,197715,197715,197716,0,1,3
56446,1,1,197716,197716,197717,0,1,0
56447,5,2,197721,197721,197723,0,2,4
56448,3,2,197724,197724,197726,0,2,1
56449,3,3,197727,197727,197730,0,3,1
56450,1,3,197728,197730,197733,2,5,0
56451,3,1,197731,197733,197734,2,3,0
56452,6,3,197737,197737,197740,0,3,3
56453,2,3,197739,197740,197743,1,4,0
56454,5,3,197744,197744,197747,0,3,1
56455,1,2,197745,197747,197749,2,4,0
56456,2,1,197747,197749,197750,2,3,0
56457,6,3,197753,197753,197756,0,3,3
56458,4,1,197757,197757,197758,0,1,1
56459,2,2,197759,197759,197761,0,2,1
56460,4,2,197763,197763,197765,0,2,2
56461,1,2,197764,197765,197767,1,3,0
56462,5,2,197769,197769,197771,0,2,2
56463,1,3,197770,197771,197774,1,4,0
56464,1,1,197771,197774,197775,3,4,0
56465,4,3,197775,197775,197778,0,3,0
56466,4,3,197779,197779,197782,0,3,1
56467,4,3,197783,197783,197786,0,3,1
56468,2,2,197785,197786,197788,1,3,0
56469,4,2,197789,197789,197791,0,2,1
56470,1,2,197790,197791,197793,1,3,0
56471,6,3,197796,197796,197799,0,3,3
56472,2,2,197798,197799,197801,1,3,0
56473,3,2,197801,197801,197803,0,2,0
56474,2,2,197803,197803,197805,0,2,0
56475,3,1,197806,197806,197807,0,1,1
56476,1,1,197807,197807,197808,0,1,0
56477,2,1,197809,197809,197810,0,1,1
56478,4,2,197813,197813,197815,0,2,3
56479,3,2,197816,197816,197818,0,2,1
56480,1,1,197817,197818,197819,1,2,0
56481,5,2,197822,197822,197824,0,2,3
56482,5,3,197827,197827,197830,0,3,3
56483,1,3,197828,197830,197833,2,5,0
56484,5,3,197833,197833,197836,0,3,0
56485,6,2,197839,197839,197841,0,2,3
56486,4,1,197843,197843,197844,0,1,2
56487,2,2,197845,197845,197847,0,2,1
56488,2,1,197847,197847,197848,0,1,0
56489,3,2,197850,197850,197852,0,2,2
56490,2,3,197852,197852,197855,0,3,0
56491,4,2,197856,197856,197858,0,2,1
56492,6,1,197862,197862,197863,0,1,4
56493,5,3,197867,197867,197870,0,3,4
56494,5,2,197872,197872,197874,0,2,2
56495,4,2,197876,197876,197878,0,2,2
56496,1,1,197877,197878,197879,1,2,0
56497,1,1,197878,197879,197880,1,2,0
56498,4,1,197882,197882,197883,0,1,2
56499,2,1,197884,197884,197885,0,1,1
56500,1,1,197885,197885,197886,0,1,0
56501,5,1,197890,197890,197891,0,1,4
56502,1,3,197891,197891,197894,0,3,0
56503,3,3,197894,197894,197897,0,3,0
56504,2,1,197896,197897,197898,1,2,0
56505,3,3,197899,197899,197902,0,3,1
56506,3,3,197902,197902,197905,0,3,0
56507,4,1,197906,197906,197907,0,1,1
56508,6,1,197912,197912,197913,0,1,5
56509,1,2,197913,197913,197915,0,2,0
56510,2,3,197915,197915,197918,0,3,0
56511,1,3,197916,197918,197921,2,5,0
56512,1,3,197917,197921,197924,4,7,0
56513,6,1,197923,197924,197925,1,2,0
56514,4,3,197927,197927,197930,0,3,2
56515,3,3,197930,197930,197933,0,3,0
56516,3,2,197933,197933,197935,0,2,0
56517,6,3,197939,197939,197942,0,3,4
56518,5,3,197944,197944,197947,0,3,2
56519,3,3,197947,197947,197950,0,3,0
56520,6,3,197953,197953,197956,0,3,3
56521,3,3,197956,197956,197959,0,3,0
56522,2,3,197958,197959,197962,1,4,0
56523,5,3,197963,197963,197966,0,3,1
56524,6,2,197969,197969,197971,0,2,3
56525,2,1,197971,197971,197972,0,1,0
56526,6,3,197977,197977,197980,0,3,5
56527,5,1,197982,197982,197983,0,1,2
56528,2,2,197984,197984,197986,0,2,1
56529,4,1,197988,197988,197989,0,1,2
56530,6,3,197994,197994,197997,0,3,5
56531,4,1,197998,197998,197999,0,1,1
56532,6,2,198004,198004,198006,0,2,5
56533,5,1,198009,198009,198010,0,1,3
56534,2,3,198011,198011,198014,0,3,1
56535,4,3,198015,198015,198018,0,3,1
56536,3,2,198018,198018,198020,0,2,0
56537,5,1,198023,198023,198024,0,1,3
56538,5,3,198028,198028,198031,0,3,4
56539,3,1,198031,198031,198032,0,1,0
56540,2,2,198033,198033,198035,0,2,1
56541,1,2,198034,198035,198037,1,3,0
56542,3,2,198037,198037,198039,0,2,0
56543,1,3,198038,198039,198042,1,4,0
56544,6,3,198044,198044,198047,0,3,2
56545,6,1,198050,198050,198051,0,1,3
56546,6,2,198056,198056,198058,0,2,5
56547,5,1,198061,198061,198062,0,1,3
56548,6,3,198067,198067,198070,0,3,5
56549,6,3,198073,198073,198076,0,3,3
56550,5,2,198078,198078,198080,0,2,2
56551,6,2,198084,198084,198086,0,2,4
56552,4,2,198088,198088,198090,0,2,2
56553,1,2,198089,198090,198092,1,3,0
56554,3,1,198092,198092,198093,0,1,0
56555,4,2,198096,198096,198098,0,2,3
56556,3,2,198099,198099,198101,0,2,1
56557,1,1,198100,198101,198102,1,2,0
56558,5,1,198105,198105,198106,0,1,3
56559,1,1,198106,198106,198107,0,1,0
56560,1,3,198107,198107,198110,0,3,0
56561,4,3,198111,198111,198114,0,3,1
56562,1,1,198112,198114,198115,2,3,0
56563,2,2,198114,198115,198117,1,3,0
56564,6,3,198120,198120,198123,0,3,3
56565,3,1,198123,198123,198124,0,1,0
56566,6,1,198129,198129,198130,0,1,5
56567,2,3,198131,198131,198134,0,3,1
56568,3,2,198134,198134,198136,0,2,0
56569,1,2,198135,198136,198138,1,3,0
56570,6,1,198141,198141,198142,0,1,3
56571,5,2,198146,198146,198148,0,2,4
56572,2,1,198148,198148,198149,0,1,0
56573,3,1,198151,198151,198152,0,1,2
56574,6,2,198157,198157,198159,0,2,5
56575,2,3,198159,198159,198162,0,3,0
56576,2,1,198161,198162,198163,1,2,0
56577,4,3,198165,198165,198168,0,3,2
56578,2,1,198167,198168,198169,1,2,0
56579,2,1,198169,198169,198170,0,1,0
56580,6,1,198175,198175,198176,0,1,5
56581,2,2,198177,198177,198179,0,2,1
56582,6,3,198183,198183,198186,0,3,4
56583,1,2,198184,198186,198188,2,4,0
56584,2,1,198186,198188,198189,2,3,0
56585,1,3,198187,198189,198192,2,5,0
56586,4,2,198191,198192,198194,1,3,0
56587,6,2,198197,198197,198199,0,2,3
56588,5,2,198202,198202,198204,0,2,3
56589,4,1,198206,198206,198207,0,1,2
56590,3,1,198209,198209,198210,0,1,2
56591,3,2,198212,198212,198214,0,2,2
56592,6,1,198218,198218,198219,0,1,4
56593,6,2,198224,198224,198226,0,2,5
56594,5,2,198229,198229,198231,0,2,3
56595,2,3,198231,198231,198234,0,3,0
56596,3,1,198234,198234,198235,0,1,0
56597,2,1,198236,198236,198237,0,1,1
56598,5,3,198241,198241,198244,0,3,4
56599,5,2,198246,198246,198248,0,2,2
56600,1,2,198247,198248,198250,1,3,0
56601,4,3,198251,198251,198254,0,3,1
56602,1,2,198252,198254,198256,2,4,0
56603,6,1,198258,198258,198259,0,1,2
56604,1,3,198259,198259,198262,0,3,0
56605,2,2,198261,198262,198264,1,3,0
56606,6,2,198267,198267,198269,0,2,3
56607,6,1,198273,198273,198274,0,1,4
56608,2,1,198275,198275,198276,0,1,1
56609,2,1,198277,198277,198278,0,1,1
56610,5,2,198282,198282,198284,0,2,4
56611,3,1,198285,198285,198286,0,1,1
56612,1,2,198286,198286,198288,0,2,0
56613,2,1,198288,198288,198289,0,1,0
56614,5,1,198293,198293,198294,0,1,4
56615,2,2,198295,198295,198297,0,2,1
56616,2,1,198297,198297,198298,0,1,0
56617,5,1,198302,198302,198303,0,1,4
56618,4,2,198306,198306,198308,0,2,3
56619,3,3,198309,198309,198312,0,3,1
56620,3,1,198312,198312,198313,0,1,0
56621,3,1,198315,198315,198316,0,1,2
56622,1,3,198316,198316,198319,0,3,0
56623,3,3,198319,198319,198322,0,3,0
56624,6,2,198325,198325,198327,0,2,3
56625,2,1,198327,198327,198328,0,1,0
56626,4,3,198331,198331,198334,0,3,3
56627,1,2,198332,198334,198336,2,4,0
56628,3,3,198335,198336,198339,1,4,0
56629,1,2,198336,198339,198341,3,5,0
56630,5,3,198341,198341,198344,0,3,0
56631,4,3,198345,198345,198348,0,3,1
56632,5,1,198350,198350,198351,0,1,2
56633,4,1,198354,198354,198355,0,1,3
56634,3,1,198357,198357,198358,0,1,2
56635,3,2,198360,198360,198362,0,2,2
56636,1,3,198361,198362,198365,1,4,0
56637,3,1,198364,198365,198366,1,2,0
56638,6,1,198370,198370,198371,0,1,4
56639,2,2,198372,198372,198374,0,2,1
56640,3,3,198375,198375,198378,0,3,1
56641,2,1,198377,198378,198379,1,2,0
56642,4,2,198381,198381,198383,0,2,2
56643,6,2,198387,198387,198389,0,2,4
56644,3,1,198390,198390,198391,0,1,1
56645,6,3,198396,198396,198399,0,3,5
56646,4,3,198400,198400,198403,0,3,1
56647,3,3,198403,198403,198406,0,3,0
56648,2,1,198405,198406,198407,1,2,0
56649,1,2,198406,198407,198409,1,3,0
56650,1,3,198407,198409,198412,2,5,0
56651,1,2,198408,198412,198414,4,6,0
56652,4,2,198412,198414,198416,2,4,0
56653,3,2,198415,198416,198418,1,3,0
56654,1,2,198416,198418,198420,2,4,0
56655,5,3,198421,198421,198424,0,3,1
56656,4,3,198425,198425,198428,0,3,1
56657,1,2,198426,198428,198430,2,4,0
56658,3,1,198429,198430,198431,1,2,0
56659,6,2,198435,198435,198437,0,2,4
56660,2,2,198437,198437,198439,0,2,0
56661,4,3,198441,198441,198444,0,3,2
56662,4,2,198445,198445,198447,0,2,1
56663,4,2,198449,198449,198451,0,2,2
56664,2,3,198451,198451,198454,0,3,0
56665,1,3,198452,198454,198457,2,5,0
56666,6,3,198458,198458,198461,0,3,1
56667,4,3,198462,198462,198465,0,3,1
56668,6,2,198468,198468,198470,0,2,3
56669,4,2,198472,198472,198474,0,2,2
56670,5,3,198477,198477,198480,0,3,3
56671,4,2,198481,198481,198483,0,2,1
56672,6,2,198487,198487,198489,0,2,4
56673,1,2,198488,198489,198491,1,3,0
56674,4,1,198492,198492,198493,0,1,1
56675,5,1,198497,198497,198498,0,1,4
56676,1,1,198498,198498,198499,0,1,0
56677,1,1,198499,198499,198500,0,1,0
56678,2,3,198501,198501,198504,0,3,1
56679,4,3,198505,198505,198508,0,3,1
56680,3,1,198508,198508,198509,0,1,0
56681,6,3,198514,198514,198517,0,3,5
56682,5,1,198519,198519,198520,0,1,2
56683,5,2,198524,198524,198526,0,2,4
56684,1,3,198525,198526,198529,1,4,0
56685,4,1,198529,198529,198530,0,1,0
56686,4,1,198533,198533,198534,0,1,3
56687,3,3,198536,198536,198539,0,3,2
56688,5,1,198541,198541,198542,0,1,2
56689,5,2,198546,198546,198548,0,2,4
56690,4,1,198550,198550,198551,0,1,2
56691,6,2,198556,198556,198558,0,2,5
56692,4,1,198560,198560,198561,0,1,2
56693,4,3,198564,198564,198567,0,3,3
56694,3,3,198567,198567,198570,0,3,0
56695,1,3,198568,198570,198573,2,5,0
56696,1,1,198569,198573,198574,4,5,0
56697,4,2,198573,198574,198576,1,3,0
56698,3,2,198576,198576,198578,0,2,0
56699,2,1,198578,198578,198579,0,1,0
56700,3,2,198581,198581,198583,0,2,2
56701,6,1,198587,198587,198588,0,1,4
56702,2,1,198589,198589,198590,0,1,1
56703,6,1,198595,198595,198596,0,1,5
56704,3,2,198598,198598,198600,0,2,2
56705,6,2,198604,198604,198606,0,2,4
56706,2,1,198606,198606,198607,0,1,0
56707,6,3,198612,198612,198615,0,3,5
56708,4,2,198616,198616,198618,0,2,1
56709,4,3,198620,198620,198623,0,3,2
56710,6,3,198626,198626,198629,0,3,3
56711,6,2,198632,198632,198634,0,2,3
56712,1,2,198633,198634,198636,1,3,0
56713,4,3,198637,198637,198640,0,3,1
56714,4,1,198641,198641,198642,0,1,1
56715,3,1,198644,198644,198645,0,1,2
56716,3,3,198647,198647,198650,0,3,2
56717,3,2,198650,198650,198652,0,2,0
56718,1,3,198651,198652,198655,1,4,0
56719,2,2,198653,198655,198657,2,4,0
56720,5,1,198658,198658,198659,0,1,1
56721,4,1,198662,198662,198663,0,1,3
56722,4,2,198666,198666,198668,0,2,3
56723,4,3,198670,198670,198673,0,3,2
56724,6,3,198676,198676,198679,0,3,3
56725,6,3,198682,198682,198685,0,3,3
56726,6,3,198688,198688,198691,0,3,3
56727,6,3,198694,198694,198697,0,3,3
56728,3,1,198697,198697,198698,0,1,0
56729,5,3,198702,198702,198705,0,3,4
56730,5,2,198707,198707,198709,0,2,2
56731,1,2,198708,198709,198711,1,3,0
56732,3,1,198711,198711,198712,0,1,0
56733,5,3,198716,198716,198719,0,3,4
56734,1,2,198717,198719,198721,2,4,0
56735,6,2,198723,198723,198725,0,2,2
56736,1,3,198724,198725,198728,1,4,0
56737,3,3,198727,198728,198731,1,4,0
56738,6,1,198733,198733,198734,0,1,2
56739,1,1,198734,198734,198735,0,1,0
56740,4,2,198738,198738,198740,0,2,3
56741,3,1,198741,198741,198742,0,1,1
56742,4,1,198745,198745,198746,0,1,3
56743,5,1,198750,198750,198751,0,1,4
56744,2,2,198752,198752,198754,0,2,1
56745,6,3,198758,198758,198761,0,3,4
56746,1,1,198759,198761,198762,2,3,0
56747,5,1,198764,198764,198765,0,1,2
56748,2,1,198766,198766,198767,0,1,1
56749,1,3,198767,198767,198770,0,3,0
56750,2,1,198769,198770,198771,1,2,0
56751,6,2,198775,198775,198777,0,2,4
56752,3,3,198778,198778,198781,0,3,1
56753,5,1,198783,198783,198784,0,1,2
56754,3,1,198786,198786,198787,0,1,2
56755,4,1,198790,198790,198791,0,1,3
56756,6,1,198796,198796,198797,0,1,5
56757,6,3,198802,198802,198805,0,3,5
56758,2,1,198804,198805,198806,1,2,0
56759,6,3,198810,198810,198813,0,3,4
56760,4,2,198814,198814,198816,0,2,1
56761,1,2,198815,198816,198818,1,3,0
56762,2,1,198817,198818,198819,1,2,0
56763,1,3,198818,198819,198822,1,4,0
56764,1,3,198819,198822,198825,3,6,0
56765,1,3,198820,198825,198828,5,8,0
56766,2,2,198822,198828,198830,6,8,0
56767,6,1,198828,198830,198831,2,3,0
56768,1,2,198829,198831,198833,2,4,0
56769,1,3,198830,198833,198836,3,6,0
56770,5,3,198835,198836,198839,1,4,0
56771,6,2,198841,198841,198843,0,2,2
56772,6,2,198847,198847,198849,0,2,4
56773,3,2,198850,198850,198852,0,2,1
56774,3,2,198853,198853,198855,0,2,1
56775,6,1,198859,198859,198860,0,1,4
56776,3,3,198862,198862,198865,0,3,2
56777,2,2,198864,198865,198867,1,3,0
56778,1,2,198865,198867,198869,2,4,0
56779,4,2,198869,198869,198871,0,2,0
56780,3,3,198872,198872,198875,0,3,1
56781,4,3,198876,198876,198879,0,3,1
56782,5,2,198881,198881,198883,0,2,2
56783,4,3,198885,198885,198888,0,3,2
56784,1,1,198886,198888,198889,2,3,0
56785,6,3,198892,198892,198895,0,3,3
56786,3,1,198895,198895,198896,0,1,0
56787,4,2,198899,198899,198901,0,2,3
56788,6,1,198905,198905,198906,0,1,4
56789,2,2,198907,198907,198909,0,2,1
56790,2,1,198909,198909,198910,0,1,0
56791,4,3,198913,198913,198916,0,3,3
56792,6,1,198919,198919,198920,0,1,3
56793,1,1,198920,198920,198921,0,1,0
56794,5,2,198925,198925,198927,0,2,4
56795,1,1,198926,198927,198928,1,2,0
56796,4,2,198930,198930,198932,0,2,2
56797,1,3,198931,198932,198935,1,4,0
56798,5,3,198936,198936,198939,0,3,1
56799,3,2,198939,198939,198941,0,2,0
56800,3,2,198942,198942,198944,0,2,1
56801,3,1,198945,198945,198946,0,1,1
56802,4,1,198949,198949,198950,0,1,3
56803,2,3,198951,198951,198954,0,3,1
56804,3,2,198954,198954,198956,0,2,0
56805,5,1,198959,198959,198960,0,1,3
56806,5,3,198964,198964,198967,0,3,4
56807,4,3,198968,198968,198971,0,3,1
56808,6,3,198974,198974,198977,0,3,3
56809,1,1,198975,198977,198978,2,3,0
56810,6,3,198981,198981,198984,0,3,3
56811,3,3,198984,198984,198987,0,3,0
56812,4,1,198988,198988,198989,0,1,1
56813,1,1,198989,198989,198990,0,1,0
56814,3,3,198992,198992,198995,0,3,2
56815,6,2,198998,198998,199000,0,2,3
56816,5,3,199003,199003,199006,0,3,3
56817,4,3,199007,199007,199010,0,3,1
56818,1,2,199008,199010,199012,2,4,0
56819,3,1,199011,199012,199013,1,2,0
56820,4,2,199015,199015,199017,0,2,2
56821,4,2,199019,199019,199021,0,2,2
56822,6,3,199025,199025,199028,0,3,4
56823,5,2,199030,199030,199032,0,2,2
56824,4,3,199034,199034,199037,0,3,2
56825,2,3,199036,199037,199040,1,4,0
56826,4,3,199040,199040,199043,0,3,0
56827,5,2,199045,199045,199047,0,2,2
56828,1,3,199046,199047,199050,1,4,0
56829,1,3,199047,199050,199053,3,6,0
56830,1,2,199048,199053,199055,5,7,0
56831,3,1,199051,199055,199056,4,5,0
56832,3,3,199054,199056,199059,2,5,0
56833,5,1,199059,199059,199060,0,1,0
56834,2,2,199061,199061,199063,0,2,1
56835,2,3,199063,199063,199066,0,3,0
56836,5,1,199068,199068,199069,0,1,2
56837,6,2,199074,199074,199076,0,2,5
56838,3,2,199077,199077,199079,0,2,1
56839,1,3,199078,199079,199082,1,4,0
56840,3,3,199081,199082,199085,1,4,0
56841,6,1,199087,199087,199088,0,1,2
56842,3,2,199090,199090,199092,0,2,2
56843,2,2,199092,199092,199094,0,2,0
56844,4,3,199096,199096,199099,0,3,2
56845,1,3,199097,199099,199102,2,5,0
56846,5,2,199102,199102,199104,0,2,0
56847,3,1,199105,199105,199106,0,1,1
56848,6,2,199111,199111,199113,0,2,5
56849,5,1,199116,199116,199117,0,1,3
56850,1,2,199117,199117,199119,0,2,0
56851,1,1,199118,199119,199120,1,2,0
56852,5,1,199123,199123,199124,0,1,3
56853,3,3,199126,199126,199129,0,3,2
56854,1,3,199127,199129,199132,2,5,0
56855,1,2,199128,199132,199134,4,6,0
56856,3,1,199131,199134,199135,3,4,0
56857,4,2,199135,199135,199137,0,2,0
56858,4,2,199139,199139,199141,0,2,2
56859,3,2,199142,199142,199144,0,2,1
56860,5,1,199147,199147,199148,0,1,3
56861,2,3,199149,199149,199152,0,3,1
56862,6,3,199155,199155,199158,0,3,3
56863,3,2,199158,199158,199160,0,2,0
56864,2,3,199160,199160,199163,0,3,0
56865,2,1,199162,199163,199164,1,2,0
56866,1,3,199163,199164,199167,1,4,0
56867,4,3,199167,199167,199170,0,3,0
56868,1,3,199168,199170,199173,2,5,0
56869,3,1,199171,199173,199174,2,3,0
56870,4,3,199175,199175,199178,0,3,1
56871,6,3,199181,199181,199184,0,3,3
56872,3,3,199184,199184,199187,0,3,0
56873,3,1,199187,199187,199188,0,1,0
56874,3,1,199190,199190,199191,0,1,2
56875,3,2,199193,199193,199195,0,2,2
56876,2,2,199195,199195,199197,0,2,0
56877,1,3,199196,199197,199200,1,4,0
56878,1,2,199197,199200,199202,3,5,0
56879,1,2,199198,199202,199204,4,6,0
56880,4,3,199202,199204,199207,2,5,0
56881,4,1,199206,199207,199208,1,2,0
56882,6,2,199212,199212,199214,0,2,4
56883,2,2,199214,199214,199216,0,2,0
56884,1,1,199215,199216,199217,1,2,0
56885,1,2,199216,199217,199219,1,3,0
56886,5,1,199221,199221,199222,0,1,2
56887,1,3,199222,199222,199225,0,3,0
56888,3,2,199225,199225,199227,0,2,0
56889,2,3,199227,199227,199230,0,3,0
56890,6,2,199233,199233,199235,0,2,3
56891,5,3,199238,199238,199241,0,3,3
56892,1,2,199239,199241,199243,2,4,0
56893,1,3,199240,199243,199246,3,6,0
56894,6,3,199246,199246,199249,0,3,0
56895,1,2,199247,199249,199251,2,4,0
56896,2,1,199249,199251,199252,2,3,0
56897,2,1,199251,199252,199253,1,2,0
56898,3,1,199254,199254,199255,0,1,1
56899,6,2,199260,199260,199262,0,2,5
56900,6,3,199266,199266,199269,0,3,4
56901,6,2,199272,199272,199274,0,2,3
56902,6,3,199278,199278,199281,0,3,4
56903,4,1,199282,199282,199283,0,1,1
56904,1,1,199283,199283,199284,0,1,0
56905,1,2,199284,199284,199286,0,2,0
56906,1,3,199285,199286,199289,1,4,0
56907,4,1,199289,199289,199290,0,1,0
56908,6,3,199295,199295,199298,0,3,5
56909,2,1,199297,199298,199299,1,2,0
56910,2,3,199299,199299,199302,0,3,0
56911,6,3,199305,199305,199308,0,3,3
56912,5,2,199310,199310,199312,0,2,2
56913,2,1,199312,199312,199313,0,1,0
56914,4,2,199316,199316,199318,0,2,3
56915,1,3,199317,199318,199321,1,4,0
56916,2,1,199319,199321,199322,2,3,0
56917,4,3,199323,199323,199326,0,3,1
56918,1,1,199324,199326,199327,2,3,0
56919,2,3,199326,199327,199330,1,4,0
56920,2,1,199328,199330,199331,2,3,0
56921,5,3,199333,199333,199336,0,3,2
56922,2,1,199335,199336,199337,1,2,0
56923,4,2,199339,199339,199341,0,2,2
56924,6,1,199345,199345,199346,0,1,4
56925,3,1,199348,199348,199349,0,1,2
56926,4,2,199352,199352,199354,0,2,3
56927,6,2,199358,199358,199360,0,2,4
56928,2,3,199360,199360,199363,0,3,0
56929,4,3,199364,199364,199367,0,3,1
56930,1,1,199365,199367,199368,2,3,0
56931,4,2,199369,199369,199371,0,2,1
56932,1,1,199370,199371,199372,1,2,0
56933,3,3,199373,199373,199376,0,3,1
56934,1,2,199374,199376,199378,2,4,0
56935,4,3,199378,199378,199381,0,3,0
56936,6,2,199384,199384,199386,0,2,3
56937,6,2,199390,199390,199392,0,2,4
56938,6,1,199396,199396,199397,0,1,4
56939,2,2,199398,199398,199400,0,2,1
56940,5,1,199403,199403,199404,0,1,3
56941,3,2,199406,199406,199408,0,2,2
56942,1,3,199407,199408,199411,1,4,0
56943,3,2,199410,199411,199413,1,3,0
56944,3,1,199413,199413,199414,0,1,0
56945,4,1,199417,199417,199418,0,1,3
56946,6,2,199423,199423,199425,0,2,5
56947,1,3,199424,199425,199428,1,4,0
56948,2,3,199426,199428,199431,2,5,0
56949,6,1,199432,199432,199433,0,1,1
56950,5,3,199437,199437,199440,0,3,4
56951,2,3,199439,199440,199443,1,4,0
56952,6,1,199445,199445,199446,0,1,2
56953,6,2,199451,199451,199453,0,2,5
56954,4,2,199455,199455,199457,0,2,2
56955,4,2,199459,199459,199461,0,2,2
56956,3,2,199462,199462,199464,0,2,1
56957,4,1,199466,199466,199467,0,1,2
56958,4,1,199470,199470,199471,0,1,3
56959,4,2,199474,199474,199476,0,2,3
56960,3,2,199477,199477,199479,0,2,1
56961,6,1,199483,199483,199484,0,1,4
56962,5,2,199488,199488,199490,0,2,4
56963,2,2,199490,199490,199492,0,2,0
56964,3,2,199493,199493,199495,0,2,1
56965,5,1,199498,199498,199499,0,1,3
56966,1,3,199499,199499,199502,0,3,0
56967,3,2,199502,199502,199504,0,2,0
56968,5,3,199507,199507,199510,0,3,3
56969,1,1,199508,199510,199511,2,3,0
56970,6,2,199514,199514,199516,0,2,3
56971,3,2,199517,199517,199519,0,2,1
56972,3,2,199520,199520,199522,0,2,1
56973,1,1,199521,199522,199523,1,2,0
56974,5,3,199526,199526,199529,0,3,3
56975,1,2,199527,199529,199531,2,4,0
56976,6,3,199533,199533,199536,0,3,2
56977,6,3,199539,199539,199542,0,3,3
56978,1,1,199540,199542,199543,2,3,0
56979,2,1,199542,199543,199544,1,2,0
56980,6,2,199548,199548,199550,0,2,4
56981,1,3,199549,199550,199553,1,4,0
56982,2,3,199551,199553,199556,2,5,0
56983,3,2,199554,199556,199558,2,4,0
56984,4,3,199558,199558,199561,0,3,0
56985,4,3,199562,199562,199565,0,3,1
56986,6,3,199568,199568,199571,0,3,3
56987,6,1,199574,199574,199575,0,1,3
56988,3,2,199577,199577,199579,0,2,2
56989,5,2,199582,199582,199584,0,2,3
56990,4,2,199586,199586,199588,0,2,2
56991,1,2,199587,199588,199590,1,3,0
56992,2,1,199589,199590,199591,1,2,0
56993,5,3,199594,199594,199597,0,3,3
56994,3,2,199597,199597,199599,0,2,0
56995,1,2,199598,199599,199601,1,3,0
56996,2,3,199600,199601,199604,1,4,0
56997,6,2,199606,199606,199608,0,2,2
56998,4,3,199610,199610,199613,0,3,2
56999,6,2,199616,199616,199618,0,2,3
57000,3,1,199619,199619,199620,0,1,1
57001,2,1,199621,199621,199622,0,1,1
57002,2,1,199623,199623,199624,0,1,1
57003,3,1,199626,199626,199627,0,1,2
57004,1,1,199627,199627,199628,0,1,0
57005,2,2,199629,199629,199631,0,2,1
57006,5,1,199634,199634,199635,0,1,3
57007,6,3,199640,199640,199643,0,3,5
57008,4,1,199644,199644,199645,0,1,1
57009,3,2,199647,199647,199649,0,2,2
57010,1,3,199648,199649,199652,1,4,0
57011,2,2,199650,199652,199654,2,4,0
57012,2,3,199652,199654,199657,2,5,0
57013,1,3,199653,199657,199660,4,7,0
57014,2,3,199655,199660,199663,5,8,0
57015,5,2,199660,199663,199665,3,5,0
57016,4,1,199664,199665,199666,1,2,0
57017,3,1,199667,199667,199668,0,1,1
57018,5,3,199672,199672,199675,0,3,4
57019,3,3,199675,199675,199678,0,3,0
57020,4,2,199679,199679,199681,0,2,1
57021,5,2,199684,199684,199686,0,2,3
57022,4,3,199688,199688,199691,0,3,2
57023,1,1,199689,199691,199692,2,3,0
57024,5,1,199694,199694,199695,0,1,2
57025,3,2,199697,199697,199699,0,2,2
57026,5,3,199702,199702,199705,0,3,3
57027,6,3,199708,199708,199711,0,3,3
57028,6,3,199714,199714,199717,0,3,3
57029,4,2,199718,199718,199720,0,2,1
57030,6,1,199724,199724,199725,0,1,4
57031,1,2,199725,199725,199727,0,2,0
57032,3,1,199728,199728,199729,0,1,1
57033,4,2,199732,199732,199734,0,2,3
57034,4,1,199736,199736,199737,0,1,2
57035,2,1,199738,199738,199739,0,1,1
57036,4,2,199742,199742,199744,0,2,3
57037,3,3,199745,199745,199748,0,3,1
57038,3,2,199748,199748,199750,0,2,0
57039,1,3,199749,199750,199753,1,4,0
57040,2,1,199751,199753,199754,2,3,0
57041,2,1,199753,199754,199755,1,2,0
57042,1,3,199754,199755,199758,1,4,0
57043,2,1,199756,199758,199759,2,3,0
57044,1,2,199757,199759,199761,2,4,0
57045,2,3,199759,199761,199764,2,5,0
57046,1,1,199760,199764,199765,4,5,0
57047,5,1,199765,199765,199766,0,1,0
57048,3,1,199768,199768,199769,0,1,2
57049,3,2,199771,199771,199773,0,2,2
57050,5,2,199776,199776,199778,0,2,3
57051,6,1,199782,199782,199783,0,1,4
57052,3,1,199785,199785,199786,0,1,2
57053,1,2,199786,199786,199788,0,2,0
57054,2,1,199788,199788,199789,0,1,0
57055,5,1,199793,199793,199794,0,1,4
57056,2,1,199795,199795,199796,0,1,1
57057,1,2,199796,199796,199798,0,2,0
57058,1,2,199797,199798,199800,1,3,0
57059,4,1,199801,199801,199802,0,1,1
57060,6,3,199807,199807,199810,0,3,5
57061,2,2,199809,199810,199812,1,3,0
57062,5,3,199814,199814,199817,0,3,2
57063,2,1,199816,199817,199818,1,2,0
57064,4,1,199820,199820,199821,0,1,2
57065,4,2,199824,199824,199826,0,2,3
57066,6,2,199830,199830,199832,0,2,4
57067,1,1,199831,199832,199833,1,2,0
57068,6,2,199837,199837,199839,0,2,4
57069,6,2,199843,199843,199845,0,2,4
57070,6,2,199849,199849,199851,0,2,4
57071,1,1,199850,199851,199852,1,2,0
57072,6,3,199856,199856,199859,0,3,4
57073,4,1,199860,199860,199861,0,1,1
57074,4,2,199864,199864,199866,0,2,3
57075,2,3,199866,199866,199869,0,3,0
57076,4,1,199870,199870,199871,0,1,1
57077,4,2,199874,199874,199876,0,2,3
57078,5,1,199879,199879,199880,0,1,3
57079,1,1,199880,199880,199881,0,1,0
57080,2,3,199882,199882,199885,0,3,1
57081,6,3,199888,199888,199891,0,3,3
57082,2,3,199890,199891,199894,1,4,0
57083,4,1,199894,199894,199895,0,1,0
57084,2,2,199896,199896,199898,0,2,1
57085,1,1,199897,199898,199899,1,2,0
57086,4,3,199901,199901,199904,0,3,2
57087,2,3,199903,199904,199907,1,4,0
57088,6,1,199909,199909,199910,0,1,2
57089,2,3,199911,199911,199914,0,3,1
57090,1,3,199912,199914,199917,2,5,0
57091,3,1,199915,199917,199918,2,3,0
57092,4,2,199919,199919,199921,0,2,1
57093,1,2,199920,199921,199923,1,3,0
57094,3,1,199923,199923,199924,0,1,0
57095,3,2,199926,199926,199928,0,2,2
57096,3,1,199929,199929,199930,0,1,1
57097,1,2,199930,199930,199932,0,2,0
57098,2,3,199932,199932,199935,0,3,0
57099,6,2,199938,199938,199940,0,2,3
57100,4,2,199942,199942,199944,0,2,2
57101,2,3,199944,199944,199947,0,3,0
57102,3,1,199947,199947,199948,0,1,0
57103,6,1,199953,199953,199954,0,1,5
57104,2,1,199955,199955,199956,0,1,1
57105,3,1,199958,199958,199959,0,1,2
57106,1,2,199959,199959,199961,0,2,0
57107,1,2,199960,199961,199963,1,3,0
57108,1,1,199961,199963,199964,2,3,0
57109,2,2,199963,199964,199966,1,3,0
57110,2,1,199965,199966,199967,1,2,0
57111,1,2,199966,199967,199969,1,3,0
57112,1,2,199967,199969,199971,2,4,0
57113,6,1,199973,199973,199974,0,1,2
57114,4,2,199977,199977,199979,0,2,3
57115,4,2,199981,199981,199983,0,2,2
57116,2,1,199983,199983,199984,0,1,0
57117,4,3,199987,199987,199990,0,3,3
57118,2,1,199989,199990,199991,1,2,0
57119,1,1,199990,199991,199992,1,2,0
57120,1,2,199991,199992,199994,1,3,0
57121,6,1,199997,199997,199998,0,1,3
57122,3,1,200000,200000,200001,0,1,2
57123,5,1,200005,200005,200006,0,1,4
57124,3,2,200008,200008,200010,0,2,2
57125,1,1,200009,200010,200011,1,2,0
57126,5,1,200014,200014,200015,0,1,3
57127,2,3,200016,200016,200019,0,3,1
57128,3,2,200019,200019,200021,0,2,0
57129,3,2,200022,200022,200024,0,2,1
57130,6,2,200028,200028,200030,0,2,4
57131,4,2,200032,200032,200034,0,2,2
57132,4,3,200036,200036,200039,0,3,2
57133,5,2,200041,200041,200043,0,2,2
57134,3,3,200044,200044,200047,0,3,1
57135,6,1,200050,200050,200051,0,1,3
57136,2,1,200052,200052,200053,0,1,1
57137,3,3,200055,200055,200058,0,3,2
57138,1,1,200056,200058,200059,2,3,0
57139,4,2,200060,200060,200062,0,2,1
57140,1,2,200061,200062,200064,1,3,0
57141,5,3,200066,200066,200069,0,3,2
57142,2,1,200068,200069,200070,1,2,0
57143,5,3,200073,200073,200076,0,3,3
57144,6,3,200079,200079,200082,0,3,3
57145,1,1,200080,200082,200083,2,3,0
57146,6,2,200086,200086,200088,0,2,3
57147,6,1,200092,200092,200093,0,1,4
57148,2,2,200094,200094,200096,0,2,1
57149,1,3,200095,200096,200099,1,4,0
57150,5,2,200100,200100,200102,0,2,1
57151,1,1,200101,200102,200103,1,2,0
57152,4,1,200105,200105,200106,0,1,2
57153,2,1,200107,200107,200108,0,1,1
57154,2,3,200109,200109,200112,0,3,1
57155,6,3,200115,200115,200118,0,3,3
57156,3,1,200118,200118,200119,0,1,0
57157,5,2,200123,200123,200125,0,2,4
57158,2,3,200125,200125,200128,0,3,0
57159,5,3,200130,200130,200133,0,3,2
57160,1,3,200131,200133,200136,2,5,0
57161,1,2,200132,200136,200138,4,6,0
57162,6,2,200138,200138,200140,0,2,0
57163,4,1,200142,200142,200143,0,1,2
57164,3,1,200145,200145,200146,0,1,2
57165,2,1,200147,200147,200148,0,1,1
57166,1,1,200148,200148,200149,0,1,0
57167,3,1,200151,200151,200152,0,1,2
57168,5,1,200156,200156,200157,0,1,4
57169,6,1,200162,200162,200163,0,1,5
57170,6,3,200168,200168,200171,0,3,5
57171,4,1,200172,200172,200173,0,1,1
57172,2,3,200174,200174,200177,0,3,1
57173,6,3,200180,200180,200183,0,3,3
57174,6,2,200186,200186,200188,0,2,3
57175,5,1,200191,200191,200192,0,1,3
57176,6,3,200197,200197,200200,0,3,5
57177,5,1,200202,200202,200203,0,1,2
57178,2,3,200204,200204,200207,0,3,1
57179,2,3,200206,200207,200210,1,4,0
57180,3,2,200209,200210,200212,1,3,0
57181,6,3,200215,200215,200218,0,3,3
57182,4,1,200219,200219,200220,0,1,1
57183,2,3,200221,200221,200224,0,3,1
57184,3,1,200224,200224,200225,0,1,0
57185,4,1,200228,200228,200229,0,1,3
57186,6,1,200234,200234,200235,0,1,5
57187,5,3,200239,200239,200242,0,3,4
57188,3,1,200242,200242,200243,0,1,0
57189,5,1,200247,200247,200248,0,1,4
57190,2,1,200249,200249,200250,0,1,1
57191,4,2,200253,200253,200255,0,2,3
57192,3,1,200256,200256,200257,0,1,1
57193,4,1,200260,200260,200261,0,1,3
57194,3,1,200263,200263,200264,0,1,2
57195,4,1,200267,200267,200268,0,1,3
57196,6,1,200273,200273,200274,0,1,5
57197,2,1,200275,200275,200276,0,1,1
57198,6,2,200281,200281,200283,0,2,5
57199,2,1,200283,200283,200284,0,1,0
57200,4,3,200287,200287,200290,0,3,3
57201,6,1,200293,200293,200294,0,1,3
57202,1,1,200294,200294,200295,0,1,0
57203,4,3,200298,200298,200301,0,3,3
57204,3,3,200301,200301,200304,0,3,0
57205,2,3,200303,200304,200307,1,4,0
57206,2,3,200305,200307,200310,2,5,0
57207,1,2,200306,200310,200312,4,6,0
57208,2,1,200308,200312,200313,4,5,0
57209,6,2,200314,200314,200316,0,2,1
57210,6,2,200320,200320,200322,0,2,4
57211,5,1,200325,200325,200326,0,1,3
57212,4,1,200329,200329,200330,0,1,3
57213,2,2,200331,200331,200333,0,2,1
57214,2,3,200333,200333,200336,0,3,0
57215,5,1,200338,200338,200339,0,1,2
57216,6,3,200344,200344,200347,0,3,5
57217,3,2,200347,200347,200349,0,2,0
57218,1,3,200348,200349,200352,1,4,0
57219,4,1,200352,200352,200353,0,1,0
57220,4,1,200356,200356,200357,0,1,3
57221,5,2,200361,200361,200363,0,2,4
57222,5,3,200366,200366,200369,0,3,3
57223,4,2,200370,200370,200372,0,2,1
57224,1,2,200371,200372,200374,1,3,0
57225,2,1,200373,200374,200375,1,2,0
57226,4,3,200377,200377,200380,0,3,2
57227,3,1,200380,200380,200381,0,1,0
57228,4,3,200384,200384,200387,0,3,3
57229,2,1,200386,200387,200388,1,2,0
57230,6,3,200392,200392,200395,0,3,4
57231,4,3,200396,200396,200399,0,3,1
57232,4,1,200400,200400,200401,0,1,1
57233,6,2,200406,200406,200408,0,2,5
57234,2,3,200408,200408,200411,0,3,0
57235,4,3,200412,200412,200415,0,3,1
57236,2,1,200414,200415,200416,1,2,0
57237,4,3,200418,200418,200421,0,3,2
57238,4,2,200422,200422,200424,0,2,1
57239,6,1,200428,200428,200429,0,1,4
57240,3,3,200431,200431,200434,0,3,2
57241,5,1,200436,200436,200437,0,1,2
57242,5,2,200441,200441,200443,0,2,4
57243,2,3,200443,200443,200446,0,3,0
57244,1,1,200444,200446,200447,2,3,0
57245,3,2,200447,200447,200449,0,2,0
57246,1,1,200448,200449,200450,1,2,0
57247,6,2,200454,200454,200456,0,2,4
57248,1,3,200455,200456,200459,1,4,0
57249,5,3,200460,200460,200463,0,3,1
57250,3,1,200463,200463,200464,0,1,0
57251,5,3,200468,200468,200471,0,3,4
57252,5,3,200473,200473,200476,0,3,2
57253,4,3,200477,200477,200480,0,3,1
57254,6,2,200483,200483,200485,0,2,3
57255,5,3,200488,200488,200491,0,3,3
57256,4,1,200492,200492,200493,0,1,1
57257,1,2,200493,200493,200495,0,2,0
57258,5,1,200498,200498,200499,0,1,3
57259,3,1,200501,200501,200502,0,1,2
57260,3,1,200504,200504,200505,0,1,2
57261,4,3,200508,200508,200511,0,3,3
57262,3,1,200511,200511,200512,0,1,0
57263,3,2,200514,200514,200516,0,2,2
57264,3,2,200517,200517,200519,0,2,1
57265,6,1,200523,200523,200524,0,1,4
57266,2,2,200525,200525,200527,0,2,1
57267,1,1,200526,200527,200528,1,2,0
57268,3,1,200529,200529,200530,0,1,1
57269,1,1,200530,200530,200531,0,1,0
57270,6,3,200536,200536,200539,0,3,5
57271,6,2,200542,200542,200544,0,2,3
57272,2,2,200544,200544,200546,0,2,0
57273,4,1,200548,200548,200549,0,1,2
57274,6,1,200554,200554,200555,0,1,5
57275,1,2,200555,200555,200557,0,2,0
57276,4,1,200559,200559,200560,0,1,2
57277,5,1,200564,200564,200565,0,1,4
57278,3,3,200567,200567,200570,0,3,2
57279,6,2,200573,200573,200575,0,2,3
57280,3,1,200576,200576,200577,0,1,1
57281,1,1,200577,200577,200578,0,1,0
57282,4,1,200581,200581,200582,0,1,3
57283,1,3,200582,200582,200585,0,3,0
57284,4,2,200586,200586,200588,0,2,1
57285,1,1,200587,200588,200589,1,2,0
57286,6,1,200593,200593,200594,0,1,4
57287,6,1,200599,200599,200600,0,1,5
57288,5,3,200604,200604,200607,0,3,4
57289,5,1,200609,200609,200610,0,1,2
57290,4,1,200613,200613,200614,0,1,3
57291,6,3,200619,200619,200622,0,3,5
57292,6,2,200625,200625,200627,0,2,3
57293,2,2,200627,200627,200629,0,2,0
57294,6,1,200633,200633,200634,0,1,4
57295,5,2,200638,200638,200640,0,2,4
57296,3,2,200641,200641,200643,0,2,1
57297,3,3,200644,200644,200647,0,3,1
57298,3,1,200647,200647,200648,0,1,0
57299,6,3,200653,200653,200656,0,3,5
57300,6,1,200659,200659,200660,0,1,3
57301,5,3,200664,200664,200667,0,3,4
57302,4,2,200668,200668,200670,0,2,1
57303,6,2,200674,200674,200676,0,2,4
57304,6,2,200680,200680,200682,0,2,4
57305,5,3,200685,200685,200688,0,3,3
57306,3,2,200688,200688,200690,0,2,0
57307,2,1,200690,200690,200691,0,1,0
57308,1,2,200691,200691,200693,0,2,0
57309,5,1,200696,200696,200697,0,1,3
57310,2,1,200698,200698,200699,0,1,1
57311,3,3,200701,200701,200704,0,3,2
57312,4,3,200705,200705,200708,0,3,1
57313,3,3,200708,200708,200711,0,3,0
57314,2,1,200710,200711,200712,1,2,0
57315,3,1,200713,200713,200714,0,1,1
57316,2,2,200715,200715,200717,0,2,1
57317,6,3,200721,200721,200724,0,3,4
57318,2,3,200723,200724,200727,1,4,0
57319,6,2,200729,200729,200731,0,2,2
57320,2,2,200731,200731,200733,0,2,0
57321,2,1,200733,200733,200734,0,1,0
57322,2,1,200735,200735,200736,0,1,1
57323,6,1,200741,200741,200742,0,1,5
57324,6,2,200747,200747,200749,0,2,5
57325,2,3,200749,200749,200752,0,3,0
57326,5,3,200754,200754,200757,0,3,2
57327,1,1,200755,200757,200758,2,3,0
57328,2,2,200757,200758,200760,1,3,0
57329,2,3,200759,200760,200763,1,4,0
57330,2,1,200761,200763,200764,2,3,0
57331,5,3,200766,200766,200769,0,3,2
57332,6,1,200772,200772,200773,0,1,3
57333,2,3,200774,200774,200777,0,3,1
57334,6,2,200780,200780,200782,0,2,3
57335,5,3,200785,200785,200788,0,3,3
57336,5,1,200790,200790,200791,0,1,2
57337,6,2,200796,200796,200798,0,2,5
57338,5,1,200801,200801,200802,0,1,3
57339,2,3,200803,200803,200806,0,3,1
57340,3,3,200806,200806,200809,0,3,0
57341,1,3,200807,200809,200812,2,5,0
57342,1,2,200808,200812,200814,4,6,0
57343,6,2,200814,200814,200816,0,2,0
57344,1,1,200815,200816,200817,1,2,0
57345,1,1,200816,200817,200818,1,2,0
57346,3,3,200819,200819,200822,0,3,1
57347,2,2,200821,200822,200824,1,3,0
57348,5,2,200826,200826,200828,0,2,2
57349,4,2,200830,200830,200832,0,2,2
57350,4,2,200834,200834,200836,0,2,2
57351,2,2,200836,200836,200838,0,2,0
57352,4,2,200840,200840,200842,0,2,2
57353,5,1,200845,200845,200846,0,1,3
57354,4,3,200849,200849,200852,0,3,3
57355,4,3,200853,200853,200856,0,3,1
57356,6,2,200859,200859,200861,0,2,3
57357,6,3,200865,200865,200868,0,3,4
57358,3,3,200868,200868,200871,0,3,0
57359,4,2,200872,200872,200874,0,2,1
57360,6,3,200878,200878,200881,0,3,4
57361,6,2,200884,200884,200886,0,2,3
57362,5,3,200889,200889,200892,0,3,3
57363,3,2,200892,200892,200894,0,2,0
57364,2,3,200894,200894,200897,0,3,0
57365,3,3,200897,200897,200900,0,3,0
57366,6,2,200903,200903,200905,0,2,3
57367,4,3,200907,200907,200910,0,3,2
57368,2,1,200909,200910,200911,1,2,0
57369,4,1,200913,200913,200914,0,1,2
57370,2,3,200915,200915,200918,0,3,1
57371,4,2,200919,200919,200921,0,2,1
57372,1,1,200920,200921,200922,1,2,0
57373,1,3,200921,200922,200925,1,4,0
57374,3,3,200924,200925,200928,1,4,0
57375,1,3,200925,200928,200931,3,6,0
57376,1,1,200926,200931,200932,5,6,0
57377,6,2,200932,200932,200934,0,2,0
57378,5,2,200937,200937,200939,0,2,3
57379,2,1,200939,200939,200940,0,1,0
57380,1,1,200940,200940,200941,0,1,0
57381,2,3,200942,200942,200945,0,3,1
57382,3,3,200945,200945,200948,0,3,0
57383,5,3,200950,200950,200953,0,3,2
57384,4,1,200954,200954,200955,0,1,1
57385,2,1,200956,200956,200957,0,1,1
57386,4,3,200960,200960,200963,0,3,3
57387,3,3,200963,200963,200966,0,3,0
57388,1,1,200964,200966,200967,2,3,0
57389,5,1,200969,200969,200970,0,1,2
57390,4,2,200973,200973,200975,0,2,3
57391,1,3,200974,200975,200978,1,4,0
57392,3,2,200977,200978,200980,1,3,0
57393,3,3,200980,200980,200983,0,3,0
57394,6,1,200986,200986,200987,0,1,3
57395,4,3,200990,200990,200993,0,3,3
57396,1,2,200991,200993,200995,2,4,0
57397,1,1,200992,200995,200996,3,4,0
57398,3,3,200995,200996,200999,1,4,0
57399,6,2,201001,201001,201003,0,2,2
57400,6,3,201007,201007,201010,0,3,4
57401,6,3,201013,201013,201016,0,3,3
57402,3,2,201016,201016,201018,0,2,0
57403,2,3,201018,201018,201021,0,3,0
57404,2,1,201020,201021,201022,1,2,0
57405,1,2,201021,201022,201024,1,3,0
57406,6,2,201027,201027,201029,0,2,3
57407,3,3,201030,201030,201033,0,3,1
57408,3,3,201033,201033,201036,0,3,0
57409,6,3,201039,201039,201042,0,3,3
57410,5,1,201044,201044,201045,0,1,2
57411,3,2,201047,201047,201049,0,2,2
57412,4,3,201051,201051,201054,0,3,2
57413,6,1,201057,201057,201058,0,1,3
57414,4,3,201061,201061,201064,0,3,3
57415,4,1,201065,201065,201066,0,1,1
57416,5,3,201070,201070,201073,0,3,4
57417,3,3,201073,201073,201076,0,3,0
57418,3,2,201076,201076,201078,0,2,0
57419,3,2,201079,201079,201081,0,2,1
57420,3,1,201082,201082,201083,0,1,1
57421,3,1,201085,201085,201086,0,1,2
57422,3,1,201088,201088,201089,0,1,2
57423,4,1,201092,201092,201093,0,1,3
57424,6,3,201098,201098,201101,0,3,5
57425,2,2,201100,201101,201103,1,3,0
57426,1,1,201101,201103,201104,2,3,0
57427,1,1,201102,201104,201105,2,3,0
57428,5,3,201107,201107,201110,0,3,2
57429,6,3,201113,201113,201116,0,3,3
57430,5,3,201118,201118,201121,0,3,2
57431,2,3,201120,201121,201124,1,4,0
57432,1,3,201121,201124,201127,3,6,0
57433,4,3,201125,201127,201130,2,5,0
57434,1,2,201126,201130,201132,4,6,0
57435,2,1,201128,201132,201133,4,5,0
57436,4,2,201132,201133,201135,1,3,0
57437,6,1,201138,201138,201139,0,1,3
57438,5,2,201143,201143,201145,0,2,4
57439,3,3,201146,201146,201149,0,3,1
57440,1,1,201147,201149,201150,2,3,0
57441,5,3,201152,201152,201155,0,3,2
57442,6,3,201158,201158,201161,0,3,3
57443,3,2,201161,201161,201163,0,2,0
57444,1,1,201162,201163,201164,1,2,0
57445,1,3,201163,201164,201167,1,4,0
57446,4,2,201167,201167,201169,0,2,0
57447,2,1,201169,201169,201170,0,1,0
57448,1,2,201170,201170,201172,0,2,0
57449,2,1,201172,201172,201173,0,1,0
57450,3,2,201175,201175,201177,0,2,2
57451,6,3,201181,201181,201184,0,3,4
57452,1,1,201182,201184,201185,2,3,0
57453,5,1,201187,201187,201188,0,1,2
57454,3,1,201190,201190,201191,0,1,2
57455,3,2,201193,201193,201195,0,2,2
57456,1,2,201194,201195,201197,1,3,0
57457,3,1,201197,201197,201198,0,1,0
57458,6,1,201203,201203,201204,0,1,5
57459,3,3,201206,201206,201209,0,3,2
57460,5,1,201211,201211,201212,0,1,2
57461,4,3,201215,201215,201218,0,3,3
57462,3,1,201218,201218,201219,0,1,0
57463,1,3,201219,201219,201222,0,3,0
57464,6,3,201225,201225,201228,0,3,3
57465,6,1,201231,201231,201232,0,1,3
57466,4,2,201235,201235,201237,0,2,3
57467,2,2,201237,201237,201239,0,2,0
57468,1,2,201238,201239,201241,1,3,0
57469,3,3,201241,201241,201244,0,3,0
57470,6,1,201247,201247,201248,0,1,3
57471,5,3,201252,201252,201255,0,3,4
57472,2,3,201254,201255,201258,1,4,0
57473,2,3,201256,201258,201261,2,5,0
57474,3,3,201259,201261,201264,2,5,0
57475,5,3,201264,201264,201267,0,3,0
57476,5,2,201269,201269,201271,0,2,2
57477,3,3,201272,201272,201275,0,3,1
57478,4,1,201276,201276,201277,0,1,1
57479,2,1,201278,201278,201279,0,1,1
57480,6,3,201284,201284,201287,0,3,5
57481,3,1,201287,201287,201288,0,1,0
57482,2,2,201289,201289,201291,0,2,1
57483,4,1,201293,201293,201294,0,1,2
57484,3,1,201296,201296,201297,0,1,2
57485,4,2,201300,201300,201302,0,2,3
57486,5,3,201305,201305,201308,0,3,3
57487,6,3,201311,201311,201314,0,3,3
57488,4,2,201315,201315,201317,0,2,1
57489,3,1,201318,201318,201319,0,1,1
57490,5,2,201323,201323,201325,0,2,4
57491,4,3,201327,201327,201330,0,3,2
57492,4,3,201331,201331,201334,0,3,1
57493,4,2,201335,201335,201337,0,2,1
57494,1,3,201336,201337,201340,1,4,0
57495,1,1,201337,201340,201341,3,4,0
57496,2,2,201339,201341,201343,2,4,0
57497,6,3,201345,201345,201348,0,3,2
57498,1,1,201346,201348,201349,2,3,0
57499,2,1,201348,201349,201350,1,2,0
57500,4,3,201352,201352,201355,0,3,2
57501,4,2,201356,201356,201358,0,2,1
57502,4,2,201360,201360,201362,0,2,2
57503,2,3,201362,201362,201365,0,3,0
57504,6,1,201368,201368,201369,0,1,3
57505,6,3,201374,201374,201377,0,3,5
57506,4,3,201378,201378,201381,0,3,1
57507,1,2,201379,201381,201383,2,4,0
57508,6,1,201385,201385,201386,0,1,2
57509,2,1,201387,201387,201388,0,1,1
57510,1,3,201388,201388,201391,0,3,0
57511,4,3,201392,201392,201395,0,3,1
57512,3,3,201395,201395,201398,0,3,0
57513,1,3,201396,201398,201401,2,5,0
57514,3,1,201399,201401,201402,2,3,0
57515,4,1,201403,201403,201404,0,1,1
57516,3,2,201406,201406,201408,0,2,2
57517,6,1,201412,201412,201413,0,1,4
57518,1,3,201413,201413,201416,0,3,0
57519,4,2,201417,201417,201419,0,2,1
57520,3,3,201420,201420,201423,0,3,1
57521,4,1,201424,201424,201425,0,1,1
57522,2,1,201426,201426,201427,0,1,1
57523,1,2,201427,201427,201429,0,2,0
57524,6,2,201433,201433,201435,0,2,4
57525,1,1,201434,201435,201436,1,2,0
57526,4,3,201438,201438,201441,0,3,2
57527,5,2,201443,201443,201445,0,2,2
57528,4,2,201447,201447,201449,0,2,2
57529,1,3,201448,201449,201452,1,4,0
57530,1,2,201449,201452,201454,3,5,0
57531,4,3,201453,201454,201457,1,4,0
57532,3,2,201456,201457,201459,1,3,0
57533,1,1,201457,201459,201460,2,3,0
57534,2,3,201459,201460,201463,1,4,0
57535,4,1,201463,201463,201464,0,1,0
57536,4,1,201467,201467,201468,0,1,3
57537,1,1,201468,201468,201469,0,1,0
57538,5,3,201473,201473,201476,0,3,4
57539,3,3,201476,201476,201479,0,3,0
57540,2,3,201478,201479,201482,1,4,0
57541,3,3,201481,201482,201485,1,4,0
57542,2,2,201483,201485,201487,2,4,0
57543,1,2,201484,201487,201489,3,5,0
57544,5,2,201489,201489,201491,0,2,0
57545,6,1,201495,201495,201496,0,1,4
57546,4,1,201499,201499,201500,0,1,3
57547,4,1,201503,201503,201504,0,1,3
57548,2,3,201505,201505,201508,0,3,1
57549,2,3,201507,201508,201511,1,4,0
57550,4,2,201511,201511,201513,0,2,0
57551,2,1,201513,201513,201514,0,1,0
57552,4,2,201517,201517,201519,0,2,3
57553,6,1,201523,201523,201524,0,1,4
57554,6,3,201529,201529,201532,0,3,5
57555,1,2,201530,201532,201534,2,4,0
57556,5,3,201535,201535,201538,0,3,1
57557,6,1,201541,201541,201542,0,1,3
57558,2,1,201543,201543,201544,0,1,1
57559,2,1,201545,201545,201546,0,1,1
57560,3,2,201548,201548,201550,0,2,2
57561,1,2,201549,201550,201552,1,3,0
57562,5,1,201554,201554,201555,0,1,2
57563,3,2,201557,201557,201559,0,2,2
57564,3,1,201560,201560,201561,0,1,1
57565,4,1,201564,201564,201565,0,1,3
57566,4,3,201568,201568,201571,0,3,3
57567,2,2,201570,201571,201573,1,3,0
57568,2,1,201572,201573,201574,1,2,0
57569,3,1,201575,201575,201576,0,1,1
57570,1,1,201576,201576,201577,0,1,0
57571,6,2,201582,201582,201584,0,2,5
57572,2,3,201584,201584,201587,0,3,0
57573,6,3,201590,201590,201593,0,3,3
57574,2,3,201592,201593,201596,1,4,0
57575,1,3,201593,201596,201599,3,6,0
57576,6,3,201599,201599,201602,0,3,0
57577,3,2,201602,201602,201604,0,2,0
57578,1,3,201603,201604,201607,1,4,0
57579,2,2,201605,201607,201609,2,4,0
57580,3,2,201608,201609,201611,1,3,0
57581,6,1,201614,201614,201615,0,1,3
57582,1,3,201615,201615,201618,0,3,0
57583,3,3,201618,201618,201621,0,3,0
57584,1,1,201619,201621,201622,2,3,0
57585,5,2,201624,201624,201626,0,2,2
57586,3,1,201627,201627,201628,0,1,1
57587,4,3,201631,201631,201634,0,3,3
57588,6,2,201637,201637,201639,0,2,3
57589,6,2,201643,201643,201645,0,2,4
57590,3,2,201646,201646,201648,0,2,1
57591,4,2,201650,201650,201652,0,2,2
57592,2,2,201652,201652,201654,0,2,0
57593,6,3,201658,201658,201661,0,3,4
57594,1,2,201659,201661,201663,2,4,0
57595,2,2,201661,201663,201665,2,4,0
57596,3,3,201664,201665,201668,1,4,0
57597,5,2,201669,201669,201671,0,2,1
57598,5,1,201674,201674,201675,0,1,3
57599,1,2,201675,201675,201677,0,2,0
57600,6,1,201681,201681,201682,0,1,4
57601,5,1,201686,201686,201687,0,1,4
57602,4,2,201690,201690,201692,0,2,3
57603,2,1,201692,201692,201693,0,1,0
57604,5,2,201697,201697,201699,0,2,4
57605,5,1,201702,201702,201703,0,1,3
57606,5,2,201707,201707,201709,0,2,4
57607,1,1,201708,201709,201710,1,2,0
57608,3,3,201711,201711,201714,0,3,1
57609,2,1,201713,201714,201715,1,2,0
57610,3,1,201716,201716,201717,0,1,1
57611,6,1,201722,201722,201723,0,1,5
57612,6,2,201728,201728,201730,0,2,5
57613,2,3,201730,201730,201733,0,3,0
57614,5,2,201735,201735,201737,0,2,2
57615,4,2,201739,201739,201741,0,2,2
57616,4,2,201743,201743,201745,0,2,2
57617,3,1,201746,201746,201747,0,1,1
57618,1,3,201747,201747,201750,0,3,0
57619,6,2,201753,201753,201755,0,2,3
57620,6,1,201759,201759,201760,0,1,4
57621,4,1,201763,201763,201764,0,1,3
57622,4,1,201767,201767,201768,0,1,3
57623,1,3,201768,201768,201771,0,3,0
57624,1,3,201769,201771,201774,2,5,0
57625,1,2,201770,201774,201776,4,6,0
57626,2,1,201772,201776,201777,4,5,0
57627,6,3,201778,201778,201781,0,3,1
57628,4,2,201782,201782,201784,0,2,1
57629,4,2,201786,201786,201788,0,2,2
57630,4,3,201790,201790,201793,0,3,2
57631,6,3,201796,201796,201799,0,3,3
57632,6,1,201802,201802,201803,0,1,3
57633,6,1,201808,201808,201809,0,1,5
57634,4,2,201812,201812,201814,0,2,3
57635,5,1,201817,201817,201818,0,1,3
57636,6,2,201823,201823,201825,0,2,5
57637,1,1,201824,201825,201826,1,2,0
57638,1,3,201825,201826,201829,1,4,0
57639,6,2,201831,201831,201833,0,2,2
57640,3,1,201834,201834,201835,0,1,1
57641,4,2,201838,201838,201840,0,2,3
57642,4,3,201842,201842,201845,0,3,2
57643,6,2,201848,201848,201850,0,2,3
57644,1,1,201849,201850,201851,1,2,0
57645,6,3,201855,201855,201858,0,3,4
57646,1,3,201856,201858,201861,2,5,0
57647,4,2,201860,201861,201863,1,3,0
57648,1,2,201861,201863,201865,2,4,0
57649,2,2,201863,201865,201867,2,4,0
57650,3,3,201866,201867,201870,1,4,0
57651,2,3,201868,201870,201873,2,5,0
57652,1,1,201869,201873,201874,4,5,0
57653,5,1,201874,201874,201875,0,1,0
57654,1,3,201875,201875,201878,0,3,0
57655,1,2,201876,201878,201880,2,4,0
57656,3,2,201879,201880,201882,1,3,0
57657,4,1,201883,201883,201884,0,1,1
57658,5,1,201888,201888,201889,0,1,4
57659,3,3,201891,201891,201894,0,3,2
57660,5,1,201896,201896,201897,0,1,2
57661,4,2,201900,201900,201902,0,2,3
57662,2,2,201902,201902,201904,0,2,0
57663,4,1,201906,201906,201907,0,1,2
57664,5,1,201911,201911,201912,0,1,4
57665,3,3,201914,201914,201917,0,3,2
57666,6,1,201920,201920,201921,0,1,3
57667,3,3,201923,201923,201926,0,3,2
57668,3,1,201926,201926,201927,0,1,0
57669,4,2,201930,201930,201932,0,2,3
57670,4,2,201934,201934,201936,0,2,2
57671,5,2,201939,201939,201941,0,2,3
57672,5,2,201944,201944,201946,0,2,3
57673,2,1,201946,201946,201947,0,1,0
57674,6,3,201952,201952,201955,0,3,5
57675,5,2,201957,201957,201959,0,2,2
57676,4,3,201961,201961,201964,0,3,2
57677,6,3,201967,201967,201970,0,3,3
57678,6,3,201973,201973,201976,0,3,3
57679,5,2,201978,201978,201980,0,2,2
57680,6,3,201984,201984,201987,0,3,4
57681,3,1,201987,201987,201988,0,1,0
57682,6,3,201993,201993,201996,0,3,5
57683,1,1,201994,201996,201997,2,3,0
57684,4,1,201998,201998,201999,0,1,1
57685,5,2,202003,202003,202005,0,2,4
57686,3,1,202006,202006,202007,0,1,1
57687,5,2,202011,202011,202013,0,2,4
57688,3,3,202014,202014,202017,0,3,1
57689,2,2,202016,202017,202019,1,3,0
57690,2,3,202018,202019,202022,1,4,0
57691,5,2,202023,202023,202025,0,2,1
57692,1,1,202024,202025,202026,1,2,0
57693,3,3,202027,202027,202030,0,3,1
57694,2,2,202029,202030,202032,1,3,0
57695,6,1,202035,202035,202036,0,1,3
57696,1,2,202036,202036,202038,0,2,0
57697,6,3,202042,202042,202045,0,3,4
57698,6,1,202048,202048,202049,0,1,3
57699,4,2,202052,202052,202054,0,2,3
57700,2,2,202054,202054,202056,0,2,0
57701,4,1,202058,202058,202059,0,1,2
57702,5,3,202063,202063,202066,0,3,4
57703,3,1,202066,202066,202067,0,1,0
57704,1,2,202067,202067,202069,0,2,0
57705,1,3,202068,202069,202072,1,4,0
57706,6,2,202074,202074,202076,0,2,2
57707,6,3,202080,202080,202083,0,3,4
57708,6,2,202086,202086,202088,0,2,3
57709,6,2,202092,202092,202094,0,2,4
57710,1,3,202093,202094,202097,1,4,0
57711,3,1,202096,202097,202098,1,2,0
57712,3,3,202099,202099,202102,0,3,1
57713,2,3,202101,202102,202105,1,4,0
57714,2,1,202103,202105,202106,2,3,0
57715,5,2,202108,202108,202110,0,2,2
57716,5,3,202113,202113,202116,0,3,3
57717,5,1,202118,202118,202119,0,1,2
57718,6,1,202124,202124,202125,0,1,5
57719,2,1,202126,202126,202127,0,1,1
57720,6,2,202132,202132,202134,0,2,5
57721,3,1,202135,202135,202136,0,1,1
57722,6,3,202141,202141,202144,0,3,5
57723,1,1,202142,202144,202145,2,3,0
57724,4,2,202146,202146,202148,0,2,1
57725,4,1,202150,202150,202151,0,1,2
57726,2,2,202152,202152,202154,0,2,1
57727,5,3,202157,202157,202160,0,3,3
57728,1,2,202158,202160,202162,2,4,0
57729,6,2,202164,202164,202166,0,2,2
57730,1,2,202165,202166,202168,1,3,0
57731,6,3,202171,202171,202174,0,3,3
57732,1,1,202172,202174,202175,2,3,0
57733,6,1,202178,202178,202179,0,1,3
57734,3,3,202181,202181,202184,0,3,2
57735,3,2,202184,202184,202186,0,2,0
57736,5,1,202189,202189,202190,0,1,3
57737,2,2,202191,202191,202193,0,2,1
57738,1,1,202192,202193,202194,1,2,0
57739,3,1,202195,202195,202196,0,1,1
57740,4,2,202199,202199,202201,0,2,3
57741,1,3,202200,202201,202204,1,4,0
57742,2,2,202202,202204,202206,2,4,0
57743,2,3,202204,202206,202209,2,5,0
57744,4,3,202208,202209,202212,1,4,0
57745,4,2,202212,202212,202214,0,2,0
57746,6,1,202218,202218,202219,0,1,4
57747,4,1,202222,202222,202223,0,1,3
57748,3,1,202225,202225,202226,0,1,2
57749,6,3,202231,202231,202234,0,3,5
57750,6,3,202237,202237,202240,0,3,3
57751,2,1,202239,202240,202241,1,2,0
57752,1,2,202240,202241,202243,1,3,0
57753,6,3,202246,202246,202249,0,3,3
57754,5,2,202251,202251,202253,0,2,2
57755,4,1,202255,202255,202256,0,1,2
57756,3,3,202258,202258,202261,0,3,2
57757,2,1,202260,202261,202262,1,2,0
57758,3,3,202263,202263,202266,0,3,1
57759,5,2,202268,202268,202270,0,2,2
57760,5,3,202273,202273,202276,0,3,3
57761,5,1,202278,202278,202279,0,1,2
57762,3,1,202281,202281,202282,0,1,2
57763,6,2,202287,202287,202289,0,2,5
57764,4,3,202291,202291,202294,0,3,2
57765,4,2,202295,202295,202297,0,2,1
57766,5,3,202300,202300,202303,0,3,3
57767,1,1,202301,202303,202304,2,3,0
57768,6,2,202307,202307,202309,0,2,3
57769,4,1,202311,202311,202312,0,1,2
57770,4,2,202315,202315,202317,0,2,3
57771,5,3,202320,202320,202323,0,3,3
57772,6,2,202326,202326,202328,0,2,3
57773,3,3,202329,202329,202332,0,3,1
57774,6,3,202335,202335,202338,0,3,3
57775,2,1,202337,202338,202339,1,2,0
57776,6,2,202343,202343,202345,0,2,4
57777,3,2,202346,202346,202348,0,2,1
57778,2,2,202348,202348,202350,0,2,0
57779,3,3,202351,202351,202354,0,3,1
57780,2,1,202353,202354,202355,1,2,0
57781,5,1,202358,202358,202359,0,1,3
57782,4,1,202362,202362,202363,0,1,3
57783,1,1,202363,202363,202364,0,1,0
57784,6,2,202369,202369,202371,0,2,5
57785,1,2,202370,202371,202373,1,3,0
57786,1,3,202371,202373,202376,2,5,0
57787,2,1,202373,202376,202377,3,4,0
57788,4,1,202377,202377,202378,0,1,0
57789,3,1,202380,202380,202381,0,1,2
57790,4,2,202384,202384,202386,0,2,3
57791,4,2,202388,202388,202390,0,2,2
57792,1,1,202389,202390,202391,1,2,0
57793,2,3,202391,202391,202394,0,3,0
57794,6,1,202397,202397,202398,0,1,3
57795,6,3,202403,202403,202406,0,3,5
57796,5,3,202408,202408,202411,0,3,2
57797,5,1,202413,202413,202414,0,1,2
57798,4,3,202417,202417,202420,0,3,3
57799,1,2,202418,202420,202422,2,4,0
57800,5,3,202423,202423,202426,0,3,1
57801,2,2,202425,202426,202428,1,3,0
57802,2,2,202427,202428,202430,1,3,0
57803,4,3,202431,202431,202434,0,3,1
57804,2,2,202433,202434,202436,1,3,0
57805,3,3,202436,202436,202439,0,3,0
57806,4,1,202440,202440,202441,0,1,1
57807,6,3,202446,202446,202449,0,3,5
57808,6,2,202452,202452,202454,0,2,3
57809,2,2,202454,202454,202456,0,2,0
57810,3,3,202457,202457,202460,0,3,1
57811,4,3,202461,202461,202464,0,3,1
57812,6,3,202467,202467,202470,0,3,3
57813,2,2,202469,202470,202472,1,3,0
57814,5,3,202474,202474,202477,0,3,2
57815,3,3,202477,202477,202480,0,3,0
57816,4,3,202481,202481,202484,0,3,1
57817,3,1,202484,202484,202485,0,1,0
57818,6,1,202490,202490,202491,0,1,5
57819,1,1,202491,202491,202492,0,1,0
57820,6,3,202497,202497,202500,0,3,5
57821,3,3,202500,202500,202503,0,3,0
57822,5,1,202505,202505,202506,0,1,2
57823,4,3,202509,202509,202512,0,3,3
57824,5,1,202514,202514,202515,0,1,2
57825,1,3,202515,202515,202518,0,3,0
57826,6,2,202521,202521,202523,0,2,3
57827,2,1,202523,202523,202524,0,1,0
57828,6,2,202529,202529,202531,0,2,5
57829,2,2,202531,202531,202533,0,2,0
57830,5,3,202536,202536,202539,0,3,3
57831,4,3,202540,202540,202543,0,3,1
57832,1,2,202541,202543,202545,2,4,0
57833,1,2,202542,202545,202547,3,5,0
57834,5,3,202547,202547,202550,0,3,0
57835,4,3,202551,202551,202554,0,3,1
57836,4,3,202555,202555,202558,0,3,1
57837,4,1,202559,202559,202560,0,1,1
57838,2,3,202561,202561,202564,0,3,1
57839,4,1,202565,202565,202566,0,1,1
57840,1,2,202566,202566,202568,0,2,0
57841,1,3,202567,202568,202571,1,4,0
57842,3,2,202570,202571,202573,1,3,0
57843,2,1,202572,202573,202574,1,2,0
57844,2,1,202574,202574,202575,0,1,0
57845,2,3,202576,202576,202579,0,3,1
57846,3,2,202579,202579,202581,0,2,0
57847,6,2,202585,202585,202587,0,2,4
57848,5,3,202590,202590,202593,0,3,3
57849,4,2,202594,202594,202596,0,2,1
57850,6,1,202600,202600,202601,0,1,4
57851,5,3,202605,202605,202608,0,3,4
57852,4,1,202609,202609,202610,0,1,1
57853,1,3,202610,202610,202613,0,3,0
57854,5,2,202615,202615,202617,0,2,2
57855,2,2,202617,202617,202619,0,2,0
57856,6,3,202623,202623,202626,0,3,4
57857,4,1,202627,202627,202628,0,1,1
57858,1,2,202628,202628,202630,0,2,0
57859,6,1,202634,202634,202635,0,1,4
57860,1,1,202635,202635,202636,0,1,0
57861,1,3,202636,202636,202639,0,3,0
57862,1,2,202637,202639,202641,2,4,0
57863,4,1,202641,202641,202642,0,1,0
57864,6,2,202647,202647,202649,0,2,5
57865,2,2,202649,202649,202651,0,2,0
57866,4,2,202653,202653,202655,0,2,2
57867,4,1,202657,202657,202658,0,1,2
57868,4,1,202661,202661,202662,0,1,3
57869,6,3,202667,202667,202670,0,3,5
57870,2,2,202669,202670,202672,1,3,0
57871,3,3,202672,202672,202675,0,3,0
57872,6,3,202678,202678,202681,0,3,3
57873,1,1,202679,202681,202682,2,3,0
57874,5,1,202684,202684,202685,0,1,2
57875,4,1,202688,202688,202689,0,1,3
57876,3,2,202691,202691,202693,0,2,2
57877,4,3,202695,202695,202698,0,3,2
57878,5,3,202700,202700,202703,0,3,2
57879,4,1,202704,202704,202705,0,1,1
57880,5,1,202709,202709,202710,0,1,4
57881,2,3,202711,202711,202714,0,3,1
57882,4,3,202715,202715,202718,0,3,1
57883,6,1,202721,202721,202722,0,1,3
57884,2,3,202723,202723,202726,0,3,1
57885,5,1,202728,202728,202729,0,1,2
57886,3,2,202731,202731,202733,0,2,2
57887,3,2,202734,202734,202736,0,2,1
57888,1,3,202735,202736,202739,1,4,0
57889,5,1,202740,202740,202741,0,1,1
57890,2,3,202742,202742,202745,0,3,1
57891,2,3,202744,202745,202748,1,4,0
57892,3,1,202747,202748,202749,1,2,0
57893,1,3,202748,202749,202752,1,4,0
57894,3,2,202751,202752,202754,1,3,0
57895,6,2,202757,202757,202759,0,2,3
57896,2,1,202759,202759,202760,0,1,0
57897,1,3,202760,202760,202763,0,3,0
57898,6,2,202766,202766,202768,0,2,3
57899,4,3,202770,202770,202773,0,3,2
57900,5,1,202775,202775,202776,0,1,2
57901,6,3,202781,202781,202784,0,3,5
57902,6,2,202787,202787,202789,0,2,3
57903,2,2,202789,202789,202791,0,2,0
57904,5,2,202794,202794,202796,0,2,3
57905,1,1,202795,202796,202797,1,2,0
57906,2,1,202797,202797,202798,0,1,0
57907,1,2,202798,202798,202800,0,2,0
57908,5,3,202803,202803,202806,0,3,3
57909,1,2,202804,202806,202808,2,4,0
57910,5,3,202809,202809,202812,0,3,1
57911,2,1,202811,202812,202813,1,2,0
57912,6,3,202817,202817,202820,0,3,4
57913,3,3,202820,202820,202823,0,3,0
57914,4,2,202824,202824,202826,0,2,1
57915,4,1,202828,202828,202829,0,1,2
57916,3,1,202831,202831,202832,0,1,2
57917,1,3,202832,202832,202835,0,3,0
57918,5,2,202837,202837,202839,0,2,2
57919,6,1,202843,202843,202844,0,1,4
57920,6,1,202849,202849,202850,0,1,5
57921,3,1,202852,202852,202853,0,1,2
57922,1,2,202853,202853,202855,0,2,0
57923,2,3,202855,202855,202858,0,3,0
57924,3,1,202858,202858,202859,0,1,0
57925,1,2,202859,202859,202861,0,2,0
57926,4,3,202863,202863,202866,0,3,2
57927,6,3,202869,202869,202872,0,3,3
57928,4,3,202873,202873,202876,0,3,1
57929,2,2,202875,202876,202878,1,3,0
57930,4,2,202879,202879,202881,0,2,1
57931,5,1,202884,202884,202885,0,1,3
57932,3,2,202887,202887,202889,0,2,2
57933,1,1,202888,202889,202890,1,2,0
57934,3,1,202891,202891,202892,0,1,1
57935,5,1,202896,202896,202897,0,1,4
57936,4,2,202900,202900,202902,0,2,3
57937,5,3,202905,202905,202908,0,3,3
57938,5,3,202910,202910,202913,0,3,2
57939,2,3,202912,202913,202916,1,4,0
57940,3,2,202915,202916,202918,1,3,0
57941,4,3,202919,202919,202922,0,3,1
57942,3,2,202922,202922,202924,0,2,0
57943,6,2,202928,202928,202930,0,2,4
57944,6,2,202934,202934,202936,0,2,4
57945,5,3,202939,202939,202942,0,3,3
57946,5,2,202944,202944,202946,0,2,2
57947,3,2,202947,202947,202949,0,2,1
57948,1,2,202948,202949,202951,1,3,0
57949,4,3,202952,202952,202955,0,3,1
57950,6,3,202958,202958,202961,0,3,3
57951,2,3,202960,202961,202964,1,4,0
57952,4,1,202964,202964,202965,0,1,0
57953,6,1,202970,202970,202971,0,1,5
57954,5,1,202975,202975,202976,0,1,4
57955,2,3,202977,202977,202980,0,3,1
57956,1,1,202978,202980,202981,2,3,0
57957,3,2,202981,202981,202983,0,2,0
57958,3,3,202984,202984,202987,0,3,1
57959,5,2,202989,202989,202991,0,2,2
57960,6,3,202995,202995,202998,0,3,4
57961,5,3,203000,203000,203003,0,3,2
57962,3,2,203003,203003,203005,0,2,0
57963,1,1,203004,203005,203006,1,2,0
57964,4,1,203008,203008,203009,0,1,2
57965,1,3,203009,203009,203012,0,3,0
57966,2,2,203011,203012,203014,1,3,0
57967,6,2,203017,203017,203019,0,2,3
57968,3,3,203020,203020,203023,0,3,1
57969,5,2,203025,203025,203027,0,2,2
57970,3,2,203028,203028,203030,0,2,1
57971,2,1,203030,203030,203031,0,1,0
57972,1,1,203031,203031,203032,0,1,0
57973,4,1,203035,203035,203036,0,1,3
57974,6,2,203041,203041,203043,0,2,5
57975,3,1,203044,203044,203045,0,1,1
57976,2,2,203046,203046,203048,0,2,1
57977,1,1,203047,203048,203049,1,2,0
57978,5,2,203052,203052,203054,0,2,3
57979,4,1,203056,203056,203057,0,1,2
57980,5,1,203061,203061,203062,0,1,4
57981,6,3,203067,203067,203070,0,3,5
57982,6,1,203073,203073,203074,0,1,3
57983,4,1,203077,203077,203078,0,1,3
57984,3,2,203080,203080,203082,0,2,2
57985,2,1,203082,203082,203083,0,1,0
57986,5,1,203087,203087,203088,0,1,4
57987,3,1,203090,203090,203091,0,1,2
57988,6,2,203096,203096,203098,0,2,5
57989,1,2,203097,203098,203100,1,3,0
57990,3,3,203100,203100,203103,0,3,0
57991,5,3,203105,203105,203108,0,3,2
57992,4,2,203109,203109,203111,0,2,1
57993,1,1,203110,203111,203112,1,2,0
57994,4,1,203114,203114,203115,0,1,2
57995,3,3,203117,203117,203120,0,3,2
57996,1,3,203118,203120,203123,2,5,0
57997,1,1,203119,203123,203124,4,5,0
57998,3,1,203122,203124,203125,2,3,0
57999,6,3,203128,203128,203131,0,3,3
58000,6,2,203134,203134,203136,0,2,3
58001,5,1,203139,203139,203140,0,1,3
58002,1,1,203140,203140,203141,0,1,0
58003,1,2,203141,203141,203143,0,2,0
58004,2,3,203143,203143,203146,0,3,0
58005,2,2,203145,203146,203148,1,3,0
58006,1,2,203146,203148,203150,2,4,0
58007,5,2,203151,203151,203153,0,2,1
58008,4,2,203155,203155,203157,0,2,2
58009,3,1,203158,203158,203159,0,1,1
58010,1,1,203159,203159,203160,0,1,0
58011,6,3,203165,203165,203168,0,3,5
58012,2,2,203167,203168,203170,1,3,0
58013,4,3,203171,203171,203174,0,3,1
58014,3,3,203174,203174,203177,0,3,0
58015,2,3,203176,203177,203180,1,4,0
58016,4,2,203180,203180,203182,0,2,0
58017,5,1,203185,203185,203186,0,1,3
58018,2,1,203187,203187,203188,0,1,1
58019,5,2,203192,203192,203194,0,2,4
58020,5,1,203197,203197,203198,0,1,3
58021,2,1,203199,203199,203200,0,1,1
58022,5,2,203204,203204,203206,0,2,4
58023,1,1,203205,203206,203207,1,2,0
58024,2,2,203207,203207,203209,0,2,0
58025,5,3,203212,203212,203215,0,3,3
58026,2,1,203214,203215,203216,1,2,0
58027,4,3,203218,203218,203221,0,3,2
58028,2,3,203220,203221,203224,1,4,0
58029,6,3,203226,203226,203229,0,3,2
58030,4,3,203230,203230,203233,0,3,1
58031,6,3,203236,203236,203239,0,3,3
58032,4,2,203240,203240,203242,0,2,1
58033,5,1,203245,203245,203246,0,1,3
58034,1,3,203246,203246,203249,0,3,0
58035,6,3,203252,203252,203255,0,3,3
58036,6,1,203258,203258,203259,0,1,3
58037,3,2,203261,203261,203263,0,2,2
58038,4,3,203265,203265,203268,0,3,2
58039,1,3,203266,203268,203271,2,5,0
58040,4,2,203270,203271,203273,1,3,0
58041,6,3,203276,203276,203279,0,3,3
58042,3,2,203279,203279,203281,0,2,0
58043,6,1,203285,203285,203286,0,1,4
58044,4,1,203289,203289,203290,0,1,3
58045,5,3,203294,203294,203297,0,3,4
58046,4,3,203298,203298,203301,0,3,1
58047,6,1,203304,203304,203305,0,1,3
58048,1,3,203305,203305,203308,0,3,0
58049,1,3,203306,203308,203311,2,5,0
58050,5,1,203311,203311,203312,0,1,0
58051,6,2,203317,203317,203319,0,2,5
58052,6,2,203323,203323,203325,0,2,4
58053,3,3,203326,203326,203329,0,3,1
58054,5,1,203331,203331,203332,0,1,2
58055,4,2,203335,203335,203337,0,2,3
58056,1,2,203336,203337,203339,1,3,0
58057,6,2,203342,203342,203344,0,2,3
58058,4,1,203346,203346,203347,0,1,2
58059,6,2,203352,203352,203354,0,2,5
58060,4,1,203356,203356,203357,0,1,2
58061,4,3,203360,203360,203363,0,3,3
58062,3,1,203363,203363,203364,0,1,0
58063,4,2,203367,203367,203369,0,2,3
58064,3,3,203370,203370,203373,0,3,1
58065,3,3,203373,203373,203376,0,3,0
58066,1,1,203374,203376,203377,2,3,0
58067,3,2,203377,203377,203379,0,2,0
58068,1,2,203378,203379,203381,1,3,0
58069,4,3,203382,203382,203385,0,3,1
58070,5,1,203387,203387,203388,0,1,2
58071,1,1,203388,203388,203389,0,1,0
58072,6,1,203394,203394,203395,0,1,5
58073,4,1,203398,203398,203399,0,1,3
58074,3,1,203401,203401,203402,0,1,2
58075,5,2,203406,203406,203408,0,2,4
58076,2,2,203408,203408,203410,0,2,0
58077,6,1,203414,203414,203415,0,1,4
58078,3,2,203417,203417,203419,0,2,2
58079,5,1,203422,203422,203423,0,1,3
58080,5,3,203427,203427,203430,0,3,4
58081,3,3,203430,203430,203433,0,3,0
58082,2,2,203432,203433,203435,1,3,0
58083,1,3,203433,203435,203438,2,5,0
58084,1,1,203434,203438,203439,4,5,0
58085,5,2,203439,203439,203441,0,2,0
58086,4,1,203443,203443,203444,0,1,2
58087,3,2,203446,203446,203448,0,2,2
58088,3,1,203449,203449,203450,0,1,1
58089,1,3,203450,203450,203453,0,3,0
58090,5,1,203455,203455,203456,0,1,2
58091,1,2,203456,203456,203458,0,2,0
58092,5,3,203461,203461,203464,0,3,3
58093,3,3,203464,203464,203467,0,3,0
58094,1,1,203465,203467,203468,2,3,0
58095,2,1,203467,203468,203469,1,2,0
58096,3,3,203470,203470,203473,0,3,1
58097,1,3,203471,203473,203476,2,5,0
58098,6,1,203477,203477,203478,0,1,1
58099,5,2,203482,203482,203484,0,2,4
58100,3,1,203485,203485,203486,0,1,1
58101,5,1,203490,203490,203491,0,1,4
58102,6,1,203496,203496,203497,0,1,5
58103,3,1,203499,203499,203500,0,1,2
58104,1,1,203500,203500,203501,0,1,0
58105,5,1,203505,203505,203506,0,1,4
58106,3,3,203508,203508,203511,0,3,2
58107,1,3,203509,203511,203514,2,5,0
58108,1,2,203510,203514,203516,4,6,0
58109,2,1,203512,203516,203517,4,5,0
58110,1,2,203513,203517,203519,4,6,0
58111,2,1,203515,203519,203520,4,5,0
58112,3,2,203518,203520,203522,2,4,0
58113,2,2,203520,203522,203524,2,4,0
58114,5,2,203525,203525,203527,0,2,1
58115,1,2,203526,203527,203529,1,3,0
58116,2,1,203528,203529,203530,1,2,0
58117,1,2,203529,203530,203532,1,3,0
58118,1,3,203530,203532,203535,2,5,0
58119,4,2,203534,203535,203537,1,3,0
58120,5,2,203539,203539,203541,0,2,2
58121,2,1,203541,203541,203542,0,1,0
58122,6,1,203547,203547,203548,0,1,5
58123,3,2,203550,203550,203552,0,2,2
58124,6,3,203556,203556,203559,0,3,4
58125,3,3,203559,203559,203562,0,3,0
58126,6,3,203565,203565,203568,0,3,3
58127,4,2,203569,203569,203571,0,2,1
58128,3,3,203572,203572,203575,0,3,1
58129,4,3,203576,203576,203579,0,3,1
58130,4,2,203580,203580,203582,0,2,1
58131,6,1,203586,203586,203587,0,1,4
58132,4,3,203590,203590,203593,0,3,3
58133,2,1,203592,203593,203594,1,2,0
58134,5,3,203597,203597,203600,0,3,3
58135,3,2,203600,203600,203602,0,2,0
58136,2,3,203602,203602,203605,0,3,0
58137,5,3,203607,203607,203610,0,3,2
58138,1,3,203608,203610,203613,2,5,0
58139,6,2,203614,203614,203616,0,2,1
58140,2,2,203616,203616,203618,0,2,0
58141,5,2,203621,203621,203623,0,2,3
58142,6,2,203627,203627,203629,0,2,4
58143,1,3,203628,203629,203632,1,4,0
58144,2,2,203630,203632,203634,2,4,0
58145,2,2,203632,203634,203636,2,4,0
58146,5,1,203637,203637,203638,0,1,1
58147,1,3,203638,203638,203641,0,3,0
58148,5,1,203643,203643,203644,0,1,2
58149,2,2,203645,203645,203647,0,2,1
58150,5,2,203650,203650,203652,0,2,3
58151,6,2,203656,203656,203658,0,2,4
58152,6,1,203662,203662,203663,0,1,4
58153,6,1,203668,203668,203669,0,1,5
58154,6,1,203674,203674,203675,0,1,5
58155,6,1,203680,203680,203681,0,1,5
58156,3,3,203683,203683,203686,0,3,2
58157,3,1,203686,203686,203687,0,1,0
58158,6,3,203692,203692,203695,0,3,5
58159,4,3,203696,203696,203699,0,3,1
58160,6,1,203702,203702,203703,0,1,3
58161,2,2,203704,203704,203706,0,2,1
58162,1,2,203705,203706,203708,1,3,0
58163,2,2,203707,203708,203710,1,3,0
58164,5,3,203712,203712,203715,0,3,2
58165,2,2,203714,203715,203717,1,3,0
58166,6,2,203720,203720,203722,0,2,3
58167,5,2,203725,203725,203727,0,2,3
58168,5,3,203730,203730,203733,0,3,3
58169,3,3,203733,203733,203736,0,3,0
58170,6,1,203739,203739,203740,0,1,3
58171,6,2,203745,203745,203747,0,2,5
58172,5,1,203750,203750,203751,0,1,3
58173,6,1,203756,203756,203757,0,1,5
58174,2,1,203758,203758,203759,0,1,1
58175,2,1,203760,203760,203761,0,1,1
58176,3,1,203763,203763,203764,0,1,2
58177,5,2,203768,203768,203770,0,2,4
58178,5,1,203773,203773,203774,0,1,3
58179,3,3,203776,203776,203779,0,3,2
58180,1,3,203777,203779,203782,2,5,0
58181,1,1,203778,203782,203783,4,5,0
58182,1,2,203779,203783,203785,4,6,0
58183,3,3,203782,203785,203788,3,6,0
58184,4,1,203786,203788,203789,2,3,0
58185,4,3,203790,203790,203793,0,3,1
58186,3,3,203793,203793,203796,0,3,0
58187,4,1,203797,203797,203798,0,1,1
58188,6,1,203803,203803,203804,0,1,5
58189,5,1,203808,203808,203809,0,1,4
58190,4,2,203812,203812,203814,0,2,3
58191,4,1,203816,203816,203817,0,1,2
58192,6,2,203822,203822,203824,0,2,5
58193,4,2,203826,203826,203828,0,2,2
58194,4,1,203830,203830,203831,0,1,2
58195,6,3,203836,203836,203839,0,3,5
58196,5,2,203841,203841,203843,0,2,2
58197,2,1,203843,203843,203844,0,1,0
58198,6,1,203849,203849,203850,0,1,5
58199,3,1,203852,203852,203853,0,1,2
58200,1,1,203853,203853,203854,0,1,0
58201,1,2,203854,203854,203856,0,2,0
58202,2,2,203856,203856,203858,0,2,0
58203,4,2,203860,203860,203862,0,2,2
58204,6,3,203866,203866,203869,0,3,4
58205,2,2,203868,203869,203871,1,3,0
58206,5,2,203873,203873,203875,0,2,2
58207,4,3,203877,203877,203880,0,3,2
58208,1,3,203878,203880,203883,2,5,0
58209,5,1,203883,203883,203884,0,1,0
58210,4,3,203887,203887,203890,0,3,3
58211,1,1,203888,203890,203891,2,3,0
58212,4,2,203892,203892,203894,0,2,1
58213,2,3,203894,203894,203897,0,3,0
58214,3,2,203897,203897,203899,0,2,0
58215,4,1,203901,203901,203902,0,1,2
58216,3,2,203904,203904,203906,0,2,2
58217,4,3,203908,203908,203911,0,3,2
58218,3,1,203911,203911,203912,0,1,0
58219,3,1,203914,203914,203915,0,1,2
58220,4,2,203918,203918,203920,0,2,3
58221,6,1,203924,203924,203925,0,1,4
58222,2,3,203926,203926,203929,0,3,1
58223,3,1,203929,203929,203930,0,1,0
58224,1,3,203930,203930,203933,0,3,0
58225,1,2,203931,203933,203935,2,4,0
58226,3,2,203934,203935,203937,1,3,0
58227,1,3,203935,203937,203940,2,5,0
58228,6,1,203941,203941,203942,0,1,1
58229,1,1,203942,203942,203943,0,1,0
58230,5,3,203947,203947,203950,0,3,4
58231,5,3,203952,203952,203955,0,3,2
58232,5,1,203957,203957,203958,0,1,2
58233,4,2,203961,203961,203963,0,2,3
58234,2,3,203963,203963,203966,0,3,0
58235,1,2,203964,203966,203968,2,4,0
58236,5,3,203969,203969,203972,0,3,1
58237,5,1,203974,203974,203975,0,1,2
58238,4,3,203978,203978,203981,0,3,3
58239,2,2,203980,203981,203983,1,3,0
58240,5,1,203985,203985,203986,0,1,2
58241,4,3,203989,203989,203992,0,3,3
58242,1,2,203990,203992,203994,2,4,0
58243,2,3,203992,203994,203997,2,5,0
58244,4,3,203996,203997,204000,1,4,0
58245,1,2,203997,204000,204002,3,5,0
58246,2,3,203999,204002,204005,3,6,0
58247,3,3,204002,204005,204008,3,6,0
58248,6,1,204008,204008,204009,0,1,0
58249,3,1,204011,204011,204012,0,1,2
58250,2,1,204013,204013,204014,0,1,1
58251,2,1,204015,204015,204016,0,1,1
58252,5,2,204020,204020,204022,0,2,4
58253,5,3,204025,204025,204028,0,3,3
58254,3,2,204028,204028,204030,0,2,0
58255,5,2,204033,204033,204035,0,2,3
58256,4,3,204037,204037,204040,0,3,2
58257,5,2,204042,204042,204044,0,2,2
58258,2,1,204044,204044,204045,0,1,0
58259,4,1,204048,204048,204049,0,1,3
58260,2,1,204050,204050,204051,0,1,1
58261,3,1,204053,204053,204054,0,1,2
58262,1,2,204054,204054,204056,0,2,0
58263,2,2,204056,204056,204058,0,2,0
58264,6,1,204062,204062,204063,0,1,4
58265,2,2,204064,204064,204066,0,2,1
58266,2,3,204066,204066,204069,0,3,0
58267,2,3,204068,204069,204072,1,4,0
58268,3,3,204071,204072,204075,1,4,0
58269,5,3,204076,204076,204079,0,3,1
58270,5,1,204081,204081,204082,0,1,2
58271,5,2,204086,204086,204088,0,2,4
58272,1,1,204087,204088,204089,1,2,0
58273,1,2,204088,204089,204091,1,3,0
58274,6,2,204094,204094,204096,0,2,3
58275,4,3,204098,204098,204101,0,3,2
58276,1,3,204099,204101,204104,2,5,0
58277,1,2,204100,204104,204106,4,6,0
58278,5,3,204105,204106,204109,1,4,0
58279,2,1,204107,204109,204110,2,3,0
58280,2,2,204109,204110,204112,1,3,0
58281,5,3,204114,204114,204117,0,3,2
58282,4,2,204118,204118,204120,0,2,1
58283,3,3,204121,204121,204124,0,3,1
58284,2,2,204123,204124,204126,1,3,0
58285,1,2,204124,204126,204128,2,4,0
58286,2,1,204126,204128,204129,2,3,0
58287,4,1,204130,204130,204131,0,1,1
58288,2,3,204132,204132,204135,0,3,1
58289,2,3,204134,204135,204138,1,4,0
58290,3,2,204137,204138,204140,1,3,0
58291,6,1,204143,204143,204144,0,1,3
58292,3,3,204146,204146,204149,0,3,2
58293,4,1,204150,204150,204151,0,1,1
58294,1,1,204151,204151,204152,0,1,0
58295,4,3,204155,204155,204158,0,3,3
58296,1,3,204156,204158,204161,2,5,0
58297,4,1,204160,204161,204162,1,2,0
58298,5,3,204165,204165,204168,0,3,3
58299,5,3,204170,204170,204173,0,3,2
58300,6,3,204176,204176,204179,0,3,3
58301,4,3,204180,204180,204183,0,3,1
58302,4,1,204184,204184,204185,0,1,1
58303,3,3,204187,204187,204190,0,3,2
58304,4,3,204191,204191,204194,0,3,1
58305,4,3,204195,204195,204198,0,3,1
58306,6,2,204201,204201,204203,0,2,3
58307,5,2,204206,204206,204208,0,2,3
58308,1,3,204207,204208,204211,1,4,0
58309,2,1,204209,204211,204212,2,3,0
58310,6,3,204215,204215,204218,0,3,3
58311,3,1,204218,204218,204219,0,1,0
58312,3,2,204221,204221,204223,0,2,2
58313,2,2,204223,204223,204225,0,2,0
58314,6,3,204229,204229,204232,0,3,4
58315,4,2,204233,204233,204235,0,2,1
58316,6,3,204239,204239,204242,0,3,4
58317,3,1,204242,204242,204243,0,1,0
58318,6,2,204248,204248,204250,0,2,5
58319,5,1,204253,204253,204254,0,1,3
58320,4,2,204257,204257,204259,0,2,3
58321,5,3,204262,204262,204265,0,3,3
58322,2,1,204264,204265,204266,1,2,0
58323,4,3,204268,204268,204271,0,3,2
58324,1,3,204269,204271,204274,2,5,0
58325,2,1,204271,204274,204275,3,4,0
58326,5,2,204276,204276,204278,0,2,1
58327,3,3,204279,204279,204282,0,3,1
58328,1,1,204280,204282,204283,2,3,0
58329,6,2,204286,204286,204288,0,2,3
58330,6,3,204292,204292,204295,0,3,4
58331,5,1,204297,204297,204298,0,1,2
58332,4,2,204301,204301,204303,0,2,3
58333,1,2,204302,204303,204305,1,3,0
58334,4,2,204306,204306,204308,0,2,1
58335,4,2,204310,204310,204312,0,2,2
58336,2,3,204312,204312,204315,0,3,0
58337,5,3,204317,204317,204320,0,3,2
58338,2,1,204319,204320,204321,1,2,0
58339,6,1,204325,204325,204326,0,1,4
58340,6,2,204331,204331,204333,0,2,5
58341,3,3,204334,204334,204337,0,3,1
58342,5,1,204339,204339,204340,0,1,2
58343,4,2,204343,204343,204345,0,2,3
58344,6,3,204349,204349,204352,0,3,4
58345,4,1,204353,204353,204354,0,1,1
58346,5,1,204358,204358,204359,0,1,4
58347,6,1,204364,204364,204365,0,1,5
58348,2,1,204366,204366,204367,0,1,1
58349,5,2,204371,204371,204373,0,2,4
58350,5,3,204376,204376,204379,0,3,3
58351,5,2,204381,204381,204383,0,2,2
58352,4,2,204385,204385,204387,0,2,2
58353,2,1,204387,204387,204388,0,1,0
58354,6,2,204393,204393,204395,0,2,5
58355,1,3,204394,204395,204398,1,4,0
58356,6,1,204400,204400,204401,0,1,2
58357,3,3,204403,204403,204406,0,3,2
58358,2,2,204405,204406,204408,1,3,0
58359,5,3,204410,204410,204413,0,3,2
58360,2,2,204412,204413,204415,1,3,0
58361,6,2,204418,204418,204420,0,2,3
58362,1,3,204419,204420,204423,1,4,0
58363,1,2,204420,204423,204425,3,5,0
58364,5,3,204425,204425,204428,0,3,0
58365,6,2,204431,204431,204433,0,2,3
58366,6,2,204437,204437,204439,0,2,4
58367,4,3,204441,204441,204444,0,3,2
58368,1,3,204442,204444,204447,2,5,0
58369,6,2,204448,204448,204450,0,2,1
58370,6,1,204454,204454,204455,0,1,4
58371,2,2,204456,204456,204458,0,2,1
58372,2,2,204458,204458,204460,0,2,0
58373,2,1,204460,204460,204461,0,1,0
58374,1,3,204461,204461,204464,0,3,0
58375,4,3,204465,204465,204468,0,3,1
58376,3,2,204468,204468,204470,0,2,0
58377,4,1,204472,204472,204473,0,1,2
58378,1,2,204473,204473,204475,0,2,0
58379,1,1,204474,204475,204476,1,2,0
58380,1,1,204475,204476,204477,1,2,0
58381,4,3,204479,204479,204482,0,3,2
58382,2,3,204481,204482,204485,1,4,0
58383,6,1,204487,204487,204488,0,1,2
58384,5,3,204492,204492,204495,0,3,4
58385,1,3,204493,204495,204498,2,5,0
58386,5,1,204498,204498,204499,0,1,0
58387,3,2,204501,204501,204503,0,2,2
58388,4,3,204505,204505,204508,0,3,2
58389,1,3,204506,204508,204511,2,5,0
58390,4,2,204510,204511,204513,1,3,0
58391,6,1,204516,204516,204517,0,1,3
58392,5,2,204521,204521,204523,0,2,4
58393,2,2,204523,204523,204525,0,2,0
58394,2,1,204525,204525,204526,0,1,0
58395,2,1,204527,204527,204528,0,1,1
58396,2,3,204529,204529,204532,0,3,1
58397,4,1,204533,204533,204534,0,1,1
58398,2,2,204535,204535,204537,0,2,1
58399,5,2,204540,204540,204542,0,2,3
58400,2,2,204542,204542,204544,0,2,0
58401,2,1,204544,204544,204545,0,1,0
58402,1,2,204545,204545,204547,0,2,0
58403,3,1,204548,204548,204549,0,1,1
58404,5,2,204553,204553,204555,0,2,4
58405,6,2,204559,204559,204561,0,2,4
58406,5,1,204564,204564,204565,0,1,3
58407,4,1,204568,204568,204569,0,1,3
58408,5,2,204573,204573,204575,0,2,4
58409,2,1,204575,204575,204576,0,1,0
58410,5,2,204580,204580,204582,0,2,4
58411,2,2,204582,204582,204584,0,2,0
58412,2,1,204584,204584,204585,0,1,0
58413,6,2,204590,204590,204592,0,2,5
58414,1,3,204591,204592,204595,1,4,0
58415,3,2,204594,204595,204597,1,3,0
58416,4,1,204598,204598,204599,0,1,1
58417,2,2,204600,204600,204602,0,2,1
58418,1,2,204601,204602,204604,1,3,0
58419,1,3,204602,204604,204607,2,5,0
58420,2,3,204604,204607,204610,3,6,0
58421,2,2,204606,204610,204612,4,6,0
58422,1,1,204607,204612,204613,5,6,0
58423,4,2,204611,204613,204615,2,4,0
58424,5,2,204616,204616,204618,0,2,1
58425,1,3,204617,204618,204621,1,4,0
58426,6,1,204623,204623,204624,0,1,2
58427,1,2,204624,204624,204626,0,2,0
58428,2,2,204626,204626,204628,0,2,0
58429,1,2,204627,204628,204630,1,3,0
58430,6,3,204633,204633,204636,0,3,3
58431,3,3,204636,204636,204639,0,3,0
58432,4,2,204640,204640,204642,0,2,1
58433,3,3,204643,204643,204646,0,3,1
58434,1,2,204644,204646,204648,2,4,0
58435,5,1,204649,204649,204650,0,1,1
58436,3,2,204652,204652,204654,0,2,2
58437,4,3,204656,204656,204659,0,3,2
58438,3,2,204659,204659,204661,0,2,0
58439,3,3,204662,204662,204665,0,3,1
58440,4,2,204666,204666,204668,0,2,1
58441,2,3,204668,204668,204671,0,3,0
58442,5,1,204673,204673,204674,0,1,2
58443,4,1,204677,204677,204678,0,1,3
58444,5,2,204682,204682,204684,0,2,4
58445,2,3,204684,204684,204687,0,3,0
58446,4,1,204688,204688,204689,0,1,1
58447,3,1,204691,204691,204692,0,1,2
58448,3,3,204694,204694,204697,0,3,2
58449,2,3,204696,204697,204700,1,4,0
58450,4,2,204700,204700,204702,0,2,0
58451,5,2,204705,204705,204707,0,2,3
58452,1,2,204706,204707,204709,1,3,0
58453,2,1,204708,204709,204710,1,2,0
58454,4,3,204712,204712,204715,0,3,2
58455,4,1,204716,204716,204717,0,1,1
58456,3,1,204719,204719,204720,0,1,2
58457,6,2,204725,204725,204727,0,2,5
58458,6,1,204731,204731,204732,0,1,4
58459,1,2,204732,204732,204734,0,2,0
58460,2,3,204734,204734,204737,0,3,0
58461,4,3,204738,204738,204741,0,3,1
58462,1,2,204739,204741,204743,2,4,0
58463,1,1,204740,204743,204744,3,4,0
58464,4,1,204744,204744,204745,0,1,0
58465,6,1,204750,204750,204751,0,1,5
58466,1,2,204751,204751,204753,0,2,0
58467,6,2,204757,204757,204759,0,2,4
58468,2,1,204759,204759,204760,0,1,0
58469,1,2,204760,204760,204762,0,2,0
58470,1,2,204761,204762,204764,1,3,0
58471,3,2,204764,204764,204766,0,2,0
58472,4,3,204768,204768,204771,0,3,2
58473,4,1,204772,204772,204773,0,1,1
58474,1,1,204773,204773,204774,0,1,0
58475,1,2,204774,204774,204776,0,2,0
58476,1,2,204775,204776,204778,1,3,0
58477,6,1,204781,204781,204782,0,1,3
58478,1,1,204782,204782,204783,0,1,0
58479,3,2,204785,204785,204787,0,2,2
58480,2,1,204787,204787,204788,0,1,0
58481,4,3,204791,204791,204794,0,3,3
58482,1,2,204792,204794,204796,2,4,0
58483,3,1,204795,204796,204797,1,2,0
58484,3,3,204798,204798,204801,0,3,1
58485,3,1,204801,204801,204802,0,1,0
58486,3,1,204804,204804,204805,0,1,2
58487,5,2,204809,204809,204811,0,2,4
58488,6,1,204815,204815,204816,0,1,4
58489,3,2,204818,204818,204820,0,2,2
58490,6,1,204824,204824,204825,0,1,4
58491,5,3,204829,204829,204832,0,3,4
58492,2,2,204831,204832,204834,1,3,0
58493,2,1,204833,204834,204835,1,2,0
58494,5,3,204838,204838,204841,0,3,3
58495,5,2,204843,204843,204845,0,2,2
58496,5,2,204848,204848,204850,0,2,3
58497,2,2,204850,204850,204852,0,2,0
58498,5,2,204855,204855,204857,0,2,3
58499,3,1,204858,204858,204859,0,1,1
58500,6,1,204864,204864,204865,0,1,5
58501,6,3,204870,204870,204873,0,3,5
58502,2,1,204872,204873,204874,1,2,0
58503,6,3,204878,204878,204881,0,3,4
58504,6,3,204884,204884,204887,0,3,3
58505,6,3,204890,204890,204893,0,3,3
58506,3,1,204893,204893,204894,0,1,0
58507,3,1,204896,204896,204897,0,1,2
58508,6,2,204902,204902,204904,0,2,5
58509,1,3,204903,204904,204907,1,4,0
58510,2,3,204905,204907,204910,2,5,0
58511,1,3,204906,204910,204913,4,7,0
58512,1,3,204907,204913,204916,6,9,0
58513,1,1,204908,204916,204917,8,9,0
58514,2,1,204910,204917,204918,7,8,0
58515,4,2,204914,204918,204920,4,6,0
58516,3,2,204917,204920,204922,3,5,0
58517,4,3,204921,204922,204925,1,4,0
58518,1,3,204922,204925,204928,3,6,0
58519,5,3,204927,204928,204931,1,4,0
58520,3,2,204930,204931,204933,1,3,0
58521,1,2,204931,204933,204935,2,4,0
58522,3,2,204934,204935,204937,1,3,0
58523,2,2,204936,204937,204939,1,3,0
58524,5,3,204941,204941,204944,0,3,2
58525,6,1,204947,204947,204948,0,1,3
58526,4,1,204951,204951,204952,0,1,3
58527,6,1,204957,204957,204958,0,1,5
58528,2,3,204959,204959,204962,0,3,1
58529,6,3,204965,204965,204968,0,3,3
58530,6,3,204971,204971,204974,0,3,3
58531,4,3,204975,204975,204978,0,3,1
58532,4,1,204979,204979,204980,0,1,1
58533,3,1,204982,204982,204983,0,1,2
58534,5,1,204987,204987,204988,0,1,4
58535,4,1,204991,204991,204992,0,1,3
58536,1,1,204992,204992,204993,0,1,0
58537,6,2,204998,204998,205000,0,2,5
58538,4,2,205002,205002,205004,0,2,2
58539,5,2,205007,205007,205009,0,2,3
58540,2,2,205009,205009,205011,0,2,0
58541,3,1,205012,205012,205013,0,1,1
58542,2,2,205014,205014,205016,0,2,1
58543,4,1,205018,205018,205019,0,1,2
58544,2,1,205020,205020,205021,0,1,1
58545,4,1,205024,205024,205025,0,1,3
58546,2,3,205026,205026,205029,0,3,1
58547,6,3,205032,205032,205035,0,3,3
58548,3,3,205035,205035,205038,0,3,0
58549,2,3,205037,205038,205041,1,4,0
58550,5,1,205042,205042,205043,0,1,1
58551,1,1,205043,205043,205044,0,1,0
58552,6,2,205049,205049,205051,0,2,5
58553,1,1,205050,205051,205052,1,2,0
58554,3,3,205053,205053,205056,0,3,1
58555,4,1,205057,205057,205058,0,1,1
58556,3,2,205060,205060,205062,0,2,2
58557,3,3,205063,205063,205066,0,3,1
58558,4,2,205067,205067,205069,0,2,1
58559,3,1,205070,205070,205071,0,1,1
58560,3,1,205073,205073,205074,0,1,2
58561,6,3,205079,205079,205082,0,3,5
58562,5,3,205084,205084,205087,0,3,2
58563,5,3,205089,205089,205092,0,3,2
58564,5,2,205094,205094,205096,0,2,2
58565,6,3,205100,205100,205103,0,3,4
58566,2,3,205102,205103,205106,1,4,0
58567,1,3,205103,205106,205109,3,6,0
58568,1,2,205104,205109,205111,5,7,0
58569,1,3,205105,205111,205114,6,9,0
58570,1,2,205106,205114,205116,8,10,0
58571,2,2,205108,205116,205118,8,10,0
58572,5,1,205113,205118,205119,5,6,0
58573,5,1,205118,205119,205120,1,2,0
58574,3,3,205121,205121,205124,0,3,1
58575,4,3,205125,205125,205128,0,3,1
58576,3,1,205128,205128,205129,0,1,0
58577,2,3,205130,205130,205133,0,3,1
58578,6,2,205136,205136,205138,0,2,3
58579,3,2,205139,205139,205141,0,2,1
58580,5,3,205144,205144,205147,0,3,3
58581,4,2,205148,205148,205150,0,2,1
58582,6,3,205154,205154,205157,0,3,4
58583,2,3,205156,205157,205160,1,4,0
58584,2,3,205158,205160,205163,2,5,0
58585,5,1,205163,205163,205164,0,1,0
58586,1,1,205164,205164,205165,0,1,0
58587,4,1,205168,205168,205169,0,1,3
58588,2,3,205170,205170,205173,0,3,1
58589,6,2,205176,205176,205178,0,2,3
58590,6,2,205182,205182,205184,0,2,4
58591,3,1,205185,205185,205186,0,1,1
58592,3,2,205188,205188,205190,0,2,2
58593,1,3,205189,205190,205193,1,4,0
58594,4,1,205193,205193,205194,0,1,0
58595,1,3,205194,205194,205197,0,3,0
58596,4,3,205198,205198,205201,0,3,1
58597,6,2,205204,205204,205206,0,2,3
58598,5,1,205209,205209,205210,0,1,3
58599,5,2,205214,205214,205216,0,2,4
58600,6,3,205220,205220,205223,0,3,4
58601,1,1,205221,205223,205224,2,3,0
58602,3,3,205224,205224,205227,0,3,0
58603,5,2,205229,205229,205231,0,2,2
58604,6,1,205235,205235,205236,0,1,4
58605,4,3,205239,205239,205242,0,3,3
58606,4,1,205243,205243,205244,0,1,1
58607,3,3,205246,205246,205249,0,3,2
58608,3,1,205249,205249,205250,0,1,0
58609,1,2,205250,205250,205252,0,2,0
58610,3,2,205253,205253,205255,0,2,1
58611,4,1,205257,205257,205258,0,1,2
58612,2,1,205259,205259,205260,0,1,1
58613,2,2,205261,205261,205263,0,2,1
58614,1,2,205262,205263,205265,1,3,0
58615,3,2,205265,205265,205267,0,2,0
58616,6,3,205271,205271,205274,0,3,4
58617,5,1,205276,205276,205277,0,1,2
58618,5,3,205281,205281,205284,0,3,4
58619,1,1,205282,205284,205285,2,3,0
58620,1,3,205283,205285,205288,2,5,0
58621,4,3,205287,205288,205291,1,4,0
58622,4,1,205291,205291,205292,0,1,0
58623,4,2,205295,205295,205297,0,2,3
58624,3,3,205298,205298,205301,0,3,1
58625,6,3,205304,205304,205307,0,3,3
58626,3,2,205307,205307,205309,0,2,0
58627,4,3,205311,205311,205314,0,3,2
58628,6,1,205317,205317,205318,0,1,3
58629,1,3,205318,205318,205321,0,3,0
58630,1,3,205319,205321,205324,2,5,0
58631,1,2,205320,205324,205326,4,6,0
58632,6,3,205326,205326,205329,0,3,0
58633,6,3,205332,205332,205335,0,3,3
58634,4,1,205336,205336,205337,0,1,1
58635,5,1,205341,205341,205342,0,1,4
58636,5,3,205346,205346,205349,0,3,4
58637,5,1,205351,205351,205352,0,1,2
58638,3,1,205354,205354,205355,0,1,2
58639,6,2,205360,205360,205362,0,2,5
58640,6,2,205366,205366,205368,0,2,4
58641,4,3,205370,205370,205373,0,3,2
58642,5,1,205375,205375,205376,0,1,2
58643,4,3,205379,205379,205382,0,3,3
58644,4,3,205383,205383,205386,0,3,1
58645,1,2,205384,205386,205388,2,4,0
58646,5,3,205389,205389,205392,0,3,1
58647,6,2,205395,205395,205397,0,2,3
58648,6,2,205401,205401,205403,0,2,4
58649,5,2,205406,205406,205408,0,2,3
58650,5,3,205411,205411,205414,0,3,3
58651,2,1,205413,205414,205415,1,2,0
58652,6,3,205419,205419,205422,0,3,4
58653,2,1,205421,205422,205423,1,2,0
58654,6,2,205427,205427,205429,0,2,4
58655,1,2,205428,205429,205431,1,3,0
58656,5,3,205433,205433,205436,0,3,2
58657,6,2,205439,205439,205441,0,2,3
58658,5,2,205444,205444,205446,0,2,3
58659,2,1,205446,205446,205447,0,1,0
58660,3,1,205449,205449,205450,0,1,2
58661,6,3,205455,205455,205458,0,3,5
58662,2,1,205457,205458,205459,1,2,0
58663,6,3,205463,205463,205466,0,3,4
58664,3,1,205466,205466,205467,0,1,0
58665,3,1,205469,205469,205470,0,1,2
58666,1,2,205470,205470,205472,0,2,0
58667,6,1,205476,205476,205477,0,1,4
58668,4,1,205480,205480,205481,0,1,3
58669,5,1,205485,205485,205486,0,1,4
58670,4,1,205489,205489,205490,0,1,3
58671,6,2,205495,205495,205497,0,2,5
58672,2,3,205497,205497,205500,0,3,0
58673,1,2,205498,205500,205502,2,4,0
58674,2,2,205500,205502,205504,2,4,0
58675,6,1,205506,205506,205507,0,1,2
58676,2,2,205508,205508,205510,0,2,1
58677,3,2,205511,205511,205513,0,2,1
58678,5,1,205516,205516,205517,0,1,3
58679,4,1,205520,205520,205521,0,1,3
58680,3,1,205523,205523,205524,0,1,2
58681,2,2,205525,205525,205527,0,2,1
58682,2,2,205527,205527,205529,0,2,0
58683,6,2,205533,205533,205535,0,2,4
58684,3,1,205536,205536,205537,0,1,1
58685,6,2,205542,205542,205544,0,2,5
58686,4,1,205546,205546,205547,0,1,2
58687,5,1,205551,205551,205552,0,1,4
58688,1,3,205552,205552,205555,0,3,0
58689,3,2,205555,205555,205557,0,2,0
58690,4,1,205559,205559,205560,0,1,2
58691,5,3,205564,205564,205567,0,3,4
58692,2,2,205566,205567,205569,1,3,0
58693,6,2,205572,205572,205574,0,2,3
58694,6,2,205578,205578,205580,0,2,4
58695,2,3,205580,205580,205583,0,3,0
58696,5,3,205585,205585,205588,0,3,2
58697,4,1,205589,205589,205590,0,1,1
58698,1,1,205590,205590,205591,0,1,0
58699,4,1,205594,205594,205595,0,1,3
58700,1,2,205595,205595,205597,0,2,0
58701,5,2,205600,205600,205602,0,2,3
58702,4,1,205604,205604,205605,0,1,2
58703,3,2,205607,205607,205609,0,2,2
58704,3,3,205610,205610,205613,0,3,1
58705,1,2,205611,205613,205615,2,4,0
58706,6,2,205617,205617,205619,0,2,2
58707,4,1,205621,205621,205622,0,1,2
58708,2,1,205623,205623,205624,0,1,1
58709,4,3,205627,205627,205630,0,3,3
58710,3,2,205630,205630,205632,0,2,0
58711,6,2,205636,205636,205638,0,2,4
58712,6,1,205642,205642,205643,0,1,4
58713,1,2,205643,205643,205645,0,2,0
58714,4,1,205647,205647,205648,0,1,2
58715,5,3,205652,205652,205655,0,3,4
58716,2,3,205654,205655,205658,1,4,0
58717,6,3,205660,205660,205663,0,3,2
58718,3,2,205663,205663,205665,0,2,0
58719,3,2,205666,205666,205668,0,2,1
58720,6,1,205672,205672,205673,0,1,4
58721,5,1,205677,205677,205678,0,1,4
58722,5,2,205682,205682,205684,0,2,4
58723,4,1,205686,205686,205687,0,1,2
58724,5,1,205691,205691,205692,0,1,4
58725,6,1,205697,205697,205698,0,1,5
58726,6,3,205703,205703,205706,0,3,5
58727,4,1,205707,205707,205708,0,1,1
58728,1,1,205708,205708,205709,0,1,0
58729,5,1,205713,205713,205714,0,1,4
58730,3,3,205716,205716,205719,0,3,2
58731,4,3,205720,205720,205723,0,3,1
58732,5,1,205725,205725,205726,0,1,2
58733,4,1,205729,205729,205730,0,1,3
58734,3,1,205732,205732,205733,0,1,2
58735,3,3,205735,205735,205738,0,3,2
58736,2,2,205737,205738,205740,1,3,0
58737,6,3,205743,205743,205746,0,3,3
58738,5,1,205748,205748,205749,0,1,2
58739,6,1,205754,205754,205755,0,1,5
58740,4,2,205758,205758,205760,0,2,3
58741,3,1,205761,205761,205762,0,1,1
58742,2,2,205763,205763,205765,0,2,1
58743,2,2,205765,205765,205767,0,2,0
58744,3,2,205768,205768,205770,0,2,1
58745,5,3,205773,205773,205776,0,3,3
58746,2,1,205775,205776,205777,1,2,0
58747,4,1,205779,205779,205780,0,1,2
58748,2,1,205781,205781,205782,0,1,1
58749,1,2,205782,205782,205784,0,2,0
58750,5,2,205787,205787,205789,0,2,3
58751,2,2,205789,205789,205791,0,2,0
58752,6,2,205795,205795,205797,0,2,4
58753,6,3,205801,205801,205804,0,3,4
58754,6,3,205807,205807,205810,0,3,3
58755,6,1,205813,205813,205814,0,1,3
58756,4,1,205817,205817,205818,0,1,3
58757,3,1,205820,205820,205821,0,1,2
58758,3,2,205823,205823,205825,0,2,2
58759,3,2,205826,205826,205828,0,2,1
58760,5,2,205831,205831,205833,0,2,3
58761,5,3,205836,205836,205839,0,3,3
58762,6,3,205842,205842,205845,0,3,3
58763,1,3,205843,205845,205848,2,5,0
58764,3,3,205846,205848,205851,2,5,0
58765,4,1,205850,205851,205852,1,2,0
58766,5,2,205855,205855,205857,0,2,3
58767,6,2,205861,205861,205863,0,2,4
58768,6,1,205867,205867,205868,0,1,4
58769,3,1,205870,205870,205871,0,1,2
58770,3,2,205873,205873,205875,0,2,2
58771,1,3,205874,205875,205878,1,4,0
58772,4,1,205878,205878,205879,0,1,0
58773,2,3,205880,205880,205883,0,3,1
58774,2,1,205882,205883,205884,1,2,0
58775,2,1,205884,205884,205885,0,1,0
58776,1,2,205885,205885,205887,0,2,0
58777,6,1,205891,205891,205892,0,1,4
58778,4,3,205895,205895,205898,0,3,3
58779,1,1,205896,205898,205899,2,3,0
58780,5,3,205901,205901,205904,0,3,2
58781,5,3,205906,205906,205909,0,3,2
58782,1,1,205907,205909,205910,2,3,0
58783,1,3,205908,205910,205913,2,5,0
58784,2,2,205910,205913,205915,3,5,0
58785,2,3,205912,205915,205918,3,6,0
58786,4,1,205916,205918,205919,2,3,0
58787,6,2,205922,205922,205924,0,2,3
58788,1,2,205923,205924,205926,1,3,0
58789,5,1,205928,205928,205929,0,1,2
58790,6,1,205934,205934,205935,0,1,5
58791,2,2,205936,205936,205938,0,2,1
58792,4,1,205940,205940,205941,0,1,2
58793,5,2,205945,205945,205947,0,2,4
58794,6,1,205951,205951,205952,0,1,4
58795,1,2,205952,205952,205954,0,2,0
58796,6,3,205958,205958,205961,0,3,4
58797,4,3,205962,205962,205965,0,3,1
58798,5,1,205967,205967,205968,0,1,2
58799,5,3,205972,205972,205975,0,3,4
58800,4,2,205976,205976,205978,0,2,1
58801,6,3,205982,205982,205985,0,3,4
58802,5,1,205987,205987,205988,0,1,2
58803,6,2,205993,205993,205995,0,2,5
58804,4,3,205997,205997,206000,0,3,2
58805,2,3,205999,206000,206003,1,4,0
58806,2,3,206001,206003,206006,2,5,0
58807,1,3,206002,206006,206009,4,7,0
58808,1,1,206003,206009,206010,6,7,0
58809,3,2,206006,206010,206012,4,6,0
58810,4,3,206010,206012,206015,2,5,0
58811,2,3,206012,206015,206018,3,6,0
58812,3,1,206015,206018,206019,3,4,0
58813,3,1,206018,206019,206020,1,2,0
58814,6,2,206024,206024,206026,0,2,4
58815,4,2,206028,206028,206030,0,2,2
58816,2,2,206030,206030,206032,0,2,0
58817,3,3,206033,206033,206036,0,3,1
58818,3,3,206036,206036,206039,0,3,0
58819,3,2,206039,206039,206041,0,2,0
58820,4,2,206043,206043,206045,0,2,2
58821,5,2,206048,206048,206050,0,2,3
58822,3,1,206051,206051,206052,0,1,1
58823,1,2,206052,206052,206054,0,2,0
58824,6,3,206058,206058,206061,0,3,4
58825,1,1,206059,206061,206062,2,3,0
58826,5,3,206064,206064,206067,0,3,2
58827,4,3,206068,206068,206071,0,3,1
58828,6,1,206074,206074,206075,0,1,3
58829,4,2,206078,206078,206080,0,2,3
58830,2,2,206080,206080,206082,0,2,0
58831,2,3,206082,206082,206085,0,3,0
58832,5,2,206087,206087,206089,0,2,2
58833,6,1,206093,206093,206094,0,1,4
58834,3,3,206096,206096,206099,0,3,2
58835,2,1,206098,206099,206100,1,2,0
58836,6,1,206104,206104,206105,0,1,4
58837,4,2,206108,206108,206110,0,2,3
58838,6,1,206114,206114,206115,0,1,4
58839,1,2,206115,206115,206117,0,2,0
58840,2,3,206117,206117,206120,0,3,0
58841,3,2,206120,206120,206122,0,2,0
58842,3,3,206123,206123,206126,0,3,1
58843,4,2,206127,206127,206129,0,2,1
58844,6,1,206133,206133,206134,0,1,4
58845,2,1,206135,206135,206136,0,1,1
58846,4,3,206139,206139,206142,0,3,3
58847,4,2,206143,206143,206145,0,2,1
58848,3,2,206146,206146,206148,0,2,1
58849,6,3,206152,206152,206155,0,3,4
58850,1,1,206153,206155,206156,2,3,0
58851,6,2,206159,206159,206161,0,2,3
58852,4,3,206163,206163,206166,0,3,2
58853,1,3,206164,206166,206169,2,5,0
58854,3,3,206167,206169,206172,2,5,0
58855,6,1,206173,206173,206174,0,1,1
58856,6,3,206179,206179,206182,0,3,5
58857,4,2,206183,206183,206185,0,2,1
58858,5,1,206188,206188,206189,0,1,3
58859,6,1,206194,206194,206195,0,1,5
58860,1,2,206195,206195,206197,0,2,0
58861,4,1,206199,206199,206200,0,1,2
58862,5,3,206204,206204,206207,0,3,4
58863,4,2,206208,206208,206210,0,2,1
58864,6,3,206214,206214,206217,0,3,4
58865,6,3,206220,206220,206223,0,3,3
58866,6,1,206226,206226,206227,0,1,3
58867,6,2,206232,206232,206234,0,2,5
58868,5,1,206237,206237,206238,0,1,3
58869,2,3,206239,206239,206242,0,3,1
58870,2,3,206241,206242,206245,1,4,0
58871,1,3,206242,206245,206248,3,6,0
58872,1,3,206243,206248,206251,5,8,0
58873,3,3,206246,206251,206254,5,8,0
58874,4,2,206250,206254,206256,4,6,0
58875,3,3,206253,206256,206259,3,6,0
58876,2,3,206255,206259,206262,4,7,0
58877,6,2,206261,206262,206264,1,3,0
58878,6,1,206267,206267,206268,0,1,3
58879,2,3,206269,206269,206272,0,3,1
58880,6,3,206275,206275,206278,0,3,3
58881,5,3,206280,206280,206283,0,3,2
58882,3,3,206283,206283,206286,0,3,0
58883,2,1,206285,206286,206287,1,2,0
58884,2,1,206287,206287,206288,0,1,0
58885,6,2,206293,206293,206295,0,2,5
58886,5,2,206298,206298,206300,0,2,3
58887,4,3,206302,206302,206305,0,3,2
58888,4,1,206306,206306,206307,0,1,1
58889,4,3,206310,206310,206313,0,3,3
58890,4,3,206314,206314,206317,0,3,1
58891,3,1,206317,206317,206318,0,1,0
58892,6,1,206323,206323,206324,0,1,5
58893,3,3,206326,206326,206329,0,3,2
58894,3,2,206329,206329,206331,0,2,0
58895,1,3,206330,206331,206334,1,4,0
58896,5,2,206335,206335,206337,0,2,1
58897,1,1,206336,206337,206338,1,2,0
58898,2,3,206338,206338,206341,0,3,0
58899,3,3,206341,206341,206344,0,3,0
58900,6,3,206347,206347,206350,0,3,3
58901,4,1,206351,206351,206352,0,1,1
58902,1,1,206352,206352,206353,0,1,0
58903,4,2,206356,206356,206358,0,2,3
58904,1,1,206357,206358,206359,1,2,0
58905,4,3,206361,206361,206364,0,3,2
58906,1,1,206362,206364,206365,2,3,0
58907,5,2,206367,206367,206369,0,2,2
58908,1,3,206368,206369,206372,1,4,0
58909,3,1,206371,206372,206373,1,2,0
58910,4,2,206375,206375,206377,0,2,2
58911,4,2,206379,206379,206381,0,2,2
58912,3,2,206382,206382,206384,0,2,1
58913,6,3,206388,206388,206391,0,3,4
58914,3,2,206391,206391,206393,0,2,0
58915,5,1,206396,206396,206397,0,1,3
58916,4,2,206400,206400,206402,0,2,3
58917,3,2,206403,206403,206405,0,2,1
58918,6,3,206409,206409,206412,0,3,4
58919,4,2,206413,206413,206415,0,2,1
58920,4,3,206417,206417,206420,0,3,2
58921,6,1,206423,206423,206424,0,1,3
58922,2,2,206425,206425,206427,0,2,1
58923,4,2,206429,206429,206431,0,2,2
58924,2,2,206431,206431,206433,0,2,0
58925,2,3,206433,206433,206436,0,3,0
58926,3,1,206436,206436,206437,0,1,0
58927,5,3,206441,206441,206444,0,3,4
58928,2,3,206443,206444,206447,1,4,0
58929,3,2,206446,206447,206449,1,3,0
58930,1,2,206447,206449,206451,2,4,0
58931,3,3,206450,206451,206454,1,4,0
58932,5,2,206455,206455,206457,0,2,1
58933,3,1,206458,206458,206459,0,1,1
58934,6,3,206464,206464,206467,0,3,5
58935,1,1,206465,206467,206468,2,3,0
58936,3,1,206468,206468,206469,0,1,0
58937,2,3,206470,206470,206473,0,3,1
58938,4,1,206474,206474,206475,0,1,1
58939,4,3,206478,206478,206481,0,3,3
58940,2,1,206480,206481,206482,1,2,0
58941,4,1,206484,206484,206485,0,1,2
58942,2,2,206486,206486,206488,0,2,1
58943,6,1,206492,206492,206493,0,1,4
58944,3,1,206495,206495,206496,0,1,2
58945,3,3,206498,206498,206501,0,3,2
58946,5,2,206503,206503,206505,0,2,2
58947,4,1,206507,206507,206508,0,1,2
58948,5,1,206512,206512,206513,0,1,4
58949,1,3,206513,206513,206516,0,3,0
58950,4,3,206517,206517,206520,0,3,1
58951,6,3,206523,206523,206526,0,3,3
58952,3,2,206526,206526,206528,0,2,0
58953,5,1,206531,206531,206532,0,1,3
58954,3,1,206534,206534,206535,0,1,2
58955,4,2,206538,206538,206540,0,2,3
58956,6,3,206544,206544,206547,0,3,4
58957,2,1,206546,206547,206548,1,2,0
58958,4,2,206550,206550,206552,0,2,2
58959,4,1,206554,206554,206555,0,1,2
58960,4,1,206558,206558,206559,0,1,3
58961,6,1,206564,206564,206565,0,1,5
58962,5,1,206569,206569,206570,0,1,4
58963,2,2,206571,206571,206573,0,2,1
58964,6,1,206577,206577,206578,0,1,4
58965,4,3,206581,206581,206584,0,3,3
58966,3,2,206584,206584,206586,0,2,0
58967,4,1,206588,206588,206589,0,1,2
58968,5,3,206593,206593,206596,0,3,4
58969,2,1,206595,206596,206597,1,2,0
58970,4,3,206599,206599,206602,0,3,2
58971,2,1,206601,206602,206603,1,2,0
58972,4,1,206605,206605,206606,0,1,2
58973,6,1,206611,206611,206612,0,1,5
58974,5,1,206616,206616,206617,0,1,4
58975,5,3,206621,206621,206624,0,3,4
58976,3,2,206624,206624,206626,0,2,0
58977,1,2,206625,206626,206628,1,3,0
58978,5,3,206630,206630,206633,0,3,2
58979,5,1,206635,206635,206636,0,1,2
58980,6,1,206641,206641,206642,0,1,5
58981,6,1,206647,206647,206648,0,1,5
58982,3,1,206650,206650,206651,0,1,2
58983,2,2,206652,206652,206654,0,2,1
58984,4,2,206656,206656,206658,0,2,2
58985,6,1,206662,206662,206663,0,1,4
58986,6,3,206668,206668,206671,0,3,5
58987,6,2,206674,206674,206676,0,2,3
58988,2,3,206676,206676,206679,0,3,0
58989,6,1,206682,206682,206683,0,1,3
58990,2,2,206684,206684,206686,0,2,1
58991,1,3,206685,206686,206689,1,4,0
58992,6,1,206691,206691,206692,0,1,2
58993,2,2,206693,206693,206695,0,2,1
58994,2,2,206695,206695,206697,0,2,0
58995,4,1,206699,206699,206700,0,1,2
58996,4,1,206703,206703,206704,0,1,3
58997,5,2,206708,206708,206710,0,2,4
58998,4,3,206712,206712,206715,0,3,2
58999,1,2,206713,206715,206717,2,4,0
59000,3,3,206716,206717,206720,1,4,0
59001,3,1,206719,206720,206721,1,2,0
59002,3,3,206722,206722,206725,0,3,1
59003,6,2,206728,206728,206730,0,2,3
59004,4,1,206732,206732,206733,0,1,2
59005,6,1,206738,206738,206739,0,1,5
59006,5,3,206743,206743,206746,0,3,4
59007,1,2,206744,206746,206748,2,4,0
59008,6,3,206750,206750,206753,0,3,2
59009,6,3,206756,206756,206759,0,3,3
59010,5,3,206761,206761,206764,0,3,2
59011,1,3,206762,206764,206767,2,5,0
59012,1,3,206763,206767,206770,4,7,0
59013,5,2,206768,206770,206772,2,4,0
59014,5,2,206773,206773,206775,0,2,1
59015,2,2,206775,206775,206777,0,2,0
59016,5,3,206780,206780,206783,0,3,3
59017,5,1,206785,206785,206786,0,1,2
59018,3,2,206788,206788,206790,0,2,2
59019,1,3,206789,206790,206793,1,4,0
59020,2,3,206791,206793,206796,2,5,0
59021,3,3,206794,206796,206799,2,5,0
59022,5,2,206799,206799,206801,0,2,0
59023,5,3,206804,206804,206807,0,3,3
59024,3,2,206807,206807,206809,0,2,0
59025,4,2,206811,206811,206813,0,2,2
59026,1,1,206812,206813,206814,1,2,0
59027,6,1,206818,206818,206819,0,1,4
59028,5,2,206823,206823,206825,0,2,4
59029,5,2,206828,206828,206830,0,2,3
59030,4,1,206832,206832,206833,0,1,2
59031,3,2,206835,206835,206837,0,2,2
59032,5,2,206840,206840,206842,0,2,3
59033,1,1,206841,206842,206843,1,2,0
59034,1,1,206842,206843,206844,1,2,0
59035,6,2,206848,206848,206850,0,2,4
59036,6,3,206854,206854,206857,0,3,4
59037,4,1,206858,206858,206859,0,1,1
59038,2,2,206860,206860,206862,0,2,1
59039,3,3,206863,206863,206866,0,3,1
59040,3,1,206866,206866,206867,0,1,0
59041,4,1,206870,206870,206871,0,1,3
59042,6,3,206876,206876,206879,0,3,5
59043,2,3,206878,206879,206882,1,4,0
59044,3,2,206881,206882,206884,1,3,0
59045,3,2,206884,206884,206886,0,2,0
59046,3,3,206887,206887,206890,0,3,1
59047,4,2,206891,206891,206893,0,2,1
59048,2,1,206893,206893,206894,0,1,0
59049,5,3,206898,206898,206901,0,3,4
59050,6,1,206904,206904,206905,0,1,3
59051,2,1,206906,206906,206907,0,1,1
59052,6,3,206912,206912,206915,0,3,5
59053,2,3,206914,206915,206918,1,4,0
59054,4,1,206918,206918,206919,0,1,0
59055,6,1,206924,206924,206925,0,1,5
59056,5,3,206929,206929,206932,0,3,4
59057,6,1,206935,206935,206936,0,1,3
59058,3,3,206938,206938,206941,0,3,2
59059,1,3,206939,206941,206944,2,5,0
59060,5,2,206944,206944,206946,0,2,0
59061,3,3,206947,206947,206950,0,3,1
59062,3,2,206950,206950,206952,0,2,0
59063,4,2,206954,206954,206956,0,2,2
59064,3,3,206957,206957,206960,0,3,1
59065,6,2,206963,206963,206965,0,2,3
59066,1,2,206964,206965,206967,1,3,0
59067,3,2,206967,206967,206969,0,2,0
59068,3,1,206970,206970,206971,0,1,1
59069,1,2,206971,206971,206973,0,2,0
59070,1,1,206972,206973,206974,1,2,0
59071,1,2,206973,206974,206976,1,3,0
59072,2,3,206975,206976,206979,1,4,0
59073,5,1,206980,206980,206981,0,1,1
59074,2,3,206982,206982,206985,0,3,1
59075,2,3,206984,206985,206988,1,4,0
59076,3,1,206987,206988,206989,1,2,0
59077,1,2,206988,206989,206991,1,3,0
59078,6,2,206994,206994,206996,0,2,3
59079,1,3,206995,206996,206999,1,4,0
59080,3,2,206998,206999,207001,1,3,0
59081,3,3,207001,207001,207004,0,3,0
59082,2,2,207003,207004,207006,1,3,0
59083,5,2,207008,207008,207010,0,2,2
59084,2,3,207010,207010,207013,0,3,0
59085,4,1,207014,207014,207015,0,1,1
59086,5,2,207019,207019,207021,0,2,4
59087,1,3,207020,207021,207024,1,4,0
59088,2,3,207022,207024,207027,2,5,0
59089,6,1,207028,207028,207029,0,1,1
59090,3,3,207031,207031,207034,0,3,2
59091,5,3,207036,207036,207039,0,3,2
59092,5,2,207041,207041,207043,0,2,2
59093,2,3,207043,207043,207046,0,3,0
59094,3,3,207046,207046,207049,0,3,0
59095,1,3,207047,207049,207052,2,5,0
59096,2,3,207049,207052,207055,3,6,0
59097,2,3,207051,207055,207058,4,7,0
59098,3,1,207054,207058,207059,4,5,0
59099,5,1,207059,207059,207060,0,1,0
59100,4,2,207063,207063,207065,0,2,3
59101,1,2,207064,207065,207067,1,3,0
59102,3,3,207067,207067,207070,0,3,0
59103,5,3,207072,207072,207075,0,3,2
59104,5,3,207077,207077,207080,0,3,2
59105,6,1,207083,207083,207084,0,1,3
59106,1,1,207084,207084,207085,0,1,0
59107,3,2,207087,207087,207089,0,2,2
59108,1,1,207088,207089,207090,1,2,0
59109,3,1,207091,207091,207092,0,1,1
59110,3,1,207094,207094,207095,0,1,2
59111,1,1,207095,207095,207096,0,1,0
59112,6,2,207101,207101,207103,0,2,5
59113,6,3,207107,207107,207110,0,3,4
59114,3,3,207110,207110,207113,0,3,0
59115,5,1,207115,207115,207116,0,1,2
59116,3,3,207118,207118,207121,0,3,2
59117,1,2,207119,207121,207123,2,4,0
59118,5,3,207124,207124,207127,0,3,1
59119,3,2,207127,207127,207129,0,2,0
59120,5,2,207132,207132,207134,0,2,3
59121,5,3,207137,207137,207140,0,3,3
59122,6,1,207143,207143,207144,0,1,3
59123,6,3,207149,207149,207152,0,3,5
59124,5,1,207154,207154,207155,0,1,2
59125,3,3,207157,207157,207160,0,3,2
59126,5,1,207162,207162,207163,0,1,2
59127,4,1,207166,207166,207167,0,1,3
59128,6,2,207172,207172,207174,0,2,5
59129,3,3,207175,207175,207178,0,3,1
59130,1,2,207176,207178,207180,2,4,0
59131,6,2,207182,207182,207184,0,2,2
59132,1,3,207183,207184,207187,1,4,0
59133,1,1,207184,207187,207188,3,4,0
59134,6,1,207190,207190,207191,0,1,2
59135,1,3,207191,207191,207194,0,3,0
59136,1,1,207192,207194,207195,2,3,0
59137,5,2,207197,207197,207199,0,2,2
59138,6,1,207203,207203,207204,0,1,4
59139,1,2,207204,207204,207206,0,2,0
59140,5,3,207209,207209,207212,0,3,3
59141,1,2,207210,207212,207214,2,4,0
59142,2,3,207212,207214,207217,2,5,0
59143,1,2,207213,207217,207219,4,6,0
59144,5,3,207218,207219,207222,1,4,0
59145,4,2,207222,207222,207224,0,2,0
59146,5,1,207227,207227,207228,0,1,3
59147,6,3,207233,207233,207236,0,3,5
59148,6,1,207239,207239,207240,0,1,3
59149,3,2,207242,207242,207244,0,2,2
59150,2,3,207244,207244,207247,0,3,0
59151,1,1,207245,207247,207248,2,3,0
59152,4,1,207249,207249,207250,0,1,1
59153,4,1,207253,207253,207254,0,1,3
59154,6,2,207259,207259,207261,0,2,5
59155,6,2,207265,207265,207267,0,2,4
59156,6,3,207271,207271,207274,0,3,4
59157,1,1,207272,207274,207275,2,3,0
59158,3,2,207275,207275,207277,0,2,0
59159,3,3,207278,207278,207281,0,3,1
59160,4,1,207282,207282,207283,0,1,1
59161,5,3,207287,207287,207290,0,3,4
59162,6,1,207293,207293,207294,0,1,3
59163,4,1,207297,207297,207298,0,1,3
59164,4,2,207301,207301,207303,0,2,3
59165,5,1,207306,207306,207307,0,1,3
59166,1,2,207307,207307,207309,0,2,0
59167,6,2,207313,207313,207315,0,2,4
59168,2,1,207315,207315,207316,0,1,0
59169,5,1,207320,207320,207321,0,1,4
59170,4,1,207324,207324,207325,0,1,3
59171,6,3,207330,207330,207333,0,3,5
59172,4,2,207334,207334,207336,0,2,1
59173,1,2,207335,207336,207338,1,3,0
59174,4,2,207339,207339,207341,0,2,1
59175,2,2,207341,207341,207343,0,2,0
59176,5,1,207346,207346,207347,0,1,3
59177,2,2,207348,207348,207350,0,2,1
59178,2,2,207350,207350,207352,0,2,0
59179,5,1,207355,207355,207356,0,1,3
59180,3,2,207358,207358,207360,0,2,2
59181,4,3,207362,207362,207365,0,3,2
59182,6,1,207368,207368,207369,0,1,3
59183,5,3,207373,207373,207376,0,3,4
59184,2,1,207375,207376,207377,1,2,0
59185,2,2,207377,207377,207379,0,2,0
59186,1,2,207378,207379,207381,1,3,0
59187,5,3,207383,207383,207386,0,3,2
59188,4,1,207387,207387,207388,0,1,1
59189,6,3,207393,207393,207396,0,3,5
59190,5,1,207398,207398,207399,0,1,2
59191,4,1,207402,207402,207403,0,1,3
59192,4,3,207406,207406,207409,0,3,3
59193,6,1,207412,207412,207413,0,1,3
59194,1,1,207413,207413,207414,0,1,0
59195,4,1,207417,207417,207418,0,1,3
59196,1,3,207418,207418,207421,0,3,0
59197,1,2,207419,207421,207423,2,4,0
59198,3,1,207422,207423,207424,1,2,0
59199,3,2,207425,207425,207427,0,2,1
59200,4,1,207429,207429,207430,0,1,2
59201,6,2,207435,207435,207437,0,2,5
59202,6,3,207441,207441,207444,0,3,4
59203,3,1,207444,207444,207445,0,1,0
59204,2,3,207446,207446,207449,0,3,1
59205,1,2,207447,207449,207451,2,4,0
59206,1,1,207448,207451,207452,3,4,0
59207,1,3,207449,207452,207455,3,6,0
59208,6,1,207455,207455,207456,0,1,0
59209,1,3,207456,207456,207459,0,3,0
59210,2,3,207458,207459,207462,1,4,0
59211,3,1,207461,207462,207463,1,2,0
59212,4,1,207465,207465,207466,0,1,2
59213,6,3,207471,207471,207474,0,3,5
59214,3,3,207474,207474,207477,0,3,0
59215,6,2,207480,207480,207482,0,2,3
59216,3,2,207483,207483,207485,0,2,1
59217,6,1,207489,207489,207490,0,1,4
59218,2,1,207491,207491,207492,0,1,1
59219,5,1,207496,207496,207497,0,1,4
59220,2,2,207498,207498,207500,0,2,1
59221,6,3,207504,207504,207507,0,3,4
59222,1,1,207505,207507,207508,2,3,0
59223,2,2,207507,207508,207510,1,3,0
59224,4,1,207511,207511,207512,0,1,1
59225,4,2,207515,207515,207517,0,2,3
59226,4,2,207519,207519,207521,0,2,2
59227,2,1,207521,207521,207522,0,1,0
59228,3,1,207524,207524,207525,0,1,2
59229,1,2,207525,207525,207527,0,2,0
59230,4,3,207529,207529,207532,0,3,2
59231,2,3,207531,207532,207535,1,4,0
59232,5,3,207536,207536,207539,0,3,1
59233,4,3,207540,207540,207543,0,3,1
59234,2,1,207542,207543,207544,1,2,0
59235,3,2,207545,207545,207547,0,2,1
59236,1,3,207546,207547,207550,1,4,0
59237,5,2,207551,207551,207553,0,2,1
59238,4,1,207555,207555,207556,0,1,2
59239,6,2,207561,207561,207563,0,2,5
59240,2,2,207563,207563,207565,0,2,0
59241,1,2,207564,207565,207567,1,3,0
59242,5,1,207569,207569,207570,0,1,2
59243,4,2,207573,207573,207575,0,2,3
59244,3,2,207576,207576,207578,0,2,1
59245,3,1,207579,207579,207580,0,1,1
59246,1,2,207580,207580,207582,0,2,0
59247,2,2,207582,207582,207584,0,2,0
59248,6,3,207588,207588,207591,0,3,4
59249,1,2,207589,207591,207593,2,4,0
59250,5,3,207594,207594,207597,0,3,1
59251,6,2,207600,207600,207602,0,2,3
59252,1,1,207601,207602,207603,1,2,0
59253,4,1,207605,207605,207606,0,1,2
59254,6,3,207611,207611,207614,0,3,5
59255,4,2,207615,207615,207617,0,2,1
59256,3,1,207618,207618,207619,0,1,1
59257,3,2,207621,207621,207623,0,2,2
59258,2,3,207623,207623,207626,0,3,0
59259,1,2,207624,207626,207628,2,4,0
59260,1,2,207625,207628,207630,3,5,0
59261,5,1,207630,207630,207631,0,1,0
59262,2,2,207632,207632,207634,0,2,1
59263,5,3,207637,207637,207640,0,3,3
59264,2,2,207639,207640,207642,1,3,0
59265,6,3,207645,207645,207648,0,3,3
59266,6,2,207651,207651,207653,0,2,3
59267,6,1,207657,207657,207658,0,1,4
59268,4,2,207661,207661,207663,0,2,3
59269,5,1,207666,207666,207667,0,1,3
59270,3,1,207669,207669,207670,0,1,2
59271,2,3,207671,207671,207674,0,3,1
59272,2,2,207673,207674,207676,1,3,0
59273,6,3,207679,207679,207682,0,3,3
59274,2,1,207681,207682,207683,1,2,0
59275,3,1,207684,207684,207685,0,1,1
59276,5,2,207689,207689,207691,0,2,4
59277,5,1,207694,207694,207695,0,1,3
59278,1,3,207695,207695,207698,0,3,0
59279,6,2,207701,207701,207703,0,2,3
59280,1,2,207702,207703,207705,1,3,0
59281,3,3,207705,207705,207708,0,3,0
59282,1,2,207706,207708,207710,2,4,0
59283,4,1,207710,207710,207711,0,1,0
59284,6,2,207716,207716,207718,0,2,5
59285,3,2,207719,207719,207721,0,2,1
59286,2,2,207721,207721,207723,0,2,0
59287,5,3,207726,207726,207729,0,3,3
59288,5,2,207731,207731,207733,0,2,2
59289,4,1,207735,207735,207736,0,1,2
59290,1,3,207736,207736,207739,0,3,0
59291,2,2,207738,207739,207741,1,3,0
59292,1,3,207739,207741,207744,2,5,0
59293,1,1,207740,207744,207745,4,5,0
59294,6,3,207746,207746,207749,0,3,1
59295,3,2,207749,207749,207751,0,2,0
59296,5,2,207754,207754,207756,0,2,3
59297,2,1,207756,207756,207757,0,1,0
59298,2,1,207758,207758,207759,0,1,1
59299,3,1,207761,207761,207762,0,1,2
59300,6,1,207767,207767,207768,0,1,5
59301,1,1,207768,207768,207769,0,1,0
59302,6,2,207774,207774,207776,0,2,5
59303,4,2,207778,207778,207780,0,2,2
59304,6,3,207784,207784,207787,0,3,4
59305,4,3,207788,207788,207791,0,3,1
59306,6,1,207794,207794,207795,0,1,3
59307,5,2,207799,207799,207801,0,2,4
59308,3,3,207802,207802,207805,0,3,1
59309,2,1,207804,207805,207806,1,2,0
59310,1,1,207805,207806,207807,1,2,0
59311,1,3,207806,207807,207810,1,4,0
59312,4,3,207810,207810,207813,0,3,0
59313,2,1,207812,207813,207814,1,2,0
59314,4,2,207816,207816,207818,0,2,2
59315,4,1,207820,207820,207821,0,1,2
59316,2,1,207822,207822,207823,0,1,1
59317,6,2,207828,207828,207830,0,2,5
59318,6,2,207834,207834,207836,0,2,4
59319,4,3,207838,207838,207841,0,3,2
59320,3,1,207841,207841,207842,0,1,0
59321,3,1,207844,207844,207845,0,1,2
59322,1,2,207845,207845,207847,0,2,0
59323,2,1,207847,207847,207848,0,1,0
59324,1,2,207848,207848,207850,0,2,0
59325,4,1,207852,207852,207853,0,1,2
59326,6,1,207858,207858,207859,0,1,5
59327,2,1,207860,207860,207861,0,1,1
59328,2,1,207862,207862,207863,0,1,1
59329,4,2,207866,207866,207868,0,2,3
59330,6,1,207872,207872,207873,0,1,4
59331,1,2,207873,207873,207875,0,2,0
59332,3,3,207876,207876,207879,0,3,1
59333,1,1,207877,207879,207880,2,3,0
59334,6,1,207883,207883,207884,0,1,3
59335,5,2,207888,207888,207890,0,2,4
59336,2,2,207890,207890,207892,0,2,0
59337,1,3,207891,207892,207895,1,4,0
59338,3,1,207894,207895,207896,1,2,0
59339,3,3,207897,207897,207900,0,3,1
59340,5,3,207902,207902,207905,0,3,2
59341,5,3,207907,207907,207910,0,3,2
59342,1,3,207908,207910,207913,2,5,0
59343,2,1,207910,207913,207914,3,4,0
59344,3,1,207913,207914,207915,1,2,0
59345,1,1,207914,207915,207916,1,2,0
59346,2,1,207916,207916,207917,0,1,0
59347,2,3,207918,207918,207921,0,3,1
59348,4,1,207922,207922,207923,0,1,1
59349,6,1,207928,207928,207929,0,1,5
59350,1,1,207929,207929,207930,0,1,0
59351,3,1,207932,207932,207933,0,1,2
59352,1,3,207933,207933,207936,0,3,0
59353,2,2,207935,207936,207938,1,3,0
59354,6,1,207941,207941,207942,0,1,3
59355,2,1,207943,207943,207944,0,1,1
59356,4,2,207947,207947,207949,0,2,3
59357,5,2,207952,207952,207954,0,2,3
59358,1,2,207953,207954,207956,1,3,0
59359,5,3,207958,207958,207961,0,3,2
59360,3,3,207961,207961,207964,0,3,0
59361,3,2,207964,207964,207966,0,2,0
59362,5,2,207969,207969,207971,0,2,3
59363,6,1,207975,207975,207976,0,1,4
59364,3,3,207978,207978,207981,0,3,2
59365,2,2,207980,207981,207983,1,3,0
59366,5,1,207985,207985,207986,0,1,2
59367,5,3,207990,207990,207993,0,3,4
59368,2,3,207992,207993,207996,1,4,0
59369,2,3,207994,207996,207999,2,5,0
59370,4,2,207998,207999,208001,1,3,0
59371,1,1,207999,208001,208002,2,3,0
59372,5,2,208004,208004,208006,0,2,2
59373,3,2,208007,208007,208009,0,2,1
59374,1,2,208008,208009,208011,1,3,0
59375,1,2,208009,208011,208013,2,4,0
59376,3,1,208012,208013,208014,1,2,0
59377,2,1,208014,208014,208015,0,1,0
59378,3,2,208017,208017,208019,0,2,2
59379,6,3,208023,208023,208026,0,3,4
59380,3,1,208026,208026,208027,0,1,0
59381,4,3,208030,208030,208033,0,3,3
59382,4,1,208034,208034,208035,0,1,1
59383,6,2,208040,208040,208042,0,2,5
59384,1,2,208041,208042,208044,1,3,0
59385,3,1,208044,208044,208045,0,1,0
59386,5,2,208049,208049,208051,0,2,4
59387,6,2,208055,208055,208057,0,2,4
59388,6,2,208061,208061,208063,0,2,4
59389,5,3,208066,208066,208069,0,3,3
59390,6,3,208072,208072,208075,0,3,3
59391,5,2,208077,208077,208079,0,2,2
59392,6,2,208083,208083,208085,0,2,4
59393,4,2,208087,208087,208089,0,2,2
59394,3,1,208090,208090,208091,0,1,1
59395,4,2,208094,208094,208096,0,2,3
59396,4,1,208098,208098,208099,0,1,2
59397,4,3,208102,208102,208105,0,3,3
59398,3,3,208105,208105,208108,0,3,0
59399,2,3,208107,208108,208111,1,4,0
59400,4,1,208111,208111,208112,0,1,0
59401,6,3,208117,208117,208120,0,3,5
59402,6,2,208123,208123,208125,0,2,3
59403,3,1,208126,208126,208127,0,1,1
59404,3,2,208129,208129,208131,0,2,2
59405,3,2,208132,208132,208134,0,2,1
59406,3,3,208135,208135,208138,0,3,1
59407,6,1,208141,208141,208142,0,1,3
59408,2,3,208143,208143,208146,0,3,1
59409,4,3,208147,208147,208150,0,3,1
59410,2,3,208149,208150,208153,1,4,0
59411,4,2,208153,208153,208155,0,2,0
59412,1,1,208154,208155,208156,1,2,0
59413,6,2,208160,208160,208162,0,2,4
59414,2,3,208162,208162,208165,0,3,0
59415,1,2,208163,208165,208167,2,4,0
59416,4,3,208167,208167,208170,0,3,0
59417,2,1,208169,208170,208171,1,2,0
59418,5,3,208174,208174,208177,0,3,3
59419,5,3,208179,208179,208182,0,3,2
59420,1,1,208180,208182,208183,2,3,0
59421,3,1,208183,208183,208184,0,1,0
59422,3,3,208186,208186,208189,0,3,2
59423,3,3,208189,208189,208192,0,3,0
59424,1,3,208190,208192,208195,2,5,0
59425,5,1,208195,208195,208196,0,1,0
59426,6,2,208201,208201,208203,0,2,5
59427,2,2,208203,208203,208205,0,2,0
59428,6,2,208209,208209,208211,0,2,4
59429,5,2,208214,208214,208216,0,2,3
59430,1,3,208215,208216,208219,1,4,0
59431,1,1,208216,208219,208220,3,4,0
59432,6,2,208222,208222,208224,0,2,2
59433,2,2,208224,208224,208226,0,2,0
59434,4,1,208228,208228,208229,0,1,2
59435,6,1,208234,208234,208235,0,1,5
59436,4,1,208238,208238,208239,0,1,3
59437,4,3,208242,208242,208245,0,3,3
59438,6,3,208248,208248,208251,0,3,3
59439,1,2,208249,208251,208253,2,4,0
59440,5,1,208254,208254,208255,0,1,1
59441,2,3,208256,208256,208259,0,3,1
59442,1,3,208257,208259,208262,2,5,0
59443,5,3,208262,208262,208265,0,3,0
59444,6,1,208268,208268,208269,0,1,3
59445,4,3,208272,208272,208275,0,3,3
59446,4,1,208276,208276,208277,0,1,1
59447,3,1,208279,208279,208280,0,1,2
59448,1,2,208280,208280,208282,0,2,0
59449,4,2,208284,208284,208286,0,2,2
59450,2,2,208286,208286,208288,0,2,0
59451,2,3,208288,208288,208291,0,3,0
59452,4,3,208292,208292,208295,0,3,1
59453,2,3,208294,208295,208298,1,4,0
59454,1,3,208295,208298,208301,3,6,0
59455,3,3,208298,208301,208304,3,6,0
59456,5,1,208303,208304,208305,1,2,0
59457,4,1,208307,208307,208308,0,1,2
59458,4,3,208311,208311,208314,0,3,3
59459,3,1,208314,208314,208315,0,1,0
59460,1,2,208315,208315,208317,0,2,0
59461,4,1,208319,208319,208320,0,1,2
59462,4,1,208323,208323,208324,0,1,3
59463,2,1,208325,208325,208326,0,1,1
59464,2,2,208327,208327,208329,0,2,1
59465,2,3,208329,208329,208332,0,3,0
59466,5,2,208334,208334,208336,0,2,2
59467,4,1,208338,208338,208339,0,1,2
59468,4,2,208342,208342,208344,0,2,3
59469,2,3,208344,208344,208347,0,3,0
59470,5,2,208349,208349,208351,0,2,2
59471,5,1,208354,208354,208355,0,1,3
59472,1,3,208355,208355,208358,0,3,0
59473,4,2,208359,208359,208361,0,2,1
59474,3,3,208362,208362,208365,0,3,1
59475,6,3,208368,208368,208371,0,3,3
59476,5,3,208373,208373,208376,0,3,2
59477,4,1,208377,208377,208378,0,1,1
59478,3,2,208380,208380,208382,0,2,2
59479,1,1,208381,208382,208383,1,2,0
59480,6,1,208387,208387,208388,0,1,4
59481,5,3,208392,208392,208395,0,3,4
59482,5,2,208397,208397,208399,0,2,2
59483,5,1,208402,208402,208403,0,1,3
59484,5,1,208407,208407,208408,0,1,4
59485,1,1,208408,208408,208409,0,1,0
59486,6,1,208414,208414,208415,0,1,5
59487,5,1,208419,208419,208420,0,1,4
59488,6,1,208425,208425,208426,0,1,5
59489,6,3,208431,208431,208434,0,3,5
59490,1,2,208432,208434,208436,2,4,0
59491,3,3,208435,208436,208439,1,4,0
59492,5,3,208440,208440,208443,0,3,1
59493,4,2,208444,208444,208446,0,2,1
59494,3,1,208447,208447,208448,0,1,1
59495,3,1,208450,208450,208451,0,1,2
59496,5,2,208455,208455,208457,0,2,4
59497,2,1,208457,208457,208458,0,1,0
59498,6,3,208463,208463,208466,0,3,5
59499,2,1,208465,208466,208467,1,2,0
59500,6,3,208471,208471,208474,0,3,4
59501,5,2,208476,208476,208478,0,2,2
59502,1,3,208477,208478,208481,1,4,0
59503,5,1,208482,208482,208483,0,1,1
59504,4,3,208486,208486,208489,0,3,3
59505,6,3,208492,208492,208495,0,3,3
59506,1,1,208493,208495,208496,2,3,0
59507,3,2,208496,208496,208498,0,2,0
59508,5,2,208501,208501,208503,0,2,3
59509,3,1,208504,208504,208505,0,1,1
59510,5,2,208509,208509,208511,0,2,4
59511,3,3,208512,208512,208515,0,3,1
59512,6,1,208518,208518,208519,0,1,3
59513,4,3,208522,208522,208525,0,3,3
59514,2,2,208524,208525,208527,1,3,0
59515,4,1,208528,208528,208529,0,1,1
59516,2,3,208530,208530,208533,0,3,1
59517,2,1,208532,208533,208534,1,2,0
59518,3,1,208535,208535,208536,0,1,1
59519,1,3,208536,208536,208539,0,3,0
59520,2,2,208538,208539,208541,1,3,0
59521,3,2,208541,208541,208543,0,2,0
59522,3,1,208544,208544,208545,0,1,1
59523,4,2,208548,208548,208550,0,2,3
59524,1,2,208549,208550,208552,1,3,0
59525,5,3,208554,208554,208557,0,3,2
59526,6,2,208560,208560,208562,0,2,3
59527,1,3,208561,208562,208565,1,4,0
59528,1,1,208562,208565,208566,3,4,0
59529,1,1,208563,208566,208567,3,4,0
59530,4,2,208567,208567,208569,0,2,0
59531,1,2,208568,208569,208571,1,3,0
59532,3,2,208571,208571,208573,0,2,0
59533,6,1,208577,208577,208578,0,1,4
59534,5,2,208582,208582,208584,0,2,4
59535,6,2,208588,208588,208590,0,2,4
59536,3,3,208591,208591,208594,0,3,1
59537,1,1,208592,208594,208595,2,3,0
59538,3,1,208595,208595,208596,0,1,0
59539,5,3,208600,208600,208603,0,3,4
59540,4,2,208604,208604,208606,0,2,1
59541,5,2,208609,208609,208611,0,2,3
59542,5,1,208614,208614,208615,0,1,3
59543,6,3,208620,208620,208623,0,3,5
59544,5,3,208625,208625,208628,0,3,2
59545,6,3,208631,208631,208634,0,3,3
59546,2,1,208633,208634,208635,1,2,0
59547,2,2,208635,208635,208637,0,2,0
59548,5,1,208640,208640,208641,0,1,3
59549,6,1,208646,208646,208647,0,1,5
59550,4,1,208650,208650,208651,0,1,3
59551,5,1,208655,208655,208656,0,1,4
59552,6,1,208661,208661,208662,0,1,5
59553,6,2,208667,208667,208669,0,2,5
59554,3,1,208670,208670,208671,0,1,1
59555,3,2,208673,208673,208675,0,2,2
59556,1,2,208674,208675,208677,1,3,0
59557,4,3,208678,208678,208681,0,3,1
59558,3,1,208681,208681,208682,0,1,0
59559,2,3,208683,208683,208686,0,3,1
59560,5,3,208688,208688,208691,0,3,2
59561,5,2,208693,208693,208695,0,2,2
59562,2,1,208695,208695,208696,0,1,0
59563,1,3,208696,208696,208699,0,3,0
59564,4,1,208700,208700,208701,0,1,1
59565,4,2,208704,208704,208706,0,2,3
59566,4,2,208708,208708,208710,0,2,2
59567,2,3,208710,208710,208713,0,3,0
59568,6,1,208716,208716,208717,0,1,3
59569,1,3,208717,208717,208720,0,3,0
59570,6,1,208723,208723,208724,0,1,3
59571,6,1,208729,208729,208730,0,1,5
59572,2,2,208731,208731,208733,0,2,1
59573,1,2,208732,208733,208735,1,3,0
59574,2,1,208734,208735,208736,1,2,0
59575,3,1,208737,208737,208738,0,1,1
59576,3,2,208740,208740,208742,0,2,2
59577,3,3,208743,208743,208746,0,3,1
59578,1,3,208744,208746,208749,2,5,0
59579,5,2,208749,208749,208751,0,2,0
59580,3,1,208752,208752,208753,0,1,1
59581,2,2,208754,208754,208756,0,2,1
59582,5,1,208759,208759,208760,0,1,3
59583,4,3,208763,208763,208766,0,3,3
59584,5,3,208768,208768,208771,0,3,2
59585,6,3,208774,208774,208777,0,3,3
59586,4,1,208778,208778,208779,0,1,1
59587,4,1,208782,208782,208783,0,1,3
59588,4,1,208786,208786,208787,0,1,3
59589,1,3,208787,208787,208790,0,3,0
59590,6,3,208793,208793,208796,0,3,3
59591,6,3,208799,208799,208802,0,3,3
59592,4,1,208803,208803,208804,0,1,1
59593,6,1,208809,208809,208810,0,1,5
59594,2,1,208811,208811,208812,0,1,1
59595,1,2,208812,208812,208814,0,2,0
59596,5,3,208817,208817,208820,0,3,3
59597,4,2,208821,208821,208823,0,2,1
59598,4,1,208825,208825,208826,0,1,2
59599,4,1,208829,208829,208830,0,1,3
59600,2,3,208831,208831,208834,0,3,1
59601,6,1,208837,208837,208838,0,1,3
59602,1,3,208838,208838,208841,0,3,0
59603,1,1,208839,208841,208842,2,3,0
59604,5,2,208844,208844,208846,0,2,2
59605,5,3,208849,208849,208852,0,3,3
59606,4,2,208853,208853,208855,0,2,1
59607,5,2,208858,208858,208860,0,2,3
59608,5,3,208863,208863,208866,0,3,3
59609,1,2,208864,208866,208868,2,4,0
59610,2,3,208866,208868,208871,2,5,0
59611,4,2,208870,208871,208873,1,3,0
59612,2,2,208872,208873,208875,1,3,0
59613,4,2,208876,208876,208878,0,2,1
59614,2,2,208878,208878,208880,0,2,0
59615,2,1,208880,208880,208881,0,1,0
59616,1,2,208881,208881,208883,0,2,0
59617,2,2,208883,208883,208885,0,2,0
59618,4,3,208887,208887,208890,0,3,2
59619,4,3,208891,208891,208894,0,3,1
59620,4,3,208895,208895,208898,0,3,1
59621,6,3,208901,208901,208904,0,3,3
59622,6,1,208907,208907,208908,0,1,3
59623,6,2,208913,208913,208915,0,2,5
59624,2,1,208915,208915,208916,0,1,0
59625,6,1,208921,208921,208922,0,1,5
59626,4,3,208925,208925,208928,0,3,3
59627,3,2,208928,208928,208930,0,2,0
59628,3,3,208931,208931,208934,0,3,1
59629,2,1,208933,208934,208935,1,2,0
59630,6,1,208939,208939,208940,0,1,4
59631,4,2,208943,208943,208945,0,2,3
59632,2,1,208945,208945,208946,0,1,0
59633,3,1,208948,208948,208949,0,1,2
59634,6,2,208954,208954,208956,0,2,5
59635,3,2,208957,208957,208959,0,2,1
59636,2,1,208959,208959,208960,0,1,0
59637,4,3,208963,208963,208966,0,3,3
59638,6,3,208969,208969,208972,0,3,3
59639,5,3,208974,208974,208977,0,3,2
59640,4,2,208978,208978,208980,0,2,1
59641,5,2,208983,208983,208985,0,2,3
59642,4,3,208987,208987,208990,0,3,2
59643,1,1,208988,208990,208991,2,3,0
59644,3,3,208991,208991,208994,0,3,0
59645,1,1,208992,208994,208995,2,3,0
59646,3,3,208995,208995,208998,0,3,0
59647,2,2,208997,208998,209000,1,3,0
59648,1,3,208998,209000,209003,2,5,0
59649,1,1,208999,209003,209004,4,5,0
59650,6,3,209005,209005,209008,0,3,1
59651,4,1,209009,209009,209010,0,1,1
59652,2,1,209011,209011,209012,0,1,1
59653,6,1,209017,209017,209018,0,1,5
59654,5,1,209022,209022,209023,0,1,4
59655,3,1,209025,209025,209026,0,1,2
59656,3,3,209028,209028,209031,0,3,2
59657,3,2,209031,209031,209033,0,2,0
59658,1,3,209032,209033,209036,1,4,0
59659,1,2,209033,209036,209038,3,5,0
59660,2,2,209035,209038,209040,3,5,0
59661,6,2,209041,209041,209043,0,2,1
59662,2,3,209043,209043,209046,0,3,0
59663,3,1,209046,209046,209047,0,1,0
59664,6,2,209052,209052,209054,0,2,5
59665,4,2,209056,209056,209058,0,2,2
59666,2,2,209058,209058,209060,0,2,0
59667,1,2,209059,209060,209062,1,3,0
59668,6,1,209065,209065,209066,0,1,3
59669,1,1,209066,209066,209067,0,1,0
59670,3,3,209069,209069,209072,0,3,2
59671,6,1,209075,209075,209076,0,1,3
59672,4,3,209079,209079,209082,0,3,3
59673,5,3,209084,209084,209087,0,3,2
59674,6,2,209090,209090,209092,0,2,3
59675,3,1,209093,209093,209094,0,1,1
59676,4,2,209097,209097,209099,0,2,3
59677,1,2,209098,209099,209101,1,3,0
59678,3,3,209101,209101,209104,0,3,0
59679,1,1,209102,209104,209105,2,3,0
59680,5,1,209107,209107,209108,0,1,2
59681,5,1,209112,209112,209113,0,1,4
59682,5,1,209117,209117,209118,0,1,4
59683,2,1,209119,209119,209120,0,1,1
59684,6,3,209125,209125,209128,0,3,5
59685,3,3,209128,209128,209131,0,3,0
59686,5,1,209133,209133,209134,0,1,2
59687,4,1,209137,209137,209138,0,1,3
59688,3,1,209140,209140,209141,0,1,2
59689,2,1,209142,209142,209143,0,1,1
59690,1,2,209143,209143,209145,0,2,0
59691,2,2,209145,209145,209147,0,2,0
59692,4,1,209149,209149,209150,0,1,2
59693,2,3,209151,209151,209154,0,3,1
59694,4,1,209155,209155,209156,0,1,1
59695,1,1,209156,209156,209157,0,1,0
59696,1,1,209157,209157,209158,0,1,0
59697,6,2,209163,209163,209165,0,2,5
59698,2,3,209165,209165,209168,0,3,0
59699,3,2,209168,209168,209170,0,2,0
59700,6,3,209174,209174,209177,0,3,4
59701,5,2,209179,209179,209181,0,2,2
59702,5,3,209184,209184,209187,0,3,3
59703,1,3,209185,209187,209190,2,5,0
59704,6,2,209191,209191,209193,0,2,1
59705,3,1,209194,209194,209195,0,1,1
59706,4,2,209198,209198,209200,0,2,3
59707,2,2,209200,209200,209202,0,2,0
59708,3,1,209203,209203,209204,0,1,1
59709,5,3,209208,209208,209211,0,3,4
59710,2,2,209210,209211,209213,1,3,0
59711,5,2,209215,209215,209217,0,2,2
59712,4,2,209219,209219,209221,0,2,2
59713,3,2,209222,209222,209224,0,2,1
59714,1,1,209223,209224,209225,1,2,0
59715,2,3,209225,209225,209228,0,3,0
59716,4,2,209229,209229,209231,0,2,1
59717,3,2,209232,209232,209234,0,2,1
59718,4,1,209236,209236,209237,0,1,2
59719,5,1,209241,209241,209242,0,1,4
59720,3,2,209244,209244,209246,0,2,2
59721,3,3,209247,209247,209250,0,3,1
59722,6,2,209253,209253,209255,0,2,3
59723,3,2,209256,209256,209258,0,2,1
59724,4,3,209260,209260,209263,0,3,2
59725,6,1,209266,209266,209267,0,1,3
59726,6,1,209272,209272,209273,0,1,5
59727,5,1,209277,209277,209278,0,1,4
59728,3,3,209280,209280,209283,0,3,2
59729,6,1,209286,209286,209287,0,1,3
59730,2,1,209288,209288,209289,0,1,1
59731,5,3,209293,209293,209296,0,3,4
59732,6,3,209299,209299,209302,0,3,3
59733,4,1,209303,209303,209304,0,1,1
59734,6,2,209309,209309,209311,0,2,5
59735,4,1,209313,209313,209314,0,1,2
59736,2,3,209315,209315,209318,0,3,1
59737,4,2,209319,209319,209321,0,2,1
59738,3,1,209322,209322,209323,0,1,1
59739,5,2,209327,209327,209329,0,2,4
59740,3,2,209330,209330,209332,0,2,1
59741,2,1,209332,209332,209333,0,1,0
59742,2,1,209334,209334,209335,0,1,1
59743,5,2,209339,209339,209341,0,2,4
59744,2,3,209341,209341,209344,0,3,0
59745,1,1,209342,209344,209345,2,3,0
59746,2,2,209344,209345,209347,1,3,0
59747,6,2,209350,209350,209352,0,2,3
59748,5,1,209355,209355,209356,0,1,3
59749,5,2,209360,209360,209362,0,2,4
59750,6,3,209366,209366,209369,0,3,4
59751,2,3,209368,209369,209372,1,4,0
59752,2,1,209370,209372,209373,2,3,0
59753,3,3,209373,209373,209376,0,3,0
59754,2,1,209375,209376,209377,1,2,0
59755,5,3,209380,209380,209383,0,3,3
59756,1,2,209381,209383,209385,2,4,0
59757,5,2,209386,209386,209388,0,2,1
59758,1,1,209387,209388,209389,1,2,0
59759,4,1,209391,209391,209392,0,1,2
59760,3,1,209394,209394,209395,0,1,2
59761,5,1,209399,209399,209400,0,1,4
59762,5,2,209404,209404,209406,0,2,4
59763,3,1,209407,209407,209408,0,1,1
59764,2,2,209409,209409,209411,0,2,1
59765,6,3,209415,209415,209418,0,3,4
59766,3,3,209418,209418,209421,0,3,0
59767,1,3,209419,209421,209424,2,5,0
59768,4,3,209423,209424,209427,1,4,0
59769,2,1,209425,209427,209428,2,3,0
59770,3,3,209428,209428,209431,0,3,0
59771,2,2,209430,209431,209433,1,3,0
59772,5,2,209435,209435,209437,0,2,2
59773,1,1,209436,209437,209438,1,2,0
59774,1,1,209437,209438,209439,1,2,0
59775,5,2,209442,209442,209444,0,2,3
59776,1,2,209443,209444,209446,1,3,0
59777,5,1,209448,209448,209449,0,1,2
59778,6,2,209454,209454,209456,0,2,5
59779,2,2,209456,209456,209458,0,2,0
59780,3,1,209459,209459,209460,0,1,1
59781,1,3,209460,209460,209463,0,3,0
59782,5,3,209465,209465,209468,0,3,2
59783,2,1,209467,209468,209469,1,2,0
59784,5,1,209472,209472,209473,0,1,3
59785,2,1,209474,209474,209475,0,1,1
59786,3,2,209477,209477,209479,0,2,2
59787,6,1,209483,209483,209484,0,1,4
59788,2,2,209485,209485,209487,0,2,1
59789,2,3,209487,209487,209490,0,3,0
59790,4,3,209491,209491,209494,0,3,1
59791,6,2,209497,209497,209499,0,2,3
59792,1,2,209498,209499,209501,1,3,0
59793,4,1,209502,209502,209503,0,1,1
59794,4,3,209506,209506,209509,0,3,3
59795,2,1,209508,209509,209510,1,2,0
59796,1,3,209509,209510,209513,1,4,0
59797,3,3,209512,209513,209516,1,4,0
59798,3,3,209515,209516,209519,1,4,0
59799,6,1,209521,209521,209522,0,1,2
59800,6,2,209527,209527,209529,0,2,5
59801,6,2,209533,209533,209535,0,2,4
59802,3,1,209536,209536,209537,0,1,1
59803,5,1,209541,209541,209542,0,1,4
59804,3,3,209544,209544,209547,0,3,2
59805,5,1,209549,209549,209550,0,1,2
59806,5,1,209554,209554,209555,0,1,4
59807,4,1,209558,209558,209559,0,1,3
59808,5,1,209563,209563,209564,0,1,4
59809,4,2,209567,209567,209569,0,2,3
59810,1,1,209568,209569,209570,1,2,0
59811,4,2,209572,209572,209574,0,2,2
59812,5,2,209577,209577,209579,0,2,3
59813,1,1,209578,209579,209580,1,2,0
59814,3,2,209581,209581,209583,0,2,1
59815,1,1,209582,209583,209584,1,2,0
59816,5,2,209587,209587,209589,0,2,3
59817,3,3,209590,209590,209593,0,3,1
59818,3,1,209593,209593,209594,0,1,0
59819,4,1,209597,209597,209598,0,1,3
59820,1,3,209598,209598,209601,0,3,0
59821,6,2,209604,209604,209606,0,2,3
59822,5,1,209609,209609,209610,0,1,3
59823,1,3,209610,209610,209613,0,3,0
59824,1,1,209611,209613,209614,2,3,0
59825,3,3,209614,209614,209617,0,3,0
59826,1,2,209615,209617,209619,2,4,0
59827,1,2,209616,209619,209621,3,5,0
59828,4,2,209620,209621,209623,1,3,0
59829,3,3,209623,209623,209626,0,3,0
59830,5,1,209628,209628,209629,0,1,2
59831,6,1,209634,209634,209635,0,1,5
59832,5,3,209639,209639,209642,0,3,4
59833,1,1,209640,209642,209643,2,3,0
59834,1,1,209641,209643,209644,2,3,0
59835,6,2,209647,209647,209649,0,2,3
59836,6,3,209653,209653,209656,0,3,4
59837,1,2,209654,209656,209658,2,4,0
59838,2,3,209656,209658,209661,2,5,0
59839,4,2,209660,209661,209663,1,3,0
59840,2,1,209662,209663,209664,1,2,0
59841,4,1,209666,209666,209667,0,1,2
59842,2,1,209668,209668,209669,0,1,1
59843,4,1,209672,209672,209673,0,1,3
59844,2,3,209674,209674,209677,0,3,1
59845,4,1,209678,209678,209679,0,1,1
59846,3,2,209681,209681,209683,0,2,2
59847,6,2,209687,209687,209689,0,2,4
59848,1,1,209688,209689,209690,1,2,0
59849,5,3,209693,209693,209696,0,3,3
59850,4,2,209697,209697,209699,0,2,1
59851,2,2,209699,209699,209701,0,2,0
59852,6,1,209705,209705,209706,0,1,4
59853,3,3,209708,209708,209711,0,3,2
59854,1,2,209709,209711,209713,2,4,0
59855,4,1,209713,209713,209714,0,1,0
59856,6,1,209719,209719,209720,0,1,5
59857,6,2,209725,209725,209727,0,2,5
59858,5,2,209730,209730,209732,0,2,3
59859,3,1,209733,209733,209734,0,1,1
59860,1,3,209734,209734,209737,0,3,0
59861,4,1,209738,209738,209739,0,1,1
59862,3,3,209741,209741,209744,0,3,2
59863,4,3,209745,209745,209748,0,3,1
59864,3,2,209748,209748,209750,0,2,0
59865,2,2,209750,209750,209752,0,2,0
59866,1,3,209751,209752,209755,1,4,0
59867,4,2,209755,209755,209757,0,2,0
59868,1,2,209756,209757,209759,1,3,0
59869,6,3,209762,209762,209765,0,3,3
59870,4,2,209766,209766,209768,0,2,1
59871,5,3,209771,209771,209774,0,3,3
59872,1,2,209772,209774,209776,2,4,0
59873,5,2,209777,209777,209779,0,2,1
59874,4,2,209781,209781,209783,0,2,2
59875,5,1,209786,209786,209787,0,1,3
59876,1,2,209787,209787,209789,0,2,0
59877,5,2,209792,209792,209794,0,2,3
59878,6,2,209798,209798,209800,0,2,4
59879,2,3,209800,209800,209803,0,3,0
59880,3,3,209803,209803,209806,0,3,0
59881,1,3,209804,209806,209809,2,5,0
59882,2,1,209806,209809,209810,3,4,0
59883,6,3,209812,209812,209815,0,3,2
59884,3,2,209815,209815,209817,0,2,0
59885,4,1,209819,209819,209820,0,1,2
59886,1,2,209820,209820,209822,0,2,0
59887,3,2,209823,209823,209825,0,2,1
59888,6,2,209829,209829,209831,0,2,4
59889,6,3,209835,209835,209838,0,3,4
59890,2,3,209837,209838,209841,1,4,0
59891,2,2,209839,209841,209843,2,4,0
59892,6,3,209845,209845,209848,0,3,2
59893,6,3,209851,209851,209854,0,3,3
59894,6,1,209857,209857,209858,0,1,3
59895,2,1,209859,209859,209860,0,1,1
59896,2,2,209861,209861,209863,0,2,1
59897,4,1,209865,209865,209866,0,1,2
59898,6,2,209871,209871,209873,0,2,5
59899,2,3,209873,209873,209876,0,3,0
59900,6,3,209879,209879,209882,0,3,3
59901,5,1,209884,209884,209885,0,1,2
59902,6,3,209890,209890,209893,0,3,5
59903,6,1,209896,209896,209897,0,1,3
59904,1,1,209897,209897,209898,0,1,0
59905,1,2,209898,209898,209900,0,2,0
59906,5,2,209903,209903,209905,0,2,3
59907,1,1,209904,209905,209906,1,2,0
59908,2,3,209906,209906,209909,0,3,0
59909,5,2,209911,209911,209913,0,2,2
59910,5,1,209916,209916,209917,0,1,3
59911,3,2,209919,209919,209921,0,2,2
59912,3,2,209922,209922,209924,0,2,1
59913,3,2,209925,209925,209927,0,2,1
59914,2,3,209927,209927,209930,0,3,0
59915,5,3,209932,209932,209935,0,3,2
59916,5,2,209937,209937,209939,0,2,2
59917,5,1,209942,209942,209943,0,1,3
59918,3,2,209945,209945,209947,0,2,2
59919,3,3,209948,209948,209951,0,3,1
59920,5,2,209953,209953,209955,0,2,2
59921,5,3,209958,209958,209961,0,3,3
59922,1,3,209959,209961,209964,2,5,0
59923,3,2,209962,209964,209966,2,4,0
59924,4,3,209966,209966,209969,0,3,0
59925,1,2,209967,209969,209971,2,4,0
59926,4,2,209971,209971,209973,0,2,0
59927,4,2,209975,209975,209977,0,2,2
59928,1,1,209976,209977,209978,1,2,0
59929,1,1,209977,209978,209979,1,2,0
59930,1,2,209978,209979,209981,1,3,0
59931,2,2,209980,209981,209983,1,3,0
59932,5,1,209985,209985,209986,0,1,2
59933,1,1,209986,209986,209987,0,1,0
59934,6,3,209992,209992,209995,0,3,5
59935,5,2,209997,209997,209999,0,2,2
59936,3,1,210000,210000,210001,0,1,1
59937,2,1,210002,210002,210003,0,1,1
59938,3,3,210005,210005,210008,0,3,2
59939,5,3,210010,210010,210013,0,3,2
59940,3,1,210013,210013,210014,0,1,0
59941,5,1,210018,210018,210019,0,1,4
59942,4,1,210022,210022,210023,0,1,3
59943,2,1,210024,210024,210025,0,1,1
59944,1,3,210025,210025,210028,0,3,0
59945,4,3,210029,210029,210032,0,3,1
59946,6,1,210035,210035,210036,0,1,3
59947,1,1,210036,210036,210037,0,1,0
59948,3,1,210039,210039,210040,0,1,2
59949,4,2,210043,210043,210045,0,2,3
59950,1,2,210044,210045,210047,1,3,0
59951,1,1,210045,210047,210048,2,3,0
59952,3,2,210048,210048,210050,0,2,0
59953,6,2,210054,210054,210056,0,2,4
59954,4,1,210058,210058,210059,0,1,2
59955,4,2,210062,210062,210064,0,2,3
59956,5,2,210067,210067,210069,0,2,3
59957,2,2,210069,210069,210071,0,2,0
59958,2,3,210071,210071,210074,0,3,0
59959,2,1,210073,210074,210075,1,2,0
59960,6,3,210079,210079,210082,0,3,4
59961,1,2,210080,210082,210084,2,4,0
59962,1,1,210081,210084,210085,3,4,0
59963,5,3,210086,210086,210089,0,3,1
59964,6,3,210092,210092,210095,0,3,3
59965,4,2,210096,210096,210098,0,2,1
59966,2,1,210098,210098,210099,0,1,0
59967,6,1,210104,210104,210105,0,1,5
59968,1,1,210105,210105,210106,0,1,0
59969,6,2,210111,210111,210113,0,2,5
59970,2,2,210113,210113,210115,0,2,0
59971,1,3,210114,210115,210118,1,4,0
59972,1,1,210115,210118,210119,3,4,0
59973,3,1,210118,210119,210120,1,2,0
59974,3,2,210121,210121,210123,0,2,1
59975,1,2,210122,210123,210125,1,3,0
59976,5,1,210127,210127,210128,0,1,2
59977,3,3,210130,210130,210133,0,3,2
59978,2,1,210132,210133,210134,1,2,0
59979,1,3,210133,210134,210137,1,4,0
59980,5,2,210138,210138,210140,0,2,1
59981,3,3,210141,210141,210144,0,3,1
59982,6,2,210147,210147,210149,0,2,3
59983,6,3,210153,210153,210156,0,3,4
59984,6,2,210159,210159,210161,0,2,3
59985,2,1,210161,210161,210162,0,1,0
59986,4,1,210165,210165,210166,0,1,3
59987,3,2,210168,210168,210170,0,2,2
59988,4,3,210172,210172,210175,0,3,2
59989,6,3,210178,210178,210181,0,3,3
59990,5,2,210183,210183,210185,0,2,2
59991,5,2,210188,210188,210190,0,2,3
59992,6,2,210194,210194,210196,0,2,4
59993,3,3,210197,210197,210200,0,3,1
59994,2,3,210199,210200,210203,1,4,0
59995,4,1,210203,210203,210204,0,1,0
59996,2,3,210205,210205,210208,0,3,1
59997,6,1,210211,210211,210212,0,1,3
59998,6,3,210217,210217,210220,0,3,5
59999,3,2,210220,210220,210222,0,2,0
60000,5,3,210225,210225,210228,0,3,3
60001,5,2,210230,210230,210232,0,2,2
60002,2,1,210232,210232,210233,0,1,0
60003,4,1,210236,210236,210237,0,1,3
60004,5,2,210241,210241,210243,0,2,4
60005,5,1,210246,210246,210247,0,1,3
60006,2,1,210248,210248,210249,0,1,1
60007,3,2,210251,210251,210253,0,2,2
60008,1,3,210252,210253,210256,1,4,0
60009,4,1,210256,210256,210257,0,1,0
60010,1,2,210257,210257,210259,0,2,0
60011,5,3,210262,210262,210265,0,3,3
60012,4,1,210266,210266,210267,0,1,1
60013,1,3,210267,210267,210270,0,3,0
60014,5,1,210272,210272,210273,0,1,2
60015,1,1,210273,210273,210274,0,1,0
60016,3,1,210276,210276,210277,0,1,2
60017,1,1,210277,210277,210278,0,1,0
60018,2,1,210279,210279,210280,0,1,1
60019,2,1,210281,210281,210282,0,1,1
60020,5,1,210286,210286,210287,0,1,4
60021,6,2,210292,210292,210294,0,2,5
60022,2,1,210294,210294,210295,0,1,0
60023,4,1,210298,210298,210299,0,1,3
60024,1,1,210299,210299,210300,0,1,0
60025,5,1,210304,210304,210305,0,1,4
60026,6,1,210310,210310,210311,0,1,5
60027,4,3,210314,210314,210317,0,3,3
60028,1,1,210315,210317,210318,2,3,0
60029,3,2,210318,210318,210320,0,2,0
60030,6,1,210324,210324,210325,0,1,4
60031,1,2,210325,210325,210327,0,2,0
60032,2,2,210327,210327,210329,0,2,0
60033,1,3,210328,210329,210332,1,4,0
60034,5,1,210333,210333,210334,0,1,1
60035,4,2,210337,210337,210339,0,2,3
60036,1,1,210338,210339,210340,1,2,0
60037,5,1,210343,210343,210344,0,1,3
60038,2,3,210345,210345,210348,0,3,1
60039,6,3,210351,210351,210354,0,3,3
60040,3,2,210354,210354,210356,0,2,0
60041,6,2,210360,210360,210362,0,2,4
60042,5,3,210365,210365,210368,0,3,3
60043,4,2,210369,210369,210371,0,2,1
60044,6,3,210375,210375,210378,0,3,4
60045,6,3,210381,210381,210384,0,3,3
60046,1,2,210382,210384,210386,2,4,0
60047,3,1,210385,210386,210387,1,2,0
60048,6,1,210391,210391,210392,0,1,4
60049,2,1,210393,210393,210394,0,1,1
60050,5,1,210398,210398,210399,0,1,4
60051,6,3,210404,210404,210407,0,3,5
60052,6,1,210410,210410,210411,0,1,3
60053,2,3,210412,210412,210415,0,3,1
60054,4,1,210416,210416,210417,0,1,1
60055,4,3,210420,210420,210423,0,3,3
60056,5,1,210425,210425,210426,0,1,2
60057,2,2,210427,210427,210429,0,2,1
60058,5,1,210432,210432,210433,0,1,3
60059,2,1,210434,210434,210435,0,1,1
60060,2,2,210436,210436,210438,0,2,1
60061,6,3,210442,210442,210445,0,3,4
60062,2,3,210444,210445,210448,1,4,0
60063,3,1,210447,210448,210449,1,2,0
60064,1,2,210448,210449,210451,1,3,0
60065,1,2,210449,210451,210453,2,4,0
60066,2,3,210451,210453,210456,2,5,0
60067,6,1,210457,210457,210458,0,1,1
60068,6,2,210463,210463,210465,0,2,5
60069,3,2,210466,210466,210468,0,2,1
60070,2,3,210468,210468,210471,0,3,0
60071,3,2,210471,210471,210473,0,2,0
60072,4,1,210475,210475,210476,0,1,2
60073,3,3,210478,210478,210481,0,3,2
60074,3,3,210481,210481,210484,0,3,0
60075,6,3,210487,210487,210490,0,3,3
60076,2,1,210489,210490,210491,1,2,0
60077,4,3,210493,210493,210496,0,3,2
60078,3,2,210496,210496,210498,0,2,0
60079,5,3,210501,210501,210504,0,3,3
60080,6,3,210507,210507,210510,0,3,3
60081,2,1,210509,210510,210511,1,2,0
60082,4,3,210513,210513,210516,0,3,2
60083,2,2,210515,210516,210518,1,3,0
60084,4,3,210519,210519,210522,0,3,1
60085,3,2,210522,210522,210524,0,2,0
60086,1,1,210523,210524,210525,1,2,0
60087,6,1,210529,210529,210530,0,1,4
60088,1,3,210530,210530,210533,0,3,0
60089,5,3,210535,210535,210538,0,3,2
60090,1,2,210536,210538,210540,2,4,0
60091,4,1,210540,210540,210541,0,1,0
60092,3,2,210543,210543,210545,0,2,2
60093,1,1,210544,210545,210546,1,2,0
60094,5,2,210549,210549,210551,0,2,3
60095,4,1,210553,210553,210554,0,1,2
60096,1,1,210554,210554,210555,0,1,0
60097,3,1,210557,210557,210558,0,1,2
60098,1,1,210558,210558,210559,0,1,0
60099,5,1,210563,210563,210564,0,1,4
60100,2,2,210565,210565,210567,0,2,1
60101,3,3,210568,210568,210571,0,3,1
60102,2,3,210570,210571,210574,1,4,0
60103,4,2,210574,210574,210576,0,2,0
60104,3,2,210577,210577,210579,0,2,1
60105,1,1,210578,210579,210580,1,2,0
60106,1,2,210579,210580,210582,1,3,0
60107,1,1,210580,210582,210583,2,3,0
60108,2,2,210582,210583,210585,1,3,0
60109,1,1,210583,210585,210586,2,3,0
60110,2,2,210585,210586,210588,1,3,0
60111,3,2,210588,210588,210590,0,2,0
60112,6,1,210594,210594,210595,0,1,4
60113,3,3,210597,210597,210600,0,3,2
60114,4,2,210601,210601,210603,0,2,1
60115,3,1,210604,210604,210605,0,1,1
60116,5,1,210609,210609,210610,0,1,4
60117,1,3,210610,210610,210613,0,3,0
60118,5,3,210615,210615,210618,0,3,2
60119,5,1,210620,210620,210621,0,1,2
60120,1,2,210621,210621,210623,0,2,0
60121,4,1,210625,210625,210626,0,1,2
60122,2,1,210627,210627,210628,0,1,1
60123,1,2,210628,210628,210630,0,2,0
60124,3,1,210631,210631,210632,0,1,1
60125,2,3,210633,210633,210636,0,3,1
60126,5,2,210638,210638,210640,0,2,2
60127,3,2,210641,210641,210643,0,2,1
60128,3,2,210644,210644,210646,0,2,1
60129,4,3,210648,210648,210651,0,3,2
60130,3,1,210651,210651,210652,0,1,0
60131,4,2,210655,210655,210657,0,2,3
60132,6,2,210661,210661,210663,0,2,4
60133,5,1,210666,210666,210667,0,1,3
60134,6,2,210672,210672,210674,0,2,5
60135,3,3,210675,210675,210678,0,3,1
60136,2,3,210677,210678,210681,1,4,0
60137,6,1,210683,210683,210684,0,1,2
60138,1,3,210684,210684,210687,0,3,0
60139,5,1,210689,210689,210690,0,1,2
60140,3,2,210692,210692,210694,0,2,2
60141,1,3,210693,210694,210697,1,4,0
60142,2,3,210695,210697,210700,2,5,0
60143,1,3,210696,210700,210703,4,7,0
60144,3,3,210699,210703,210706,4,7,0
60145,2,3,210701,210706,210709,5,8,0
60146,5,1,210706,210709,210710,3,4,0
60147,5,1,210711,210711,210712,0,1,1
60148,4,1,210715,210715,210716,0,1,3
60149,4,2,210719,210719,210721,0,2,3
60150,1,1,210720,210721,210722,1,2,0
60151,2,2,210722,210722,210724,0,2,0
60152,2,3,210724,210724,210727,0,3,0
60153,2,2,210726,210727,210729,1,3,0
60154,5,1,210731,210731,210732,0,1,2
60155,2,1,210733,210733,210734,0,1,1
60156,3,3,210736,210736,210739,0,3,2
60157,5,1,210741,210741,210742,0,1,2
60158,3,1,210744,210744,210745,0,1,2
60159,1,2,210745,210745,210747,0,2,0
60160,2,2,210747,210747,210749,0,2,0
60161,6,2,210753,210753,210755,0,2,4
60162,4,3,210757,210757,210760,0,3,2
60163,3,2,210760,210760,210762,0,2,0
60164,1,2,210761,210762,210764,1,3,0
60165,2,1,210763,210764,210765,1,2,0
60166,3,2,210766,210766,210768,0,2,1
60167,4,1,210770,210770,210771,0,1,2
60168,2,1,210772,210772,210773,0,1,1
60169,6,3,210778,210778,210781,0,3,5
60170,3,2,210781,210781,210783,0,2,0
60171,2,1,210783,210783,210784,0,1,0
60172,5,1,210788,210788,210789,0,1,4
60173,2,3,210790,210790,210793,0,3,1
60174,1,2,210791,210793,210795,2,4,0
60175,6,2,210797,210797,210799,0,2,2
60176,5,3,210802,210802,210805,0,3,3
60177,1,2,210803,210805,210807,2,4,0
60178,2,2,210805,210807,210809,2,4,0
60179,1,2,210806,210809,210811,3,5,0
60180,4,1,210810,210811,210812,1,2,0
60181,2,1,210812,210812,210813,0,1,0
60182,5,2,210817,210817,210819,0,2,4
60183,6,3,210823,210823,210826,0,3,4
60184,1,2,210824,210826,210828,2,4,0
60185,3,3,210827,210828,210831,1,4,0
60186,4,1,210831,210831,210832,0,1,0
60187,3,2,210834,210834,210836,0,2,2
60188,2,2,210836,210836,210838,0,2,0
60189,2,3,210838,210838,210841,0,3,0
60190,3,3,210841,210841,210844,0,3,0
60191,5,1,210846,210846,210847,0,1,2
60192,6,3,210852,210852,210855,0,3,5
60193,4,3,210856,210856,210859,0,3,1
60194,4,1,210860,210860,210861,0,1,1
60195,1,3,210861,210861,210864,0,3,0
60196,2,2,210863,210864,210866,1,3,0
60197,1,1,210864,210866,210867,2,3,0
60198,1,3,210865,210867,210870,2,5,0
60199,5,1,210870,210870,210871,0,1,0
60200,5,1,210875,210875,210876,0,1,4
60201,1,2,210876,210876,210878,0,2,0
60202,6,2,210882,210882,210884,0,2,4
60203,2,3,210884,210884,210887,0,3,0
60204,5,3,210889,210889,210892,0,3,2
60205,6,3,210895,210895,210898,0,3,3
60206,3,3,210898,210898,210901,0,3,0
60207,1,2,210899,210901,210903,2,4,0
60208,1,1,210900,210903,210904,3,4,0
60209,6,2,210906,210906,210908,0,2,2
60210,1,2,210907,210908,210910,1,3,0
60211,4,1,210911,210911,210912,0,1,1
60212,6,2,210917,210917,210919,0,2,5
60213,1,3,210918,210919,210922,1,4,0
60214,3,3,210921,210922,210925,1,4,0
60215,6,1,210927,210927,210928,0,1,2
60216,4,3,210931,210931,210934,0,3,3
60217,2,2,210933,210934,210936,1,3,0
60218,5,3,210938,210938,210941,0,3,2
60219,2,3,210940,210941,210944,1,4,0
60220,2,2,210942,210944,210946,2,4,0
60221,4,3,210946,210946,210949,0,3,0
60222,4,2,210950,210950,210952,0,2,1
60223,5,2,210955,210955,210957,0,2,3
60224,3,2,210958,210958,210960,0,2,1
60225,6,1,210964,210964,210965,0,1,4
60226,6,2,210970,210970,210972,0,2,5
60227,6,3,210976,210976,210979,0,3,4
60228,2,2,210978,210979,210981,1,3,0
60229,5,3,210983,210983,210986,0,3,2
60230,2,3,210985,210986,210989,1,4,0
60231,1,2,210986,210989,210991,3,5,0
60232,3,2,210989,210991,210993,2,4,0
60233,3,2,210992,210993,210995,1,3,0
60234,1,2,210993,210995,210997,2,4,0
60235,6,3,210999,210999,211002,0,3,2
60236,4,2,211003,211003,211005,0,2,1
60237,1,2,211004,211005,211007,1,3,0
60238,4,2,211008,211008,211010,0,2,1
60239,1,1,211009,211010,211011,1,2,0
60240,6,2,211015,211015,211017,0,2,4
60241,3,2,211018,211018,211020,0,2,1
60242,5,3,211023,211023,211026,0,3,3
60243,2,2,211025,211026,211028,1,3,0
60244,2,3,211027,211028,211031,1,4,0
60245,6,2,211033,211033,211035,0,2,2
60246,2,3,211035,211035,211038,0,3,0
60247,2,3,211037,211038,211041,1,4,0
60248,6,3,211043,211043,211046,0,3,2
60249,2,3,211045,211046,211049,1,4,0
60250,6,3,211051,211051,211054,0,3,2
60251,3,1,211054,211054,211055,0,1,0
60252,6,2,211060,211060,211062,0,2,5
60253,1,3,211061,211062,211065,1,4,0
60254,2,3,211063,211065,211068,2,5,0
60255,6,1,211069,211069,211070,0,1,1
60256,2,3,211071,211071,211074,0,3,1
60257,3,3,211074,211074,211077,0,3,0
60258,6,1,211080,211080,211081,0,1,3
60259,5,1,211085,211085,211086,0,1,4
60260,4,2,211089,211089,211091,0,2,3
60261,5,2,211094,211094,211096,0,2,3
60262,3,2,211097,211097,211099,0,2,1
60263,4,2,211101,211101,211103,0,2,2
60264,1,3,211102,211103,211106,1,4,0
60265,2,1,211104,211106,211107,2,3,0
60266,1,1,211105,211107,211108,2,3,0
60267,2,1,211107,211108,211109,1,2,0
60268,3,3,211110,211110,211113,0,3,1
60269,1,3,211111,211113,211116,2,5,0
60270,3,1,211114,211116,211117,2,3,0
60271,5,2,211119,211119,211121,0,2,2
60272,3,1,211122,211122,211123,0,1,1
60273,2,2,211124,211124,211126,0,2,1
60274,6,1,211130,211130,211131,0,1,4
60275,5,3,211135,211135,211138,0,3,4
60276,4,1,211139,211139,211140,0,1,1
60277,4,2,211143,211143,211145,0,2,3
60278,4,1,211147,211147,211148,0,1,2
60279,4,1,211151,211151,211152,0,1,3
60280,4,2,211155,211155,211157,0,2,3
60281,6,3,211161,211161,211164,0,3,4
60282,4,2,211165,211165,211167,0,2,1
60283,5,1,211170,211170,211171,0,1,3
60284,6,3,211176,211176,211179,0,3,5
60285,6,1,211182,211182,211183,0,1,3
60286,4,2,211186,211186,211188,0,2,3
60287,5,1,211191,211191,211192,0,1,3
60288,6,2,211197,211197,211199,0,2,5
60289,2,3,211199,211199,211202,0,3,0
60290,3,1,211202,211202,211203,0,1,0
60291,1,3,211203,211203,211206,0,3,0
60292,2,3,211205,211206,211209,1,4,0
60293,6,2,211211,211211,211213,0,2,2
60294,4,2,211215,211215,211217,0,2,2
60295,2,2,211217,211217,211219,0,2,0
60296,6,2,211223,211223,211225,0,2,4
60297,2,2,211225,211225,211227,0,2,0
60298,5,1,211230,211230,211231,0,1,3
60299,3,3,211233,211233,211236,0,3,2
60300,3,1,211236,211236,211237,0,1,0
60301,2,1,211238,211238,211239,0,1,1
60302,6,3,211244,211244,211247,0,3,5
60303,4,1,211248,211248,211249,0,1,1
60304,3,3,211251,211251,211254,0,3,2
60305,4,3,211255,211255,211258,0,3,1
60306,6,1,211261,211261,211262,0,1,3
60307,4,1,211265,211265,211266,0,1,3
60308,1,3,211266,211266,211269,0,3,0
60309,6,1,211272,211272,211273,0,1,3
60310,4,3,211276,211276,211279,0,3,3
60311,3,2,211279,211279,211281,0,2,0
60312,1,2,211280,211281,211283,1,3,0
60313,3,1,211283,211283,211284,0,1,0
60314,1,3,211284,211284,211287,0,3,0
60315,3,1,211287,211287,211288,0,1,0
60316,5,1,211292,211292,211293,0,1,4
60317,2,1,211294,211294,211295,0,1,1
60318,6,3,211300,211300,211303,0,3,5
60319,5,2,211305,211305,211307,0,2,2
60320,2,1,211307,211307,211308,0,1,0
60321,4,3,211311,211311,211314,0,3,3
60322,6,1,211317,211317,211318,0,1,3
60323,2,2,211319,211319,211321,0,2,1
60324,4,3,211323,211323,211326,0,3,2
60325,6,1,211329,211329,211330,0,1,3
60326,4,3,211333,211333,211336,0,3,3
60327,4,2,211337,211337,211339,0,2,1
60328,4,3,211341,211341,211344,0,3,2
60329,5,3,211346,211346,211349,0,3,2
60330,3,3,211349,211349,211352,0,3,0
60331,4,2,211353,211353,211355,0,2,1
60332,1,2,211354,211355,211357,1,3,0
60333,3,2,211357,211357,211359,0,2,0
60334,2,3,211359,211359,211362,0,3,0
60335,1,3,211360,211362,211365,2,5,0
60336,4,2,211364,211365,211367,1,3,0
60337,2,2,211366,211367,211369,1,3,0
60338,6,2,211372,211372,211374,0,2,3
60339,2,1,211374,211374,211375,0,1,0
60340,4,3,211378,211378,211381,0,3,3
60341,1,3,211379,211381,211384,2,5,0
60342,4,1,211383,211384,211385,1,2,0
60343,6,3,211389,211389,211392,0,3,4
60344,1,3,211390,211392,211395,2,5,0
60345,4,2,211394,211395,211397,1,3,0
60346,2,3,211396,211397,211400,1,4,0
60347,6,2,211402,211402,211404,0,2,2
60348,5,1,211407,211407,211408,0,1,3
60349,5,3,211412,211412,211415,0,3,4
60350,6,2,211418,211418,211420,0,2,3
60351,5,3,211423,211423,211426,0,3,3
60352,4,2,211427,211427,211429,0,2,1
60353,3,3,211430,211430,211433,0,3,1
60354,6,3,211436,211436,211439,0,3,3
60355,5,3,211441,211441,211444,0,3,2
60356,6,2,211447,211447,211449,0,2,3
60357,1,2,211448,211449,211451,1,3,0
60358,2,2,211450,211451,211453,1,3,0
60359,4,2,211454,211454,211456,0,2,1
60360,2,3,211456,211456,211459,0,3,0
60361,1,1,211457,211459,211460,2,3,0
60362,4,1,211461,211461,211462,0,1,1
60363,5,2,211466,211466,211468,0,2,4
60364,4,2,211470,211470,211472,0,2,2
60365,5,1,211475,211475,211476,0,1,3
60366,6,3,211481,211481,211484,0,3,5
60367,4,1,211485,211485,211486,0,1,1
60368,4,1,211489,211489,211490,0,1,3
60369,1,2,211490,211490,211492,0,2,0
60370,6,3,211496,211496,211499,0,3,4
60371,3,1,211499,211499,211500,0,1,0
60372,1,3,211500,211500,211503,0,3,0
60373,5,3,211505,211505,211508,0,3,2
60374,3,2,211508,211508,211510,0,2,0
60375,2,2,211510,211510,211512,0,2,0
60376,2,1,211512,211512,211513,0,1,0
60377,2,2,211514,211514,211516,0,2,1
60378,3,2,211517,211517,211519,0,2,1
60379,5,3,211522,211522,211525,0,3,3
60380,4,1,211526,211526,211527,0,1,1
60381,3,1,211529,211529,211530,0,1,2
60382,6,1,211535,211535,211536,0,1,5
60383,1,1,211536,211536,211537,0,1,0
60384,4,1,211540,211540,211541,0,1,3
60385,4,1,211544,211544,211545,0,1,3
60386,1,2,211545,211545,211547,0,2,0
60387,6,3,211551,211551,211554,0,3,4
60388,2,3,211553,211554,211557,1,4,0
60389,2,1,211555,211557,211558,2,3,0
60390,6,2,211561,211561,211563,0,2,3
60391,2,1,211563,211563,211564,0,1,0
60392,3,2,211566,211566,211568,0,2,2
60393,4,3,211570,211570,211573,0,3,2
60394,1,2,211571,211573,211575,2,4,0
60395,6,3,211577,211577,211580,0,3,2
60396,2,1,211579,211580,211581,1,2,0
60397,1,2,211580,211581,211583,1,3,0
60398,1,2,211581,211583,211585,2,4,0
60399,5,3,211586,211586,211589,0,3,1
60400,2,1,211588,211589,211590,1,2,0
60401,6,3,211594,211594,211597,0,3,4
60402,2,1,211596,211597,211598,1,2,0
60403,2,3,211598,211598,211601,0,3,0
60404,3,2,211601,211601,211603,0,2,0
60405,3,2,211604,211604,211606,0,2,1
60406,3,2,211607,211607,211609,0,2,1
60407,4,1,211611,211611,211612,0,1,2
60408,5,2,211616,211616,211618,0,2,4
60409,5,2,211621,211621,211623,0,2,3
60410,6,3,211627,211627,211630,0,3,4
60411,1,3,211628,211630,211633,2,5,0
60412,1,2,211629,211633,211635,4,6,0
60413,2,2,211631,211635,211637,4,6,0
60414,1,2,211632,211637,211639,5,7,0
60415,3,1,211635,211639,211640,4,5,0
60416,2,1,211637,211640,211641,3,4,0
60417,1,3,211638,211641,211644,3,6,0
60418,2,3,211640,211644,211647,4,7,0
60419,3,1,211643,211647,211648,4,5,0
60420,4,3,211647,211648,211651,1,4,0
60421,6,3,211653,211653,211656,0,3,2
60422,4,2,211657,211657,211659,0,2,1
60423,4,3,211661,211661,211664,0,3,2
60424,5,3,211666,211666,211669,0,3,2
60425,6,2,211672,211672,211674,0,2,3
60426,2,2,211674,211674,211676,0,2,0
60427,3,3,211677,211677,211680,0,3,1
60428,2,1,211679,211680,211681,1,2,0
60429,2,2,211681,211681,211683,0,2,0
60430,4,2,211685,211685,211687,0,2,2
60431,2,3,211687,211687,211690,0,3,0
60432,5,2,211692,211692,211694,0,2,2
60433,1,3,211693,211694,211697,1,4,0
60434,5,3,211698,211698,211701,0,3,1
60435,6,3,211704,211704,211707,0,3,3
60436,5,1,211709,211709,211710,0,1,2
60437,5,1,211714,211714,211715,0,1,4
60438,3,1,211717,211717,211718,0,1,2
60439,5,1,211722,211722,211723,0,1,4
60440,1,2,211723,211723,211725,0,2,0
60441,2,3,211725,211725,211728,0,3,0
60442,3,3,211728,211728,211731,0,3,0
60443,6,2,211734,211734,211736,0,2,3
60444,1,3,211735,211736,211739,1,4,0
60445,2,3,211737,211739,211742,2,5,0
60446,5,1,211742,211742,211743,0,1,0
60447,1,2,211743,211743,211745,0,2,0
60448,1,1,211744,211745,211746,1,2,0
60449,4,2,211748,211748,211750,0,2,2
60450,6,2,211754,211754,211756,0,2,4
60451,2,3,211756,211756,211759,0,3,0
60452,5,3,211761,211761,211764,0,3,2
60453,2,2,211763,211764,211766,1,3,0
60454,1,1,211764,211766,211767,2,3,0
60455,5,2,211769,211769,211771,0,2,2
60456,4,1,211773,211773,211774,0,1,2
60457,1,3,211774,211774,211777,0,3,0
60458,6,3,211780,211780,211783,0,3,3
60459,5,1,211785,211785,211786,0,1,2
60460,4,3,211789,211789,211792,0,3,3
60461,4,2,211793,211793,211795,0,2,1
60462,2,1,211795,211795,211796,0,1,0
60463,5,2,211800,211800,211802,0,2,4
60464,1,3,211801,211802,211805,1,4,0
60465,1,3,211802,211805,211808,3,6,0
60466,4,1,211806,211808,211809,2,3,0
60467,2,3,211808,211809,211812,1,4,0
60468,2,3,211810,211812,211815,2,5,0
60469,4,2,211814,211815,211817,1,3,0
60470,3,1,211817,211817,211818,0,1,0
60471,4,1,211821,211821,211822,0,1,3
60472,1,3,211822,211822,211825,0,3,0
60473,5,3,211827,211827,211830,0,3,2
60474,3,3,211830,211830,211833,0,3,0
60475,3,3,211833,211833,211836,0,3,0
60476,1,1,211834,211836,211837,2,3,0
60477,1,2,211835,211837,211839,2,4,0
60478,5,3,211840,211840,211843,0,3,1
60479,1,1,211841,211843,211844,2,3,0
60480,2,1,211843,211844,211845,1,2,0
60481,5,1,211848,211848,211849,0,1,3
60482,4,3,211852,211852,211855,0,3,3
60483,3,1,211855,211855,211856,0,1,0
60484,4,3,211859,211859,211862,0,3,3
60485,3,3,211862,211862,211865,0,3,0
60486,1,2,211863,211865,211867,2,4,0
60487,6,1,211869,211869,211870,0,1,2
60488,5,3,211874,211874,211877,0,3,4
60489,2,3,211876,211877,211880,1,4,0
60490,4,3,211880,211880,211883,0,3,0
60491,6,1,211886,211886,211887,0,1,3
60492,3,3,211889,211889,211892,0,3,2
60493,1,3,211890,211892,211895,2,5,0
60494,1,1,211891,211895,211896,4,5,0
60495,3,3,211894,211896,211899,2,5,0
60496,3,1,211897,211899,211900,2,3,0
60497,5,2,211902,211902,211904,0,2,2
60498,3,1,211905,211905,211906,0,1,1
60499,3,3,211908,211908,211911,0,3,2
60500,4,2,211912,211912,211914,0,2,1
60501,6,3,211918,211918,211921,0,3,4
60502,1,2,211919,211921,211923,2,4,0
60503,1,1,211920,211923,211924,3,4,0
60504,5,2,211925,211925,211927,0,2,1
60505,3,2,211928,211928,211930,0,2,1
60506,4,3,211932,211932,211935,0,3,2
60507,6,3,211938,211938,211941,0,3,3
60508,1,2,211939,211941,211943,2,4,0
60509,2,2,211941,211943,211945,2,4,0
60510,2,2,211943,211945,211947,2,4,0
60511,6,1,211949,211949,211950,0,1,2
60512,2,2,211951,211951,211953,0,2,1
60513,5,3,211956,211956,211959,0,3,3
60514,4,2,211960,211960,211962,0,2,1
60515,5,1,211965,211965,211966,0,1,3
60516,3,2,211968,211968,211970,0,2,2
60517,3,3,211971,211971,211974,0,3,1
60518,4,1,211975,211975,211976,0,1,1
60519,4,1,211979,211979,211980,0,1,3
60520,4,1,211983,211983,211984,0,1,3
60521,5,2,211988,211988,211990,0,2,4
60522,5,2,211993,211993,211995,0,2,3
60523,4,2,211997,211997,211999,0,2,2
60524,4,1,212001,212001,212002,0,1,2
60525,6,1,212007,212007,212008,0,1,5
60526,1,2,212008,212008,212010,0,2,0
60527,6,2,212014,212014,212016,0,2,4
60528,4,3,212018,212018,212021,0,3,2
60529,3,1,212021,212021,212022,0,1,0
60530,4,3,212025,212025,212028,0,3,3
60531,1,1,212026,212028,212029,2,3,0
60532,5,2,212031,212031,212033,0,2,2
60533,4,2,212035,212035,212037,0,2,2
60534,5,1,212040,212040,212041,0,1,3
60535,1,2,212041,212041,212043,0,2,0
60536,2,2,212043,212043,212045,0,2,0
60537,3,2,212046,212046,212048,0,2,1
60538,1,3,212047,212048,212051,1,4,0
60539,6,3,212053,212053,212056,0,3,2
60540,5,3,212058,212058,212061,0,3,2
60541,1,3,212059,212061,212064,2,5,0
60542,2,1,212061,212064,212065,3,4,0
60543,1,1,212062,212065,212066,3,4,0
60544,4,3,212066,212066,212069,0,3,0
60545,3,3,212069,212069,212072,0,3,0
60546,6,2,212075,212075,212077,0,2,3
60547,5,2,212080,212080,212082,0,2,3
60548,4,3,212084,212084,212087,0,3,2
60549,4,1,212088,212088,212089,0,1,1
60550,1,2,212089,212089,212091,0,2,0
60551,5,2,212094,212094,212096,0,2,3
60552,6,3,212100,212100,212103,0,3,4
60553,6,2,212106,212106,212108,0,2,3
60554,1,2,212107,212108,212110,1,3,0
60555,1,3,212108,212110,212113,2,5,0
60556,1,2,212109,212113,212115,4,6,0
60557,3,3,212112,212115,212118,3,6,0
60558,3,2,212115,212118,212120,3,5,0
60559,2,1,212117,212120,212121,3,4,0
60560,5,1,212122,212122,212123,0,1,1
60561,1,2,212123,212123,212125,0,2,0
60562,3,2,212126,212126,212128,0,2,1
60563,6,3,212132,212132,212135,0,3,4
60564,5,1,212137,212137,212138,0,1,2
60565,6,1,212143,212143,212144,0,1,5
60566,5,1,212148,212148,212149,0,1,4
60567,2,2,212150,212150,212152,0,2,1
60568,5,1,212155,212155,212156,0,1,3
60569,5,1,212160,212160,212161,0,1,4
60570,2,3,212162,212162,212165,0,3,1
60571,5,3,212167,212167,212170,0,3,2
60572,2,2,212169,212170,212172,1,3,0
60573,5,1,212174,212174,212175,0,1,2
60574,2,3,212176,212176,212179,0,3,1
60575,6,3,212182,212182,212185,0,3,3
60576,4,1,212186,212186,212187,0,1,1
60577,2,2,212188,212188,212190,0,2,1
60578,2,3,212190,212190,212193,0,3,0
60579,4,2,212194,212194,212196,0,2,1
60580,1,3,212195,212196,212199,1,4,0
60581,3,3,212198,212199,212202,1,4,0
60582,6,1,212204,212204,212205,0,1,2
60583,2,3,212206,212206,212209,0,3,1
60584,3,1,212209,212209,212210,0,1,0
60585,2,3,212211,212211,212214,0,3,1
60586,6,3,212217,212217,212220,0,3,3
60587,1,2,212218,212220,212222,2,4,0
60588,5,2,212223,212223,212225,0,2,1
60589,4,3,212227,212227,212230,0,3,2
60590,3,3,212230,212230,212233,0,3,0
60591,1,2,212231,212233,212235,2,4,0
60592,3,2,212234,212235,212237,1,3,0
60593,4,3,212238,212238,212241,0,3,1
60594,2,2,212240,212241,212243,1,3,0
60595,3,2,212243,212243,212245,0,2,0
60596,5,1,212248,212248,212249,0,1,3
60597,4,1,212252,212252,212253,0,1,3
60598,2,1,212254,212254,212255,0,1,1
60599,1,3,212255,212255,212258,0,3,0
60600,3,3,212258,212258,212261,0,3,0
60601,6,3,212264,212264,212267,0,3,3
60602,5,1,212269,212269,212270,0,1,2
60603,6,3,212275,212275,212278,0,3,5
60604,5,2,212280,212280,212282,0,2,2
60605,1,3,212281,212282,212285,1,4,0
60606,4,2,212285,212285,212287,0,2,0
60607,3,1,212288,212288,212289,0,1,1
60608,1,3,212289,212289,212292,0,3,0
60609,6,1,212295,212295,212296,0,1,3
60610,5,1,212300,212300,212301,0,1,4
60611,4,3,212304,212304,212307,0,3,3
60612,3,3,212307,212307,212310,0,3,0
60613,1,3,212308,212310,212313,2,5,0
60614,4,1,212312,212313,212314,1,2,0
60615,1,2,212313,212314,212316,1,3,0
60616,3,3,212316,212316,212319,0,3,0
60617,3,1,212319,212319,212320,0,1,0
60618,5,2,212324,212324,212326,0,2,4
60619,6,1,212330,212330,212331,0,1,4
60620,1,3,212331,212331,212334,0,3,0
60621,3,2,212334,212334,212336,0,2,0
60622,6,2,212340,212340,212342,0,2,4
60623,1,2,212341,212342,212344,1,3,0
60624,1,2,212342,212344,212346,2,4,0
60625,4,3,212346,212346,212349,0,3,0
60626,3,1,212349,212349,212350,0,1,0
60627,6,1,212355,212355,212356,0,1,5
60628,6,3,212361,212361,212364,0,3,5
60629,1,1,212362,212364,212365,2,3,0
60630,2,1,212364,212365,212366,1,2,0
60631,4,2,212368,212368,212370,0,2,2
60632,2,1,212370,212370,212371,0,1,0
60633,4,2,212374,212374,212376,0,2,3
60634,5,1,212379,212379,212380,0,1,3
60635,2,3,212381,212381,212384,0,3,1
60636,4,1,212385,212385,212386,0,1,1
60637,5,3,212390,212390,212393,0,3,4
60638,5,1,212395,212395,212396,0,1,2
60639,6,1,212401,212401,212402,0,1,5
60640,3,1,212404,212404,212405,0,1,2
60641,5,1,212409,212409,212410,0,1,4
60642,6,2,212415,212415,212417,0,2,5
60643,3,1,212418,212418,212419,0,1,1
60644,4,3,212422,212422,212425,0,3,3
60645,5,2,212427,212427,212429,0,2,2
60646,4,2,212431,212431,212433,0,2,2
60647,5,1,212436,212436,212437,0,1,3
60648,1,3,212437,212437,212440,0,3,0
60649,6,3,212443,212443,212446,0,3,3
60650,4,3,212447,212447,212450,0,3,1
60651,3,1,212450,212450,212451,0,1,0
60652,6,1,212456,212456,212457,0,1,5
60653,2,3,212458,212458,212461,0,3,1
60654,3,1,212461,212461,212462,0,1,0
60655,5,3,212466,212466,212469,0,3,4
60656,6,2,212472,212472,212474,0,2,3
60657,4,3,212476,212476,212479,0,3,2
60658,1,1,212477,212479,212480,2,3,0
60659,1,1,212478,212480,212481,2,3,0
60660,1,2,212479,212481,212483,2,4,0
60661,6,2,212485,212485,212487,0,2,2
60662,2,1,212487,212487,212488,0,1,0
60663,2,3,212489,212489,212492,0,3,1
60664,3,3,212492,212492,212495,0,3,0
60665,3,1,212495,212495,212496,0,1,0
60666,1,1,212496,212496,212497,0,1,0
60667,3,1,212499,212499,212500,0,1,2
60668,2,2,212501,212501,212503,0,2,1
60669,3,1,212504,212504,212505,0,1,1
60670,1,1,212505,212505,212506,0,1,0
60671,5,1,212510,212510,212511,0,1,4
60672,1,3,212511,212511,212514,0,3,0
60673,6,1,212517,212517,212518,0,1,3
60674,5,2,212522,212522,212524,0,2,4
60675,4,3,212526,212526,212529,0,3,2
60676,4,3,212530,212530,212533,0,3,1
60677,6,3,212536,212536,212539,0,3,3
60678,5,3,212541,212541,212544,0,3,2
60679,6,3,212547,212547,212550,0,3,3
60680,2,1,212549,212550,212551,1,2,0
60681,4,1,212553,212553,212554,0,1,2
60682,1,3,212554,212554,212557,0,3,0
60683,6,2,212560,212560,212562,0,2,3
60684,4,1,212564,212564,212565,0,1,2
60685,1,2,212565,212565,212567,0,2,0
60686,2,1,212567,212567,212568,0,1,0
60687,4,3,212571,212571,212574,0,3,3
60688,3,1,212574,212574,212575,0,1,0
60689,1,3,212575,212575,212578,0,3,0
60690,6,1,212581,212581,212582,0,1,3
60691,6,2,212587,212587,212589,0,2,5
60692,1,1,212588,212589,212590,1,2,0
60693,2,1,212590,212590,212591,0,1,0
60694,6,3,212596,212596,212599,0,3,5
60695,2,1,212598,212599,212600,1,2,0
60696,1,2,212599,212600,212602,1,3,0
60697,1,2,212600,212602,212604,2,4,0
60698,2,2,212602,212604,212606,2,4,0
60699,2,1,212604,212606,212607,2,3,0
60700,6,1,212610,212610,212611,0,1,3
60701,1,3,212611,212611,212614,0,3,0
60702,6,2,212617,212617,212619,0,2,3
60703,5,2,212622,212622,212624,0,2,3
60704,2,2,212624,212624,212626,0,2,0
60705,1,2,212625,212626,212628,1,3,0
60706,5,1,212630,212630,212631,0,1,2
60707,3,1,212633,212633,212634,0,1,2
60708,4,3,212637,212637,212640,0,3,3
60709,4,3,212641,212641,212644,0,3,1
60710,1,2,212642,212644,212646,2,4,0
60711,4,3,212646,212646,212649,0,3,0
60712,5,2,212651,212651,212653,0,2,2
60713,6,1,212657,212657,212658,0,1,4
60714,4,2,212661,212661,212663,0,2,3
60715,6,2,212667,212667,212669,0,2,4
60716,1,2,212668,212669,212671,1,3,0
60717,6,3,212674,212674,212677,0,3,3
60718,1,2,212675,212677,212679,2,4,0
60719,3,2,212678,212679,212681,1,3,0
60720,6,2,212684,212684,212686,0,2,3
60721,2,3,212686,212686,212689,0,3,0
60722,5,2,212691,212691,212693,0,2,2
60723,1,2,212692,212693,212695,1,3,0
60724,2,2,212694,212695,212697,1,3,0
60725,6,2,212700,212700,212702,0,2,3
60726,4,2,212704,212704,212706,0,2,2
60727,5,2,212709,212709,212711,0,2,3
60728,6,2,212715,212715,212717,0,2,4
60729,4,1,212719,212719,212720,0,1,2
60730,2,2,212721,212721,212723,0,2,1
60731,2,1,212723,212723,212724,0,1,0
60732,2,3,212725,212725,212728,0,3,1
60733,6,2,212731,212731,212733,0,2,3
60734,3,3,212734,212734,212737,0,3,1
60735,6,3,212740,212740,212743,0,3,3
60736,6,3,212746,212746,212749,0,3,3
60737,5,1,212751,212751,212752,0,1,2
60738,2,3,212753,212753,212756,0,3,1
60739,3,3,212756,212756,212759,0,3,0
60740,5,3,212761,212761,212764,0,3,2
60741,2,2,212763,212764,212766,1,3,0
60742,3,3,212766,212766,212769,0,3,0
60743,1,3,212767,212769,212772,2,5,0
60744,5,3,212772,212772,212775,0,3,0
60745,5,1,212777,212777,212778,0,1,2
60746,4,1,212781,212781,212782,0,1,3
60747,5,2,212786,212786,212788,0,2,4
60748,5,3,212791,212791,212794,0,3,3
60749,2,2,212793,212794,212796,1,3,0
60750,6,3,212799,212799,212802,0,3,3
60751,4,1,212803,212803,212804,0,1,1
60752,3,3,212806,212806,212809,0,3,2
60753,1,1,212807,212809,212810,2,3,0
60754,3,2,212810,212810,212812,0,2,0
60755,5,3,212815,212815,212818,0,3,3
60756,4,1,212819,212819,212820,0,1,1
60757,6,3,212825,212825,212828,0,3,5
60758,6,3,212831,212831,212834,0,3,3
60759,2,1,212833,212834,212835,1,2,0
60760,5,3,212838,212838,212841,0,3,3
60761,5,1,212843,212843,212844,0,1,2
60762,2,1,212845,212845,212846,0,1,1
60763,6,1,212851,212851,212852,0,1,5
60764,2,1,212853,212853,212854,0,1,1
60765,1,2,212854,212854,212856,0,2,0
60766,4,2,212858,212858,212860,0,2,2
60767,6,2,212864,212864,212866,0,2,4
60768,3,1,212867,212867,212868,0,1,1
60769,3,2,212870,212870,212872,0,2,2
60770,1,1,212871,212872,212873,1,2,0
60771,5,2,212876,212876,212878,0,2,3
60772,2,2,212878,212878,212880,0,2,0
60773,1,3,212879,212880,212883,1,4,0
60774,6,3,212885,212885,212888,0,3,2
60775,5,2,212890,212890,212892,0,2,2
60776,1,1,212891,212892,212893,1,2,0
60777,3,1,212894,212894,212895,0,1,1
60778,4,2,212898,212898,212900,0,2,3
60779,5,3,212903,212903,212906,0,3,3
60780,5,2,212908,212908,212910,0,2,2
60781,6,2,212914,212914,212916,0,2,4
60782,6,3,212920,212920,212923,0,3,4
60783,2,1,212922,212923,212924,1,2,0
60784,5,3,212927,212927,212930,0,3,3
60785,5,2,212932,212932,212934,0,2,2
60786,6,2,212938,212938,212940,0,2,4
60787,5,2,212943,212943,212945,0,2,3
60788,3,2,212946,212946,212948,0,2,1
60789,4,1,212950,212950,212951,0,1,2
60790,1,1,212951,212951,212952,0,1,0
60791,1,2,212952,212952,212954,0,2,0
60792,1,1,212953,212954,212955,1,2,0
60793,5,3,212958,212958,212961,0,3,3
60794,3,3,212961,212961,212964,0,3,0
60795,1,3,212962,212964,212967,2,5,0
60796,5,2,212967,212967,212969,0,2,0
60797,1,2,212968,212969,212971,1,3,0
60798,5,1,212973,212973,212974,0,1,2
60799,2,3,212975,212975,212978,0,3,1
60800,4,1,212979,212979,212980,0,1,1
60801,3,3,212982,212982,212985,0,3,2
60802,3,1,212985,212985,212986,0,1,0
60803,5,1,212990,212990,212991,0,1,4
60804,6,2,212996,212996,212998,0,2,5
60805,3,3,212999,212999,213002,0,3,1
60806,4,3,213003,213003,213006,0,3,1
60807,4,3,213007,213007,213010,0,3,1
60808,3,2,213010,213010,213012,0,2,0
60809,1,3,213011,213012,213015,1,4,0
60810,4,1,213015,213015,213016,0,1,0
60811,2,1,213017,213017,213018,0,1,1
60812,3,2,213020,213020,213022,0,2,2
60813,2,3,213022,213022,213025,0,3,0
60814,3,2,213025,213025,213027,0,2,0
60815,5,1,213030,213030,213031,0,1,3
60816,1,3,213031,213031,213034,0,3,0
60817,4,3,213035,213035,213038,0,3,1
60818,6,1,213041,213041,213042,0,1,3
60819,6,3,213047,213047,213050,0,3,5
60820,6,2,213053,213053,213055,0,2,3
60821,4,3,213057,213057,213060,0,3,2
60822,6,3,213063,213063,213066,0,3,3
60823,6,1,213069,213069,213070,0,1,3
60824,3,1,213072,213072,213073,0,1,2
60825,2,1,213074,213074,213075,0,1,1
60826,5,1,213079,213079,213080,0,1,4
60827,3,2,213082,213082,213084,0,2,2
60828,5,3,213087,213087,213090,0,3,3
60829,2,1,213089,213090,213091,1,2,0
60830,6,3,213095,213095,213098,0,3,4
60831,1,3,213096,213098,213101,2,5,0
60832,3,3,213099,213101,213104,2,5,0
60833,2,1,213101,213104,213105,3,4,0
60834,4,1,213105,213105,213106,0,1,0
60835,6,1,213111,213111,213112,0,1,5
60836,5,3,213116,213116,213119,0,3,4
60837,4,3,213120,213120,213123,0,3,1
60838,4,2,213124,213124,213126,0,2,1
60839,6,3,213130,213130,213133,0,3,4
60840,2,1,213132,213133,213134,1,2,0
60841,6,3,213138,213138,213141,0,3,4
60842,1,2,213139,213141,213143,2,4,0
60843,2,1,213141,213143,213144,2,3,0
60844,3,1,213144,213144,213145,0,1,0
60845,1,3,213145,213145,213148,0,3,0
60846,1,2,213146,213148,213150,2,4,0
60847,6,1,213152,213152,213153,0,1,2
60848,2,1,213154,213154,213155,0,1,1
60849,3,1,213157,213157,213158,0,1,2
60850,5,1,213162,213162,213163,0,1,4
60851,2,2,213164,213164,213166,0,2,1
60852,1,3,213165,213166,213169,1,4,0
60853,4,2,213169,213169,213171,0,2,0
60854,3,2,213172,213172,213174,0,2,1
60855,6,3,213178,213178,213181,0,3,4
60856,5,2,213183,213183,213185,0,2,2
60857,6,1,213189,213189,213190,0,1,4
60858,4,2,213193,213193,213195,0,2,3
60859,2,3,213195,213195,213198,0,3,0
60860,1,2,213196,213198,213200,2,4,0
60861,3,3,213199,213200,213203,1,4,0
60862,6,1,213205,213205,213206,0,1,2
60863,3,3,213208,213208,213211,0,3,2
60864,5,3,213213,213213,213216,0,3,2
60865,1,2,213214,213216,213218,2,4,0
60866,6,1,213220,213220,213221,0,1,2
60867,1,3,213221,213221,213224,0,3,0
60868,6,3,213227,213227,213230,0,3,3
60869,4,1,213231,213231,213232,0,1,1
60870,1,2,213232,213232,213234,0,2,0
60871,3,3,213235,213235,213238,0,3,1
60872,4,2,213239,213239,213241,0,2,1
60873,3,3,213242,213242,213245,0,3,1
60874,6,1,213248,213248,213249,0,1,3
60875,4,1,213252,213252,213253,0,1,3
60876,6,2,213258,213258,213260,0,2,5
60877,2,2,213260,213260,213262,0,2,0
60878,6,3,213266,213266,213269,0,3,4
60879,6,1,213272,213272,213273,0,1,3
60880,3,3,213275,213275,213278,0,3,2
60881,3,1,213278,213278,213279,0,1,0
60882,4,2,213282,213282,213284,0,2,3
60883,5,3,213287,213287,213290,0,3,3
60884,4,2,213291,213291,213293,0,2,1
60885,3,1,213294,213294,213295,0,1,1
60886,4,2,213298,213298,213300,0,2,3
60887,6,3,213304,213304,213307,0,3,4
60888,3,3,213307,213307,213310,0,3,0
60889,2,2,213309,213310,213312,1,3,0
60890,1,1,213310,213312,213313,2,3,0
60891,4,2,213314,213314,213316,0,2,1
60892,3,3,213317,213317,213320,0,3,1
60893,3,3,213320,213320,213323,0,3,0
60894,6,3,213326,213326,213329,0,3,3
60895,4,2,213330,213330,213332,0,2,1
60896,6,3,213336,213336,213339,0,3,4
60897,4,2,213340,213340,213342,0,2,1
60898,6,2,213346,213346,213348,0,2,4
60899,6,2,213352,213352,213354,0,2,4
60900,1,1,213353,213354,213355,1,2,0
60901,2,3,213355,213355,213358,0,3,0
60902,2,2,213357,213358,213360,1,3,0
60903,2,1,213359,213360,213361,1,2,0
60904,3,3,213362,213362,213365,0,3,1
60905,5,2,213367,213367,213369,0,2,2
60906,4,3,213371,213371,213374,0,3,2
60907,6,3,213377,213377,213380,0,3,3
60908,5,3,213382,213382,213385,0,3,2
60909,3,2,213385,213385,213387,0,2,0
60910,3,2,213388,213388,213390,0,2,1
60911,6,2,213394,213394,213396,0,2,4
60912,3,1,213397,213397,213398,0,1,1
60913,5,3,213402,213402,213405,0,3,4
60914,3,2,213405,213405,213407,0,2,0
60915,1,3,213406,213407,213410,1,4,0
60916,1,1,213407,213410,213411,3,4,0
60917,2,1,213409,213411,213412,2,3,0
60918,2,3,213411,213412,213415,1,4,0
60919,5,2,213416,213416,213418,0,2,1
60920,2,1,213418,213418,213419,0,1,0
60921,1,1,213419,213419,213420,0,1,0
60922,4,1,213423,213423,213424,0,1,3
60923,1,2,213424,213424,213426,0,2,0
60924,1,1,213425,213426,213427,1,2,0
60925,2,3,213427,213427,213430,0,3,0
60926,6,3,213433,213433,213436,0,3,3
60927,6,2,213439,213439,213441,0,2,3
60928,1,3,213440,213441,213444,1,4,0
60929,1,1,213441,213444,213445,3,4,0
60930,5,3,213446,213446,213449,0,3,1
60931,5,2,213451,213451,213453,0,2,2
60932,4,3,213455,213455,213458,0,3,2
60933,2,2,213457,213458,213460,1,3,0
60934,5,1,213462,213462,213463,0,1,2
60935,1,1,213463,213463,213464,0,1,0
60936,6,3,213469,213469,213472,0,3,5
60937,4,3,213473,213473,213476,0,3,1
60938,5,1,213478,213478,213479,0,1,2
60939,1,2,213479,213479,213481,0,2,0
60940,3,2,213482,213482,213484,0,2,1
60941,5,3,213487,213487,213490,0,3,3
60942,5,2,213492,213492,213494,0,2,2
60943,3,1,213495,213495,213496,0,1,1
60944,5,1,213500,213500,213501,0,1,4
60945,5,3,213505,213505,213508,0,3,4
60946,2,1,213507,213508,213509,1,2,0
60947,2,1,213509,213509,213510,0,1,0
60948,2,3,213511,213511,213514,0,3,1
60949,5,3,213516,213516,213519,0,3,2
60950,2,3,213518,213519,213522,1,4,0
60951,1,2,213519,213522,213524,3,5,0
60952,6,3,213525,213525,213528,0,3,1
60953,4,3,213529,213529,213532,0,3,1
60954,4,2,213533,213533,213535,0,2,1
60955,1,3,213534,213535,213538,1,4,0
60956,2,3,213536,213538,213541,2,5,0
60957,6,3,213542,213542,213545,0,3,1
60958,4,3,213546,213546,213549,0,3,1
60959,2,1,213548,213549,213550,1,2,0
60960,3,2,213551,213551,213553,0,2,1
60961,3,1,213554,213554,213555,0,1,1
60962,3,1,213557,213557,213558,0,1,2
60963,5,3,213562,213562,213565,0,3,4
60964,6,3,213568,213568,213571,0,3,3
60965,2,2,213570,213571,213573,1,3,0
60966,5,2,213575,213575,213577,0,2,2
60967,3,2,213578,213578,213580,0,2,1
60968,1,3,213579,213580,213583,1,4,0
60969,2,3,213581,213583,213586,2,5,0
60970,2,2,213583,213586,213588,3,5,0
60971,3,1,213586,213588,213589,2,3,0
60972,6,1,213592,213592,213593,0,1,3
60973,4,3,213596,213596,213599,0,3,3
60974,2,2,213598,213599,213601,1,3,0
60975,3,3,213601,213601,213604,0,3,0
60976,3,3,213604,213604,213607,0,3,0
60977,3,2,213607,213607,213609,0,2,0
60978,5,1,213612,213612,213613,0,1,3
60979,5,1,213617,213617,213618,0,1,4
60980,3,1,213620,213620,213621,0,1,2
60981,5,1,213625,213625,213626,0,1,4
60982,2,3,213627,213627,213630,0,3,1
60983,2,2,213629,213630,213632,1,3,0
60984,6,3,213635,213635,213638,0,3,3
60985,6,2,213641,213641,213643,0,2,3
60986,4,1,213645,213645,213646,0,1,2
60987,6,2,213651,213651,213653,0,2,5
60988,2,1,213653,213653,213654,0,1,0
60989,2,3,213655,213655,213658,0,3,1
60990,4,3,213659,213659,213662,0,3,1
60991,1,1,213660,213662,213663,2,3,0
60992,1,1,213661,213663,213664,2,3,0
60993,5,3,213666,213666,213669,0,3,2
60994,2,3,213668,213669,213672,1,4,0
60995,1,1,213669,213672,213673,3,4,0
60996,5,1,213674,213674,213675,0,1,1
60997,5,1,213679,213679,213680,0,1,4
60998,3,1,213682,213682,213683,0,1,2
60999,6,3,213688,213688,213691,0,3,5
61000,3,3,213691,213691,213694,0,3,0
61001,4,1,213695,213695,213696,0,1,1
61002,5,1,213700,213700,213701,0,1,4
61003,4,2,213704,213704,213706,0,2,3
61004,1,3,213705,213706,213709,1,4,0
61005,1,3,213706,213709,213712,3,6,0
61006,5,2,213711,213712,213714,1,3,0
61007,5,1,213716,213716,213717,0,1,2
61008,6,2,213722,213722,213724,0,2,5
61009,6,2,213728,213728,213730,0,2,4
61010,2,3,213730,213730,213733,0,3,0
61011,4,2,213734,213734,213736,0,2,1
61012,4,2,213738,213738,213740,0,2,2
61013,4,3,213742,213742,213745,0,3,2
61014,5,2,213747,213747,213749,0,2,2
61015,1,2,213748,213749,213751,1,3,0
61016,3,1,213751,213751,213752,0,1,0
61017,5,2,213756,213756,213758,0,2,4
61018,2,3,213758,213758,213761,0,3,0
61019,4,1,213762,213762,213763,0,1,1
61020,2,2,213764,213764,213766,0,2,1
61021,1,1,213765,213766,213767,1,2,0
61022,4,3,213769,213769,213772,0,3,2
61023,4,2,213773,213773,213775,0,2,1
61024,4,1,213777,213777,213778,0,1,2
61025,4,1,213781,213781,213782,0,1,3
61026,6,2,213787,213787,213789,0,2,5
61027,1,2,213788,213789,213791,1,3,0
61028,2,1,213790,213791,213792,1,2,0
61029,6,2,213796,213796,213798,0,2,4
61030,2,2,213798,213798,213800,0,2,0
61031,6,1,213804,213804,213805,0,1,4
61032,3,2,213807,213807,213809,0,2,2
61033,6,3,213813,213813,213816,0,3,4
61034,3,2,213816,213816,213818,0,2,0
61035,5,3,213821,213821,213824,0,3,3
61036,3,2,213824,213824,213826,0,2,0
61037,1,2,213825,213826,213828,1,3,0
61038,4,1,213829,213829,213830,0,1,1
61039,2,2,213831,213831,213833,0,2,1
61040,5,2,213836,213836,213838,0,2,3
61041,3,2,213839,213839,213841,0,2,1
61042,3,2,213842,213842,213844,0,2,1
61043,5,2,213847,213847,213849,0,2,3
61044,3,1,213850,213850,213851,0,1,1
61045,5,2,213855,213855,213857,0,2,4
61046,2,3,213857,213857,213860,0,3,0
61047,5,3,213862,213862,213865,0,3,2
61048,4,3,213866,213866,213869,0,3,1
61049,1,2,213867,213869,213871,2,4,0
61050,6,3,213873,213873,213876,0,3,2
61051,6,3,213879,213879,213882,0,3,3
61052,5,1,213884,213884,213885,0,1,2
61053,5,2,213889,213889,213891,0,2,4
61054,4,2,213893,213893,213895,0,2,2
61055,6,3,213899,213899,213902,0,3,4
61056,6,2,213905,213905,213907,0,2,3
61057,3,2,213908,213908,213910,0,2,1
61058,1,3,213909,213910,213913,1,4,0
61059,5,1,213914,213914,213915,0,1,1
61060,5,3,213919,213919,213922,0,3,4
61061,2,1,213921,213922,213923,1,2,0
61062,2,3,213923,213923,213926,0,3,0
61063,5,1,213928,213928,213929,0,1,2
61064,5,3,213933,213933,213936,0,3,4
61065,4,1,213937,213937,213938,0,1,1
61066,5,3,213942,213942,213945,0,3,4
61067,5,2,213947,213947,213949,0,2,2
61068,5,2,213952,213952,213954,0,2,3
61069,2,2,213954,213954,213956,0,2,0
61070,1,2,213955,213956,213958,1,3,0
61071,1,3,213956,213958,213961,2,5,0
61072,3,2,213959,213961,213963,2,4,0
61073,3,2,213962,213963,213965,1,3,0
61074,3,2,213965,213965,213967,0,2,0
61075,1,1,213966,213967,213968,1,2,0
61076,3,3,213969,213969,213972,0,3,1
61077,6,1,213975,213975,213976,0,1,3
61078,4,3,213979,213979,213982,0,3,3
61079,6,3,213985,213985,213988,0,3,3
61080,2,2,213987,213988,213990,1,3,0
61081,6,1,213993,213993,213994,0,1,3
61082,2,3,213995,213995,213998,0,3,1
61083,3,2,213998,213998,214000,0,2,0
61084,2,1,214000,214000,214001,0,1,0
61085,1,1,214001,214001,214002,0,1,0
61086,3,2,214004,214004,214006,0,2,2
61087,6,1,214010,214010,214011,0,1,4
61088,2,3,214012,214012,214015,0,3,1
61089,5,2,214017,214017,214019,0,2,2
61090,4,1,214021,214021,214022,0,1,2
61091,6,3,214027,214027,214030,0,3,5
61092,3,3,214030,214030,214033,0,3,0
61093,3,3,214033,214033,214036,0,3,0
61094,3,2,214036,214036,214038,0,2,0
61095,5,3,214041,214041,214044,0,3,3
61096,2,2,214043,214044,214046,1,3,0
61097,5,1,214048,214048,214049,0,1,2
61098,5,3,214053,214053,214056,0,3,4
61099,6,3,214059,214059,214062,0,3,3
61100,3,2,214062,214062,214064,0,2,0
61101,2,1,214064,214064,214065,0,1,0
61102,6,2,214070,214070,214072,0,2,5
61103,5,3,214075,214075,214078,0,3,3
61104,6,2,214081,214081,214083,0,2,3
61105,6,3,214087,214087,214090,0,3,4
61106,2,3,214089,214090,214093,1,4,0
61107,6,1,214095,214095,214096,0,1,2
61108,6,2,214101,214101,214103,0,2,5
61109,2,1,214103,214103,214104,0,1,0
61110,2,2,214105,214105,214107,0,2,1
61111,5,2,214110,214110,214112,0,2,3
61112,3,2,214113,214113,214115,0,2,1
61113,2,1,214115,214115,214116,0,1,0
61114,5,2,214120,214120,214122,0,2,4
61115,6,2,214126,214126,214128,0,2,4
61116,2,3,214128,214128,214131,0,3,0
61117,5,2,214133,214133,214135,0,2,2
61118,3,2,214136,214136,214138,0,2,1
61119,2,3,214138,214138,214141,0,3,0
61120,2,3,214140,214141,214144,1,4,0
61121,6,1,214146,214146,214147,0,1,2
61122,4,1,214150,214150,214151,0,1,3
61123,2,1,214152,214152,214153,0,1,1
61124,6,2,214158,214158,214160,0,2,5
61125,2,2,214160,214160,214162,0,2,0
61126,5,1,214165,214165,214166,0,1,3
61127,2,3,214167,214167,214170,0,3,1
61128,6,3,214173,214173,214176,0,3,3
61129,6,2,214179,214179,214181,0,2,3
61130,5,1,214184,214184,214185,0,1,3
61131,3,3,214187,214187,214190,0,3,2
61132,4,2,214191,214191,214193,0,2,1
61133,6,3,214197,214197,214200,0,3,4
61134,4,3,214201,214201,214204,0,3,1
61135,4,3,214205,214205,214208,0,3,1
61136,6,3,214211,214211,214214,0,3,3
61137,3,2,214214,214214,214216,0,2,0
61138,1,2,214215,214216,214218,1,3,0
61139,1,3,214216,214218,214221,2,5,0
61140,2,2,214218,214221,214223,3,5,0
61141,6,3,214224,214224,214227,0,3,1
61142,1,1,214225,214227,214228,2,3,0
61143,2,1,214227,214228,214229,1,2,0
61144,3,2,214230,214230,214232,0,2,1
61145,6,3,214236,214236,214239,0,3,4
61146,2,1,214238,214239,214240,1,2,0
61147,2,1,214240,214240,214241,0,1,0
61148,2,2,214242,214242,214244,0,2,1
61149,4,2,214246,214246,214248,0,2,2
61150,2,2,214248,214248,214250,0,2,0
61151,3,2,214251,214251,214253,0,2,1
61152,5,1,214256,214256,214257,0,1,3
61153,3,3,214259,214259,214262,0,3,2
61154,5,3,214264,214264,214267,0,3,2
61155,4,1,214268,214268,214269,0,1,1
61156,5,3,214273,214273,214276,0,3,4
61157,1,1,214274,214276,214277,2,3,0
61158,2,2,214276,214277,214279,1,3,0
61159,4,2,214280,214280,214282,0,2,1
61160,6,3,214286,214286,214289,0,3,4
61161,5,2,214291,214291,214293,0,2,2
61162,3,1,214294,214294,214295,0,1,1
61163,5,3,214299,214299,214302,0,3,4
61164,4,1,214303,214303,214304,0,1,1
61165,1,1,214304,214304,214305,0,1,0
61166,4,3,214308,214308,214311,0,3,3
61167,3,2,214311,214311,214313,0,2,0
61168,1,2,214312,214313,214315,1,3,0
61169,2,2,214314,214315,214317,1,3,0
61170,4,1,214318,214318,214319,0,1,1
61171,4,2,214322,214322,214324,0,2,3
61172,2,1,214324,214324,214325,0,1,0
61173,5,3,214329,214329,214332,0,3,4
61174,5,3,214334,214334,214337,0,3,2
61175,2,1,214336,214337,214338,1,2,0
61176,3,2,214339,214339,214341,0,2,1
61177,4,3,214343,214343,214346,0,3,2
61178,3,2,214346,214346,214348,0,2,0
61179,6,3,214352,214352,214355,0,3,4
61180,3,3,214355,214355,214358,0,3,0
61181,6,3,214361,214361,214364,0,3,3
61182,6,1,214367,214367,214368,0,1,3
61183,5,2,214372,214372,214374,0,2,4
61184,3,3,214375,214375,214378,0,3,1
61185,4,1,214379,214379,214380,0,1,1
61186,6,3,214385,214385,214388,0,3,5
61187,1,2,214386,214388,214390,2,4,0
61188,3,3,214389,214390,214393,1,4,0
61189,6,3,214395,214395,214398,0,3,2
61190,2,1,214397,214398,214399,1,2,0
61191,3,2,214400,214400,214402,0,2,1
61192,1,2,214401,214402,214404,1,3,0
61193,5,2,214406,214406,214408,0,2,2
61194,6,2,214412,214412,214414,0,2,4
61195,3,1,214415,214415,214416,0,1,1
61196,3,2,214418,214418,214420,0,2,2
61197,5,3,214423,214423,214426,0,3,3
61198,1,2,214424,214426,214428,2,4,0
61199,4,1,214428,214428,214429,0,1,0
61200,1,1,214429,214429,214430,0,1,0
61201,3,3,214432,214432,214435,0,3,2
61202,4,1,214436,214436,214437,0,1,1
61203,6,3,214442,214442,214445,0,3,5
61204,4,2,214446,214446,214448,0,2,1
61205,3,2,214449,214449,214451,0,2,1
61206,2,3,214451,214451,214454,0,3,0
61207,4,2,214455,214455,214457,0,2,1
61208,2,3,214457,214457,214460,0,3,0
61209,1,1,214458,214460,214461,2,3,0
61210,3,1,214461,214461,214462,0,1,0
61211,5,1,214466,214466,214467,0,1,4
61212,3,1,214469,214469,214470,0,1,2
61213,6,1,214475,214475,214476,0,1,5
61214,5,1,214480,214480,214481,0,1,4
61215,3,2,214483,214483,214485,0,2,2
61216,2,1,214485,214485,214486,0,1,0
61217,5,3,214490,214490,214493,0,3,4
61218,6,3,214496,214496,214499,0,3,3
61219,6,3,214502,214502,214505,0,3,3
61220,3,3,214505,214505,214508,0,3,0
61221,6,1,214511,214511,214512,0,1,3
61222,1,3,214512,214512,214515,0,3,0
61223,5,2,214517,214517,214519,0,2,2
61224,5,2,214522,214522,214524,0,2,3
61225,6,3,214528,214528,214531,0,3,4
61226,3,3,214531,214531,214534,0,3,0
61227,5,3,214536,214536,214539,0,3,2
61228,3,1,214539,214539,214540,0,1,0
61229,4,3,214543,214543,214546,0,3,3
61230,3,3,214546,214546,214549,0,3,0
61231,6,2,214552,214552,214554,0,2,3
61232,4,3,214556,214556,214559,0,3,2
61233,2,2,214558,214559,214561,1,3,0
61234,2,2,214560,214561,214563,1,3,0
61235,2,2,214562,214563,214565,1,3,0
61236,6,1,214568,214568,214569,0,1,3
61237,5,1,214573,214573,214574,0,1,4
61238,5,1,214578,214578,214579,0,1,4
61239,6,1,214584,214584,214585,0,1,5
61240,5,1,214589,214589,214590,0,1,4
61241,3,2,214592,214592,214594,0,2,2
61242,6,2,214598,214598,214600,0,2,4
61243,5,2,214603,214603,214605,0,2,3
61244,1,2,214604,214605,214607,1,3,0
61245,5,2,214609,214609,214611,0,2,2
61246,6,2,214615,214615,214617,0,2,4
61247,6,2,214621,214621,214623,0,2,4
61248,6,3,214627,214627,214630,0,3,4
61249,4,1,214631,214631,214632,0,1,1
61250,6,1,214637,214637,214638,0,1,5
61251,1,1,214638,214638,214639,0,1,0
61252,6,2,214644,214644,214646,0,2,5
61253,3,3,214647,214647,214650,0,3,1
61254,6,2,214653,214653,214655,0,2,3
61255,2,1,214655,214655,214656,0,1,0
61256,2,1,214657,214657,214658,0,1,1
61257,6,2,214663,214663,214665,0,2,5
61258,5,3,214668,214668,214671,0,3,3
61259,6,2,214674,214674,214676,0,2,3
61260,4,2,214678,214678,214680,0,2,2
61261,1,1,214679,214680,214681,1,2,0
61262,2,2,214681,214681,214683,0,2,0
61263,3,3,214684,214684,214687,0,3,1
61264,6,2,214690,214690,214692,0,2,3
61265,4,2,214694,214694,214696,0,2,2
61266,6,3,214700,214700,214703,0,3,4
61267,3,3,214703,214703,214706,0,3,0
61268,6,1,214709,214709,214710,0,1,3
61269,5,3,214714,214714,214717,0,3,4
61270,4,2,214718,214718,214720,0,2,1
61271,2,1,214720,214720,214721,0,1,0
61272,3,1,214723,214723,214724,0,1,2
61273,6,2,214729,214729,214731,0,2,5
61274,5,2,214734,214734,214736,0,2,3
61275,4,3,214738,214738,214741,0,3,2
61276,5,3,214743,214743,214746,0,3,2
61277,6,2,214749,214749,214751,0,2,3
61278,1,2,214750,214751,214753,1,3,0
61279,6,3,214756,214756,214759,0,3,3
61280,6,3,214762,214762,214765,0,3,3
61281,3,3,214765,214765,214768,0,3,0
61282,6,3,214771,214771,214774,0,3,3
61283,3,1,214774,214774,214775,0,1,0
61284,3,3,214777,214777,214780,0,3,2
61285,5,2,214782,214782,214784,0,2,2
61286,2,2,214784,214784,214786,0,2,0
61287,3,2,214787,214787,214789,0,2,1
61288,6,3,214793,214793,214796,0,3,4
61289,2,1,214795,214796,214797,1,2,0
61290,5,3,214800,214800,214803,0,3,3
61291,1,1,214801,214803,214804,2,3,0
61292,4,3,214805,214805,214808,0,3,1
61293,4,1,214809,214809,214810,0,1,1
61294,1,2,214810,214810,214812,0,2,0
61295,5,2,214815,214815,214817,0,2,3
61296,3,3,214818,214818,214821,0,3,1
61297,3,2,214821,214821,214823,0,2,0
61298,6,2,214827,214827,214829,0,2,4
61299,1,1,214828,214829,214830,1,2,0
61300,2,1,214830,214830,214831,0,1,0
61301,2,3,214832,214832,214835,0,3,1
61302,1,2,214833,214835,214837,2,4,0
61303,3,2,214836,214837,214839,1,3,0
61304,2,3,214838,214839,214842,1,4,0
61305,5,3,214843,214843,214846,0,3,1
61306,2,1,214845,214846,214847,1,2,0
61307,4,3,214849,214849,214852,0,3,2
61308,4,1,214853,214853,214854,0,1,1
61309,3,3,214856,214856,214859,0,3,2
61310,4,2,214860,214860,214862,0,2,1
61311,1,1,214861,214862,214863,1,2,0
61312,3,2,214864,214864,214866,0,2,1
61313,6,3,214870,214870,214873,0,3,4
61314,6,1,214876,214876,214877,0,1,3
61315,1,3,214877,214877,214880,0,3,0
61316,5,3,214882,214882,214885,0,3,2
61317,3,3,214885,214885,214888,0,3,0
61318,3,2,214888,214888,214890,0,2,0
61319,2,3,214890,214890,214893,0,3,0
61320,6,1,214896,214896,214897,0,1,3
61321,6,1,214902,214902,214903,0,1,5
61322,2,2,214904,214904,214906,0,2,1
61323,2,1,214906,214906,214907,0,1,0
61324,5,1,214911,214911,214912,0,1,4
61325,6,1,214917,214917,214918,0,1,5
61326,3,2,214920,214920,214922,0,2,2
61327,1,2,214921,214922,214924,1,3,0
61328,5,1,214926,214926,214927,0,1,2
61329,5,1,214931,214931,214932,0,1,4
61330,2,1,214933,214933,214934,0,1,1
61331,5,3,214938,214938,214941,0,3,4
61332,2,1,214940,214941,214942,1,2,0
61333,6,1,214946,214946,214947,0,1,4
61334,4,2,214950,214950,214952,0,2,3
61335,2,3,214952,214952,214955,0,3,0
61336,6,3,214958,214958,214961,0,3,3
61337,3,2,214961,214961,214963,0,2,0
61338,2,3,214963,214963,214966,0,3,0
61339,6,2,214969,214969,214971,0,2,3
61340,1,1,214970,214971,214972,1,2,0
61341,3,3,214973,214973,214976,0,3,1
61342,5,3,214978,214978,214981,0,3,2
61343,6,1,214984,214984,214985,0,1,3
61344,5,3,214989,214989,214992,0,3,4
61345,1,1,214990,214992,214993,2,3,0
61346,2,1,214992,214993,214994,1,2,0
61347,4,3,214996,214996,214999,0,3,2
61348,3,3,214999,214999,215002,0,3,0
61349,5,2,215004,215004,215006,0,2,2
61350,2,2,215006,215006,215008,0,2,0
61351,2,3,215008,215008,215011,0,3,0
61352,6,3,215014,215014,215017,0,3,3
61353,5,3,215019,215019,215022,0,3,2
61354,1,1,215020,215022,215023,2,3,0
61355,6,2,215026,215026,215028,0,2,3
61356,2,2,215028,215028,215030,0,2,0
61357,5,1,215033,215033,215034,0,1,3
61358,6,3,215039,215039,215042,0,3,5
61359,5,2,215044,215044,215046,0,2,2
61360,6,2,215050,215050,215052,0,2,4
61361,6,1,215056,215056,215057,0,1,4
61362,2,3,215058,215058,215061,0,3,1
61363,5,1,215063,215063,215064,0,1,2
61364,5,2,215068,215068,215070,0,2,4
61365,6,2,215074,215074,215076,0,2,4
61366,5,1,215079,215079,215080,0,1,3
61367,5,1,215084,215084,215085,0,1,4
61368,1,1,215085,215085,215086,0,1,0
61369,4,2,215089,215089,215091,0,2,3
61370,4,1,215093,215093,215094,0,1,2
61371,1,2,215094,215094,215096,0,2,0
61372,5,3,215099,215099,215102,0,3,3
61373,1,1,215100,215102,215103,2,3,0
61374,3,1,215103,215103,215104,0,1,0
61375,1,3,215104,215104,215107,0,3,0
61376,1,2,215105,215107,215109,2,4,0
61377,6,2,215111,215111,215113,0,2,2
61378,2,3,215113,215113,215116,0,3,0
61379,2,1,215115,215116,215117,1,2,0
61380,3,1,215118,215118,215119,0,1,1
61381,1,3,215119,215119,215122,0,3,0
61382,1,1,215120,215122,215123,2,3,0
61383,4,2,215124,215124,215126,0,2,1
61384,6,3,215130,215130,215133,0,3,4
61385,5,2,215135,215135,215137,0,2,2
61386,4,1,215139,215139,215140,0,1,2
61387,5,3,215144,215144,215147,0,3,4
61388,3,3,215147,215147,215150,0,3,0
61389,2,1,215149,215150,215151,1,2,0
61390,2,1,215151,215151,215152,0,1,0
61391,4,1,215155,215155,215156,0,1,3
61392,2,3,215157,215157,215160,0,3,1
61393,3,2,215160,215160,215162,0,2,0
61394,1,2,215161,215162,215164,1,3,0
61395,3,1,215164,215164,215165,0,1,0
61396,4,3,215168,215168,215171,0,3,3
61397,1,2,215169,215171,215173,2,4,0
61398,4,1,215173,215173,215174,0,1,0
61399,1,3,215174,215174,215177,0,3,0
61400,1,1,215175,215177,215178,2,3,0
61401,5,1,215180,215180,215181,0,1,2
61402,3,3,215183,215183,215186,0,3,2
61403,4,2,215187,215187,215189,0,2,1
61404,3,1,215190,215190,215191,0,1,1
61405,4,1,215194,215194,215195,0,1,3
61406,6,2,215200,215200,215202,0,2,5
61407,5,2,215205,215205,215207,0,2,3
61408,5,1,215210,215210,215211,0,1,3
61409,3,1,215213,215213,215214,0,1,2
61410,5,1,215218,215218,215219,0,1,4
61411,6,1,215224,215224,215225,0,1,5
61412,3,2,215227,215227,215229,0,2,2
61413,4,1,215231,215231,215232,0,1,2
61414,5,2,215236,215236,215238,0,2,4
61415,6,3,215242,215242,215245,0,3,4
61416,6,3,215248,215248,215251,0,3,3
61417,2,2,215250,215251,215253,1,3,0
61418,2,1,215252,215253,215254,1,2,0
61419,1,1,215253,215254,215255,1,2,0
61420,2,2,215255,215255,215257,0,2,0
61421,2,3,215257,215257,215260,0,3,0
61422,5,3,215262,215262,215265,0,3,2
61423,6,3,215268,215268,215271,0,3,3
61424,5,3,215273,215273,215276,0,3,2
61425,6,1,215279,215279,215280,0,1,3
61426,5,3,215284,215284,215287,0,3,4
61427,2,1,215286,215287,215288,1,2,0
61428,6,2,215292,215292,215294,0,2,4
61429,2,2,215294,215294,215296,0,2,0
61430,1,3,215295,215296,215299,1,4,0
61431,2,2,215297,215299,215301,2,4,0
61432,1,1,215298,215301,215302,3,4,0
61433,1,2,215299,215302,215304,3,5,0
61434,2,3,215301,215304,215307,3,6,0
61435,6,2,215307,215307,215309,0,2,0
61436,1,3,215308,215309,215312,1,4,0
61437,1,3,215309,215312,215315,3,6,0
61438,5,1,215314,215315,215316,1,2,0
61439,1,3,215315,215316,215319,1,4,0
61440,4,1,215319,215319,215320,0,1,0
61441,1,1,215320,215320,215321,0,1,0
61442,4,1,215324,215324,215325,0,1,3
61443,2,3,215326,215326,215329,0,3,1
61444,6,1,215332,215332,215333,0,1,3
61445,3,1,215335,215335,215336,0,1,2
61446,5,3,215340,215340,215343,0,3,4
61447,3,1,215343,215343,215344,0,1,0
61448,4,2,215347,215347,215349,0,2,3
61449,6,3,215353,215353,215356,0,3,4
61450,5,1,215358,215358,215359,0,1,2
61451,3,1,215361,215361,215362,0,1,2
61452,3,2,215364,215364,215366,0,2,2
61453,5,2,215369,215369,215371,0,2,3
61454,2,2,215371,215371,215373,0,2,0
61455,2,2,215373,215373,215375,0,2,0
61456,6,3,215379,215379,215382,0,3,4
61457,6,3,215385,215385,215388,0,3,3
61458,6,3,215391,215391,215394,0,3,3
61459,2,1,215393,215394,215395,1,2,0
61460,6,1,215399,215399,215400,0,1,4
61461,1,2,215400,215400,215402,0,2,0
61462,5,1,215405,215405,215406,0,1,3
61463,5,3,215410,215410,215413,0,3,4
61464,4,2,215414,215414,215416,0,2,1
61465,6,2,215420,215420,215422,0,2,4
61466,2,2,215422,215422,215424,0,2,0
61467,2,2,215424,215424,215426,0,2,0
61468,5,3,215429,215429,215432,0,3,3
61469,5,1,215434,215434,215435,0,1,2
61470,3,1,215437,215437,215438,0,1,2
61471,2,3,215439,215439,215442,0,3,1
61472,1,1,215440,215442,215443,2,3,0
61473,1,3,215441,215443,215446,2,5,0
61474,5,2,215446,215446,215448,0,2,0
61475,1,3,215447,215448,215451,1,4,0
61476,1,3,215448,215451,215454,3,6,0
61477,4,2,215452,215454,215456,2,4,0
61478,3,3,215455,215456,215459,1,4,0
61479,6,1,215461,215461,215462,0,1,2
61480,5,2,215466,215466,215468,0,2,4
61481,1,3,215467,215468,215471,1,4,0
61482,4,1,215471,215471,215472,0,1,0
61483,2,3,215473,215473,215476,0,3,1
61484,6,3,215479,215479,215482,0,3,3
61485,4,3,215483,215483,215486,0,3,1
61486,4,2,215487,215487,215489,0,2,1
61487,4,2,215491,215491,215493,0,2,2
61488,5,3,215496,215496,215499,0,3,3
61489,1,1,215497,215499,215500,2,3,0
61490,2,1,215499,215500,215501,1,2,0
61491,2,3,215501,215501,215504,0,3,0
61492,6,1,215507,215507,215508,0,1,3
61493,6,2,215513,215513,215515,0,2,5
61494,6,2,215519,215519,215521,0,2,4
61495,6,2,215525,215525,215527,0,2,4
61496,2,1,215527,215527,215528,0,1,0
61497,2,2,215529,215529,215531,0,2,1
61498,3,3,215532,215532,215535,0,3,1
61499,5,3,215537,215537,215540,0,3,2
61500,2,3,215539,215540,215543,1,4,0
61501,4,2,215543,215543,215545,0,2,0
61502,4,3,215547,215547,215550,0,3,2
61503,2,2,215549,215550,215552,1,3,0
61504,3,1,215552,215552,215553,0,1,0
61505,5,3,215557,215557,215560,0,3,4
61506,6,3,215563,215563,215566,0,3,3
61507,1,1,215564,215566,215567,2,3,0
61508,3,1,215567,215567,215568,0,1,0
61509,4,2,215571,215571,215573,0,2,3
61510,6,3,215577,215577,215580,0,3,4
61511,2,2,215579,215580,215582,1,3,0
61512,5,1,215584,215584,215585,0,1,2
61513,6,2,215590,215590,215592,0,2,5
61514,1,3,215591,215592,215595,1,4,0
61515,4,1,215595,215595,215596,0,1,0
61516,5,2,215600,215600,215602,0,2,4
61517,2,3,215602,215602,215605,0,3,0
61518,4,2,215606,215606,215608,0,2,1
61519,6,3,215612,215612,215615,0,3,4
61520,2,2,215614,215615,215617,1,3,0
61521,5,2,215619,215619,215621,0,2,2
61522,4,3,215623,215623,215626,0,3,2
61523,1,2,215624,215626,215628,2,4,0
61524,2,1,215626,215628,215629,2,3,0
61525,6,2,215632,215632,215634,0,2,3
61526,3,3,215635,215635,215638,0,3,1
61527,6,3,215641,215641,215644,0,3,3
61528,1,2,215642,215644,215646,2,4,0
61529,4,1,215646,215646,215647,0,1,0
61530,4,2,215650,215650,215652,0,2,3
61531,3,1,215653,215653,215654,0,1,1
61532,1,3,215654,215654,215657,0,3,0
61533,1,2,215655,215657,215659,2,4,0
61534,3,3,215658,215659,215662,1,4,0
61535,5,2,215663,215663,215665,0,2,1
61536,6,2,215669,215669,215671,0,2,4
61537,6,1,215675,215675,215676,0,1,4
61538,2,3,215677,215677,215680,0,3,1
61539,2,2,215679,215680,215682,1,3,0
61540,3,2,215682,215682,215684,0,2,0
61541,3,2,215685,215685,215687,0,2,1
61542,4,1,215689,215689,215690,0,1,2
61543,4,2,215693,215693,215695,0,2,3
61544,1,1,215694,215695,215696,1,2,0
61545,4,3,215698,215698,215701,0,3,2
61546,5,3,215703,215703,215706,0,3,2
61547,2,2,215705,215706,215708,1,3,0
61548,4,1,215709,215709,215710,0,1,1
61549,5,2,215714,215714,215716,0,2,4
61550,4,3,215718,215718,215721,0,3,2
61551,3,1,215721,215721,215722,0,1,0
61552,2,1,215723,215723,215724,0,1,1
61553,5,1,215728,215728,215729,0,1,4
61554,6,3,215734,215734,215737,0,3,5
61555,2,3,215736,215737,215740,1,4,0
61556,1,3,215737,215740,215743,3,6,0
61557,4,3,215741,215743,215746,2,5,0
61558,1,1,215742,215746,215747,4,5,0
61559,5,3,215747,215747,215750,0,3,0
61560,6,3,215753,215753,215756,0,3,3
61561,2,3,215755,215756,215759,1,4,0
61562,2,1,215757,215759,215760,2,3,0
61563,6,3,215763,215763,215766,0,3,3
61564,5,3,215768,215768,215771,0,3,2
61565,4,1,215772,215772,215773,0,1,1
61566,1,1,215773,215773,215774,0,1,0
61567,2,3,215775,215775,215778,0,3,1
61568,6,2,215781,215781,215783,0,2,3
61569,2,2,215783,215783,215785,0,2,0
61570,6,3,215789,215789,215792,0,3,4
61571,5,3,215794,215794,215797,0,3,2
61572,6,3,215800,215800,215803,0,3,3
61573,6,1,215806,215806,215807,0,1,3
61574,1,1,215807,215807,215808,0,1,0
61575,5,2,215812,215812,215814,0,2,4
61576,3,1,215815,215815,215816,0,1,1
61577,4,2,215819,215819,215821,0,2,3
61578,1,2,215820,215821,215823,1,3,0
61579,6,3,215826,215826,215829,0,3,3
61580,6,1,215832,215832,215833,0,1,3
61581,1,2,215833,215833,215835,0,2,0
61582,4,2,215837,215837,215839,0,2,2
61583,2,3,215839,215839,215842,0,3,0
61584,4,1,215843,215843,215844,0,1,1
61585,1,1,215844,215844,215845,0,1,0
61586,5,3,215849,215849,215852,0,3,4
61587,3,2,215852,215852,215854,0,2,0
61588,5,3,215857,215857,215860,0,3,3
61589,3,3,215860,215860,215863,0,3,0
61590,4,2,215864,215864,215866,0,2,1
61591,2,2,215866,215866,215868,0,2,0
61592,1,1,215867,215868,215869,1,2,0
61593,5,3,215872,215872,215875,0,3,3
61594,6,3,215878,215878,215881,0,3,3
61595,3,1,215881,215881,215882,0,1,0
61596,1,1,215882,215882,215883,0,1,0
61597,3,2,215885,215885,215887,0,2,2
61598,1,3,215886,215887,215890,1,4,0
61599,2,2,215888,215890,215892,2,4,0
61600,4,3,215892,215892,215895,0,3,0
61601,3,3,215895,215895,215898,0,3,0
61602,5,3,215900,215900,215903,0,3,2
61603,2,3,215902,215903,215906,1,4,0
61604,5,3,215907,215907,215910,0,3,1
61605,4,3,215911,215911,215914,0,3,1
61606,4,1,215915,215915,215916,0,1,1
61607,5,1,215920,215920,215921,0,1,4
61608,3,1,215923,215923,215924,0,1,2
61609,3,1,215926,215926,215927,0,1,2
61610,3,2,215929,215929,215931,0,2,2
61611,3,1,215932,215932,215933,0,1,1
61612,4,3,215936,215936,215939,0,3,3
61613,4,1,215940,215940,215941,0,1,1
61614,3,2,215943,215943,215945,0,2,2
61615,6,1,215949,215949,215950,0,1,4
61616,1,3,215950,215950,215953,0,3,0
61617,6,2,215956,215956,215958,0,2,3
61618,3,2,215959,215959,215961,0,2,1
61619,1,3,215960,215961,215964,1,4,0
61620,3,3,215963,215964,215967,1,4,0
61621,5,1,215968,215968,215969,0,1,1
61622,4,2,215972,215972,215974,0,2,3
61623,1,3,215973,215974,215977,1,4,0
61624,6,1,215979,215979,215980,0,1,2
61625,6,1,215985,215985,215986,0,1,5
61626,3,3,215988,215988,215991,0,3,2
61627,3,2,215991,215991,215993,0,2,0
61628,4,3,215995,215995,215998,0,3,2
61629,3,3,215998,215998,216001,0,3,0
61630,1,2,215999,216001,216003,2,4,0
61631,3,3,216002,216003,216006,1,4,0
61632,5,1,216007,216007,216008,0,1,1
61633,3,3,216010,216010,216013,0,3,2
61634,6,2,216016,216016,216018,0,2,3
61635,2,1,216018,216018,216019,0,1,0
61636,3,2,216021,216021,216023,0,2,2
61637,6,2,216027,216027,216029,0,2,4
61638,3,1,216030,216030,216031,0,1,1
61639,5,2,216035,216035,216037,0,2,4
61640,3,3,216038,216038,216041,0,3,1
61641,3,2,216041,216041,216043,0,2,0
61642,4,3,216045,216045,216048,0,3,2
61643,3,3,216048,216048,216051,0,3,0
61644,3,3,216051,216051,216054,0,3,0
61645,1,1,216052,216054,216055,2,3,0
61646,1,1,216053,216055,216056,2,3,0
61647,5,2,216058,216058,216060,0,2,2
61648,6,1,216064,216064,216065,0,1,4
61649,1,1,216065,216065,216066,0,1,0
61650,3,1,216068,216068,216069,0,1,2
61651,3,3,216071,216071,216074,0,3,2
61652,6,2,216077,216077,216079,0,2,3
61653,1,2,216078,216079,216081,1,3,0
61654,2,2,216080,216081,216083,1,3,0
61655,2,1,216082,216083,216084,1,2,0
61656,3,2,216085,216085,216087,0,2,1
61657,6,3,216091,216091,216094,0,3,4
61658,2,1,216093,216094,216095,1,2,0
61659,1,2,216094,216095,216097,1,3,0
61660,1,1,216095,216097,216098,2,3,0
61661,5,3,216100,216100,216103,0,3,2
61662,6,1,216106,216106,216107,0,1,3
61663,1,2,216107,216107,216109,0,2,0
61664,4,1,216111,216111,216112,0,1,2
61665,5,2,216116,216116,216118,0,2,4
61666,5,2,216121,216121,216123,0,2,3
61667,3,1,216124,216124,216125,0,1,1
61668,1,1,216125,216125,216126,0,1,0
61669,6,3,216131,216131,216134,0,3,5
61670,3,2,216134,216134,216136,0,2,0
61671,6,3,216140,216140,216143,0,3,4
61672,2,1,216142,216143,216144,1,2,0
61673,1,2,216143,216144,216146,1,3,0
61674,2,3,216145,216146,216149,1,4,0
61675,5,3,216150,216150,216153,0,3,1
61676,2,1,216152,216153,216154,1,2,0
61677,5,3,216157,216157,216160,0,3,3
61678,4,2,216161,216161,216163,0,2,1
61679,2,2,216163,216163,216165,0,2,0
61680,6,3,216169,216169,216172,0,3,4
61681,2,3,216171,216172,216175,1,4,0
61682,4,2,216175,216175,216177,0,2,0
61683,5,3,216180,216180,216183,0,3,3
61684,1,1,216181,216183,216184,2,3,0
61685,2,2,216183,216184,216186,1,3,0
61686,2,2,216185,216186,216188,1,3,0
61687,6,2,216191,216191,216193,0,2,3
61688,4,2,216195,216195,216197,0,2,2
61689,4,1,216199,216199,216200,0,1,2
61690,3,1,216202,216202,216203,0,1,2
61691,3,2,216205,216205,216207,0,2,2
61692,1,3,216206,216207,216210,1,4,0
61693,5,3,216211,216211,216214,0,3,1
61694,1,1,216212,216214,216215,2,3,0
61695,3,3,216215,216215,216218,0,3,0
61696,3,2,216218,216218,216220,0,2,0
61697,4,3,216222,216222,216225,0,3,2
61698,1,1,216223,216225,216226,2,3,0
61699,6,3,216229,216229,216232,0,3,3
61700,1,3,216230,216232,216235,2,5,0
61701,2,2,216232,216235,216237,3,5,0
61702,3,2,216235,216237,216239,2,4,0
61703,5,3,216240,216240,216243,0,3,1
61704,5,3,216245,216245,216248,0,3,2
61705,6,3,216251,216251,216254,0,3,3
61706,4,2,216255,216255,216257,0,2,1
61707,1,3,216256,216257,216260,1,4,0
61708,1,2,216257,216260,216262,3,5,0
61709,4,2,216261,216262,216264,1,3,0
61710,3,1,216264,216264,216265,0,1,0
61711,2,2,216266,216266,216268,0,2,1
61712,4,2,216270,216270,216272,0,2,2
61713,5,2,216275,216275,216277,0,2,3
61714,1,3,216276,216277,216280,1,4,0
61715,1,3,216277,216280,216283,3,6,0
61716,6,2,216283,216283,216285,0,2,0
61717,1,3,216284,216285,216288,1,4,0
61718,2,1,216286,216288,216289,2,3,0
61719,2,3,216288,216289,216292,1,4,0
61720,4,2,216292,216292,216294,0,2,0
61721,6,1,216298,216298,216299,0,1,4
61722,3,3,216301,216301,216304,0,3,2
61723,6,3,216307,216307,216310,0,3,3
61724,1,3,216308,216310,216313,2,5,0
61725,1,2,216309,216313,216315,4,6,0
61726,3,2,216312,216315,216317,3,5,0
61727,2,3,216314,216317,216320,3,6,0
61728,2,3,216316,216320,216323,4,7,0
61729,3,3,216319,216323,216326,4,7,0
61730,3,2,216322,216326,216328,4,6,0
61731,6,3,216328,216328,216331,0,3,0
61732,4,2,216332,216332,216334,0,2,1
61733,2,3,216334,216334,216337,0,3,0
61734,4,2,216338,216338,216340,0,2,1
61735,1,3,216339,216340,216343,1,4,0
61736,1,3,216340,216343,216346,3,6,0
61737,3,2,216343,216346,216348,3,5,0
61738,3,1,216346,216348,216349,2,3,0
61739,4,1,216350,216350,216351,0,1,1
61740,5,1,216355,216355,216356,0,1,4
61741,6,2,216361,216361,216363,0,2,5
61742,2,2,216363,216363,216365,0,2,0
61743,1,1,216364,216365,216366,1,2,0
61744,5,2,216369,216369,216371,0,2,3
61745,5,3,216374,216374,216377,0,3,3
61746,1,1,216375,216377,216378,2,3,0
61747,6,3,216381,216381,216384,0,3,3
61748,4,1,216385,216385,216386,0,1,1
61749,3,1,216388,216388,216389,0,1,2
61750,4,3,216392,216392,216395,0,3,3
61751,4,2,216396,216396,216398,0,2,1
61752,2,2,216398,216398,216400,0,2,0
61753,5,3,216403,216403,216406,0,3,3
61754,5,1,216408,216408,216409,0,1,2
61755,6,1,216414,216414,216415,0,1,5
61756,6,3,216420,216420,216423,0,3,5
61757,2,2,216422,216423,216425,1,3,0
61758,3,3,216425,216425,216428,0,3,0
61759,6,1,216431,216431,216432,0,1,3
61760,3,1,216434,216434,216435,0,1,2
61761,3,2,216437,216437,216439,0,2,2
61762,3,3,216440,216440,216443,0,3,1
61763,3,1,216443,216443,216444,0,1,0
61764,4,3,216447,216447,216450,0,3,3
61765,2,3,216449,216450,216453,1,4,0
61766,1,1,216450,216453,216454,3,4,0
61767,4,1,216454,216454,216455,0,1,0
61768,6,1,216460,216460,216461,0,1,5
61769,3,2,216463,216463,216465,0,2,2
61770,4,2,216467,216467,216469,0,2,2
61771,4,2,216471,216471,216473,0,2,2
61772,4,2,216475,216475,216477,0,2,2
61773,3,2,216478,216478,216480,0,2,1
61774,6,1,216484,216484,216485,0,1,4
61775,1,3,216485,216485,216488,0,3,0
61776,2,2,216487,216488,216490,1,3,0
61777,5,2,216492,216492,216494,0,2,2
61778,2,2,216494,216494,216496,0,2,0
61779,5,1,216499,216499,216500,0,1,3
61780,3,3,216502,216502,216505,0,3,2
61781,1,1,216503,216505,216506,2,3,0
61782,3,2,216506,216506,216508,0,2,0
61783,5,2,216511,216511,216513,0,2,3
61784,5,2,216516,216516,216518,0,2,3
61785,4,3,216520,216520,216523,0,3,2
61786,6,3,216526,216526,216529,0,3,3
61787,6,2,216532,216532,216534,0,2,3
61788,3,1,216535,216535,216536,0,1,1
61789,1,3,216536,216536,216539,0,3,0
61790,5,1,216541,216541,216542,0,1,2
61791,5,1,216546,216546,216547,0,1,4
61792,2,1,216548,216548,216549,0,1,1
61793,6,1,216554,216554,216555,0,1,5
61794,2,3,216556,216556,216559,0,3,1
61795,1,3,216557,216559,216562,2,5,0
61796,5,1,216562,216562,216563,0,1,0
61797,4,1,216566,216566,216567,0,1,3
61798,1,1,216567,216567,216568,0,1,0
61799,2,3,216569,216569,216572,0,3,1
61800,5,1,216574,216574,216575,0,1,2
61801,2,2,216576,216576,216578,0,2,1
61802,1,3,216577,216578,216581,1,4,0
61803,4,3,216581,216581,216584,0,3,0
61804,3,1,216584,216584,216585,0,1,0
61805,4,3,216588,216588,216591,0,3,3
61806,4,2,216592,216592,216594,0,2,1
61807,1,2,216593,216594,216596,1,3,0
61808,3,1,216596,216596,216597,0,1,0
61809,3,2,216599,216599,216601,0,2,2
61810,3,1,216602,216602,216603,0,1,1
61811,4,1,216606,216606,216607,0,1,3
61812,3,1,216609,216609,216610,0,1,2
61813,5,2,216614,216614,216616,0,2,4
61814,3,3,216617,216617,216620,0,3,1
61815,6,3,216623,216623,216626,0,3,3
61816,2,2,216625,216626,216628,1,3,0
61817,2,3,216627,216628,216631,1,4,0
61818,6,2,216633,216633,216635,0,2,2
61819,5,2,216638,216638,216640,0,2,3
61820,1,3,216639,216640,216643,1,4,0
61821,1,1,216640,216643,216644,3,4,0
61822,5,1,216645,216645,216646,0,1,1
61823,5,1,216650,216650,216651,0,1,4
61824,4,3,216654,216654,216657,0,3,3
61825,6,2,216660,216660,216662,0,2,3
61826,4,3,216664,216664,216667,0,3,2
61827,3,3,216667,216667,216670,0,3,0
61828,6,1,216673,216673,216674,0,1,3
61829,2,3,216675,216675,216678,0,3,1
61830,1,2,216676,216678,216680,2,4,0
61831,3,3,216679,216680,216683,1,4,0
61832,5,3,216684,216684,216687,0,3,1
61833,4,3,216688,216688,216691,0,3,1
61834,2,3,216690,216691,216694,1,4,0
61835,3,1,216693,216694,216695,1,2,0
61836,5,3,216698,216698,216701,0,3,3
61837,4,1,216702,216702,216703,0,1,1
61838,5,3,216707,216707,216710,0,3,4
61839,4,1,216711,216711,216712,0,1,1
61840,3,2,216714,216714,216716,0,2,2
61841,5,3,216719,216719,216722,0,3,3
61842,6,3,216725,216725,216728,0,3,3
61843,4,1,216729,216729,216730,0,1,1
61844,2,1,216731,216731,216732,0,1,1
61845,3,3,216734,216734,216737,0,3,2
61846,1,1,216735,216737,216738,2,3,0
61847,3,1,216738,216738,216739,0,1,0
61848,3,2,216741,216741,216743,0,2,2
61849,5,1,216746,216746,216747,0,1,3
61850,4,2,216750,216750,216752,0,2,3
61851,3,1,216753,216753,216754,0,1,1
61852,6,2,216759,216759,216761,0,2,5
61853,3,2,216762,216762,216764,0,2,1
61854,2,3,216764,216764,216767,0,3,0
61855,6,3,216770,216770,216773,0,3,3
61856,4,3,216774,216774,216777,0,3,1
61857,2,1,216776,216777,216778,1,2,0
61858,1,3,216777,216778,216781,1,4,0
61859,2,3,216779,216781,216784,2,5,0
61860,4,1,216783,216784,216785,1,2,0
61861,1,1,216784,216785,216786,1,2,0
61862,3,1,216787,216787,216788,0,1,1
61863,6,2,216793,216793,216795,0,2,5
61864,5,2,216798,216798,216800,0,2,3
61865,1,1,216799,216800,216801,1,2,0
61866,4,1,216803,216803,216804,0,1,2
61867,2,2,216805,216805,216807,0,2,1
61868,1,1,216806,216807,216808,1,2,0
61869,4,1,216810,216810,216811,0,1,2
61870,1,2,216811,216811,216813,0,2,0
61871,2,1,216813,216813,216814,0,1,0
61872,1,3,216814,216814,216817,0,3,0
61873,4,3,216818,216818,216821,0,3,1
61874,5,2,216823,216823,216825,0,2,2
61875,5,1,216828,216828,216829,0,1,3
61876,4,2,216832,216832,216834,0,2,3
61877,1,2,216833,216834,216836,1,3,0
61878,4,2,216837,216837,216839,0,2,1
61879,3,2,216840,216840,216842,0,2,1
61880,4,1,216844,216844,216845,0,1,2
61881,1,1,216845,216845,216846,0,1,0
61882,1,3,216846,216846,216849,0,3,0
61883,4,2,216850,216850,216852,0,2,1
61884,2,2,216852,216852,216854,0,2,0
61885,6,3,216858,216858,216861,0,3,4
61886,4,3,216862,216862,216865,0,3,1
61887,6,1,216868,216868,216869,0,1,3
61888,2,3,216870,216870,216873,0,3,1
61889,4,1,216874,216874,216875,0,1,1
61890,5,3,216879,216879,216882,0,3,4
61891,6,2,216885,216885,216887,0,2,3
61892,4,2,216889,216889,216891,0,2,2
61893,4,2,216893,216893,216895,0,2,2
61894,2,2,216895,216895,216897,0,2,0
61895,3,2,216898,216898,216900,0,2,1
61896,6,1,216904,216904,216905,0,1,4
61897,2,2,216906,216906,216908,0,2,1
61898,2,1,216908,216908,216909,0,1,0
61899,6,1,216914,216914,216915,0,1,5
61900,4,2,216918,216918,216920,0,2,3
61901,6,2,216924,216924,216926,0,2,4
61902,1,2,216925,216926,216928,1,3,0
61903,4,2,216929,216929,216931,0,2,1
61904,6,1,216935,216935,216936,0,1,4
61905,2,3,216937,216937,216940,0,3,1
61906,5,1,216942,216942,216943,0,1,2
61907,1,1,216943,216943,216944,0,1,0
61908,4,1,216947,216947,216948,0,1,3
61909,2,2,216949,216949,216951,0,2,1
61910,5,2,216954,216954,216956,0,2,3
61911,5,3,216959,216959,216962,0,3,3
61912,3,2,216962,216962,216964,0,2,0
61913,2,3,216964,216964,216967,0,3,0
61914,4,1,216968,216968,216969,0,1,1
61915,3,2,216971,216971,216973,0,2,2
61916,2,1,216973,216973,216974,0,1,0
61917,4,3,216977,216977,216980,0,3,3
61918,6,1,216983,216983,216984,0,1,3
61919,5,2,216988,216988,216990,0,2,4
61920,1,1,216989,216990,216991,1,2,0
61921,2,3,216991,216991,216994,0,3,0
61922,5,2,216996,216996,216998,0,2,2
61923,4,1,217000,217000,217001,0,1,2
61924,3,3,217003,217003,217006,0,3,2
61925,2,3,217005,217006,217009,1,4,0
61926,5,3,217010,217010,217013,0,3,1
61927,2,2,217012,217013,217015,1,3,0
61928,4,1,217016,217016,217017,0,1,1
61929,2,1,217018,217018,217019,0,1,1
61930,4,3,217022,217022,217025,0,3,3
61931,1,2,217023,217025,217027,2,4,0
61932,1,3,217024,217027,217030,3,6,0
61933,4,1,217028,217030,217031,2,3,0
61934,5,1,217033,217033,217034,0,1,2
61935,1,3,217034,217034,217037,0,3,0
61936,2,1,217036,217037,217038,1,2,0
61937,5,1,217041,217041,217042,0,1,3
61938,2,1,217043,217043,217044,0,1,1
61939,5,2,217048,217048,217050,0,2,4
61940,2,3,217050,217050,217053,0,3,0
61941,3,1,217053,217053,217054,0,1,0
61942,3,1,217056,217056,217057,0,1,2
61943,1,2,217057,217057,217059,0,2,0
61944,1,2,217058,217059,217061,1,3,0
61945,1,2,217059,217061,217063,2,4,0
61946,3,3,217062,217063,217066,1,4,0
61947,5,2,217067,217067,217069,0,2,1
61948,3,3,217070,217070,217073,0,3,1
61949,4,3,217074,217074,217077,0,3,1
61950,5,3,217079,217079,217082,0,3,2
61951,4,1,217083,217083,217084,0,1,1
61952,3,3,217086,217086,217089,0,3,2
61953,1,1,217087,217089,217090,2,3,0
61954,3,1,217090,217090,217091,0,1,0
61955,6,3,217096,217096,217099,0,3,5
61956,5,1,217101,217101,217102,0,1,2
61957,5,3,217106,217106,217109,0,3,4
61958,5,2,217111,217111,217113,0,2,2
61959,4,3,217115,217115,217118,0,3,2
61960,2,1,217117,217118,217119,1,2,0
61961,4,2,217121,217121,217123,0,2,2
61962,6,1,217127,217127,217128,0,1,4
61963,6,1,217133,217133,217134,0,1,5
61964,4,3,217137,217137,217140,0,3,3
61965,1,2,217138,217140,217142,2,4,0
61966,3,1,217141,217142,217143,1,2,0
61967,4,3,217145,217145,217148,0,3,2
61968,2,1,217147,217148,217149,1,2,0
61969,1,2,217148,217149,217151,1,3,0
61970,3,1,217151,217151,217152,0,1,0
61971,4,3,217155,217155,217158,0,3,3
61972,4,2,217159,217159,217161,0,2,1
61973,6,1,217165,217165,217166,0,1,4
61974,6,2,217171,217171,217173,0,2,5
61975,5,2,217176,217176,217178,0,2,3
61976,6,3,217182,217182,217185,0,3,4
61977,2,3,217184,217185,217188,1,4,0
61978,5,2,217189,217189,217191,0,2,1
61979,4,3,217193,217193,217196,0,3,2
61980,1,1,217194,217196,217197,2,3,0
61981,5,1,217199,217199,217200,0,1,2
61982,2,1,217201,217201,217202,0,1,1
61983,1,2,217202,217202,217204,0,2,0
61984,5,2,217207,217207,217209,0,2,3
61985,3,2,217210,217210,217212,0,2,1
61986,3,2,217213,217213,217215,0,2,1
61987,6,3,217219,217219,217222,0,3,4
61988,4,1,217223,217223,217224,0,1,1
61989,6,2,217229,217229,217231,0,2,5
61990,4,3,217233,217233,217236,0,3,2
61991,4,2,217237,217237,217239,0,2,1
61992,6,2,217243,217243,217245,0,2,4
61993,6,1,217249,217249,217250,0,1,4
61994,5,3,217254,217254,217257,0,3,4
61995,4,2,217258,217258,217260,0,2,1
61996,2,3,217260,217260,217263,0,3,0
61997,2,1,217262,217263,217264,1,2,0
61998,5,2,217267,217267,217269,0,2,3
61999,6,3,217273,217273,217276,0,3,4
62000,4,3,217277,217277,217280,0,3,1
62001,3,1,217280,217280,217281,0,1,0
62002,1,1,217281,217281,217282,0,1,0
62003,2,1,217283,217283,217284,0,1,1
62004,3,1,217286,217286,217287,0,1,2
62005,5,1,217291,217291,217292,0,1,4
62006,3,3,217294,217294,217297,0,3,2
62007,6,2,217300,217300,217302,0,2,3
62008,1,2,217301,217302,217304,1,3,0
62009,6,1,217307,217307,217308,0,1,3
62010,1,1,217308,217308,217309,0,1,0
62011,6,3,217314,217314,217317,0,3,5
62012,6,2,217320,217320,217322,0,2,3
62013,2,3,217322,217322,217325,0,3,0
62014,6,3,217328,217328,217331,0,3,3
62015,3,2,217331,217331,217333,0,2,0
62016,5,3,217336,217336,217339,0,3,3
62017,2,2,217338,217339,217341,1,3,0
62018,5,1,217343,217343,217344,0,1,2
62019,4,3,217347,217347,217350,0,3,3
62020,1,1,217348,217350,217351,2,3,0
62021,6,1,217354,217354,217355,0,1,3
62022,2,3,217356,217356,217359,0,3,1
62023,1,2,217357,217359,217361,2,4,0
62024,2,2,217359,217361,217363,2,4,0
62025,3,1,217362,217363,217364,1,2,0
62026,3,2,217365,217365,217367,0,2,1
62027,3,1,217368,217368,217369,0,1,1
62028,5,3,217373,217373,217376,0,3,4
62029,1,3,217374,217376,217379,2,5,0
62030,2,1,217376,217379,217380,3,4,0
62031,4,1,217380,217380,217381,0,1,0
62032,5,1,217385,217385,217386,0,1,4
62033,2,1,217387,217387,217388,0,1,1
62034,3,2,217390,217390,217392,0,2,2
62035,5,2,217395,217395,217397,0,2,3
62036,5,3,217400,217400,217403,0,3,3
62037,1,2,217401,217403,217405,2,4,0
62038,3,2,217404,217405,217407,1,3,0
62039,5,1,217409,217409,217410,0,1,2
62040,6,3,217415,217415,217418,0,3,5
62041,6,2,217421,217421,217423,0,2,3
62042,2,3,217423,217423,217426,0,3,0
62043,3,3,217426,217426,217429,0,3,0
62044,3,3,217429,217429,217432,0,3,0
62045,2,1,217431,217432,217433,1,2,0
62046,6,2,217437,217437,217439,0,2,4
62047,4,2,217441,217441,217443,0,2,2
62048,6,2,217447,217447,217449,0,2,4
62049,2,2,217449,217449,217451,0,2,0
62050,5,2,217454,217454,217456,0,2,3
62051,3,3,217457,217457,217460,0,3,1
62052,5,3,217462,217462,217465,0,3,2
62053,4,1,217466,217466,217467,0,1,1
62054,1,3,217467,217467,217470,0,3,0
62055,5,2,217472,217472,217474,0,2,2
62056,4,3,217476,217476,217479,0,3,2
62057,4,2,217480,217480,217482,0,2,1
62058,5,2,217485,217485,217487,0,2,3
62059,1,3,217486,217487,217490,1,4,0
62060,3,1,217489,217490,217491,1,2,0
62061,3,3,217492,217492,217495,0,3,1
62062,6,3,217498,217498,217501,0,3,3
62063,5,2,217503,217503,217505,0,2,2
62064,5,2,217508,217508,217510,0,2,3
62065,3,3,217511,217511,217514,0,3,1
62066,4,3,217515,217515,217518,0,3,1
62067,2,1,217517,217518,217519,1,2,0
62068,5,3,217522,217522,217525,0,3,3
62069,1,1,217523,217525,217526,2,3,0
62070,5,3,217528,217528,217531,0,3,2
62071,2,1,217530,217531,217532,1,2,0
62072,6,2,217536,217536,217538,0,2,4
62073,1,3,217537,217538,217541,1,4,0
62074,6,1,217543,217543,217544,0,1,2
62075,2,3,217545,217545,217548,0,3,1
62076,5,2,217550,217550,217552,0,2,2
62077,6,3,217556,217556,217559,0,3,4
62078,2,2,217558,217559,217561,1,3,0
62079,5,1,217563,217563,217564,0,1,2
62080,5,1,217568,217568,217569,0,1,4
62081,1,1,217569,217569,217570,0,1,0
62082,6,3,217575,217575,217578,0,3,5
62083,6,3,217581,217581,217584,0,3,3
62084,6,3,217587,217587,217590,0,3,3
62085,5,3,217592,217592,217595,0,3,2
62086,6,2,217598,217598,217600,0,2,3
62087,5,1,217603,217603,217604,0,1,3
62088,4,1,217607,217607,217608,0,1,3
62089,1,1,217608,217608,217609,0,1,0
62090,1,2,217609,217609,217611,0,2,0
62091,4,3,217613,217613,217616,0,3,2
62092,5,3,217618,217618,217621,0,3,2
62093,5,1,217623,217623,217624,0,1,2
62094,2,2,217625,217625,217627,0,2,1
62095,5,1,217630,217630,217631,0,1,3
62096,2,2,217632,217632,217634,0,2,1
62097,3,2,217635,217635,217637,0,2,1
62098,1,3,217636,217637,217640,1,4,0
62099,6,3,217642,217642,217645,0,3,2
62100,5,2,217647,217647,217649,0,2,2
62101,4,1,217651,217651,217652,0,1,2
62102,5,2,217656,217656,217658,0,2,4
62103,5,2,217661,217661,217663,0,2,3
62104,4,3,217665,217665,217668,0,3,2
62105,2,3,217667,217668,217671,1,4,0
62106,3,3,217670,217671,217674,1,4,0
62107,5,1,217675,217675,217676,0,1,1
62108,5,2,217680,217680,217682,0,2,4
62109,3,3,217683,217683,217686,0,3,1
62110,6,1,217689,217689,217690,0,1,3
62111,2,1,217691,217691,217692,0,1,1
62112,4,3,217695,217695,217698,0,3,3
62113,5,3,217700,217700,217703,0,3,2
62114,5,2,217705,217705,217707,0,2,2
62115,3,1,217708,217708,217709,0,1,1
62116,3,3,217711,217711,217714,0,3,2
62117,3,1,217714,217714,217715,0,1,0
62118,4,1,217718,217718,217719,0,1,3
62119,1,1,217719,217719,217720,0,1,0
62120,3,3,217722,217722,217725,0,3,2
62121,6,3,217728,217728,217731,0,3,3
62122,4,2,217732,217732,217734,0,2,1
62123,4,1,217736,217736,217737,0,1,2
62124,1,1,217737,217737,217738,0,1,0
62125,2,3,217739,217739,217742,0,3,1
62126,1,1,217740,217742,217743,2,3,0
62127,1,2,217741,217743,217745,2,4,0
62128,1,2,217742,217745,217747,3,5,0
62129,4,3,217746,217747,217750,1,4,0
62130,3,3,217749,217750,217753,1,4,0
62131,2,1,217751,217753,217754,2,3,0
62132,4,3,217755,217755,217758,0,3,1
62133,6,3,217761,217761,217764,0,3,3
62134,4,2,217765,217765,217767,0,2,1
62135,1,1,217766,217767,217768,1,2,0
62136,1,1,217767,217768,217769,1,2,0
62137,6,2,217773,217773,217775,0,2,4
62138,5,3,217778,217778,217781,0,3,3
62139,2,2,217780,217781,217783,1,3,0
62140,5,3,217785,217785,217788,0,3,2
62141,1,3,217786,217788,217791,2,5,0
62142,4,1,217790,217791,217792,1,2,0
62143,2,1,217792,217792,217793,0,1,0
62144,1,3,217793,217793,217796,0,3,0
62145,4,2,217797,217797,217799,0,2,1
62146,4,1,217801,217801,217802,0,1,2
62147,5,2,217806,217806,217808,0,2,4
62148,1,1,217807,217808,217809,1,2,0
62149,6,3,217813,217813,217816,0,3,4
62150,1,1,217814,217816,217817,2,3,0
62151,2,1,217816,217817,217818,1,2,0
62152,5,2,217821,217821,217823,0,2,3
62153,5,1,217826,217826,217827,0,1,3
62154,4,2,217830,217830,217832,0,2,3
62155,2,3,217832,217832,217835,0,3,0
62156,2,1,217834,217835,217836,1,2,0
62157,3,2,217837,217837,217839,0,2,1
62158,4,3,217841,217841,217844,0,3,2
62159,1,3,217842,217844,217847,2,5,0
62160,6,1,217848,217848,217849,0,1,1
62161,1,3,217849,217849,217852,0,3,0
62162,4,1,217853,217853,217854,0,1,1
62163,1,3,217854,217854,217857,0,3,0
62164,1,1,217855,217857,217858,2,3,0
62165,6,3,217861,217861,217864,0,3,3
62166,2,1,217863,217864,217865,1,2,0
62167,2,1,217865,217865,217866,0,1,0
62168,3,1,217868,217868,217869,0,1,2
62169,3,1,217871,217871,217872,0,1,2
62170,1,2,217872,217872,217874,0,2,0
62171,4,2,217876,217876,217878,0,2,2
62172,1,1,217877,217878,217879,1,2,0
62173,6,1,217883,217883,217884,0,1,4
62174,5,3,217888,217888,217891,0,3,4
62175,6,3,217894,217894,217897,0,3,3
62176,2,3,217896,217897,217900,1,4,0
62177,1,2,217897,217900,217902,3,5,0
62178,4,2,217901,217902,217904,1,3,0
62179,2,2,217903,217904,217906,1,3,0
62180,6,3,217909,217909,217912,0,3,3
62181,4,3,217913,217913,217916,0,3,1
62182,4,1,217917,217917,217918,0,1,1
62183,6,1,217923,217923,217924,0,1,5
62184,4,1,217927,217927,217928,0,1,3
62185,6,3,217933,217933,217936,0,3,5
62186,4,3,217937,217937,217940,0,3,1
62187,6,2,217943,217943,217945,0,2,3
62188,5,3,217948,217948,217951,0,3,3
62189,6,3,217954,217954,217957,0,3,3
62190,2,2,217956,217957,217959,1,3,0
62191,5,3,217961,217961,217964,0,3,2
62192,5,3,217966,217966,217969,0,3,2
62193,2,3,217968,217969,217972,1,4,0
62194,1,1,217969,217972,217973,3,4,0
62195,5,2,217974,217974,217976,0,2,1
62196,2,3,217976,217976,217979,0,3,0
62197,1,1,217977,217979,217980,2,3,0
62198,4,3,217981,217981,217984,0,3,1
62199,2,2,217983,217984,217986,1,3,0
62200,4,2,217987,217987,217989,0,2,1
62201,3,1,217990,217990,217991,0,1,1
62202,5,3,217995,217995,217998,0,3,4
62203,4,3,217999,217999,218002,0,3,1
62204,6,3,218005,218005,218008,0,3,3
62205,1,2,218006,218008,218010,2,4,0
62206,4,3,218010,218010,218013,0,3,0
62207,5,3,218015,218015,218018,0,3,2
62208,1,1,218016,218018,218019,2,3,0
62209,4,1,218020,218020,218021,0,1,1
62210,1,3,218021,218021,218024,0,3,0
62211,6,2,218027,218027,218029,0,2,3
62212,1,3,218028,218029,218032,1,4,0
62213,4,1,218032,218032,218033,0,1,0
62214,1,1,218033,218033,218034,0,1,0
62215,2,2,218035,218035,218037,0,2,1
62216,1,2,218036,218037,218039,1,3,0
62217,5,2,218041,218041,218043,0,2,2
62218,1,2,218042,218043,218045,1,3,0
62219,3,3,218045,218045,218048,0,3,0
62220,1,2,218046,218048,218050,2,4,0
62221,6,2,218052,218052,218054,0,2,2
62222,4,3,218056,218056,218059,0,3,2
62223,2,1,218058,218059,218060,1,2,0
62224,2,1,218060,218060,218061,0,1,0
62225,2,2,218062,218062,218064,0,2,1
62226,6,3,218068,218068,218071,0,3,4
62227,3,3,218071,218071,218074,0,3,0
62228,6,1,218077,218077,218078,0,1,3
62229,4,3,218081,218081,218084,0,3,3
62230,5,1,218086,218086,218087,0,1,2
62231,3,2,218089,218089,218091,0,2,2
62232,3,1,218092,218092,218093,0,1,1
62233,6,3,218098,218098,218101,0,3,5
62234,1,3,218099,218101,218104,2,5,0
62235,3,3,218102,218104,218107,2,5,0
62236,3,1,218105,218107,218108,2,3,0
62237,4,1,218109,218109,218110,0,1,1
62238,5,2,218114,218114,218116,0,2,4
62239,1,3,218115,218116,218119,1,4,0
62240,1,2,218116,218119,218121,3,5,0
62241,3,3,218119,218121,218124,2,5,0
62242,4,3,218123,218124,218127,1,4,0
62243,4,3,218127,218127,218130,0,3,0
62244,4,2,218131,218131,218133,0,2,1
62245,3,2,218134,218134,218136,0,2,1
62246,1,3,218135,218136,218139,1,4,0
62247,4,3,218139,218139,218142,0,3,0
62248,6,2,218145,218145,218147,0,2,3
62249,3,1,218148,218148,218149,0,1,1
62250,2,3,218150,218150,218153,0,3,1
62251,5,1,218155,218155,218156,0,1,2
62252,5,2,218160,218160,218162,0,2,4
62253,4,1,218164,218164,218165,0,1,2
62254,4,2,218168,218168,218170,0,2,3
62255,1,1,218169,218170,218171,1,2,0
62256,2,3,218171,218171,218174,0,3,0
62257,5,1,218176,218176,218177,0,1,2
62258,5,1,218181,218181,218182,0,1,4
62259,1,2,218182,218182,218184,0,2,0
62260,2,1,218184,218184,218185,0,1,0
62261,4,3,218188,218188,218191,0,3,3
62262,2,2,218190,218191,218193,1,3,0
62263,3,1,218193,218193,218194,0,1,0
62264,1,1,218194,218194,218195,0,1,0
62265,3,2,218197,218197,218199,0,2,2
62266,6,1,218203,218203,218204,0,1,4
62267,6,1,218209,218209,218210,0,1,5
62268,6,2,218215,218215,218217,0,2,5
62269,3,3,218218,218218,218221,0,3,1
62270,1,1,218219,218221,218222,2,3,0
62271,6,3,218225,218225,218228,0,3,3
62272,3,1,218228,218228,218229,0,1,0
62273,6,3,218234,218234,218237,0,3,5
62274,3,1,218237,218237,218238,0,1,0
62275,6,3,218243,218243,218246,0,3,5
62276,5,2,218248,218248,218250,0,2,2
62277,2,1,218250,218250,218251,0,1,0
62278,5,2,218255,218255,218257,0,2,4
62279,2,3,218257,218257,218260,0,3,0
62280,4,1,218261,218261,218262,0,1,1
62281,4,1,218265,218265,218266,0,1,3
62282,2,3,218267,218267,218270,0,3,1
62283,3,3,218270,218270,218273,0,3,0
62284,6,3,218276,218276,218279,0,3,3
62285,5,3,218281,218281,218284,0,3,2
62286,3,1,218284,218284,218285,0,1,0
62287,1,3,218285,218285,218288,0,3,0
62288,5,2,218290,218290,218292,0,2,2
62289,1,1,218291,218292,218293,1,2,0
62290,3,2,218294,218294,218296,0,2,1
62291,2,1,218296,218296,218297,0,1,0
62292,1,2,218297,218297,218299,0,2,0
62293,2,3,218299,218299,218302,0,3,0
62294,6,2,218305,218305,218307,0,2,3
62295,3,1,218308,218308,218309,0,1,1
62296,2,1,218310,218310,218311,0,1,1
62297,3,2,218313,218313,218315,0,2,2
62298,5,1,218318,218318,218319,0,1,3
62299,6,2,218324,218324,218326,0,2,5
62300,1,1,218325,218326,218327,1,2,0
62301,5,1,218330,218330,218331,0,1,3
62302,4,3,218334,218334,218337,0,3,3
62303,3,2,218337,218337,218339,0,2,0
62304,6,3,218343,218343,218346,0,3,4
62305,5,3,218348,218348,218351,0,3,2
62306,6,1,218354,218354,218355,0,1,3
62307,2,3,218356,218356,218359,0,3,1
62308,2,3,218358,218359,218362,1,4,0
62309,1,3,218359,218362,218365,3,6,0
62310,4,2,218363,218365,218367,2,4,0
62311,3,3,218366,218367,218370,1,4,0
62312,4,1,218370,218370,218371,0,1,0
62313,6,1,218376,218376,218377,0,1,5
62314,2,2,218378,218378,218380,0,2,1
62315,2,1,218380,218380,218381,0,1,0
62316,4,3,218384,218384,218387,0,3,3
62317,6,3,218390,218390,218393,0,3,3
62318,5,3,218395,218395,218398,0,3,2
62319,1,2,218396,218398,218400,2,4,0
62320,1,2,218397,218400,218402,3,5,0
62321,6,2,218403,218403,218405,0,2,1
62322,2,1,218405,218405,218406,0,1,0
62323,5,1,218410,218410,218411,0,1,4
62324,6,1,218416,218416,218417,0,1,5
62325,1,1,218417,218417,218418,0,1,0
62326,4,1,218421,218421,218422,0,1,3
62327,3,3,218424,218424,218427,0,3,2
62328,1,3,218425,218427,218430,2,5,0
62329,5,3,218430,218430,218433,0,3,0
62330,3,3,218433,218433,218436,0,3,0
62331,6,3,218439,218439,218442,0,3,3
62332,6,3,218445,218445,218448,0,3,3
62333,2,3,218447,218448,218451,1,4,0
62334,6,2,218453,218453,218455,0,2,2
62335,4,2,218457,218457,218459,0,2,2
62336,5,1,218462,218462,218463,0,1,3
62337,1,2,218463,218463,218465,0,2,0
62338,4,1,218467,218467,218468,0,1,2
62339,5,3,218472,218472,218475,0,3,4
62340,5,3,218477,218477,218480,0,3,2
62341,5,2,218482,218482,218484,0,2,2
62342,6,2,218488,218488,218490,0,2,4
62343,2,1,218490,218490,218491,0,1,0
62344,2,1,218492,218492,218493,0,1,1
62345,5,3,218497,218497,218500,0,3,4
62346,2,3,218499,218500,218503,1,4,0
62347,4,1,218503,218503,218504,0,1,0
62348,5,3,218508,218508,218511,0,3,4
62349,3,3,218511,218511,218514,0,3,0
62350,1,1,218512,218514,218515,2,3,0
62351,6,3,218518,218518,218521,0,3,3
62352,6,3,218524,218524,218527,0,3,3
62353,1,3,218525,218527,218530,2,5,0
62354,2,3,218527,218530,218533,3,6,0
62355,1,2,218528,218533,218535,5,7,0
62356,6,3,218534,218535,218538,1,4,0
62357,3,3,218537,218538,218541,1,4,0
62358,2,1,218539,218541,218542,2,3,0
62359,6,3,218545,218545,218548,0,3,3
62360,4,1,218549,218549,218550,0,1,1
62361,5,1,218554,218554,218555,0,1,4
62362,3,1,218557,218557,218558,0,1,2
62363,1,1,218558,218558,218559,0,1,0
62364,1,1,218559,218559,218560,0,1,0
62365,6,1,218565,218565,218566,0,1,5
62366,6,2,218571,218571,218573,0,2,5
62367,4,1,218575,218575,218576,0,1,2
62368,2,3,218577,218577,218580,0,3,1
62369,4,2,218581,218581,218583,0,2,1
62370,4,1,218585,218585,218586,0,1,2
62371,1,2,218586,218586,218588,0,2,0
62372,1,2,218587,218588,218590,1,3,0
62373,4,1,218591,218591,218592,0,1,1
62374,6,2,218597,218597,218599,0,2,5
62375,3,1,218600,218600,218601,0,1,1
62376,6,3,218606,218606,218609,0,3,5
62377,1,1,218607,218609,218610,2,3,0
62378,1,3,218608,218610,218613,2,5,0
62379,4,3,218612,218613,218616,1,4,0
62380,6,1,218618,218618,218619,0,1,2
62381,2,2,218620,218620,218622,0,2,1
62382,5,2,218625,218625,218627,0,2,3
62383,6,1,218631,218631,218632,0,1,4
62384,2,1,218633,218633,218634,0,1,1
62385,5,1,218638,218638,218639,0,1,4
62386,1,3,218639,218639,218642,0,3,0
62387,1,1,218640,218642,218643,2,3,0
62388,5,1,218645,218645,218646,0,1,2
62389,1,1,218646,218646,218647,0,1,0
62390,4,1,218650,218650,218651,0,1,3
62391,3,3,218653,218653,218656,0,3,2
62392,2,2,218655,218656,218658,1,3,0
62393,3,3,218658,218658,218661,0,3,0
62394,5,3,218663,218663,218666,0,3,2
62395,5,3,218668,218668,218671,0,3,2
62396,2,1,218670,218671,218672,1,2,0
62397,3,3,218673,218673,218676,0,3,1
62398,1,3,218674,218676,218679,2,5,0
62399,5,1,218679,218679,218680,0,1,0
62400,3,3,218682,218682,218685,0,3,2
62401,6,1,218688,218688,218689,0,1,3
62402,1,3,218689,218689,218692,0,3,0
62403,6,1,218695,218695,218696,0,1,3
62404,5,3,218700,218700,218703,0,3,4
62405,4,3,218704,218704,218707,0,3,1
62406,5,3,218709,218709,218712,0,3,2
62407,2,1,218711,218712,218713,1,2,0
62408,5,2,218716,218716,218718,0,2,3
62409,4,2,218720,218720,218722,0,2,2
62410,1,2,218721,218722,218724,1,3,0
62411,4,1,218725,218725,218726,0,1,1
62412,4,3,218729,218729,218732,0,3,3
62413,2,3,218731,218732,218735,1,4,0
62414,6,2,218737,218737,218739,0,2,2
62415,3,3,218740,218740,218743,0,3,1
62416,6,3,218746,218746,218749,0,3,3
62417,5,3,218751,218751,218754,0,3,2
62418,2,2,218753,218754,218756,1,3,0
62419,5,3,218758,218758,218761,0,3,2
62420,2,2,218760,218761,218763,1,3,0
62421,3,2,218763,218763,218765,0,2,0
62422,4,1,218767,218767,218768,0,1,2
62423,3,3,218770,218770,218773,0,3,2
62424,1,1,218771,218773,218774,2,3,0
62425,6,1,218777,218777,218778,0,1,3
62426,4,1,218781,218781,218782,0,1,3
62427,2,2,218783,218783,218785,0,2,1
62428,1,3,218784,218785,218788,1,4,0
62429,1,2,218785,218788,218790,3,5,0
62430,6,3,218791,218791,218794,0,3,1
62431,6,1,218797,218797,218798,0,1,3
62432,4,1,218801,218801,218802,0,1,3
62433,2,2,218803,218803,218805,0,2,1
62434,4,3,218807,218807,218810,0,3,2
62435,4,1,218811,218811,218812,0,1,1
62436,4,3,218815,218815,218818,0,3,3
62437,3,2,218818,218818,218820,0,2,0
62438,2,2,218820,218820,218822,0,2,0
62439,1,1,218821,218822,218823,1,2,0
62440,6,1,218827,218827,218828,0,1,4
62441,2,3,218829,218829,218832,0,3,1
62442,4,1,218833,218833,218834,0,1,1
62443,5,3,218838,218838,218841,0,3,4
62444,5,1,218843,218843,218844,0,1,2
62445,5,2,218848,218848,218850,0,2,4
62446,5,2,218853,218853,218855,0,2,3
62447,6,2,218859,218859,218861,0,2,4
62448,6,3,218865,218865,218868,0,3,4
62449,1,1,218866,218868,218869,2,3,0
62450,1,3,218867,218869,218872,2,5,0
62451,1,2,218868,218872,218874,4,6,0
62452,1,2,218869,218874,218876,5,7,0
62453,5,3,218874,218876,218879,2,5,0
62454,2,1,218876,218879,218880,3,4,0
62455,2,1,218878,218880,218881,2,3,0
62456,1,3,218879,218881,218884,2,5,0
62457,6,2,218885,218885,218887,0,2,1
62458,5,3,218890,218890,218893,0,3,3
62459,1,2,218891,218893,218895,2,4,0
62460,6,1,218897,218897,218898,0,1,2
62461,3,1,218900,218900,218901,0,1,2
62462,1,2,218901,218901,218903,0,2,0
62463,5,3,218906,218906,218909,0,3,3
62464,4,2,218910,218910,218912,0,2,1
62465,5,2,218915,218915,218917,0,2,3
62466,3,2,218918,218918,218920,0,2,1
62467,5,2,218923,218923,218925,0,2,3
62468,2,2,218925,218925,218927,0,2,0
62469,3,3,218928,218928,218931,0,3,1
62470,3,1,218931,218931,218932,0,1,0
62471,5,3,218936,218936,218939,0,3,4
62472,2,2,218938,218939,218941,1,3,0
62473,1,3,218939,218941,218944,2,5,0
62474,3,1,218942,218944,218945,2,3,0
62475,3,2,218945,218945,218947,0,2,0
62476,4,1,218949,218949,218950,0,1,2
62477,4,3,218953,218953,218956,0,3,3
62478,2,2,218955,218956,218958,1,3,0
62479,4,1,218959,218959,218960,0,1,1
62480,5,1,218964,218964,218965,0,1,4
62481,3,3,218967,218967,218970,0,3,2
62482,4,2,218971,218971,218973,0,2,1
62483,5,2,218976,218976,218978,0,2,3
62484,5,1,218981,218981,218982,0,1,3
62485,6,1,218987,218987,218988,0,1,5
62486,5,2,218992,218992,218994,0,2,4
62487,2,2,218994,218994,218996,0,2,0
62488,5,1,218999,218999,219000,0,1,3
62489,2,2,219001,219001,219003,0,2,1
62490,2,3,219003,219003,219006,0,3,0
62491,6,3,219009,219009,219012,0,3,3
62492,6,2,219015,219015,219017,0,2,3
62493,4,3,219019,219019,219022,0,3,2
62494,3,3,219022,219022,219025,0,3,0
62495,1,2,219023,219025,219027,2,4,0
62496,2,1,219025,219027,219028,2,3,0
62497,1,3,219026,219028,219031,2,5,0
62498,3,2,219029,219031,219033,2,4,0
62499,1,1,219030,219033,219034,3,4,0
62500,6,1,219036,219036,219037,0,1,2
62501,4,1,219040,219040,219041,0,1,3
62502,4,1,219044,219044,219045,0,1,3
62503,2,1,219046,219046,219047,0,1,1
62504,2,3,219048,219048,219051,0,3,1
62505,1,2,219049,219051,219053,2,4,0
62506,3,2,219052,219053,219055,1,3,0
62507,5,1,219057,219057,219058,0,1,2
62508,3,2,219060,219060,219062,0,2,2
62509,5,2,219065,219065,219067,0,2,3
62510,4,1,219069,219069,219070,0,1,2
62511,3,1,219072,219072,219073,0,1,2
62512,2,1,219074,219074,219075,0,1,1
62513,1,1,219075,219075,219076,0,1,0
62514,1,3,219076,219076,219079,0,3,0
62515,5,1,219081,219081,219082,0,1,2
62516,1,2,219082,219082,219084,0,2,0
62517,1,3,219083,219084,219087,1,4,0
62518,5,1,219088,219088,219089,0,1,1
62519,5,3,219093,219093,219096,0,3,4
62520,1,2,219094,219096,219098,2,4,0
62521,1,2,219095,219098,219100,3,5,0
62522,2,1,219097,219100,219101,3,4,0
62523,5,3,219102,219102,219105,0,3,1
62524,4,2,219106,219106,219108,0,2,1
62525,3,2,219109,219109,219111,0,2,1
62526,1,3,219110,219111,219114,1,4,0
62527,5,2,219115,219115,219117,0,2,1
62528,1,3,219116,219117,219120,1,4,0
62529,4,2,219120,219120,219122,0,2,0
62530,2,1,219122,219122,219123,0,1,0
62531,4,3,219126,219126,219129,0,3,3
62532,3,2,219129,219129,219131,0,2,0
62533,3,2,219132,219132,219134,0,2,1
62534,1,1,219133,219134,219135,1,2,0
62535,1,1,219134,219135,219136,1,2,0
62536,4,3,219138,219138,219141,0,3,2
62537,1,2,219139,219141,219143,2,4,0
62538,6,3,219145,219145,219148,0,3,2
62539,4,1,219149,219149,219150,0,1,1
62540,4,3,219153,219153,219156,0,3,3
62541,1,3,219154,219156,219159,2,5,0
62542,2,1,219156,219159,219160,3,4,0
62543,6,1,219162,219162,219163,0,1,2
62544,1,3,219163,219163,219166,0,3,0
62545,2,2,219165,219166,219168,1,3,0
62546,2,3,219167,219168,219171,1,4,0
62547,6,1,219173,219173,219174,0,1,2
62548,5,1,219178,219178,219179,0,1,4
62549,2,1,219180,219180,219181,0,1,1
62550,5,2,219185,219185,219187,0,2,4
62551,4,3,219189,219189,219192,0,3,2
62552,3,3,219192,219192,219195,0,3,0
62553,5,3,219197,219197,219200,0,3,2
62554,6,3,219203,219203,219206,0,3,3
62555,6,3,219209,219209,219212,0,3,3
62556,4,1,219213,219213,219214,0,1,1
62557,1,2,219214,219214,219216,0,2,0
62558,4,3,219218,219218,219221,0,3,2
62559,6,3,219224,219224,219227,0,3,3
62560,6,3,219230,219230,219233,0,3,3
62561,3,3,219233,219233,219236,0,3,0
62562,6,1,219239,219239,219240,0,1,3
62563,4,2,219243,219243,219245,0,2,3
62564,3,1,219246,219246,219247,0,1,1
62565,4,3,219250,219250,219253,0,3,3
62566,5,2,219255,219255,219257,0,2,2
62567,3,2,219258,219258,219260,0,2,1
62568,4,3,219262,219262,219265,0,3,2
62569,5,2,219267,219267,219269,0,2,2
62570,4,3,219271,219271,219274,0,3,2
62571,3,3,219274,219274,219277,0,3,0
62572,1,3,219275,219277,219280,2,5,0
62573,5,1,219280,219280,219281,0,1,0
62574,1,2,219281,219281,219283,0,2,0
62575,1,3,219282,219283,219286,1,4,0
62576,4,2,219286,219286,219288,0,2,0
62577,6,1,219292,219292,219293,0,1,4
62578,1,1,219293,219293,219294,0,1,0
62579,5,3,219298,219298,219301,0,3,4
62580,1,3,219299,219301,219304,2,5,0
62581,6,1,219305,219305,219306,0,1,1
62582,5,3,219310,219310,219313,0,3,4
62583,1,3,219311,219313,219316,2,5,0
62584,4,3,219315,219316,219319,1,4,0
62585,1,2,219316,219319,219321,3,5,0
62586,6,1,219322,219322,219323,0,1,1
62587,1,3,219323,219323,219326,0,3,0
62588,1,1,219324,219326,219327,2,3,0
62589,3,2,219327,219327,219329,0,2,0
62590,3,1,219330,219330,219331,0,1,1
62591,6,3,219336,219336,219339,0,3,5
62592,3,2,219339,219339,219341,0,2,0
62593,5,3,219344,219344,219347,0,3,3
62594,3,2,219347,219347,219349,0,2,0
62595,1,2,219348,219349,219351,1,3,0
62596,5,2,219353,219353,219355,0,2,2
62597,2,3,219355,219355,219358,0,3,0
62598,3,1,219358,219358,219359,0,1,0
62599,6,1,219364,219364,219365,0,1,5
62600,6,2,219370,219370,219372,0,2,5
62601,2,2,219372,219372,219374,0,2,0
62602,2,2,219374,219374,219376,0,2,0
62603,6,2,219380,219380,219382,0,2,4
62604,1,3,219381,219382,219385,1,4,0
62605,6,2,219387,219387,219389,0,2,2
62606,4,2,219391,219391,219393,0,2,2
62607,5,1,219396,219396,219397,0,1,3
62608,4,3,219400,219400,219403,0,3,3
62609,1,1,219401,219403,219404,2,3,0
62610,2,1,219403,219404,219405,1,2,0
62611,5,2,219408,219408,219410,0,2,3
62612,6,2,219414,219414,219416,0,2,4
62613,4,1,219418,219418,219419,0,1,2
62614,2,1,219420,219420,219421,0,1,1
62615,4,1,219424,219424,219425,0,1,3
62616,2,2,219426,219426,219428,0,2,1
62617,2,3,219428,219428,219431,0,3,0
62618,5,1,219433,219433,219434,0,1,2
62619,6,2,219439,219439,219441,0,2,5
62620,5,1,219444,219444,219445,0,1,3
62621,3,3,219447,219447,219450,0,3,2
62622,3,2,219450,219450,219452,0,2,0
62623,6,3,219456,219456,219459,0,3,4
62624,2,1,219458,219459,219460,1,2,0
62625,3,3,219461,219461,219464,0,3,1
62626,2,3,219463,219464,219467,1,4,0
62627,6,2,219469,219469,219471,0,2,2
62628,3,3,219472,219472,219475,0,3,1
62629,4,1,219476,219476,219477,0,1,1
62630,1,2,219477,219477,219479,0,2,0
62631,5,2,219482,219482,219484,0,2,3
62632,2,3,219484,219484,219487,0,3,0
62633,4,1,219488,219488,219489,0,1,1
62634,4,2,219492,219492,219494,0,2,3
62635,5,1,219497,219497,219498,0,1,3
62636,5,3,219502,219502,219505,0,3,4
62637,5,2,219507,219507,219509,0,2,2
62638,1,2,219508,219509,219511,1,3,0
62639,3,1,219511,219511,219512,0,1,0
62640,1,3,219512,219512,219515,0,3,0
62641,6,2,219518,219518,219520,0,2,3
62642,4,1,219522,219522,219523,0,1,2
62643,1,2,219523,219523,219525,0,2,0
62644,1,2,219524,219525,219527,1,3,0
62645,4,2,219528,219528,219530,0,2,1
62646,4,1,219532,219532,219533,0,1,2
62647,5,1,219537,219537,219538,0,1,4
62648,1,3,219538,219538,219541,0,3,0
62649,2,3,219540,219541,219544,1,4,0
62650,3,2,219543,219544,219546,1,3,0
62651,5,3,219548,219548,219551,0,3,2
62652,6,3,219554,219554,219557,0,3,3
62653,2,2,219556,219557,219559,1,3,0
62654,1,2,219557,219559,219561,2,4,0
62655,2,1,219559,219561,219562,2,3,0
62656,1,3,219560,219562,219565,2,5,0
62657,2,1,219562,219565,219566,3,4,0
62658,4,2,219566,219566,219568,0,2,0
62659,3,2,219569,219569,219571,0,2,1
62660,5,3,219574,219574,219577,0,3,3
62661,6,3,219580,219580,219583,0,3,3
62662,4,2,219584,219584,219586,0,2,1
62663,6,3,219590,219590,219593,0,3,4
62664,1,2,219591,219593,219595,2,4,0
62665,3,1,219594,219595,219596,1,2,0
62666,3,1,219597,219597,219598,0,1,1
62667,1,3,219598,219598,219601,0,3,0
62668,5,1,219603,219603,219604,0,1,2
62669,2,2,219605,219605,219607,0,2,1
62670,3,2,219608,219608,219610,0,2,1
62671,3,1,219611,219611,219612,0,1,1
62672,2,2,219613,219613,219615,0,2,1
62673,6,3,219619,219619,219622,0,3,4
62674,3,2,219622,219622,219624,0,2,0
62675,5,2,219627,219627,219629,0,2,3
62676,3,2,219630,219630,219632,0,2,1
62677,2,3,219632,219632,219635,0,3,0
62678,4,1,219636,219636,219637,0,1,1
62679,6,1,219642,219642,219643,0,1,5
62680,4,1,219646,219646,219647,0,1,3
62681,4,2,219650,219650,219652,0,2,3
62682,1,2,219651,219652,219654,1,3,0
62683,3,2,219654,219654,219656,0,2,0
62684,4,1,219658,219658,219659,0,1,2
62685,1,3,219659,219659,219662,0,3,0
62686,1,1,219660,219662,219663,2,3,0
62687,1,1,219661,219663,219664,2,3,0
62688,5,3,219666,219666,219669,0,3,2
62689,4,1,219670,219670,219671,0,1,1
62690,2,2,219672,219672,219674,0,2,1
62691,4,2,219676,219676,219678,0,2,2
62692,1,3,219677,219678,219681,1,4,0
62693,3,1,219680,219681,219682,1,2,0
62694,6,1,219686,219686,219687,0,1,4
62695,4,3,219690,219690,219693,0,3,3
62696,3,1,219693,219693,219694,0,1,0
62697,3,1,219696,219696,219697,0,1,2
62698,4,3,219700,219700,219703,0,3,3
62699,6,3,219706,219706,219709,0,3,3
62700,2,1,219708,219709,219710,1,2,0
62701,5,3,219713,219713,219716,0,3,3
62702,4,3,219717,219717,219720,0,3,1
62703,1,1,219718,219720,219721,2,3,0
62704,2,3,219720,219721,219724,1,4,0
62705,1,2,219721,219724,219726,3,5,0
62706,6,1,219727,219727,219728,0,1,1
62707,3,3,219730,219730,219733,0,3,2
62708,4,3,219734,219734,219737,0,3,1
62709,2,2,219736,219737,219739,1,3,0
62710,1,1,219737,219739,219740,2,3,0
62711,4,2,219741,219741,219743,0,2,1
62712,1,1,219742,219743,219744,1,2,0
62713,2,3,219744,219744,219747,0,3,0
62714,2,1,219746,219747,219748,1,2,0
62715,4,3,219750,219750,219753,0,3,2
62716,5,2,219755,219755,219757,0,2,2
62717,3,2,219758,219758,219760,0,2,1
62718,2,1,219760,219760,219761,0,1,0
62719,2,1,219762,219762,219763,0,1,1
62720,1,3,219763,219763,219766,0,3,0
62721,2,2,219765,219766,219768,1,3,0
62722,3,3,219768,219768,219771,0,3,0
62723,4,1,219772,219772,219773,0,1,1
62724,3,2,219775,219775,219777,0,2,2
62725,2,1,219777,219777,219778,0,1,0
62726,4,2,219781,219781,219783,0,2,3
62727,5,2,219786,219786,219788,0,2,3
62728,6,1,219792,219792,219793,0,1,4
62729,3,3,219795,219795,219798,0,3,2
62730,2,2,219797,219798,219800,1,3,0
62731,2,1,219799,219800,219801,1,2,0
62732,3,3,219802,219802,219805,0,3,1
62733,6,2,219808,219808,219810,0,2,3
62734,4,1,219812,219812,219813,0,1,2
62735,4,2,219816,219816,219818,0,2,3
62736,4,1,219820,219820,219821,0,1,2
62737,4,3,219824,219824,219827,0,3,3
62738,4,1,219828,219828,219829,0,1,1
62739,5,1,219833,219833,219834,0,1,4
62740,5,3,219838,219838,219841,0,3,4
62741,2,2,219840,219841,219843,1,3,0
62742,3,1,219843,219843,219844,0,1,0
62743,4,2,219847,219847,219849,0,2,3
62744,3,1,219850,219850,219851,0,1,1
62745,3,3,219853,219853,219856,0,3,2
62746,5,3,219858,219858,219861,0,3,2
62747,2,2,219860,219861,219863,1,3,0
62748,6,2,219866,219866,219868,0,2,3
62749,6,1,219872,219872,219873,0,1,4
62750,5,2,219877,219877,219879,0,2,4
62751,5,2,219882,219882,219884,0,2,3
62752,5,3,219887,219887,219890,0,3,3
62753,6,3,219893,219893,219896,0,3,3
62754,6,2,219899,219899,219901,0,2,3
62755,4,2,219903,219903,219905,0,2,2
62756,1,2,219904,219905,219907,1,3,0
62757,1,3,219905,219907,219910,2,5,0
62758,5,1,219910,219910,219911,0,1,0
62759,4,1,219914,219914,219915,0,1,3
62760,3,2,219917,219917,219919,0,2,2
62761,1,1,219918,219919,219920,1,2,0
62762,4,3,219922,219922,219925,0,3,2
62763,5,2,219927,219927,219929,0,2,2
62764,5,1,219932,219932,219933,0,1,3
62765,3,3,219935,219935,219938,0,3,2
62766,6,3,219941,219941,219944,0,3,3
62767,1,3,219942,219944,219947,2,5,0
62768,6,1,219948,219948,219949,0,1,1
62769,2,3,219950,219950,219953,0,3,1
62770,5,2,219955,219955,219957,0,2,2
62771,2,1,219957,219957,219958,0,1,0
62772,6,3,219963,219963,219966,0,3,5
62773,6,1,219969,219969,219970,0,1,3
62774,6,2,219975,219975,219977,0,2,5
62775,1,3,219976,219977,219980,1,4,0
62776,4,1,219980,219980,219981,0,1,0
62777,1,1,219981,219981,219982,0,1,0
62778,3,3,219984,219984,219987,0,3,2
62779,6,3,219990,219990,219993,0,3,3
62780,2,1,219992,219993,219994,1,2,0
62781,6,3,219998,219998,220001,0,3,4
62782,4,3,220002,220002,220005,0,3,1
62783,6,2,220008,220008,220010,0,2,3
62784,6,2,220014,220014,220016,0,2,4
62785,3,1,220017,220017,220018,0,1,1
62786,6,1,220023,220023,220024,0,1,5
62787,4,1,220027,220027,220028,0,1,3
62788,1,3,220028,220028,220031,0,3,0
62789,4,2,220032,220032,220034,0,2,1
62790,4,1,220036,220036,220037,0,1,2
62791,1,1,220037,220037,220038,0,1,0
62792,1,3,220038,220038,220041,0,3,0
62793,6,1,220044,220044,220045,0,1,3
62794,3,2,220047,220047,220049,0,2,2
62795,4,1,220051,220051,220052,0,1,2
62796,5,3,220056,220056,220059,0,3,4
62797,3,1,220059,220059,220060,0,1,0
62798,2,1,220061,220061,220062,0,1,1
62799,1,2,220062,220062,220064,0,2,0
62800,5,1,220067,220067,220068,0,1,3
62801,6,2,220073,220073,220075,0,2,5
62802,2,1,220075,220075,220076,0,1,0
62803,4,3,220079,220079,220082,0,3,3
62804,3,2,220082,220082,220084,0,2,0
62805,1,2,220083,220084,220086,1,3,0
62806,2,2,220085,220086,220088,1,3,0
62807,1,3,220086,220088,220091,2,5,0
62808,1,2,220087,220091,220093,4,6,0
62809,2,1,220089,220093,220094,4,5,0
62810,6,3,220095,220095,220098,0,3,1
62811,4,1,220099,220099,220100,0,1,1
62812,3,2,220102,220102,220104,0,2,2
62813,3,3,220105,220105,220108,0,3,1
62814,5,1,220110,220110,220111,0,1,2
62815,3,1,220113,220113,220114,0,1,2
62816,1,1,220114,220114,220115,0,1,0
62817,2,3,220116,220116,220119,0,3,1
62818,2,2,220118,220119,220121,1,3,0
62819,6,1,220124,220124,220125,0,1,3
62820,6,2,220130,220130,220132,0,2,5
62821,4,1,220134,220134,220135,0,1,2
62822,6,1,220140,220140,220141,0,1,5
62823,5,1,220145,220145,220146,0,1,4
62824,1,3,220146,220146,220149,0,3,0
62825,1,2,220147,220149,220151,2,4,0
62826,1,3,220148,220151,220154,3,6,0
62827,5,2,220153,220154,220156,1,3,0
62828,2,1,220155,220156,220157,1,2,0
62829,6,2,220161,220161,220163,0,2,4
62830,1,2,220162,220163,220165,1,3,0
62831,4,2,220166,220166,220168,0,2,1
62832,1,2,220167,220168,220170,1,3,0
62833,2,1,220169,220170,220171,1,2,0
62834,6,3,220175,220175,220178,0,3,4
62835,3,3,220178,220178,220181,0,3,0
62836,5,3,220183,220183,220186,0,3,2
62837,6,3,220189,220189,220192,0,3,3
62838,2,1,220191,220192,220193,1,2,0
62839,5,3,220196,220196,220199,0,3,3
62840,1,1,220197,220199,220200,2,3,0
62841,1,3,220198,220200,220203,2,5,0
62842,1,3,220199,220203,220206,4,7,0
62843,1,1,220200,220206,220207,6,7,0
62844,3,3,220203,220207,220210,4,7,0
62845,3,2,220206,220210,220212,4,6,0
62846,2,1,220208,220212,220213,4,5,0
62847,3,3,220211,220213,220216,2,5,0
62848,3,2,220214,220216,220218,2,4,0
62849,2,1,220216,220218,220219,2,3,0
62850,2,3,220218,220219,220222,1,4,0
62851,4,2,220222,220222,220224,0,2,0
62852,4,1,220226,220226,220227,0,1,2
62853,4,3,220230,220230,220233,0,3,3
62854,5,3,220235,220235,220238,0,3,2
62855,3,1,220238,220238,220239,0,1,0
62856,4,1,220242,220242,220243,0,1,3
62857,5,3,220247,220247,220250,0,3,4
62858,6,2,220253,220253,220255,0,2,3
62859,2,2,220255,220255,220257,0,2,0
62860,2,2,220257,220257,220259,0,2,0
62861,6,2,220263,220263,220265,0,2,4
62862,6,1,220269,220269,220270,0,1,4
62863,2,1,220271,220271,220272,0,1,1
62864,2,3,220273,220273,220276,0,3,1
62865,1,2,220274,220276,220278,2,4,0
62866,4,2,220278,220278,220280,0,2,0
62867,6,1,220284,220284,220285,0,1,4
62868,1,3,220285,220285,220288,0,3,0
62869,1,3,220286,220288,220291,2,5,0
62870,4,3,220290,220291,220294,1,4,0
62871,5,2,220295,220295,220297,0,2,1
62872,2,1,220297,220297,220298,0,1,0
62873,4,2,220301,220301,220303,0,2,3
62874,5,1,220306,220306,220307,0,1,3
62875,4,1,220310,220310,220311,0,1,3
62876,3,1,220313,220313,220314,0,1,2
62877,4,3,220317,220317,220320,0,3,3
62878,3,1,220320,220320,220321,0,1,0
62879,2,1,220322,220322,220323,0,1,1
62880,4,2,220326,220326,220328,0,2,3
62881,3,1,220329,220329,220330,0,1,1
62882,1,1,220330,220330,220331,0,1,0
62883,3,3,220333,220333,220336,0,3,2
62884,5,2,220338,220338,220340,0,2,2
62885,5,1,220343,220343,220344,0,1,3
62886,2,1,220345,220345,220346,0,1,1
62887,4,1,220349,220349,220350,0,1,3
62888,3,1,220352,220352,220353,0,1,2
62889,5,1,220357,220357,220358,0,1,4
62890,3,2,220360,220360,220362,0,2,2
62891,1,1,220361,220362,220363,1,2,0
62892,5,3,220366,220366,220369,0,3,3
62893,5,1,220371,220371,220372,0,1,2
62894,3,3,220374,220374,220377,0,3,2
62895,5,1,220379,220379,220380,0,1,2
62896,3,2,220382,220382,220384,0,2,2
62897,6,2,220388,220388,220390,0,2,4
62898,1,3,220389,220390,220393,1,4,0
62899,4,1,220393,220393,220394,0,1,0
62900,5,3,220398,220398,220401,0,3,4
62901,2,3,220400,220401,220404,1,4,0
62902,4,2,220404,220404,220406,0,2,0
62903,2,3,220406,220406,220409,0,3,0
62904,3,1,220409,220409,220410,0,1,0
62905,2,1,220411,220411,220412,0,1,1
62906,3,1,220414,220414,220415,0,1,2
62907,6,3,220420,220420,220423,0,3,5
62908,4,1,220424,220424,220425,0,1,1
62909,3,1,220427,220427,220428,0,1,2
62910,4,1,220431,220431,220432,0,1,3
62911,3,2,220434,220434,220436,0,2,2
62912,6,1,220440,220440,220441,0,1,4
62913,3,2,220443,220443,220445,0,2,2
62914,1,2,220444,220445,220447,1,3,0
62915,5,1,220449,220449,220450,0,1,2
62916,1,1,220450,220450,220451,0,1,0
62917,6,1,220456,220456,220457,0,1,5
62918,2,2,220458,220458,220460,0,2,1
62919,6,3,220464,220464,220467,0,3,4
62920,1,1,220465,220467,220468,2,3,0
62921,4,3,220469,220469,220472,0,3,1
62922,3,2,220472,220472,220474,0,2,0
62923,2,1,220474,220474,220475,0,1,0
62924,5,2,220479,220479,220481,0,2,4
62925,1,1,220480,220481,220482,1,2,0
62926,1,1,220481,220482,220483,1,2,0
62927,2,2,220483,220483,220485,0,2,0
62928,4,1,220487,220487,220488,0,1,2
62929,6,1,220493,220493,220494,0,1,5
62930,2,3,220495,220495,220498,0,3,1
62931,2,2,220497,220498,220500,1,3,0
62932,6,2,220503,220503,220505,0,2,3
62933,5,1,220508,220508,220509,0,1,3
62934,5,1,220513,220513,220514,0,1,4
62935,6,1,220519,220519,220520,0,1,5
62936,4,1,220523,220523,220524,0,1,3
62937,1,1,220524,220524,220525,0,1,0
62938,5,2,220529,220529,220531,0,2,4
62939,2,3,220531,220531,220534,0,3,0
62940,1,3,220532,220534,220537,2,5,0
62941,2,3,220534,220537,220540,3,6,0
62942,1,3,220535,220540,220543,5,8,0
62943,5,2,220540,220543,220545,3,5,0
62944,3,2,220543,220545,220547,2,4,0
62945,3,1,220546,220547,220548,1,2,0
62946,2,3,220548,220548,220551,0,3,0
62947,5,3,220553,220553,220556,0,3,2
62948,2,2,220555,220556,220558,1,3,0
62949,6,3,220561,220561,220564,0,3,3
62950,1,3,220562,220564,220567,2,5,0
62951,1,1,220563,220567,220568,4,5,0
62952,1,2,220564,220568,220570,4,6,0
62953,1,1,220565,220570,220571,5,6,0
62954,2,1,220567,220571,220572,4,5,0
62955,6,1,220573,220573,220574,0,1,1
62956,4,2,220577,220577,220579,0,2,3
62957,2,3,220579,220579,220582,0,3,0
62958,1,3,220580,220582,220585,2,5,0
62959,4,2,220584,220585,220587,1,3,0
62960,2,2,220586,220587,220589,1,3,0
62961,1,2,220587,220589,220591,2,4,0
62962,3,3,220590,220591,220594,1,4,0
62963,1,1,220591,220594,220595,3,4,0
62964,2,1,220593,220595,220596,2,3,0
62965,2,2,220595,220596,220598,1,3,0
62966,2,3,220597,220598,220601,1,4,0
62967,2,3,220599,220601,220604,2,5,0
62968,2,3,220601,220604,220607,3,6,0
62969,3,1,220604,220607,220608,3,4,0
62970,5,3,220609,220609,220612,0,3,1
62971,3,3,220612,220612,220615,0,3,0
62972,1,3,220613,220615,220618,2,5,0
62973,6,1,220619,220619,220620,0,1,1
62974,4,2,220623,220623,220625,0,2,3
62975,4,3,220627,220627,220630,0,3,2
62976,5,3,220632,220632,220635,0,3,2
62977,6,2,220638,220638,220640,0,2,3
62978,2,3,220640,220640,220643,0,3,0
62979,5,1,220645,220645,220646,0,1,2
62980,1,2,220646,220646,220648,0,2,0
62981,1,3,220647,220648,220651,1,4,0
62982,3,3,220650,220651,220654,1,4,0
62983,2,2,220652,220654,220656,2,4,0
62984,2,3,220654,220656,220659,2,5,0
62985,2,3,220656,220659,220662,3,6,0
62986,5,1,220661,220662,220663,1,2,0
62987,2,1,220663,220663,220664,0,1,0
62988,1,1,220664,220664,220665,0,1,0
62989,3,3,220667,220667,220670,0,3,2
62990,1,1,220668,220670,220671,2,3,0
62991,2,1,220670,220671,220672,1,2,0
62992,3,1,220673,220673,220674,0,1,1
62993,5,3,220678,220678,220681,0,3,4
62994,6,1,220684,220684,220685,0,1,3
62995,6,1,220690,220690,220691,0,1,5
62996,5,2,220695,220695,220697,0,2,4
62997,2,3,220697,220697,220700,0,3,0
62998,6,1,220703,220703,220704,0,1,3
62999,1,1,220704,220704,220705,0,1,0
63000,3,2,220707,220707,220709,0,2,2
63001,1,1,220708,220709,220710,1,2,0
63002,1,1,220709,220710,220711,1,2,0
63003,1,2,220710,220711,220713,1,3,0
63004,3,2,220713,220713,220715,0,2,0
63005,5,1,220718,220718,220719,0,1,3
63006,4,2,220722,220722,220724,0,2,3
63007,6,2,220728,220728,220730,0,2,4
63008,3,2,220731,220731,220733,0,2,1
63009,2,1,220733,220733,220734,0,1,0
63010,4,1,220737,220737,220738,0,1,3
63011,2,3,220739,220739,220742,0,3,1
63012,6,1,220745,220745,220746,0,1,3
63013,3,1,220748,220748,220749,0,1,2
63014,6,1,220754,220754,220755,0,1,5
63015,4,2,220758,220758,220760,0,2,3
63016,6,3,220764,220764,220767,0,3,4
63017,3,1,220767,220767,220768,0,1,0
63018,2,2,220769,220769,220771,0,2,1
63019,3,3,220772,220772,220775,0,3,1
63020,4,2,220776,220776,220778,0,2,1
63021,3,1,220779,220779,220780,0,1,1
63022,6,3,220785,220785,220788,0,3,5
63023,3,1,220788,220788,220789,0,1,0
63024,2,2,220790,220790,220792,0,2,1
63025,3,2,220793,220793,220795,0,2,1
63026,1,1,220794,220795,220796,1,2,0
63027,4,3,220798,220798,220801,0,3,2
63028,6,2,220804,220804,220806,0,2,3
63029,6,2,220810,220810,220812,0,2,4
63030,4,2,220814,220814,220816,0,2,2
63031,2,2,220816,220816,220818,0,2,0
63032,4,2,220820,220820,220822,0,2,2
63033,2,2,220822,220822,220824,0,2,0
63034,5,3,220827,220827,220830,0,3,3
63035,1,3,220828,220830,220833,2,5,0
63036,6,2,220834,220834,220836,0,2,1
63037,1,3,220835,220836,220839,1,4,0
63038,2,3,220837,220839,220842,2,5,0
63039,1,3,220838,220842,220845,4,7,0
63040,1,3,220839,220845,220848,6,9,0
63041,6,3,220845,220848,220851,3,6,0
63042,1,3,220846,220851,220854,5,8,0
63043,2,3,220848,220854,220857,6,9,0
63044,1,2,220849,220857,220859,8,10,0
63045,3,3,220852,220859,220862,7,10,0
63046,4,2,220856,220862,220864,6,8,0
63047,5,2,220861,220864,220866,3,5,0
63048,3,3,220864,220866,220869,2,5,0
63049,5,2,220869,220869,220871,0,2,0
63050,2,1,220871,220871,220872,0,1,0
63051,6,1,220877,220877,220878,0,1,5
63052,2,3,220879,220879,220882,0,3,1
63053,3,2,220882,220882,220884,0,2,0
63054,4,2,220886,220886,220888,0,2,2
63055,4,3,220890,220890,220893,0,3,2
63056,1,3,220891,220893,220896,2,5,0
63057,5,2,220896,220896,220898,0,2,0
63058,3,2,220899,220899,220901,0,2,1
63059,4,2,220903,220903,220905,0,2,2
63060,3,2,220906,220906,220908,0,2,1
63061,5,3,220911,220911,220914,0,3,3
63062,3,3,220914,220914,220917,0,3,0
63063,2,3,220916,220917,220920,1,4,0
63064,3,2,220919,220920,220922,1,3,0
63065,4,2,220923,220923,220925,0,2,1
63066,1,1,220924,220925,220926,1,2,0
63067,3,3,220927,220927,220930,0,3,1
63068,3,3,220930,220930,220933,0,3,0
63069,3,2,220933,220933,220935,0,2,0
63070,4,3,220937,220937,220940,0,3,2
63071,6,1,220943,220943,220944,0,1,3
63072,1,3,220944,220944,220947,0,3,0
63073,1,2,220945,220947,220949,2,4,0
63074,4,2,220949,220949,220951,0,2,0
63075,3,3,220952,220952,220955,0,3,1
63076,6,1,220958,220958,220959,0,1,3
63077,1,1,220959,220959,220960,0,1,0
63078,2,2,220961,220961,220963,0,2,1
63079,5,3,220966,220966,220969,0,3,3
63080,1,2,220967,220969,220971,2,4,0
63081,6,2,220973,220973,220975,0,2,2
63082,3,3,220976,220976,220979,0,3,1
63083,6,3,220982,220982,220985,0,3,3
63084,4,2,220986,220986,220988,0,2,1
63085,1,2,220987,220988,220990,1,3,0
63086,2,1,220989,220990,220991,1,2,0
63087,2,2,220991,220991,220993,0,2,0
63088,2,2,220993,220993,220995,0,2,0
63089,5,3,220998,220998,221001,0,3,3
63090,1,1,220999,221001,221002,2,3,0
63091,6,3,221005,221005,221008,0,3,3
63092,5,2,221010,221010,221012,0,2,2
63093,1,2,221011,221012,221014,1,3,0
63094,2,3,221013,221014,221017,1,4,0
63095,5,1,221018,221018,221019,0,1,1
63096,3,3,221021,221021,221024,0,3,2
63097,6,2,221027,221027,221029,0,2,3
63098,4,2,221031,221031,221033,0,2,2
63099,3,3,221034,221034,221037,0,3,1
63100,6,3,221040,221040,221043,0,3,3
63101,2,1,221042,221043,221044,1,2,0
63102,2,1,221044,221044,221045,0,1,0
63103,6,3,221050,221050,221053,0,3,5
63104,1,3,221051,221053,221056,2,5,0
63105,1,3,221052,221056,221059,4,7,0
63106,3,2,221055,221059,221061,4,6,0
63107,5,2,221060,221061,221063,1,3,0
63108,4,1,221064,221064,221065,0,1,1
63109,3,2,221067,221067,221069,0,2,2
63110,6,3,221073,221073,221076,0,3,4
63111,2,1,221075,221076,221077,1,2,0
63112,2,2,221077,221077,221079,0,2,0
63113,2,1,221079,221079,221080,0,1,0
63114,4,2,221083,221083,221085,0,2,3
63115,6,2,221089,221089,221091,0,2,4
63116,2,1,221091,221091,221092,0,1,0
63117,1,3,221092,221092,221095,0,3,0
63118,3,2,221095,221095,221097,0,2,0
63119,6,1,221101,221101,221102,0,1,4
63120,2,1,221103,221103,221104,0,1,1
63121,1,1,221104,221104,221105,0,1,0
63122,5,3,221109,221109,221112,0,3,4
63123,3,2,221112,221112,221114,0,2,0
63124,1,3,221113,221114,221117,1,4,0
63125,1,2,221114,221117,221119,3,5,0
63126,3,1,221117,221119,221120,2,3,0
63127,6,1,221123,221123,221124,0,1,3
63128,5,1,221128,221128,221129,0,1,4
63129,4,2,221132,221132,221134,0,2,3
63130,2,2,221134,221134,221136,0,2,0
63131,4,2,221138,221138,221140,0,2,2
63132,5,1,221143,221143,221144,0,1,3
63133,4,3,221147,221147,221150,0,3,3
63134,3,3,221150,221150,221153,0,3,0
63135,2,3,221152,221153,221156,1,4,0
63136,5,3,221157,221157,221160,0,3,1
63137,2,1,221159,221160,221161,1,2,0
63138,3,3,221162,221162,221165,0,3,1
63139,2,2,221164,221165,221167,1,3,0
63140,4,1,221168,221168,221169,0,1,1
63141,2,2,221170,221170,221172,0,2,1
63142,2,1,221172,221172,221173,0,1,0
63143,1,3,221173,221173,221176,0,3,0
63144,5,3,221178,221178,221181,0,3,2
63145,4,1,221182,221182,221183,0,1,1
63146,4,3,221186,221186,221189,0,3,3
63147,3,1,221189,221189,221190,0,1,0
63148,3,3,221192,221192,221195,0,3,2
63149,4,3,221196,221196,221199,0,3,1
63150,2,1,221198,221199,221200,1,2,0
63151,4,2,221202,221202,221204,0,2,2
63152,2,1,221204,221204,221205,0,1,0
63153,5,2,221209,221209,221211,0,2,4
63154,6,2,221215,221215,221217,0,2,4
63155,6,3,221221,221221,221224,0,3,4
63156,5,3,221226,221226,221229,0,3,2
63157,2,1,221228,221229,221230,1,2,0
63158,1,3,221229,221230,221233,1,4,0
63159,3,1,221232,221233,221234,1,2,0
63160,3,1,221235,221235,221236,0,1,1
63161,5,3,221240,221240,221243,0,3,4
63162,2,2,221242,221243,221245,1,3,0
63163,1,1,221243,221245,221246,2,3,0
63164,5,2,221248,221248,221250,0,2,2
63165,6,2,221254,221254,221256,0,2,4
63166,4,1,221258,221258,221259,0,1,2
63167,1,1,221259,221259,221260,0,1,0
63168,2,3,221261,221261,221264,0,3,1
63169,6,2,221267,221267,221269,0,2,3
63170,1,2,221268,221269,221271,1,3,0
63171,1,3,221269,221271,221274,2,5,0
63172,6,3,221275,221275,221278,0,3,1
63173,3,1,221278,221278,221279,0,1,0
63174,6,1,221284,221284,221285,0,1,5
63175,2,1,221286,221286,221287,0,1,1
63176,3,2,221289,221289,221291,0,2,2
63177,4,3,221293,221293,221296,0,3,2
63178,6,1,221299,221299,221300,0,1,3
63179,2,2,221301,221301,221303,0,2,1
63180,5,2,221306,221306,221308,0,2,3
63181,6,3,221312,221312,221315,0,3,4
63182,4,2,221316,221316,221318,0,2,1
63183,6,2,221322,221322,221324,0,2,4
63184,3,1,221325,221325,221326,0,1,1
63185,1,1,221326,221326,221327,0,1,0
63186,6,1,221332,221332,221333,0,1,5
63187,6,3,221338,221338,221341,0,3,5
63188,5,3,221343,221343,221346,0,3,2
63189,5,1,221348,221348,221349,0,1,2
63190,2,2,221350,221350,221352,0,2,1
63191,6,2,221356,221356,221358,0,2,4
63192,3,2,221359,221359,221361,0,2,1
63193,5,1,221364,221364,221365,0,1,3
63194,5,2,221369,221369,221371,0,2,4
63195,2,3,221371,221371,221374,0,3,0
63196,6,3,221377,221377,221380,0,3,3
63197,1,1,221378,221380,221381,2,3,0
63198,1,2,221379,221381,221383,2,4,0
63199,1,3,221380,221383,221386,3,6,0
63200,5,2,221385,221386,221388,1,3,0
63201,5,1,221390,221390,221391,0,1,2
63202,1,1,221391,221391,221392,0,1,0
63203,4,1,221395,221395,221396,0,1,3
63204,6,3,221401,221401,221404,0,3,5
63205,2,2,221403,221404,221406,1,3,0
63206,4,2,221407,221407,221409,0,2,1
63207,3,1,221410,221410,221411,0,1,1
63208,3,1,221413,221413,221414,0,1,2
63209,1,1,221414,221414,221415,0,1,0
63210,5,3,221419,221419,221422,0,3,4
63211,6,2,221425,221425,221427,0,2,3
63212,1,2,221426,221427,221429,1,3,0
63213,2,2,221428,221429,221431,1,3,0
63214,5,1,221433,221433,221434,0,1,2
63215,6,2,221439,221439,221441,0,2,5
63216,2,1,221441,221441,221442,0,1,0
63217,5,1,221446,221446,221447,0,1,4
63218,6,1,221452,221452,221453,0,1,5
63219,4,2,221456,221456,221458,0,2,3
63220,4,2,221460,221460,221462,0,2,2
63221,5,2,221465,221465,221467,0,2,3
63222,3,2,221468,221468,221470,0,2,1
63223,4,1,221472,221472,221473,0,1,2
63224,5,2,221477,221477,221479,0,2,4
63225,1,2,221478,221479,221481,1,3,0
63226,1,1,221479,221481,221482,2,3,0
63227,1,1,221480,221482,221483,2,3,0
63228,3,1,221483,221483,221484,0,1,0
63229,3,3,221486,221486,221489,0,3,2
63230,4,2,221490,221490,221492,0,2,1
63231,1,3,221491,221492,221495,1,4,0
63232,4,3,221495,221495,221498,0,3,0
63233,5,3,221500,221500,221503,0,3,2
63234,5,3,221505,221505,221508,0,3,2
63235,2,2,221507,221508,221510,1,3,0
63236,5,3,221512,221512,221515,0,3,2
63237,2,2,221514,221515,221517,1,3,0
63238,5,1,221519,221519,221520,0,1,2
63239,3,3,221522,221522,221525,0,3,2
63240,1,1,221523,221525,221526,2,3,0
63241,2,3,221525,221526,221529,1,4,0
63242,2,2,221527,221529,221531,2,4,0
63243,3,2,221530,221531,221533,1,3,0
63244,3,1,221533,221533,221534,0,1,0
63245,4,1,221537,221537,221538,0,1,3
63246,1,1,221538,221538,221539,0,1,0
63247,6,1,221544,221544,221545,0,1,5
63248,6,2,221550,221550,221552,0,2,5
63249,3,2,221553,221553,221555,0,2,1
63250,5,2,221558,221558,221560,0,2,3
63251,1,2,221559,221560,221562,1,3,0
63252,5,1,221564,221564,221565,0,1,2
63253,6,1,221570,221570,221571,0,1,5
63254,4,2,221574,221574,221576,0,2,3
63255,3,3,221577,221577,221580,0,3,1
63256,6,2,221583,221583,221585,0,2,3
63257,6,3,221589,221589,221592,0,3,4
63258,6,2,221595,221595,221597,0,2,3
63259,3,3,221598,221598,221601,0,3,1
63260,6,2,221604,221604,221606,0,2,3
63261,4,1,221608,221608,221609,0,1,2
63262,3,2,221611,221611,221613,0,2,2
63263,1,1,221612,221613,221614,1,2,0
63264,4,3,221616,221616,221619,0,3,2
63265,1,2,221617,221619,221621,2,4,0
63266,2,3,221619,221621,221624,2,5,0
63267,4,3,221623,221624,221627,1,4,0
63268,5,1,221628,221628,221629,0,1,1
63269,6,1,221634,221634,221635,0,1,5
63270,3,2,221637,221637,221639,0,2,2
63271,5,2,221642,221642,221644,0,2,3
63272,1,2,221643,221644,221646,1,3,0
63273,1,2,221644,221646,221648,2,4,0
63274,5,2,221649,221649,221651,0,2,1
63275,3,2,221652,221652,221654,0,2,1
63276,4,3,221656,221656,221659,0,3,2
63277,1,1,221657,221659,221660,2,3,0
63278,2,2,221659,221660,221662,1,3,0
63279,3,2,221662,221662,221664,0,2,0
63280,4,2,221666,221666,221668,0,2,2
63281,4,1,221670,221670,221671,0,1,2
63282,1,1,221671,221671,221672,0,1,0
63283,5,2,221676,221676,221678,0,2,4
63284,6,1,221682,221682,221683,0,1,4
63285,2,1,221684,221684,221685,0,1,1
63286,4,2,221688,221688,221690,0,2,3
63287,2,2,221690,221690,221692,0,2,0
63288,1,3,221691,221692,221695,1,4,0
63289,1,1,221692,221695,221696,3,4,0
63290,1,1,221693,221696,221697,3,4,0
63291,2,3,221695,221697,221700,2,5,0
63292,3,3,221698,221700,221703,2,5,0
63293,5,1,221703,221703,221704,0,1,0
63294,5,1,221708,221708,221709,0,1,4
63295,1,3,221709,221709,221712,0,3,0
63296,1,1,221710,221712,221713,2,3,0
63297,3,1,221713,221713,221714,0,1,0
63298,4,3,221717,221717,221720,0,3,3
63299,4,3,221721,221721,221724,0,3,1
63300,1,3,221722,221724,221727,2,5,0
63301,4,2,221726,221727,221729,1,3,0
63302,3,3,221729,221729,221732,0,3,0
63303,3,1,221732,221732,221733,0,1,0
63304,2,3,221734,221734,221737,0,3,1
63305,6,1,221740,221740,221741,0,1,3
63306,5,1,221745,221745,221746,0,1,4
63307,3,3,221748,221748,221751,0,3,2
63308,6,2,221754,221754,221756,0,2,3
63309,1,2,221755,221756,221758,1,3,0
63310,6,3,221761,221761,221764,0,3,3
63311,1,1,221762,221764,221765,2,3,0
63312,5,1,221767,221767,221768,0,1,2
63313,6,2,221773,221773,221775,0,2,5
63314,3,3,221776,221776,221779,0,3,1
63315,5,2,221781,221781,221783,0,2,2
63316,6,1,221787,221787,221788,0,1,4
63317,1,3,221788,221788,221791,0,3,0
63318,5,2,221793,221793,221795,0,2,2
63319,3,3,221796,221796,221799,0,3,1
63320,6,2,221802,221802,221804,0,2,3
63321,5,2,221807,221807,221809,0,2,3
63322,1,2,221808,221809,221811,1,3,0
63323,4,3,221812,221812,221815,0,3,1
63324,3,3,221815,221815,221818,0,3,0
63325,6,2,221821,221821,221823,0,2,3
63326,2,3,221823,221823,221826,0,3,0
63327,6,1,221829,221829,221830,0,1,3
63328,5,2,221834,221834,221836,0,2,4
63329,6,3,221840,221840,221843,0,3,4
63330,3,2,221843,221843,221845,0,2,0
63331,5,2,221848,221848,221850,0,2,3
63332,5,1,221853,221853,221854,0,1,3
63333,6,2,221859,221859,221861,0,2,5
63334,1,2,221860,221861,221863,1,3,0
63335,5,3,221865,221865,221868,0,3,2
63336,3,1,221868,221868,221869,0,1,0
63337,6,2,221874,221874,221876,0,2,5
63338,4,3,221878,221878,221881,0,3,2
63339,2,3,221880,221881,221884,1,4,0
63340,1,1,221881,221884,221885,3,4,0
63341,6,3,221887,221887,221890,0,3,2
63342,6,3,221893,221893,221896,0,3,3
63343,2,1,221895,221896,221897,1,2,0
63344,5,2,221900,221900,221902,0,2,3
63345,1,1,221901,221902,221903,1,2,0
63346,4,2,221905,221905,221907,0,2,2
63347,3,2,221908,221908,221910,0,2,1
63348,2,2,221910,221910,221912,0,2,0
63349,2,2,221912,221912,221914,0,2,0
63350,4,3,221916,221916,221919,0,3,2
63351,5,1,221921,221921,221922,0,1,2
63352,2,1,221923,221923,221924,0,1,1
63353,5,1,221928,221928,221929,0,1,4
63354,1,2,221929,221929,221931,0,2,0
63355,5,2,221934,221934,221936,0,2,3
63356,6,2,221940,221940,221942,0,2,4
63357,5,2,221945,221945,221947,0,2,3
63358,1,2,221946,221947,221949,1,3,0
63359,4,2,221950,221950,221952,0,2,1
63360,6,1,221956,221956,221957,0,1,4
63361,1,1,221957,221957,221958,0,1,0
63362,1,3,221958,221958,221961,0,3,0
63363,4,1,221962,221962,221963,0,1,1
63364,2,1,221964,221964,221965,0,1,1
63365,2,1,221966,221966,221967,0,1,1
63366,6,3,221972,221972,221975,0,3,5
63367,5,3,221977,221977,221980,0,3,2
63368,4,1,221981,221981,221982,0,1,1
63369,4,2,221985,221985,221987,0,2,3
63370,4,1,221989,221989,221990,0,1,2
63371,5,3,221994,221994,221997,0,3,4
63372,2,3,221996,221997,222000,1,4,0
63373,3,2,221999,222000,222002,1,3,0
63374,2,3,222001,222002,222005,1,4,0
63375,2,2,222003,222005,222007,2,4,0
63376,3,2,222006,222007,222009,1,3,0
63377,3,1,222009,222009,222010,0,1,0
63378,4,3,222013,222013,222016,0,3,3
63379,2,2,222015,222016,222018,1,3,0
63380,2,1,222017,222018,222019,1,2,0
63381,3,2,222020,222020,222022,0,2,1
63382,6,2,222026,222026,222028,0,2,4
63383,6,3,222032,222032,222035,0,3,4
63384,4,3,222036,222036,222039,0,3,1
63385,4,1,222040,222040,222041,0,1,1
63386,5,3,222045,222045,222048,0,3,4
63387,4,3,222049,222049,222052,0,3,1
63388,1,3,222050,222052,222055,2,5,0
63389,4,1,222054,222055,222056,1,2,0
63390,3,3,222057,222057,222060,0,3,1
63391,4,2,222061,222061,222063,0,2,1
63392,5,3,222066,222066,222069,0,3,3
63393,2,1,222068,222069,222070,1,2,0
63394,2,2,222070,222070,222072,0,2,0
63395,6,1,222076,222076,222077,0,1,4
63396,6,3,222082,222082,222085,0,3,5
63397,3,3,222085,222085,222088,0,3,0
63398,3,1,222088,222088,222089,0,1,0
63399,1,2,222089,222089,222091,0,2,0
63400,6,2,222095,222095,222097,0,2,4
63401,3,1,222098,222098,222099,0,1,1
63402,4,1,222102,222102,222103,0,1,3
63403,2,2,222104,222104,222106,0,2,1
63404,2,2,222106,222106,222108,0,2,0
63405,4,2,222110,222110,222112,0,2,2
63406,3,3,222113,222113,222116,0,3,1
63407,3,1,222116,222116,222117,0,1,0
63408,6,2,222122,222122,222124,0,2,5
63409,1,1,222123,222124,222125,1,2,0
63410,1,3,222124,222125,222128,1,4,0
63411,4,3,222128,222128,222131,0,3,0
63412,6,2,222134,222134,222136,0,2,3
63413,2,1,222136,222136,222137,0,1,0
63414,2,3,222138,222138,222141,0,3,1
63415,1,3,222139,222141,222144,2,5,0
63416,4,2,222143,222144,222146,1,3,0
63417,6,1,222149,222149,222150,0,1,3
63418,1,2,222150,222150,222152,0,2,0
63419,6,3,222156,222156,222159,0,3,4
63420,2,2,222158,222159,222161,1,3,0
63421,4,1,222162,222162,222163,0,1,1
63422,2,2,222164,222164,222166,0,2,1
63423,2,3,222166,222166,222169,0,3,0
63424,4,3,222170,222170,222173,0,3,1
63425,2,2,222172,222173,222175,1,3,0
63426,1,1,222173,222175,222176,2,3,0
63427,1,2,222174,222176,222178,2,4,0
63428,3,3,222177,222178,222181,1,4,0
63429,2,1,222179,222181,222182,2,3,0
63430,1,2,222180,222182,222184,2,4,0
63431,4,3,222184,222184,222187,0,3,0
63432,4,3,222188,222188,222191,0,3,1
63433,6,3,222194,222194,222197,0,3,3
63434,6,2,222200,222200,222202,0,2,3
63435,1,1,222201,222202,222203,1,2,0
63436,2,2,222203,222203,222205,0,2,0
63437,4,3,222207,222207,222210,0,3,2
63438,6,2,222213,222213,222215,0,2,3
63439,5,3,222218,222218,222221,0,3,3
63440,6,2,222224,222224,222226,0,2,3
63441,2,2,222226,222226,222228,0,2,0
63442,2,1,222228,222228,222229,0,1,0
63443,3,2,222231,222231,222233,0,2,2
63444,4,1,222235,222235,222236,0,1,2
63445,5,1,222240,222240,222241,0,1,4
63446,4,1,222244,222244,222245,0,1,3
63447,1,2,222245,222245,222247,0,2,0
63448,2,1,222247,222247,222248,0,1,0
63449,4,1,222251,222251,222252,0,1,3
63450,3,1,222254,222254,222255,0,1,2
63451,2,3,222256,222256,222259,0,3,1
63452,2,3,222258,222259,222262,1,4,0
63453,3,3,222261,222262,222265,1,4,0
63454,1,2,222262,222265,222267,3,5,0
63455,2,1,222264,222267,222268,3,4,0
63456,3,1,222267,222268,222269,1,2,0
63457,5,2,222272,222272,222274,0,2,3
63458,4,3,222276,222276,222279,0,3,2
63459,1,2,222277,222279,222281,2,4,0
63460,4,1,222281,222281,222282,0,1,0
63461,5,2,222286,222286,222288,0,2,4
63462,4,1,222290,222290,222291,0,1,2
63463,4,3,222294,222294,222297,0,3,3
63464,2,3,222296,222297,222300,1,4,0
63465,4,2,222300,222300,222302,0,2,0
63466,6,1,222306,222306,222307,0,1,4
63467,5,2,222311,222311,222313,0,2,4
63468,3,3,222314,222314,222317,0,3,1
63469,4,1,222318,222318,222319,0,1,1
63470,4,1,222322,222322,222323,0,1,3
63471,5,2,222327,222327,222329,0,2,4
63472,1,1,222328,222329,222330,1,2,0
63473,2,2,222330,222330,222332,0,2,0
63474,3,2,222333,222333,222335,0,2,1
63475,3,2,222336,222336,222338,0,2,1
63476,5,1,222341,222341,222342,0,1,3
63477,5,3,222346,222346,222349,0,3,4
63478,2,2,222348,222349,222351,1,3,0
63479,2,1,222350,222351,222352,1,2,0
63480,4,1,222354,222354,222355,0,1,2
63481,3,3,222357,222357,222360,0,3,2
63482,3,1,222360,222360,222361,0,1,0
63483,1,2,222361,222361,222363,0,2,0
63484,2,2,222363,222363,222365,0,2,0
63485,1,1,222364,222365,222366,1,2,0
63486,2,2,222366,222366,222368,0,2,0
63487,4,2,222370,222370,222372,0,2,2
63488,6,3,222376,222376,222379,0,3,4
63489,5,2,222381,222381,222383,0,2,2
63490,4,3,222385,222385,222388,0,3,2
63491,5,1,222390,222390,222391,0,1,2
63492,6,2,222396,222396,222398,0,2,5
63493,6,1,222402,222402,222403,0,1,4
63494,5,3,222407,222407,222410,0,3,4
63495,4,2,222411,222411,222413,0,2,1
63496,5,2,222416,222416,222418,0,2,3
63497,6,2,222422,222422,222424,0,2,4
63498,5,1,222427,222427,222428,0,1,3
63499,1,3,222428,222428,222431,0,3,0
63500,6,3,222434,222434,222437,0,3,3
63501,1,2,222435,222437,222439,2,4,0
63502,4,1,222439,222439,222440,0,1,0
63503,3,3,222442,222442,222445,0,3,2
63504,6,3,222448,222448,222451,0,3,3
63505,5,1,222453,222453,222454,0,1,2
63506,3,1,222456,222456,222457,0,1,2
63507,5,1,222461,222461,222462,0,1,4
63508,3,1,222464,222464,222465,0,1,2
63509,6,1,222470,222470,222471,0,1,5
63510,6,1,222476,222476,222477,0,1,5
63511,5,2,222481,222481,222483,0,2,4
63512,2,2,222483,222483,222485,0,2,0
63513,3,2,222486,222486,222488,0,2,1
63514,4,2,222490,222490,222492,0,2,2
63515,5,2,222495,222495,222497,0,2,3
63516,1,3,222496,222497,222500,1,4,0
63517,4,2,222500,222500,222502,0,2,0
63518,3,2,222503,222503,222505,0,2,1
63519,3,1,222506,222506,222507,0,1,1
63520,4,3,222510,222510,222513,0,3,3
63521,2,2,222512,222513,222515,1,3,0
63522,6,1,222518,222518,222519,0,1,3
63523,1,1,222519,222519,222520,0,1,0
63524,5,2,222524,222524,222526,0,2,4
63525,2,3,222526,222526,222529,0,3,0
63526,6,1,222532,222532,222533,0,1,3
63527,4,3,222536,222536,222539,0,3,3
63528,4,1,222540,222540,222541,0,1,1
63529,5,2,222545,222545,222547,0,2,4
63530,3,2,222548,222548,222550,0,2,1
63531,6,1,222554,222554,222555,0,1,4
63532,1,1,222555,222555,222556,0,1,0
63533,1,1,222556,222556,222557,0,1,0
63534,1,2,222557,222557,222559,0,2,0
63535,1,2,222558,222559,222561,1,3,0
63536,5,2,222563,222563,222565,0,2,2
63537,1,1,222564,222565,222566,1,2,0
63538,2,1,222566,222566,222567,0,1,0
63539,3,1,222569,222569,222570,0,1,2
63540,2,3,222571,222571,222574,0,3,1
63541,5,2,222576,222576,222578,0,2,2
63542,2,3,222578,222578,222581,0,3,0
63543,2,3,222580,222581,222584,1,4,0
63544,2,2,222582,222584,222586,2,4,0
63545,5,2,222587,222587,222589,0,2,1
63546,2,2,222589,222589,222591,0,2,0
63547,1,2,222590,222591,222593,1,3,0
63548,5,2,222595,222595,222597,0,2,2
63549,3,1,222598,222598,222599,0,1,1
63550,1,2,222599,222599,222601,0,2,0
63551,4,3,222603,222603,222606,0,3,2
63552,3,3,222606,222606,222609,0,3,0
63553,2,1,222608,222609,222610,1,2,0
63554,4,1,222612,222612,222613,0,1,2
63555,4,1,222616,222616,222617,0,1,3
63556,6,3,222622,222622,222625,0,3,5
63557,6,3,222628,222628,222631,0,3,3
63558,4,3,222632,222632,222635,0,3,1
63559,6,2,222638,222638,222640,0,2,3
63560,1,1,222639,222640,222641,1,2,0
63561,4,3,222643,222643,222646,0,3,2
63562,4,2,222647,222647,222649,0,2,1
63563,3,1,222650,222650,222651,0,1,1
63564,1,1,222651,222651,222652,0,1,0
63565,2,1,222653,222653,222654,0,1,1
63566,3,2,222656,222656,222658,0,2,2
63567,2,2,222658,222658,222660,0,2,0
63568,1,3,222659,222660,222663,1,4,0
63569,6,2,222665,222665,222667,0,2,2
63570,5,1,222670,222670,222671,0,1,3
63571,6,2,222676,222676,222678,0,2,5
63572,6,2,222682,222682,222684,0,2,4
63573,2,1,222684,222684,222685,0,1,0
63574,5,3,222689,222689,222692,0,3,4
63575,6,2,222695,222695,222697,0,2,3
63576,4,1,222699,222699,222700,0,1,2
63577,4,1,222703,222703,222704,0,1,3
63578,3,3,222706,222706,222709,0,3,2
63579,6,2,222712,222712,222714,0,2,3
63580,1,1,222713,222714,222715,1,2,0
63581,2,3,222715,222715,222718,0,3,0
63582,5,1,222720,222720,222721,0,1,2
63583,3,1,222723,222723,222724,0,1,2
63584,4,3,222727,222727,222730,0,3,3
63585,1,2,222728,222730,222732,2,4,0
63586,3,3,222731,222732,222735,1,4,0
63587,5,3,222736,222736,222739,0,3,1
63588,4,2,222740,222740,222742,0,2,1
63589,4,2,222744,222744,222746,0,2,2
63590,5,3,222749,222749,222752,0,3,3
63591,6,1,222755,222755,222756,0,1,3
63592,5,3,222760,222760,222763,0,3,4
63593,1,1,222761,222763,222764,2,3,0
63594,6,3,222767,222767,222770,0,3,3
63595,4,2,222771,222771,222773,0,2,1
63596,1,1,222772,222773,222774,1,2,0
63597,2,2,222774,222774,222776,0,2,0
63598,2,2,222776,222776,222778,0,2,0
63599,3,1,222779,222779,222780,0,1,1
63600,5,1,222784,222784,222785,0,1,4
63601,3,1,222787,222787,222788,0,1,2
63602,1,2,222788,222788,222790,0,2,0
63603,6,1,222794,222794,222795,0,1,4
63604,3,1,222797,222797,222798,0,1,2
63605,5,1,222802,222802,222803,0,1,4
63606,5,3,222807,222807,222810,0,3,4
63607,4,1,222811,222811,222812,0,1,1
63608,4,3,222815,222815,222818,0,3,3
63609,6,2,222821,222821,222823,0,2,3
63610,2,1,222823,222823,222824,0,1,0
63611,2,1,222825,222825,222826,0,1,1
63612,3,1,222828,222828,222829,0,1,2
63613,4,1,222832,222832,222833,0,1,3
63614,1,1,222833,222833,222834,0,1,0
63615,3,2,222836,222836,222838,0,2,2
63616,6,2,222842,222842,222844,0,2,4
63617,5,2,222847,222847,222849,0,2,3
63618,5,3,222852,222852,222855,0,3,3
63619,5,3,222857,222857,222860,0,3,2
63620,1,2,222858,222860,222862,2,4,0
63621,1,2,222859,222862,222864,3,5,0
63622,4,3,222863,222864,222867,1,4,0
63623,2,3,222865,222867,222870,2,5,0
63624,6,1,222871,222871,222872,0,1,1
63625,3,3,222874,222874,222877,0,3,2
63626,4,3,222878,222878,222881,0,3,1
63627,4,1,222882,222882,222883,0,1,1
63628,2,1,222884,222884,222885,0,1,1
63629,1,2,222885,222885,222887,0,2,0
63630,5,2,222890,222890,222892,0,2,3
63631,4,1,222894,222894,222895,0,1,2
63632,2,1,222896,222896,222897,0,1,1
63633,5,3,222901,222901,222904,0,3,4
63634,4,2,222905,222905,222907,0,2,1
63635,4,2,222909,222909,222911,0,2,2
63636,6,3,222915,222915,222918,0,3,4
63637,4,2,222919,222919,222921,0,2,1
63638,1,1,222920,222921,222922,1,2,0
63639,4,3,222924,222924,222927,0,3,2
63640,4,2,222928,222928,222930,0,2,1
63641,4,3,222932,222932,222935,0,3,2
63642,2,1,222934,222935,222936,1,2,0
63643,4,2,222938,222938,222940,0,2,2
63644,3,1,222941,222941,222942,0,1,1
63645,1,2,222942,222942,222944,0,2,0
63646,5,3,222947,222947,222950,0,3,3
63647,3,2,222950,222950,222952,0,2,0
63648,5,3,222955,222955,222958,0,3,3
63649,1,2,222956,222958,222960,2,4,0
63650,1,3,222957,222960,222963,3,6,0
63651,1,1,222958,222963,222964,5,6,0
63652,4,2,222962,222964,222966,2,4,0
63653,6,3,222968,222968,222971,0,3,2
63654,1,3,222969,222971,222974,2,5,0
63655,3,2,222972,222974,222976,2,4,0
63656,1,2,222973,222976,222978,3,5,0
63657,5,3,222978,222978,222981,0,3,0
63658,4,3,222982,222982,222985,0,3,1
63659,1,1,222983,222985,222986,2,3,0
63660,6,3,222989,222989,222992,0,3,3
63661,2,2,222991,222992,222994,1,3,0
63662,2,1,222993,222994,222995,1,2,0
63663,6,1,222999,222999,223000,0,1,4
63664,3,1,223002,223002,223003,0,1,2
63665,6,1,223008,223008,223009,0,1,5
63666,4,3,223012,223012,223015,0,3,3
63667,5,1,223017,223017,223018,0,1,2
63668,1,1,223018,223018,223019,0,1,0
63669,3,2,223021,223021,223023,0,2,2
63670,4,3,223025,223025,223028,0,3,2
63671,6,2,223031,223031,223033,0,2,3
63672,1,3,223032,223033,223036,1,4,0
63673,3,1,223035,223036,223037,1,2,0
63674,2,1,223037,223037,223038,0,1,0
63675,6,2,223043,223043,223045,0,2,5
63676,5,3,223048,223048,223051,0,3,3
63677,2,3,223050,223051,223054,1,4,0
63678,4,3,223054,223054,223057,0,3,0
63679,6,2,223060,223060,223062,0,2,3
63680,4,3,223064,223064,223067,0,3,2
63681,6,1,223070,223070,223071,0,1,3
63682,2,2,223072,223072,223074,0,2,1
63683,2,3,223074,223074,223077,0,3,0
63684,1,3,223075,223077,223080,2,5,0
63685,6,1,223081,223081,223082,0,1,1
63686,5,2,223086,223086,223088,0,2,4
63687,3,1,223089,223089,223090,0,1,1
63688,6,3,223095,223095,223098,0,3,5
63689,5,1,223100,223100,223101,0,1,2
63690,5,2,223105,223105,223107,0,2,4
63691,3,1,223108,223108,223109,0,1,1
63692,6,1,223114,223114,223115,0,1,5
63693,3,3,223117,223117,223120,0,3,2
63694,1,2,223118,223120,223122,2,4,0
63695,6,3,223124,223124,223127,0,3,2
63696,5,1,223129,223129,223130,0,1,2
63697,1,1,223130,223130,223131,0,1,0
63698,5,3,223135,223135,223138,0,3,4
63699,2,2,223137,223138,223140,1,3,0
63700,2,2,223139,223140,223142,1,3,0
63701,5,2,223144,223144,223146,0,2,2
63702,5,1,223149,223149,223150,0,1,3
63703,3,1,223152,223152,223153,0,1,2
63704,6,1,223158,223158,223159,0,1,5
63705,1,1,223159,223159,223160,0,1,0
63706,5,2,223164,223164,223166,0,2,4
63707,5,2,223169,223169,223171,0,2,3
63708,6,3,223175,223175,223178,0,3,4
63709,6,3,223181,223181,223184,0,3,3
63710,6,1,223187,223187,223188,0,1,3
63711,4,2,223191,223191,223193,0,2,3
63712,4,2,223195,223195,223197,0,2,2
63713,3,2,223198,223198,223200,0,2,1
63714,6,3,223204,223204,223207,0,3,4
63715,6,3,223210,223210,223213,0,3,3
63716,4,3,223214,223214,223217,0,3,1
63717,3,1,223217,223217,223218,0,1,0
63718,2,1,223219,223219,223220,0,1,1
63719,4,1,223223,223223,223224,0,1,3
63720,1,3,223224,223224,223227,0,3,0
63721,5,2,223229,223229,223231,0,2,2
63722,4,3,223233,223233,223236,0,3,2
63723,5,3,223238,223238,223241,0,3,2
63724,6,1,223244,223244,223245,0,1,3
63725,6,1,223250,223250,223251,0,1,5
63726,6,3,223256,223256,223259,0,3,5
63727,2,3,223258,223259,223262,1,4,0
63728,6,3,223264,223264,223267,0,3,2
63729,3,3,223267,223267,223270,0,3,0
63730,3,3,223270,223270,223273,0,3,0
63731,3,2,223273,223273,223275,0,2,0
63732,3,1,223276,223276,223277,0,1,1
63733,5,3,223281,223281,223284,0,3,4
63734,4,1,223285,223285,223286,0,1,1
63735,6,3,223291,223291,223294,0,3,5
63736,3,3,223294,223294,223297,0,3,0
63737,4,2,223298,223298,223300,0,2,1
63738,3,3,223301,223301,223304,0,3,1
63739,2,2,223303,223304,223306,1,3,0
63740,2,2,223305,223306,223308,1,3,0
63741,1,3,223306,223308,223311,2,5,0
63742,2,2,223308,223311,223313,3,5,0
63743,5,1,223313,223313,223314,0,1,0
63744,6,2,223319,223319,223321,0,2,5
63745,3,1,223322,223322,223323,0,1,1
63746,2,1,223324,223324,223325,0,1,1
63747,1,2,223325,223325,223327,0,2,0
63748,2,2,223327,223327,223329,0,2,0
63749,2,2,223329,223329,223331,0,2,0
63750,4,3,223333,223333,223336,0,3,2
63751,5,1,223338,223338,223339,0,1,2
63752,3,3,223341,223341,223344,0,3,2
63753,5,1,223346,223346,223347,0,1,2
63754,6,2,223352,223352,223354,0,2,5
63755,2,1,223354,223354,223355,0,1,0
63756,1,3,223355,223355,223358,0,3,0
63757,6,3,223361,223361,223364,0,3,3
63758,6,3,223367,223367,223370,0,3,3
63759,4,1,223371,223371,223372,0,1,1
63760,2,2,223373,223373,223375,0,2,1
63761,1,2,223374,223375,223377,1,3,0
63762,6,3,223380,223380,223383,0,3,3
63763,6,3,223386,223386,223389,0,3,3
63764,6,3,223392,223392,223395,0,3,3
63765,5,3,223397,223397,223400,0,3,2
63766,5,1,223402,223402,223403,0,1,2
63767,4,2,223406,223406,223408,0,2,3
63768,6,1,223412,223412,223413,0,1,4
63769,2,3,223414,223414,223417,0,3,1
63770,6,3,223420,223420,223423,0,3,3
63771,5,1,223425,223425,223426,0,1,2
63772,5,1,223430,223430,223431,0,1,4
63773,3,3,223433,223433,223436,0,3,2
63774,4,2,223437,223437,223439,0,2,1
63775,5,3,223442,223442,223445,0,3,3
63776,5,3,223447,223447,223450,0,3,2
63777,2,3,223449,223450,223453,1,4,0
63778,3,3,223452,223453,223456,1,4,0
63779,4,3,223456,223456,223459,0,3,0
63780,3,1,223459,223459,223460,0,1,0
63781,3,3,223462,223462,223465,0,3,2
63782,5,1,223467,223467,223468,0,1,2
63783,1,1,223468,223468,223469,0,1,0
63784,5,3,223473,223473,223476,0,3,4
63785,5,3,223478,223478,223481,0,3,2
63786,3,1,223481,223481,223482,0,1,0
63787,3,1,223484,223484,223485,0,1,2
63788,2,2,223486,223486,223488,0,2,1
63789,1,3,223487,223488,223491,1,4,0
63790,4,3,223491,223491,223494,0,3,0
63791,6,2,223497,223497,223499,0,2,3
63792,3,1,223500,223500,223501,0,1,1
63793,4,1,223504,223504,223505,0,1,3
63794,3,3,223507,223507,223510,0,3,2
63795,3,1,223510,223510,223511,0,1,0
63796,6,3,223516,223516,223519,0,3,5
63797,4,3,223520,223520,223523,0,3,1
63798,5,2,223525,223525,223527,0,2,2
63799,4,3,223529,223529,223532,0,3,2
63800,1,2,223530,223532,223534,2,4,0
63801,6,1,223536,223536,223537,0,1,2
63802,6,3,223542,223542,223545,0,3,5
63803,3,1,223545,223545,223546,0,1,0
63804,4,2,223549,223549,223551,0,2,3
63805,6,3,223555,223555,223558,0,3,4
63806,1,3,223556,223558,223561,2,5,0
63807,1,3,223557,223561,223564,4,7,0
63808,5,2,223562,223564,223566,2,4,0
63809,5,1,223567,223567,223568,0,1,1
63810,2,2,223569,223569,223571,0,2,1
63811,2,3,223571,223571,223574,0,3,0
63812,3,3,223574,223574,223577,0,3,0
63813,1,2,223575,223577,223579,2,4,0
63814,3,1,223578,223579,223580,1,2,0
63815,6,2,223584,223584,223586,0,2,4
63816,5,1,223589,223589,223590,0,1,3
63817,2,3,223591,223591,223594,0,3,1
63818,2,2,223593,223594,223596,1,3,0
63819,5,2,223598,223598,223600,0,2,2
63820,5,2,223603,223603,223605,0,2,3
63821,5,3,223608,223608,223611,0,3,3
63822,3,1,223611,223611,223612,0,1,0
63823,3,2,223614,223614,223616,0,2,2
63824,2,1,223616,223616,223617,0,1,0
63825,3,3,223619,223619,223622,0,3,2
63826,1,3,223620,223622,223625,2,5,0
63827,5,2,223625,223625,223627,0,2,0
63828,5,3,223630,223630,223633,0,3,3
63829,6,3,223636,223636,223639,0,3,3
63830,4,1,223640,223640,223641,0,1,1
63831,3,2,223643,223643,223645,0,2,2
63832,4,3,223647,223647,223650,0,3,2
63833,2,2,223649,223650,223652,1,3,0
63834,3,2,223652,223652,223654,0,2,0
63835,5,3,223657,223657,223660,0,3,3
63836,6,3,223663,223663,223666,0,3,3
63837,5,3,223668,223668,223671,0,3,2
63838,5,3,223673,223673,223676,0,3,2
63839,1,2,223674,223676,223678,2,4,0
63840,6,2,223680,223680,223682,0,2,2
63841,4,3,223684,223684,223687,0,3,2
63842,4,2,223688,223688,223690,0,2,1
63843,6,2,223694,223694,223696,0,2,4
63844,6,1,223700,223700,223701,0,1,4
63845,4,3,223704,223704,223707,0,3,3
63846,5,3,223709,223709,223712,0,3,2
63847,3,3,223712,223712,223715,0,3,0
63848,4,1,223716,223716,223717,0,1,1
63849,3,2,223719,223719,223721,0,2,2
63850,1,2,223720,223721,223723,1,3,0
63851,6,2,223726,223726,223728,0,2,3
63852,2,1,223728,223728,223729,0,1,0
63853,4,2,223732,223732,223734,0,2,3
63854,1,3,223733,223734,223737,1,4,0
63855,4,2,223737,223737,223739,0,2,0
63856,2,1,223739,223739,223740,0,1,0
63857,5,3,223744,223744,223747,0,3,4
63858,3,1,223747,223747,223748,0,1,0
63859,3,3,223750,223750,223753,0,3,2
63860,2,1,223752,223753,223754,1,2,0
63861,2,2,223754,223754,223756,0,2,0
63862,3,2,223757,223757,223759,0,2,1
63863,5,1,223762,223762,223763,0,1,3
63864,2,1,223764,223764,223765,0,1,1
63865,1,3,223765,223765,223768,0,3,0
63866,6,3,223771,223771,223774,0,3,3
63867,1,3,223772,223774,223777,2,5,0
63868,2,1,223774,223777,223778,3,4,0
63869,6,1,223780,223780,223781,0,1,2
63870,3,3,223783,223783,223786,0,3,2
63871,3,3,223786,223786,223789,0,3,0
63872,5,1,223791,223791,223792,0,1,2
63873,2,3,223793,223793,223796,0,3,1
63874,5,3,223798,223798,223801,0,3,2
63875,6,3,223804,223804,223807,0,3,3
63876,5,1,223809,223809,223810,0,1,2
63877,1,2,223810,223810,223812,0,2,0
63878,3,2,223813,223813,223815,0,2,1
63879,4,3,223817,223817,223820,0,3,2
63880,5,2,223822,223822,223824,0,2,2
63881,3,3,223825,223825,223828,0,3,1
63882,3,2,223828,223828,223830,0,2,0
63883,2,1,223830,223830,223831,0,1,0
63884,4,2,223834,223834,223836,0,2,3
63885,3,1,223837,223837,223838,0,1,1
63886,4,1,223841,223841,223842,0,1,3
63887,5,2,223846,223846,223848,0,2,4
63888,3,2,223849,223849,223851,0,2,1
63889,1,1,223850,223851,223852,1,2,0
63890,6,1,223856,223856,223857,0,1,4
63891,2,2,223858,223858,223860,0,2,1
63892,5,3,223863,223863,223866,0,3,3
63893,3,3,223866,223866,223869,0,3,0
63894,4,2,223870,223870,223872,0,2,1
63895,4,3,223874,223874,223877,0,3,2
63896,6,2,223880,223880,223882,0,2,3
63897,4,2,223884,223884,223886,0,2,2
63898,3,1,223887,223887,223888,0,1,1
63899,2,1,223889,223889,223890,0,1,1
63900,1,1,223890,223890,223891,0,1,0
63901,1,1,223891,223891,223892,0,1,0
63902,4,2,223895,223895,223897,0,2,3
63903,1,2,223896,223897,223899,1,3,0
63904,2,3,223898,223899,223902,1,4,0
63905,4,2,223902,223902,223904,0,2,0
63906,3,3,223905,223905,223908,0,3,1
63907,2,1,223907,223908,223909,1,2,0
63908,1,2,223908,223909,223911,1,3,0
63909,2,2,223910,223911,223913,1,3,0
63910,3,2,223913,223913,223915,0,2,0
63911,5,1,223918,223918,223919,0,1,3
63912,4,3,223922,223922,223925,0,3,3
63913,3,2,223925,223925,223927,0,2,0
63914,5,1,223930,223930,223931,0,1,3
63915,4,2,223934,223934,223936,0,2,3
63916,2,1,223936,223936,223937,0,1,0
63917,3,1,223939,223939,223940,0,1,2
63918,4,2,223943,223943,223945,0,2,3
63919,4,3,223947,223947,223950,0,3,2
63920,6,3,223953,223953,223956,0,3,3
63921,1,1,223954,223956,223957,2,3,0
63922,1,1,223955,223957,223958,2,3,0
63923,6,3,223961,223961,223964,0,3,3
63924,4,1,223965,223965,223966,0,1,1
63925,2,3,223967,223967,223970,0,3,1
63926,3,2,223970,223970,223972,0,2,0
63927,2,3,223972,223972,223975,0,3,0
63928,6,3,223978,223978,223981,0,3,3
63929,3,2,223981,223981,223983,0,2,0
63930,3,2,223984,223984,223986,0,2,1
63931,4,2,223988,223988,223990,0,2,2
63932,6,2,223994,223994,223996,0,2,4
63933,6,1,224000,224000,224001,0,1,4
63934,5,2,224005,224005,224007,0,2,4
63935,5,3,224010,224010,224013,0,3,3
63936,4,2,224014,224014,224016,0,2,1
63937,5,3,224019,224019,224022,0,3,3
63938,6,1,224025,224025,224026,0,1,3
63939,5,2,224030,224030,224032,0,2,4
63940,1,1,224031,224032,224033,1,2,0
63941,5,1,224036,224036,224037,0,1,3
63942,2,1,224038,224038,224039,0,1,1
63943,4,3,224042,224042,224045,0,3,3
63944,5,3,224047,224047,224050,0,3,2
63945,2,3,224049,224050,224053,1,4,0
63946,5,2,224054,224054,224056,0,2,1
63947,5,2,224059,224059,224061,0,2,3
63948,1,2,224060,224061,224063,1,3,0
63949,2,1,224062,224063,224064,1,2,0
63950,2,2,224064,224064,224066,0,2,0
63951,2,1,224066,224066,224067,0,1,0
63952,6,2,224072,224072,224074,0,2,5
63953,2,1,224074,224074,224075,0,1,0
63954,5,2,224079,224079,224081,0,2,4
63955,4,2,224083,224083,224085,0,2,2
63956,6,3,224089,224089,224092,0,3,4
63957,3,2,224092,224092,224094,0,2,0
63958,5,2,224097,224097,224099,0,2,3
63959,5,2,224102,224102,224104,0,2,3
63960,1,3,224103,224104,224107,1,4,0
63961,2,2,224105,224107,224109,2,4,0
63962,4,1,224109,224109,224110,0,1,0
63963,4,1,224113,224113,224114,0,1,3
63964,4,1,224117,224117,224118,0,1,3
63965,1,3,224118,224118,224121,0,3,0
63966,1,2,224119,224121,224123,2,4,0
63967,1,2,224120,224123,224125,3,5,0
63968,5,2,224125,224125,224127,0,2,0
63969,6,3,224131,224131,224134,0,3,4
63970,3,3,224134,224134,224137,0,3,0
63971,6,3,224140,224140,224143,0,3,3
63972,1,2,224141,224143,224145,2,4,0
63973,2,3,224143,224145,224148,2,5,0
63974,6,2,224149,224149,224151,0,2,1
63975,6,2,224155,224155,224157,0,2,4
63976,3,3,224158,224158,224161,0,3,1
63977,1,3,224159,224161,224164,2,5,0
63978,6,3,224165,224165,224168,0,3,1
63979,6,2,224171,224171,224173,0,2,3
63980,4,2,224175,224175,224177,0,2,2
63981,5,2,224180,224180,224182,0,2,3
63982,1,2,224181,224182,224184,1,3,0
63983,5,3,224186,224186,224189,0,3,2
63984,3,1,224189,224189,224190,0,1,0
63985,5,3,224194,224194,224197,0,3,4
63986,2,2,224196,224197,224199,1,3,0
63987,3,3,224199,224199,224202,0,3,0
63988,6,2,224205,224205,224207,0,2,3
63989,6,3,224211,224211,224214,0,3,4
63990,5,2,224216,224216,224218,0,2,2
63991,6,3,224222,224222,224225,0,3,4
63992,2,2,224224,224225,224227,1,3,0
63993,6,3,224230,224230,224233,0,3,3
63994,5,1,224235,224235,224236,0,1,2
63995,5,2,224240,224240,224242,0,2,4
63996,6,2,224246,224246,224248,0,2,4
63997,5,1,224251,224251,224252,0,1,3
63998,3,3,224254,224254,224257,0,3,2
63999,5,3,224259,224259,224262,0,3,2
64000,2,2,224261,224262,224264,1,3,0
64001,5,1,224266,224266,224267,0,1,2
64002,4,1,224270,224270,224271,0,1,3
64003,3,3,224273,224273,224276,0,3,2
64004,4,3,224277,224277,224280,0,3,1
64005,3,3,224280,224280,224283,0,3,0
64006,6,1,224286,224286,224287,0,1,3
64007,4,2,224290,224290,224292,0,2,3
64008,1,2,224291,224292,224294,1,3,0
64009,3,1,224294,224294,224295,0,1,0
64010,2,1,224296,224296,224297,0,1,1
64011,1,1,224297,224297,224298,0,1,0
64012,5,3,224302,224302,224305,0,3,4
64013,5,1,224307,224307,224308,0,1,2
64014,3,3,224310,224310,224313,0,3,2
64015,5,3,224315,224315,224318,0,3,2
64016,1,3,224316,224318,224321,2,5,0
64017,3,3,224319,224321,224324,2,5,0
64018,4,1,224323,224324,224325,1,2,0
64019,4,2,224327,224327,224329,0,2,2
64020,5,2,224332,224332,224334,0,2,3
64021,6,1,224338,224338,224339,0,1,4
64022,2,1,224340,224340,224341,0,1,1
64023,2,1,224342,224342,224343,0,1,1
64024,3,2,224345,224345,224347,0,2,2
64025,4,1,224349,224349,224350,0,1,2
64026,1,1,224350,224350,224351,0,1,0
64027,1,3,224351,224351,224354,0,3,0
64028,3,2,224354,224354,224356,0,2,0
64029,1,1,224355,224356,224357,1,2,0
64030,6,3,224361,224361,224364,0,3,4
64031,2,1,224363,224364,224365,1,2,0
64032,1,2,224364,224365,224367,1,3,0
64033,2,2,224366,224367,224369,1,3,0
64034,4,1,224370,224370,224371,0,1,1
64035,4,1,224374,224374,224375,0,1,3
64036,2,2,224376,224376,224378,0,2,1
64037,4,2,224380,224380,224382,0,2,2
64038,5,3,224385,224385,224388,0,3,3
64039,4,2,224389,224389,224391,0,2,1
64040,2,1,224391,224391,224392,0,1,0
64041,6,1,224397,224397,224398,0,1,5
64042,1,1,224398,224398,224399,0,1,0
64043,3,2,224401,224401,224403,0,2,2
64044,5,2,224406,224406,224408,0,2,3
64045,3,2,224409,224409,224411,0,2,1
64046,4,2,224413,224413,224415,0,2,2
64047,2,2,224415,224415,224417,0,2,0
64048,4,2,224419,224419,224421,0,2,2
64049,1,3,224420,224421,224424,1,4,0
64050,4,2,224424,224424,224426,0,2,0
64051,1,1,224425,224426,224427,1,2,0
64052,5,1,224430,224430,224431,0,1,3
64053,5,2,224435,224435,224437,0,2,4
64054,1,2,224436,224437,224439,1,3,0
64055,3,3,224439,224439,224442,0,3,0
64056,6,3,224445,224445,224448,0,3,3
64057,5,2,224450,224450,224452,0,2,2
64058,1,2,224451,224452,224454,1,3,0
64059,3,1,224454,224454,224455,0,1,0
64060,1,1,224455,224455,224456,0,1,0
64061,2,2,224457,224457,224459,0,2,1
64062,6,3,224463,224463,224466,0,3,4
64063,4,3,224467,224467,224470,0,3,1
64064,2,3,224469,224470,224473,1,4,0
64065,1,3,224470,224473,224476,3,6,0
64066,6,1,224476,224476,224477,0,1,0
64067,2,2,224478,224478,224480,0,2,1
64068,3,2,224481,224481,224483,0,2,1
64069,6,2,224487,224487,224489,0,2,4
64070,6,2,224493,224493,224495,0,2,4
64071,2,1,224495,224495,224496,0,1,0
64072,5,2,224500,224500,224502,0,2,4
64073,4,1,224504,224504,224505,0,1,2
64074,5,1,224509,224509,224510,0,1,4
64075,5,1,224514,224514,224515,0,1,4
64076,2,2,224516,224516,224518,0,2,1
64077,4,2,224520,224520,224522,0,2,2
64078,3,2,224523,224523,224525,0,2,1
64079,6,3,224529,224529,224532,0,3,4
64080,6,3,224535,224535,224538,0,3,3
64081,2,1,224537,224538,224539,1,2,0
64082,4,2,224541,224541,224543,0,2,2
64083,5,1,224546,224546,224547,0,1,3
64084,3,1,224549,224549,224550,0,1,2
64085,2,2,224551,224551,224553,0,2,1
64086,5,1,224556,224556,224557,0,1,3
64087,2,2,224558,224558,224560,0,2,1
64088,5,3,224563,224563,224566,0,3,3
64089,3,3,224566,224566,224569,0,3,0
64090,4,3,224570,224570,224573,0,3,1
64091,5,2,224575,224575,224577,0,2,2
64092,1,2,224576,224577,224579,1,3,0
64093,5,3,224581,224581,224584,0,3,2
64094,1,3,224582,224584,224587,2,5,0
64095,2,3,224584,224587,224590,3,6,0
64096,1,2,224585,224590,224592,5,7,0
64097,4,2,224589,224592,224594,3,5,0
64098,3,3,224592,224594,224597,2,5,0
64099,6,1,224598,224598,224599,0,1,1
64100,3,1,224601,224601,224602,0,1,2
64101,3,3,224604,224604,224607,0,3,2
64102,6,1,224610,224610,224611,0,1,3
64103,1,2,224611,224611,224613,0,2,0
64104,1,1,224612,224613,224614,1,2,0
64105,4,1,224616,224616,224617,0,1,2
64106,2,3,224618,224618,224621,0,3,1
64107,1,2,224619,224621,224623,2,4,0
64108,2,1,224621,224623,224624,2,3,0
64109,1,2,224622,224624,224626,2,4,0
64110,5,3,224627,224627,224630,0,3,1
64111,2,2,224629,224630,224632,1,3,0
64112,5,1,224634,224634,224635,0,1,2
64113,2,1,224636,224636,224637,0,1,1
64114,4,1,224640,224640,224641,0,1,3
64115,5,1,224645,224645,224646,0,1,4
64116,5,3,224650,224650,224653,0,3,4
64117,2,2,224652,224653,224655,1,3,0
64118,6,3,224658,224658,224661,0,3,3
64119,3,2,224661,224661,224663,0,2,0
64120,6,3,224667,224667,224670,0,3,4
64121,2,2,224669,224670,224672,1,3,0
64122,4,3,224673,224673,224676,0,3,1
64123,5,3,224678,224678,224681,0,3,2
64124,4,1,224682,224682,224683,0,1,1
64125,5,2,224687,224687,224689,0,2,4
64126,1,1,224688,224689,224690,1,2,0
64127,1,3,224689,224690,224693,1,4,0
64128,2,3,224691,224693,224696,2,5,0
64129,1,2,224692,224696,224698,4,6,0
64130,4,1,224696,224698,224699,2,3,0
64131,4,2,224700,224700,224702,0,2,1
64132,1,3,224701,224702,224705,1,4,0
64133,6,3,224707,224707,224710,0,3,2
64134,6,3,224713,224713,224716,0,3,3
64135,6,3,224719,224719,224722,0,3,3
64136,5,2,224724,224724,224726,0,2,2
64137,3,2,224727,224727,224729,0,2,1
64138,5,3,224732,224732,224735,0,3,3
64139,6,2,224738,224738,224740,0,2,3
64140,5,1,224743,224743,224744,0,1,3
64141,6,3,224749,224749,224752,0,3,5
64142,6,3,224755,224755,224758,0,3,3
64143,5,2,224760,224760,224762,0,2,2
64144,4,2,224764,224764,224766,0,2,2
64145,6,3,224770,224770,224773,0,3,4
64146,1,1,224771,224773,224774,2,3,0
64147,6,1,224777,224777,224778,0,1,3
64148,1,3,224778,224778,224781,0,3,0
64149,6,1,224784,224784,224785,0,1,3
64150,1,2,224785,224785,224787,0,2,0
64151,5,3,224790,224790,224793,0,3,3
64152,1,3,224791,224793,224796,2,5,0
64153,5,1,224796,224796,224797,0,1,0
64154,4,1,224800,224800,224801,0,1,3
64155,2,3,224802,224802,224805,0,3,1
64156,4,1,224806,224806,224807,0,1,1
64157,2,3,224808,224808,224811,0,3,1
64158,6,2,224814,224814,224816,0,2,3
64159,6,3,224820,224820,224823,0,3,4
64160,2,2,224822,224823,224825,1,3,0
64161,3,3,224825,224825,224828,0,3,0
64162,4,2,224829,224829,224831,0,2,1
64163,6,1,224835,224835,224836,0,1,4
64164,5,1,224840,224840,224841,0,1,4
64165,4,3,224844,224844,224847,0,3,3
64166,3,3,224847,224847,224850,0,3,0
64167,3,2,224850,224850,224852,0,2,0
64168,2,3,224852,224852,224855,0,3,0
64169,6,1,224858,224858,224859,0,1,3
64170,4,2,224862,224862,224864,0,2,3
64171,1,1,224863,224864,224865,1,2,0
64172,1,2,224864,224865,224867,1,3,0
64173,4,1,224868,224868,224869,0,1,1
64174,3,3,224871,224871,224874,0,3,2
64175,6,2,224877,224877,224879,0,2,3
64176,5,1,224882,224882,224883,0,1,3
64177,4,2,224886,224886,224888,0,2,3
64178,4,2,224890,224890,224892,0,2,2
64179,2,1,224892,224892,224893,0,1,0
64180,5,1,224897,224897,224898,0,1,4
64181,4,3,224901,224901,224904,0,3,3
64182,5,3,224906,224906,224909,0,3,2
64183,2,1,224908,224909,224910,1,2,0
64184,4,2,224912,224912,224914,0,2,2
64185,1,2,224913,224914,224916,1,3,0
64186,3,1,224916,224916,224917,0,1,0
64187,5,2,224921,224921,224923,0,2,4
64188,3,3,224924,224924,224927,0,3,1
64189,5,2,224929,224929,224931,0,2,2
64190,3,3,224932,224932,224935,0,3,1
64191,1,2,224933,224935,224937,2,4,0
64192,6,2,224939,224939,224941,0,2,2
64193,4,2,224943,224943,224945,0,2,2
64194,1,3,224944,224945,224948,1,4,0
64195,5,2,224949,224949,224951,0,2,1
64196,3,3,224952,224952,224955,0,3,1
64197,4,2,224956,224956,224958,0,2,1
64198,2,3,224958,224958,224961,0,3,0
64199,2,3,224960,224961,224964,1,4,0
64200,4,3,224964,224964,224967,0,3,0
64201,3,3,224967,224967,224970,0,3,0
64202,4,1,224971,224971,224972,0,1,1
64203,1,1,224972,224972,224973,0,1,0
64204,5,2,224977,224977,224979,0,2,4
64205,2,3,224979,224979,224982,0,3,0
64206,6,1,224985,224985,224986,0,1,3
64207,4,1,224989,224989,224990,0,1,3
64208,4,3,224993,224993,224996,0,3,3
64209,6,3,224999,224999,225002,0,3,3
64210,6,3,225005,225005,225008,0,3,3
64211,3,2,225008,225008,225010,0,2,0
64212,4,2,225012,225012,225014,0,2,2
64213,1,2,225013,225014,225016,1,3,0
64214,4,3,225017,225017,225020,0,3,1
64215,3,3,225020,225020,225023,0,3,0
64216,1,1,225021,225023,225024,2,3,0
64217,5,1,225026,225026,225027,0,1,2
64218,1,3,225027,225027,225030,0,3,0
64219,6,1,225033,225033,225034,0,1,3
64220,2,1,225035,225035,225036,0,1,1
64221,1,3,225036,225036,225039,0,3,0
64222,4,1,225040,225040,225041,0,1,1
64223,5,1,225045,225045,225046,0,1,4
64224,5,2,225050,225050,225052,0,2,4
64225,2,1,225052,225052,225053,0,1,0
64226,5,3,225057,225057,225060,0,3,4
64227,4,3,225061,225061,225064,0,3,1
64228,5,1,225066,225066,225067,0,1,2
64229,4,3,225070,225070,225073,0,3,3
64230,1,2,225071,225073,225075,2,4,0
64231,5,3,225076,225076,225079,0,3,1
64232,3,3,225079,225079,225082,0,3,0
64233,2,2,225081,225082,225084,1,3,0
64234,3,1,225084,225084,225085,0,1,0
64235,5,1,225089,225089,225090,0,1,4
64236,2,2,225091,225091,225093,0,2,1
64237,6,2,225097,225097,225099,0,2,4
64238,1,3,225098,225099,225102,1,4,0
64239,5,1,225103,225103,225104,0,1,1
64240,6,3,225109,225109,225112,0,3,5
64241,2,3,225111,225112,225115,1,4,0
64242,2,1,225113,225115,225116,2,3,0
64243,2,3,225115,225116,225119,1,4,0
64244,3,1,225118,225119,225120,1,2,0
64245,5,1,225123,225123,225124,0,1,3
64246,6,1,225129,225129,225130,0,1,5
64247,2,3,225131,225131,225134,0,3,1
64248,6,1,225137,225137,225138,0,1,3
64249,2,2,225139,225139,225141,0,2,1
64250,5,3,225144,225144,225147,0,3,3
64251,4,3,225148,225148,225151,0,3,1
64252,2,1,225150,225151,225152,1,2,0
64253,5,1,225155,225155,225156,0,1,3
64254,1,3,225156,225156,225159,0,3,0
64255,6,1,225162,225162,225163,0,1,3
64256,1,1,225163,225163,225164,0,1,0
64257,5,1,225168,225168,225169,0,1,4
64258,1,3,225169,225169,225172,0,3,0
64259,5,1,225174,225174,225175,0,1,2
64260,1,1,225175,225175,225176,0,1,0
64261,5,3,225180,225180,225183,0,3,4
64262,6,1,225186,225186,225187,0,1,3
64263,1,1,225187,225187,225188,0,1,0
64264,6,1,225193,225193,225194,0,1,5
64265,5,2,225198,225198,225200,0,2,4
64266,2,3,225200,225200,225203,0,3,0
64267,3,3,225203,225203,225206,0,3,0
64268,4,2,225207,225207,225209,0,2,1
64269,4,1,225211,225211,225212,0,1,2
64270,4,2,225215,225215,225217,0,2,3
64271,4,3,225219,225219,225222,0,3,2
64272,2,3,225221,225222,225225,1,4,0
64273,1,1,225222,225225,225226,3,4,0
64274,1,3,225223,225226,225229,3,6,0
64275,4,3,225227,225229,225232,2,5,0
64276,2,3,225229,225232,225235,3,6,0
64277,1,3,225230,225235,225238,5,8,0
64278,6,2,225236,225238,225240,2,4,0
64279,6,2,225242,225242,225244,0,2,2
64280,2,3,225244,225244,225247,0,3,0
64281,6,3,225250,225250,225253,0,3,3
64282,2,2,225252,225253,225255,1,3,0
64283,2,1,225254,225255,225256,1,2,0
64284,6,3,225260,225260,225263,0,3,4
64285,2,1,225262,225263,225264,1,2,0
64286,2,3,225264,225264,225267,0,3,0
64287,1,3,225265,225267,225270,2,5,0
64288,2,2,225267,225270,225272,3,5,0
64289,1,2,225268,225272,225274,4,6,0
64290,1,3,225269,225274,225277,5,8,0
64291,5,2,225274,225277,225279,3,5,0
64292,6,1,225280,225280,225281,0,1,1
64293,3,1,225283,225283,225284,0,1,2
64294,5,3,225288,225288,225291,0,3,4
64295,4,3,225292,225292,225295,0,3,1
64296,2,1,225294,225295,225296,1,2,0
64297,6,2,225300,225300,225302,0,2,4
64298,2,1,225302,225302,225303,0,1,0
64299,2,3,225304,225304,225307,0,3,1
64300,4,2,225308,225308,225310,0,2,1
64301,4,2,225312,225312,225314,0,2,2
64302,4,2,225316,225316,225318,0,2,2
64303,6,2,225322,225322,225324,0,2,4
64304,4,2,225326,225326,225328,0,2,2
64305,1,1,225327,225328,225329,1,2,0
64306,6,3,225333,225333,225336,0,3,4
64307,3,3,225336,225336,225339,0,3,0
64308,5,3,225341,225341,225344,0,3,2
64309,6,1,225347,225347,225348,0,1,3
64310,4,2,225351,225351,225353,0,2,3
64311,1,2,225352,225353,225355,1,3,0
64312,3,2,225355,225355,225357,0,2,0
64313,1,3,225356,225357,225360,1,4,0
64314,5,1,225361,225361,225362,0,1,1
64315,1,3,225362,225362,225365,0,3,0
64316,2,3,225364,225365,225368,1,4,0
64317,2,2,225366,225368,225370,2,4,0
64318,6,1,225372,225372,225373,0,1,2
64319,6,2,225378,225378,225380,0,2,5
64320,4,2,225382,225382,225384,0,2,2
64321,2,1,225384,225384,225385,0,1,0
64322,1,1,225385,225385,225386,0,1,0
64323,1,3,225386,225386,225389,0,3,0
64324,3,2,225389,225389,225391,0,2,0
64325,6,3,225395,225395,225398,0,3,4
64326,3,1,225398,225398,225399,0,1,0
64327,1,2,225399,225399,225401,0,2,0
64328,3,2,225402,225402,225404,0,2,1
64329,2,2,225404,225404,225406,0,2,0
64330,2,1,225406,225406,225407,0,1,0
64331,2,1,225408,225408,225409,0,1,1
64332,2,1,225410,225410,225411,0,1,1
64333,2,3,225412,225412,225415,0,3,1
64334,2,2,225414,225415,225417,1,3,0
64335,5,1,225419,225419,225420,0,1,2
64336,3,3,225422,225422,225425,0,3,2
64337,4,1,225426,225426,225427,0,1,1
64338,2,3,225428,225428,225431,0,3,1
64339,6,2,225434,225434,225436,0,2,3
64340,2,2,225436,225436,225438,0,2,0
64341,3,1,225439,225439,225440,0,1,1
64342,5,1,225444,225444,225445,0,1,4
64343,6,1,225450,225450,225451,0,1,5
64344,1,1,225451,225451,225452,0,1,0
64345,2,2,225453,225453,225455,0,2,1
64346,6,3,225459,225459,225462,0,3,4
64347,5,2,225464,225464,225466,0,2,2
64348,6,2,225470,225470,225472,0,2,4
64349,5,2,225475,225475,225477,0,2,3
64350,4,2,225479,225479,225481,0,2,2
64351,4,3,225483,225483,225486,0,3,2
64352,4,2,225487,225487,225489,0,2,1
64353,2,3,225489,225489,225492,0,3,0
64354,2,2,225491,225492,225494,1,3,0
64355,4,2,225495,225495,225497,0,2,1
64356,5,1,225500,225500,225501,0,1,3
64357,5,3,225505,225505,225508,0,3,4
64358,3,2,225508,225508,225510,0,2,0
64359,3,1,225511,225511,225512,0,1,1
64360,6,1,225517,225517,225518,0,1,5
64361,6,3,225523,225523,225526,0,3,5
64362,5,2,225528,225528,225530,0,2,2
64363,6,1,225534,225534,225535,0,1,4
64364,1,1,225535,225535,225536,0,1,0
64365,3,3,225538,225538,225541,0,3,2
64366,5,1,225543,225543,225544,0,1,2
64367,4,2,225547,225547,225549,0,2,3
64368,5,1,225552,225552,225553,0,1,3
64369,2,1,225554,225554,225555,0,1,1
64370,5,3,225559,225559,225562,0,3,4
64371,6,2,225565,225565,225567,0,2,3
64372,4,2,225569,225569,225571,0,2,2
64373,6,1,225575,225575,225576,0,1,4
64374,4,3,225579,225579,225582,0,3,3
64375,1,2,225580,225582,225584,2,4,0
64376,3,1,225583,225584,225585,1,2,0
64377,2,3,225585,225585,225588,0,3,0
64378,4,3,225589,225589,225592,0,3,1
64379,2,3,225591,225592,225595,1,4,0
64380,1,2,225592,225595,225597,3,5,0
64381,1,1,225593,225597,225598,4,5,0
64382,3,3,225596,225598,225601,2,5,0
64383,4,1,225600,225601,225602,1,2,0
64384,4,3,225604,225604,225607,0,3,2
64385,5,3,225609,225609,225612,0,3,2
64386,3,1,225612,225612,225613,0,1,0
64387,4,2,225616,225616,225618,0,2,3
64388,3,2,225619,225619,225621,0,2,1
64389,5,3,225624,225624,225627,0,3,3
64390,3,3,225627,225627,225630,0,3,0
64391,2,1,225629,225630,225631,1,2,0
64392,1,1,225630,225631,225632,1,2,0
64393,4,3,225634,225634,225637,0,3,2
64394,3,1,225637,225637,225638,0,1,0
64395,5,1,225642,225642,225643,0,1,4
64396,2,2,225644,225644,225646,0,2,1
64397,2,2,225646,225646,225648,0,2,0
64398,1,1,225647,225648,225649,1,2,0
64399,1,2,225648,225649,225651,1,3,0
64400,2,1,225650,225651,225652,1,2,0
64401,2,3,225652,225652,225655,0,3,0
64402,3,3,225655,225655,225658,0,3,0
64403,2,1,225657,225658,225659,1,2,0
64404,5,1,225662,225662,225663,0,1,3
64405,6,1,225668,225668,225669,0,1,5
64406,1,2,225669,225669,225671,0,2,0
64407,6,2,225675,225675,225677,0,2,4
64408,2,3,225677,225677,225680,0,3,0
64409,3,1,225680,225680,225681,0,1,0
64410,5,1,225685,225685,225686,0,1,4
64411,3,2,225688,225688,225690,0,2,2
64412,1,3,225689,225690,225693,1,4,0
64413,4,1,225693,225693,225694,0,1,0
64414,6,2,225699,225699,225701,0,2,5
64415,1,1,225700,225701,225702,1,2,0
64416,2,1,225702,225702,225703,0,1,0
64417,3,1,225705,225705,225706,0,1,2
64418,4,3,225709,225709,225712,0,3,3
64419,2,2,225711,225712,225714,1,3,0
64420,3,3,225714,225714,225717,0,3,0
64421,5,3,225719,225719,225722,0,3,2
64422,3,1,225722,225722,225723,0,1,0
64423,6,3,225728,225728,225731,0,3,5
64424,1,2,225729,225731,225733,2,4,0
64425,4,1,225733,225733,225734,0,1,0
64426,1,3,225734,225734,225737,0,3,0
64427,2,3,225736,225737,225740,1,4,0
64428,4,2,225740,225740,225742,0,2,0
64429,3,3,225743,225743,225746,0,3,1
64430,4,3,225747,225747,225750,0,3,1
64431,3,3,225750,225750,225753,0,3,0
64432,3,2,225753,225753,225755,0,2,0
64433,5,2,225758,225758,225760,0,2,3
64434,3,1,225761,225761,225762,0,1,1
64435,1,2,225762,225762,225764,0,2,0
64436,2,3,225764,225764,225767,0,3,0
64437,6,2,225770,225770,225772,0,2,3
64438,4,1,225774,225774,225775,0,1,2
64439,6,1,225780,225780,225781,0,1,5
64440,1,1,225781,225781,225782,0,1,0
64441,1,3,225782,225782,225785,0,3,0
64442,2,1,225784,225785,225786,1,2,0
64443,1,3,225785,225786,225789,1,4,0
64444,4,2,225789,225789,225791,0,2,0
64445,2,2,225791,225791,225793,0,2,0
64446,5,3,225796,225796,225799,0,3,3
64447,1,1,225797,225799,225800,2,3,0
64448,6,2,225803,225803,225805,0,2,3
64449,4,2,225807,225807,225809,0,2,2
64450,4,2,225811,225811,225813,0,2,2
64451,6,1,225817,225817,225818,0,1,4
64452,4,1,225821,225821,225822,0,1,3
64453,5,1,225826,225826,225827,0,1,4
64454,4,1,225830,225830,225831,0,1,3
64455,5,1,225835,225835,225836,0,1,4
64456,5,2,225840,225840,225842,0,2,4
64457,2,1,225842,225842,225843,0,1,0
64458,1,3,225843,225843,225846,0,3,0
64459,4,3,225847,225847,225850,0,3,1
64460,2,3,225849,225850,225853,1,4,0
64461,2,1,225851,225853,225854,2,3,0
64462,2,2,225853,225854,225856,1,3,0
64463,2,3,225855,225856,225859,1,4,0
64464,3,3,225858,225859,225862,1,4,0
64465,1,1,225859,225862,225863,3,4,0
64466,5,1,225864,225864,225865,0,1,1
64467,1,1,225865,225865,225866,0,1,0
64468,4,3,225869,225869,225872,0,3,3
64469,3,2,225872,225872,225874,0,2,0
64470,5,1,225877,225877,225878,0,1,3
64471,2,3,225879,225879,225882,0,3,1
64472,4,1,225883,225883,225884,0,1,1
64473,3,1,225886,225886,225887,0,1,2
64474,3,3,225889,225889,225892,0,3,2
64475,3,2,225892,225892,225894,0,2,0
64476,4,2,225896,225896,225898,0,2,2
64477,1,1,225897,225898,225899,1,2,0
64478,5,2,225902,225902,225904,0,2,3
64479,5,1,225907,225907,225908,0,1,3
64480,5,1,225912,225912,225913,0,1,4
64481,5,3,225917,225917,225920,0,3,4
64482,5,3,225922,225922,225925,0,3,2
64483,3,2,225925,225925,225927,0,2,0
64484,2,3,225927,225927,225930,0,3,0
64485,6,2,225933,225933,225935,0,2,3
64486,1,3,225934,225935,225938,1,4,0
64487,2,1,225936,225938,225939,2,3,0
64488,6,2,225942,225942,225944,0,2,3
64489,3,1,225945,225945,225946,0,1,1
64490,6,2,225951,225951,225953,0,2,5
64491,5,2,225956,225956,225958,0,2,3
64492,6,2,225962,225962,225964,0,2,4
64493,5,1,225967,225967,225968,0,1,3
64494,4,2,225971,225971,225973,0,2,3
64495,6,2,225977,225977,225979,0,2,4
64496,1,3,225978,225979,225982,1,4,0
64497,6,2,225984,225984,225986,0,2,2
64498,2,3,225986,225986,225989,0,3,0
64499,1,2,225987,225989,225991,2,4,0
64500,6,2,225993,225993,225995,0,2,2
64501,6,2,225999,225999,226001,0,2,4
64502,6,1,226005,226005,226006,0,1,4
64503,3,3,226008,226008,226011,0,3,2
64504,4,3,226012,226012,226015,0,3,1
64505,4,1,226016,226016,226017,0,1,1
64506,1,2,226017,226017,226019,0,2,0
64507,5,1,226022,226022,226023,0,1,3
64508,3,2,226025,226025,226027,0,2,2
64509,5,3,226030,226030,226033,0,3,3
64510,3,2,226033,226033,226035,0,2,0
64511,3,1,226036,226036,226037,0,1,1
64512,6,2,226042,226042,226044,0,2,5
64513,2,3,226044,226044,226047,0,3,0
64514,3,3,226047,226047,226050,0,3,0
64515,1,2,226048,226050,226052,2,4,0
64516,5,2,226053,226053,226055,0,2,1
64517,5,2,226058,226058,226060,0,2,3
64518,6,2,226064,226064,226066,0,2,4
64519,3,3,226067,226067,226070,0,3,1
64520,4,3,226071,226071,226074,0,3,1
64521,2,3,226073,226074,226077,1,4,0
64522,4,2,226077,226077,226079,0,2,0
64523,3,3,226080,226080,226083,0,3,1
64524,1,3,226081,226083,226086,2,5,0
64525,6,2,226087,226087,226089,0,2,1
64526,1,3,226088,226089,226092,1,4,0
64527,1,3,226089,226092,226095,3,6,0
64528,5,2,226094,226095,226097,1,3,0
64529,5,2,226099,226099,226101,0,2,2
64530,1,1,226100,226101,226102,1,2,0
64531,1,1,226101,226102,226103,1,2,0
64532,4,1,226105,226105,226106,0,1,2
64533,5,1,226110,226110,226111,0,1,4
64534,1,1,226111,226111,226112,0,1,0
64535,3,2,226114,226114,226116,0,2,2
64536,4,2,226118,226118,226120,0,2,2
64537,3,2,226121,226121,226123,0,2,1
64538,3,2,226124,226124,226126,0,2,1
64539,5,1,226129,226129,226130,0,1,3
64540,2,3,226131,226131,226134,0,3,1
64541,6,2,226137,226137,226139,0,2,3
64542,5,1,226142,226142,226143,0,1,3
64543,2,3,226144,226144,226147,0,3,1
64544,2,1,226146,226147,226148,1,2,0
64545,3,3,226149,226149,226152,0,3,1
64546,5,2,226154,226154,226156,0,2,2
64547,6,1,226160,226160,226161,0,1,4
64548,3,1,226163,226163,226164,0,1,2
64549,3,3,226166,226166,226169,0,3,2
64550,4,3,226170,226170,226173,0,3,1
64551,6,3,226176,226176,226179,0,3,3
64552,3,2,226179,226179,226181,0,2,0
64553,3,3,226182,226182,226185,0,3,1
64554,4,2,226186,226186,226188,0,2,1
64555,3,1,226189,226189,226190,0,1,1
64556,6,3,226195,226195,226198,0,3,5
64557,3,3,226198,226198,226201,0,3,0
64558,3,2,226201,226201,226203,0,2,0
64559,6,1,226207,226207,226208,0,1,4
64560,1,2,226208,226208,226210,0,2,0
64561,6,3,226214,226214,226217,0,3,4
64562,2,1,226216,226217,226218,1,2,0
64563,5,3,226221,226221,226224,0,3,3
64564,4,1,226225,226225,226226,0,1,1
64565,6,3,226231,226231,226234,0,3,5
64566,4,2,226235,226235,226237,0,2,1
64567,4,2,226239,226239,226241,0,2,2
64568,4,3,226243,226243,226246,0,3,2
64569,5,1,226248,226248,226249,0,1,2
64570,2,2,226250,226250,226252,0,2,1
64571,5,1,226255,226255,226256,0,1,3
64572,2,2,226257,226257,226259,0,2,1
64573,4,3,226261,226261,226264,0,3,2
64574,4,2,226265,226265,226267,0,2,1
64575,4,1,226269,226269,226270,0,1,2
64576,1,2,226270,226270,226272,0,2,0
64577,3,1,226273,226273,226274,0,1,1
64578,3,3,226276,226276,226279,0,3,2
64579,4,3,226280,226280,226283,0,3,1
64580,1,3,226281,226283,226286,2,5,0
64581,1,2,226282,226286,226288,4,6,0
64582,3,1,226285,226288,226289,3,4,0
64583,1,1,226286,226289,226290,3,4,0
64584,3,1,226289,226290,226291,1,2,0
64585,1,3,226290,226291,226294,1,4,0
64586,3,1,226293,226294,226295,1,2,0
64587,5,2,226298,226298,226300,0,2,3
64588,5,1,226303,226303,226304,0,1,3
64589,5,3,226308,226308,226311,0,3,4
64590,4,1,226312,226312,226313,0,1,1
64591,3,2,226315,226315,226317,0,2,2
64592,5,3,226320,226320,226323,0,3,3
64593,6,2,226326,226326,226328,0,2,3
64594,2,1,226328,226328,226329,0,1,0
64595,5,3,226333,226333,226336,0,3,4
64596,3,1,226336,226336,226337,0,1,0
64597,1,3,226337,226337,226340,0,3,0
64598,2,1,226339,226340,226341,1,2,0
64599,2,3,226341,226341,226344,0,3,0
64600,3,2,226344,226344,226346,0,2,0
64601,2,1,226346,226346,226347,0,1,0
64602,3,1,226349,226349,226350,0,1,2
64603,6,1,226355,226355,226356,0,1,5
64604,1,2,226356,226356,226358,0,2,0
64605,3,1,226359,226359,226360,0,1,1
64606,2,1,226361,226361,226362,0,1,1
64607,4,2,226365,226365,226367,0,2,3
64608,3,1,226368,226368,226369,0,1,1
64609,5,3,226373,226373,226376,0,3,4
64610,6,2,226379,226379,226381,0,2,3
64611,6,1,226385,226385,226386,0,1,4
64612,4,3,226389,226389,226392,0,3,3
64613,6,1,226395,226395,226396,0,1,3
64614,6,1,226401,226401,226402,0,1,5
64615,2,1,226403,226403,226404,0,1,1
64616,3,1,226406,226406,226407,0,1,2
64617,3,3,226409,226409,226412,0,3,2
64618,4,3,226413,226413,226416,0,3,1
64619,2,2,226415,226416,226418,1,3,0
64620,2,1,226417,226418,226419,1,2,0
64621,1,2,226418,226419,226421,1,3,0
64622,6,2,226424,226424,226426,0,2,3
64623,4,2,226428,226428,226430,0,2,2
64624,5,1,226433,226433,226434,0,1,3
64625,3,1,226436,226436,226437,0,1,2
64626,1,3,226437,226437,226440,0,3,0
64627,6,2,226443,226443,226445,0,2,3
64628,2,3,226445,226445,226448,0,3,0
64629,4,2,226449,226449,226451,0,2,1
64630,1,2,226450,226451,226453,1,3,0
64631,6,1,226456,226456,226457,0,1,3
64632,6,3,226462,226462,226465,0,3,5
64633,4,2,226466,226466,226468,0,2,1
64634,3,3,226469,226469,226472,0,3,1
64635,1,3,226470,226472,226475,2,5,0
64636,6,1,226476,226476,226477,0,1,1
64637,5,2,226481,226481,226483,0,2,4
64638,5,2,226486,226486,226488,0,2,3
64639,1,2,226487,226488,226490,1,3,0
64640,3,2,226490,226490,226492,0,2,0
64641,2,1,226492,226492,226493,0,1,0
64642,4,2,226496,226496,226498,0,2,3
64643,1,2,226497,226498,226500,1,3,0
64644,6,2,226503,226503,226505,0,2,3
64645,5,2,226508,226508,226510,0,2,3
64646,1,3,226509,226510,226513,1,4,0
64647,6,3,226515,226515,226518,0,3,2
64648,1,1,226516,226518,226519,2,3,0
64649,1,1,226517,226519,226520,2,3,0
64650,2,3,226519,226520,226523,1,4,0
64651,4,2,226523,226523,226525,0,2,0
64652,6,2,226529,226529,226531,0,2,4
64653,3,2,226532,226532,226534,0,2,1
64654,2,2,226534,226534,226536,0,2,0
64655,6,1,226540,226540,226541,0,1,4
64656,4,2,226544,226544,226546,0,2,3
64657,1,1,226545,226546,226547,1,2,0
64658,4,3,226549,226549,226552,0,3,2
64659,5,1,226554,226554,226555,0,1,2
64660,5,1,226559,226559,226560,0,1,4
64661,3,2,226562,226562,226564,0,2,2
64662,3,1,226565,226565,226566,0,1,1
64663,4,2,226569,226569,226571,0,2,3
64664,2,3,226571,226571,226574,0,3,0
64665,6,1,226577,226577,226578,0,1,3
64666,5,3,226582,226582,226585,0,3,4
64667,2,3,226584,226585,226588,1,4,0
64668,4,1,226588,226588,226589,0,1,0
64669,1,1,226589,226589,226590,0,1,0
64670,4,3,226593,226593,226596,0,3,3
64671,1,3,226594,226596,226599,2,5,0
64672,1,1,226595,226599,226600,4,5,0
64673,5,1,226600,226600,226601,0,1,0
64674,2,3,226602,226602,226605,0,3,1
64675,4,1,226606,226606,226607,0,1,1
64676,2,1,226608,226608,226609,0,1,1
64677,1,1,226609,226609,226610,0,1,0
64678,3,2,226612,226612,226614,0,2,2
64679,4,3,226616,226616,226619,0,3,2
64680,3,1,226619,226619,226620,0,1,0
64681,2,1,226621,226621,226622,0,1,1
64682,3,1,226624,226624,226625,0,1,2
64683,1,2,226625,226625,226627,0,2,0
64684,5,3,226630,226630,226633,0,3,3
64685,6,2,226636,226636,226638,0,2,3
64686,4,3,226640,226640,226643,0,3,2
64687,5,3,226645,226645,226648,0,3,2
64688,1,1,226646,226648,226649,2,3,0
64689,6,2,226652,226652,226654,0,2,3
64690,2,2,226654,226654,226656,0,2,0
64691,6,2,226660,226660,226662,0,2,4
64692,3,2,226663,226663,226665,0,2,1
64693,6,2,226669,226669,226671,0,2,4
64694,4,1,226673,226673,226674,0,1,2
64695,6,1,226679,226679,226680,0,1,5
64696,4,1,226683,226683,226684,0,1,3
64697,5,2,226688,226688,226690,0,2,4
64698,6,3,226694,226694,226697,0,3,4
64699,4,1,226698,226698,226699,0,1,1
64700,2,2,226700,226700,226702,0,2,1
64701,5,1,226705,226705,226706,0,1,3
64702,5,1,226710,226710,226711,0,1,4
64703,1,2,226711,226711,226713,0,2,0
64704,3,3,226714,226714,226717,0,3,1
64705,6,2,226720,226720,226722,0,2,3
64706,1,2,226721,226722,226724,1,3,0
64707,1,3,226722,226724,226727,2,5,0
64708,4,1,226726,226727,226728,1,2,0
64709,6,1,226732,226732,226733,0,1,4
64710,6,2,226738,226738,226740,0,2,5
64711,4,2,226742,226742,226744,0,2,2
64712,4,3,226746,226746,226749,0,3,2
64713,5,1,226751,226751,226752,0,1,2
64714,2,2,226753,226753,226755,0,2,1
64715,1,2,226754,226755,226757,1,3,0
64716,4,3,226758,226758,226761,0,3,1
64717,2,1,226760,226761,226762,1,2,0
64718,4,3,226764,226764,226767,0,3,2
64719,3,1,226767,226767,226768,0,1,0
64720,5,1,226772,226772,226773,0,1,4
64721,3,1,226775,226775,226776,0,1,2
64722,6,2,226781,226781,226783,0,2,5
64723,2,3,226783,226783,226786,0,3,0
64724,6,3,226789,226789,226792,0,3,3
64725,3,1,226792,226792,226793,0,1,0
64726,5,3,226797,226797,226800,0,3,4
64727,2,2,226799,226800,226802,1,3,0
64728,4,3,226803,226803,226806,0,3,1
64729,2,2,226805,226806,226808,1,3,0
64730,6,3,226811,226811,226814,0,3,3
64731,2,1,226813,226814,226815,1,2,0
64732,3,1,226816,226816,226817,0,1,1
64733,5,3,226821,226821,226824,0,3,4
64734,5,1,226826,226826,226827,0,1,2
64735,6,3,226832,226832,226835,0,3,5
64736,6,3,226838,226838,226841,0,3,3
64737,3,2,226841,226841,226843,0,2,0
64738,3,3,226844,226844,226847,0,3,1
64739,4,1,226848,226848,226849,0,1,1
64740,6,3,226854,226854,226857,0,3,5
64741,2,3,226856,226857,226860,1,4,0
64742,3,2,226859,226860,226862,1,3,0
64743,3,2,226862,226862,226864,0,2,0
64744,5,1,226867,226867,226868,0,1,3
64745,6,2,226873,226873,226875,0,2,5
64746,5,1,226878,226878,226879,0,1,3
64747,4,2,226882,226882,226884,0,2,3
64748,3,3,226885,226885,226888,0,3,1
64749,5,3,226890,226890,226893,0,3,2
64750,2,1,226892,226893,226894,1,2,0
64751,2,2,226894,226894,226896,0,2,0
64752,5,1,226899,226899,226900,0,1,3
64753,1,3,226900,226900,226903,0,3,0
64754,2,1,226902,226903,226904,1,2,0
64755,6,3,226908,226908,226911,0,3,4
64756,4,1,226912,226912,226913,0,1,1
64757,1,3,226913,226913,226916,0,3,0
64758,3,3,226916,226916,226919,0,3,0
64759,1,1,226917,226919,226920,2,3,0
64760,5,3,226922,226922,226925,0,3,2
64761,6,1,226928,226928,226929,0,1,3
64762,4,2,226932,226932,226934,0,2,3
64763,4,1,226936,226936,226937,0,1,2
64764,6,2,226942,226942,226944,0,2,5
64765,6,2,226948,226948,226950,0,2,4
64766,4,1,226952,226952,226953,0,1,2
64767,2,3,226954,226954,226957,0,3,1
64768,2,2,226956,226957,226959,1,3,0
64769,1,2,226957,226959,226961,2,4,0
64770,4,1,226961,226961,226962,0,1,0
64771,4,3,226965,226965,226968,0,3,3
64772,5,2,226970,226970,226972,0,2,2
64773,2,1,226972,226972,226973,0,1,0
64774,4,2,226976,226976,226978,0,2,3
64775,5,2,226981,226981,226983,0,2,3
64776,1,1,226982,226983,226984,1,2,0
64777,2,2,226984,226984,226986,0,2,0
64778,1,2,226985,226986,226988,1,3,0
64779,3,2,226988,226988,226990,0,2,0
64780,5,3,226993,226993,226996,0,3,3
64781,1,1,226994,226996,226997,2,3,0
64782,3,3,226997,226997,227000,0,3,0
64783,2,3,226999,227000,227003,1,4,0
64784,2,2,227001,227003,227005,2,4,0
64785,2,2,227003,227005,227007,2,4,0
64786,2,2,227005,227007,227009,2,4,0
64787,2,1,227007,227009,227010,2,3,0
64788,1,1,227008,227010,227011,2,3,0
64789,1,3,227009,227011,227014,2,5,0
64790,6,2,227015,227015,227017,0,2,1
64791,3,2,227018,227018,227020,0,2,1
64792,2,2,227020,227020,227022,0,2,0
64793,2,2,227022,227022,227024,0,2,0
64794,3,3,227025,227025,227028,0,3,1
64795,6,3,227031,227031,227034,0,3,3
64796,2,2,227033,227034,227036,1,3,0
64797,6,2,227039,227039,227041,0,2,3
64798,3,3,227042,227042,227045,0,3,1
64799,3,1,227045,227045,227046,0,1,0
64800,3,3,227048,227048,227051,0,3,2
64801,3,1,227051,227051,227052,0,1,0
64802,4,2,227055,227055,227057,0,2,3
64803,4,1,227059,227059,227060,0,1,2
64804,4,2,227063,227063,227065,0,2,3
64805,6,2,227069,227069,227071,0,2,4
64806,4,3,227073,227073,227076,0,3,2
64807,4,2,227077,227077,227079,0,2,1
64808,2,1,227079,227079,227080,0,1,0
64809,6,3,227085,227085,227088,0,3,5
64810,2,2,227087,227088,227090,1,3,0
64811,3,2,227090,227090,227092,0,2,0
64812,3,3,227093,227093,227096,0,3,1
64813,4,2,227097,227097,227099,0,2,1
64814,2,1,227099,227099,227100,0,1,0
64815,2,3,227101,227101,227104,0,3,1
64816,4,2,227105,227105,227107,0,2,1
64817,1,1,227106,227107,227108,1,2,0
64818,5,2,227111,227111,227113,0,2,3
64819,5,2,227116,227116,227118,0,2,3
64820,2,3,227118,227118,227121,0,3,0
64821,6,3,227124,227124,227127,0,3,3
64822,3,1,227127,227127,227128,0,1,0
64823,4,1,227131,227131,227132,0,1,3
64824,1,2,227132,227132,227134,0,2,0
64825,1,3,227133,227134,227137,1,4,0
64826,6,2,227139,227139,227141,0,2,2
64827,6,1,227145,227145,227146,0,1,4
64828,1,1,227146,227146,227147,0,1,0
64829,5,1,227151,227151,227152,0,1,4
64830,4,2,227155,227155,227157,0,2,3
64831,5,1,227160,227160,227161,0,1,3
64832,2,1,227162,227162,227163,0,1,1
64833,1,1,227163,227163,227164,0,1,0
64834,6,3,227169,227169,227172,0,3,5
64835,1,3,227170,227172,227175,2,5,0
64836,2,1,227172,227175,227176,3,4,0
64837,4,3,227176,227176,227179,0,3,0
64838,6,1,227182,227182,227183,0,1,3
64839,2,1,227184,227184,227185,0,1,1
64840,1,1,227185,227185,227186,0,1,0
64841,2,1,227187,227187,227188,0,1,1
64842,1,2,227188,227188,227190,0,2,0
64843,2,3,227190,227190,227193,0,3,0
64844,5,3,227195,227195,227198,0,3,2
64845,3,1,227198,227198,227199,0,1,0
64846,1,1,227199,227199,227200,0,1,0
64847,6,3,227205,227205,227208,0,3,5
64848,6,3,227211,227211,227214,0,3,3
64849,4,2,227215,227215,227217,0,2,1
64850,1,2,227216,227217,227219,1,3,0
64851,3,1,227219,227219,227220,0,1,0
64852,6,3,227225,227225,227228,0,3,5
64853,6,3,227231,227231,227234,0,3,3
64854,6,3,227237,227237,227240,0,3,3
64855,5,3,227242,227242,227245,0,3,2
64856,4,1,227246,227246,227247,0,1,1
64857,4,3,227250,227250,227253,0,3,3
64858,2,3,227252,227253,227256,1,4,0
64859,1,2,227253,227256,227258,3,5,0
64860,6,3,227259,227259,227262,0,3,1
64861,3,2,227262,227262,227264,0,2,0
64862,3,3,227265,227265,227268,0,3,1
64863,2,1,227267,227268,227269,1,2,0
64864,6,1,227273,227273,227274,0,1,4
64865,2,2,227275,227275,227277,0,2,1
64866,2,3,227277,227277,227280,0,3,0
64867,6,3,227283,227283,227286,0,3,3
64868,5,3,227288,227288,227291,0,3,2
64869,4,2,227292,227292,227294,0,2,1
64870,5,3,227297,227297,227300,0,3,3
64871,3,3,227300,227300,227303,0,3,0
64872,5,3,227305,227305,227308,0,3,2
64873,5,1,227310,227310,227311,0,1,2
64874,3,1,227313,227313,227314,0,1,2
64875,2,1,227315,227315,227316,0,1,1
64876,2,2,227317,227317,227319,0,2,1
64877,3,1,227320,227320,227321,0,1,1
64878,4,3,227324,227324,227327,0,3,3
64879,3,1,227327,227327,227328,0,1,0
64880,6,3,227333,227333,227336,0,3,5
64881,6,3,227339,227339,227342,0,3,3
64882,5,1,227344,227344,227345,0,1,2
64883,1,1,227345,227345,227346,0,1,0
64884,4,1,227349,227349,227350,0,1,3
64885,4,2,227353,227353,227355,0,2,3
64886,3,3,227356,227356,227359,0,3,1
64887,6,1,227362,227362,227363,0,1,3
64888,1,1,227363,227363,227364,0,1,0
64889,1,1,227364,227364,227365,0,1,0
64890,4,2,227368,227368,227370,0,2,3
64891,6,2,227374,227374,227376,0,2,4
64892,5,1,227379,227379,227380,0,1,3
64893,5,3,227384,227384,227387,0,3,4
64894,5,1,227389,227389,227390,0,1,2
64895,6,2,227395,227395,227397,0,2,5
64896,6,3,227401,227401,227404,0,3,4
64897,1,1,227402,227404,227405,2,3,0
64898,3,2,227405,227405,227407,0,2,0
64899,2,2,227407,227407,227409,0,2,0
64900,3,2,227410,227410,227412,0,2,1
64901,6,2,227416,227416,227418,0,2,4
64902,6,2,227422,227422,227424,0,2,4
64903,5,1,227427,227427,227428,0,1,3
64904,2,3,227429,227429,227432,0,3,1
64905,5,3,227434,227434,227437,0,3,2
64906,2,1,227436,227437,227438,1,2,0
64907,4,3,227440,227440,227443,0,3,2
64908,2,2,227442,227443,227445,1,3,0
64909,5,3,227447,227447,227450,0,3,2
64910,6,1,227453,227453,227454,0,1,3
64911,4,2,227457,227457,227459,0,2,3
64912,4,3,227461,227461,227464,0,3,2
64913,1,2,227462,227464,227466,2,4,0
64914,6,1,227468,227468,227469,0,1,2
64915,1,1,227469,227469,227470,0,1,0
64916,5,2,227474,227474,227476,0,2,4
64917,3,1,227477,227477,227478,0,1,1
64918,4,2,227481,227481,227483,0,2,3
64919,2,3,227483,227483,227486,0,3,0
64920,4,2,227487,227487,227489,0,2,1
64921,3,2,227490,227490,227492,0,2,1
64922,2,1,227492,227492,227493,0,1,0
64923,2,1,227494,227494,227495,0,1,1
64924,6,1,227500,227500,227501,0,1,5
64925,2,1,227502,227502,227503,0,1,1
64926,4,3,227506,227506,227509,0,3,3
64927,5,3,227511,227511,227514,0,3,2
64928,5,1,227516,227516,227517,0,1,2
64929,1,1,227517,227517,227518,0,1,0
64930,2,3,227519,227519,227522,0,3,1
64931,3,3,227522,227522,227525,0,3,0
64932,5,2,227527,227527,227529,0,2,2
64933,4,3,227531,227531,227534,0,3,2
64934,6,1,227537,227537,227538,0,1,3
64935,6,1,227543,227543,227544,0,1,5
64936,4,2,227547,227547,227549,0,2,3
64937,4,3,227551,227551,227554,0,3,2
64938,4,3,227555,227555,227558,0,3,1
64939,6,1,227561,227561,227562,0,1,3
64940,4,1,227565,227565,227566,0,1,3
64941,4,1,227569,227569,227570,0,1,3
64942,5,3,227574,227574,227577,0,3,4
64943,4,2,227578,227578,227580,0,2,1
64944,2,1,227580,227580,227581,0,1,0
64945,6,2,227586,227586,227588,0,2,5
64946,4,3,227590,227590,227593,0,3,2
64947,6,3,227596,227596,227599,0,3,3
64948,3,3,227599,227599,227602,0,3,0
64949,1,3,227600,227602,227605,2,5,0
64950,1,2,227601,227605,227607,4,6,0
64951,2,2,227603,227607,227609,4,6,0
64952,5,1,227608,227609,227610,1,2,0
64953,6,2,227614,227614,227616,0,2,4
64954,2,1,227616,227616,227617,0,1,0
64955,1,1,227617,227617,227618,0,1,0
64956,5,1,227622,227622,227623,0,1,4
64957,5,3,227627,227627,227630,0,3,4
64958,6,3,227633,227633,227636,0,3,3
64959,5,3,227638,227638,227641,0,3,2
64960,5,2,227643,227643,227645,0,2,2
64961,2,1,227645,227645,227646,0,1,0
64962,2,3,227647,227647,227650,0,3,1
64963,6,3,227653,227653,227656,0,3,3
64964,3,3,227656,227656,227659,0,3,0
64965,6,2,227662,227662,227664,0,2,3
64966,5,3,227667,227667,227670,0,3,3
64967,5,3,227672,227672,227675,0,3,2
64968,3,1,227675,227675,227676,0,1,0
64969,5,1,227680,227680,227681,0,1,4
64970,4,3,227684,227684,227687,0,3,3
64971,1,3,227685,227687,227690,2,5,0
64972,2,2,227687,227690,227692,3,5,0
64973,6,2,227693,227693,227695,0,2,1
64974,1,3,227694,227695,227698,1,4,0
64975,4,3,227698,227698,227701,0,3,0
64976,5,3,227703,227703,227706,0,3,2
64977,1,1,227704,227706,227707,2,3,0
64978,5,3,227709,227709,227712,0,3,2
64979,5,2,227714,227714,227716,0,2,2
64980,5,2,227719,227719,227721,0,2,3
64981,6,2,227725,227725,227727,0,2,4
64982,3,2,227728,227728,227730,0,2,1
64983,1,2,227729,227730,227732,1,3,0
64984,4,1,227733,227733,227734,0,1,1
64985,2,3,227735,227735,227738,0,3,1
64986,2,1,227737,227738,227739,1,2,0
64987,3,1,227740,227740,227741,0,1,1
64988,2,2,227742,227742,227744,0,2,1
64989,3,1,227745,227745,227746,0,1,1
64990,1,3,227746,227746,227749,0,3,0
64991,1,2,227747,227749,227751,2,4,0
64992,6,3,227753,227753,227756,0,3,2
64993,2,2,227755,227756,227758,1,3,0
64994,3,3,227758,227758,227761,0,3,0
64995,2,1,227760,227761,227762,1,2,0
64996,3,2,227763,227763,227765,0,2,1
64997,1,1,227764,227765,227766,1,2,0
64998,5,2,227769,227769,227771,0,2,3
64999,6,3,227775,227775,227778,0,3,4
65000,2,2,227777,227778,227780,1,3,0
65001,2,1,227779,227780,227781,1,2,0
65002,6,3,227785,227785,227788,0,3,4
65003,3,3,227788,227788,227791,0,3,0
65004,6,2,227794,227794,227796,0,2,3
65005,1,3,227795,227796,227799,1,4,0
65006,2,1,227797,227799,227800,2,3,0
65007,4,2,227801,227801,227803,0,2,1
65008,6,1,227807,227807,227808,0,1,4
65009,2,3,227809,227809,227812,0,3,1
65010,4,3,227813,227813,227816,0,3,1
65011,6,1,227819,227819,227820,0,1,3
65012,2,3,227821,227821,227824,0,3,1
65013,3,3,227824,227824,227827,0,3,0
65014,6,3,227830,227830,227833,0,3,3
65015,3,3,227833,227833,227836,0,3,0
65016,2,3,227835,227836,227839,1,4,0
65017,2,1,227837,227839,227840,2,3,0
65018,3,3,227840,227840,227843,0,3,0
65019,3,2,227843,227843,227845,0,2,0
65020,6,2,227849,227849,227851,0,2,4
65021,3,1,227852,227852,227853,0,1,1
65022,4,1,227856,227856,227857,0,1,3
65023,1,1,227857,227857,227858,0,1,0
65024,5,1,227862,227862,227863,0,1,4
65025,3,2,227865,227865,227867,0,2,2
65026,6,2,227871,227871,227873,0,2,4
65027,6,3,227877,227877,227880,0,3,4
65028,6,2,227883,227883,227885,0,2,3
65029,3,3,227886,227886,227889,0,3,1
65030,3,2,227889,227889,227891,0,2,0
65031,2,2,227891,227891,227893,0,2,0
65032,2,3,227893,227893,227896,0,3,0
65033,5,3,227898,227898,227901,0,3,2
65034,3,2,227901,227901,227903,0,2,0
65035,2,1,227903,227903,227904,0,1,0
65036,5,1,227908,227908,227909,0,1,4
65037,5,3,227913,227913,227916,0,3,4
65038,6,1,227919,227919,227920,0,1,3
65039,2,2,227921,227921,227923,0,2,1
65040,2,2,227923,227923,227925,0,2,0
65041,1,2,227924,227925,227927,1,3,0
65042,3,2,227927,227927,227929,0,2,0
65043,3,1,227930,227930,227931,0,1,1
65044,5,2,227935,227935,227937,0,2,4
65045,1,3,227936,227937,227940,1,4,0
65046,2,3,227938,227940,227943,2,5,0
65047,2,1,227940,227943,227944,3,4,0
65048,3,2,227943,227944,227946,1,3,0
65049,1,3,227944,227946,227949,2,5,0
65050,6,3,227950,227950,227953,0,3,1
65051,3,2,227953,227953,227955,0,2,0
65052,1,1,227954,227955,227956,1,2,0
65053,2,1,227956,227956,227957,0,1,0
65054,1,2,227957,227957,227959,0,2,0
65055,4,1,227961,227961,227962,0,1,2
65056,3,3,227964,227964,227967,0,3,2
65057,2,2,227966,227967,227969,1,3,0
65058,4,1,227970,227970,227971,0,1,1
65059,4,3,227974,227974,227977,0,3,3
65060,4,1,227978,227978,227979,0,1,1
65061,2,3,227980,227980,227983,0,3,1
65062,6,2,227986,227986,227988,0,2,3
65063,1,3,227987,227988,227991,1,4,0
65064,3,3,227990,227991,227994,1,4,0
65065,3,2,227993,227994,227996,1,3,0
65066,1,1,227994,227996,227997,2,3,0
65067,6,2,228000,228000,228002,0,2,3
65068,4,3,228004,228004,228007,0,3,2
65069,6,2,228010,228010,228012,0,2,3
65070,6,3,228016,228016,228019,0,3,4
65071,4,2,228020,228020,228022,0,2,1
65072,2,2,228022,228022,228024,0,2,0
65073,2,3,228024,228024,228027,0,3,0
65074,6,1,228030,228030,228031,0,1,3
65075,4,2,228034,228034,228036,0,2,3
65076,5,3,228039,228039,228042,0,3,3
65077,2,3,228041,228042,228045,1,4,0
65078,1,1,228042,228045,228046,3,4,0
65079,4,3,228046,228046,228049,0,3,0
65080,6,3,228052,228052,228055,0,3,3
65081,5,2,228057,228057,228059,0,2,2
65082,4,1,228061,228061,228062,0,1,2
65083,5,2,228066,228066,228068,0,2,4
65084,4,3,228070,228070,228073,0,3,2
65085,3,3,228073,228073,228076,0,3,0
65086,6,1,228079,228079,228080,0,1,3
65087,2,2,228081,228081,228083,0,2,1
65088,3,2,228084,228084,228086,0,2,1
65089,1,2,228085,228086,228088,1,3,0
65090,4,3,228089,228089,228092,0,3,1
65091,6,3,228095,228095,228098,0,3,3
65092,2,2,228097,228098,228100,1,3,0
65093,3,2,228100,228100,228102,0,2,0
65094,4,1,228104,228104,228105,0,1,2
65095,1,1,228105,228105,228106,0,1,0
65096,1,1,228106,228106,228107,0,1,0
65097,1,1,228107,228107,228108,0,1,0
65098,2,1,228109,228109,228110,0,1,1
65099,6,2,228115,228115,228117,0,2,5
65100,6,2,228121,228121,228123,0,2,4
65101,6,1,228127,228127,228128,0,1,4
65102,4,1,228131,228131,228132,0,1,3
65103,4,3,228135,228135,228138,0,3,3
65104,4,2,228139,228139,228141,0,2,1
65105,4,3,228143,228143,228146,0,3,2
65106,1,1,228144,228146,228147,2,3,0
65107,1,2,228145,228147,228149,2,4,0
65108,2,2,228147,228149,228151,2,4,0
65109,1,1,228148,228151,228152,3,4,0
65110,2,1,228150,228152,228153,2,3,0
65111,4,2,228154,228154,228156,0,2,1
65112,1,1,228155,228156,228157,1,2,0
65113,5,2,228160,228160,228162,0,2,3
65114,4,1,228164,228164,228165,0,1,2
65115,4,3,228168,228168,228171,0,3,3
65116,3,2,228171,228171,228173,0,2,0
65117,6,1,228177,228177,228178,0,1,4
65118,6,3,228183,228183,228186,0,3,5
65119,6,2,228189,228189,228191,0,2,3
65120,5,2,228194,228194,228196,0,2,3
65121,5,2,228199,228199,228201,0,2,3
65122,4,1,228203,228203,228204,0,1,2
65123,2,2,228205,228205,228207,0,2,1
65124,4,3,228209,228209,228212,0,3,2
65125,5,2,228214,228214,228216,0,2,2
65126,5,3,228219,228219,228222,0,3,3
65127,2,2,228221,228222,228224,1,3,0
65128,3,1,228224,228224,228225,0,1,0
65129,3,1,228227,228227,228228,0,1,2
65130,2,2,228229,228229,228231,0,2,1
65131,2,3,228231,228231,228234,0,3,0
65132,5,1,228236,228236,228237,0,1,2
65133,1,2,228237,228237,228239,0,2,0
65134,1,2,228238,228239,228241,1,3,0
65135,1,1,228239,228241,228242,2,3,0
65136,1,3,228240,228242,228245,2,5,0
65137,1,1,228241,228245,228246,4,5,0
65138,1,2,228242,228246,228248,4,6,0
65139,6,1,228248,228248,228249,0,1,0
65140,1,3,228249,228249,228252,0,3,0
65141,5,1,228254,228254,228255,0,1,2
65142,3,1,228257,228257,228258,0,1,2
65143,6,1,228263,228263,228264,0,1,5
65144,5,2,228268,228268,228270,0,2,4
65145,6,1,228274,228274,228275,0,1,4
65146,1,1,228275,228275,228276,0,1,0
65147,5,3,228280,228280,228283,0,3,4
65148,3,2,228283,228283,228285,0,2,0
65149,1,1,228284,228285,228286,1,2,0
65150,2,2,228286,228286,228288,0,2,0
65151,6,3,228292,228292,228295,0,3,4
65152,1,3,228293,228295,228298,2,5,0
65153,3,3,228296,228298,228301,2,5,0
65154,2,3,228298,228301,228304,3,6,0
65155,3,2,228301,228304,228306,3,5,0
65156,3,2,228304,228306,228308,2,4,0
65157,1,2,228305,228308,228310,3,5,0
65158,6,2,228311,228311,228313,0,2,1
65159,5,1,228316,228316,228317,0,1,3
65160,2,2,228318,228318,228320,0,2,1
65161,2,1,228320,228320,228321,0,1,0
65162,2,2,228322,228322,228324,0,2,1
65163,6,3,228328,228328,228331,0,3,4
65164,2,3,228330,228331,228334,1,4,0
65165,6,1,228336,228336,228337,0,1,2
65166,3,1,228339,228339,228340,0,1,2
65167,1,2,228340,228340,228342,0,2,0
65168,1,3,228341,228342,228345,1,4,0
65169,3,3,228344,228345,228348,1,4,0
65170,2,1,228346,228348,228349,2,3,0
65171,1,1,228347,228349,228350,2,3,0
65172,1,1,228348,228350,228351,2,3,0
65173,2,2,228350,228351,228353,1,3,0
65174,6,2,228356,228356,228358,0,2,3
65175,6,2,228362,228362,228364,0,2,4
65176,4,1,228366,228366,228367,0,1,2
65177,5,3,228371,228371,228374,0,3,4
65178,4,3,228375,228375,228378,0,3,1
65179,6,2,228381,228381,228383,0,2,3
65180,5,3,228386,228386,228389,0,3,3
65181,4,3,228390,228390,228393,0,3,1
65182,3,2,228393,228393,228395,0,2,0
65183,5,3,228398,228398,228401,0,3,3
65184,5,1,228403,228403,228404,0,1,2
65185,6,1,228409,228409,228410,0,1,5
65186,3,1,228412,228412,228413,0,1,2
65187,5,2,228417,228417,228419,0,2,4
65188,1,1,228418,228419,228420,1,2,0
65189,3,1,228421,228421,228422,0,1,1
65190,4,1,228425,228425,228426,0,1,3
65191,5,2,228430,228430,228432,0,2,4
65192,3,3,228433,228433,228436,0,3,1
65193,6,2,228439,228439,228441,0,2,3
65194,5,2,228444,228444,228446,0,2,3
65195,6,1,228450,228450,228451,0,1,4
65196,2,3,228452,228452,228455,0,3,1
65197,3,3,228455,228455,228458,0,3,0
65198,2,1,228457,228458,228459,1,2,0
65199,2,1,228459,228459,228460,0,1,0
65200,3,3,228462,228462,228465,0,3,2
65201,4,1,228466,228466,228467,0,1,1
65202,6,2,228472,228472,228474,0,2,5
65203,5,1,228477,228477,228478,0,1,3
65204,1,2,228478,228478,228480,0,2,0
65205,6,1,228484,228484,228485,0,1,4
65206,3,2,228487,228487,228489,0,2,2
65207,1,1,228488,228489,228490,1,2,0
65208,2,2,228490,228490,228492,0,2,0
65209,4,3,228494,228494,228497,0,3,2
65210,2,2,228496,228497,228499,1,3,0
65211,1,1,228497,228499,228500,2,3,0
65212,5,2,228502,228502,228504,0,2,2
65213,5,2,228507,228507,228509,0,2,3
65214,2,3,228509,228509,228512,0,3,0
65215,4,2,228513,228513,228515,0,2,1
65216,4,1,228517,228517,228518,0,1,2
65217,6,1,228523,228523,228524,0,1,5
65218,4,3,228527,228527,228530,0,3,3
65219,4,1,228531,228531,228532,0,1,1
65220,6,3,228537,228537,228540,0,3,5
65221,4,3,228541,228541,228544,0,3,1
65222,4,3,228545,228545,228548,0,3,1
65223,5,2,228550,228550,228552,0,2,2
65224,1,3,228551,228552,228555,1,4,0
65225,4,3,228555,228555,228558,0,3,0
65226,6,1,228561,228561,228562,0,1,3
65227,3,2,228564,228564,228566,0,2,2
65228,1,1,228565,228566,228567,1,2,0
65229,4,1,228569,228569,228570,0,1,2
65230,6,2,228575,228575,228577,0,2,5
65231,4,1,228579,228579,228580,0,1,2
65232,5,1,228584,228584,228585,0,1,4
65233,3,1,228587,228587,228588,0,1,2
65234,6,3,228593,228593,228596,0,3,5
65235,3,3,228596,228596,228599,0,3,0
65236,4,3,228600,228600,228603,0,3,1
65237,6,1,228606,228606,228607,0,1,3
65238,1,2,228607,228607,228609,0,2,0
65239,1,3,228608,228609,228612,1,4,0
65240,3,1,228611,228612,228613,1,2,0
65241,2,2,228613,228613,228615,0,2,0
65242,2,2,228615,228615,228617,0,2,0
65243,2,3,228617,228617,228620,0,3,0
65244,6,2,228623,228623,228625,0,2,3
65245,3,3,228626,228626,228629,0,3,1
65246,6,2,228632,228632,228634,0,2,3
65247,2,3,228634,228634,228637,0,3,0
65248,4,2,228638,228638,228640,0,2,1
65249,6,2,228644,228644,228646,0,2,4
65250,3,1,228647,228647,228648,0,1,1
65251,1,2,228648,228648,228650,0,2,0
65252,5,3,228653,228653,228656,0,3,3
65253,1,3,228654,228656,228659,2,5,0
65254,4,2,228658,228659,228661,1,3,0
65255,3,1,228661,228661,228662,0,1,0
65256,2,1,228663,228663,228664,0,1,1
65257,2,1,228665,228665,228666,0,1,1
65258,1,2,228666,228666,228668,0,2,0
65259,3,2,228669,228669,228671,0,2,1
65260,2,2,228671,228671,228673,0,2,0
65261,4,2,228675,228675,228677,0,2,2
65262,6,1,228681,228681,228682,0,1,4
65263,3,3,228684,228684,228687,0,3,2
65264,2,2,228686,228687,228689,1,3,0
65265,1,1,228687,228689,228690,2,3,0
65266,2,3,228689,228690,228693,1,4,0
65267,2,3,228691,228693,228696,2,5,0
65268,6,2,228697,228697,228699,0,2,1
65269,6,1,228703,228703,228704,0,1,4
65270,5,2,228708,228708,228710,0,2,4
65271,5,3,228713,228713,228716,0,3,3
65272,1,2,228714,228716,228718,2,4,0
65273,4,2,228718,228718,228720,0,2,0
65274,3,3,228721,228721,228724,0,3,1
65275,1,3,228722,228724,228727,2,5,0
65276,4,3,228726,228727,228730,1,4,0
65277,3,1,228729,228730,228731,1,2,0
65278,4,2,228733,228733,228735,0,2,2
65279,1,3,228734,228735,228738,1,4,0
65280,6,3,228740,228740,228743,0,3,2
65281,2,2,228742,228743,228745,1,3,0
65282,6,1,228748,228748,228749,0,1,3
65283,4,2,228752,228752,228754,0,2,3
65284,5,2,228757,228757,228759,0,2,3
65285,4,3,228761,228761,228764,0,3,2
65286,4,1,228765,228765,228766,0,1,1
65287,4,1,228769,228769,228770,0,1,3
65288,3,3,228772,228772,228775,0,3,2
65289,5,1,228777,228777,228778,0,1,2
65290,3,1,228780,228780,228781,0,1,2
65291,3,1,228783,228783,228784,0,1,2
65292,6,2,228789,228789,228791,0,2,5
65293,4,2,228793,228793,228795,0,2,2
65294,6,1,228799,228799,228800,0,1,4
65295,2,2,228801,228801,228803,0,2,1
65296,1,3,228802,228803,228806,1,4,0
65297,5,2,228807,228807,228809,0,2,1
65298,2,3,228809,228809,228812,0,3,0
65299,4,3,228813,228813,228816,0,3,1
65300,3,1,228816,228816,228817,0,1,0
65301,6,1,228822,228822,228823,0,1,5
65302,6,3,228828,228828,228831,0,3,5
65303,1,2,228829,228831,228833,2,4,0
65304,3,2,228832,228833,228835,1,3,0
65305,6,1,228838,228838,228839,0,1,3
65306,6,2,228844,228844,228846,0,2,5
65307,4,2,228848,228848,228850,0,2,2
65308,5,1,228853,228853,228854,0,1,3
65309,1,2,228854,228854,228856,0,2,0
65310,1,2,228855,228856,228858,1,3,0
65311,1,3,228856,228858,228861,2,5,0
65312,5,3,228861,228861,228864,0,3,0
65313,5,3,228866,228866,228869,0,3,2
65314,1,3,228867,228869,228872,2,5,0
65315,4,3,228871,228872,228875,1,4,0
65316,1,2,228872,228875,228877,3,5,0
65317,1,2,228873,228877,228879,4,6,0
65318,6,1,228879,228879,228880,0,1,0
65319,1,1,228880,228880,228881,0,1,0
65320,6,2,228886,228886,228888,0,2,5
65321,5,3,228891,228891,228894,0,3,3
65322,1,2,228892,228894,228896,2,4,0
65323,6,3,228898,228898,228901,0,3,2
65324,1,3,228899,228901,228904,2,5,0
65325,3,2,228902,228904,228906,2,4,0
65326,3,2,228905,228906,228908,1,3,0
65327,1,1,228906,228908,228909,2,3,0
65328,2,2,228908,228909,228911,1,3,0
65329,2,1,228910,228911,228912,1,2,0
65330,5,2,228915,228915,228917,0,2,3
65331,6,3,228921,228921,228924,0,3,4
65332,1,3,228922,228924,228927,2,5,0
65333,2,3,228924,228927,228930,3,6,0
65334,1,2,228925,228930,228932,5,7,0
65335,5,2,228930,228932,228934,2,4,0
65336,3,2,228933,228934,228936,1,3,0
65337,6,1,228939,228939,228940,0,1,3
65338,3,1,228942,228942,228943,0,1,2
65339,5,3,228947,228947,228950,0,3,4
65340,2,3,228949,228950,228953,1,4,0
65341,1,1,228950,228953,228954,3,4,0
65342,1,3,228951,228954,228957,3,6,0
65343,4,1,228955,228957,228958,2,3,0
65344,1,2,228956,228958,228960,2,4,0
65345,3,3,228959,228960,228963,1,4,0
65346,1,3,228960,228963,228966,3,6,0
65347,2,3,228962,228966,228969,4,7,0
65348,2,3,228964,228969,228972,5,8,0
65349,4,2,228968,228972,228974,4,6,0
65350,6,1,228974,228974,228975,0,1,0
65351,6,3,228980,228980,228983,0,3,5
65352,6,1,228986,228986,228987,0,1,3
65353,3,1,228989,228989,228990,0,1,2
65354,3,2,228992,228992,228994,0,2,2
65355,3,1,228995,228995,228996,0,1,1
65356,2,2,228997,228997,228999,0,2,1
65357,6,3,229003,229003,229006,0,3,4
65358,3,3,229006,229006,229009,0,3,0
65359,2,1,229008,229009,229010,1,2,0
65360,5,2,229013,229013,229015,0,2,3
65361,2,3,229015,229015,229018,0,3,0
65362,2,1,229017,229018,229019,1,2,0
65363,2,1,229019,229019,229020,0,1,0
65364,1,2,229020,229020,229022,0,2,0
65365,5,3,229025,229025,229028,0,3,3
65366,1,1,229026,229028,229029,2,3,0
65367,4,2,229030,229030,229032,0,2,1
65368,4,1,229034,229034,229035,0,1,2
65369,5,1,229039,229039,229040,0,1,4
65370,1,3,229040,229040,229043,0,3,0
65371,3,3,229043,229043,229046,0,3,0
65372,6,2,229049,229049,229051,0,2,3
65373,6,3,229055,229055,229058,0,3,4
65374,6,2,229061,229061,229063,0,2,3
65375,6,3,229067,229067,229070,0,3,4
65376,5,1,229072,229072,229073,0,1,2
65377,1,2,229073,229073,229075,0,2,0
65378,3,1,229076,229076,229077,0,1,1
65379,2,2,229078,229078,229080,0,2,1
65380,6,2,229084,229084,229086,0,2,4
65381,4,2,229088,229088,229090,0,2,2
65382,3,2,229091,229091,229093,0,2,1
65383,6,3,229097,229097,229100,0,3,4
65384,2,2,229099,229100,229102,1,3,0
65385,2,2,229101,229102,229104,1,3,0
65386,4,3,229105,229105,229108,0,3,1
65387,2,1,229107,229108,229109,1,2,0
65388,5,1,229112,229112,229113,0,1,3
65389,2,3,229114,229114,229117,0,3,1
65390,2,2,229116,229117,229119,1,3,0
65391,2,2,229118,229119,229121,1,3,0
65392,4,1,229122,229122,229123,0,1,1
65393,5,2,229127,229127,229129,0,2,4
65394,6,1,229133,229133,229134,0,1,4
65395,3,3,229136,229136,229139,0,3,2
65396,5,3,229141,229141,229144,0,3,2
65397,6,2,229147,229147,229149,0,2,3
65398,5,2,229152,229152,229154,0,2,3
65399,2,2,229154,229154,229156,0,2,0
65400,1,2,229155,229156,229158,1,3,0
65401,1,2,229156,229158,229160,2,4,0
65402,6,1,229162,229162,229163,0,1,2
65403,3,3,229165,229165,229168,0,3,2
65404,6,3,229171,229171,229174,0,3,3
65405,4,2,229175,229175,229177,0,2,1
65406,1,1,229176,229177,229178,1,2,0
65407,5,1,229181,229181,229182,0,1,3
65408,5,2,229186,229186,229188,0,2,4
65409,1,3,229187,229188,229191,1,4,0
65410,1,3,229188,229191,229194,3,6,0
65411,6,1,229194,229194,229195,0,1,0
65412,2,3,229196,229196,229199,0,3,1
65413,4,2,229200,229200,229202,0,2,1
65414,5,2,229205,229205,229207,0,2,3
65415,4,3,229209,229209,229212,0,3,2
65416,4,1,229213,229213,229214,0,1,1
65417,4,1,229217,229217,229218,0,1,3
65418,6,3,229223,229223,229226,0,3,5
65419,3,3,229226,229226,229229,0,3,0
65420,2,3,229228,229229,229232,1,4,0
65421,6,2,229234,229234,229236,0,2,2
65422,1,3,229235,229236,229239,1,4,0
65423,3,1,229238,229239,229240,1,2,0
65424,5,2,229243,229243,229245,0,2,3
65425,3,3,229246,229246,229249,0,3,1
65426,5,1,229251,229251,229252,0,1,2
65427,2,2,229253,229253,229255,0,2,1
65428,4,1,229257,229257,229258,0,1,2
65429,4,3,229261,229261,229264,0,3,3
65430,6,2,229267,229267,229269,0,2,3
65431,1,2,229268,229269,229271,1,3,0
65432,2,3,229270,229271,229274,1,4,0
65433,2,2,229272,229274,229276,2,4,0
65434,5,1,229277,229277,229278,0,1,1
65435,6,1,229283,229283,229284,0,1,5
65436,2,1,229285,229285,229286,0,1,1
65437,3,2,229288,229288,229290,0,2,2
65438,6,3,229294,229294,229297,0,3,4
65439,5,3,229299,229299,229302,0,3,2
65440,2,1,229301,229302,229303,1,2,0
65441,4,3,229305,229305,229308,0,3,2
65442,1,1,229306,229308,229309,2,3,0
65443,2,2,229308,229309,229311,1,3,0
65444,4,3,229312,229312,229315,0,3,1
65445,1,1,229313,229315,229316,2,3,0
65446,4,2,229317,229317,229319,0,2,1
65447,5,1,229322,229322,229323,0,1,3
65448,6,1,229328,229328,229329,0,1,5
65449,3,2,229331,229331,229333,0,2,2
65450,5,3,229336,229336,229339,0,3,3
65451,3,3,229339,229339,229342,0,3,0
65452,1,1,229340,229342,229343,2,3,0
65453,2,3,229342,229343,229346,1,4,0
65454,1,2,229343,229346,229348,3,5,0
65455,5,2,229348,229348,229350,0,2,0
65456,3,2,229351,229351,229353,0,2,1
65457,3,1,229354,229354,229355,0,1,1
65458,3,3,229357,229357,229360,0,3,2
65459,3,2,229360,229360,229362,0,2,0
65460,6,2,229366,229366,229368,0,2,4
65461,3,2,229369,229369,229371,0,2,1
65462,3,1,229372,229372,229373,0,1,1
65463,6,3,229378,229378,229381,0,3,5
65464,3,3,229381,229381,229384,0,3,0
65465,4,2,229385,229385,229387,0,2,1
65466,2,1,229387,229387,229388,0,1,0
65467,2,1,229389,229389,229390,0,1,1
65468,2,1,229391,229391,229392,0,1,1
65469,6,2,229397,229397,229399,0,2,5
65470,3,3,229400,229400,229403,0,3,1
65471,6,2,229406,229406,229408,0,2,3
65472,1,2,229407,229408,229410,1,3,0
65473,2,2,229409,229410,229412,1,3,0
65474,6,1,229415,229415,229416,0,1,3
65475,5,2,229420,229420,229422,0,2,4
65476,2,2,229422,229422,229424,0,2,0
65477,5,2,229427,229427,229429,0,2,3
65478,6,3,229433,229433,229436,0,3,4
65479,4,3,229437,229437,229440,0,3,1
65480,6,3,229443,229443,229446,0,3,3
65481,2,3,229445,229446,229449,1,4,0
65482,1,2,229446,229449,229451,3,5,0
65483,3,3,229449,229451,229454,2,5,0
65484,3,3,229452,229454,229457,2,5,0
65485,1,2,229453,229457,229459,4,6,0
65486,4,1,229457,229459,229460,2,3,0
65487,4,3,229461,229461,229464,0,3,1
65488,4,3,229465,229465,229468,0,3,1
65489,2,1,229467,229468,229469,1,2,0
65490,4,2,229471,229471,229473,0,2,2
65491,6,1,229477,229477,229478,0,1,4
65492,6,2,229483,229483,229485,0,2,5
65493,3,2,229486,229486,229488,0,2,1
65494,3,3,229489,229489,229492,0,3,1
65495,5,1,229494,229494,229495,0,1,2
65496,6,3,229500,229500,229503,0,3,5
65497,2,2,229502,229503,229505,1,3,0
65498,4,1,229506,229506,229507,0,1,1
65499,6,1,229512,229512,229513,0,1,5
65500,4,1,229516,229516,229517,0,1,3
65501,5,2,229521,229521,229523,0,2,4
65502,3,2,229524,229524,229526,0,2,1
65503,3,3,229527,229527,229530,0,3,1
65504,4,3,229531,229531,229534,0,3,1
65505,2,1,229533,229534,229535,1,2,0
65506,2,1,229535,229535,229536,0,1,0
65507,1,3,229536,229536,229539,0,3,0
65508,6,2,229542,229542,229544,0,2,3
65509,6,3,229548,229548,229551,0,3,4
65510,6,2,229554,229554,229556,0,2,3
65511,3,1,229557,229557,229558,0,1,1
65512,5,2,229562,229562,229564,0,2,4
65513,4,3,229566,229566,229569,0,3,2
65514,4,1,229570,229570,229571,0,1,1
65515,4,1,229574,229574,229575,0,1,3
65516,5,3,229579,229579,229582,0,3,4
65517,6,1,229585,229585,229586,0,1,3
65518,1,3,229586,229586,229589,0,3,0
65519,4,2,229590,229590,229592,0,2,1
65520,5,2,229595,229595,229597,0,2,3
65521,2,1,229597,229597,229598,0,1,0
65522,3,1,229600,229600,229601,0,1,2
65523,1,1,229601,229601,229602,0,1,0
65524,6,1,229607,229607,229608,0,1,5
65525,6,2,229613,229613,229615,0,2,5
65526,3,3,229616,229616,229619,0,3,1
65527,6,3,229622,229622,229625,0,3,3
65528,1,3,229623,229625,229628,2,5,0
65529,5,3,229628,229628,229631,0,3,0
65530,3,2,229631,229631,229633,0,2,0
65531,5,3,229636,229636,229639,0,3,3
65532,1,3,229637,229639,229642,2,5,0
65533,4,3,229641,229642,229645,1,4,0
65534,2,2,229643,229645,229647,2,4,0
65535,2,2,229645,229647,229649,2,4,0
65536,4,1,229649,229649,229650,0,1,0
65537,2,1,229651,229651,229652,0,1,1
65538,1,2,229652,229652,229654,0,2,0
65539,2,1,229654,229654,229655,0,1,0
65540,3,3,229657,229657,229660,0,3,2
65541,6,2,229663,229663,229665,0,2,3
65542,3,2,229666,229666,229668,0,2,1
65543,1,1,229667,229668,229669,1,2,0
65544,2,2,229669,229669,229671,0,2,0
65545,2,1,229671,229671,229672,0,1,0
65546,1,2,229672,229672,229674,0,2,0
65547,3,3,229675,229675,229678,0,3,1
65548,5,1,229680,229680,229681,0,1,2
65549,3,2,229683,229683,229685,0,2,2
65550,5,3,229688,229688,229691,0,3,3
65551,3,3,229691,229691,229694,0,3,0
65552,1,1,229692,229694,229695,2,3,0
65553,6,1,229698,229698,229699,0,1,3
65554,3,1,229701,229701,229702,0,1,2
65555,4,3,229705,229705,229708,0,3,3
65556,3,2,229708,229708,229710,0,2,0
65557,5,1,229713,229713,229714,0,1,3
65558,4,2,229717,229717,229719,0,2,3
65559,1,2,229718,229719,229721,1,3,0
65560,2,3,229720,229721,229724,1,4,0
65561,3,2,229723,229724,229726,1,3,0
65562,3,3,229726,229726,229729,0,3,0
65563,4,2,229730,229730,229732,0,2,1
65564,4,1,229734,229734,229735,0,1,2
65565,5,1,229739,229739,229740,0,1,4
65566,2,1,229741,229741,229742,0,1,1
65567,6,1,229747,229747,229748,0,1,5
65568,3,2,229750,229750,229752,0,2,2
65569,6,2,229756,229756,229758,0,2,4
65570,4,2,229760,229760,229762,0,2,2
65571,6,1,229766,229766,229767,0,1,4
65572,4,1,229770,229770,229771,0,1,3
65573,4,2,229774,229774,229776,0,2,3
65574,1,2,229775,229776,229778,1,3,0
65575,5,1,229780,229780,229781,0,1,2
65576,6,2,229786,229786,229788,0,2,5
65577,6,1,229792,229792,229793,0,1,4
65578,1,1,229793,229793,229794,0,1,0
65579,6,3,229799,229799,229802,0,3,5
65580,2,1,229801,229802,229803,1,2,0
65581,1,2,229802,229803,229805,1,3,0
65582,3,3,229805,229805,229808,0,3,0
65583,1,2,229806,229808,229810,2,4,0
65584,6,2,229812,229812,229814,0,2,2
65585,3,2,229815,229815,229817,0,2,1
65586,1,1,229816,229817,229818,1,2,0
65587,6,1,229822,229822,229823,0,1,4
65588,1,3,229823,229823,229826,0,3,0
65589,3,3,229826,229826,229829,0,3,0
65590,1,2,229827,229829,229831,2,4,0
65591,3,2,229830,229831,229833,1,3,0
65592,1,2,229831,229833,229835,2,4,0
65593,6,2,229837,229837,229839,0,2,2
65594,2,2,229839,229839,229841,0,2,0
65595,2,3,229841,229841,229844,0,3,0
65596,2,3,229843,229844,229847,1,4,0
65597,1,1,229844,229847,229848,3,4,0
65598,1,2,229845,229848,229850,3,5,0
65599,6,2,229851,229851,229853,0,2,1
65600,1,3,229852,229853,229856,1,4,0
65601,2,1,229854,229856,229857,2,3,0
65602,1,1,229855,229857,229858,2,3,0
65603,6,2,229861,229861,229863,0,2,3
65604,1,1,229862,229863,229864,1,2,0
65605,2,3,229864,229864,229867,0,3,0
65606,2,1,229866,229867,229868,1,2,0
65607,1,2,229867,229868,229870,1,3,0
65608,4,3,229871,229871,229874,0,3,1
65609,5,2,229876,229876,229878,0,2,2
65610,3,1,229879,229879,229880,0,1,1
65611,4,2,229883,229883,229885,0,2,3
65612,6,2,229889,229889,229891,0,2,4
65613,3,2,229892,229892,229894,0,2,1
65614,1,1,229893,229894,229895,1,2,0
65615,6,3,229899,229899,229902,0,3,4
65616,4,2,229903,229903,229905,0,2,1
65617,4,2,229907,229907,229909,0,2,2
65618,6,3,229913,229913,229916,0,3,4
65619,2,1,229915,229916,229917,1,2,0
65620,6,1,229921,229921,229922,0,1,4
65621,2,2,229923,229923,229925,0,2,1
65622,3,3,229926,229926,229929,0,3,1
65623,6,2,229932,229932,229934,0,2,3
65624,6,1,229938,229938,229939,0,1,4
65625,5,1,229943,229943,229944,0,1,4
65626,1,1,229944,229944,229945,0,1,0
65627,1,3,229945,229945,229948,0,3,0
65628,5,1,229950,229950,229951,0,1,2
65629,1,3,229951,229951,229954,0,3,0
65630,3,2,229954,229954,229956,0,2,0
65631,1,2,229955,229956,229958,1,3,0
65632,6,2,229961,229961,229963,0,2,3
65633,5,2,229966,229966,229968,0,2,3
65634,5,3,229971,229971,229974,0,3,3
65635,5,2,229976,229976,229978,0,2,2
65636,2,2,229978,229978,229980,0,2,0
65637,3,2,229981,229981,229983,0,2,1
65638,5,3,229986,229986,229989,0,3,3
65639,4,1,229990,229990,229991,0,1,1
65640,6,1,229996,229996,229997,0,1,5
65641,4,2,230000,230000,230002,0,2,3
65642,1,3,230001,230002,230005,1,4,0
65643,2,3,230003,230005,230008,2,5,0
65644,2,3,230005,230008,230011,3,6,0
65645,2,3,230007,230011,230014,4,7,0
65646,4,1,230011,230014,230015,3,4,0
65647,1,2,230012,230015,230017,3,5,0
65648,6,2,230018,230018,230020,0,2,1
65649,3,1,230021,230021,230022,0,1,1
65650,5,2,230026,230026,230028,0,2,4
65651,1,1,230027,230028,230029,1,2,0
65652,4,1,230031,230031,230032,0,1,2
65653,6,1,230037,230037,230038,0,1,5
65654,3,2,230040,230040,230042,0,2,2
65655,3,2,230043,230043,230045,0,2,1
65656,5,2,230048,230048,230050,0,2,3
65657,5,1,230053,230053,230054,0,1,3
65658,1,3,230054,230054,230057,0,3,0
65659,4,2,230058,230058,230060,0,2,1
65660,6,1,230064,230064,230065,0,1,4
65661,4,1,230068,230068,230069,0,1,3
65662,4,1,230072,230072,230073,0,1,3
65663,1,2,230073,230073,230075,0,2,0
65664,5,3,230078,230078,230081,0,3,3
65665,5,1,230083,230083,230084,0,1,2
65666,5,3,230088,230088,230091,0,3,4
65667,3,1,230091,230091,230092,0,1,0
65668,3,2,230094,230094,230096,0,2,2
65669,3,3,230097,230097,230100,0,3,1
65670,1,3,230098,230100,230103,2,5,0
65671,1,1,230099,230103,230104,4,5,0
65672,6,2,230105,230105,230107,0,2,1
65673,3,1,230108,230108,230109,0,1,1
65674,2,1,230110,230110,230111,0,1,1
65675,3,2,230113,230113,230115,0,2,2
65676,3,3,230116,230116,230119,0,3,1
65677,1,1,230117,230119,230120,2,3,0
65678,4,1,230121,230121,230122,0,1,1
65679,6,1,230127,230127,230128,0,1,5
65680,1,1,230128,230128,230129,0,1,0
65681,1,2,230129,230129,230131,0,2,0
65682,5,2,230134,230134,230136,0,2,3
65683,5,1,230139,230139,230140,0,1,3
65684,5,3,230144,230144,230147,0,3,4
65685,3,3,230147,230147,230150,0,3,0
65686,2,3,230149,230150,230153,1,4,0
65687,5,3,230154,230154,230157,0,3,1
65688,6,1,230160,230160,230161,0,1,3
65689,2,3,230162,230162,230165,0,3,1
65690,1,3,230163,230165,230168,2,5,0
65691,4,1,230167,230168,230169,1,2,0
65692,6,3,230173,230173,230176,0,3,4
65693,3,3,230176,230176,230179,0,3,0
65694,5,2,230181,230181,230183,0,2,2
65695,5,1,230186,230186,230187,0,1,3
65696,4,1,230190,230190,230191,0,1,3
65697,1,2,230191,230191,230193,0,2,0
65698,6,2,230197,230197,230199,0,2,4
65699,5,1,230202,230202,230203,0,1,3
65700,2,3,230204,230204,230207,0,3,1
65701,1,3,230205,230207,230210,2,5,0
65702,6,2,230211,230211,230213,0,2,1
65703,3,3,230214,230214,230217,0,3,1
65704,6,1,230220,230220,230221,0,1,3
65705,5,1,230225,230225,230226,0,1,4
65706,3,3,230228,230228,230231,0,3,2
65707,6,1,230234,230234,230235,0,1,3
65708,4,2,230238,230238,230240,0,2,3
65709,6,3,230244,230244,230247,0,3,4
65710,1,1,230245,230247,230248,2,3,0
65711,2,3,230247,230248,230251,1,4,0
65712,3,1,230250,230251,230252,1,2,0
65713,4,3,230254,230254,230257,0,3,2
65714,3,2,230257,230257,230259,0,2,0
65715,1,3,230258,230259,230262,1,4,0
65716,1,1,230259,230262,230263,3,4,0
65717,4,2,230263,230263,230265,0,2,0
65718,5,2,230268,230268,230270,0,2,3
65719,3,3,230271,230271,230274,0,3,1
65720,2,1,230273,230274,230275,1,2,0
65721,2,3,230275,230275,230278,0,3,0
65722,5,3,230280,230280,230283,0,3,2
65723,6,3,230286,230286,230289,0,3,3
65724,5,3,230291,230291,230294,0,3,2
65725,4,1,230295,230295,230296,0,1,1
65726,1,3,230296,230296,230299,0,3,0
65727,6,2,230302,230302,230304,0,2,3
65728,4,3,230306,230306,230309,0,3,2
65729,6,3,230312,230312,230315,0,3,3
65730,3,2,230315,230315,230317,0,2,0
65731,1,2,230316,230317,230319,1,3,0
65732,2,3,230318,230319,230322,1,4,0
65733,2,2,230320,230322,230324,2,4,0
65734,5,1,230325,230325,230326,0,1,1
65735,3,2,230328,230328,230330,0,2,2
65736,3,1,230331,230331,230332,0,1,1
65737,2,2,230333,230333,230335,0,2,1
65738,5,2,230338,230338,230340,0,2,3
65739,6,1,230344,230344,230345,0,1,4
65740,4,2,230348,230348,230350,0,2,3
65741,4,2,230352,230352,230354,0,2,2
65742,1,1,230353,230354,230355,1,2,0
65743,2,2,230355,230355,230357,0,2,0
65744,3,3,230358,230358,230361,0,3,1
65745,1,3,230359,230361,230364,2,5,0
65746,4,2,230363,230364,230366,1,3,0
65747,4,2,230367,230367,230369,0,2,1
65748,2,2,230369,230369,230371,0,2,0
65749,3,3,230372,230372,230375,0,3,1
65750,6,2,230378,230378,230380,0,2,3
65751,6,2,230384,230384,230386,0,2,4
65752,1,1,230385,230386,230387,1,2,0
65753,4,2,230389,230389,230391,0,2,2
65754,1,2,230390,230391,230393,1,3,0
65755,3,2,230393,230393,230395,0,2,0
65756,3,3,230396,230396,230399,0,3,1
65757,2,3,230398,230399,230402,1,4,0
65758,1,1,230399,230402,230403,3,4,0
65759,2,2,230401,230403,230405,2,4,0
65760,5,1,230406,230406,230407,0,1,1
65761,3,3,230409,230409,230412,0,3,2
65762,1,3,230410,230412,230415,2,5,0
65763,5,2,230415,230415,230417,0,2,0
65764,1,1,230416,230417,230418,1,2,0
65765,4,1,230420,230420,230421,0,1,2
65766,1,3,230421,230421,230424,0,3,0
65767,3,2,230424,230424,230426,0,2,0
65768,3,3,230427,230427,230430,0,3,1
65769,5,1,230432,230432,230433,0,1,2
65770,5,2,230437,230437,230439,0,2,4
65771,5,2,230442,230442,230444,0,2,3
65772,4,1,230446,230446,230447,0,1,2
65773,1,3,230447,230447,230450,0,3,0
65774,5,1,230452,230452,230453,0,1,2
65775,3,1,230455,230455,230456,0,1,2
65776,1,2,230456,230456,230458,0,2,0
65777,3,1,230459,230459,230460,0,1,1
65778,1,3,230460,230460,230463,0,3,0
65779,3,2,230463,230463,230465,0,2,0
65780,1,1,230464,230465,230466,1,2,0
65781,6,2,230470,230470,230472,0,2,4
65782,5,3,230475,230475,230478,0,3,3
65783,1,3,230476,230478,230481,2,5,0
65784,4,3,230480,230481,230484,1,4,0
65785,5,2,230485,230485,230487,0,2,1
65786,2,2,230487,230487,230489,0,2,0
65787,2,3,230489,230489,230492,0,3,0
65788,1,2,230490,230492,230494,2,4,0
65789,1,2,230491,230494,230496,3,5,0
65790,2,2,230493,230496,230498,3,5,0
65791,6,2,230499,230499,230501,0,2,1
65792,5,1,230504,230504,230505,0,1,3
65793,3,1,230507,230507,230508,0,1,2
65794,3,3,230510,230510,230513,0,3,2
65795,4,1,230514,230514,230515,0,1,1
65796,6,2,230520,230520,230522,0,2,5
65797,4,2,230524,230524,230526,0,2,2
65798,1,2,230525,230526,230528,1,3,0
65799,4,1,230529,230529,230530,0,1,1
65800,3,2,230532,230532,230534,0,2,2
65801,5,2,230537,230537,230539,0,2,3
65802,1,1,230538,230539,230540,1,2,0
65803,5,2,230543,230543,230545,0,2,3
65804,2,3,230545,230545,230548,0,3,0
65805,4,1,230549,230549,230550,0,1,1
65806,6,2,230555,230555,230557,0,2,5
65807,1,3,230556,230557,230560,1,4,0
65808,6,2,230562,230562,230564,0,2,2
65809,2,2,230564,230564,230566,0,2,0
65810,1,2,230565,230566,230568,1,3,0
65811,2,2,230567,230568,230570,1,3,0
65812,2,1,230569,230570,230571,1,2,0
65813,2,2,230571,230571,230573,0,2,0
65814,3,3,230574,230574,230577,0,3,1
65815,5,1,230579,230579,230580,0,1,2
65816,6,2,230585,230585,230587,0,2,5
65817,6,3,230591,230591,230594,0,3,4
65818,3,1,230594,230594,230595,0,1,0
65819,1,1,230595,230595,230596,0,1,0
65820,6,3,230601,230601,230604,0,3,5
65821,2,2,230603,230604,230606,1,3,0
65822,6,2,230609,230609,230611,0,2,3
65823,3,3,230612,230612,230615,0,3,1
65824,5,3,230617,230617,230620,0,3,2
65825,6,3,230623,230623,230626,0,3,3
65826,5,1,230628,230628,230629,0,1,2
65827,2,1,230630,230630,230631,0,1,1
65828,1,1,230631,230631,230632,0,1,0
65829,1,3,230632,230632,230635,0,3,0
65830,5,1,230637,230637,230638,0,1,2
65831,4,1,230641,230641,230642,0,1,3
65832,6,3,230647,230647,230650,0,3,5
65833,3,1,230650,230650,230651,0,1,0
65834,1,1,230651,230651,230652,0,1,0
65835,1,2,230652,230652,230654,0,2,0
65836,2,1,230654,230654,230655,0,1,0
65837,2,3,230656,230656,230659,0,3,1
65838,4,1,230660,230660,230661,0,1,1
65839,5,1,230665,230665,230666,0,1,4
65840,3,2,230668,230668,230670,0,2,2
65841,3,3,230671,230671,230674,0,3,1
65842,4,3,230675,230675,230678,0,3,1
65843,3,3,230678,230678,230681,0,3,0
65844,5,1,230683,230683,230684,0,1,2
65845,6,1,230689,230689,230690,0,1,5
65846,4,3,230693,230693,230696,0,3,3
65847,2,3,230695,230696,230699,1,4,0
65848,1,1,230696,230699,230700,3,4,0
65849,2,2,230698,230700,230702,2,4,0
65850,2,2,230700,230702,230704,2,4,0
65851,3,2,230703,230704,230706,1,3,0
65852,6,1,230709,230709,230710,0,1,3
65853,2,3,230711,230711,230714,0,3,1
65854,2,2,230713,230714,230716,1,3,0
65855,1,3,230714,230716,230719,2,5,0
65856,6,3,230720,230720,230723,0,3,1
65857,6,2,230726,230726,230728,0,2,3
65858,4,1,230730,230730,230731,0,1,2
65859,2,3,230732,230732,230735,0,3,1
65860,3,1,230735,230735,230736,0,1,0
65861,5,1,230740,230740,230741,0,1,4
65862,1,3,230741,230741,230744,0,3,0
65863,5,1,230746,230746,230747,0,1,2
65864,2,1,230748,230748,230749,0,1,1
65865,4,1,230752,230752,230753,0,1,3
65866,6,1,230758,230758,230759,0,1,5
65867,3,3,230761,230761,230764,0,3,2
65868,1,3,230762,230764,230767,2,5,0
65869,5,1,230767,230767,230768,0,1,0
65870,6,3,230773,230773,230776,0,3,5
65871,1,2,230774,230776,230778,2,4,0
65872,2,3,230776,230778,230781,2,5,0
65873,1,3,230777,230781,230784,4,7,0
65874,1,3,230778,230784,230787,6,9,0
65875,2,3,230780,230787,230790,7,10,0
65876,5,2,230785,230790,230792,5,7,0
65877,4,3,230789,230792,230795,3,6,0
65878,5,1,230794,230795,230796,1,2,0
65879,1,3,230795,230796,230799,1,4,0
65880,2,3,230797,230799,230802,2,5,0
65881,5,1,230802,230802,230803,0,1,0
65882,5,2,230807,230807,230809,0,2,4
65883,4,1,230811,230811,230812,0,1,2
65884,6,1,230817,230817,230818,0,1,5
65885,6,1,230823,230823,230824,0,1,5
65886,5,2,230828,230828,230830,0,2,4
65887,5,2,230833,230833,230835,0,2,3
65888,6,3,230839,230839,230842,0,3,4
65889,4,3,230843,230843,230846,0,3,1
65890,1,2,230844,230846,230848,2,4,0
65891,4,2,230848,230848,230850,0,2,0
65892,1,2,230849,230850,230852,1,3,0
65893,6,2,230855,230855,230857,0,2,3
65894,2,1,230857,230857,230858,0,1,0
65895,5,1,230862,230862,230863,0,1,4
65896,1,1,230863,230863,230864,0,1,0
65897,5,1,230868,230868,230869,0,1,4
65898,3,3,230871,230871,230874,0,3,2
65899,4,1,230875,230875,230876,0,1,1
65900,6,3,230881,230881,230884,0,3,5
65901,3,1,230884,230884,230885,0,1,0
65902,3,1,230887,230887,230888,0,1,2
65903,1,1,230888,230888,230889,0,1,0
65904,1,2,230889,230889,230891,0,2,0
65905,2,2,230891,230891,230893,0,2,0
65906,3,3,230894,230894,230897,0,3,1
65907,6,3,230900,230900,230903,0,3,3
65908,6,1,230906,230906,230907,0,1,3
65909,4,3,230910,230910,230913,0,3,3
65910,1,1,230911,230913,230914,2,3,0
65911,2,1,230913,230914,230915,1,2,0
65912,3,3,230916,230916,230919,0,3,1
65913,4,2,230920,230920,230922,0,2,1
65914,6,3,230926,230926,230929,0,3,4
65915,5,1,230931,230931,230932,0,1,2
65916,6,1,230937,230937,230938,0,1,5
65917,6,1,230943,230943,230944,0,1,5
65918,2,1,230945,230945,230946,0,1,1
65919,2,3,230947,230947,230950,0,3,1
65920,1,2,230948,230950,230952,2,4,0
65921,4,1,230952,230952,230953,0,1,0
65922,2,1,230954,230954,230955,0,1,1
65923,3,2,230957,230957,230959,0,2,2
65924,1,2,230958,230959,230961,1,3,0
65925,3,1,230961,230961,230962,0,1,0
65926,4,3,230965,230965,230968,0,3,3
65927,6,2,230971,230971,230973,0,2,3
65928,3,1,230974,230974,230975,0,1,1
65929,5,3,230979,230979,230982,0,3,4
65930,6,2,230985,230985,230987,0,2,3
65931,5,3,230990,230990,230993,0,3,3
65932,3,3,230993,230993,230996,0,3,0
65933,3,3,230996,230996,230999,0,3,0
65934,2,3,230998,230999,231002,1,4,0
65935,2,2,231000,231002,231004,2,4,0
65936,1,1,231001,231004,231005,3,4,0
65937,6,2,231007,231007,231009,0,2,2
65938,4,2,231011,231011,231013,0,2,2
65939,5,3,231016,231016,231019,0,3,3
65940,6,1,231022,231022,231023,0,1,3
65941,3,3,231025,231025,231028,0,3,2
65942,2,3,231027,231028,231031,1,4,0
65943,2,3,231029,231031,231034,2,5,0
65944,6,3,231035,231035,231038,0,3,1
65945,4,3,231039,231039,231042,0,3,1
65946,6,2,231045,231045,231047,0,2,3
65947,1,2,231046,231047,231049,1,3,0
65948,1,3,231047,231049,231052,2,5,0
65949,2,1,231049,231052,231053,3,4,0
65950,6,3,231055,231055,231058,0,3,2
65951,1,2,231056,231058,231060,2,4,0
65952,6,1,231062,231062,231063,0,1,2
65953,6,2,231068,231068,231070,0,2,5
65954,2,3,231070,231070,231073,0,3,0
65955,6,2,231076,231076,231078,0,2,3
65956,1,1,231077,231078,231079,1,2,0
65957,3,1,231080,231080,231081,0,1,1
65958,1,2,231081,231081,231083,0,2,0
65959,3,2,231084,231084,231086,0,2,1
65960,2,2,231086,231086,231088,0,2,0
65961,1,2,231087,231088,231090,1,3,0
65962,3,2,231090,231090,231092,0,2,0
65963,3,3,231093,231093,231096,0,3,1
65964,4,2,231097,231097,231099,0,2,1
65965,3,3,231100,231100,231103,0,3,1
65966,1,3,231101,231103,231106,2,5,0
65967,5,1,231106,231106,231107,0,1,0
65968,1,2,231107,231107,231109,0,2,0
65969,3,1,231110,231110,231111,0,1,1
65970,1,2,231111,231111,231113,0,2,0
65971,3,2,231114,231114,231116,0,2,1
65972,5,1,231119,231119,231120,0,1,3
65973,6,2,231125,231125,231127,0,2,5
65974,1,1,231126,231127,231128,1,2,0
65975,3,3,231129,231129,231132,0,3,1
65976,6,2,231135,231135,231137,0,2,3
65977,5,2,231140,231140,231142,0,2,3
65978,6,3,231146,231146,231149,0,3,4
65979,1,1,231147,231149,231150,2,3,0
65980,2,1,231149,231150,231151,1,2,0
65981,6,2,231155,231155,231157,0,2,4
65982,4,2,231159,231159,231161,0,2,2
65983,1,2,231160,231161,231163,1,3,0
65984,5,2,231165,231165,231167,0,2,2
65985,5,3,231170,231170,231173,0,3,3
65986,2,2,231172,231173,231175,1,3,0
65987,3,3,231175,231175,231178,0,3,0
65988,6,2,231181,231181,231183,0,2,3
65989,6,1,231187,231187,231188,0,1,4
65990,6,3,231193,231193,231196,0,3,5
65991,4,1,231197,231197,231198,0,1,1
65992,6,2,231203,231203,231205,0,2,5
65993,5,2,231208,231208,231210,0,2,3
65994,1,1,231209,231210,231211,1,2,0
65995,2,1,231211,231211,231212,0,1,0
65996,4,1,231215,231215,231216,0,1,3
65997,1,3,231216,231216,231219,0,3,0
65998,6,3,231222,231222,231225,0,3,3
65999,5,3,231227,231227,231230,0,3,2
66000,1,3,231228,231230,231233,2,5,0
66001,6,1,231234,231234,231235,0,1,1
66002,5,1,231239,231239,231240,0,1,4
66003,5,1,231244,231244,231245,0,1,4
66004,2,2,231246,231246,231248,0,2,1
66005,3,3,231249,231249,231252,0,3,1
66006,1,3,231250,231252,231255,2,5,0
66007,6,1,231256,231256,231257,0,1,1
66008,2,1,231258,231258,231259,0,1,1
66009,6,2,231264,231264,231266,0,2,5
66010,1,1,231265,231266,231267,1,2,0
66011,6,2,231271,231271,231273,0,2,4
66012,3,3,231274,231274,231277,0,3,1
66013,1,2,231275,231277,231279,2,4,0
66014,1,3,231276,231279,231282,3,6,0
66015,2,1,231278,231282,231283,4,5,0
66016,2,1,231280,231283,231284,3,4,0
66017,4,1,231284,231284,231285,0,1,0
66018,1,1,231285,231285,231286,0,1,0
66019,2,1,231287,231287,231288,0,1,1
66020,5,3,231292,231292,231295,0,3,4
66021,5,1,231297,231297,231298,0,1,2
66022,2,3,231299,231299,231302,0,3,1
66023,1,2,231300,231302,231304,2,4,0
66024,1,2,231301,231304,231306,3,5,0
66025,5,1,231306,231306,231307,0,1,0
66026,1,1,231307,231307,231308,0,1,0
66027,6,3,231313,231313,231316,0,3,5
66028,2,3,231315,231316,231319,1,4,0
66029,5,1,231320,231320,231321,0,1,1
66030,1,1,231321,231321,231322,0,1,0
66031,3,3,231324,231324,231327,0,3,2
66032,5,3,231329,231329,231332,0,3,2
66033,3,3,231332,231332,231335,0,3,0
66034,3,3,231335,231335,231338,0,3,0
66035,3,2,231338,231338,231340,0,2,0
66036,4,2,231342,231342,231344,0,2,2
66037,4,2,231346,231346,231348,0,2,2
66038,6,2,231352,231352,231354,0,2,4
66039,2,3,231354,231354,231357,0,3,0
66040,5,1,231359,231359,231360,0,1,2
66041,6,1,231365,231365,231366,0,1,5
66042,6,2,231371,231371,231373,0,2,5
66043,5,1,231376,231376,231377,0,1,3
66044,3,3,231379,231379,231382,0,3,2
66045,6,3,231385,231385,231388,0,3,3
66046,5,2,231390,231390,231392,0,2,2
66047,4,2,231394,231394,231396,0,2,2
66048,1,2,231395,231396,231398,1,3,0
66049,3,3,231398,231398,231401,0,3,0
66050,1,2,231399,231401,231403,2,4,0
66051,5,3,231404,231404,231407,0,3,1
66052,6,1,231410,231410,231411,0,1,3
66053,6,2,231416,231416,231418,0,2,5
66054,6,1,231422,231422,231423,0,1,4
66055,3,1,231425,231425,231426,0,1,2
66056,5,2,231430,231430,231432,0,2,4
66057,1,1,231431,231432,231433,1,2,0
66058,1,3,231432,231433,231436,1,4,0
66059,2,1,231434,231436,231437,2,3,0
66060,2,3,231436,231437,231440,1,4,0
66061,6,1,231442,231442,231443,0,1,2
66062,1,3,231443,231443,231446,0,3,0
66063,6,2,231449,231449,231451,0,2,3
66064,4,1,231453,231453,231454,0,1,2
66065,1,2,231454,231454,231456,0,2,0
66066,1,2,231455,231456,231458,1,3,0
66067,5,3,231460,231460,231463,0,3,2
66068,2,2,231462,231463,231465,1,3,0
66069,3,3,231465,231465,231468,0,3,0
66070,2,3,231467,231468,231471,1,4,0
66071,3,1,231470,231471,231472,1,2,0
66072,5,1,231475,231475,231476,0,1,3
66073,6,2,231481,231481,231483,0,2,5
66074,3,2,231484,231484,231486,0,2,1
66075,2,2,231486,231486,231488,0,2,0
66076,2,1,231488,231488,231489,0,1,0
66077,6,3,231494,231494,231497,0,3,5
66078,1,2,231495,231497,231499,2,4,0
66079,3,3,231498,231499,231502,1,4,0
66080,3,3,231501,231502,231505,1,4,0
66081,2,2,231503,231505,231507,2,4,0
66082,5,1,231508,231508,231509,0,1,1
66083,5,1,231513,231513,231514,0,1,4
66084,6,3,231519,231519,231522,0,3,5
66085,5,1,231524,231524,231525,0,1,2
66086,1,1,231525,231525,231526,0,1,0
66087,2,1,231527,231527,231528,0,1,1
66088,6,3,231533,231533,231536,0,3,5
66089,3,1,231536,231536,231537,0,1,0
66090,6,2,231542,231542,231544,0,2,5
66091,4,1,231546,231546,231547,0,1,2
66092,6,3,231552,231552,231555,0,3,5
66093,1,3,231553,231555,231558,2,5,0
66094,6,3,231559,231559,231562,0,3,1
66095,1,3,231560,231562,231565,2,5,0
66096,6,1,231566,231566,231567,0,1,1
66097,1,1,231567,231567,231568,0,1,0
66098,5,2,231572,231572,231574,0,2,4
66099,1,3,231573,231574,231577,1,4,0
66100,4,1,231577,231577,231578,0,1,0
66101,5,2,231582,231582,231584,0,2,4
66102,6,1,231588,231588,231589,0,1,4
66103,4,3,231592,231592,231595,0,3,3
66104,2,3,231594,231595,231598,1,4,0
66105,1,1,231595,231598,231599,3,4,0
66106,6,1,231601,231601,231602,0,1,2
66107,5,2,231606,231606,231608,0,2,4
66108,5,3,231611,231611,231614,0,3,3
66109,5,1,231616,231616,231617,0,1,2
66110,3,1,231619,231619,231620,0,1,2
66111,1,1,231620,231620,231621,0,1,0
66112,2,1,231622,231622,231623,0,1,1
66113,3,3,231625,231625,231628,0,3,2
66114,5,2,231630,231630,231632,0,2,2
66115,1,3,231631,231632,231635,1,4,0
66116,5,2,231636,231636,231638,0,2,1
66117,2,1,231638,231638,231639,0,1,0
66118,3,3,231641,231641,231644,0,3,2
66119,4,1,231645,231645,231646,0,1,1
66120,5,3,231650,231650,231653,0,3,4
66121,5,3,231655,231655,231658,0,3,2
66122,4,1,231659,231659,231660,0,1,1
66123,6,2,231665,231665,231667,0,2,5
66124,2,2,231667,231667,231669,0,2,0
66125,3,1,231670,231670,231671,0,1,1
66126,3,3,231673,231673,231676,0,3,2
66127,1,3,231674,231676,231679,2,5,0
66128,6,2,231680,231680,231682,0,2,1
66129,4,2,231684,231684,231686,0,2,2
66130,2,3,231686,231686,231689,0,3,0
66131,1,3,231687,231689,231692,2,5,0
66132,3,1,231690,231692,231693,2,3,0
66133,6,2,231696,231696,231698,0,2,3
66134,6,1,231702,231702,231703,0,1,4
66135,6,3,231708,231708,231711,0,3,5
66136,4,3,231712,231712,231715,0,3,1
66137,3,1,231715,231715,231716,0,1,0
66138,3,3,231718,231718,231721,0,3,2
66139,3,2,231721,231721,231723,0,2,0
66140,4,1,231725,231725,231726,0,1,2
66141,1,3,231726,231726,231729,0,3,0
66142,3,1,231729,231729,231730,0,1,0
66143,2,2,231731,231731,231733,0,2,1
66144,2,3,231733,231733,231736,0,3,0
66145,6,3,231739,231739,231742,0,3,3
66146,6,3,231745,231745,231748,0,3,3
66147,3,2,231748,231748,231750,0,2,0
66148,1,1,231749,231750,231751,1,2,0
66149,2,1,231751,231751,231752,0,1,0
66150,5,2,231756,231756,231758,0,2,4
66151,1,1,231757,231758,231759,1,2,0
66152,6,2,231763,231763,231765,0,2,4
66153,4,3,231767,231767,231770,0,3,2
66154,4,2,231771,231771,231773,0,2,1
66155,2,1,231773,231773,231774,0,1,0
66156,1,1,231774,231774,231775,0,1,0
66157,3,3,231777,231777,231780,0,3,2
66158,2,3,231779,231780,231783,1,4,0
66159,5,1,231784,231784,231785,0,1,1
66160,6,1,231790,231790,231791,0,1,5
66161,5,3,231795,231795,231798,0,3,4
66162,3,1,231798,231798,231799,0,1,0
66163,4,3,231802,231802,231805,0,3,3
66164,5,3,231807,231807,231810,0,3,2
66165,3,2,231810,231810,231812,0,2,0
66166,1,2,231811,231812,231814,1,3,0
66167,6,1,231817,231817,231818,0,1,3
66168,2,3,231819,231819,231822,0,3,1
66169,2,1,231821,231822,231823,1,2,0
66170,6,2,231827,231827,231829,0,2,4
66171,1,2,231828,231829,231831,1,3,0
66172,6,3,231834,231834,231837,0,3,3
66173,4,3,231838,231838,231841,0,3,1
66174,5,2,231843,231843,231845,0,2,2
66175,6,3,231849,231849,231852,0,3,4
66176,4,3,231853,231853,231856,0,3,1
66177,2,3,231855,231856,231859,1,4,0
66178,2,3,231857,231859,231862,2,5,0
66179,2,1,231859,231862,231863,3,4,0
66180,2,2,231861,231863,231865,2,4,0
66181,2,3,231863,231865,231868,2,5,0
66182,4,2,231867,231868,231870,1,3,0
66183,3,2,231870,231870,231872,0,2,0
66184,1,3,231871,231872,231875,1,4,0
66185,5,1,231876,231876,231877,0,1,1
66186,4,3,231880,231880,231883,0,3,3
66187,5,1,231885,231885,231886,0,1,2
66188,4,2,231889,231889,231891,0,2,3
66189,3,1,231892,231892,231893,0,1,1
66190,5,1,231897,231897,231898,0,1,4
66191,3,2,231900,231900,231902,0,2,2
66192,6,1,231906,231906,231907,0,1,4
66193,3,2,231909,231909,231911,0,2,2
66194,1,1,231910,231911,231912,1,2,0
66195,3,3,231913,231913,231916,0,3,1
66196,5,3,231918,231918,231921,0,3,2
66197,6,2,231924,231924,231926,0,2,3
66198,4,3,231928,231928,231931,0,3,2
66199,1,3,231929,231931,231934,2,5,0
66200,6,3,231935,231935,231938,0,3,1
66201,6,2,231941,231941,231943,0,2,3
66202,2,1,231943,231943,231944,0,1,0
66203,4,1,231947,231947,231948,0,1,3
66204,6,1,231953,231953,231954,0,1,5
66205,6,2,231959,231959,231961,0,2,5
66206,5,3,231964,231964,231967,0,3,3
66207,3,1,231967,231967,231968,0,1,0
66208,5,1,231972,231972,231973,0,1,4
66209,5,1,231977,231977,231978,0,1,4
66210,2,2,231979,231979,231981,0,2,1
66211,3,2,231982,231982,231984,0,2,1
66212,6,3,231988,231988,231991,0,3,4
66213,2,1,231990,231991,231992,1,2,0
66214,3,2,231993,231993,231995,0,2,1
66215,5,2,231998,231998,232000,0,2,3
66216,1,2,231999,232000,232002,1,3,0
66217,1,3,232000,232002,232005,2,5,0
66218,1,3,232001,232005,232008,4,7,0
66219,4,3,232005,232008,232011,3,6,0
66220,6,2,232011,232011,232013,0,2,0
66221,6,3,232017,232017,232020,0,3,4
66222,3,2,232020,232020,232022,0,2,0
66223,4,3,232024,232024,232027,0,3,2
66224,2,3,232026,232027,232030,1,4,0
66225,3,3,232029,232030,232033,1,4,0
66226,1,3,232030,232033,232036,3,6,0
66227,4,1,232034,232036,232037,2,3,0
66228,4,1,232038,232038,232039,0,1,1
66229,6,2,232044,232044,232046,0,2,5
66230,6,2,232050,232050,232052,0,2,4
66231,3,3,232053,232053,232056,0,3,1
66232,6,3,232059,232059,232062,0,3,3
66233,5,3,232064,232064,232067,0,3,2
66234,4,2,232068,232068,232070,0,2,1
66235,4,1,232072,232072,232073,0,1,2
66236,5,1,232077,232077,232078,0,1,4
66237,2,3,232079,232079,232082,0,3,1
66238,3,3,232082,232082,232085,0,3,0
66239,5,2,232087,232087,232089,0,2,2
66240,1,3,232088,232089,232092,1,4,0
66241,6,2,232094,232094,232096,0,2,2
66242,2,1,232096,232096,232097,0,1,0
66243,4,3,232100,232100,232103,0,3,3
66244,1,1,232101,232103,232104,2,3,0
66245,6,1,232107,232107,232108,0,1,3
66246,4,1,232111,232111,232112,0,1,3
66247,5,2,232116,232116,232118,0,2,4
66248,1,3,232117,232118,232121,1,4,0
66249,3,1,232120,232121,232122,1,2,0
66250,6,3,232126,232126,232129,0,3,4
66251,4,1,232130,232130,232131,0,1,1
66252,6,3,232136,232136,232139,0,3,5
66253,6,3,232142,232142,232145,0,3,3
66254,2,2,232144,232145,232147,1,3,0
66255,6,1,232150,232150,232151,0,1,3
66256,2,1,232152,232152,232153,0,1,1
66257,4,1,232156,232156,232157,0,1,3
66258,6,1,232162,232162,232163,0,1,5
66259,6,1,232168,232168,232169,0,1,5
66260,5,1,232173,232173,232174,0,1,4
66261,6,2,232179,232179,232181,0,2,5
66262,5,2,232184,232184,232186,0,2,3
66263,3,1,232187,232187,232188,0,1,1
66264,4,2,232191,232191,232193,0,2,3
66265,1,1,232192,232193,232194,1,2,0
66266,4,1,232196,232196,232197,0,1,2
66267,1,3,232197,232197,232200,0,3,0
66268,1,3,232198,232200,232203,2,5,0
66269,2,1,232200,232203,232204,3,4,0
66270,2,3,232202,232204,232207,2,5,0
66271,2,2,232204,232207,232209,3,5,0
66272,1,2,232205,232209,232211,4,6,0
66273,5,2,232210,232211,232213,1,3,0
66274,4,3,232214,232214,232217,0,3,1
66275,2,3,232216,232217,232220,1,4,0
66276,6,3,232222,232222,232225,0,3,2
66277,4,1,232226,232226,232227,0,1,1
66278,5,2,232231,232231,232233,0,2,4
66279,2,1,232233,232233,232234,0,1,0
66280,6,1,232239,232239,232240,0,1,5
66281,3,2,232242,232242,232244,0,2,2
66282,2,2,232244,232244,232246,0,2,0
66283,1,3,232245,232246,232249,1,4,0
66284,5,2,232250,232250,232252,0,2,1
66285,6,2,232256,232256,232258,0,2,4
66286,1,3,232257,232258,232261,1,4,0
66287,2,3,232259,232261,232264,2,5,0
66288,6,3,232265,232265,232268,0,3,1
66289,4,3,232269,232269,232272,0,3,1
66290,3,3,232272,232272,232275,0,3,0
66291,5,3,232277,232277,232280,0,3,2
66292,4,2,232281,232281,232283,0,2,1
66293,4,2,232285,232285,232287,0,2,2
66294,2,1,232287,232287,232288,0,1,0
66295,2,2,232289,232289,232291,0,2,1
66296,6,1,232295,232295,232296,0,1,4
66297,3,3,232298,232298,232301,0,3,2
66298,6,2,232304,232304,232306,0,2,3
66299,1,2,232305,232306,232308,1,3,0
66300,6,3,232311,232311,232314,0,3,3
66301,5,3,232316,232316,232319,0,3,2
66302,6,2,232322,232322,232324,0,2,3
66303,4,1,232326,232326,232327,0,1,2
66304,2,1,232328,232328,232329,0,1,1
66305,5,2,232333,232333,232335,0,2,4
66306,1,3,232334,232335,232338,1,4,0
66307,1,3,232335,232338,232341,3,6,0
66308,1,1,232336,232341,232342,5,6,0
66309,3,2,232339,232342,232344,3,5,0
66310,2,2,232341,232344,232346,3,5,0
66311,2,2,232343,232346,232348,3,5,0
66312,4,2,232347,232348,232350,1,3,0
66313,6,3,232353,232353,232356,0,3,3
66314,4,2,232357,232357,232359,0,2,1
66315,6,2,232363,232363,232365,0,2,4
66316,5,3,232368,232368,232371,0,3,3
66317,4,2,232372,232372,232374,0,2,1
66318,6,2,232378,232378,232380,0,2,4
66319,4,2,232382,232382,232384,0,2,2
66320,1,3,232383,232384,232387,1,4,0
66321,4,3,232387,232387,232390,0,3,0
66322,5,1,232392,232392,232393,0,1,2
66323,3,1,232395,232395,232396,0,1,2
66324,5,3,232400,232400,232403,0,3,4
66325,6,3,232406,232406,232409,0,3,3
66326,2,1,232408,232409,232410,1,2,0
66327,6,3,232414,232414,232417,0,3,4
66328,2,1,232416,232417,232418,1,2,0
66329,6,2,232422,232422,232424,0,2,4
66330,5,3,232427,232427,232430,0,3,3
66331,4,1,232431,232431,232432,0,1,1
66332,1,2,232432,232432,232434,0,2,0
66333,4,2,232436,232436,232438,0,2,2
66334,2,1,232438,232438,232439,0,1,0
66335,2,3,232440,232440,232443,0,3,1
66336,2,1,232442,232443,232444,1,2,0
66337,5,3,232447,232447,232450,0,3,3
66338,4,1,232451,232451,232452,0,1,1
66339,3,1,232454,232454,232455,0,1,2
66340,2,2,232456,232456,232458,0,2,1
66341,6,3,232462,232462,232465,0,3,4
66342,5,3,232467,232467,232470,0,3,2
66343,1,2,232468,232470,232472,2,4,0
66344,2,1,232470,232472,232473,2,3,0
66345,6,3,232476,232476,232479,0,3,3
66346,6,1,232482,232482,232483,0,1,3
66347,3,3,232485,232485,232488,0,3,2
66348,5,2,232490,232490,232492,0,2,2
66349,2,2,232492,232492,232494,0,2,0
66350,2,2,232494,232494,232496,0,2,0
66351,5,2,232499,232499,232501,0,2,3
66352,1,3,232500,232501,232504,1,4,0
66353,2,2,232502,232504,232506,2,4,0
66354,5,3,232507,232507,232510,0,3,1
66355,1,3,232508,232510,232513,2,5,0
66356,3,1,232511,232513,232514,2,3,0
66357,2,2,232513,232514,232516,1,3,0
66358,4,1,232517,232517,232518,0,1,1
66359,3,1,232520,232520,232521,0,1,2
66360,4,2,232524,232524,232526,0,2,3
66361,2,1,232526,232526,232527,0,1,0
66362,1,1,232527,232527,232528,0,1,0
66363,2,2,232529,232529,232531,0,2,1
66364,3,1,232532,232532,232533,0,1,1
66365,6,1,232538,232538,232539,0,1,5
66366,6,2,232544,232544,232546,0,2,5
66367,4,1,232548,232548,232549,0,1,2
66368,1,3,232549,232549,232552,0,3,0
66369,6,1,232555,232555,232556,0,1,3
66370,5,3,232560,232560,232563,0,3,4
66371,6,1,232566,232566,232567,0,1,3
66372,2,3,232568,232568,232571,0,3,1
66373,6,2,232574,232574,232576,0,2,3
66374,4,1,232578,232578,232579,0,1,2
66375,6,3,232584,232584,232587,0,3,5
66376,5,3,232589,232589,232592,0,3,2
66377,3,1,232592,232592,232593,0,1,0
66378,1,1,232593,232593,232594,0,1,0
66379,3,2,232596,232596,232598,0,2,2
66380,5,2,232601,232601,232603,0,2,3
66381,5,2,232606,232606,232608,0,2,3
66382,1,1,232607,232608,232609,1,2,0
66383,3,2,232610,232610,232612,0,2,1
66384,4,3,232614,232614,232617,0,3,2
66385,1,2,232615,232617,232619,2,4,0
66386,1,3,232616,232619,232622,3,6,0
66387,3,2,232619,232622,232624,3,5,0
66388,5,2,232624,232624,232626,0,2,0
66389,1,3,232625,232626,232629,1,4,0
66390,1,1,232626,232629,232630,3,4,0
66391,2,2,232628,232630,232632,2,4,0
66392,4,1,232632,232632,232633,0,1,0
66393,6,3,232638,232638,232641,0,3,5
66394,6,1,232644,232644,232645,0,1,3
66395,6,1,232650,232650,232651,0,1,5
66396,5,3,232655,232655,232658,0,3,4
66397,3,1,232658,232658,232659,0,1,0
66398,3,2,232661,232661,232663,0,2,2
66399,2,1,232663,232663,232664,0,1,0
66400,3,3,232666,232666,232669,0,3,2
66401,6,1,232672,232672,232673,0,1,3
66402,1,2,232673,232673,232675,0,2,0
66403,3,2,232676,232676,232678,0,2,1
66404,2,1,232678,232678,232679,0,1,0
66405,5,2,232683,232683,232685,0,2,4
66406,2,1,232685,232685,232686,0,1,0
66407,6,3,232691,232691,232694,0,3,5
66408,6,1,232697,232697,232698,0,1,3
66409,2,1,232699,232699,232700,0,1,1
66410,3,2,232702,232702,232704,0,2,2
66411,4,1,232706,232706,232707,0,1,2
66412,5,2,232711,232711,232713,0,2,4
66413,4,3,232715,232715,232718,0,3,2
66414,4,3,232719,232719,232722,0,3,1
66415,3,3,232722,232722,232725,0,3,0
66416,2,1,232724,232725,232726,1,2,0
66417,3,1,232727,232727,232728,0,1,1
66418,2,3,232729,232729,232732,0,3,1
66419,4,2,232733,232733,232735,0,2,1
66420,3,1,232736,232736,232737,0,1,1
66421,3,2,232739,232739,232741,0,2,2
66422,3,1,232742,232742,232743,0,1,1
66423,3,2,232745,232745,232747,0,2,2
66424,1,3,232746,232747,232750,1,4,0
66425,3,3,232749,232750,232753,1,4,0
66426,6,1,232755,232755,232756,0,1,2
66427,3,3,232758,232758,232761,0,3,2
66428,1,1,232759,232761,232762,2,3,0
66429,5,1,232764,232764,232765,0,1,2
66430,4,1,232768,232768,232769,0,1,3
66431,4,1,232772,232772,232773,0,1,3
66432,6,1,232778,232778,232779,0,1,5
66433,3,3,232781,232781,232784,0,3,2
66434,1,3,232782,232784,232787,2,5,0
66435,4,1,232786,232787,232788,1,2,0
66436,6,3,232792,232792,232795,0,3,4
66437,4,3,232796,232796,232799,0,3,1
66438,3,2,232799,232799,232801,0,2,0
66439,5,3,232804,232804,232807,0,3,3
66440,3,1,232807,232807,232808,0,1,0
66441,1,3,232808,232808,232811,0,3,0
66442,5,1,232813,232813,232814,0,1,2
66443,6,1,232819,232819,232820,0,1,5
66444,2,3,232821,232821,232824,0,3,1
66445,1,3,232822,232824,232827,2,5,0
66446,2,1,232824,232827,232828,3,4,0
66447,4,3,232828,232828,232831,0,3,0
66448,2,1,232830,232831,232832,1,2,0
66449,3,2,232833,232833,232835,0,2,1
66450,2,2,232835,232835,232837,0,2,0
66451,4,1,232839,232839,232840,0,1,2
66452,2,1,232841,232841,232842,0,1,1
66453,5,3,232846,232846,232849,0,3,4
66454,1,1,232847,232849,232850,2,3,0
66455,4,2,232851,232851,232853,0,2,1
66456,6,3,232857,232857,232860,0,3,4
66457,5,1,232862,232862,232863,0,1,2
66458,1,3,232863,232863,232866,0,3,0
66459,3,2,232866,232866,232868,0,2,0
66460,1,1,232867,232868,232869,1,2,0
66461,1,1,232868,232869,232870,1,2,0
66462,4,1,232872,232872,232873,0,1,2
66463,5,1,232877,232877,232878,0,1,4
66464,5,2,232882,232882,232884,0,2,4
66465,5,2,232887,232887,232889,0,2,3
66466,3,3,232890,232890,232893,0,3,1
66467,2,3,232892,232893,232896,1,4,0
66468,2,1,232894,232896,232897,2,3,0
66469,2,3,232896,232897,232900,1,4,0
66470,6,2,232902,232902,232904,0,2,2
66471,4,1,232906,232906,232907,0,1,2
66472,5,1,232911,232911,232912,0,1,4
66473,2,1,232913,232913,232914,0,1,1
66474,4,3,232917,232917,232920,0,3,3
66475,3,2,232920,232920,232922,0,2,0
66476,5,2,232925,232925,232927,0,2,3
66477,2,3,232927,232927,232930,0,3,0
66478,2,1,232929,232930,232931,1,2,0
66479,2,3,232931,232931,232934,0,3,0
66480,1,1,232932,232934,232935,2,3,0
66481,6,1,232938,232938,232939,0,1,3
66482,4,3,232942,232942,232945,0,3,3
66483,5,2,232947,232947,232949,0,2,2
66484,1,1,232948,232949,232950,1,2,0
66485,1,1,232949,232950,232951,1,2,0
66486,4,2,232953,232953,232955,0,2,2
66487,4,1,232957,232957,232958,0,1,2
66488,2,1,232959,232959,232960,0,1,1
66489,1,1,232960,232960,232961,0,1,0
66490,4,1,232964,232964,232965,0,1,3
66491,5,1,232969,232969,232970,0,1,4
66492,4,1,232973,232973,232974,0,1,3
66493,5,2,232978,232978,232980,0,2,4
66494,2,3,232980,232980,232983,0,3,0
66495,1,1,232981,232983,232984,2,3,0
66496,6,1,232987,232987,232988,0,1,3
66497,3,3,232990,232990,232993,0,3,2
66498,6,2,232996,232996,232998,0,2,3
66499,2,3,232998,232998,233001,0,3,0
66500,6,2,233004,233004,233006,0,2,3
66501,5,3,233009,233009,233012,0,3,3
66502,3,3,233012,233012,233015,0,3,0
66503,1,3,233013,233015,233018,2,5,0
66504,6,3,233019,233019,233022,0,3,1
66505,5,2,233024,233024,233026,0,2,2
66506,1,2,233025,233026,233028,1,3,0
66507,6,1,233031,233031,233032,0,1,3
66508,1,1,233032,233032,233033,0,1,0
66509,1,3,233033,233033,233036,0,3,0
66510,2,3,233035,233036,233039,1,4,0
66511,6,1,233041,233041,233042,0,1,2
66512,3,3,233044,233044,233047,0,3,2
66513,6,2,233050,233050,233052,0,2,3
66514,1,1,233051,233052,233053,1,2,0
66515,5,2,233056,233056,233058,0,2,3
66516,5,1,233061,233061,233062,0,1,3
66517,4,2,233065,233065,233067,0,2,3
66518,1,2,233066,233067,233069,1,3,0
66519,3,1,233069,233069,233070,0,1,0
66520,2,1,233071,233071,233072,0,1,1
66521,3,3,233074,233074,233077,0,3,2
66522,3,2,233077,233077,233079,0,2,0
66523,3,1,233080,233080,233081,0,1,1
66524,4,1,233084,233084,233085,0,1,3
66525,5,2,233089,233089,233091,0,2,4
66526,1,3,233090,233091,233094,1,4,0
66527,3,3,233093,233094,233097,1,4,0
66528,4,2,233097,233097,233099,0,2,0
66529,6,1,233103,233103,233104,0,1,4
66530,5,2,233108,233108,233110,0,2,4
66531,5,3,233113,233113,233116,0,3,3
66532,6,3,233119,233119,233122,0,3,3
66533,5,3,233124,233124,233127,0,3,2
66534,2,2,233126,233127,233129,1,3,0
66535,1,1,233127,233129,233130,2,3,0
66536,6,1,233133,233133,233134,0,1,3
66537,1,3,233134,233134,233137,0,3,0
66538,5,3,233139,233139,233142,0,3,2
66539,6,3,233145,233145,233148,0,3,3
66540,5,1,233150,233150,233151,0,1,2
66541,1,1,233151,233151,233152,0,1,0
66542,3,1,233154,233154,233155,0,1,2
66543,5,3,233159,233159,233162,0,3,4
66544,6,3,233165,233165,233168,0,3,3
66545,2,3,233167,233168,233171,1,4,0
66546,2,1,233169,233171,233172,2,3,0
66547,5,3,233174,233174,233177,0,3,2
66548,1,1,233175,233177,233178,2,3,0
66549,2,2,233177,233178,233180,1,3,0
66550,4,1,233181,233181,233182,0,1,1
66551,5,2,233186,233186,233188,0,2,4
66552,5,2,233191,233191,233193,0,2,3
66553,6,3,233197,233197,233200,0,3,4
66554,1,1,233198,233200,233201,2,3,0
66555,2,3,233200,233201,233204,1,4,0
66556,6,1,233206,233206,233207,0,1,2
66557,5,1,233211,233211,233212,0,1,4
66558,2,2,233213,233213,233215,0,2,1
66559,5,2,233218,233218,233220,0,2,3
66560,2,3,233220,233220,233223,0,3,0
66561,5,3,233225,233225,233228,0,3,2
66562,3,3,233228,233228,233231,0,3,0
66563,6,2,233234,233234,233236,0,2,3
66564,4,3,233238,233238,233241,0,3,2
66565,4,1,233242,233242,233243,0,1,1
66566,5,2,233247,233247,233249,0,2,4
66567,3,3,233250,233250,233253,0,3,1
66568,4,1,233254,233254,233255,0,1,1
66569,4,2,233258,233258,233260,0,2,3
66570,1,3,233259,233260,233263,1,4,0
66571,6,2,233265,233265,233267,0,2,2
66572,6,1,233271,233271,233272,0,1,4
66573,4,1,233275,233275,233276,0,1,3
66574,3,3,233278,233278,233281,0,3,2
66575,5,2,233283,233283,233285,0,2,2
66576,6,3,233289,233289,233292,0,3,4
66577,6,2,233295,233295,233297,0,2,3
66578,1,3,233296,233297,233300,1,4,0
66579,4,1,233300,233300,233301,0,1,0
66580,3,2,233303,233303,233305,0,2,2
66581,5,1,233308,233308,233309,0,1,3
66582,6,2,233314,233314,233316,0,2,5
66583,4,2,233318,233318,233320,0,2,2
66584,3,2,233321,233321,233323,0,2,1
66585,6,1,233327,233327,233328,0,1,4
66586,1,3,233328,233328,233331,0,3,0
66587,3,3,233331,233331,233334,0,3,0
66588,6,3,233337,233337,233340,0,3,3
66589,2,3,233339,233340,233343,1,4,0
66590,4,1,233343,233343,233344,0,1,0
66591,4,3,233347,233347,233350,0,3,3
66592,4,1,233351,233351,233352,0,1,1
66593,2,3,233353,233353,233356,0,3,1
66594,4,1,233357,233357,233358,0,1,1
66595,2,1,233359,233359,233360,0,1,1
66596,3,1,233362,233362,233363,0,1,2
66597,1,3,233363,233363,233366,0,3,0
66598,5,2,233368,233368,233370,0,2,2
66599,6,1,233374,233374,233375,0,1,4
66600,3,2,233377,233377,233379,0,2,2
66601,3,2,233380,233380,233382,0,2,1
66602,4,3,233384,233384,233387,0,3,2
66603,6,1,233390,233390,233391,0,1,3
66604,1,3,233391,233391,233394,0,3,0
66605,5,3,233396,233396,233399,0,3,2
66606,2,1,233398,233399,233400,1,2,0
66607,4,3,233402,233402,233405,0,3,2
66608,3,2,233405,233405,233407,0,2,0
66609,4,2,233409,233409,233411,0,2,2
66610,5,3,233414,233414,233417,0,3,3
66611,1,1,233415,233417,233418,2,3,0
66612,4,1,233419,233419,233420,0,1,1
66613,3,3,233422,233422,233425,0,3,2
66614,1,1,233423,233425,233426,2,3,0
66615,5,2,233428,233428,233430,0,2,2
66616,1,3,233429,233430,233433,1,4,0
66617,1,1,233430,233433,233434,3,4,0
66618,4,2,233434,233434,233436,0,2,0
66619,2,2,233436,233436,233438,0,2,0
66620,5,1,233441,233441,233442,0,1,3
66621,5,1,233446,233446,233447,0,1,4
66622,6,1,233452,233452,233453,0,1,5
66623,2,3,233454,233454,233457,0,3,1
66624,3,1,233457,233457,233458,0,1,0
66625,1,1,233458,233458,233459,0,1,0
66626,1,3,233459,233459,233462,0,3,0
66627,5,3,233464,233464,233467,0,3,2
66628,4,1,233468,233468,233469,0,1,1
66629,5,2,233473,233473,233475,0,2,4
66630,5,3,233478,233478,233481,0,3,3
66631,5,3,233483,233483,233486,0,3,2
66632,2,2,233485,233486,233488,1,3,0
66633,1,3,233486,233488,233491,2,5,0
66634,5,3,233491,233491,233494,0,3,0
66635,6,3,233497,233497,233500,0,3,3
66636,6,3,233503,233503,233506,0,3,3
66637,4,1,233507,233507,233508,0,1,1
66638,5,2,233512,233512,233514,0,2,4
66639,6,3,233518,233518,233521,0,3,4
66640,3,2,233521,233521,233523,0,2,0
66641,4,2,233525,233525,233527,0,2,2
66642,4,3,233529,233529,233532,0,3,2
66643,6,2,233535,233535,233537,0,2,3
66644,1,1,233536,233537,233538,1,2,0
66645,3,1,233539,233539,233540,0,1,1
66646,5,1,233544,233544,233545,0,1,4
66647,4,1,233548,233548,233549,0,1,3
66648,3,1,233551,233551,233552,0,1,2
66649,2,3,233553,233553,233556,0,3,1
66650,6,2,233559,233559,233561,0,2,3
66651,6,1,233565,233565,233566,0,1,4
66652,3,1,233568,233568,233569,0,1,2
66653,6,3,233574,233574,233577,0,3,5
66654,1,1,233575,233577,233578,2,3,0
66655,2,3,233577,233578,233581,1,4,0
66656,6,3,233583,233583,233586,0,3,2
66657,6,2,233589,233589,233591,0,2,3
66658,3,3,233592,233592,233595,0,3,1
66659,3,3,233595,233595,233598,0,3,0
66660,4,3,233599,233599,233602,0,3,1
66661,3,2,233602,233602,233604,0,2,0
66662,6,1,233608,233608,233609,0,1,4
66663,5,1,233613,233613,233614,0,1,4
66664,6,1,233619,233619,233620,0,1,5
66665,3,3,233622,233622,233625,0,3,2
66666,6,2,233628,233628,233630,0,2,3
66667,3,1,233631,233631,233632,0,1,1
66668,3,1,233634,233634,233635,0,1,2
66669,1,2,233635,233635,233637,0,2,0
66670,1,3,233636,233637,233640,1,4,0
66671,1,1,233637,233640,233641,3,4,0
66672,3,2,233640,233641,233643,1,3,0
66673,5,2,233645,233645,233647,0,2,2
66674,2,1,233647,233647,233648,0,1,0
66675,3,1,233650,233650,233651,0,1,2
66676,5,3,233655,233655,233658,0,3,4
66677,6,3,233661,233661,233664,0,3,3
66678,5,1,233666,233666,233667,0,1,2
66679,4,3,233670,233670,233673,0,3,3
66680,1,2,233671,233673,233675,2,4,0
66681,4,3,233675,233675,233678,0,3,0
66682,1,3,233676,233678,233681,2,5,0
66683,3,1,233679,233681,233682,2,3,0
66684,4,1,233683,233683,233684,0,1,1
66685,5,2,233688,233688,233690,0,2,4
66686,6,2,233694,233694,233696,0,2,4
66687,3,2,233697,233697,233699,0,2,1
66688,1,2,233698,233699,233701,1,3,0
66689,6,2,233704,233704,233706,0,2,3
66690,5,2,233709,233709,233711,0,2,3
66691,4,2,233713,233713,233715,0,2,2
66692,2,2,233715,233715,233717,0,2,0
66693,6,3,233721,233721,233724,0,3,4
66694,2,1,233723,233724,233725,1,2,0
66695,3,2,233726,233726,233728,0,2,1
66696,3,3,233729,233729,233732,0,3,1
66697,5,3,233734,233734,233737,0,3,2
66698,3,2,233737,233737,233739,0,2,0
66699,1,2,233738,233739,233741,1,3,0
66700,1,3,233739,233741,233744,2,5,0
66701,6,3,233745,233745,233748,0,3,1
66702,1,2,233746,233748,233750,2,4,0
66703,5,2,233751,233751,233753,0,2,1
66704,5,2,233756,233756,233758,0,2,3
66705,4,1,233760,233760,233761,0,1,2
66706,2,1,233762,233762,233763,0,1,1
66707,6,2,233768,233768,233770,0,2,5
66708,1,2,233769,233770,233772,1,3,0
66709,4,3,233773,233773,233776,0,3,1
66710,1,2,233774,233776,233778,2,4,0
66711,3,2,233777,233778,233780,1,3,0
66712,6,2,233783,233783,233785,0,2,3
66713,1,3,233784,233785,233788,1,4,0
66714,6,1,233790,233790,233791,0,1,2
66715,3,1,233793,233793,233794,0,1,2
66716,4,3,233797,233797,233800,0,3,3
66717,2,3,233799,233800,233803,1,4,0
66718,5,3,233804,233804,233807,0,3,1
66719,2,2,233806,233807,233809,1,3,0
66720,6,2,233812,233812,233814,0,2,3
66721,5,3,233817,233817,233820,0,3,3
66722,1,3,233818,233820,233823,2,5,0
66723,4,3,233822,233823,233826,1,4,0
66724,4,1,233826,233826,233827,0,1,0
66725,1,1,233827,233827,233828,0,1,0
66726,5,1,233832,233832,233833,0,1,4
66727,1,2,233833,233833,233835,0,2,0
66728,2,1,233835,233835,233836,0,1,0
66729,3,3,233838,233838,233841,0,3,2
66730,4,2,233842,233842,233844,0,2,1
66731,2,2,233844,233844,233846,0,2,0
66732,6,2,233850,233850,233852,0,2,4
66733,4,3,233854,233854,233857,0,3,2
66734,4,2,233858,233858,233860,0,2,1
66735,1,1,233859,233860,233861,1,2,0
66736,1,2,233860,233861,233863,1,3,0
66737,5,2,233865,233865,233867,0,2,2
66738,3,2,233868,233868,233870,0,2,1
66739,1,2,233869,233870,233872,1,3,0
66740,1,3,233870,233872,233875,2,5,0
66741,2,1,233872,233875,233876,3,4,0
66742,6,2,233878,233878,233880,0,2,2
66743,2,3,233880,233880,233883,0,3,0
66744,6,2,233886,233886,233888,0,2,3
66745,6,3,233892,233892,233895,0,3,4
66746,6,2,233898,233898,233900,0,2,3
66747,4,2,233902,233902,233904,0,2,2
66748,1,2,233903,233904,233906,1,3,0
66749,1,2,233904,233906,233908,2,4,0
66750,1,1,233905,233908,233909,3,4,0
66751,3,2,233908,233909,233911,1,3,0
66752,5,2,233913,233913,233915,0,2,2
66753,6,1,233919,233919,233920,0,1,4
66754,1,1,233920,233920,233921,0,1,0
66755,2,3,233922,233922,233925,0,3,1
66756,6,1,233928,233928,233929,0,1,3
66757,5,3,233933,233933,233936,0,3,4
66758,5,3,233938,233938,233941,0,3,2
66759,6,2,233944,233944,233946,0,2,3
66760,2,2,233946,233946,233948,0,2,0
66761,4,1,233950,233950,233951,0,1,2
66762,5,1,233955,233955,233956,0,1,4
66763,1,3,233956,233956,233959,0,3,0
66764,5,1,233961,233961,233962,0,1,2
66765,2,3,233963,233963,233966,0,3,1
66766,2,1,233965,233966,233967,1,2,0
66767,4,3,233969,233969,233972,0,3,2
66768,1,3,233970,233972,233975,2,5,0
66769,5,3,233975,233975,233978,0,3,0
66770,2,3,233977,233978,233981,1,4,0
66771,1,3,233978,233981,233984,3,6,0
66772,6,3,233984,233984,233987,0,3,0
66773,6,1,233990,233990,233991,0,1,3
66774,4,2,233994,233994,233996,0,2,3
66775,4,1,233998,233998,233999,0,1,2
66776,2,1,234000,234000,234001,0,1,1
66777,3,2,234003,234003,234005,0,2,2
66778,3,3,234006,234006,234009,0,3,1
66779,3,1,234009,234009,234010,0,1,0
66780,3,3,234012,234012,234015,0,3,2
66781,4,3,234016,234016,234019,0,3,1
66782,1,3,234017,234019,234022,2,5,0
66783,1,1,234018,234022,234023,4,5,0
66784,4,1,234022,234023,234024,1,2,0
66785,6,2,234028,234028,234030,0,2,4
66786,5,1,234033,234033,234034,0,1,3
66787,2,2,234035,234035,234037,0,2,1
66788,4,1,234039,234039,234040,0,1,2
66789,3,3,234042,234042,234045,0,3,2
66790,5,1,234047,234047,234048,0,1,2
66791,6,1,234053,234053,234054,0,1,5
66792,1,1,234054,234054,234055,0,1,0
66793,3,3,234057,234057,234060,0,3,2
66794,4,1,234061,234061,234062,0,1,1
66795,2,2,234063,234063,234065,0,2,1
66796,2,1,234065,234065,234066,0,1,0
66797,6,1,234071,234071,234072,0,1,5
66798,2,1,234073,234073,234074,0,1,1
66799,6,3,234079,234079,234082,0,3,5
66800,2,3,234081,234082,234085,1,4,0
66801,1,1,234082,234085,234086,3,4,0
66802,1,3,234083,234086,234089,3,6,0
66803,3,1,234086,234089,234090,3,4,0
66804,1,3,234087,234090,234093,3,6,0
66805,4,1,234091,234093,234094,2,3,0
66806,3,3,234094,234094,234097,0,3,0
66807,3,2,234097,234097,234099,0,2,0
66808,4,2,234101,234101,234103,0,2,2
66809,4,3,234105,234105,234108,0,3,2
66810,6,2,234111,234111,234113,0,2,3
66811,1,1,234112,234113,234114,1,2,0
66812,3,1,234115,234115,234116,0,1,1
66813,1,1,234116,234116,234117,0,1,0
66814,4,2,234120,234120,234122,0,2,3
66815,5,2,234125,234125,234127,0,2,3
66816,1,2,234126,234127,234129,1,3,0
66817,2,2,234128,234129,234131,1,3,0
66818,3,2,234131,234131,234133,0,2,0
66819,2,2,234133,234133,234135,0,2,0
66820,4,2,234137,234137,234139,0,2,2
66821,4,3,234141,234141,234144,0,3,2
66822,1,2,234142,234144,234146,2,4,0
66823,4,3,234146,234146,234149,0,3,0
66824,6,1,234152,234152,234153,0,1,3
66825,2,1,234154,234154,234155,0,1,1
66826,2,3,234156,234156,234159,0,3,1
66827,4,3,234160,234160,234163,0,3,1
66828,5,2,234165,234165,234167,0,2,2
66829,5,3,234170,234170,234173,0,3,3
66830,1,2,234171,234173,234175,2,4,0
66831,5,2,234176,234176,234178,0,2,1
66832,5,3,234181,234181,234184,0,3,3
66833,2,3,234183,234184,234187,1,4,0
66834,2,2,234185,234187,234189,2,4,0
66835,6,2,234191,234191,234193,0,2,2
66836,2,1,234193,234193,234194,0,1,0
66837,1,1,234194,234194,234195,0,1,0
66838,3,1,234197,234197,234198,0,1,2
66839,6,1,234203,234203,234204,0,1,5
66840,1,3,234204,234204,234207,0,3,0
66841,6,3,234210,234210,234213,0,3,3
66842,6,1,234216,234216,234217,0,1,3
66843,6,1,234222,234222,234223,0,1,5
66844,2,3,234224,234224,234227,0,3,1
66845,4,1,234228,234228,234229,0,1,1
66846,3,3,234231,234231,234234,0,3,2
66847,1,3,234232,234234,234237,2,5,0
66848,3,3,234235,234237,234240,2,5,0
66849,4,1,234239,234240,234241,1,2,0
66850,6,1,234245,234245,234246,0,1,4
66851,2,3,234247,234247,234250,0,3,1
66852,6,3,234253,234253,234256,0,3,3
66853,5,3,234258,234258,234261,0,3,2
66854,2,1,234260,234261,234262,1,2,0
66855,6,1,234266,234266,234267,0,1,4
66856,2,2,234268,234268,234270,0,2,1
66857,1,3,234269,234270,234273,1,4,0
66858,1,2,234270,234273,234275,3,5,0
66859,2,3,234272,234275,234278,3,6,0
66860,1,3,234273,234278,234281,5,8,0
66861,2,1,234275,234281,234282,6,7,0
66862,5,3,234280,234282,234285,2,5,0
66863,3,3,234283,234285,234288,2,5,0
66864,4,1,234287,234288,234289,1,2,0
66865,6,3,234293,234293,234296,0,3,4
66866,6,1,234299,234299,234300,0,1,3
66867,5,1,234304,234304,234305,0,1,4
66868,2,3,234306,234306,234309,0,3,1
66869,6,2,234312,234312,234314,0,2,3
66870,6,1,234318,234318,234319,0,1,4
66871,1,1,234319,234319,234320,0,1,0
66872,4,3,234323,234323,234326,0,3,3
66873,2,1,234325,234326,234327,1,2,0
66874,5,3,234330,234330,234333,0,3,3
66875,3,3,234333,234333,234336,0,3,0
66876,3,2,234336,234336,234338,0,2,0
66877,3,1,234339,234339,234340,0,1,1
66878,1,3,234340,234340,234343,0,3,0
66879,2,1,234342,234343,234344,1,2,0
66880,3,3,234345,234345,234348,0,3,1
66881,2,2,234347,234348,234350,1,3,0
66882,1,2,234348,234350,234352,2,4,0
66883,5,1,234353,234353,234354,0,1,1
66884,4,1,234357,234357,234358,0,1,3
66885,5,3,234362,234362,234365,0,3,4
66886,5,1,234367,234367,234368,0,1,2
66887,3,2,234370,234370,234372,0,2,2
66888,2,2,234372,234372,234374,0,2,0
66889,4,1,234376,234376,234377,0,1,2
66890,6,3,234382,234382,234385,0,3,5
66891,3,3,234385,234385,234388,0,3,0
66892,2,1,234387,234388,234389,1,2,0
66893,3,3,234390,234390,234393,0,3,1
66894,3,1,234393,234393,234394,0,1,0
66895,4,1,234397,234397,234398,0,1,3
66896,6,1,234403,234403,234404,0,1,5
66897,6,3,234409,234409,234412,0,3,5
66898,1,3,234410,234412,234415,2,5,0
66899,5,2,234415,234415,234417,0,2,0
66900,6,3,234421,234421,234424,0,3,4
66901,4,2,234425,234425,234427,0,2,1
66902,5,1,234430,234430,234431,0,1,3
66903,3,3,234433,234433,234436,0,3,2
66904,6,1,234439,234439,234440,0,1,3
66905,3,3,234442,234442,234445,0,3,2
66906,1,3,234443,234445,234448,2,5,0
66907,5,2,234448,234448,234450,0,2,0
66908,5,1,234453,234453,234454,0,1,3
66909,5,2,234458,234458,234460,0,2,4
66910,4,2,234462,234462,234464,0,2,2
66911,1,3,234463,234464,234467,1,4,0
66912,2,3,234465,234467,234470,2,5,0
66913,1,2,234466,234470,234472,4,6,0
66914,2,1,234468,234472,234473,4,5,0
66915,1,2,234469,234473,234475,4,6,0
66916,5,3,234474,234475,234478,1,4,0
66917,1,2,234475,234478,234480,3,5,0
66918,3,3,234478,234480,234483,2,5,0
66919,4,1,234482,234483,234484,1,2,0
66920,2,2,234484,234484,234486,0,2,0
66921,5,2,234489,234489,234491,0,2,3
66922,5,3,234494,234494,234497,0,3,3
66923,1,1,234495,234497,234498,2,3,0
66924,3,1,234498,234498,234499,0,1,0
66925,4,1,234502,234502,234503,0,1,3
66926,3,3,234505,234505,234508,0,3,2
66927,5,3,234510,234510,234513,0,3,2
66928,6,1,234516,234516,234517,0,1,3
66929,1,2,234517,234517,234519,0,2,0
66930,4,2,234521,234521,234523,0,2,2
66931,5,3,234526,234526,234529,0,3,3
66932,6,3,234532,234532,234535,0,3,3
66933,4,2,234536,234536,234538,0,2,1
66934,1,2,234537,234538,234540,1,3,0
66935,6,2,234543,234543,234545,0,2,3
66936,3,2,234546,234546,234548,0,2,1
66937,1,2,234547,234548,234550,1,3,0
66938,5,1,234552,234552,234553,0,1,2
66939,1,1,234553,234553,234554,0,1,0
66940,6,2,234559,234559,234561,0,2,5
66941,2,2,234561,234561,234563,0,2,0
66942,6,1,234567,234567,234568,0,1,4
66943,4,3,234571,234571,234574,0,3,3
66944,2,3,234573,234574,234577,1,4,0
66945,3,2,234576,234577,234579,1,3,0
66946,6,3,234582,234582,234585,0,3,3
66947,6,1,234588,234588,234589,0,1,3
66948,3,2,234591,234591,234593,0,2,2
66949,4,2,234595,234595,234597,0,2,2
66950,6,3,234601,234601,234604,0,3,4
66951,2,1,234603,234604,234605,1,2,0
66952,5,3,234608,234608,234611,0,3,3
66953,1,2,234609,234611,234613,2,4,0
66954,3,1,234612,234613,234614,1,2,0
66955,3,3,234615,234615,234618,0,3,1
66956,5,3,234620,234620,234623,0,3,2
66957,3,1,234623,234623,234624,0,1,0
66958,2,1,234625,234625,234626,0,1,1
66959,1,2,234626,234626,234628,0,2,0
66960,2,3,234628,234628,234631,0,3,0
66961,3,2,234631,234631,234633,0,2,0
66962,2,2,234633,234633,234635,0,2,0
66963,1,2,234634,234635,234637,1,3,0
66964,6,3,234640,234640,234643,0,3,3
66965,1,1,234641,234643,234644,2,3,0
66966,1,3,234642,234644,234647,2,5,0
66967,1,2,234643,234647,234649,4,6,0
66968,5,2,234648,234649,234651,1,3,0
66969,6,3,234654,234654,234657,0,3,3
66970,4,2,234658,234658,234660,0,2,1
66971,2,2,234660,234660,234662,0,2,0
66972,5,3,234665,234665,234668,0,3,3
66973,6,1,234671,234671,234672,0,1,3
66974,1,3,234672,234672,234675,0,3,0
66975,3,3,234675,234675,234678,0,3,0
66976,2,2,234677,234678,234680,1,3,0
66977,2,1,234679,234680,234681,1,2,0
66978,3,3,234682,234682,234685,0,3,1
66979,4,3,234686,234686,234689,0,3,1
66980,3,2,234689,234689,234691,0,2,0
66981,2,2,234691,234691,234693,0,2,0
66982,3,2,234694,234694,234696,0,2,1
66983,5,2,234699,234699,234701,0,2,3
66984,3,3,234702,234702,234705,0,3,1
66985,3,1,234705,234705,234706,0,1,0
66986,5,1,234710,234710,234711,0,1,4
66987,4,3,234714,234714,234717,0,3,3
66988,2,1,234716,234717,234718,1,2,0
66989,3,2,234719,234719,234721,0,2,1
66990,2,1,234721,234721,234722,0,1,0
66991,2,1,234723,234723,234724,0,1,1
66992,6,3,234729,234729,234732,0,3,5
66993,5,2,234734,234734,234736,0,2,2
66994,3,2,234737,234737,234739,0,2,1
66995,6,1,234743,234743,234744,0,1,4
66996,2,3,234745,234745,234748,0,3,1
66997,1,1,234746,234748,234749,2,3,0
66998,1,3,234747,234749,234752,2,5,0
66999,4,3,234751,234752,234755,1,4,0
67000,6,1,234757,234757,234758,0,1,2
67001,3,1,234760,234760,234761,0,1,2
67002,6,3,234766,234766,234769,0,3,5
67003,4,2,234770,234770,234772,0,2,1
67004,4,1,234774,234774,234775,0,1,2
67005,2,1,234776,234776,234777,0,1,1
67006,5,1,234781,234781,234782,0,1,4
67007,6,3,234787,234787,234790,0,3,5
67008,3,2,234790,234790,234792,0,2,0
67009,5,2,234795,234795,234797,0,2,3
67010,3,1,234798,234798,234799,0,1,1
67011,1,2,234799,234799,234801,0,2,0
67012,4,3,234803,234803,234806,0,3,2
67013,2,1,234805,234806,234807,1,2,0
67014,4,3,234809,234809,234812,0,3,2
67015,2,1,234811,234812,234813,1,2,0
67016,3,3,234814,234814,234817,0,3,1
67017,5,2,234819,234819,234821,0,2,2
67018,6,2,234825,234825,234827,0,2,4
67019,4,2,234829,234829,234831,0,2,2
67020,6,2,234835,234835,234837,0,2,4
67021,3,3,234838,234838,234841,0,3,1
67022,2,1,234840,234841,234842,1,2,0
67023,4,2,234844,234844,234846,0,2,2
67024,5,2,234849,234849,234851,0,2,3
67025,1,1,234850,234851,234852,1,2,0
67026,3,2,234853,234853,234855,0,2,1
67027,4,3,234857,234857,234860,0,3,2
67028,6,2,234863,234863,234865,0,2,3
67029,6,3,234869,234869,234872,0,3,4
67030,1,1,234870,234872,234873,2,3,0
67031,6,2,234876,234876,234878,0,2,3
67032,2,3,234878,234878,234881,0,3,0
67033,5,1,234883,234883,234884,0,1,2
67034,2,2,234885,234885,234887,0,2,1
67035,3,2,234888,234888,234890,0,2,1
67036,4,3,234892,234892,234895,0,3,2
67037,5,3,234897,234897,234900,0,3,2
67038,5,1,234902,234902,234903,0,1,2
67039,3,3,234905,234905,234908,0,3,2
67040,3,1,234908,234908,234909,0,1,0
67041,3,1,234911,234911,234912,0,1,2
67042,2,3,234913,234913,234916,0,3,1
67043,4,3,234917,234917,234920,0,3,1
67044,2,3,234919,234920,234923,1,4,0
67045,1,2,234920,234923,234925,3,5,0
67046,4,1,234924,234925,234926,1,2,0
67047,2,3,234926,234926,234929,0,3,0
67048,1,3,234927,234929,234932,2,5,0
67049,3,1,234930,234932,234933,2,3,0
67050,6,2,234936,234936,234938,0,2,3
67051,3,1,234939,234939,234940,0,1,1
67052,6,2,234945,234945,234947,0,2,5
67053,2,2,234947,234947,234949,0,2,0
67054,6,3,234953,234953,234956,0,3,4
67055,3,2,234956,234956,234958,0,2,0
67056,3,1,234959,234959,234960,0,1,1
67057,5,2,234964,234964,234966,0,2,4
67058,3,2,234967,234967,234969,0,2,1
67059,5,3,234972,234972,234975,0,3,3
67060,6,1,234978,234978,234979,0,1,3
67061,4,2,234982,234982,234984,0,2,3
67062,3,3,234985,234985,234988,0,3,1
67063,6,1,234991,234991,234992,0,1,3
67064,1,1,234992,234992,234993,0,1,0
67065,4,1,234996,234996,234997,0,1,3
67066,1,2,234997,234997,234999,0,2,0
67067,6,2,235003,235003,235005,0,2,4
67068,2,2,235005,235005,235007,0,2,0
67069,3,3,235008,235008,235011,0,3,1
67070,4,1,235012,235012,235013,0,1,1
67071,4,2,235016,235016,235018,0,2,3
67072,3,1,235019,235019,235020,0,1,1
67073,1,2,235020,235020,235022,0,2,0
67074,4,2,235024,235024,235026,0,2,2
67075,3,1,235027,235027,235028,0,1,1
67076,5,1,235032,235032,235033,0,1,4
67077,3,1,235035,235035,235036,0,1,2
67078,2,2,235037,235037,235039,0,2,1
67079,5,3,235042,235042,235045,0,3,3
67080,5,1,235047,235047,235048,0,1,2
67081,2,3,235049,235049,235052,0,3,1
67082,4,1,235053,235053,235054,0,1,1
67083,5,1,235058,235058,235059,0,1,4
67084,4,1,235062,235062,235063,0,1,3
67085,2,3,235064,235064,235067,0,3,1
67086,1,1,235065,235067,235068,2,3,0
67087,6,1,235071,235071,235072,0,1,3
67088,6,3,235077,235077,235080,0,3,5
67089,2,2,235079,235080,235082,1,3,0
67090,1,1,235080,235082,235083,2,3,0
67091,1,1,235081,235083,235084,2,3,0
67092,6,2,235087,235087,235089,0,2,3
67093,5,2,235092,235092,235094,0,2,3
67094,6,1,235098,235098,235099,0,1,4
67095,4,3,235102,235102,235105,0,3,3
67096,3,1,235105,235105,235106,0,1,0
67097,6,3,235111,235111,235114,0,3,5
67098,5,1,235116,235116,235117,0,1,2
67099,2,1,235118,235118,235119,0,1,1
67100,2,1,235120,235120,235121,0,1,1
67101,6,2,235126,235126,235128,0,2,5
67102,4,1,235130,235130,235131,0,1,2
67103,4,2,235134,235134,235136,0,2,3
67104,6,3,235140,235140,235143,0,3,4
67105,4,2,235144,235144,235146,0,2,1
67106,1,2,235145,235146,235148,1,3,0
67107,4,3,235149,235149,235152,0,3,1
67108,3,2,235152,235152,235154,0,2,0
67109,4,3,235156,235156,235159,0,3,2
67110,3,2,235159,235159,235161,0,2,0
67111,4,3,235163,235163,235166,0,3,2
67112,2,2,235165,235166,235168,1,3,0
67113,5,2,235170,235170,235172,0,2,2
67114,6,1,235176,235176,235177,0,1,4
67115,6,1,235182,235182,235183,0,1,5
67116,1,2,235183,235183,235185,0,2,0
67117,2,3,235185,235185,235188,0,3,0
67118,4,2,235189,235189,235191,0,2,1
67119,1,3,235190,235191,235194,1,4,0
67120,2,3,235192,235194,235197,2,5,0
67121,5,3,235197,235197,235200,0,3,0
67122,2,3,235199,235200,235203,1,4,0
67123,5,2,235204,235204,235206,0,2,1
67124,5,1,235209,235209,235210,0,1,3
67125,1,1,235210,235210,235211,0,1,0
67126,4,1,235214,235214,235215,0,1,3
67127,4,2,235218,235218,235220,0,2,3
67128,1,1,235219,235220,235221,1,2,0
67129,4,3,235223,235223,235226,0,3,2
67130,5,3,235228,235228,235231,0,3,2
67131,5,3,235233,235233,235236,0,3,2
67132,1,1,235234,235236,235237,2,3,0
67133,2,2,235236,235237,235239,1,3,0
67134,3,3,235239,235239,235242,0,3,0
67135,6,2,235245,235245,235247,0,2,3
67136,5,3,235250,235250,235253,0,3,3
67137,4,2,235254,235254,235256,0,2,1
67138,5,3,235259,235259,235262,0,3,3
67139,1,3,235260,235262,235265,2,5,0
67140,4,3,235264,235265,235268,1,4,0
67141,4,3,235268,235268,235271,0,3,0
67142,6,3,235274,235274,235277,0,3,3
67143,4,2,235278,235278,235280,0,2,1
67144,5,1,235283,235283,235284,0,1,3
67145,4,1,235287,235287,235288,0,1,3
67146,4,1,235291,235291,235292,0,1,3
67147,2,3,235293,235293,235296,0,3,1
67148,2,2,235295,235296,235298,1,3,0
67149,5,3,235300,235300,235303,0,3,2
67150,2,2,235302,235303,235305,1,3,0
67151,3,1,235305,235305,235306,0,1,0
67152,1,3,235306,235306,235309,0,3,0
67153,4,1,235310,235310,235311,0,1,1
67154,1,2,235311,235311,235313,0,2,0
67155,1,1,235312,235313,235314,1,2,0
67156,3,3,235315,235315,235318,0,3,1
67157,1,2,235316,235318,235320,2,4,0
67158,6,2,235322,235322,235324,0,2,2
67159,1,1,235323,235324,235325,1,2,0
67160,2,3,235325,235325,235328,0,3,0
67161,3,2,235328,235328,235330,0,2,0
67162,1,3,235329,235330,235333,1,4,0
67163,3,2,235332,235333,235335,1,3,0
67164,1,3,235333,235335,235338,2,5,0
67165,3,3,235336,235338,235341,2,5,0
67166,1,1,235337,235341,235342,4,5,0
67167,6,2,235343,235343,235345,0,2,1
67168,6,1,235349,235349,235350,0,1,4
67169,1,1,235350,235350,235351,0,1,0
67170,5,3,235355,235355,235358,0,3,4
67171,3,2,235358,235358,235360,0,2,0
67172,6,2,235364,235364,235366,0,2,4
67173,3,1,235367,235367,235368,0,1,1
67174,6,2,235373,235373,235375,0,2,5
67175,4,2,235377,235377,235379,0,2,2
67176,4,1,235381,235381,235382,0,1,2
67177,5,3,235386,235386,235389,0,3,4
67178,2,3,235388,235389,235392,1,4,0
67179,5,3,235393,235393,235396,0,3,1
67180,3,3,235396,235396,235399,0,3,0
67181,2,2,235398,235399,235401,1,3,0
67182,2,2,235400,235401,235403,1,3,0
67183,5,2,235405,235405,235407,0,2,2
67184,1,2,235406,235407,235409,1,3,0
67185,5,3,235411,235411,235414,0,3,2
67186,4,1,235415,235415,235416,0,1,1
67187,1,2,235416,235416,235418,0,2,0
67188,3,2,235419,235419,235421,0,2,1
67189,4,3,235423,235423,235426,0,3,2
67190,1,2,235424,235426,235428,2,4,0
67191,6,3,235430,235430,235433,0,3,2
67192,2,1,235432,235433,235434,1,2,0
67193,5,2,235437,235437,235439,0,2,3
67194,2,3,235439,235439,235442,0,3,0
67195,2,1,235441,235442,235443,1,2,0
67196,1,1,235442,235443,235444,1,2,0
67197,4,3,235446,235446,235449,0,3,2
67198,6,3,235452,235452,235455,0,3,3
67199,2,2,235454,235455,235457,1,3,0
67200,4,1,235458,235458,235459,0,1,1
67201,6,1,235464,235464,235465,0,1,5
67202,3,2,235467,235467,235469,0,2,2
67203,5,3,235472,235472,235475,0,3,3
67204,1,2,235473,235475,235477,2,4,0
67205,4,1,235477,235477,235478,0,1,0
67206,3,2,235480,235480,235482,0,2,2
67207,4,2,235484,235484,235486,0,2,2
67208,5,2,235489,235489,235491,0,2,3
67209,5,2,235494,235494,235496,0,2,3
67210,2,1,235496,235496,235497,0,1,0
67211,6,1,235502,235502,235503,0,1,5
67212,2,3,235504,235504,235507,0,3,1
67213,4,3,235508,235508,235511,0,3,1
67214,6,3,235514,235514,235517,0,3,3
67215,1,2,235515,235517,235519,2,4,0
67216,3,1,235518,235519,235520,1,2,0
67217,6,2,235524,235524,235526,0,2,4
67218,3,1,235527,235527,235528,0,1,1
67219,4,2,235531,235531,235533,0,2,3
67220,5,2,235536,235536,235538,0,2,3
67221,3,3,235539,235539,235542,0,3,1
67222,6,2,235545,235545,235547,0,2,3
67223,1,1,235546,235547,235548,1,2,0
67224,2,3,235548,235548,235551,0,3,0
67225,4,1,235552,235552,235553,0,1,1
67226,2,1,235554,235554,235555,0,1,1
67227,3,2,235557,235557,235559,0,2,2
67228,2,3,235559,235559,235562,0,3,0
67229,4,2,235563,235563,235565,0,2,1
67230,6,1,235569,235569,235570,0,1,4
67231,4,1,235573,235573,235574,0,1,3
67232,2,3,235575,235575,235578,0,3,1
67233,6,2,235581,235581,235583,0,2,3
67234,6,1,235587,235587,235588,0,1,4
67235,1,2,235588,235588,235590,0,2,0
67236,5,3,235593,235593,235596,0,3,3
67237,4,2,235597,235597,235599,0,2,1
67238,1,3,235598,235599,235602,1,4,0
67239,2,3,235600,235602,235605,2,5,0
67240,5,2,235605,235605,235607,0,2,0
67241,2,3,235607,235607,235610,0,3,0
67242,5,2,235612,235612,235614,0,2,2
67243,2,1,235614,235614,235615,0,1,0
67244,2,1,235616,235616,235617,0,1,1
67245,2,2,235618,235618,235620,0,2,1
67246,5,1,235623,235623,235624,0,1,3
67247,3,3,235626,235626,235629,0,3,2
67248,2,3,235628,235629,235632,1,4,0
67249,4,3,235632,235632,235635,0,3,0
67250,6,3,235638,235638,235641,0,3,3
67251,1,1,235639,235641,235642,2,3,0
67252,3,1,235642,235642,235643,0,1,0
67253,1,1,235643,235643,235644,0,1,0
67254,2,3,235645,235645,235648,0,3,1
67255,5,2,235650,235650,235652,0,2,2
67256,4,2,235654,235654,235656,0,2,2
67257,6,3,235660,235660,235663,0,3,4
67258,2,1,235662,235663,235664,1,2,0
67259,6,2,235668,235668,235670,0,2,4
67260,3,2,235671,235671,235673,0,2,1
67261,4,1,235675,235675,235676,0,1,2
67262,2,2,235677,235677,235679,0,2,1
67263,2,2,235679,235679,235681,0,2,0
67264,3,2,235682,235682,235684,0,2,1
67265,5,2,235687,235687,235689,0,2,3
67266,1,3,235688,235689,235692,1,4,0
67267,4,2,235692,235692,235694,0,2,0
67268,3,2,235695,235695,235697,0,2,1
67269,4,1,235699,235699,235700,0,1,2
67270,4,1,235703,235703,235704,0,1,3
67271,4,3,235707,235707,235710,0,3,3
67272,4,3,235711,235711,235714,0,3,1
67273,5,3,235716,235716,235719,0,3,2
67274,4,3,235720,235720,235723,0,3,1
67275,3,1,235723,235723,235724,0,1,0
67276,1,1,235724,235724,235725,0,1,0
67277,3,1,235727,235727,235728,0,1,2
67278,6,1,235733,235733,235734,0,1,5
67279,5,2,235738,235738,235740,0,2,4
67280,5,1,235743,235743,235744,0,1,3
67281,4,1,235747,235747,235748,0,1,3
67282,2,2,235749,235749,235751,0,2,1
67283,4,1,235753,235753,235754,0,1,2
67284,1,1,235754,235754,235755,0,1,0
67285,3,1,235757,235757,235758,0,1,2
67286,2,2,235759,235759,235761,0,2,1
67287,3,1,235762,235762,235763,0,1,1
67288,6,2,235768,235768,235770,0,2,5
67289,5,2,235773,235773,235775,0,2,3
67290,1,3,235774,235775,235778,1,4,0
67291,3,3,235777,235778,235781,1,4,0
67292,2,1,235779,235781,235782,2,3,0
67293,5,1,235784,235784,235785,0,1,2
67294,3,2,235787,235787,235789,0,2,2
67295,6,3,235793,235793,235796,0,3,4
67296,1,3,235794,235796,235799,2,5,0
67297,1,1,235795,235799,235800,4,5,0
67298,6,3,235801,235801,235804,0,3,1
67299,1,3,235802,235804,235807,2,5,0
67300,2,1,235804,235807,235808,3,4,0
67301,2,3,235806,235808,235811,2,5,0
67302,1,2,235807,235811,235813,4,6,0
67303,6,3,235813,235813,235816,0,3,0
67304,6,2,235819,235819,235821,0,2,3
67305,3,1,235822,235822,235823,0,1,1
67306,6,1,235828,235828,235829,0,1,5
67307,6,3,235834,235834,235837,0,3,5
67308,1,1,235835,235837,235838,2,3,0
67309,6,2,235841,235841,235843,0,2,3
67310,5,3,235846,235846,235849,0,3,3
67311,3,3,235849,235849,235852,0,3,0
67312,2,3,235851,235852,235855,1,4,0
67313,1,3,235852,235855,235858,3,6,0
67314,5,2,235857,235858,235860,1,3,0
67315,1,2,235858,235860,235862,2,4,0
67316,3,2,235861,235862,235864,1,3,0
67317,1,1,235862,235864,235865,2,3,0
67318,4,3,235866,235866,235869,0,3,1
67319,1,1,235867,235869,235870,2,3,0
67320,6,3,235873,235873,235876,0,3,3
67321,2,1,235875,235876,235877,1,2,0
67322,4,3,235879,235879,235882,0,3,2
67323,3,2,235882,235882,235884,0,2,0
67324,2,3,235884,235884,235887,0,3,0
67325,2,2,235886,235887,235889,1,3,0
67326,3,3,235889,235889,235892,0,3,0
67327,6,2,235895,235895,235897,0,2,3
67328,4,2,235899,235899,235901,0,2,2
67329,1,1,235900,235901,235902,1,2,0
67330,2,2,235902,235902,235904,0,2,0
67331,2,1,235904,235904,235905,0,1,0
67332,5,3,235909,235909,235912,0,3,4
67333,2,1,235911,235912,235913,1,2,0
67334,3,1,235914,235914,235915,0,1,1
67335,6,3,235920,235920,235923,0,3,5
67336,3,3,235923,235923,235926,0,3,0
67337,1,2,235924,235926,235928,2,4,0
67338,1,2,235925,235928,235930,3,5,0
67339,2,1,235927,235930,235931,3,4,0
67340,1,1,235928,235931,235932,3,4,0
67341,4,3,235932,235932,235935,0,3,0
67342,6,3,235938,235938,235941,0,3,3
67343,6,2,235944,235944,235946,0,2,3
67344,4,1,235948,235948,235949,0,1,2
67345,3,2,235951,235951,235953,0,2,2
67346,3,3,235954,235954,235957,0,3,1
67347,6,2,235960,235960,235962,0,2,3
67348,1,3,235961,235962,235965,1,4,0
67349,6,3,235967,235967,235970,0,3,2
67350,2,1,235969,235970,235971,1,2,0
67351,6,3,235975,235975,235978,0,3,4
67352,5,3,235980,235980,235983,0,3,2
67353,2,1,235982,235983,235984,1,2,0
67354,4,2,235986,235986,235988,0,2,2
67355,3,3,235989,235989,235992,0,3,1
67356,1,1,235990,235992,235993,2,3,0
67357,5,3,235995,235995,235998,0,3,2
67358,6,1,236001,236001,236002,0,1,3
67359,5,3,236006,236006,236009,0,3,4
67360,4,2,236010,236010,236012,0,2,1
67361,2,1,236012,236012,236013,0,1,0
67362,3,1,236015,236015,236016,0,1,2
67363,6,1,236021,236021,236022,0,1,5
67364,1,1,236022,236022,236023,0,1,0
67365,1,1,236023,236023,236024,0,1,0
67366,6,2,236029,236029,236031,0,2,5
67367,1,1,236030,236031,236032,1,2,0
67368,4,3,236034,236034,236037,0,3,2
67369,5,2,236039,236039,236041,0,2,2
67370,1,3,236040,236041,236044,1,4,0
67371,1,2,236041,236044,236046,3,5,0
67372,3,1,236044,236046,236047,2,3,0
67373,4,1,236048,236048,236049,0,1,1
67374,5,1,236053,236053,236054,0,1,4
67375,4,1,236057,236057,236058,0,1,3
67376,1,3,236058,236058,236061,0,3,0
67377,4,3,236062,236062,236065,0,3,1
67378,2,1,236064,236065,236066,1,2,0
67379,3,1,236067,236067,236068,0,1,1
67380,5,1,236072,236072,236073,0,1,4
67381,4,1,236076,236076,236077,0,1,3
67382,5,3,236081,236081,236084,0,3,4
67383,3,3,236084,236084,236087,0,3,0
67384,6,1,236090,236090,236091,0,1,3
67385,5,2,236095,236095,236097,0,2,4
67386,4,2,236099,236099,236101,0,2,2
67387,5,3,236104,236104,236107,0,3,3
67388,3,3,236107,236107,236110,0,3,0
67389,2,2,236109,236110,236112,1,3,0
67390,2,2,236111,236112,236114,1,3,0
67391,1,2,236112,236114,236116,2,4,0
67392,6,2,236118,236118,236120,0,2,2
67393,6,3,236124,236124,236127,0,3,4
67394,4,1,236128,236128,236129,0,1,1
67395,2,1,236130,236130,236131,0,1,1
67396,4,2,236134,236134,236136,0,2,3
67397,3,2,236137,236137,236139,0,2,1
67398,1,1,236138,236139,236140,1,2,0
67399,2,2,236140,236140,236142,0,2,0
67400,6,2,236146,236146,236148,0,2,4
67401,2,1,236148,236148,236149,0,1,0
67402,3,3,236151,236151,236154,0,3,2
67403,2,2,236153,236154,236156,1,3,0
67404,6,1,236159,236159,236160,0,1,3
67405,6,2,236165,236165,236167,0,2,5
67406,6,1,236171,236171,236172,0,1,4
67407,5,3,236176,236176,236179,0,3,4
67408,4,3,236180,236180,236183,0,3,1
67409,6,3,236186,236186,236189,0,3,3
67410,6,3,236192,236192,236195,0,3,3
67411,3,1,236195,236195,236196,0,1,0
67412,1,3,236196,236196,236199,0,3,0
67413,6,1,236202,236202,236203,0,1,3
67414,1,2,236203,236203,236205,0,2,0
67415,5,1,236208,236208,236209,0,1,3
67416,2,3,236210,236210,236213,0,3,1
67417,6,2,236216,236216,236218,0,2,3
67418,2,1,236218,236218,236219,0,1,0
67419,3,3,236221,236221,236224,0,3,2
67420,3,3,236224,236224,236227,0,3,0
67421,3,2,236227,236227,236229,0,2,0
67422,6,1,236233,236233,236234,0,1,4
67423,3,1,236236,236236,236237,0,1,2
67424,2,1,236238,236238,236239,0,1,1
67425,4,1,236242,236242,236243,0,1,3
67426,6,3,236248,236248,236251,0,3,5
67427,3,2,236251,236251,236253,0,2,0
67428,1,2,236252,236253,236255,1,3,0
67429,1,1,236253,236255,236256,2,3,0
67430,4,2,236257,236257,236259,0,2,1
67431,1,3,236258,236259,236262,1,4,0
67432,1,2,236259,236262,236264,3,5,0
67433,5,3,236264,236264,236267,0,3,0
67434,5,2,236269,236269,236271,0,2,2
67435,2,1,236271,236271,236272,0,1,0
67436,3,3,236274,236274,236277,0,3,2
67437,6,3,236280,236280,236283,0,3,3
67438,4,1,236284,236284,236285,0,1,1
67439,2,3,236286,236286,236289,0,3,1
67440,2,2,236288,236289,236291,1,3,0
67441,6,2,236294,236294,236296,0,2,3
67442,5,1,236299,236299,236300,0,1,3
67443,6,1,236305,236305,236306,0,1,5
67444,5,2,236310,236310,236312,0,2,4
67445,1,3,236311,236312,236315,1,4,0
67446,4,3,236315,236315,236318,0,3,0
67447,2,3,236317,236318,236321,1,4,0
67448,2,2,236319,236321,236323,2,4,0
67449,2,2,236321,236323,236325,2,4,0
67450,3,1,236324,236325,236326,1,2,0
67451,5,3,236329,236329,236332,0,3,3
67452,6,3,236335,236335,236338,0,3,3
67453,4,2,236339,236339,236341,0,2,1
67454,3,2,236342,236342,236344,0,2,1
67455,4,1,236346,236346,236347,0,1,2
67456,5,3,236351,236351,236354,0,3,4
67457,6,2,236357,236357,236359,0,2,3
67458,5,1,236362,236362,236363,0,1,3
67459,6,1,236368,236368,236369,0,1,5
67460,3,3,236371,236371,236374,0,3,2
67461,1,3,236372,236374,236377,2,5,0
67462,6,3,236378,236378,236381,0,3,1
67463,4,3,236382,236382,236385,0,3,1
67464,2,2,236384,236385,236387,1,3,0
67465,5,2,236389,236389,236391,0,2,2
67466,6,1,236395,236395,236396,0,1,4
67467,3,3,236398,236398,236401,0,3,2
67468,4,1,236402,236402,236403,0,1,1
67469,1,1,236403,236403,236404,0,1,0
67470,2,3,236405,236405,236408,0,3,1
67471,2,1,236407,236408,236409,1,2,0
67472,6,2,236413,236413,236415,0,2,4
67473,5,3,236418,236418,236421,0,3,3
67474,2,2,236420,236421,236423,1,3,0
67475,2,3,236422,236423,236426,1,4,0
67476,5,2,236427,236427,236429,0,2,1
67477,1,3,236428,236429,236432,1,4,0
67478,6,3,236434,236434,236437,0,3,2
67479,6,2,236440,236440,236442,0,2,3
67480,5,1,236445,236445,236446,0,1,3
67481,6,1,236451,236451,236452,0,1,5
67482,5,3,236456,236456,236459,0,3,4
67483,1,3,236457,236459,236462,2,5,0
67484,3,3,236460,236462,236465,2,5,0
67485,5,1,236465,236465,236466,0,1,0
67486,4,3,236469,236469,236472,0,3,3
67487,3,2,236472,236472,236474,0,2,0
67488,1,2,236473,236474,236476,1,3,0
67489,2,3,236475,236476,236479,1,4,0
67490,5,1,236480,236480,236481,0,1,1
67491,6,2,236486,236486,236488,0,2,5
67492,1,3,236487,236488,236491,1,4,0
67493,5,2,236492,236492,236494,0,2,1
67494,2,1,236494,236494,236495,0,1,0
67495,4,1,236498,236498,236499,0,1,3
67496,2,1,236500,236500,236501,0,1,1
67497,3,1,236503,236503,236504,0,1,2
67498,3,3,236506,236506,236509,0,3,2
67499,4,3,236510,236510,236513,0,3,1
67500,6,1,236516,236516,236517,0,1,3
67501,1,3,236517,236517,236520,0,3,0
67502,5,2,236522,236522,236524,0,2,2
67503,2,2,236524,236524,236526,0,2,0
67504,5,3,236529,236529,236532,0,3,3
67505,1,2,236530,236532,236534,2,4,0
67506,5,2,236535,236535,236537,0,2,1
67507,5,1,236540,236540,236541,0,1,3
67508,1,3,236541,236541,236544,0,3,0
67509,1,2,236542,236544,236546,2,4,0
67510,3,3,236545,236546,236549,1,4,0
67511,1,2,236546,236549,236551,3,5,0
67512,1,1,236547,236551,236552,4,5,0
67513,1,3,236548,236552,236555,4,7,0
67514,1,3,236549,236555,236558,6,9,0
67515,1,3,236550,236558,236561,8,11,0
67516,1,2,236551,236561,236563,10,12,0
67517,5,2,236556,236563,236565,7,9,0
67518,1,1,236557,236565,236566,8,9,0
67519,4,3,236561,236566,236569,5,8,0
67520,3,3,236564,236569,236572,5,8,0
67521,4,3,236568,236572,236575,4,7,0
67522,5,3,236573,236575,236578,2,5,0
67523,5,3,236578,236578,236581,0,3,0
67524,4,1,236582,236582,236583,0,1,1
67525,6,1,236588,236588,236589,0,1,5
67526,5,1,236593,236593,236594,0,1,4
67527,6,1,236599,236599,236600,0,1,5
67528,3,2,236602,236602,236604,0,2,2
67529,6,1,236608,236608,236609,0,1,4
67530,5,1,236613,236613,236614,0,1,4
67531,5,1,236618,236618,236619,0,1,4
67532,4,3,236622,236622,236625,0,3,3
67533,6,2,236628,236628,236630,0,2,3
67534,3,3,236631,236631,236634,0,3,1
67535,4,1,236635,236635,236636,0,1,1
67536,5,2,236640,236640,236642,0,2,4
67537,2,2,236642,236642,236644,0,2,0
67538,4,3,236646,236646,236649,0,3,2
67539,5,3,236651,236651,236654,0,3,2
67540,3,2,236654,236654,236656,0,2,0
67541,4,2,236658,236658,236660,0,2,2
67542,1,1,236659,236660,236661,1,2,0
67543,3,3,236662,236662,236665,0,3,1
67544,6,1,236668,236668,236669,0,1,3
67545,1,2,236669,236669,236671,0,2,0
67546,2,1,236671,236671,236672,0,1,0
67547,2,2,236673,236673,236675,0,2,1
67548,5,1,236678,236678,236679,0,1,3
67549,5,1,236683,236683,236684,0,1,4
67550,6,2,236689,236689,236691,0,2,5
67551,6,3,236695,236695,236698,0,3,4
67552,6,1,236701,236701,236702,0,1,3
67553,3,3,236704,236704,236707,0,3,2
67554,1,3,236705,236707,236710,2,5,0
67555,1,2,236706,236710,236712,4,6,0
67556,3,1,236709,236712,236713,3,4,0
67557,3,2,236712,236713,236715,1,3,0
67558,1,1,236713,236715,236716,2,3,0
67559,5,2,236718,236718,236720,0,2,2
67560,2,2,236720,236720,236722,0,2,0
67561,3,3,236723,236723,236726,0,3,1
67562,4,2,236727,236727,236729,0,2,1
67563,1,1,236728,236729,236730,1,2,0
67564,6,2,236734,236734,236736,0,2,4
67565,2,1,236736,236736,236737,0,1,0
67566,4,3,236740,236740,236743,0,3,3
67567,4,3,236744,236744,236747,0,3,1
67568,3,2,236747,236747,236749,0,2,0
67569,6,2,236753,236753,236755,0,2,4
67570,4,1,236757,236757,236758,0,1,2
67571,5,2,236762,236762,236764,0,2,4
67572,6,2,236768,236768,236770,0,2,4
67573,5,2,236773,236773,236775,0,2,3
67574,6,2,236779,236779,236781,0,2,4
67575,3,1,236782,236782,236783,0,1,1
67576,4,1,236786,236786,236787,0,1,3
67577,6,2,236792,236792,236794,0,2,5
67578,6,2,236798,236798,236800,0,2,4
67579,3,3,236801,236801,236804,0,3,1
67580,6,3,236807,236807,236810,0,3,3
67581,4,1,236811,236811,236812,0,1,1
67582,2,3,236813,236813,236816,0,3,1
67583,6,2,236819,236819,236821,0,2,3
67584,6,1,236825,236825,236826,0,1,4
67585,1,1,236826,236826,236827,0,1,0
67586,3,3,236829,236829,236832,0,3,2
67587,6,1,236835,236835,236836,0,1,3
67588,5,3,236840,236840,236843,0,3,4
67589,6,1,236846,236846,236847,0,1,3
67590,3,3,236849,236849,236852,0,3,2
67591,5,2,236854,236854,236856,0,2,2
67592,4,2,236858,236858,236860,0,2,2
67593,1,3,236859,236860,236863,1,4,0
67594,4,2,236863,236863,236865,0,2,0
67595,3,1,236866,236866,236867,0,1,1
67596,3,1,236869,236869,236870,0,1,2
67597,2,3,236871,236871,236874,0,3,1
67598,4,1,236875,236875,236876,0,1,1
67599,4,2,236879,236879,236881,0,2,3
67600,4,2,236883,236883,236885,0,2,2
67601,6,2,236889,236889,236891,0,2,4
67602,3,1,236892,236892,236893,0,1,1
67603,3,2,236895,236895,236897,0,2,2
67604,5,2,236900,236900,236902,0,2,3
67605,6,3,236906,236906,236909,0,3,4
67606,2,3,236908,236909,236912,1,4,0
67607,4,1,236912,236912,236913,0,1,0
67608,6,1,236918,236918,236919,0,1,5
67609,5,3,236923,236923,236926,0,3,4
67610,2,1,236925,236926,236927,1,2,0
67611,5,1,236930,236930,236931,0,1,3
67612,6,2,236936,236936,236938,0,2,5
67613,6,2,236942,236942,236944,0,2,4
67614,1,2,236943,236944,236946,1,3,0
67615,5,1,236948,236948,236949,0,1,2
67616,5,2,236953,236953,236955,0,2,4
67617,4,1,236957,236957,236958,0,1,2
67618,5,3,236962,236962,236965,0,3,4
67619,4,1,236966,236966,236967,0,1,1
67620,4,3,236970,236970,236973,0,3,3
67621,3,3,236973,236973,236976,0,3,0
67622,5,3,236978,236978,236981,0,3,2
67623,4,2,236982,236982,236984,0,2,1
67624,4,3,236986,236986,236989,0,3,2
67625,1,3,236987,236989,236992,2,5,0
67626,4,2,236991,236992,236994,1,3,0
67627,3,1,236994,236994,236995,0,1,0
67628,3,1,236997,236997,236998,0,1,2
67629,3,3,237000,237000,237003,0,3,2
67630,2,1,237002,237003,237004,1,2,0
67631,2,2,237004,237004,237006,0,2,0
67632,1,2,237005,237006,237008,1,3,0
67633,4,1,237009,237009,237010,0,1,1
67634,4,2,237013,237013,237015,0,2,3
67635,4,1,237017,237017,237018,0,1,2
67636,5,2,237022,237022,237024,0,2,4
67637,6,1,237028,237028,237029,0,1,4
67638,4,3,237032,237032,237035,0,3,3
67639,2,2,237034,237035,237037,1,3,0
67640,2,3,237036,237037,237040,1,4,0
67641,2,1,237038,237040,237041,2,3,0
67642,2,3,237040,237041,237044,1,4,0
67643,5,1,237045,237045,237046,0,1,1
67644,1,1,237046,237046,237047,0,1,0
67645,3,2,237049,237049,237051,0,2,2
67646,5,1,237054,237054,237055,0,1,3
67647,1,3,237055,237055,237058,0,3,0
67648,1,1,237056,237058,237059,2,3,0
67649,4,2,237060,237060,237062,0,2,1
67650,2,2,237062,237062,237064,0,2,0
67651,4,2,237066,237066,237068,0,2,2
67652,3,2,237069,237069,237071,0,2,1
67653,1,1,237070,237071,237072,1,2,0
67654,1,1,237071,237072,237073,1,2,0
67655,2,3,237073,237073,237076,0,3,0
67656,6,1,237079,237079,237080,0,1,3
67657,2,3,237081,237081,237084,0,3,1
67658,5,1,237086,237086,237087,0,1,2
67659,2,1,237088,237088,237089,0,1,1
67660,5,1,237093,237093,237094,0,1,4
67661,1,3,237094,237094,237097,0,3,0
67662,5,1,237099,237099,237100,0,1,2
67663,3,3,237102,237102,237105,0,3,2
67664,4,2,237106,237106,237108,0,2,1
67665,5,3,237111,237111,237114,0,3,3
67666,2,1,237113,237114,237115,1,2,0
67667,2,3,237115,237115,237118,0,3,0
67668,5,2,237120,237120,237122,0,2,2
67669,3,1,237123,237123,237124,0,1,1
67670,2,2,237125,237125,237127,0,2,1
67671,1,1,237126,237127,237128,1,2,0
67672,3,2,237129,237129,237131,0,2,1
67673,4,2,237133,237133,237135,0,2,2
67674,1,2,237134,237135,237137,1,3,0
67675,2,2,237136,237137,237139,1,3,0
67676,3,2,237139,237139,237141,0,2,0
67677,3,1,237142,237142,237143,0,1,1
67678,3,3,237145,237145,237148,0,3,2
67679,1,1,237146,237148,237149,2,3,0
67680,4,2,237150,237150,237152,0,2,1
67681,2,1,237152,237152,237153,0,1,0
67682,1,3,237153,237153,237156,0,3,0
67683,5,3,237158,237158,237161,0,3,2
67684,1,2,237159,237161,237163,2,4,0
67685,2,3,237161,237163,237166,2,5,0
67686,2,2,237163,237166,237168,3,5,0
67687,2,3,237165,237168,237171,3,6,0
67688,4,2,237169,237171,237173,2,4,0
67689,1,2,237170,237173,237175,3,5,0
67690,6,2,237176,237176,237178,0,2,1
67691,3,1,237179,237179,237180,0,1,1
67692,3,3,237182,237182,237185,0,3,2
67693,1,3,237183,237185,237188,2,5,0
67694,4,3,237187,237188,237191,1,4,0
67695,1,2,237188,237191,237193,3,5,0
67696,6,1,237194,237194,237195,0,1,1
67697,6,2,237200,237200,237202,0,2,5
67698,2,1,237202,237202,237203,0,1,0
67699,2,3,237204,237204,237207,0,3,1
67700,3,3,237207,237207,237210,0,3,0
67701,4,3,237211,237211,237214,0,3,1
67702,2,2,237213,237214,237216,1,3,0
67703,2,2,237215,237216,237218,1,3,0
67704,4,1,237219,237219,237220,0,1,1
67705,4,2,237223,237223,237225,0,2,3
67706,6,2,237229,237229,237231,0,2,4
67707,4,2,237233,237233,237235,0,2,2
67708,4,2,237237,237237,237239,0,2,2
67709,6,1,237243,237243,237244,0,1,4
67710,3,3,237246,237246,237249,0,3,2
67711,3,2,237249,237249,237251,0,2,0
67712,2,1,237251,237251,237252,0,1,0
67713,1,2,237252,237252,237254,0,2,0
67714,6,2,237258,237258,237260,0,2,4
67715,4,2,237262,237262,237264,0,2,2
67716,4,2,237266,237266,237268,0,2,2
67717,2,2,237268,237268,237270,0,2,0
67718,2,1,237270,237270,237271,0,1,0
67719,3,2,237273,237273,237275,0,2,2
67720,6,1,237279,237279,237280,0,1,4
67721,1,3,237280,237280,237283,0,3,0
67722,5,2,237285,237285,237287,0,2,2
67723,2,3,237287,237287,237290,0,3,0
67724,3,1,237290,237290,237291,0,1,0
67725,4,3,237294,237294,237297,0,3,3
67726,1,2,237295,237297,237299,2,4,0
67727,5,2,237300,237300,237302,0,2,1
67728,6,1,237306,237306,237307,0,1,4
67729,2,3,237308,237308,237311,0,3,1
67730,5,2,237313,237313,237315,0,2,2
67731,2,2,237315,237315,237317,0,2,0
67732,3,1,237318,237318,237319,0,1,1
67733,4,2,237322,237322,237324,0,2,3
67734,6,2,237328,237328,237330,0,2,4
67735,2,3,237330,237330,237333,0,3,0
67736,3,3,237333,237333,237336,0,3,0
67737,1,1,237334,237336,237337,2,3,0
67738,6,3,237340,237340,237343,0,3,3
67739,3,1,237343,237343,237344,0,1,0
67740,4,3,237347,237347,237350,0,3,3
67741,5,2,237352,237352,237354,0,2,2
67742,6,2,237358,237358,237360,0,2,4
67743,2,1,237360,237360,237361,0,1,0
67744,4,2,237364,237364,237366,0,2,3
67745,5,3,237369,237369,237372,0,3,3
67746,2,2,237371,237372,237374,1,3,0
67747,2,2,237373,237374,237376,1,3,0
67748,2,3,237375,237376,237379,1,4,0
67749,6,1,237381,237381,237382,0,1,2
67750,4,3,237385,237385,237388,0,3,3
67751,1,3,237386,237388,237391,2,5,0
67752,3,2,237389,237391,237393,2,4,0
67753,6,2,237395,237395,237397,0,2,2
67754,3,2,237398,237398,237400,0,2,1
67755,1,1,237399,237400,237401,1,2,0
67756,3,3,237402,237402,237405,0,3,1
67757,5,3,237407,237407,237410,0,3,2
67758,3,3,237410,237410,237413,0,3,0
67759,6,1,237416,237416,237417,0,1,3
67760,6,2,237422,237422,237424,0,2,5
67761,5,2,237427,237427,237429,0,2,3
67762,3,1,237430,237430,237431,0,1,1
67763,4,3,237434,237434,237437,0,3,3
67764,3,3,237437,237437,237440,0,3,0
67765,2,3,237439,237440,237443,1,4,0
67766,6,3,237445,237445,237448,0,3,2
67767,1,2,237446,237448,237450,2,4,0
67768,5,3,237451,237451,237454,0,3,1
67769,3,3,237454,237454,237457,0,3,0
67770,1,1,237455,237457,237458,2,3,0
67771,2,3,237457,237458,237461,1,4,0
67772,2,1,237459,237461,237462,2,3,0
67773,6,2,237465,237465,237467,0,2,3
67774,6,2,237471,237471,237473,0,2,4
67775,4,2,237475,237475,237477,0,2,2
67776,1,1,237476,237477,237478,1,2,0
67777,2,2,237478,237478,237480,0,2,0
67778,4,2,237482,237482,237484,0,2,2
67779,3,2,237485,237485,237487,0,2,1
67780,1,2,237486,237487,237489,1,3,0
67781,1,3,237487,237489,237492,2,5,0
67782,6,1,237493,237493,237494,0,1,1
67783,2,3,237495,237495,237498,0,3,1
67784,1,1,237496,237498,237499,2,3,0
67785,5,1,237501,237501,237502,0,1,2
67786,6,2,237507,237507,237509,0,2,5
67787,3,1,237510,237510,237511,0,1,1
67788,2,2,237512,237512,237514,0,2,1
67789,2,2,237514,237514,237516,0,2,0
67790,6,1,237520,237520,237521,0,1,4
67791,4,3,237524,237524,237527,0,3,3
67792,4,1,237528,237528,237529,0,1,1
67793,1,2,237529,237529,237531,0,2,0
67794,1,1,237530,237531,237532,1,2,0
67795,6,2,237536,237536,237538,0,2,4
67796,1,3,237537,237538,237541,1,4,0
67797,5,3,237542,237542,237545,0,3,1
67798,3,1,237545,237545,237546,0,1,0
67799,3,3,237548,237548,237551,0,3,2
67800,1,1,237549,237551,237552,2,3,0
67801,6,1,237555,237555,237556,0,1,3
67802,5,1,237560,237560,237561,0,1,4
67803,4,2,237564,237564,237566,0,2,3
67804,2,3,237566,237566,237569,0,3,0
67805,2,3,237568,237569,237572,1,4,0
67806,6,2,237574,237574,237576,0,2,2
67807,3,1,237577,237577,237578,0,1,1
67808,3,1,237580,237580,237581,0,1,2
67809,2,1,237582,237582,237583,0,1,1
67810,4,2,237586,237586,237588,0,2,3
67811,5,1,237591,237591,237592,0,1,3
67812,5,3,237596,237596,237599,0,3,4
67813,2,2,237598,237599,237601,1,3,0
67814,2,2,237600,237601,237603,1,3,0
67815,4,3,237604,237604,237607,0,3,1
67816,2,1,237606,237607,237608,1,2,0
67817,5,3,237611,237611,237614,0,3,3
67818,4,1,237615,237615,237616,0,1,1
67819,6,3,237621,237621,237624,0,3,5
67820,4,1,237625,237625,237626,0,1,1
67821,3,3,237628,237628,237631,0,3,2
67822,4,3,237632,237632,237635,0,3,1
67823,4,2,237636,237636,237638,0,2,1
67824,5,3,237641,237641,237644,0,3,3
67825,6,3,237647,237647,237650,0,3,3
67826,3,3,237650,237650,237653,0,3,0
67827,2,2,237652,237653,237655,1,3,0
67828,1,3,237653,237655,237658,2,5,0
67829,3,1,237656,237658,237659,2,3,0
67830,6,3,237662,237662,237665,0,3,3
67831,5,3,237667,237667,237670,0,3,2
67832,4,1,237671,237671,237672,0,1,1
67833,3,1,237674,237674,237675,0,1,2
67834,1,3,237675,237675,237678,0,3,0
67835,4,3,237679,237679,237682,0,3,1
67836,4,3,237683,237683,237686,0,3,1
67837,5,3,237688,237688,237691,0,3,2
67838,1,3,237689,237691,237694,2,5,0
67839,5,1,237694,237694,237695,0,1,0
67840,5,3,237699,237699,237702,0,3,4
67841,5,2,237704,237704,237706,0,2,2
67842,6,3,237710,237710,237713,0,3,4
67843,6,2,237716,237716,237718,0,2,3
67844,1,1,237717,237718,237719,1,2,0
67845,3,3,237720,237720,237723,0,3,1
67846,3,3,237723,237723,237726,0,3,0
67847,2,3,237725,237726,237729,1,4,0
67848,2,3,237727,237729,237732,2,5,0
67849,5,2,237732,237732,237734,0,2,0
67850,2,2,237734,237734,237736,0,2,0
67851,1,2,237735,237736,237738,1,3,0
67852,6,2,237741,237741,237743,0,2,3
67853,3,1,237744,237744,237745,0,1,1
67854,4,1,237748,237748,237749,0,1,3
67855,6,3,237754,237754,237757,0,3,5
67856,6,2,237760,237760,237762,0,2,3
67857,5,1,237765,237765,237766,0,1,3
67858,3,2,237768,237768,237770,0,2,2
67859,3,1,237771,237771,237772,0,1,1
67860,4,1,237775,237775,237776,0,1,3
67861,6,3,237781,237781,237784,0,3,5
67862,1,1,237782,237784,237785,2,3,0
67863,2,1,237784,237785,237786,1,2,0
67864,2,2,237786,237786,237788,0,2,0
67865,6,3,237792,237792,237795,0,3,4
67866,2,1,237794,237795,237796,1,2,0
67867,1,2,237795,237796,237798,1,3,0
67868,5,1,237800,237800,237801,0,1,2
67869,3,1,237803,237803,237804,0,1,2
67870,2,2,237805,237805,237807,0,2,1
67871,3,1,237808,237808,237809,0,1,1
67872,3,3,237811,237811,237814,0,3,2
67873,1,1,237812,237814,237815,2,3,0
67874,3,1,237815,237815,237816,0,1,0
67875,6,2,237821,237821,237823,0,2,5
67876,4,2,237825,237825,237827,0,2,2
67877,5,1,237830,237830,237831,0,1,3
67878,4,3,237834,237834,237837,0,3,3
67879,6,3,237840,237840,237843,0,3,3
67880,6,1,237846,237846,237847,0,1,3
67881,6,2,237852,237852,237854,0,2,5
67882,2,1,237854,237854,237855,0,1,0
67883,6,1,237860,237860,237861,0,1,5
67884,4,2,237864,237864,237866,0,2,3
67885,5,1,237869,237869,237870,0,1,3
67886,3,3,237872,237872,237875,0,3,2
67887,5,2,237877,237877,237879,0,2,2
67888,3,3,237880,237880,237883,0,3,1
67889,6,3,237886,237886,237889,0,3,3
67890,6,1,237892,237892,237893,0,1,3
67891,2,3,237894,237894,237897,0,3,1
67892,4,1,237898,237898,237899,0,1,1
67893,5,3,237903,237903,237906,0,3,4
67894,6,2,237909,237909,237911,0,2,3
67895,5,1,237914,237914,237915,0,1,3
67896,6,3,237920,237920,237923,0,3,5
67897,4,1,237924,237924,237925,0,1,1
67898,5,2,237929,237929,237931,0,2,4
67899,6,2,237935,237935,237937,0,2,4
67900,2,2,237937,237937,237939,0,2,0
67901,3,3,237940,237940,237943,0,3,1
67902,3,2,237943,237943,237945,0,2,0
67903,4,2,237947,237947,237949,0,2,2
67904,5,1,237952,237952,237953,0,1,3
67905,4,3,237956,237956,237959,0,3,3
67906,4,3,237960,237960,237963,0,3,1
67907,2,3,237962,237963,237966,1,4,0
67908,3,3,237965,237966,237969,1,4,0
67909,1,1,237966,237969,237970,3,4,0
67910,1,2,237967,237970,237972,3,5,0
67911,3,3,237970,237972,237975,2,5,0
67912,3,1,237973,237975,237976,2,3,0
67913,3,1,237976,237976,237977,0,1,0
67914,1,2,237977,237977,237979,0,2,0
67915,6,3,237983,237983,237986,0,3,4
67916,4,2,237987,237987,237989,0,2,1
67917,1,2,237988,237989,237991,1,3,0
67918,5,2,237993,237993,237995,0,2,2
67919,3,3,237996,237996,237999,0,3,1
67920,5,2,238001,238001,238003,0,2,2
67921,4,2,238005,238005,238007,0,2,2
67922,6,1,238011,238011,238012,0,1,4
67923,6,2,238017,238017,238019,0,2,5
67924,5,3,238022,238022,238025,0,3,3
67925,4,2,238026,238026,238028,0,2,1
67926,2,3,238028,238028,238031,0,3,0
67927,2,1,238030,238031,238032,1,2,0
67928,5,2,238035,238035,238037,0,2,3
67929,4,3,238039,238039,238042,0,3,2
67930,4,2,238043,238043,238045,0,2,1
67931,5,1,238048,238048,238049,0,1,3
67932,1,3,238049,238049,238052,0,3,0
67933,5,3,238054,238054,238057,0,3,2
67934,5,3,238059,238059,238062,0,3,2
67935,1,3,238060,238062,238065,2,5,0
67936,3,1,238063,238065,238066,2,3,0
67937,2,3,238065,238066,238069,1,4,0
67938,2,1,238067,238069,238070,2,3,0
67939,4,1,238071,238071,238072,0,1,1
67940,2,2,238073,238073,238075,0,2,1
67941,3,1,238076,238076,238077,0,1,1
67942,1,2,238077,238077,238079,0,2,0
67943,1,3,238078,238079,238082,1,4,0
67944,5,1,238083,238083,238084,0,1,1
67945,6,1,238089,238089,238090,0,1,5
67946,6,3,238095,238095,238098,0,3,5
67947,1,1,238096,238098,238099,2,3,0
67948,4,2,238100,238100,238102,0,2,1
67949,6,2,238106,238106,238108,0,2,4
67950,3,3,238109,238109,238112,0,3,1
67951,5,1,238114,238114,238115,0,1,2
67952,1,1,238115,238115,238116,0,1,0
67953,2,3,238117,238117,238120,0,3,1
67954,3,3,238120,238120,238123,0,3,0
67955,6,1,238126,238126,238127,0,1,3
67956,1,1,238127,238127,238128,0,1,0
67957,3,2,238130,238130,238132,0,2,2
67958,1,1,238131,238132,238133,1,2,0
67959,3,1,238134,238134,238135,0,1,1
67960,1,3,238135,238135,238138,0,3,0
67961,1,2,238136,238138,238140,2,4,0
67962,6,2,238142,238142,238144,0,2,2
67963,5,2,238147,238147,238149,0,2,3
67964,2,2,238149,238149,238151,0,2,0
67965,5,2,238154,238154,238156,0,2,3
67966,1,1,238155,238156,238157,1,2,0
67967,2,3,238157,238157,238160,0,3,0
67968,2,1,238159,238160,238161,1,2,0
67969,4,3,238163,238163,238166,0,3,2
67970,6,3,238169,238169,238172,0,3,3
67971,3,2,238172,238172,238174,0,2,0
67972,1,1,238173,238174,238175,1,2,0
67973,4,1,238177,238177,238178,0,1,2
67974,5,1,238182,238182,238183,0,1,4
67975,4,1,238186,238186,238187,0,1,3
67976,5,1,238191,238191,238192,0,1,4
67977,6,1,238197,238197,238198,0,1,5
67978,6,3,238203,238203,238206,0,3,5
67979,4,3,238207,238207,238210,0,3,1
67980,1,1,238208,238210,238211,2,3,0
67981,2,1,238210,238211,238212,1,2,0
67982,2,1,238212,238212,238213,0,1,0
67983,2,1,238214,238214,238215,0,1,1
67984,2,3,238216,238216,238219,0,3,1
67985,1,3,238217,238219,238222,2,5,0
67986,3,1,238220,238222,238223,2,3,0
67987,2,2,238222,238223,238225,1,3,0
67988,4,1,238226,238226,238227,0,1,1
67989,5,1,238231,238231,238232,0,1,4
67990,3,3,238234,238234,238237,0,3,2
67991,5,1,238239,238239,238240,0,1,2
67992,4,1,238243,238243,238244,0,1,3
67993,5,1,238248,238248,238249,0,1,4
67994,6,2,238254,238254,238256,0,2,5
67995,3,3,238257,238257,238260,0,3,1
67996,1,1,238258,238260,238261,2,3,0
67997,3,2,238261,238261,238263,0,2,0
67998,3,3,238264,238264,238267,0,3,1
67999,1,3,238265,238267,238270,2,5,0
68000,3,2,238268,238270,238272,2,4,0
68001,5,1,238273,238273,238274,0,1,1
68002,2,2,238275,238275,238277,0,2,1
68003,1,2,238276,238277,238279,1,3,0
68004,2,1,238278,238279,238280,1,2,0
68005,4,3,238282,238282,238285,0,3,2
68006,5,3,238287,238287,238290,0,3,2
68007,1,2,238288,238290,238292,2,4,0
68008,4,1,238292,238292,238293,0,1,0
68009,4,1,238296,238296,238297,0,1,3
68010,5,3,238301,238301,238304,0,3,4
68011,1,3,238302,238304,238307,2,5,0
68012,6,1,238308,238308,238309,0,1,1
68013,5,3,238313,238313,238316,0,3,4
68014,3,2,238316,238316,238318,0,2,0
68015,6,1,238322,238322,238323,0,1,4
68016,1,2,238323,238323,238325,0,2,0
68017,2,2,238325,238325,238327,0,2,0
68018,2,3,238327,238327,238330,0,3,0
68019,1,2,238328,238330,238332,2,4,0
68020,1,3,238329,238332,238335,3,6,0
68021,4,1,238333,238335,238336,2,3,0
68022,2,1,238335,238336,238337,1,2,0
68023,2,2,238337,238337,238339,0,2,0
68024,1,3,238338,238339,238342,1,4,0
68025,6,3,238344,238344,238347,0,3,2
68026,3,3,238347,238347,238350,0,3,0
68027,4,1,238351,238351,238352,0,1,1
68028,4,1,238355,238355,238356,0,1,3
68029,4,1,238359,238359,238360,0,1,3
68030,6,3,238365,238365,238368,0,3,5
68031,4,1,238369,238369,238370,0,1,1
68032,1,2,238370,238370,238372,0,2,0
68033,1,3,238371,238372,238375,1,4,0
68034,2,3,238373,238375,238378,2,5,0
68035,2,3,238375,238378,238381,3,6,0
68036,3,3,238378,238381,238384,3,6,0
68037,5,1,238383,238384,238385,1,2,0
68038,3,2,238386,238386,238388,0,2,1
68039,1,1,238387,238388,238389,1,2,0
68040,6,1,238393,238393,238394,0,1,4
68041,1,3,238394,238394,238397,0,3,0
68042,3,1,238397,238397,238398,0,1,0
68043,2,3,238399,238399,238402,0,3,1
68044,1,3,238400,238402,238405,2,5,0
68045,6,3,238406,238406,238409,0,3,1
68046,1,3,238407,238409,238412,2,5,0
68047,4,3,238411,238412,238415,1,4,0
68048,2,2,238413,238415,238417,2,4,0
68049,2,1,238415,238417,238418,2,3,0
68050,4,3,238419,238419,238422,0,3,1
68051,5,2,238424,238424,238426,0,2,2
68052,3,2,238427,238427,238429,0,2,1
68053,3,1,238430,238430,238431,0,1,1
68054,4,2,238434,238434,238436,0,2,3
68055,2,1,238436,238436,238437,0,1,0
68056,3,3,238439,238439,238442,0,3,2
68057,2,3,238441,238442,238445,1,4,0
68058,3,3,238444,238445,238448,1,4,0
68059,6,1,238450,238450,238451,0,1,2
68060,2,3,238452,238452,238455,0,3,1
68061,1,2,238453,238455,238457,2,4,0
68062,3,1,238456,238457,238458,1,2,0
68063,4,2,238460,238460,238462,0,2,2
68064,4,3,238464,238464,238467,0,3,2
68065,6,1,238470,238470,238471,0,1,3
68066,2,2,238472,238472,238474,0,2,1
68067,1,3,238473,238474,238477,1,4,0
68068,1,1,238474,238477,238478,3,4,0
68069,2,1,238476,238478,238479,2,3,0
68070,6,1,238482,238482,238483,0,1,3
68071,1,2,238483,238483,238485,0,2,0
68072,3,1,238486,238486,238487,0,1,1
68073,2,3,238488,238488,238491,0,3,1
68074,6,2,238494,238494,238496,0,2,3
68075,1,2,238495,238496,238498,1,3,0
68076,1,2,238496,238498,238500,2,4,0
68077,1,3,238497,238500,238503,3,6,0
68078,2,3,238499,238503,238506,4,7,0
68079,1,2,238500,238506,238508,6,8,0
68080,6,3,238506,238508,238511,2,5,0
68081,5,1,238511,238511,238512,0,1,0
68082,1,2,238512,238512,238514,0,2,0
68083,4,3,238516,238516,238519,0,3,2
68084,4,3,238520,238520,238523,0,3,1
68085,6,1,238526,238526,238527,0,1,3
68086,6,1,238532,238532,238533,0,1,5
68087,1,1,238533,238533,238534,0,1,0
68088,3,1,238536,238536,238537,0,1,2
68089,5,2,238541,238541,238543,0,2,4
68090,4,1,238545,238545,238546,0,1,2
68091,5,1,238550,238550,238551,0,1,4
68092,4,3,238554,238554,238557,0,3,3
68093,6,1,238560,238560,238561,0,1,3
68094,3,1,238563,238563,238564,0,1,2
68095,1,2,238564,238564,238566,0,2,0
68096,3,2,238567,238567,238569,0,2,1
68097,6,3,238573,238573,238576,0,3,4
68098,5,1,238578,238578,238579,0,1,2
68099,3,1,238581,238581,238582,0,1,2
68100,4,3,238585,238585,238588,0,3,3
68101,4,3,238589,238589,238592,0,3,1
68102,2,3,238591,238592,238595,1,4,0
68103,6,1,238597,238597,238598,0,1,2
68104,6,2,238603,238603,238605,0,2,5
68105,2,1,238605,238605,238606,0,1,0
68106,4,1,238609,238609,238610,0,1,3
68107,5,2,238614,238614,238616,0,2,4
68108,5,3,238619,238619,238622,0,3,3
68109,1,3,238620,238622,238625,2,5,0
68110,3,3,238623,238625,238628,2,5,0
68111,4,2,238627,238628,238630,1,3,0
68112,1,3,238628,238630,238633,2,5,0
68113,6,2,238634,238634,238636,0,2,1
68114,1,3,238635,238636,238639,1,4,0
68115,1,3,238636,238639,238642,3,6,0
68116,1,1,238637,238642,238643,5,6,0
68117,1,3,238638,238643,238646,5,8,0
68118,5,2,238643,238646,238648,3,5,0
68119,3,1,238646,238648,238649,2,3,0
68120,4,1,238650,238650,238651,0,1,1
68121,1,2,238651,238651,238653,0,2,0
68122,6,1,238657,238657,238658,0,1,4
68123,3,3,238660,238660,238663,0,3,2
68124,2,3,238662,238663,238666,1,4,0
68125,6,3,238668,238668,238671,0,3,2
68126,3,2,238671,238671,238673,0,2,0
68127,4,3,238675,238675,238678,0,3,2
68128,5,3,238680,238680,238683,0,3,2
68129,5,3,238685,238685,238688,0,3,2
68130,1,3,238686,238688,238691,2,5,0
68131,1,2,238687,238691,238693,4,6,0
68132,3,2,238690,238693,238695,3,5,0
68133,4,3,238694,238695,238698,1,4,0
68134,2,1,238696,238698,238699,2,3,0
68135,3,2,238699,238699,238701,0,2,0
68136,1,2,238700,238701,238703,1,3,0
68137,6,3,238706,238706,238709,0,3,3
68138,2,3,238708,238709,238712,1,4,0
68139,2,1,238710,238712,238713,2,3,0
68140,4,1,238714,238714,238715,0,1,1
68141,6,1,238720,238720,238721,0,1,5
68142,2,1,238722,238722,238723,0,1,1
68143,6,1,238728,238728,238729,0,1,5
68144,6,3,238734,238734,238737,0,3,5
68145,1,3,238735,238737,238740,2,5,0
68146,4,1,238739,238740,238741,1,2,0
68147,4,3,238743,238743,238746,0,3,2
68148,6,3,238749,238749,238752,0,3,3
68149,5,2,238754,238754,238756,0,2,2
68150,6,1,238760,238760,238761,0,1,4
68151,3,2,238763,238763,238765,0,2,2
68152,1,3,238764,238765,238768,1,4,0
68153,5,2,238769,238769,238771,0,2,1
68154,4,2,238773,238773,238775,0,2,2
68155,1,3,238774,238775,238778,1,4,0
68156,4,3,238778,238778,238781,0,3,0
68157,2,3,238780,238781,238784,1,4,0
68158,4,2,238784,238784,238786,0,2,0
68159,1,1,238785,238786,238787,1,2,0
68160,2,1,238787,238787,238788,0,1,0
68161,3,1,238790,238790,238791,0,1,2
68162,5,1,238795,238795,238796,0,1,4
68163,4,1,238799,238799,238800,0,1,3
68164,3,1,238802,238802,238803,0,1,2
68165,5,1,238807,238807,238808,0,1,4
68166,3,1,238810,238810,238811,0,1,2
68167,1,1,238811,238811,238812,0,1,0
68168,5,1,238816,238816,238817,0,1,4
68169,6,3,238822,238822,238825,0,3,5
68170,3,3,238825,238825,238828,0,3,0
68171,3,1,238828,238828,238829,0,1,0
68172,5,3,238833,238833,238836,0,3,4
68173,3,1,238836,238836,238837,0,1,0
68174,5,1,238841,238841,238842,0,1,4
68175,1,2,238842,238842,238844,0,2,0
68176,6,2,238848,238848,238850,0,2,4
68177,3,1,238851,238851,238852,0,1,1
68178,4,2,238855,238855,238857,0,2,3
68179,4,2,238859,238859,238861,0,2,2
68180,1,1,238860,238861,238862,1,2,0
68181,3,3,238863,238863,238866,0,3,1
68182,4,2,238867,238867,238869,0,2,1
68183,3,2,238870,238870,238872,0,2,1
68184,2,2,238872,238872,238874,0,2,0
68185,2,3,238874,238874,238877,0,3,0
68186,4,1,238878,238878,238879,0,1,1
68187,6,2,238884,238884,238886,0,2,5
68188,4,3,238888,238888,238891,0,3,2
68189,5,3,238893,238893,238896,0,3,2
68190,3,3,238896,238896,238899,0,3,0
68191,2,3,238898,238899,238902,1,4,0
68192,3,3,238901,238902,238905,1,4,0
68193,5,1,238906,238906,238907,0,1,1
68194,1,1,238907,238907,238908,0,1,0
68195,2,2,238909,238909,238911,0,2,1
68196,5,3,238914,238914,238917,0,3,3
68197,5,3,238919,238919,238922,0,3,2
68198,5,1,238924,238924,238925,0,1,2
68199,3,1,238927,238927,238928,0,1,2
68200,5,1,238932,238932,238933,0,1,4
68201,1,3,238933,238933,238936,0,3,0
68202,5,1,238938,238938,238939,0,1,2
68203,3,1,238941,238941,238942,0,1,2
68204,6,3,238947,238947,238950,0,3,5
68205,5,1,238952,238952,238953,0,1,2
68206,5,3,238957,238957,238960,0,3,4
68207,3,1,238960,238960,238961,0,1,0
68208,5,2,238965,238965,238967,0,2,4
68209,5,1,238970,238970,238971,0,1,3
68210,4,1,238974,238974,238975,0,1,3
68211,6,1,238980,238980,238981,0,1,5
68212,4,1,238984,238984,238985,0,1,3
68213,1,1,238985,238985,238986,0,1,0
68214,1,3,238986,238986,238989,0,3,0
68215,5,1,238991,238991,238992,0,1,2
68216,4,3,238995,238995,238998,0,3,3
68217,1,1,238996,238998,238999,2,3,0
68218,5,2,239001,239001,239003,0,2,2
68219,2,1,239003,239003,239004,0,1,0
68220,3,2,239006,239006,239008,0,2,2
68221,5,1,239011,239011,239012,0,1,3
68222,1,3,239012,239012,239015,0,3,0
68223,5,2,239017,239017,239019,0,2,2
68224,2,1,239019,239019,239020,0,1,0
68225,2,2,239021,239021,239023,0,2,1
68226,6,1,239027,239027,239028,0,1,4
68227,3,2,239030,239030,239032,0,2,2
68228,5,2,239035,239035,239037,0,2,3
68229,3,2,239038,239038,239040,0,2,1
68230,3,1,239041,239041,239042,0,1,1
68231,3,2,239044,239044,239046,0,2,2
68232,1,2,239045,239046,239048,1,3,0
68233,3,3,239048,239048,239051,0,3,0
68234,5,1,239053,239053,239054,0,1,2
68235,5,2,239058,239058,239060,0,2,4
68236,3,1,239061,239061,239062,0,1,1
68237,6,3,239067,239067,239070,0,3,5
68238,1,1,239068,239070,239071,2,3,0
68239,4,1,239072,239072,239073,0,1,1
68240,5,2,239077,239077,239079,0,2,4
68241,6,1,239083,239083,239084,0,1,4
68242,6,1,239089,239089,239090,0,1,5
68243,1,2,239090,239090,239092,0,2,0
68244,6,1,239096,239096,239097,0,1,4
68245,6,2,239102,239102,239104,0,2,5
68246,6,2,239108,239108,239110,0,2,4
68247,2,3,239110,239110,239113,0,3,0
68248,4,2,239114,239114,239116,0,2,1
68249,2,2,239116,239116,239118,0,2,0
68250,6,1,239122,239122,239123,0,1,4
68251,2,2,239124,239124,239126,0,2,1
68252,4,1,239128,239128,239129,0,1,2
68253,4,1,239132,239132,239133,0,1,3
68254,5,2,239137,239137,239139,0,2,4
68255,3,3,239140,239140,239143,0,3,1
68256,4,3,239144,239144,239147,0,3,1
68257,1,2,239145,239147,239149,2,4,0
68258,5,2,239150,239150,239152,0,2,1
68259,1,2,239151,239152,239154,1,3,0
68260,6,3,239157,239157,239160,0,3,3
68261,4,3,239161,239161,239164,0,3,1
68262,2,3,239163,239164,239167,1,4,0
68263,4,3,239167,239167,239170,0,3,0
68264,6,1,239173,239173,239174,0,1,3
68265,6,2,239179,239179,239181,0,2,5
68266,5,2,239184,239184,239186,0,2,3
68267,1,3,239185,239186,239189,1,4,0
68268,4,1,239189,239189,239190,0,1,0
68269,5,3,239194,239194,239197,0,3,4
68270,4,3,239198,239198,239201,0,3,1
68271,1,2,239199,239201,239203,2,4,0
68272,1,3,239200,239203,239206,3,6,0
68273,5,2,239205,239206,239208,1,3,0
68274,5,2,239210,239210,239212,0,2,2
68275,1,1,239211,239212,239213,1,2,0
68276,1,1,239212,239213,239214,1,2,0
68277,1,1,239213,239214,239215,1,2,0
68278,4,2,239217,239217,239219,0,2,2
68279,3,2,239220,239220,239222,0,2,1
68280,5,1,239225,239225,239226,0,1,3
68281,3,1,239228,239228,239229,0,1,2
68282,4,3,239232,239232,239235,0,3,3
68283,3,2,239235,239235,239237,0,2,0
68284,1,2,239236,239237,239239,1,3,0
68285,5,2,239241,239241,239243,0,2,2
68286,4,1,239245,239245,239246,0,1,2
68287,1,3,239246,239246,239249,0,3,0
68288,6,3,239252,239252,239255,0,3,3
68289,2,2,239254,239255,239257,1,3,0
68290,5,2,239259,239259,239261,0,2,2
68291,3,3,239262,239262,239265,0,3,1
68292,6,3,239268,239268,239271,0,3,3
68293,5,3,239273,239273,239276,0,3,2
68294,3,3,239276,239276,239279,0,3,0
68295,5,3,239281,239281,239284,0,3,2
68296,2,2,239283,239284,239286,1,3,0
68297,4,3,239287,239287,239290,0,3,1
68298,2,1,239289,239290,239291,1,2,0
68299,2,3,239291,239291,239294,0,3,0
68300,6,3,239297,239297,239300,0,3,3
68301,2,3,239299,239300,239303,1,4,0
68302,1,2,239300,239303,239305,3,5,0
68303,5,1,239305,239305,239306,0,1,0
68304,5,3,239310,239310,239313,0,3,4
68305,3,1,239313,239313,239314,0,1,0
68306,4,2,239317,239317,239319,0,2,3
68307,1,2,239318,239319,239321,1,3,0
68308,6,3,239324,239324,239327,0,3,3
68309,4,1,239328,239328,239329,0,1,1
68310,6,2,239334,239334,239336,0,2,5
68311,4,1,239338,239338,239339,0,1,2
68312,3,3,239341,239341,239344,0,3,2
68313,2,1,239343,239344,239345,1,2,0
68314,2,3,239345,239345,239348,0,3,0
68315,3,1,239348,239348,239349,0,1,0
68316,1,3,239349,239349,239352,0,3,0
68317,6,2,239355,239355,239357,0,2,3
68318,1,1,239356,239357,239358,1,2,0
68319,3,3,239359,239359,239362,0,3,1
68320,4,1,239363,239363,239364,0,1,1
68321,2,2,239365,239365,239367,0,2,1
68322,6,2,239371,239371,239373,0,2,4
68323,4,3,239375,239375,239378,0,3,2
68324,5,3,239380,239380,239383,0,3,2
68325,6,2,239386,239386,239388,0,2,3
68326,3,3,239389,239389,239392,0,3,1
68327,1,2,239390,239392,239394,2,4,0
68328,1,1,239391,239394,239395,3,4,0
68329,2,3,239393,239395,239398,2,5,0
68330,2,3,239395,239398,239401,3,6,0
68331,6,3,239401,239401,239404,0,3,0
68332,4,2,239405,239405,239407,0,2,1
68333,2,3,239407,239407,239410,0,3,0
68334,3,2,239410,239410,239412,0,2,0
68335,2,3,239412,239412,239415,0,3,0
68336,1,1,239413,239415,239416,2,3,0
68337,5,2,239418,239418,239420,0,2,2
68338,5,3,239423,239423,239426,0,3,3
68339,4,3,239427,239427,239430,0,3,1
68340,2,3,239429,239430,239433,1,4,0
68341,1,3,239430,239433,239436,3,6,0
68342,3,1,239433,239436,239437,3,4,0
68343,3,2,239436,239437,239439,1,3,0
68344,4,2,239440,239440,239442,0,2,1
68345,1,2,239441,239442,239444,1,3,0
68346,3,2,239444,239444,239446,0,2,0
68347,5,2,239449,239449,239451,0,2,3
68348,2,3,239451,239451,239454,0,3,0
68349,6,3,239457,239457,239460,0,3,3
68350,1,2,239458,239460,239462,2,4,0
68351,6,1,239464,239464,239465,0,1,2
68352,3,1,239467,239467,239468,0,1,2
68353,3,1,239470,239470,239471,0,1,2
68354,4,3,239474,239474,239477,0,3,3
68355,1,1,239475,239477,239478,2,3,0
68356,5,1,239480,239480,239481,0,1,2
68357,3,1,239483,239483,239484,0,1,2
68358,2,3,239485,239485,239488,0,3,1
68359,5,3,239490,239490,239493,0,3,2
68360,6,3,239496,239496,239499,0,3,3
68361,1,1,239497,239499,239500,2,3,0
68362,2,2,239499,239500,239502,1,3,0
68363,5,1,239504,239504,239505,0,1,2
68364,1,2,239505,239505,239507,0,2,0
68365,3,3,239508,239508,239511,0,3,1
68366,3,1,239511,239511,239512,0,1,0
68367,3,1,239514,239514,239515,0,1,2
68368,5,1,239519,239519,239520,0,1,4
68369,1,1,239520,239520,239521,0,1,0
68370,5,3,239525,239525,239528,0,3,4
68371,1,2,239526,239528,239530,2,4,0
68372,3,3,239529,239530,239533,1,4,0
68373,6,1,239535,239535,239536,0,1,2
68374,4,1,239539,239539,239540,0,1,3
68375,5,2,239544,239544,239546,0,2,4
68376,3,2,239547,239547,239549,0,2,1
68377,5,2,239552,239552,239554,0,2,3
68378,3,3,239555,239555,239558,0,3,1
68379,4,1,239559,239559,239560,0,1,1
68380,4,3,239563,239563,239566,0,3,3
68381,3,3,239566,239566,239569,0,3,0
68382,5,2,239571,239571,239573,0,2,2
68383,5,1,239576,239576,239577,0,1,3
68384,3,1,239579,239579,239580,0,1,2
68385,5,2,239584,239584,239586,0,2,4
68386,1,3,239585,239586,239589,1,4,0
68387,5,3,239590,239590,239593,0,3,1
68388,2,2,239592,239593,239595,1,3,0
68389,2,1,239594,239595,239596,1,2,0
68390,1,3,239595,239596,239599,1,4,0
68391,5,3,239600,239600,239603,0,3,1
68392,5,2,239605,239605,239607,0,2,2
68393,6,2,239611,239611,239613,0,2,4
68394,1,1,239612,239613,239614,1,2,0
68395,4,2,239616,239616,239618,0,2,2
68396,2,3,239618,239618,239621,0,3,0
68397,5,2,239623,239623,239625,0,2,2
68398,4,3,239627,239627,239630,0,3,2
68399,4,1,239631,239631,239632,0,1,1
68400,5,1,239636,239636,239637,0,1,4
68401,6,3,239642,239642,239645,0,3,5
68402,3,1,239645,239645,239646,0,1,0
68403,6,1,239651,239651,239652,0,1,5
68404,2,3,239653,239653,239656,0,3,1
68405,1,2,239654,239656,239658,2,4,0
68406,4,3,239658,239658,239661,0,3,0
68407,3,1,239661,239661,239662,0,1,0
68408,6,1,239667,239667,239668,0,1,5
68409,4,2,239671,239671,239673,0,2,3
68410,5,3,239676,239676,239679,0,3,3
68411,4,2,239680,239680,239682,0,2,1
68412,3,2,239683,239683,239685,0,2,1
68413,1,3,239684,239685,239688,1,4,0
68414,6,1,239690,239690,239691,0,1,2
68415,3,2,239693,239693,239695,0,2,2
68416,4,2,239697,239697,239699,0,2,2
68417,6,2,239703,239703,239705,0,2,4
68418,4,2,239707,239707,239709,0,2,2
68419,6,2,239713,239713,239715,0,2,4
68420,1,3,239714,239715,239718,1,4,0
68421,5,2,239719,239719,239721,0,2,1
68422,4,2,239723,239723,239725,0,2,2
68423,6,2,239729,239729,239731,0,2,4
68424,5,3,239734,239734,239737,0,3,3
68425,6,2,239740,239740,239742,0,2,3
68426,5,3,239745,239745,239748,0,3,3
68427,2,2,239747,239748,239750,1,3,0
68428,6,1,239753,239753,239754,0,1,3
68429,3,2,239756,239756,239758,0,2,2
68430,1,3,239757,239758,239761,1,4,0
68431,5,2,239762,239762,239764,0,2,1
68432,6,3,239768,239768,239771,0,3,4
68433,1,2,239769,239771,239773,2,4,0
68434,4,2,239773,239773,239775,0,2,0
68435,5,1,239778,239778,239779,0,1,3
68436,6,1,239784,239784,239785,0,1,5
68437,5,1,239789,239789,239790,0,1,4
68438,2,2,239791,239791,239793,0,2,1
68439,2,2,239793,239793,239795,0,2,0
68440,5,3,239798,239798,239801,0,3,3
68441,3,1,239801,239801,239802,0,1,0
68442,2,2,239803,239803,239805,0,2,1
68443,3,2,239806,239806,239808,0,2,1
68444,2,3,239808,239808,239811,0,3,0
68445,1,1,239809,239811,239812,2,3,0
68446,6,3,239815,239815,239818,0,3,3
68447,4,1,239819,239819,239820,0,1,1
68448,2,2,239821,239821,239823,0,2,1
68449,5,2,239826,239826,239828,0,2,3
68450,5,1,239831,239831,239832,0,1,3
68451,1,1,239832,239832,239833,0,1,0
68452,4,3,239836,239836,239839,0,3,3
68453,3,3,239839,239839,239842,0,3,0
68454,3,1,239842,239842,239843,0,1,0
68455,5,1,239847,239847,239848,0,1,4
68456,4,1,239851,239851,239852,0,1,3
68457,2,1,239853,239853,239854,0,1,1
68458,3,2,239856,239856,239858,0,2,2
68459,6,3,239862,239862,239865,0,3,4
68460,3,3,239865,239865,239868,0,3,0
68461,1,2,239866,239868,239870,2,4,0
68462,2,3,239868,239870,239873,2,5,0
68463,2,2,239870,239873,239875,3,5,0
68464,4,3,239874,239875,239878,1,4,0
68465,3,1,239877,239878,239879,1,2,0
68466,4,3,239881,239881,239884,0,3,2
68467,2,3,239883,239884,239887,1,4,0
68468,5,2,239888,239888,239890,0,2,1
68469,2,2,239890,239890,239892,0,2,0
68470,6,2,239896,239896,239898,0,2,4
68471,6,3,239902,239902,239905,0,3,4
68472,5,1,239907,239907,239908,0,1,2
68473,4,3,239911,239911,239914,0,3,3
68474,6,3,239917,239917,239920,0,3,3
68475,5,3,239922,239922,239925,0,3,2
68476,2,2,239924,239925,239927,1,3,0
68477,1,3,239925,239927,239930,2,5,0
68478,1,3,239926,239930,239933,4,7,0
68479,3,1,239929,239933,239934,4,5,0
68480,6,2,239935,239935,239937,0,2,1
68481,2,1,239937,239937,239938,0,1,0
68482,5,3,239942,239942,239945,0,3,4
68483,4,2,239946,239946,239948,0,2,1
68484,1,1,239947,239948,239949,1,2,0
68485,5,2,239952,239952,239954,0,2,3
68486,4,2,239956,239956,239958,0,2,2
68487,4,2,239960,239960,239962,0,2,2
68488,1,1,239961,239962,239963,1,2,0
68489,6,3,239967,239967,239970,0,3,4
68490,3,1,239970,239970,239971,0,1,0
68491,3,1,239973,239973,239974,0,1,2
68492,1,3,239974,239974,239977,0,3,0
68493,1,3,239975,239977,239980,2,5,0
68494,4,2,239979,239980,239982,1,3,0
68495,3,1,239982,239982,239983,0,1,0
68496,4,3,239986,239986,239989,0,3,3
68497,1,1,239987,239989,239990,2,3,0
68498,5,3,239992,239992,239995,0,3,2
68499,2,2,239994,239995,239997,1,3,0
68500,2,1,239996,239997,239998,1,2,0
68501,3,3,239999,239999,240002,0,3,1
68502,3,2,240002,240002,240004,0,2,0
68503,3,2,240005,240005,240007,0,2,1
68504,4,3,240009,240009,240012,0,3,2
68505,3,3,240012,240012,240015,0,3,0
68506,5,2,240017,240017,240019,0,2,2
68507,4,2,240021,240021,240023,0,2,2
68508,2,1,240023,240023,240024,0,1,0
68509,4,1,240027,240027,240028,0,1,3
68510,6,2,240033,240033,240035,0,2,5
68511,4,3,240037,240037,240040,0,3,2
68512,5,1,240042,240042,240043,0,1,2
68513,4,3,240046,240046,240049,0,3,3
68514,1,1,240047,240049,240050,2,3,0
68515,5,3,240052,240052,240055,0,3,2
68516,3,3,240055,240055,240058,0,3,0
68517,2,3,240057,240058,240061,1,4,0
68518,4,1,240061,240061,240062,0,1,0
68519,2,1,240063,240063,240064,0,1,1
68520,1,1,240064,240064,240065,0,1,0
68521,6,1,240070,240070,240071,0,1,5
68522,4,1,240074,240074,240075,0,1,3
68523,1,3,240075,240075,240078,0,3,0
68524,3,1,240078,240078,240079,0,1,0
68525,6,3,240084,240084,240087,0,3,5
68526,2,2,240086,240087,240089,1,3,0
68527,1,2,240087,240089,240091,2,4,0
68528,6,1,240093,240093,240094,0,1,2
68529,2,2,240095,240095,240097,0,2,1
68530,5,1,240100,240100,240101,0,1,3
68531,4,2,240104,240104,240106,0,2,3
68532,6,1,240110,240110,240111,0,1,4
68533,2,1,240112,240112,240113,0,1,1
68534,1,3,240113,240113,240116,0,3,0
68535,5,3,240118,240118,240121,0,3,2
68536,4,1,240122,240122,240123,0,1,1
68537,3,2,240125,240125,240127,0,2,2
68538,2,3,240127,240127,240130,0,3,0
68539,3,2,240130,240130,240132,0,2,0
68540,4,2,240134,240134,240136,0,2,2
68541,3,3,240137,240137,240140,0,3,1
68542,2,2,240139,240140,240142,1,3,0
68543,3,1,240142,240142,240143,0,1,0
68544,1,3,240143,240143,240146,0,3,0
68545,2,1,240145,240146,240147,1,2,0
68546,3,1,240148,240148,240149,0,1,1
68547,5,2,240153,240153,240155,0,2,4
68548,3,2,240156,240156,240158,0,2,1
68549,2,1,240158,240158,240159,0,1,0
68550,1,1,240159,240159,240160,0,1,0
68551,5,3,240164,240164,240167,0,3,4
68552,1,2,240165,240167,240169,2,4,0
68553,1,3,240166,240169,240172,3,6,0
68554,3,2,240169,240172,240174,3,5,0
68555,4,3,240173,240174,240177,1,4,0
68556,6,2,240179,240179,240181,0,2,2
68557,3,2,240182,240182,240184,0,2,1
68558,4,1,240186,240186,240187,0,1,2
68559,4,2,240190,240190,240192,0,2,3
68560,1,1,240191,240192,240193,1,2,0
68561,4,2,240195,240195,240197,0,2,2
68562,1,3,240196,240197,240200,1,4,0
68563,4,1,240200,240200,240201,0,1,0
68564,4,1,240204,240204,240205,0,1,3
68565,5,1,240209,240209,240210,0,1,4
68566,4,1,240213,240213,240214,0,1,3
68567,5,1,240218,240218,240219,0,1,4
68568,1,1,240219,240219,240220,0,1,0
68569,1,3,240220,240220,240223,0,3,0
68570,2,3,240222,240223,240226,1,4,0
68571,3,3,240225,240226,240229,1,4,0
68572,4,3,240229,240229,240232,0,3,0
68573,6,1,240235,240235,240236,0,1,3
68574,3,3,240238,240238,240241,0,3,2
68575,5,3,240243,240243,240246,0,3,2
68576,6,2,240249,240249,240251,0,2,3
68577,2,3,240251,240251,240254,0,3,0
68578,1,3,240252,240254,240257,2,5,0
68579,5,1,240257,240257,240258,0,1,0
68580,5,1,240262,240262,240263,0,1,4
68581,2,2,240264,240264,240266,0,2,1
68582,5,1,240269,240269,240270,0,1,3
68583,1,2,240270,240270,240272,0,2,0
68584,3,2,240273,240273,240275,0,2,1
68585,6,1,240279,240279,240280,0,1,4
68586,3,2,240282,240282,240284,0,2,2
68587,2,3,240284,240284,240287,0,3,0
68588,5,3,240289,240289,240292,0,3,2
68589,5,3,240294,240294,240297,0,3,2
68590,3,2,240297,240297,240299,0,2,0
68591,6,2,240303,240303,240305,0,2,4
68592,3,2,240306,240306,240308,0,2,1
68593,6,3,240312,240312,240315,0,3,4
68594,2,3,240314,240315,240318,1,4,0
68595,5,3,240319,240319,240322,0,3,1
68596,3,3,240322,240322,240325,0,3,0
68597,2,2,240324,240325,240327,1,3,0
68598,1,3,240325,240327,240330,2,5,0
68599,4,2,240329,240330,240332,1,3,0
68600,2,2,240331,240332,240334,1,3,0
68601,4,3,240335,240335,240338,0,3,1
68602,4,2,240339,240339,240341,0,2,1
68603,6,1,240345,240345,240346,0,1,4
68604,3,2,240348,240348,240350,0,2,2
68605,6,1,240354,240354,240355,0,1,4
68606,5,3,240359,240359,240362,0,3,4
68607,4,2,240363,240363,240365,0,2,1
68608,6,3,240369,240369,240372,0,3,4
68609,1,3,240370,240372,240375,2,5,0
68610,2,3,240372,240375,240378,3,6,0
68611,4,2,240376,240378,240380,2,4,0
68612,5,1,240381,240381,240382,0,1,1
68613,5,1,240386,240386,240387,0,1,4
68614,6,2,240392,240392,240394,0,2,5
68615,4,3,240396,240396,240399,0,3,2
68616,5,2,240401,240401,240403,0,2,2
68617,3,2,240404,240404,240406,0,2,1
68618,3,1,240407,240407,240408,0,1,1
68619,4,2,240411,240411,240413,0,2,3
68620,1,2,240412,240413,240415,1,3,0
68621,2,1,240414,240415,240416,1,2,0
68622,3,3,240417,240417,240420,0,3,1
68623,5,2,240422,240422,240424,0,2,2
68624,5,2,240427,240427,240429,0,2,3
68625,1,2,240428,240429,240431,1,3,0
68626,4,2,240432,240432,240434,0,2,1
68627,2,2,240434,240434,240436,0,2,0
68628,1,1,240435,240436,240437,1,2,0
68629,4,3,240439,240439,240442,0,3,2
68630,6,2,240445,240445,240447,0,2,3
68631,6,3,240451,240451,240454,0,3,4
68632,1,1,240452,240454,240455,2,3,0
68633,1,3,240453,240455,240458,2,5,0
68634,1,3,240454,240458,240461,4,7,0
68635,6,3,240460,240461,240464,1,4,0
68636,1,3,240461,240464,240467,3,6,0
68637,3,1,240464,240467,240468,3,4,0
68638,5,2,240469,240469,240471,0,2,1
68639,1,3,240470,240471,240474,1,4,0
68640,6,3,240476,240476,240479,0,3,2
68641,3,3,240479,240479,240482,0,3,0
68642,4,1,240483,240483,240484,0,1,1
68643,5,2,240488,240488,240490,0,2,4
68644,3,2,240491,240491,240493,0,2,1
68645,2,1,240493,240493,240494,0,1,0
68646,6,1,240499,240499,240500,0,1,5
68647,6,3,240505,240505,240508,0,3,5
68648,5,1,240510,240510,240511,0,1,2
68649,3,2,240513,240513,240515,0,2,2
68650,6,3,240519,240519,240522,0,3,4
68651,6,1,240525,240525,240526,0,1,3
68652,2,1,240527,240527,240528,0,1,1
68653,2,1,240529,240529,240530,0,1,1
68654,3,3,240532,240532,240535,0,3,2
68655,6,1,240538,240538,240539,0,1,3
68656,3,2,240541,240541,240543,0,2,2
68657,3,1,240544,240544,240545,0,1,1
68658,4,3,240548,240548,240551,0,3,3
68659,2,1,240550,240551,240552,1,2,0
68660,6,3,240556,240556,240559,0,3,4
68661,3,1,240559,240559,240560,0,1,0
68662,1,3,240560,240560,240563,0,3,0
68663,3,2,240563,240563,240565,0,2,0
68664,6,3,240569,240569,240572,0,3,4
68665,4,1,240573,240573,240574,0,1,1
68666,3,1,240576,240576,240577,0,1,2
68667,1,1,240577,240577,240578,0,1,0
68668,6,1,240583,240583,240584,0,1,5
68669,6,1,240589,240589,240590,0,1,5
68670,6,2,240595,240595,240597,0,2,5
68671,3,3,240598,240598,240601,0,3,1
68672,1,2,240599,240601,240603,2,4,0
68673,4,1,240603,240603,240604,0,1,0
68674,5,3,240608,240608,240611,0,3,4
68675,5,2,240613,240613,240615,0,2,2
68676,4,3,240617,240617,240620,0,3,2
68677,6,1,240623,240623,240624,0,1,3
68678,2,2,240625,240625,240627,0,2,1
68679,5,2,240630,240630,240632,0,2,3
68680,3,2,240633,240633,240635,0,2,1
68681,6,1,240639,240639,240640,0,1,4
68682,6,2,240645,240645,240647,0,2,5
68683,4,1,240649,240649,240650,0,1,2
68684,6,2,240655,240655,240657,0,2,5
68685,4,3,240659,240659,240662,0,3,2
68686,6,2,240665,240665,240667,0,2,3
68687,3,1,240668,240668,240669,0,1,1
68688,6,2,240674,240674,240676,0,2,5
68689,5,1,240679,240679,240680,0,1,3
68690,5,3,240684,240684,240687,0,3,4
68691,5,2,240689,240689,240691,0,2,2
68692,3,2,240692,240692,240694,0,2,1
68693,3,3,240695,240695,240698,0,3,1
68694,3,2,240698,240698,240700,0,2,0
68695,5,3,240703,240703,240706,0,3,3
68696,6,2,240709,240709,240711,0,2,3
68697,1,2,240710,240711,240713,1,3,0
68698,6,3,240716,240716,240719,0,3,3
68699,3,2,240719,240719,240721,0,2,0
68700,3,1,240722,240722,240723,0,1,1
68701,2,3,240724,240724,240727,0,3,1
68702,3,3,240727,240727,240730,0,3,0
68703,2,1,240729,240730,240731,1,2,0
68704,2,1,240731,240731,240732,0,1,0
68705,5,3,240736,240736,240739,0,3,4
68706,4,3,240740,240740,240743,0,3,1
68707,4,3,240744,240744,240747,0,3,1
68708,2,2,240746,240747,240749,1,3,0
68709,1,1,240747,240749,240750,2,3,0
68710,4,2,240751,240751,240753,0,2,1
68711,4,3,240755,240755,240758,0,3,2
68712,5,2,240760,240760,240762,0,2,2
68713,3,3,240763,240763,240766,0,3,1
68714,4,1,240767,240767,240768,0,1,1
68715,3,1,240770,240770,240771,0,1,2
68716,6,2,240776,240776,240778,0,2,5
68717,4,2,240780,240780,240782,0,2,2
68718,4,3,240784,240784,240787,0,3,2
68719,5,1,240789,240789,240790,0,1,2
68720,3,3,240792,240792,240795,0,3,2
68721,2,3,240794,240795,240798,1,4,0
68722,3,1,240797,240798,240799,1,2,0
68723,5,1,240802,240802,240803,0,1,3
68724,6,3,240808,240808,240811,0,3,5
68725,6,2,240814,240814,240816,0,2,3
68726,6,2,240820,240820,240822,0,2,4
68727,3,3,240823,240823,240826,0,3,1
68728,4,2,240827,240827,240829,0,2,1
68729,2,1,240829,240829,240830,0,1,0
68730,2,2,240831,240831,240833,0,2,1
68731,6,1,240837,240837,240838,0,1,4
68732,5,3,240842,240842,240845,0,3,4
68733,5,1,240847,240847,240848,0,1,2
68734,2,3,240849,240849,240852,0,3,1
68735,2,3,240851,240852,240855,1,4,0
68736,1,3,240852,240855,240858,3,6,0
68737,6,2,240858,240858,240860,0,2,0
68738,6,1,240864,240864,240865,0,1,4
68739,6,2,240870,240870,240872,0,2,5
68740,2,2,240872,240872,240874,0,2,0
68741,4,3,240876,240876,240879,0,3,2
68742,3,3,240879,240879,240882,0,3,0
68743,6,2,240885,240885,240887,0,2,3
68744,4,1,240889,240889,240890,0,1,2
68745,5,3,240894,240894,240897,0,3,4
68746,1,3,240895,240897,240900,2,5,0
68747,1,2,240896,240900,240902,4,6,0
68748,2,3,240898,240902,240905,4,7,0
68749,6,3,240904,240905,240908,1,4,0
68750,5,2,240909,240909,240911,0,2,1
68751,5,1,240914,240914,240915,0,1,3
68752,3,3,240917,240917,240920,0,3,2
68753,3,3,240920,240920,240923,0,3,0
68754,3,1,240923,240923,240924,0,1,0
68755,6,2,240929,240929,240931,0,2,5
68756,6,3,240935,240935,240938,0,3,4
68757,6,2,240941,240941,240943,0,2,3
68758,6,2,240947,240947,240949,0,2,4
68759,5,3,240952,240952,240955,0,3,3
68760,6,1,240958,240958,240959,0,1,3
68761,2,1,240960,240960,240961,0,1,1
68762,5,3,240965,240965,240968,0,3,4
68763,4,3,240969,240969,240972,0,3,1
68764,3,1,240972,240972,240973,0,1,0
68765,4,1,240976,240976,240977,0,1,3
68766,1,1,240977,240977,240978,0,1,0
68767,5,2,240982,240982,240984,0,2,4
68768,6,1,240988,240988,240989,0,1,4
68769,6,1,240994,240994,240995,0,1,5
68770,1,1,240995,240995,240996,0,1,0
68771,3,3,240998,240998,241001,0,3,2
68772,2,3,241000,241001,241004,1,4,0
68773,1,2,241001,241004,241006,3,5,0
68774,2,2,241003,241006,241008,3,5,0
68775,2,1,241005,241008,241009,3,4,0
68776,6,3,241011,241011,241014,0,3,2
68777,2,3,241013,241014,241017,1,4,0
68778,6,2,241019,241019,241021,0,2,2
68779,1,1,241020,241021,241022,1,2,0
68780,2,3,241022,241022,241025,0,3,0
68781,6,1,241028,241028,241029,0,1,3
68782,1,3,241029,241029,241032,0,3,0
68783,1,3,241030,241032,241035,2,5,0
68784,6,3,241036,241036,241039,0,3,1
68785,6,1,241042,241042,241043,0,1,3
68786,5,1,241047,241047,241048,0,1,4
68787,1,2,241048,241048,241050,0,2,0
68788,1,1,241049,241050,241051,1,2,0
68789,2,3,241051,241051,241054,0,3,0
68790,3,1,241054,241054,241055,0,1,0
68791,1,2,241055,241055,241057,0,2,0
68792,6,1,241061,241061,241062,0,1,4
68793,1,2,241062,241062,241064,0,2,0
68794,3,3,241065,241065,241068,0,3,1
68795,5,3,241070,241070,241073,0,3,2
68796,6,1,241076,241076,241077,0,1,3
68797,1,1,241077,241077,241078,0,1,0
68798,3,2,241080,241080,241082,0,2,2
68799,1,3,241081,241082,241085,1,4,0
68800,4,3,241085,241085,241088,0,3,0
68801,6,3,241091,241091,241094,0,3,3
68802,5,2,241096,241096,241098,0,2,2
68803,6,1,241102,241102,241103,0,1,4
68804,3,3,241105,241105,241108,0,3,2
68805,5,1,241110,241110,241111,0,1,2
68806,2,1,241112,241112,241113,0,1,1
68807,5,2,241117,241117,241119,0,2,4
68808,2,1,241119,241119,241120,0,1,0
68809,3,2,241122,241122,241124,0,2,2
68810,6,3,241128,241128,241131,0,3,4
68811,5,2,241133,241133,241135,0,2,2
68812,4,3,241137,241137,241140,0,3,2
68813,2,2,241139,241140,241142,1,3,0
68814,2,3,241141,241142,241145,1,4,0
68815,1,2,241142,241145,241147,3,5,0
68816,1,3,241143,241147,241150,4,7,0
68817,4,2,241147,241150,241152,3,5,0
68818,3,1,241150,241152,241153,2,3,0
68819,4,2,241154,241154,241156,0,2,1
68820,3,1,241157,241157,241158,0,1,1
68821,4,1,241161,241161,241162,0,1,3
68822,5,2,241166,241166,241168,0,2,4
68823,3,1,241169,241169,241170,0,1,1
68824,6,2,241175,241175,241177,0,2,5
68825,3,2,241178,241178,241180,0,2,1
68826,5,3,241183,241183,241186,0,3,3
68827,2,1,241185,241186,241187,1,2,0
68828,5,2,241190,241190,241192,0,2,3
68829,6,1,241196,241196,241197,0,1,4
68830,3,1,241199,241199,241200,0,1,2
68831,1,2,241200,241200,241202,0,2,0
68832,6,2,241206,241206,241208,0,2,4
68833,4,2,241210,241210,241212,0,2,2
68834,6,3,241216,241216,241219,0,3,4
68835,3,3,241219,241219,241222,0,3,0
68836,6,2,241225,241225,241227,0,2,3
68837,5,1,241230,241230,241231,0,1,3
68838,1,1,241231,241231,241232,0,1,0
68839,6,3,241237,241237,241240,0,3,5
68840,1,2,241238,241240,241242,2,4,0
68841,1,1,241239,241242,241243,3,4,0
68842,3,2,241242,241243,241245,1,3,0
68843,3,3,241245,241245,241248,0,3,0
68844,4,1,241249,241249,241250,0,1,1
68845,3,2,241252,241252,241254,0,2,2
68846,3,2,241255,241255,241257,0,2,1
68847,3,2,241258,241258,241260,0,2,1
68848,2,1,241260,241260,241261,0,1,0
68849,3,3,241263,241263,241266,0,3,2
68850,5,1,241268,241268,241269,0,1,2
68851,5,2,241273,241273,241275,0,2,4
68852,5,3,241278,241278,241281,0,3,3
68853,4,1,241282,241282,241283,0,1,1
68854,3,1,241285,241285,241286,0,1,2
68855,3,2,241288,241288,241290,0,2,2
68856,4,3,241292,241292,241295,0,3,2
68857,5,2,241297,241297,241299,0,2,2
68858,1,2,241298,241299,241301,1,3,0
68859,2,3,241300,241301,241304,1,4,0
68860,3,2,241303,241304,241306,1,3,0
68861,1,2,241304,241306,241308,2,4,0
68862,3,1,241307,241308,241309,1,2,0
68863,5,3,241312,241312,241315,0,3,3
68864,6,3,241318,241318,241321,0,3,3
68865,4,3,241322,241322,241325,0,3,1
68866,5,2,241327,241327,241329,0,2,2
68867,1,2,241328,241329,241331,1,3,0
68868,6,1,241334,241334,241335,0,1,3
68869,5,2,241339,241339,241341,0,2,4
68870,2,1,241341,241341,241342,0,1,0
68871,5,2,241346,241346,241348,0,2,4
68872,5,3,241351,241351,241354,0,3,3
68873,5,3,241356,241356,241359,0,3,2
68874,5,1,241361,241361,241362,0,1,2
68875,5,2,241366,241366,241368,0,2,4
68876,1,3,241367,241368,241371,1,4,0
68877,6,2,241373,241373,241375,0,2,2
68878,1,3,241374,241375,241378,1,4,0
68879,3,1,241377,241378,241379,1,2,0
68880,5,3,241382,241382,241385,0,3,3
68881,6,2,241388,241388,241390,0,2,3
68882,1,3,241389,241390,241393,1,4,0
68883,1,3,241390,241393,241396,3,6,0
68884,3,3,241393,241396,241399,3,6,0
68885,5,2,241398,241399,241401,1,3,0
68886,1,1,241399,241401,241402,2,3,0
68887,4,3,241403,241403,241406,0,3,1
68888,3,3,241406,241406,241409,0,3,0
68889,6,3,241412,241412,241415,0,3,3
68890,1,3,241413,241415,241418,2,5,0
68891,2,1,241415,241418,241419,3,4,0
68892,5,2,241420,241420,241422,0,2,1
68893,4,2,241424,241424,241426,0,2,2
68894,2,2,241426,241426,241428,0,2,0
68895,4,1,241430,241430,241431,0,1,2
68896,3,1,241433,241433,241434,0,1,2
68897,6,3,241439,241439,241442,0,3,5
68898,6,1,241445,241445,241446,0,1,3
68899,6,2,241451,241451,241453,0,2,5
68900,6,2,241457,241457,241459,0,2,4
68901,6,1,241463,241463,241464,0,1,4
68902,5,2,241468,241468,241470,0,2,4
68903,6,1,241474,241474,241475,0,1,4
68904,2,3,241476,241476,241479,0,3,1
68905,4,1,241480,241480,241481,0,1,1
68906,5,2,241485,241485,241487,0,2,4
68907,5,2,241490,241490,241492,0,2,3
68908,3,3,241493,241493,241496,0,3,1
68909,4,1,241497,241497,241498,0,1,1
68910,4,3,241501,241501,241504,0,3,3
68911,4,2,241505,241505,241507,0,2,1
68912,3,3,241508,241508,241511,0,3,1
68913,5,2,241513,241513,241515,0,2,2
68914,4,1,241517,241517,241518,0,1,2
68915,1,3,241518,241518,241521,0,3,0
68916,4,1,241522,241522,241523,0,1,1
68917,1,1,241523,241523,241524,0,1,0
68918,6,1,241529,241529,241530,0,1,5
68919,5,2,241534,241534,241536,0,2,4
68920,3,2,241537,241537,241539,0,2,1
68921,5,2,241542,241542,241544,0,2,3
68922,2,3,241544,241544,241547,0,3,0
68923,3,2,241547,241547,241549,0,2,0
68924,4,3,241551,241551,241554,0,3,2
68925,1,2,241552,241554,241556,2,4,0
68926,3,3,241555,241556,241559,1,4,0
68927,5,3,241560,241560,241563,0,3,1
68928,2,2,241562,241563,241565,1,3,0
68929,1,3,241563,241565,241568,2,5,0
68930,6,2,241569,241569,241571,0,2,1
68931,2,3,241571,241571,241574,0,3,0
68932,2,2,241573,241574,241576,1,3,0
68933,3,3,241576,241576,241579,0,3,0
68934,3,2,241579,241579,241581,0,2,0
68935,3,1,241582,241582,241583,0,1,1
68936,4,3,241586,241586,241589,0,3,3
68937,4,1,241590,241590,241591,0,1,1
68938,3,2,241593,241593,241595,0,2,2
68939,2,2,241595,241595,241597,0,2,0
68940,3,3,241598,241598,241601,0,3,1
68941,4,1,241602,241602,241603,0,1,1
68942,5,2,241607,241607,241609,0,2,4
68943,1,2,241608,241609,241611,1,3,0
68944,2,1,241610,241611,241612,1,2,0
68945,1,1,241611,241612,241613,1,2,0
68946,3,3,241614,241614,241617,0,3,1
68947,1,1,241615,241617,241618,2,3,0
68948,6,1,241621,241621,241622,0,1,3
68949,1,1,241622,241622,241623,0,1,0
68950,6,3,241628,241628,241631,0,3,5
68951,3,3,241631,241631,241634,0,3,0
68952,3,1,241634,241634,241635,0,1,0
68953,4,2,241638,241638,241640,0,2,3
68954,6,1,241644,241644,241645,0,1,4
68955,3,2,241647,241647,241649,0,2,2
68956,3,1,241650,241650,241651,0,1,1
68957,2,3,241652,241652,241655,0,3,1
68958,5,2,241657,241657,241659,0,2,2
68959,6,3,241663,241663,241666,0,3,4
68960,4,2,241667,241667,241669,0,2,1
68961,3,2,241670,241670,241672,0,2,1
68962,3,3,241673,241673,241676,0,3,1
68963,4,3,241677,241677,241680,0,3,1
68964,2,1,241679,241680,241681,1,2,0
68965,1,3,241680,241681,241684,1,4,0
68966,1,3,241681,241684,241687,3,6,0
68967,4,3,241685,241687,241690,2,5,0
68968,3,1,241688,241690,241691,2,3,0
68969,6,1,241694,241694,241695,0,1,3
68970,5,1,241699,241699,241700,0,1,4
68971,6,1,241705,241705,241706,0,1,5
68972,5,2,241710,241710,241712,0,2,4
68973,1,1,241711,241712,241713,1,2,0
68974,4,3,241715,241715,241718,0,3,2
68975,2,3,241717,241718,241721,1,4,0
68976,1,2,241718,241721,241723,3,5,0
68977,4,3,241722,241723,241726,1,4,0
68978,4,3,241726,241726,241729,0,3,0
68979,1,3,241727,241729,241732,2,5,0
68980,2,2,241729,241732,241734,3,5,0
68981,2,1,241731,241734,241735,3,4,0
68982,3,2,241734,241735,241737,1,3,0
68983,4,1,241738,241738,241739,0,1,1
68984,2,2,241740,241740,241742,0,2,1
68985,3,1,241743,241743,241744,0,1,1
68986,1,3,241744,241744,241747,0,3,0
68987,2,1,241746,241747,241748,1,2,0
68988,2,2,241748,241748,241750,0,2,0
68989,3,1,241751,241751,241752,0,1,1
68990,4,2,241755,241755,241757,0,2,3
68991,1,1,241756,241757,241758,1,2,0
68992,4,2,241760,241760,241762,0,2,2
68993,4,1,241764,241764,241765,0,1,2
68994,5,2,241769,241769,241771,0,2,4
68995,1,2,241770,241771,241773,1,3,0
68996,5,3,241775,241775,241778,0,3,2
68997,2,2,241777,241778,241780,1,3,0
68998,3,2,241780,241780,241782,0,2,0
68999,5,1,241785,241785,241786,0,1,3
69000,3,1,241788,241788,241789,0,1,2
69001,3,3,241791,241791,241794,0,3,2
69002,1,3,241792,241794,241797,2,5,0
69003,3,2,241795,241797,241799,2,4,0
69004,4,3,241799,241799,241802,0,3,0
69005,6,1,241805,241805,241806,0,1,3
69006,1,1,241806,241806,241807,0,1,0
69007,3,2,241809,241809,241811,0,2,2
69008,4,2,241813,241813,241815,0,2,2
69009,6,3,241819,241819,241822,0,3,4
69010,1,2,241820,241822,241824,2,4,0
69011,6,1,241826,241826,241827,0,1,2
69012,5,2,241831,241831,241833,0,2,4
69013,2,2,241833,241833,241835,0,2,0
69014,1,1,241834,241835,241836,1,2,0
69015,3,1,241837,241837,241838,0,1,1
69016,5,2,241842,241842,241844,0,2,4
69017,3,2,241845,241845,241847,0,2,1
69018,2,1,241847,241847,241848,0,1,0
69019,5,3,241852,241852,241855,0,3,4
69020,2,2,241854,241855,241857,1,3,0
69021,5,1,241859,241859,241860,0,1,2
69022,1,1,241860,241860,241861,0,1,0
69023,3,1,241863,241863,241864,0,1,2
69024,6,2,241869,241869,241871,0,2,5
69025,5,2,241874,241874,241876,0,2,3
69026,3,1,241877,241877,241878,0,1,1
69027,6,2,241883,241883,241885,0,2,5
69028,3,3,241886,241886,241889,0,3,1
69029,4,2,241890,241890,241892,0,2,1
69030,1,2,241891,241892,241894,1,3,0
69031,5,2,241896,241896,241898,0,2,2
69032,1,1,241897,241898,241899,1,2,0
69033,5,3,241902,241902,241905,0,3,3
69034,3,2,241905,241905,241907,0,2,0
69035,4,1,241909,241909,241910,0,1,2
69036,1,3,241910,241910,241913,0,3,0
69037,4,2,241914,241914,241916,0,2,1
69038,4,1,241918,241918,241919,0,1,2
69039,4,3,241922,241922,241925,0,3,3
69040,1,2,241923,241925,241927,2,4,0
69041,4,3,241927,241927,241930,0,3,0
69042,2,1,241929,241930,241931,1,2,0
69043,6,2,241935,241935,241937,0,2,4
69044,3,1,241938,241938,241939,0,1,1
69045,4,2,241942,241942,241944,0,2,3
69046,4,2,241946,241946,241948,0,2,2
69047,3,2,241949,241949,241951,0,2,1
69048,4,2,241953,241953,241955,0,2,2
69049,1,1,241954,241955,241956,1,2,0
69050,2,1,241956,241956,241957,0,1,0
69051,4,3,241960,241960,241963,0,3,3
69052,4,1,241964,241964,241965,0,1,1
69053,5,3,241969,241969,241972,0,3,4
69054,1,1,241970,241972,241973,2,3,0
69055,1,1,241971,241973,241974,2,3,0
69056,1,3,241972,241974,241977,2,5,0
69057,2,1,241974,241977,241978,3,4,0
69058,2,1,241976,241978,241979,2,3,0
69059,1,1,241977,241979,241980,2,3,0
69060,1,3,241978,241980,241983,2,5,0
69061,5,1,241983,241983,241984,0,1,0
69062,1,3,241984,241984,241987,0,3,0
69063,5,1,241989,241989,241990,0,1,2
69064,1,2,241990,241990,241992,0,2,0
69065,4,3,241994,241994,241997,0,3,2
69066,2,3,241996,241997,242000,1,4,0
69067,6,2,242002,242002,242004,0,2,2
69068,1,3,242003,242004,242007,1,4,0
69069,1,3,242004,242007,242010,3,6,0
69070,3,2,242007,242010,242012,3,5,0
69071,5,1,242012,242012,242013,0,1,0
69072,6,3,242018,242018,242021,0,3,5
69073,2,1,242020,242021,242022,1,2,0
69074,6,2,242026,242026,242028,0,2,4
69075,1,3,242027,242028,242031,1,4,0
69076,5,1,242032,242032,242033,0,1,1
69077,3,1,242035,242035,242036,0,1,2
69078,1,3,242036,242036,242039,0,3,0
69079,3,1,242039,242039,242040,0,1,0
69080,5,2,242044,242044,242046,0,2,4
69081,6,1,242050,242050,242051,0,1,4
69082,6,1,242056,242056,242057,0,1,5
69083,4,3,242060,242060,242063,0,3,3
69084,1,2,242061,242063,242065,2,4,0
69085,5,2,242066,242066,242068,0,2,1
69086,6,1,242072,242072,242073,0,1,4
69087,2,3,242074,242074,242077,0,3,1
69088,3,3,242077,242077,242080,0,3,0
69089,3,1,242080,242080,242081,0,1,0
69090,6,2,242086,242086,242088,0,2,5
69091,4,3,242090,242090,242093,0,3,2
69092,3,3,242093,242093,242096,0,3,0
69093,6,1,242099,242099,242100,0,1,3
69094,4,3,242103,242103,242106,0,3,3
69095,6,3,242109,242109,242112,0,3,3
69096,3,2,242112,242112,242114,0,2,0
69097,5,2,242117,242117,242119,0,2,3
69098,3,1,242120,242120,242121,0,1,1
69099,1,3,242121,242121,242124,0,3,0
69100,5,2,242126,242126,242128,0,2,2
69101,3,2,242129,242129,242131,0,2,1
69102,6,2,242135,242135,242137,0,2,4
69103,1,2,242136,242137,242139,1,3,0
69104,4,2,242140,242140,242142,0,2,1
69105,2,2,242142,242142,242144,0,2,0
69106,6,2,242148,242148,242150,0,2,4
69107,3,1,242151,242151,242152,0,1,1
69108,6,1,242157,242157,242158,0,1,5
69109,3,1,242160,242160,242161,0,1,2
69110,6,2,242166,242166,242168,0,2,5
69111,2,2,242168,242168,242170,0,2,0
69112,3,1,242171,242171,242172,0,1,1
69113,1,1,242172,242172,242173,0,1,0
69114,1,1,242173,242173,242174,0,1,0
69115,2,3,242175,242175,242178,0,3,1
69116,4,1,242179,242179,242180,0,1,1
69117,4,2,242183,242183,242185,0,2,3
69118,4,3,242187,242187,242190,0,3,2
69119,6,3,242193,242193,242196,0,3,3
69120,2,3,242195,242196,242199,1,4,0
69121,5,1,242200,242200,242201,0,1,1
69122,6,3,242206,242206,242209,0,3,5
69123,2,2,242208,242209,242211,1,3,0
69124,6,2,242214,242214,242216,0,2,3
69125,2,1,242216,242216,242217,0,1,0
69126,1,1,242217,242217,242218,0,1,0
69127,6,1,242223,242223,242224,0,1,5
69128,6,3,242229,242229,242232,0,3,5
69129,1,3,242230,242232,242235,2,5,0
69130,5,2,242235,242235,242237,0,2,0
69131,3,2,242238,242238,242240,0,2,1
69132,3,3,242241,242241,242244,0,3,1
69133,5,2,242246,242246,242248,0,2,2
69134,6,3,242252,242252,242255,0,3,4
69135,2,3,242254,242255,242258,1,4,0
69136,6,1,242260,242260,242261,0,1,2
69137,3,2,242263,242263,242265,0,2,2
69138,5,3,242268,242268,242271,0,3,3
69139,2,1,242270,242271,242272,1,2,0
69140,5,1,242275,242275,242276,0,1,3
69141,1,1,242276,242276,242277,0,1,0
69142,3,3,242279,242279,242282,0,3,2
69143,2,1,242281,242282,242283,1,2,0
69144,6,3,242287,242287,242290,0,3,4
69145,2,2,242289,242290,242292,1,3,0
69146,2,1,242291,242292,242293,1,2,0
69147,4,1,242295,242295,242296,0,1,2
69148,1,3,242296,242296,242299,0,3,0
69149,1,2,242297,242299,242301,2,4,0
69150,4,1,242301,242301,242302,0,1,0
69151,6,1,242307,242307,242308,0,1,5
69152,6,3,242313,242313,242316,0,3,5
69153,3,2,242316,242316,242318,0,2,0
69154,5,3,242321,242321,242324,0,3,3
69155,3,1,242324,242324,242325,0,1,0
69156,2,3,242326,242326,242329,0,3,1
69157,4,2,242330,242330,242332,0,2,1
69158,5,1,242335,242335,242336,0,1,3
69159,4,2,242339,242339,242341,0,2,3
69160,3,3,242342,242342,242345,0,3,1
69161,5,1,242347,242347,242348,0,1,2
69162,1,2,242348,242348,242350,0,2,0
69163,4,2,242352,242352,242354,0,2,2
69164,6,3,242358,242358,242361,0,3,4
69165,5,3,242363,242363,242366,0,3,2
69166,2,1,242365,242366,242367,1,2,0
69167,2,1,242367,242367,242368,0,1,0
69168,2,3,242369,242369,242372,0,3,1
69169,1,2,242370,242372,242374,2,4,0
69170,1,2,242371,242374,242376,3,5,0
69171,6,1,242377,242377,242378,0,1,1
69172,6,1,242383,242383,242384,0,1,5
69173,4,1,242387,242387,242388,0,1,3
69174,6,1,242393,242393,242394,0,1,5
69175,6,2,242399,242399,242401,0,2,5
69176,4,3,242403,242403,242406,0,3,2
69177,3,1,242406,242406,242407,0,1,0
69178,5,1,242411,242411,242412,0,1,4
69179,4,3,242415,242415,242418,0,3,3
69180,4,1,242419,242419,242420,0,1,1
69181,2,1,242421,242421,242422,0,1,1
69182,5,1,242426,242426,242427,0,1,4
69183,2,2,242428,242428,242430,0,2,1
69184,4,2,242432,242432,242434,0,2,2
69185,5,1,242437,242437,242438,0,1,3
69186,3,2,242440,242440,242442,0,2,2
69187,5,3,242445,242445,242448,0,3,3
69188,2,1,242447,242448,242449,1,2,0
69189,5,1,242452,242452,242453,0,1,3
69190,4,1,242456,242456,242457,0,1,3
69191,5,2,242461,242461,242463,0,2,4
69192,6,1,242467,242467,242468,0,1,4
69193,2,1,242469,242469,242470,0,1,1
69194,3,1,242472,242472,242473,0,1,2
69195,1,3,242473,242473,242476,0,3,0
69196,4,2,242477,242477,242479,0,2,1
69197,1,1,242478,242479,242480,1,2,0
69198,2,2,242480,242480,242482,0,2,0
69199,2,2,242482,242482,242484,0,2,0
69200,1,1,242483,242484,242485,1,2,0
69201,4,2,242487,242487,242489,0,2,2
69202,2,3,242489,242489,242492,0,3,0
69203,2,2,242491,242492,242494,1,3,0
69204,3,3,242494,242494,242497,0,3,0
69205,3,1,242497,242497,242498,0,1,0
69206,6,1,242503,242503,242504,0,1,5
69207,6,2,242509,242509,242511,0,2,5
69208,1,2,242510,242511,242513,1,3,0
69209,5,3,242515,242515,242518,0,3,2
69210,6,2,242521,242521,242523,0,2,3
69211,1,1,242522,242523,242524,1,2,0
69212,4,2,242526,242526,242528,0,2,2
69213,6,1,242532,242532,242533,0,1,4
69214,1,3,242533,242533,242536,0,3,0
69215,2,2,242535,242536,242538,1,3,0
69216,6,1,242541,242541,242542,0,1,3
69217,1,3,242542,242542,242545,0,3,0
69218,1,3,242543,242545,242548,2,5,0
69219,1,1,242544,242548,242549,4,5,0
69220,4,1,242548,242549,242550,1,2,0
69221,3,3,242551,242551,242554,0,3,1
69222,2,3,242553,242554,242557,1,4,0
69223,3,1,242556,242557,242558,1,2,0
69224,2,2,242558,242558,242560,0,2,0
69225,4,1,242562,242562,242563,0,1,2
69226,5,3,242567,242567,242570,0,3,4
69227,4,1,242571,242571,242572,0,1,1
69228,5,1,242576,242576,242577,0,1,4
69229,1,2,242577,242577,242579,0,2,0
69230,1,3,242578,242579,242582,1,4,0
69231,6,3,242584,242584,242587,0,3,2
69232,3,2,242587,242587,242589,0,2,0
69233,3,3,242590,242590,242593,0,3,1
69234,2,1,242592,242593,242594,1,2,0
69235,3,1,242595,242595,242596,0,1,1
69236,3,3,242598,242598,242601,0,3,2
69237,3,2,242601,242601,242603,0,2,0
69238,6,3,242607,242607,242610,0,3,4
69239,6,3,242613,242613,242616,0,3,3
69240,4,2,242617,242617,242619,0,2,1
69241,2,3,242619,242619,242622,0,3,0
69242,2,3,242621,242622,242625,1,4,0
69243,6,1,242627,242627,242628,0,1,2
69244,3,3,242630,242630,242633,0,3,2
69245,6,1,242636,242636,242637,0,1,3
69246,5,2,242641,242641,242643,0,2,4
69247,2,2,242643,242643,242645,0,2,0
69248,1,1,242644,242645,242646,1,2,0
69249,3,3,242647,242647,242650,0,3,1
69250,5,1,242652,242652,242653,0,1,2
69251,2,1,242654,242654,242655,0,1,1
69252,2,3,242656,242656,242659,0,3,1
69253,5,3,242661,242661,242664,0,3,2
69254,4,1,242665,242665,242666,0,1,1
69255,3,2,242668,242668,242670,0,2,2
69256,5,2,242673,242673,242675,0,2,3
69257,5,2,242678,242678,242680,0,2,3
69258,6,3,242684,242684,242687,0,3,4
69259,1,3,242685,242687,242690,2,5,0
69260,2,2,242687,242690,242692,3,5,0
69261,5,2,242692,242692,242694,0,2,0
69262,6,3,242698,242698,242701,0,3,4
69263,6,1,242704,242704,242705,0,1,3
69264,5,3,242709,242709,242712,0,3,4
69265,4,1,242713,242713,242714,0,1,1
69266,6,2,242719,242719,242721,0,2,5
69267,4,3,242723,242723,242726,0,3,2
69268,3,3,242726,242726,242729,0,3,0
69269,4,3,242730,242730,242733,0,3,1
69270,2,1,242732,242733,242734,1,2,0
69271,6,1,242738,242738,242739,0,1,4
69272,2,2,242740,242740,242742,0,2,1
69273,5,2,242745,242745,242747,0,2,3
69274,2,3,242747,242747,242750,0,3,0
69275,5,1,242752,242752,242753,0,1,2
69276,2,3,242754,242754,242757,0,3,1
69277,5,2,242759,242759,242761,0,2,2
69278,3,2,242762,242762,242764,0,2,1
69279,5,1,242767,242767,242768,0,1,3
69280,6,1,242773,242773,242774,0,1,5
69281,6,3,242779,242779,242782,0,3,5
69282,4,1,242783,242783,242784,0,1,1
69283,1,2,242784,242784,242786,0,2,0
69284,5,1,242789,242789,242790,0,1,3
69285,1,2,242790,242790,242792,0,2,0
69286,3,3,242793,242793,242796,0,3,1
69287,1,1,242794,242796,242797,2,3,0
69288,2,2,242796,242797,242799,1,3,0
69289,3,1,242799,242799,242800,0,1,0
69290,6,2,242805,242805,242807,0,2,5
69291,3,2,242808,242808,242810,0,2,1
69292,4,1,242812,242812,242813,0,1,2
69293,2,2,242814,242814,242816,0,2,1
69294,1,1,242815,242816,242817,1,2,0
69295,6,3,242821,242821,242824,0,3,4
69296,5,3,242826,242826,242829,0,3,2
69297,3,3,242829,242829,242832,0,3,0
69298,2,2,242831,242832,242834,1,3,0
69299,6,3,242837,242837,242840,0,3,3
69300,1,3,242838,242840,242843,2,5,0
69301,4,2,242842,242843,242845,1,3,0
69302,6,3,242848,242848,242851,0,3,3
69303,6,3,242854,242854,242857,0,3,3
69304,6,1,242860,242860,242861,0,1,3
69305,2,3,242862,242862,242865,0,3,1
69306,6,2,242868,242868,242870,0,2,3
69307,2,2,242870,242870,242872,0,2,0
69308,2,3,242872,242872,242875,0,3,0
69309,3,2,242875,242875,242877,0,2,0
69310,6,1,242881,242881,242882,0,1,4
69311,3,2,242884,242884,242886,0,2,2
69312,3,3,242887,242887,242890,0,3,1
69313,6,3,242893,242893,242896,0,3,3
69314,6,3,242899,242899,242902,0,3,3
69315,3,2,242902,242902,242904,0,2,0
69316,5,2,242907,242907,242909,0,2,3
69317,5,1,242912,242912,242913,0,1,3
69318,5,1,242917,242917,242918,0,1,4
69319,1,3,242918,242918,242921,0,3,0
69320,1,3,242919,242921,242924,2,5,0
69321,5,3,242924,242924,242927,0,3,0
69322,4,3,242928,242928,242931,0,3,1
69323,1,1,242929,242931,242932,2,3,0
69324,4,3,242933,242933,242936,0,3,1
69325,5,2,242938,242938,242940,0,2,2
69326,5,2,242943,242943,242945,0,2,3
69327,6,1,242949,242949,242950,0,1,4
69328,5,2,242954,242954,242956,0,2,4
69329,1,1,242955,242956,242957,1,2,0
69330,4,2,242959,242959,242961,0,2,2
69331,1,3,242960,242961,242964,1,4,0
69332,5,3,242965,242965,242968,0,3,1
69333,6,1,242971,242971,242972,0,1,3
69334,1,2,242972,242972,242974,0,2,0
69335,3,3,242975,242975,242978,0,3,1
69336,5,1,242980,242980,242981,0,1,2
69337,5,1,242985,242985,242986,0,1,4
69338,5,2,242990,242990,242992,0,2,4
69339,1,3,242991,242992,242995,1,4,0
69340,2,2,242993,242995,242997,2,4,0
69341,1,2,242994,242997,242999,3,5,0
69342,1,2,242995,242999,243001,4,6,0
69343,6,1,243001,243001,243002,0,1,0
69344,5,3,243006,243006,243009,0,3,4
69345,5,3,243011,243011,243014,0,3,2
69346,2,2,243013,243014,243016,1,3,0
69347,5,2,243018,243018,243020,0,2,2
69348,4,1,243022,243022,243023,0,1,2
69349,6,3,243028,243028,243031,0,3,5
69350,6,3,243034,243034,243037,0,3,3
69351,4,2,243038,243038,243040,0,2,1
69352,1,2,243039,243040,243042,1,3,0
69353,3,2,243042,243042,243044,0,2,0
69354,5,3,243047,243047,243050,0,3,3
69355,4,3,243051,243051,243054,0,3,1
69356,2,3,243053,243054,243057,1,4,0
69357,3,2,243056,243057,243059,1,3,0
69358,1,1,243057,243059,243060,2,3,0
69359,1,2,243058,243060,243062,2,4,0
69360,4,3,243062,243062,243065,0,3,0
69361,6,1,243068,243068,243069,0,1,3
69362,3,2,243071,243071,243073,0,2,2
69363,4,1,243075,243075,243076,0,1,2
69364,5,3,243080,243080,243083,0,3,4
69365,4,2,243084,243084,243086,0,2,1
69366,2,1,243086,243086,243087,0,1,0
69367,6,1,243092,243092,243093,0,1,5
69368,6,1,243098,243098,243099,0,1,5
69369,4,1,243102,243102,243103,0,1,3
69370,1,3,243103,243103,243106,0,3,0
69371,4,1,243107,243107,243108,0,1,1
69372,2,2,243109,243109,243111,0,2,1
69373,3,2,243112,243112,243114,0,2,1
69374,3,2,243115,243115,243117,0,2,1
69375,6,3,243121,243121,243124,0,3,4
69376,3,2,243124,243124,243126,0,2,0
69377,3,1,243127,243127,243128,0,1,1
69378,6,3,243133,243133,243136,0,3,5
69379,1,2,243134,243136,243138,2,4,0
69380,1,3,243135,243138,243141,3,6,0
69381,5,1,243140,243141,243142,1,2,0
69382,4,2,243144,243144,243146,0,2,2
69383,1,2,243145,243146,243148,1,3,0
69384,1,2,243146,243148,243150,2,4,0
69385,3,2,243149,243150,243152,1,3,0
69386,4,1,243153,243153,243154,0,1,1
69387,5,3,243158,243158,243161,0,3,4
69388,1,1,243159,243161,243162,2,3,0
69389,2,1,243161,243162,243163,1,2,0
69390,3,2,243164,243164,243166,0,2,1
69391,5,2,243169,243169,243171,0,2,3
69392,5,3,243174,243174,243177,0,3,3
69393,6,2,243180,243180,243182,0,2,3
69394,5,2,243185,243185,243187,0,2,3
69395,4,3,243189,243189,243192,0,3,2
69396,3,3,243192,243192,243195,0,3,0
69397,1,2,243193,243195,243197,2,4,0
69398,1,1,243194,243197,243198,3,4,0
69399,4,2,243198,243198,243200,0,2,0
69400,1,2,243199,243200,243202,1,3,0
69401,1,2,243200,243202,243204,2,4,0
69402,4,3,243204,243204,243207,0,3,0
69403,3,2,243207,243207,243209,0,2,0
69404,4,2,243211,243211,243213,0,2,2
69405,6,2,243217,243217,243219,0,2,4
69406,5,1,243222,243222,243223,0,1,3
69407,2,3,243224,243224,243227,0,3,1
69408,1,2,243225,243227,243229,2,4,0
69409,2,3,243227,243229,243232,2,5,0
69410,4,2,243231,243232,243234,1,3,0
69411,2,1,243233,243234,243235,1,2,0
69412,4,1,243237,243237,243238,0,1,2
69413,6,2,243243,243243,243245,0,2,5
69414,1,2,243244,243245,243247,1,3,0
69415,6,2,243250,243250,243252,0,2,3
69416,6,3,243256,243256,243259,0,3,4
69417,6,3,243262,243262,243265,0,3,3
69418,1,1,243263,243265,243266,2,3,0
69419,2,3,243265,243266,243269,1,4,0
69420,1,1,243266,243269,243270,3,4,0
69421,2,1,243268,243270,243271,2,3,0
69422,1,3,243269,243271,243274,2,5,0
69423,2,1,243271,243274,243275,3,4,0
69424,1,3,243272,243275,243278,3,6,0
69425,4,3,243276,243278,243281,2,5,0
69426,5,1,243281,243281,243282,0,1,0
69427,4,3,243285,243285,243288,0,3,3
69428,4,1,243289,243289,243290,0,1,1
69429,5,2,243294,243294,243296,0,2,4
69430,5,2,243299,243299,243301,0,2,3
69431,1,1,243300,243301,243302,1,2,0
69432,1,2,243301,243302,243304,1,3,0
69433,6,1,243307,243307,243308,0,1,3
69434,4,3,243311,243311,243314,0,3,3
69435,3,2,243314,243314,243316,0,2,0
69436,2,2,243316,243316,243318,0,2,0
69437,1,2,243317,243318,243320,1,3,0
69438,3,2,243320,243320,243322,0,2,0
69439,5,2,243325,243325,243327,0,2,3
69440,6,3,243331,243331,243334,0,3,4
69441,5,3,243336,243336,243339,0,3,2
69442,6,1,243342,243342,243343,0,1,3
69443,4,2,243346,243346,243348,0,2,3
69444,4,1,243350,243350,243351,0,1,2
69445,1,1,243351,243351,243352,0,1,0
69446,6,2,243357,243357,243359,0,2,5
69447,1,2,243358,243359,243361,1,3,0
69448,1,1,243359,243361,243362,2,3,0
69449,3,1,243362,243362,243363,0,1,0
69450,4,1,243366,243366,243367,0,1,3
69451,2,1,243368,243368,243369,0,1,1
69452,6,3,243374,243374,243377,0,3,5
69453,4,2,243378,243378,243380,0,2,1
69454,5,3,243383,243383,243386,0,3,3
69455,4,1,243387,243387,243388,0,1,1
69456,4,2,243391,243391,243393,0,2,3
69457,1,2,243392,243393,243395,1,3,0
69458,6,2,243398,243398,243400,0,2,3
69459,3,2,243401,243401,243403,0,2,1
69460,2,1,243403,243403,243404,0,1,0
69461,5,2,243408,243408,243410,0,2,4
69462,1,1,243409,243410,243411,1,2,0
69463,3,2,243412,243412,243414,0,2,1
69464,2,3,243414,243414,243417,0,3,0
69465,4,1,243418,243418,243419,0,1,1
69466,6,3,243424,243424,243427,0,3,5
69467,3,1,243427,243427,243428,0,1,0
69468,4,3,243431,243431,243434,0,3,3
69469,4,1,243435,243435,243436,0,1,1
69470,2,2,243437,243437,243439,0,2,1
69471,6,1,243443,243443,243444,0,1,4
69472,5,3,243448,243448,243451,0,3,4
69473,1,3,243449,243451,243454,2,5,0
69474,5,1,243454,243454,243455,0,1,0
69475,5,3,243459,243459,243462,0,3,4
69476,4,3,243463,243463,243466,0,3,1
69477,6,1,243469,243469,243470,0,1,3
69478,5,1,243474,243474,243475,0,1,4
69479,5,3,243479,243479,243482,0,3,4
69480,1,2,243480,243482,243484,2,4,0
69481,3,2,243483,243484,243486,1,3,0
69482,2,2,243485,243486,243488,1,3,0
69483,1,2,243486,243488,243490,2,4,0
69484,3,3,243489,243490,243493,1,4,0
69485,2,3,243491,243493,243496,2,5,0
69486,5,1,243496,243496,243497,0,1,0
69487,3,3,243499,243499,243502,0,3,2
69488,1,3,243500,243502,243505,2,5,0
69489,4,1,243504,243505,243506,1,2,0
69490,3,2,243507,243507,243509,0,2,1
69491,3,3,243510,243510,243513,0,3,1
69492,6,1,243516,243516,243517,0,1,3
69493,1,1,243517,243517,243518,0,1,0
69494,2,1,243519,243519,243520,0,1,1
69495,1,3,243520,243520,243523,0,3,0
69496,3,2,243523,243523,243525,0,2,0
69497,6,2,243529,243529,243531,0,2,4
69498,4,2,243533,243533,243535,0,2,2
69499,3,3,243536,243536,243539,0,3,1
69500,3,1,243539,243539,243540,0,1,0
69501,1,1,243540,243540,243541,0,1,0
69502,3,1,243543,243543,243544,0,1,2
69503,1,3,243544,243544,243547,0,3,0
69504,3,3,243547,243547,243550,0,3,0
69505,6,3,243553,243553,243556,0,3,3
69506,6,1,243559,243559,243560,0,1,3
69507,5,1,243564,243564,243565,0,1,4
69508,6,1,243570,243570,243571,0,1,5
69509,4,1,243574,243574,243575,0,1,3
69510,6,2,243580,243580,243582,0,2,5
69511,3,1,243583,243583,243584,0,1,1
69512,4,3,243587,243587,243590,0,3,3
69513,1,2,243588,243590,243592,2,4,0
69514,4,3,243592,243592,243595,0,3,0
69515,4,1,243596,243596,243597,0,1,1
69516,4,2,243600,243600,243602,0,2,3
69517,4,3,243604,243604,243607,0,3,2
69518,4,2,243608,243608,243610,0,2,1
69519,3,3,243611,243611,243614,0,3,1
69520,4,1,243615,243615,243616,0,1,1
69521,3,3,243618,243618,243621,0,3,2
69522,5,3,243623,243623,243626,0,3,2
69523,3,2,243626,243626,243628,0,2,0
69524,1,3,243627,243628,243631,1,4,0
69525,5,2,243632,243632,243634,0,2,1
69526,1,2,243633,243634,243636,1,3,0
69527,5,3,243638,243638,243641,0,3,2
69528,2,1,243640,243641,243642,1,2,0
69529,5,1,243645,243645,243646,0,1,3
69530,4,1,243649,243649,243650,0,1,3
69531,4,1,243653,243653,243654,0,1,3
69532,3,3,243656,243656,243659,0,3,2
69533,5,1,243661,243661,243662,0,1,2
69534,6,3,243667,243667,243670,0,3,5
69535,4,2,243671,243671,243673,0,2,1
69536,3,3,243674,243674,243677,0,3,1
69537,4,1,243678,243678,243679,0,1,1
69538,4,1,243682,243682,243683,0,1,3
69539,6,2,243688,243688,243690,0,2,5
69540,5,3,243693,243693,243696,0,3,3
69541,3,2,243696,243696,243698,0,2,0
69542,1,2,243697,243698,243700,1,3,0
69543,1,1,243698,243700,243701,2,3,0
69544,2,3,243700,243701,243704,1,4,0
69545,1,2,243701,243704,243706,3,5,0
69546,2,3,243703,243706,243709,3,6,0
69547,4,3,243707,243709,243712,2,5,0
69548,1,3,243708,243712,243715,4,7,0
69549,6,2,243714,243715,243717,1,3,0
69550,3,3,243717,243717,243720,0,3,0
69551,3,3,243720,243720,243723,0,3,0
69552,1,3,243721,243723,243726,2,5,0
69553,5,2,243726,243726,243728,0,2,0
69554,3,2,243729,243729,243731,0,2,1
69555,4,3,243733,243733,243736,0,3,2
69556,2,2,243735,243736,243738,1,3,0
69557,6,2,243741,243741,243743,0,2,3
69558,4,3,243745,243745,243748,0,3,2
69559,1,3,243746,243748,243751,2,5,0
69560,4,1,243750,243751,243752,1,2,0
69561,3,1,243753,243753,243754,0,1,1
69562,4,3,243757,243757,243760,0,3,3
69563,3,3,243760,243760,243763,0,3,0
69564,4,2,243764,243764,243766,0,2,1
69565,3,1,243767,243767,243768,0,1,1
69566,5,1,243772,243772,243773,0,1,4
69567,2,2,243774,243774,243776,0,2,1
69568,3,2,243777,243777,243779,0,2,1
69569,6,3,243783,243783,243786,0,3,4
69570,6,3,243789,243789,243792,0,3,3
69571,5,1,243794,243794,243795,0,1,2
69572,4,1,243798,243798,243799,0,1,3
69573,5,3,243803,243803,243806,0,3,4
69574,5,2,243808,243808,243810,0,2,2
69575,3,1,243811,243811,243812,0,1,1
69576,3,1,243814,243814,243815,0,1,2
69577,5,1,243819,243819,243820,0,1,4
69578,4,2,243823,243823,243825,0,2,3
69579,6,1,243829,243829,243830,0,1,4
69580,2,2,243831,243831,243833,0,2,1
69581,2,3,243833,243833,243836,0,3,0
69582,3,2,243836,243836,243838,0,2,0
69583,4,2,243840,243840,243842,0,2,2
69584,1,2,243841,243842,243844,1,3,0
69585,3,2,243844,243844,243846,0,2,0
69586,6,3,243850,243850,243853,0,3,4
69587,3,2,243853,243853,243855,0,2,0
69588,4,2,243857,243857,243859,0,2,2
69589,3,2,243860,243860,243862,0,2,1
69590,1,2,243861,243862,243864,1,3,0
69591,3,3,243864,243864,243867,0,3,0
69592,1,1,243865,243867,243868,2,3,0
69593,5,3,243870,243870,243873,0,3,2
69594,4,3,243874,243874,243877,0,3,1
69595,6,1,243880,243880,243881,0,1,3
69596,5,3,243885,243885,243888,0,3,4
69597,6,3,243891,243891,243894,0,3,3
69598,6,2,243897,243897,243899,0,2,3
69599,2,2,243899,243899,243901,0,2,0
69600,2,2,243901,243901,243903,0,2,0
69601,6,2,243907,243907,243909,0,2,4
69602,1,3,243908,243909,243912,1,4,0
69603,4,2,243912,243912,243914,0,2,0
69604,3,3,243915,243915,243918,0,3,1
69605,3,1,243918,243918,243919,0,1,0
69606,3,1,243921,243921,243922,0,1,2
69607,5,1,243926,243926,243927,0,1,4
69608,2,3,243928,243928,243931,0,3,1
69609,4,1,243932,243932,243933,0,1,1
69610,4,2,243936,243936,243938,0,2,3
69611,5,2,243941,243941,243943,0,2,3
69612,5,3,243946,243946,243949,0,3,3
69613,5,2,243951,243951,243953,0,2,2
69614,3,1,243954,243954,243955,0,1,1
69615,3,3,243957,243957,243960,0,3,2
69616,2,3,243959,243960,243963,1,4,0
69617,4,1,243963,243963,243964,0,1,0
69618,3,3,243966,243966,243969,0,3,2
69619,6,1,243972,243972,243973,0,1,3
69620,1,3,243973,243973,243976,0,3,0
69621,2,1,243975,243976,243977,1,2,0
69622,5,1,243980,243980,243981,0,1,3
69623,1,1,243981,243981,243982,0,1,0
69624,3,3,243984,243984,243987,0,3,2
69625,6,1,243990,243990,243991,0,1,3
69626,2,1,243992,243992,243993,0,1,1
69627,3,3,243995,243995,243998,0,3,2
69628,3,1,243998,243998,243999,0,1,0
69629,1,2,243999,243999,244001,0,2,0
69630,2,3,244001,244001,244004,0,3,0
69631,2,2,244003,244004,244006,1,3,0
69632,5,3,244008,244008,244011,0,3,2
69633,1,1,244009,244011,244012,2,3,0
69634,6,2,244015,244015,244017,0,2,3
69635,6,2,244021,244021,244023,0,2,4
69636,2,2,244023,244023,244025,0,2,0
69637,4,3,244027,244027,244030,0,3,2
69638,5,1,244032,244032,244033,0,1,2
69639,6,3,244038,244038,244041,0,3,5
69640,2,2,244040,244041,244043,1,3,0
69641,4,2,244044,244044,244046,0,2,1
69642,5,2,244049,244049,244051,0,2,3
69643,6,3,244055,244055,244058,0,3,4
69644,3,2,244058,244058,244060,0,2,0
69645,6,3,244064,244064,244067,0,3,4
69646,5,3,244069,244069,244072,0,3,2
69647,6,2,244075,244075,244077,0,2,3
69648,5,3,244080,244080,244083,0,3,3
69649,2,3,244082,244083,244086,1,4,0
69650,4,3,244086,244086,244089,0,3,0
69651,4,1,244090,244090,244091,0,1,1
69652,2,3,244092,244092,244095,0,3,1
69653,5,3,244097,244097,244100,0,3,2
69654,6,1,244103,244103,244104,0,1,3
69655,1,1,244104,244104,244105,0,1,0
69656,3,3,244107,244107,244110,0,3,2
69657,5,3,244112,244112,244115,0,3,2
69658,3,2,244115,244115,244117,0,2,0
69659,5,3,244120,244120,244123,0,3,3
69660,6,3,244126,244126,244129,0,3,3
69661,6,3,244132,244132,244135,0,3,3
69662,1,3,244133,244135,244138,2,5,0
69663,3,1,244136,244138,244139,2,3,0
69664,4,3,244140,244140,244143,0,3,1
69665,3,3,244143,244143,244146,0,3,0
69666,3,3,244146,244146,244149,0,3,0
69667,3,3,244149,244149,244152,0,3,0
69668,2,1,244151,244152,244153,1,2,0
69669,6,1,244157,244157,244158,0,1,4
69670,4,3,244161,244161,244164,0,3,3
69671,5,2,244166,244166,244168,0,2,2
69672,3,3,244169,244169,244172,0,3,1
69673,6,3,244175,244175,244178,0,3,3
69674,5,2,244180,244180,244182,0,2,2
69675,5,3,244185,244185,244188,0,3,3
69676,4,3,244189,244189,244192,0,3,1
69677,6,3,244195,244195,244198,0,3,3
69678,3,1,244198,244198,244199,0,1,0
69679,3,1,244201,244201,244202,0,1,2
69680,3,3,244204,244204,244207,0,3,2
69681,1,2,244205,244207,244209,2,4,0
69682,3,2,244208,244209,244211,1,3,0
69683,5,1,244213,244213,244214,0,1,2
69684,2,1,244215,244215,244216,0,1,1
69685,4,2,244219,244219,244221,0,2,3
69686,4,1,244223,244223,244224,0,1,2
69687,3,3,244226,244226,244229,0,3,2
69688,4,1,244230,244230,244231,0,1,1
69689,4,1,244234,244234,244235,0,1,3
69690,2,3,244236,244236,244239,0,3,1
69691,5,1,244241,244241,244242,0,1,2
69692,4,3,244245,244245,244248,0,3,3
69693,6,2,244251,244251,244253,0,2,3
69694,4,1,244255,244255,244256,0,1,2
69695,2,3,244257,244257,244260,0,3,1
69696,5,2,244262,244262,244264,0,2,2
69697,3,3,244265,244265,244268,0,3,1
69698,1,1,244266,244268,244269,2,3,0
69699,5,1,244271,244271,244272,0,1,2
69700,3,1,244274,244274,244275,0,1,2
69701,3,3,244277,244277,244280,0,3,2
69702,3,3,244280,244280,244283,0,3,0
69703,4,2,244284,244284,244286,0,2,1
69704,6,2,244290,244290,244292,0,2,4
69705,5,1,244295,244295,244296,0,1,3
69706,5,2,244300,244300,244302,0,2,4
69707,2,2,244302,244302,244304,0,2,0
69708,1,1,244303,244304,244305,1,2,0
69709,2,3,244305,244305,244308,0,3,0
69710,4,1,244309,244309,244310,0,1,1
69711,6,3,244315,244315,244318,0,3,5
69712,5,2,244320,244320,244322,0,2,2
69713,3,1,244323,244323,244324,0,1,1
69714,5,3,244328,244328,244331,0,3,4
69715,4,1,244332,244332,244333,0,1,1
69716,5,1,244337,244337,244338,0,1,4
69717,6,3,244343,244343,244346,0,3,5
69718,4,3,244347,244347,244350,0,3,1
69719,4,3,244351,244351,244354,0,3,1
69720,6,3,244357,244357,244360,0,3,3
69721,5,1,244362,244362,244363,0,1,2
69722,1,1,244363,244363,244364,0,1,0
69723,3,2,244366,244366,244368,0,2,2
69724,6,1,244372,244372,244373,0,1,4
69725,4,1,244376,244376,244377,0,1,3
69726,1,2,244377,244377,244379,0,2,0
69727,6,1,244383,244383,244384,0,1,4
69728,5,2,244388,244388,244390,0,2,4
69729,3,3,244391,244391,244394,0,3,1
69730,6,3,244397,244397,244400,0,3,3
69731,1,3,244398,244400,244403,2,5,0
69732,1,1,244399,244403,244404,4,5,0
69733,1,1,244400,244404,244405,4,5,0
69734,1,3,244401,244405,244408,4,7,0
69735,4,1,244405,244408,244409,3,4,0
69736,5,3,244410,244410,244413,0,3,1
69737,6,1,244416,244416,244417,0,1,3
69738,2,1,244418,244418,244419,0,1,1
69739,6,3,244424,244424,244427,0,3,5
69740,5,2,244429,244429,244431,0,2,2
69741,5,2,244434,244434,244436,0,2,3
69742,3,1,244437,244437,244438,0,1,1
69743,4,2,244441,244441,244443,0,2,3
69744,4,1,244445,244445,244446,0,1,2
69745,1,3,244446,244446,244449,0,3,0
69746,2,3,244448,244449,244452,1,4,0
69747,5,2,244453,244453,244455,0,2,1
69748,1,2,244454,244455,244457,1,3,0
69749,4,3,244458,244458,244461,0,3,1
69750,1,3,244459,244461,244464,2,5,0
69751,2,2,244461,244464,244466,3,5,0
69752,6,3,244467,244467,244470,0,3,1
69753,5,3,244472,244472,244475,0,3,2
69754,3,1,244475,244475,244476,0,1,0
69755,5,2,244480,244480,244482,0,2,4
69756,6,3,244486,244486,244489,0,3,4
69757,1,2,244487,244489,244491,2,4,0
69758,3,1,244490,244491,244492,1,2,0
69759,6,3,244496,244496,244499,0,3,4
69760,3,2,244499,244499,244501,0,2,0
69761,6,2,244505,244505,244507,0,2,4
69762,3,1,244508,244508,244509,0,1,1
69763,6,2,244514,244514,244516,0,2,5
69764,3,2,244517,244517,244519,0,2,1
69765,1,2,244518,244519,244521,1,3,0
69766,4,3,244522,244522,244525,0,3,1
69767,4,3,244526,244526,244529,0,3,1
69768,3,1,244529,244529,244530,0,1,0
69769,4,2,244533,244533,244535,0,2,3
69770,3,1,244536,244536,244537,0,1,1
69771,2,3,244538,244538,244541,0,3,1
69772,6,1,244544,244544,244545,0,1,3
69773,4,3,244548,244548,244551,0,3,3
69774,4,3,244552,244552,244555,0,3,1
69775,4,3,244556,244556,244559,0,3,1
69776,3,2,244559,244559,244561,0,2,0
69777,2,3,244561,244561,244564,0,3,0
69778,5,2,244566,244566,244568,0,2,2
69779,4,2,244570,244570,244572,0,2,2
69780,4,3,244574,244574,244577,0,3,2
69781,3,3,244577,244577,244580,0,3,0
69782,4,1,244581,244581,244582,0,1,1
69783,6,2,244587,244587,244589,0,2,5
69784,3,1,244590,244590,244591,0,1,1
69785,3,3,244593,244593,244596,0,3,2
69786,4,2,244597,244597,244599,0,2,1
69787,6,1,244603,244603,244604,0,1,4
69788,5,1,244608,244608,244609,0,1,4
69789,1,3,244609,244609,244612,0,3,0
69790,1,1,244610,244612,244613,2,3,0
69791,3,2,244613,244613,244615,0,2,0
69792,2,2,244615,244615,244617,0,2,0
69793,6,1,244621,244621,244622,0,1,4
69794,1,3,244622,244622,244625,0,3,0
69795,1,2,244623,244625,244627,2,4,0
69796,3,1,244626,244627,244628,1,2,0
69797,3,3,244629,244629,244632,0,3,1
69798,3,3,244632,244632,244635,0,3,0
69799,4,2,244636,244636,244638,0,2,1
69800,6,2,244642,244642,244644,0,2,4
69801,5,3,244647,244647,244650,0,3,3
69802,6,3,244653,244653,244656,0,3,3
69803,3,2,244656,244656,244658,0,2,0
69804,3,1,244659,244659,244660,0,1,1
69805,5,1,244664,244664,244665,0,1,4
69806,3,2,244667,244667,244669,0,2,2
69807,1,2,244668,244669,244671,1,3,0
69808,5,3,244673,244673,244676,0,3,2
69809,6,3,244679,244679,244682,0,3,3
69810,4,2,244683,244683,244685,0,2,1
69811,2,1,244685,244685,244686,0,1,0
69812,1,2,244686,244686,244688,0,2,0
69813,1,2,244687,244688,244690,1,3,0
69814,6,2,244693,244693,244695,0,2,3
69815,4,3,244697,244697,244700,0,3,2
69816,1,2,244698,244700,244702,2,4,0
69817,2,1,244700,244702,244703,2,3,0
69818,1,2,244701,244703,244705,2,4,0
69819,4,2,244705,244705,244707,0,2,0
69820,2,2,244707,244707,244709,0,2,0
69821,1,1,244708,244709,244710,1,2,0
69822,4,3,244712,244712,244715,0,3,2
69823,3,3,244715,244715,244718,0,3,0
69824,1,1,244716,244718,244719,2,3,0
69825,5,3,244721,244721,244724,0,3,2
69826,5,1,244726,244726,244727,0,1,2
69827,1,2,244727,244727,244729,0,2,0
69828,6,2,244733,244733,244735,0,2,4
69829,1,2,244734,244735,244737,1,3,0
69830,2,3,244736,244737,244740,1,4,0
69831,5,2,244741,244741,244743,0,2,1
69832,1,2,244742,244743,244745,1,3,0
69833,4,3,244746,244746,244749,0,3,1
69834,1,2,244747,244749,244751,2,4,0
69835,4,2,244751,244751,244753,0,2,0
69836,2,2,244753,244753,244755,0,2,0
69837,6,1,244759,244759,244760,0,1,4
69838,5,3,244764,244764,244767,0,3,4
69839,4,2,244768,244768,244770,0,2,1
69840,3,3,244771,244771,244774,0,3,1
69841,1,3,244772,244774,244777,2,5,0
69842,3,2,244775,244777,244779,2,4,0
69843,3,3,244778,244779,244782,1,4,0
69844,5,1,244783,244783,244784,0,1,1
69845,4,1,244787,244787,244788,0,1,3
69846,4,3,244791,244791,244794,0,3,3
69847,1,2,244792,244794,244796,2,4,0
69848,5,1,244797,244797,244798,0,1,1
69849,6,2,244803,244803,244805,0,2,5
69850,3,1,244806,244806,244807,0,1,1
69851,4,1,244810,244810,244811,0,1,3
69852,5,2,244815,244815,244817,0,2,4
69853,2,2,244817,244817,244819,0,2,0
69854,4,2,244821,244821,244823,0,2,2
69855,3,2,244824,244824,244826,0,2,1
69856,1,3,244825,244826,244829,1,4,0
69857,1,2,244826,244829,244831,3,5,0
69858,1,2,244827,244831,244833,4,6,0
69859,5,2,244832,244833,244835,1,3,0
69860,3,2,244835,244835,244837,0,2,0
69861,2,2,244837,244837,244839,0,2,0
69862,2,1,244839,244839,244840,0,1,0
69863,2,2,244841,244841,244843,0,2,1
69864,1,1,244842,244843,244844,1,2,0
69865,5,3,244847,244847,244850,0,3,3
69866,2,2,244849,244850,244852,1,3,0
69867,1,3,244850,244852,244855,2,5,0
69868,1,3,244851,244855,244858,4,7,0
69869,3,3,244854,244858,244861,4,7,0
69870,2,3,244856,244861,244864,5,8,0
69871,6,3,244862,244864,244867,2,5,0
69872,3,3,244865,244867,244870,2,5,0
69873,1,1,244866,244870,244871,4,5,0
69874,1,3,244867,244871,244874,4,7,0
69875,5,3,244872,244874,244877,2,5,0
69876,6,1,244878,244878,244879,0,1,1
69877,5,2,244883,244883,244885,0,2,4
69878,3,1,244886,244886,244887,0,1,1
69879,3,3,244889,244889,244892,0,3,2
69880,6,3,244895,244895,244898,0,3,3
69881,5,1,244900,244900,244901,0,1,2
69882,6,3,244906,244906,244909,0,3,5
69883,2,1,244908,244909,244910,1,2,0
69884,2,2,244910,244910,244912,0,2,0
69885,6,2,244916,244916,244918,0,2,4
69886,2,2,244918,244918,244920,0,2,0
69887,4,2,244922,244922,244924,0,2,2
69888,1,3,244923,244924,244927,1,4,0
69889,1,2,244924,244927,244929,3,5,0
69890,4,3,244928,244929,244932,1,4,0
69891,1,2,244929,244932,244934,3,5,0
69892,6,1,244935,244935,244936,0,1,1
69893,3,2,244938,244938,244940,0,2,2
69894,5,3,244943,244943,244946,0,3,3
69895,6,1,244949,244949,244950,0,1,3
69896,6,3,244955,244955,244958,0,3,5
69897,3,2,244958,244958,244960,0,2,0
69898,2,3,244960,244960,244963,0,3,0
69899,6,3,244966,244966,244969,0,3,3
69900,1,2,244967,244969,244971,2,4,0
69901,3,1,244970,244971,244972,1,2,0
69902,1,1,244971,244972,244973,1,2,0
69903,6,3,244977,244977,244980,0,3,4
69904,6,2,244983,244983,244985,0,2,3
69905,4,1,244987,244987,244988,0,1,2
69906,3,1,244990,244990,244991,0,1,2
69907,2,2,244992,244992,244994,0,2,1
69908,4,2,244996,244996,244998,0,2,2
69909,4,3,245000,245000,245003,0,3,2
69910,4,2,245004,245004,245006,0,2,1
69911,3,2,245007,245007,245009,0,2,1
69912,5,3,245012,245012,245015,0,3,3
69913,5,2,245017,245017,245019,0,2,2
69914,6,2,245023,245023,245025,0,2,4
69915,1,2,245024,245025,245027,1,3,0
69916,4,2,245028,245028,245030,0,2,1
69917,6,2,245034,245034,245036,0,2,4
69918,5,2,245039,245039,245041,0,2,3
69919,3,1,245042,245042,245043,0,1,1
69920,6,1,245048,245048,245049,0,1,5
69921,3,2,245051,245051,245053,0,2,2
69922,4,1,245055,245055,245056,0,1,2
69923,6,3,245061,245061,245064,0,3,5
69924,5,3,245066,245066,245069,0,3,2
69925,4,2,245070,245070,245072,0,2,1
69926,4,2,245074,245074,245076,0,2,2
69927,2,1,245076,245076,245077,0,1,0
69928,6,1,245082,245082,245083,0,1,5
69929,5,1,245087,245087,245088,0,1,4
69930,1,2,245088,245088,245090,0,2,0
69931,3,3,245091,245091,245094,0,3,1
69932,4,2,245095,245095,245097,0,2,1
69933,5,3,245100,245100,245103,0,3,3
69934,2,2,245102,245103,245105,1,3,0
69935,5,2,245107,245107,245109,0,2,2
69936,2,1,245109,245109,245110,0,1,0
69937,6,3,245115,245115,245118,0,3,5
69938,1,3,245116,245118,245121,2,5,0
69939,5,2,245121,245121,245123,0,2,0
69940,2,2,245123,245123,245125,0,2,0
69941,3,3,245126,245126,245129,0,3,1
69942,4,3,245130,245130,245133,0,3,1
69943,6,1,245136,245136,245137,0,1,3
69944,1,2,245137,245137,245139,0,2,0
69945,1,1,245138,245139,245140,1,2,0
69946,5,2,245143,245143,245145,0,2,3
69947,3,3,245146,245146,245149,0,3,1
69948,2,1,245148,245149,245150,1,2,0
69949,4,2,245152,245152,245154,0,2,2
69950,1,1,245153,245154,245155,1,2,0
69951,3,2,245156,245156,245158,0,2,1
69952,3,3,245159,245159,245162,0,3,1
69953,3,1,245162,245162,245163,0,1,0
69954,1,3,245163,245163,245166,0,3,0
69955,6,1,245169,245169,245170,0,1,3
69956,6,1,245175,245175,245176,0,1,5
69957,6,2,245181,245181,245183,0,2,5
69958,1,2,245182,245183,245185,1,3,0
69959,2,1,245184,245185,245186,1,2,0
69960,2,1,245186,245186,245187,0,1,0
69961,3,3,245189,245189,245192,0,3,2
69962,5,1,245194,245194,245195,0,1,2
69963,6,3,245200,245200,245203,0,3,5
69964,3,1,245203,245203,245204,0,1,0
69965,1,3,245204,245204,245207,0,3,0
69966,5,2,245209,245209,245211,0,2,2
69967,2,2,245211,245211,245213,0,2,0
69968,5,2,245216,245216,245218,0,2,3
69969,6,3,245222,245222,245225,0,3,4
69970,3,1,245225,245225,245226,0,1,0
69971,5,1,245230,245230,245231,0,1,4
69972,4,3,245234,245234,245237,0,3,3
69973,6,2,245240,245240,245242,0,2,3
69974,6,3,245246,245246,245249,0,3,4
69975,6,3,245252,245252,245255,0,3,3
69976,3,2,245255,245255,245257,0,2,0
69977,1,2,245256,245257,245259,1,3,0
69978,4,3,245260,245260,245263,0,3,1
69979,2,2,245262,245263,245265,1,3,0
69980,2,3,245264,245265,245268,1,4,0
69981,5,2,245269,245269,245271,0,2,1
69982,2,1,245271,245271,245272,0,1,0
69983,5,1,245276,245276,245277,0,1,4
69984,4,3,245280,245280,245283,0,3,3
69985,4,1,245284,245284,245285,0,1,1
69986,5,3,245289,245289,245292,0,3,4
69987,2,2,245291,245292,245294,1,3,0
69988,5,3,245296,245296,245299,0,3,2
69989,2,1,245298,245299,245300,1,2,0
69990,1,3,245299,245300,245303,1,4,0
69991,2,3,245301,245303,245306,2,5,0
69992,4,2,245305,245306,245308,1,3,0
69993,2,2,245307,245308,245310,1,3,0
69994,5,2,245312,245312,245314,0,2,2
69995,6,1,245318,245318,245319,0,1,4
69996,6,3,245324,245324,245327,0,3,5
69997,3,2,245327,245327,245329,0,2,0
69998,6,2,245333,245333,245335,0,2,4
69999,2,3,245335,245335,245338,0,3,0
70000,4,1,245339,245339,245340,0,1,1
70001,5,3,245344,245344,245347,0,3,4
70002,6,3,245350,245350,245353,0,3,3
70003,6,3,245356,245356,245359,0,3,3
70004,3,3,245359,245359,245362,0,3,0
70005,4,3,245363,245363,245366,0,3,1
70006,3,2,245366,245366,245368,0,2,0
70007,2,3,245368,245368,245371,0,3,0
70008,5,3,245373,245373,245376,0,3,2
70009,1,2,245374,245376,245378,2,4,0
70010,5,3,245379,245379,245382,0,3,1
70011,6,1,245385,245385,245386,0,1,3
70012,4,3,245389,245389,245392,0,3,3
70013,6,2,245395,245395,245397,0,2,3
70014,1,3,245396,245397,245400,1,4,0
70015,2,2,245398,245400,245402,2,4,0
70016,2,2,245400,245402,245404,2,4,0
70017,5,3,245405,245405,245408,0,3,1
70018,1,2,245406,245408,245410,2,4,0
70019,1,1,245407,245410,245411,3,4,0
70020,4,1,245411,245411,245412,0,1,0
70021,2,3,245413,245413,245416,0,3,1
70022,1,1,245414,245416,245417,2,3,0
70023,1,3,245415,245417,245420,2,5,0
70024,2,3,245417,245420,245423,3,6,0
70025,6,1,245423,245423,245424,0,1,0
70026,2,3,245425,245425,245428,0,3,1
70027,2,2,245427,245428,245430,1,3,0
70028,4,1,245431,245431,245432,0,1,1
70029,4,2,245435,245435,245437,0,2,3
70030,4,1,245439,245439,245440,0,1,2
70031,5,2,245444,245444,245446,0,2,4
70032,2,2,245446,245446,245448,0,2,0
70033,5,2,245451,245451,245453,0,2,3
70034,6,2,245457,245457,245459,0,2,4
70035,3,3,245460,245460,245463,0,3,1
70036,5,3,245465,245465,245468,0,3,2
70037,5,3,245470,245470,245473,0,3,2
70038,1,1,245471,245473,245474,2,3,0
70039,3,2,245474,245474,245476,0,2,0
70040,2,1,245476,245476,245477,0,1,0
70041,5,1,245481,245481,245482,0,1,4
70042,5,2,245486,245486,245488,0,2,4
70043,2,2,245488,245488,245490,0,2,0
70044,2,3,245490,245490,245493,0,3,0
70045,6,1,245496,245496,245497,0,1,3
70046,4,3,245500,245500,245503,0,3,3
70047,1,1,245501,245503,245504,2,3,0
70048,5,3,245506,245506,245509,0,3,2
70049,5,3,245511,245511,245514,0,3,2
70050,3,1,245514,245514,245515,0,1,0
70051,4,1,245518,245518,245519,0,1,3
70052,2,3,245520,245520,245523,0,3,1
70053,3,2,245523,245523,245525,0,2,0
70054,1,2,245524,245525,245527,1,3,0
70055,2,2,245526,245527,245529,1,3,0
70056,1,3,245527,245529,245532,2,5,0
70057,1,1,245528,245532,245533,4,5,0
70058,5,2,245533,245533,245535,0,2,0
70059,6,2,245539,245539,245541,0,2,4
70060,2,1,245541,245541,245542,0,1,0
70061,3,1,245544,245544,245545,0,1,2
70062,3,3,245547,245547,245550,0,3,2
70063,3,2,245550,245550,245552,0,2,0
70064,4,3,245554,245554,245557,0,3,2
70065,5,2,245559,245559,245561,0,2,2
70066,1,2,245560,245561,245563,1,3,0
70067,6,1,245566,245566,245567,0,1,3
70068,4,1,245570,245570,245571,0,1,3
70069,4,1,245574,245574,245575,0,1,3
70070,3,2,245577,245577,245579,0,2,2
70071,1,1,245578,245579,245580,1,2,0
70072,3,1,245581,245581,245582,0,1,1
70073,6,1,245587,245587,245588,0,1,5
70074,4,3,245591,245591,245594,0,3,3
70075,2,1,245593,245594,245595,1,2,0
70076,4,1,245597,245597,245598,0,1,2
70077,2,3,245599,245599,245602,0,3,1
70078,3,3,245602,245602,245605,0,3,0
70079,1,3,245603,245605,245608,2,5,0
70080,3,3,245606,245608,245611,2,5,0
70081,5,2,245611,245611,245613,0,2,0
70082,5,1,245616,245616,245617,0,1,3
70083,3,1,245619,245619,245620,0,1,2
70084,3,3,245622,245622,245625,0,3,2
70085,1,2,245623,245625,245627,2,4,0
70086,1,2,245624,245627,245629,3,5,0
70087,6,1,245630,245630,245631,0,1,1
70088,3,2,245633,245633,245635,0,2,2
70089,5,3,245638,245638,245641,0,3,3
70090,3,3,245641,245641,245644,0,3,0
70091,2,1,245643,245644,245645,1,2,0
70092,6,3,245649,245649,245652,0,3,4
70093,4,1,245653,245653,245654,0,1,1
70094,4,2,245657,245657,245659,0,2,3
70095,2,2,245659,245659,245661,0,2,0
70096,2,1,245661,245661,245662,0,1,0
70097,4,3,245665,245665,245668,0,3,3
70098,5,3,245670,245670,245673,0,3,2
70099,5,1,245675,245675,245676,0,1,2
70100,1,3,245676,245676,245679,0,3,0
70101,1,1,245677,245679,245680,2,3,0
70102,4,2,245681,245681,245683,0,2,1
70103,2,2,245683,245683,245685,0,2,0
70104,6,1,245689,245689,245690,0,1,4
70105,6,3,245695,245695,245698,0,3,5
70106,3,3,245698,245698,245701,0,3,0
70107,3,1,245701,245701,245702,0,1,0
70108,4,1,245705,245705,245706,0,1,3
70109,3,2,245708,245708,245710,0,2,2
70110,1,3,245709,245710,245713,1,4,0
70111,3,2,245712,245713,245715,1,3,0
70112,2,3,245714,245715,245718,1,4,0
70113,4,3,245718,245718,245721,0,3,0
70114,6,3,245724,245724,245727,0,3,3
70115,2,1,245726,245727,245728,1,2,0
70116,5,3,245731,245731,245734,0,3,3
70117,4,1,245735,245735,245736,0,1,1
70118,6,2,245741,245741,245743,0,2,5
70119,3,3,245744,245744,245747,0,3,1
70120,5,3,245749,245749,245752,0,3,2
70121,3,3,245752,245752,245755,0,3,0
70122,1,2,245753,245755,245757,2,4,0
70123,4,3,245757,245757,245760,0,3,0
70124,5,3,245762,245762,245765,0,3,2
70125,5,1,245767,245767,245768,0,1,2
70126,6,2,245773,245773,245775,0,2,5
70127,2,3,245775,245775,245778,0,3,0
70128,4,3,245779,245779,245782,0,3,1
70129,2,3,245781,245782,245785,1,4,0
70130,5,3,245786,245786,245789,0,3,1
70131,2,3,245788,245789,245792,1,4,0
70132,4,1,245792,245792,245793,0,1,0
70133,4,1,245796,245796,245797,0,1,3
70134,2,2,245798,245798,245800,0,2,1
70135,2,2,245800,245800,245802,0,2,0
70136,1,2,245801,245802,245804,1,3,0
70137,6,3,245807,245807,245810,0,3,3
70138,3,2,245810,245810,245812,0,2,0
70139,1,2,245811,245812,245814,1,3,0
70140,2,3,245813,245814,245817,1,4,0
70141,5,3,245818,245818,245821,0,3,1
70142,5,2,245823,245823,245825,0,2,2
70143,4,3,245827,245827,245830,0,3,2
70144,3,1,245830,245830,245831,0,1,0
70145,1,1,245831,245831,245832,0,1,0
70146,6,2,245837,245837,245839,0,2,5
70147,6,3,245843,245843,245846,0,3,4
70148,2,3,245845,245846,245849,1,4,0
70149,2,2,245847,245849,245851,2,4,0
70150,2,3,245849,245851,245854,2,5,0
70151,3,3,245852,245854,245857,2,5,0
70152,6,2,245858,245858,245860,0,2,1
70153,4,2,245862,245862,245864,0,2,2
70154,2,3,245864,245864,245867,0,3,0
70155,5,2,245869,245869,245871,0,2,2
70156,3,1,245872,245872,245873,0,1,1
70157,4,2,245876,245876,245878,0,2,3
70158,4,1,245880,245880,245881,0,1,2
70159,5,2,245885,245885,245887,0,2,4
70160,5,2,245890,245890,245892,0,2,3
70161,2,1,245892,245892,245893,0,1,0
70162,6,1,245898,245898,245899,0,1,5
70163,2,1,245900,245900,245901,0,1,1
70164,2,1,245902,245902,245903,0,1,1
70165,3,3,245905,245905,245908,0,3,2
70166,4,3,245909,245909,245912,0,3,1
70167,2,2,245911,245912,245914,1,3,0
70168,5,3,245916,245916,245919,0,3,2
70169,6,1,245922,245922,245923,0,1,3
70170,4,3,245926,245926,245929,0,3,3
70171,5,2,245931,245931,245933,0,2,2
70172,4,3,245935,245935,245938,0,3,2
70173,5,1,245940,245940,245941,0,1,2
70174,5,3,245945,245945,245948,0,3,4
70175,3,3,245948,245948,245951,0,3,0
70176,6,3,245954,245954,245957,0,3,3
70177,3,2,245957,245957,245959,0,2,0
70178,6,1,245963,245963,245964,0,1,4
70179,2,1,245965,245965,245966,0,1,1
70180,6,2,245971,245971,245973,0,2,5
70181,5,2,245976,245976,245978,0,2,3
70182,3,3,245979,245979,245982,0,3,1
70183,3,1,245982,245982,245983,0,1,0
70184,5,1,245987,245987,245988,0,1,4
70185,3,3,245990,245990,245993,0,3,2
70186,1,2,245991,245993,245995,2,4,0
70187,5,2,245996,245996,245998,0,2,1
70188,2,2,245998,245998,246000,0,2,0
70189,3,2,246001,246001,246003,0,2,1
70190,3,3,246004,246004,246007,0,3,1
70191,4,2,246008,246008,246010,0,2,1
70192,4,3,246012,246012,246015,0,3,2
70193,5,1,246017,246017,246018,0,1,2
70194,4,2,246021,246021,246023,0,2,3
70195,3,2,246024,246024,246026,0,2,1
70196,3,1,246027,246027,246028,0,1,1
70197,4,2,246031,246031,246033,0,2,3
70198,4,3,246035,246035,246038,0,3,2
70199,6,1,246041,246041,246042,0,1,3
70200,3,2,246044,246044,246046,0,2,2
70201,2,1,246046,246046,246047,0,1,0
70202,1,1,246047,246047,246048,0,1,0
70203,5,3,246052,246052,246055,0,3,4
70204,2,2,246054,246055,246057,1,3,0
70205,5,1,246059,246059,246060,0,1,2
70206,2,1,246061,246061,246062,0,1,1
70207,3,1,246064,246064,246065,0,1,2
70208,2,3,246066,246066,246069,0,3,1
70209,6,2,246072,246072,246074,0,2,3
70210,1,1,246073,246074,246075,1,2,0
70211,4,3,246077,246077,246080,0,3,2
70212,4,3,246081,246081,246084,0,3,1
70213,2,1,246083,246084,246085,1,2,0
70214,1,3,246084,246085,246088,1,4,0
70215,5,2,246089,246089,246091,0,2,1
70216,4,3,246093,246093,246096,0,3,2
70217,1,3,246094,246096,246099,2,5,0
70218,3,1,246097,246099,246100,2,3,0
70219,5,3,246102,246102,246105,0,3,2
70220,3,3,246105,246105,246108,0,3,0
70221,1,1,246106,246108,246109,2,3,0
70222,5,3,246111,246111,246114,0,3,2
70223,4,2,246115,246115,246117,0,2,1
70224,1,1,246116,246117,246118,1,2,0
70225,2,1,246118,246118,246119,0,1,0
70226,4,2,246122,246122,246124,0,2,3
70227,4,3,246126,246126,246129,0,3,2
70228,1,1,246127,246129,246130,2,3,0
70229,2,3,246129,246130,246133,1,4,0
70230,3,1,246132,246133,246134,1,2,0
70231,3,2,246135,246135,246137,0,2,1
70232,1,1,246136,246137,246138,1,2,0
70233,1,1,246137,246138,246139,1,2,0
70234,4,2,246141,246141,246143,0,2,2
70235,5,3,246146,246146,246149,0,3,3
70236,4,3,246150,246150,246153,0,3,1
70237,2,2,246152,246153,246155,1,3,0
70238,5,1,246157,246157,246158,0,1,2
70239,2,1,246159,246159,246160,0,1,1
70240,3,2,246162,246162,246164,0,2,2
70241,2,3,246164,246164,246167,0,3,0
70242,2,3,246166,246167,246170,1,4,0
70243,2,1,246168,246170,246171,2,3,0
70244,5,1,246173,246173,246174,0,1,2
70245,1,2,246174,246174,246176,0,2,0
70246,1,2,246175,246176,246178,1,3,0
70247,3,1,246178,246178,246179,0,1,0
70248,6,2,246184,246184,246186,0,2,5
70249,6,3,246190,246190,246193,0,3,4
70250,5,1,246195,246195,246196,0,1,2
70251,5,3,246200,246200,246203,0,3,4
70252,1,3,246201,246203,246206,2,5,0
70253,6,2,246207,246207,246209,0,2,1
70254,4,1,246211,246211,246212,0,1,2
70255,6,3,246217,246217,246220,0,3,5
70256,3,2,246220,246220,246222,0,2,0
70257,1,1,246221,246222,246223,1,2,0
70258,6,2,246227,246227,246229,0,2,4
70259,1,1,246228,246229,246230,1,2,0
70260,2,2,246230,246230,246232,0,2,0
70261,3,2,246233,246233,246235,0,2,1
70262,2,1,246235,246235,246236,0,1,0
70263,1,3,246236,246236,246239,0,3,0
70264,2,2,246238,246239,246241,1,3,0
70265,2,2,246240,246241,246243,1,3,0
70266,6,2,246246,246246,246248,0,2,3
70267,3,3,246249,246249,246252,0,3,1
70268,6,3,246255,246255,246258,0,3,3
70269,6,2,246261,246261,246263,0,2,3
70270,1,3,246262,246263,246266,1,4,0
70271,4,3,246266,246266,246269,0,3,0
70272,5,1,246271,246271,246272,0,1,2
70273,4,3,246275,246275,246278,0,3,3
70274,6,1,246281,246281,246282,0,1,3
70275,5,2,246286,246286,246288,0,2,4
70276,4,2,246290,246290,246292,0,2,2
70277,5,2,246295,246295,246297,0,2,3
70278,4,2,246299,246299,246301,0,2,2
70279,3,1,246302,246302,246303,0,1,1
70280,3,2,246305,246305,246307,0,2,2
70281,3,2,246308,246308,246310,0,2,1
70282,4,2,246312,246312,246314,0,2,2
70283,2,3,246314,246314,246317,0,3,0
70284,3,2,246317,246317,246319,0,2,0
70285,5,3,246322,246322,246325,0,3,3
70286,5,3,246327,246327,246330,0,3,2
70287,3,3,246330,246330,246333,0,3,0
70288,1,2,246331,246333,246335,2,4,0
70289,4,2,246335,246335,246337,0,2,0
70290,3,2,246338,246338,246340,0,2,1
70291,6,3,246344,246344,246347,0,3,4
70292,2,3,246346,246347,246350,1,4,0
70293,2,2,246348,246350,246352,2,4,0
70294,2,2,246350,246352,246354,2,4,0
70295,4,2,246354,246354,246356,0,2,0
70296,3,2,246357,246357,246359,0,2,1
70297,5,3,246362,246362,246365,0,3,3
70298,1,1,246363,246365,246366,2,3,0
70299,5,3,246368,246368,246371,0,3,2
70300,2,2,246370,246371,246373,1,3,0
70301,5,1,246375,246375,246376,0,1,2
70302,4,3,246379,246379,246382,0,3,3
70303,6,1,246385,246385,246386,0,1,3
70304,5,1,246390,246390,246391,0,1,4
70305,3,1,246393,246393,246394,0,1,2
70306,1,2,246394,246394,246396,0,2,0
70307,3,3,246397,246397,246400,0,3,1
70308,6,3,246403,246403,246406,0,3,3
70309,1,1,246404,246406,246407,2,3,0
70310,3,1,246407,246407,246408,0,1,0
70311,4,1,246411,246411,246412,0,1,3
70312,5,1,246416,246416,246417,0,1,4
70313,6,3,246422,246422,246425,0,3,5
70314,3,1,246425,246425,246426,0,1,0
70315,5,3,246430,246430,246433,0,3,4
70316,2,1,246432,246433,246434,1,2,0
70317,2,3,246434,246434,246437,0,3,0
70318,3,3,246437,246437,246440,0,3,0
70319,2,1,246439,246440,246441,1,2,0
70320,4,1,246443,246443,246444,0,1,2
70321,6,2,246449,246449,246451,0,2,5
70322,3,1,246452,246452,246453,0,1,1
70323,2,3,246454,246454,246457,0,3,1
70324,5,3,246459,246459,246462,0,3,2
70325,6,1,246465,246465,246466,0,1,3
70326,5,3,246470,246470,246473,0,3,4
70327,3,2,246473,246473,246475,0,2,0
70328,5,3,246478,246478,246481,0,3,3
70329,2,1,246480,246481,246482,1,2,0
70330,6,2,246486,246486,246488,0,2,4
70331,6,2,246492,246492,246494,0,2,4
70332,1,1,246493,246494,246495,1,2,0
70333,6,2,246499,246499,246501,0,2,4
70334,1,1,246500,246501,246502,1,2,0
70335,6,2,246506,246506,246508,0,2,4
70336,5,3,246511,246511,246514,0,3,3
70337,1,2,246512,246514,246516,2,4,0
70338,6,2,246518,246518,246520,0,2,2
70339,5,3,246523,246523,246526,0,3,3
70340,3,1,246526,246526,246527,0,1,0
70341,2,1,246528,246528,246529,0,1,1
70342,4,1,246532,246532,246533,0,1,3
70343,5,2,246537,246537,246539,0,2,4
70344,2,1,246539,246539,246540,0,1,0
70345,3,1,246542,246542,246543,0,1,2
70346,4,3,246546,246546,246549,0,3,3
70347,6,3,246552,246552,246555,0,3,3
70348,3,2,246555,246555,246557,0,2,0
70349,5,3,246560,246560,246563,0,3,3
70350,5,3,246565,246565,246568,0,3,2
70351,1,1,246566,246568,246569,2,3,0
70352,1,2,246567,246569,246571,2,4,0
70353,4,2,246571,246571,246573,0,2,0
70354,5,2,246576,246576,246578,0,2,3
70355,5,1,246581,246581,246582,0,1,3
70356,3,1,246584,246584,246585,0,1,2
70357,2,3,246586,246586,246589,0,3,1
70358,4,1,246590,246590,246591,0,1,1
70359,1,3,246591,246591,246594,0,3,0
70360,4,2,246595,246595,246597,0,2,1
70361,3,2,246598,246598,246600,0,2,1
70362,1,3,246599,246600,246603,1,4,0
70363,3,3,246602,246603,246606,1,4,0
70364,3,3,246605,246606,246609,1,4,0
70365,4,1,246609,246609,246610,0,1,0
70366,1,1,246610,246610,246611,0,1,0
70367,1,3,246611,246611,246614,0,3,0
70368,1,1,246612,246614,246615,2,3,0
70369,6,1,246618,246618,246619,0,1,3
70370,5,1,246623,246623,246624,0,1,4
70371,2,3,246625,246625,246628,0,3,1
70372,1,1,246626,246628,246629,2,3,0
70373,5,1,246631,246631,246632,0,1,2
70374,4,2,246635,246635,246637,0,2,3
70375,5,3,246640,246640,246643,0,3,3
70376,3,2,246643,246643,246645,0,2,0
70377,1,1,246644,246645,246646,1,2,0
70378,5,3,246649,246649,246652,0,3,3
70379,1,2,246650,246652,246654,2,4,0
70380,3,2,246653,246654,246656,1,3,0
70381,3,1,246656,246656,246657,0,1,0
70382,3,2,246659,246659,246661,0,2,2
70383,6,2,246665,246665,246667,0,2,4
70384,6,2,246671,246671,246673,0,2,4
70385,6,1,246677,246677,246678,0,1,4
70386,2,2,246679,246679,246681,0,2,1
70387,5,1,246684,246684,246685,0,1,3
70388,3,1,246687,246687,246688,0,1,2
70389,5,2,246692,246692,246694,0,2,4
70390,1,3,246693,246694,246697,1,4,0
70391,6,2,246699,246699,246701,0,2,2
70392,1,3,246700,246701,246704,1,4,0
70393,5,1,246705,246705,246706,0,1,1
70394,4,2,246709,246709,246711,0,2,3
70395,3,3,246712,246712,246715,0,3,1
70396,3,1,246715,246715,246716,0,1,0
70397,5,1,246720,246720,246721,0,1,4
70398,1,2,246721,246721,246723,0,2,0
70399,3,3,246724,246724,246727,0,3,1
70400,3,1,246727,246727,246728,0,1,0
70401,2,3,246729,246729,246732,0,3,1
70402,5,1,246734,246734,246735,0,1,2
70403,2,2,246736,246736,246738,0,2,1
70404,2,1,246738,246738,246739,0,1,0
70405,2,2,246740,246740,246742,0,2,1
70406,6,3,246746,246746,246749,0,3,4
70407,4,1,246750,246750,246751,0,1,1
70408,3,2,246753,246753,246755,0,2,2
70409,5,2,246758,246758,246760,0,2,3
70410,1,3,246759,246760,246763,1,4,0
70411,2,1,246761,246763,246764,2,3,0
70412,2,3,246763,246764,246767,1,4,0
70413,6,1,246769,246769,246770,0,1,2
70414,2,2,246771,246771,246773,0,2,1
70415,2,2,246773,246773,246775,0,2,0
70416,4,3,246777,246777,246780,0,3,2
70417,3,1,246780,246780,246781,0,1,0
70418,2,1,246782,246782,246783,0,1,1
70419,2,2,246784,246784,246786,0,2,1
70420,6,1,246790,246790,246791,0,1,4
70421,1,1,246791,246791,246792,0,1,0
70422,3,3,246794,246794,246797,0,3,2
70423,4,1,246798,246798,246799,0,1,1
70424,2,3,246800,246800,246803,0,3,1
70425,6,2,246806,246806,246808,0,2,3
70426,2,2,246808,246808,246810,0,2,0
70427,4,3,246812,246812,246815,0,3,2
70428,3,1,246815,246815,246816,0,1,0
70429,2,3,246817,246817,246820,0,3,1
70430,4,1,246821,246821,246822,0,1,1
70431,4,2,246825,246825,246827,0,2,3
70432,6,2,246831,246831,246833,0,2,4
70433,3,1,246834,246834,246835,0,1,1
70434,2,3,246836,246836,246839,0,3,1
70435,1,1,246837,246839,246840,2,3,0
70436,6,1,246843,246843,246844,0,1,3
70437,4,3,246847,246847,246850,0,3,3
70438,3,2,246850,246850,246852,0,2,0
70439,5,2,246855,246855,246857,0,2,3
70440,4,3,246859,246859,246862,0,3,2
70441,1,1,246860,246862,246863,2,3,0
70442,1,3,246861,246863,246866,2,5,0
70443,6,2,246867,246867,246869,0,2,1
70444,4,2,246871,246871,246873,0,2,2
70445,1,3,246872,246873,246876,1,4,0
70446,6,1,246878,246878,246879,0,1,2
70447,6,2,246884,246884,246886,0,2,5
70448,3,3,246887,246887,246890,0,3,1
70449,1,2,246888,246890,246892,2,4,0
70450,4,1,246892,246892,246893,0,1,0
70451,4,1,246896,246896,246897,0,1,3
70452,6,2,246902,246902,246904,0,2,5
70453,4,2,246906,246906,246908,0,2,2
70454,2,3,246908,246908,246911,0,3,0
70455,4,1,246912,246912,246913,0,1,1
70456,1,1,246913,246913,246914,0,1,0
70457,2,2,246915,246915,246917,0,2,1
70458,2,3,246917,246917,246920,0,3,0
70459,4,3,246921,246921,246924,0,3,1
70460,5,2,246926,246926,246928,0,2,2
70461,3,2,246929,246929,246931,0,2,1
70462,3,3,246932,246932,246935,0,3,1
70463,4,3,246936,246936,246939,0,3,1
70464,6,3,246942,246942,246945,0,3,3
70465,1,1,246943,246945,246946,2,3,0
70466,2,3,246945,246946,246949,1,4,0
70467,6,1,246951,246951,246952,0,1,2
70468,5,1,246956,246956,246957,0,1,4
70469,2,2,246958,246958,246960,0,2,1
70470,6,1,246964,246964,246965,0,1,4
70471,1,3,246965,246965,246968,0,3,0
70472,2,1,246967,246968,246969,1,2,0
70473,3,1,246970,246970,246971,0,1,1
70474,5,2,246975,246975,246977,0,2,4
70475,3,1,246978,246978,246979,0,1,1
70476,1,1,246979,246979,246980,0,1,0
70477,2,1,246981,246981,246982,0,1,1
70478,2,3,246983,246983,246986,0,3,1
70479,5,1,246988,246988,246989,0,1,2
70480,5,3,246993,246993,246996,0,3,4
70481,1,1,246994,246996,246997,2,3,0
70482,6,1,247000,247000,247001,0,1,3
70483,3,2,247003,247003,247005,0,2,2
70484,6,3,247009,247009,247012,0,3,4
70485,5,3,247014,247014,247017,0,3,2
70486,2,2,247016,247017,247019,1,3,0
70487,4,2,247020,247020,247022,0,2,1
70488,2,3,247022,247022,247025,0,3,0
70489,4,3,247026,247026,247029,0,3,1
70490,5,1,247031,247031,247032,0,1,2
70491,6,3,247037,247037,247040,0,3,5
70492,2,2,247039,247040,247042,1,3,0
70493,6,1,247045,247045,247046,0,1,3
70494,1,1,247046,247046,247047,0,1,0
70495,4,3,247050,247050,247053,0,3,3
70496,1,2,247051,247053,247055,2,4,0
70497,1,3,247052,247055,247058,3,6,0
70498,3,1,247055,247058,247059,3,4,0
70499,4,2,247059,247059,247061,0,2,0
70500,4,3,247063,247063,247066,0,3,2
70501,6,1,247069,247069,247070,0,1,3
70502,4,3,247073,247073,247076,0,3,3
70503,1,3,247074,247076,247079,2,5,0
70504,5,3,247079,247079,247082,0,3,0
70505,6,2,247085,247085,247087,0,2,3
70506,3,2,247088,247088,247090,0,2,1
70507,5,3,247093,247093,247096,0,3,3
70508,4,1,247097,247097,247098,0,1,1
70509,3,2,247100,247100,247102,0,2,2
70510,5,2,247105,247105,247107,0,2,3
70511,6,3,247111,247111,247114,0,3,4
70512,2,2,247113,247114,247116,1,3,0
70513,1,1,247114,247116,247117,2,3,0
70514,2,3,247116,247117,247120,1,4,0
70515,3,2,247119,247120,247122,1,3,0
70516,4,3,247123,247123,247126,0,3,1
70517,1,2,247124,247126,247128,2,4,0
70518,5,3,247129,247129,247132,0,3,1
70519,5,2,247134,247134,247136,0,2,2
70520,2,3,247136,247136,247139,0,3,0
70521,5,3,247141,247141,247144,0,3,2
70522,2,3,247143,247144,247147,1,4,0
70523,5,2,247148,247148,247150,0,2,1
70524,2,1,247150,247150,247151,0,1,0
70525,4,3,247154,247154,247157,0,3,3
70526,4,1,247158,247158,247159,0,1,1
70527,4,3,247162,247162,247165,0,3,3
70528,4,1,247166,247166,247167,0,1,1
70529,4,3,247170,247170,247173,0,3,3
70530,5,2,247175,247175,247177,0,2,2
70531,2,3,247177,247177,247180,0,3,0
70532,1,1,247178,247180,247181,2,3,0
70533,4,1,247182,247182,247183,0,1,1
70534,5,2,247187,247187,247189,0,2,4
70535,6,2,247193,247193,247195,0,2,4
70536,5,1,247198,247198,247199,0,1,3
70537,2,1,247200,247200,247201,0,1,1
70538,3,1,247203,247203,247204,0,1,2
70539,6,3,247209,247209,247212,0,3,5
70540,6,3,247215,247215,247218,0,3,3
70541,4,1,247219,247219,247220,0,1,1
70542,2,3,247221,247221,247224,0,3,1
70543,5,1,247226,247226,247227,0,1,2
70544,2,3,247228,247228,247231,0,3,1
70545,1,3,247229,247231,247234,2,5,0
70546,6,3,247235,247235,247238,0,3,1
70547,5,3,247240,247240,247243,0,3,2
70548,4,2,247244,247244,247246,0,2,1
70549,4,3,247248,247248,247251,0,3,2
70550,2,3,247250,247251,247254,1,4,0
70551,6,3,247256,247256,247259,0,3,2
70552,2,3,247258,247259,247262,1,4,0
70553,3,2,247261,247262,247264,1,3,0
70554,3,3,247264,247264,247267,0,3,0
70555,2,2,247266,247267,247269,1,3,0
70556,2,3,247268,247269,247272,1,4,0
70557,2,3,247270,247272,247275,2,5,0
70558,6,2,247276,247276,247278,0,2,1
70559,4,1,247280,247280,247281,0,1,2
70560,2,3,247282,247282,247285,0,3,1
70561,3,1,247285,247285,247286,0,1,0
70562,3,3,247288,247288,247291,0,3,2
70563,3,1,247291,247291,247292,0,1,0
70564,6,3,247297,247297,247300,0,3,5
70565,1,3,247298,247300,247303,2,5,0
70566,3,3,247301,247303,247306,2,5,0
70567,4,3,247305,247306,247309,1,4,0
70568,6,1,247311,247311,247312,0,1,2
70569,2,3,247313,247313,247316,0,3,1
70570,2,2,247315,247316,247318,1,3,0
70571,6,2,247321,247321,247323,0,2,3
70572,3,2,247324,247324,247326,0,2,1
70573,6,1,247330,247330,247331,0,1,4
70574,4,1,247334,247334,247335,0,1,3
70575,3,1,247337,247337,247338,0,1,2
70576,5,3,247342,247342,247345,0,3,4
70577,3,3,247345,247345,247348,0,3,0
70578,1,2,247346,247348,247350,2,4,0
70579,6,2,247352,247352,247354,0,2,2
70580,2,3,247354,247354,247357,0,3,0
70581,6,2,247360,247360,247362,0,2,3
70582,6,3,247366,247366,247369,0,3,4
70583,2,3,247368,247369,247372,1,4,0
70584,4,1,247372,247372,247373,0,1,0
70585,5,3,247377,247377,247380,0,3,4
70586,5,1,247382,247382,247383,0,1,2
70587,1,2,247383,247383,247385,0,2,0
70588,1,3,247384,247385,247388,1,4,0
70589,2,1,247386,247388,247389,2,3,0
70590,1,1,247387,247389,247390,2,3,0
70591,5,2,247392,247392,247394,0,2,2
70592,6,3,247398,247398,247401,0,3,4
70593,1,1,247399,247401,247402,2,3,0
70594,1,1,247400,247402,247403,2,3,0
70595,6,3,247406,247406,247409,0,3,3
70596,5,2,247411,247411,247413,0,2,2
70597,3,3,247414,247414,247417,0,3,1
70598,1,3,247415,247417,247420,2,5,0
70599,1,2,247416,247420,247422,4,6,0
70600,5,3,247421,247422,247425,1,4,0
70601,6,1,247427,247427,247428,0,1,2
70602,1,1,247428,247428,247429,0,1,0
70603,2,2,247430,247430,247432,0,2,1
70604,2,3,247432,247432,247435,0,3,0
70605,2,3,247434,247435,247438,1,4,0
70606,4,3,247438,247438,247441,0,3,0
70607,5,2,247443,247443,247445,0,2,2
70608,5,2,247448,247448,247450,0,2,3
70609,5,2,247453,247453,247455,0,2,3
70610,3,1,247456,247456,247457,0,1,1
70611,3,3,247459,247459,247462,0,3,2
70612,1,1,247460,247462,247463,2,3,0
70613,5,2,247465,247465,247467,0,2,2
70614,5,2,247470,247470,247472,0,2,3
70615,5,3,247475,247475,247478,0,3,3
70616,5,3,247480,247480,247483,0,3,2
70617,4,2,247484,247484,247486,0,2,1
70618,1,2,247485,247486,247488,1,3,0
70619,5,1,247490,247490,247491,0,1,2
70620,3,3,247493,247493,247496,0,3,2
70621,2,2,247495,247496,247498,1,3,0
70622,3,3,247498,247498,247501,0,3,0
70623,5,2,247503,247503,247505,0,2,2
70624,2,3,247505,247505,247508,0,3,0
70625,2,2,247507,247508,247510,1,3,0
70626,3,3,247510,247510,247513,0,3,0
70627,3,3,247513,247513,247516,0,3,0
70628,4,2,247517,247517,247519,0,2,1
70629,4,3,247521,247521,247524,0,3,2
70630,2,1,247523,247524,247525,1,2,0
70631,6,3,247529,247529,247532,0,3,4
70632,5,1,247534,247534,247535,0,1,2
70633,4,2,247538,247538,247540,0,2,3
70634,1,3,247539,247540,247543,1,4,0
70635,5,2,247544,247544,247546,0,2,1
70636,6,3,247550,247550,247553,0,3,4
70637,6,2,247556,247556,247558,0,2,3
70638,3,3,247559,247559,247562,0,3,1
70639,2,1,247561,247562,247563,1,2,0
70640,4,2,247565,247565,247567,0,2,2
70641,2,1,247567,247567,247568,0,1,0
70642,1,1,247568,247568,247569,0,1,0
70643,2,1,247570,247570,247571,0,1,1
70644,3,3,247573,247573,247576,0,3,2
70645,2,2,247575,247576,247578,1,3,0
70646,6,1,247581,247581,247582,0,1,3
70647,1,2,247582,247582,247584,0,2,0
70648,2,1,247584,247584,247585,0,1,0
70649,2,1,247586,247586,247587,0,1,1
70650,4,1,247590,247590,247591,0,1,3
70651,2,1,247592,247592,247593,0,1,1
70652,6,3,247598,247598,247601,0,3,5
70653,3,1,247601,247601,247602,0,1,0
70654,3,2,247604,247604,247606,0,2,2
70655,1,1,247605,247606,247607,1,2,0
70656,5,1,247610,247610,247611,0,1,3
70657,4,3,247614,247614,247617,0,3,3
70658,4,3,247618,247618,247621,0,3,1
70659,6,3,247624,247624,247627,0,3,3
70660,5,1,247629,247629,247630,0,1,2
70661,2,2,247631,247631,247633,0,2,1
70662,5,2,247636,247636,247638,0,2,3
70663,2,3,247638,247638,247641,0,3,0
70664,3,2,247641,247641,247643,0,2,0
70665,2,1,247643,247643,247644,0,1,0
70666,3,3,247646,247646,247649,0,3,2
70667,6,2,247652,247652,247654,0,2,3
70668,3,2,247655,247655,247657,0,2,1
70669,5,1,247660,247660,247661,0,1,3
70670,3,1,247663,247663,247664,0,1,2
70671,3,3,247666,247666,247669,0,3,2
70672,2,1,247668,247669,247670,1,2,0
70673,5,1,247673,247673,247674,0,1,3
70674,1,1,247674,247674,247675,0,1,0
70675,4,2,247678,247678,247680,0,2,3
70676,2,1,247680,247680,247681,0,1,0
70677,5,1,247685,247685,247686,0,1,4
70678,2,1,247687,247687,247688,0,1,1
70679,1,3,247688,247688,247691,0,3,0
70680,6,2,247694,247694,247696,0,2,3
70681,3,2,247697,247697,247699,0,2,1
70682,6,1,247703,247703,247704,0,1,4
70683,3,2,247706,247706,247708,0,2,2
70684,4,2,247710,247710,247712,0,2,2
70685,5,2,247715,247715,247717,0,2,3
70686,2,3,247717,247717,247720,0,3,0
70687,1,2,247718,247720,247722,2,4,0
70688,5,3,247723,247723,247726,0,3,1
70689,2,1,247725,247726,247727,1,2,0
70690,6,2,247731,247731,247733,0,2,4
70691,1,2,247732,247733,247735,1,3,0
70692,4,2,247736,247736,247738,0,2,1
70693,1,1,247737,247738,247739,1,2,0
70694,1,2,247738,247739,247741,1,3,0
70695,2,1,247740,247741,247742,1,2,0
70696,1,3,247741,247742,247745,1,4,0
70697,5,2,247746,247746,247748,0,2,1
70698,2,3,247748,247748,247751,0,3,0
70699,6,1,247754,247754,247755,0,1,3
70700,6,3,247760,247760,247763,0,3,5
70701,3,1,247763,247763,247764,0,1,0
70702,2,2,247765,247765,247767,0,2,1
70703,3,3,247768,247768,247771,0,3,1
70704,2,3,247770,247771,247774,1,4,0
70705,5,2,247775,247775,247777,0,2,1
70706,6,1,247781,247781,247782,0,1,4
70707,6,1,247787,247787,247788,0,1,5
70708,1,2,247788,247788,247790,0,2,0
70709,1,1,247789,247790,247791,1,2,0
70710,5,3,247794,247794,247797,0,3,3
70711,5,3,247799,247799,247802,0,3,2
70712,4,1,247803,247803,247804,0,1,1
70713,6,3,247809,247809,247812,0,3,5
70714,6,1,247815,247815,247816,0,1,3
70715,5,3,247820,247820,247823,0,3,4
70716,1,1,247821,247823,247824,2,3,0
70717,1,2,247822,247824,247826,2,4,0
70718,4,2,247826,247826,247828,0,2,0
70719,2,3,247828,247828,247831,0,3,0
70720,4,1,247832,247832,247833,0,1,1
70721,3,2,247835,247835,247837,0,2,2
70722,6,3,247841,247841,247844,0,3,4
70723,4,3,247845,247845,247848,0,3,1
70724,5,2,247850,247850,247852,0,2,2
70725,4,1,247854,247854,247855,0,1,2
70726,3,2,247857,247857,247859,0,2,2
70727,3,1,247860,247860,247861,0,1,1
70728,6,1,247866,247866,247867,0,1,5
70729,2,3,247868,247868,247871,0,3,1
70730,5,3,247873,247873,247876,0,3,2
70731,4,2,247877,247877,247879,0,2,1
70732,1,2,247878,247879,247881,1,3,0
70733,3,1,247881,247881,247882,0,1,0
70734,3,2,247884,247884,247886,0,2,2
70735,3,2,247887,247887,247889,0,2,1
70736,4,3,247891,247891,247894,0,3,2
70737,4,3,247895,247895,247898,0,3,1
70738,6,2,247901,247901,247903,0,2,3
70739,3,3,247904,247904,247907,0,3,1
70740,6,2,247910,247910,247912,0,2,3
70741,6,3,247916,247916,247919,0,3,4
70742,5,1,247921,247921,247922,0,1,2
70743,5,2,247926,247926,247928,0,2,4
70744,2,3,247928,247928,247931,0,3,0
70745,4,1,247932,247932,247933,0,1,1
70746,2,1,247934,247934,247935,0,1,1
70747,1,3,247935,247935,247938,0,3,0
70748,5,2,247940,247940,247942,0,2,2
70749,6,2,247946,247946,247948,0,2,4
70750,2,2,247948,247948,247950,0,2,0
70751,2,3,247950,247950,247953,0,3,0
70752,4,3,247954,247954,247957,0,3,1
70753,5,2,247959,247959,247961,0,2,2
70754,6,3,247965,247965,247968,0,3,4
70755,3,2,247968,247968,247970,0,2,0
70756,3,3,247971,247971,247974,0,3,1
70757,3,1,247974,247974,247975,0,1,0
70758,5,3,247979,247979,247982,0,3,4
70759,6,1,247985,247985,247986,0,1,3
70760,6,1,247991,247991,247992,0,1,5
70761,1,1,247992,247992,247993,0,1,0
70762,2,3,247994,247994,247997,0,3,1
70763,2,1,247996,247997,247998,1,2,0
70764,3,2,247999,247999,248001,0,2,1
70765,6,3,248005,248005,248008,0,3,4
70766,4,2,248009,248009,248011,0,2,1
70767,5,2,248014,248014,248016,0,2,3
70768,4,1,248018,248018,248019,0,1,2
70769,3,3,248021,248021,248024,0,3,2
70770,6,1,248027,248027,248028,0,1,3
70771,4,1,248031,248031,248032,0,1,3
70772,6,3,248037,248037,248040,0,3,5
70773,3,1,248040,248040,248041,0,1,0
70774,5,2,248045,248045,248047,0,2,4
70775,4,1,248049,248049,248050,0,1,2
70776,1,3,248050,248050,248053,0,3,0
70777,1,3,248051,248053,248056,2,5,0
70778,5,3,248056,248056,248059,0,3,0
70779,5,3,248061,248061,248064,0,3,2
70780,6,1,248067,248067,248068,0,1,3
70781,2,3,248069,248069,248072,0,3,1
70782,3,2,248072,248072,248074,0,2,0
70783,6,3,248078,248078,248081,0,3,4
70784,4,1,248082,248082,248083,0,1,1
70785,2,3,248084,248084,248087,0,3,1
70786,3,3,248087,248087,248090,0,3,0
70787,1,1,248088,248090,248091,2,3,0
70788,4,1,248092,248092,248093,0,1,1
70789,5,1,248097,248097,248098,0,1,4
70790,1,2,248098,248098,248100,0,2,0
70791,4,1,248102,248102,248103,0,1,2
70792,4,3,248106,248106,248109,0,3,3
70793,1,1,248107,248109,248110,2,3,0
70794,3,2,248110,248110,248112,0,2,0
70795,4,1,248114,248114,248115,0,1,2
70796,2,3,248116,248116,248119,0,3,1
70797,2,3,248118,248119,248122,1,4,0
70798,1,1,248119,248122,248123,3,4,0
70799,1,3,248120,248123,248126,3,6,0
70800,4,2,248124,248126,248128,2,4,0
70801,6,1,248130,248130,248131,0,1,2
70802,2,1,248132,248132,248133,0,1,1
70803,6,1,248138,248138,248139,0,1,5
70804,2,1,248140,248140,248141,0,1,1
70805,1,2,248141,248141,248143,0,2,0
70806,4,3,248145,248145,248148,0,3,2
70807,1,2,248146,248148,248150,2,4,0
70808,6,3,248152,248152,248155,0,3,2
70809,3,2,248155,248155,248157,0,2,0
70810,2,2,248157,248157,248159,0,2,0
70811,4,2,248161,248161,248163,0,2,2
70812,6,3,248167,248167,248170,0,3,4
70813,6,1,248173,248173,248174,0,1,3
70814,2,1,248175,248175,248176,0,1,1
70815,4,3,248179,248179,248182,0,3,3
70816,6,3,248185,248185,248188,0,3,3
70817,4,1,248189,248189,248190,0,1,1
70818,3,2,248192,248192,248194,0,2,2
70819,2,2,248194,248194,248196,0,2,0
70820,1,2,248195,248196,248198,1,3,0
70821,4,1,248199,248199,248200,0,1,1
70822,6,3,248205,248205,248208,0,3,5
70823,1,1,248206,248208,248209,2,3,0
70824,5,1,248211,248211,248212,0,1,2
70825,4,2,248215,248215,248217,0,2,3
70826,3,2,248218,248218,248220,0,2,1
70827,3,2,248221,248221,248223,0,2,1
70828,5,1,248226,248226,248227,0,1,3
70829,6,2,248232,248232,248234,0,2,5
70830,3,1,248235,248235,248236,0,1,1
70831,2,1,248237,248237,248238,0,1,1
70832,3,3,248240,248240,248243,0,3,2
70833,6,2,248246,248246,248248,0,2,3
70834,4,2,248250,248250,248252,0,2,2
70835,6,2,248256,248256,248258,0,2,4
70836,4,3,248260,248260,248263,0,3,2
70837,5,3,248265,248265,248268,0,3,2
70838,2,1,248267,248268,248269,1,2,0
70839,1,2,248268,248269,248271,1,3,0
70840,3,1,248271,248271,248272,0,1,0
70841,6,3,248277,248277,248280,0,3,5
70842,4,3,248281,248281,248284,0,3,1
70843,6,1,248287,248287,248288,0,1,3
70844,6,3,248293,248293,248296,0,3,5
70845,6,1,248299,248299,248300,0,1,3
70846,6,3,248305,248305,248308,0,3,5
70847,5,2,248310,248310,248312,0,2,2
70848,3,1,248313,248313,248314,0,1,1
70849,2,3,248315,248315,248318,0,3,1
70850,1,1,248316,248318,248319,2,3,0
70851,5,3,248321,248321,248324,0,3,2
70852,1,3,248322,248324,248327,2,5,0
70853,5,1,248327,248327,248328,0,1,0
70854,3,3,248330,248330,248333,0,3,2
70855,6,2,248336,248336,248338,0,2,3
70856,4,3,248340,248340,248343,0,3,2
70857,5,3,248345,248345,248348,0,3,2
70858,2,1,248347,248348,248349,1,2,0
70859,1,2,248348,248349,248351,1,3,0
70860,1,2,248349,248351,248353,2,4,0
70861,5,2,248354,248354,248356,0,2,1
70862,1,3,248355,248356,248359,1,4,0
70863,6,1,248361,248361,248362,0,1,2
70864,6,1,248367,248367,248368,0,1,5
70865,1,2,248368,248368,248370,0,2,0
70866,4,1,248372,248372,248373,0,1,2
70867,6,2,248378,248378,248380,0,2,5
70868,6,1,248384,248384,248385,0,1,4
70869,4,2,248388,248388,248390,0,2,3
70870,1,1,248389,248390,248391,1,2,0
70871,5,1,248394,248394,248395,0,1,3
70872,1,2,248395,248395,248397,0,2,0
70873,6,3,248401,248401,248404,0,3,4
70874,4,1,248405,248405,248406,0,1,1
70875,5,1,248410,248410,248411,0,1,4
70876,1,2,248411,248411,248413,0,2,0
70877,6,1,248417,248417,248418,0,1,4
70878,2,3,248419,248419,248422,0,3,1
70879,1,3,248420,248422,248425,2,5,0
70880,2,2,248422,248425,248427,3,5,0
70881,1,1,248423,248427,248428,4,5,0
70882,1,3,248424,248428,248431,4,7,0
70883,3,1,248427,248431,248432,4,5,0
70884,3,3,248430,248432,248435,2,5,0
70885,5,3,248435,248435,248438,0,3,0
70886,4,1,248439,248439,248440,0,1,1
70887,5,1,248444,248444,248445,0,1,4
70888,5,1,248449,248449,248450,0,1,4
70889,3,1,248452,248452,248453,0,1,2
70890,2,2,248454,248454,248456,0,2,1
70891,1,2,248455,248456,248458,1,3,0
70892,4,3,248459,248459,248462,0,3,1
70893,4,1,248463,248463,248464,0,1,1
70894,1,2,248464,248464,248466,0,2,0
70895,6,1,248470,248470,248471,0,1,4
70896,2,3,248472,248472,248475,0,3,1
70897,1,1,248473,248475,248476,2,3,0
70898,3,1,248476,248476,248477,0,1,0
70899,3,2,248479,248479,248481,0,2,2
70900,2,1,248481,248481,248482,0,1,0
70901,1,2,248482,248482,248484,0,2,0
70902,4,3,248486,248486,248489,0,3,2
70903,4,3,248490,248490,248493,0,3,1
70904,1,3,248491,248493,248496,2,5,0
70905,6,3,248497,248497,248500,0,3,1
70906,3,2,248500,248500,248502,0,2,0
70907,6,1,248506,248506,248507,0,1,4
70908,2,1,248508,248508,248509,0,1,1
70909,1,3,248509,248509,248512,0,3,0
70910,4,3,248513,248513,248516,0,3,1
70911,2,1,248515,248516,248517,1,2,0
70912,3,3,248518,248518,248521,0,3,1
70913,1,2,248519,248521,248523,2,4,0
70914,1,1,248520,248523,248524,3,4,0
70915,3,1,248523,248524,248525,1,2,0
70916,1,3,248524,248525,248528,1,4,0
70917,2,1,248526,248528,248529,2,3,0
70918,1,3,248527,248529,248532,2,5,0
70919,1,2,248528,248532,248534,4,6,0
70920,3,3,248531,248534,248537,3,6,0
70921,4,3,248535,248537,248540,2,5,0
70922,1,3,248536,248540,248543,4,7,0
70923,4,3,248540,248543,248546,3,6,0
70924,5,3,248545,248546,248549,1,4,0
70925,5,1,248550,248550,248551,0,1,1
70926,1,3,248551,248551,248554,0,3,0
70927,5,3,248556,248556,248559,0,3,2
70928,5,2,248561,248561,248563,0,2,2
70929,5,2,248566,248566,248568,0,2,3
70930,4,2,248570,248570,248572,0,2,2
70931,6,2,248576,248576,248578,0,2,4
70932,3,3,248579,248579,248582,0,3,1
70933,6,2,248585,248585,248587,0,2,3
70934,1,1,248586,248587,248588,1,2,0
70935,4,3,248590,248590,248593,0,3,2
70936,5,1,248595,248595,248596,0,1,2
70937,2,2,248597,248597,248599,0,2,1
70938,5,2,248602,248602,248604,0,2,3
70939,1,3,248603,248604,248607,1,4,0
70940,2,3,248605,248607,248610,2,5,0
70941,1,1,248606,248610,248611,4,5,0
70942,5,2,248611,248611,248613,0,2,0
70943,1,1,248612,248613,248614,1,2,0
70944,5,1,248617,248617,248618,0,1,3
70945,2,1,248619,248619,248620,0,1,1
70946,1,2,248620,248620,248622,0,2,0
70947,2,2,248622,248622,248624,0,2,0
70948,2,2,248624,248624,248626,0,2,0
70949,2,3,248626,248626,248629,0,3,0
70950,5,2,248631,248631,248633,0,2,2
70951,4,2,248635,248635,248637,0,2,2
70952,1,1,248636,248637,248638,1,2,0
70953,3,3,248639,248639,248642,0,3,1
70954,2,1,248641,248642,248643,1,2,0
70955,6,2,248647,248647,248649,0,2,4
70956,6,1,248653,248653,248654,0,1,4
70957,6,1,248659,248659,248660,0,1,5
70958,4,2,248663,248663,248665,0,2,3
70959,4,3,248667,248667,248670,0,3,2
70960,5,3,248672,248672,248675,0,3,2
70961,4,3,248676,248676,248679,0,3,1
70962,1,2,248677,248679,248681,2,4,0
70963,6,3,248683,248683,248686,0,3,2
70964,2,2,248685,248686,248688,1,3,0
70965,3,2,248688,248688,248690,0,2,0
70966,3,2,248691,248691,248693,0,2,1
70967,1,2,248692,248693,248695,1,3,0
70968,6,1,248698,248698,248699,0,1,3
70969,3,2,248701,248701,248703,0,2,2
70970,6,1,248707,248707,248708,0,1,4
70971,2,1,248709,248709,248710,0,1,1
70972,6,1,248715,248715,248716,0,1,5
70973,5,3,248720,248720,248723,0,3,4
70974,3,2,248723,248723,248725,0,2,0
70975,1,1,248724,248725,248726,1,2,0
70976,2,2,248726,248726,248728,0,2,0
70977,4,2,248730,248730,248732,0,2,2
70978,1,1,248731,248732,248733,1,2,0
70979,4,3,248735,248735,248738,0,3,2
70980,5,2,248740,248740,248742,0,2,2
70981,6,2,248746,248746,248748,0,2,4
70982,4,1,248750,248750,248751,0,1,2
70983,4,2,248754,248754,248756,0,2,3
70984,2,1,248756,248756,248757,0,1,0
70985,5,2,248761,248761,248763,0,2,4
70986,3,1,248764,248764,248765,0,1,1
70987,1,1,248765,248765,248766,0,1,0
70988,4,2,248769,248769,248771,0,2,3
70989,4,3,248773,248773,248776,0,3,2
70990,6,3,248779,248779,248782,0,3,3
70991,4,2,248783,248783,248785,0,2,1
70992,5,2,248788,248788,248790,0,2,3
70993,3,3,248791,248791,248794,0,3,1
70994,4,3,248795,248795,248798,0,3,1
70995,5,1,248800,248800,248801,0,1,2
70996,5,2,248805,248805,248807,0,2,4
70997,3,2,248808,248808,248810,0,2,1
70998,3,1,248811,248811,248812,0,1,1
70999,3,1,248814,248814,248815,0,1,2
71000,4,2,248818,248818,248820,0,2,3
71001,6,3,248824,248824,248827,0,3,4
71002,1,1,248825,248827,248828,2,3,0
71003,6,3,248831,248831,248834,0,3,3
71004,3,2,248834,248834,248836,0,2,0
71005,2,2,248836,248836,248838,0,2,0
71006,4,3,248840,248840,248843,0,3,2
71007,4,1,248844,248844,248845,0,1,1
71008,6,2,248850,248850,248852,0,2,5
71009,5,3,248855,248855,248858,0,3,3
71010,2,3,248857,248858,248861,1,4,0
71011,1,1,248858,248861,248862,3,4,0
71012,1,1,248859,248862,248863,3,4,0
71013,4,3,248863,248863,248866,0,3,0
71014,5,3,248868,248868,248871,0,3,2
71015,3,2,248871,248871,248873,0,2,0
71016,2,3,248873,248873,248876,0,3,0
71017,5,3,248878,248878,248881,0,3,2
71018,6,2,248884,248884,248886,0,2,3
71019,5,3,248889,248889,248892,0,3,3
71020,2,3,248891,248892,248895,1,4,0
71021,1,1,248892,248895,248896,3,4,0
71022,2,3,248894,248896,248899,2,5,0
71023,1,3,248895,248899,248902,4,7,0
71024,3,2,248898,248902,248904,4,6,0
71025,3,1,248901,248904,248905,3,4,0
71026,5,3,248906,248906,248909,0,3,1
71027,2,1,248908,248909,248910,1,2,0
71028,1,1,248909,248910,248911,1,2,0
71029,6,3,248915,248915,248918,0,3,4
71030,3,3,248918,248918,248921,0,3,0
71031,5,3,248923,248923,248926,0,3,2
71032,5,2,248928,248928,248930,0,2,2
71033,1,3,248929,248930,248933,1,4,0
71034,5,3,248934,248934,248937,0,3,1
71035,5,1,248939,248939,248940,0,1,2
71036,4,3,248943,248943,248946,0,3,3
71037,1,3,248944,248946,248949,2,5,0
71038,1,1,248945,248949,248950,4,5,0
71039,4,3,248949,248950,248953,1,4,0
71040,5,1,248954,248954,248955,0,1,1
71041,6,2,248960,248960,248962,0,2,5
71042,2,1,248962,248962,248963,0,1,0
71043,5,3,248967,248967,248970,0,3,4
71044,5,3,248972,248972,248975,0,3,2
71045,3,3,248975,248975,248978,0,3,0
71046,5,1,248980,248980,248981,0,1,2
71047,1,3,248981,248981,248984,0,3,0
71048,3,3,248984,248984,248987,0,3,0
71049,3,2,248987,248987,248989,0,2,0
71050,4,3,248991,248991,248994,0,3,2
71051,3,3,248994,248994,248997,0,3,0
71052,3,3,248997,248997,249000,0,3,0
71053,5,1,249002,249002,249003,0,1,2
71054,5,1,249007,249007,249008,0,1,4
71055,5,1,249012,249012,249013,0,1,4
71056,5,3,249017,249017,249020,0,3,4
71057,5,2,249022,249022,249024,0,2,2
71058,6,2,249028,249028,249030,0,2,4
71059,5,2,249033,249033,249035,0,2,3
71060,1,1,249034,249035,249036,1,2,0
71061,1,3,249035,249036,249039,1,4,0
71062,5,1,249040,249040,249041,0,1,1
71063,4,2,249044,249044,249046,0,2,3
71064,2,2,249046,249046,249048,0,2,0
71065,4,1,249050,249050,249051,0,1,2
71066,3,3,249053,249053,249056,0,3,2
71067,2,3,249055,249056,249059,1,4,0
71068,1,3,249056,249059,249062,3,6,0
71069,2,2,249058,249062,249064,4,6,0
71070,6,3,249064,249064,249067,0,3,0
71071,1,2,249065,249067,249069,2,4,0
71072,1,2,249066,249069,249071,3,5,0
71073,6,3,249072,249072,249075,0,3,1
71074,5,2,249077,249077,249079,0,2,2
71075,1,3,249078,249079,249082,1,4,0
71076,1,3,249079,249082,249085,3,6,0
71077,4,1,249083,249085,249086,2,3,0
71078,1,1,249084,249086,249087,2,3,0
71079,5,2,249089,249089,249091,0,2,2
71080,1,1,249090,249091,249092,1,2,0
71081,5,2,249095,249095,249097,0,2,3
71082,5,1,249100,249100,249101,0,1,3
71083,1,1,249101,249101,249102,0,1,0
71084,5,2,249106,249106,249108,0,2,4
71085,1,1,249107,249108,249109,1,2,0
71086,4,2,249111,249111,249113,0,2,2
71087,5,2,249116,249116,249118,0,2,3
71088,2,2,249118,249118,249120,0,2,0
71089,6,3,249124,249124,249127,0,3,4
71090,2,1,249126,249127,249128,1,2,0
71091,4,1,249130,249130,249131,0,1,2
71092,2,1,249132,249132,249133,0,1,1
71093,6,2,249138,249138,249140,0,2,5
71094,2,3,249140,249140,249143,0,3,0
71095,4,3,249144,249144,249147,0,3,1
71096,2,1,249146,249147,249148,1,2,0
71097,4,2,249150,249150,249152,0,2,2
71098,6,3,249156,249156,249159,0,3,4
71099,1,3,249157,249159,249162,2,5,0
71100,1,3,249158,249162,249165,4,7,0
71101,3,3,249161,249165,249168,4,7,0
71102,5,3,249166,249168,249171,2,5,0
71103,4,2,249170,249171,249173,1,3,0
71104,4,2,249174,249174,249176,0,2,1
71105,5,2,249179,249179,249181,0,2,3
71106,6,3,249185,249185,249188,0,3,4
71107,4,1,249189,249189,249190,0,1,1
71108,5,1,249194,249194,249195,0,1,4
71109,6,1,249200,249200,249201,0,1,5
71110,4,3,249204,249204,249207,0,3,3
71111,5,2,249209,249209,249211,0,2,2
71112,1,3,249210,249211,249214,1,4,0
71113,4,2,249214,249214,249216,0,2,0
71114,4,3,249218,249218,249221,0,3,2
71115,3,3,249221,249221,249224,0,3,0
71116,1,3,249222,249224,249227,2,5,0
71117,3,2,249225,249227,249229,2,4,0
71118,3,3,249228,249229,249232,1,4,0
71119,5,2,249233,249233,249235,0,2,1
71120,3,2,249236,249236,249238,0,2,1
71121,1,1,249237,249238,249239,1,2,0
71122,3,3,249240,249240,249243,0,3,1
71123,6,2,249246,249246,249248,0,2,3
71124,2,2,249248,249248,249250,0,2,0
71125,1,1,249249,249250,249251,1,2,0
71126,2,1,249251,249251,249252,0,1,0
71127,2,2,249253,249253,249255,0,2,1
71128,1,2,249254,249255,249257,1,3,0
71129,3,1,249257,249257,249258,0,1,0
71130,1,2,249258,249258,249260,0,2,0
71131,2,2,249260,249260,249262,0,2,0
71132,6,2,249266,249266,249268,0,2,4
71133,6,2,249272,249272,249274,0,2,4
71134,3,1,249275,249275,249276,0,1,1
71135,2,1,249277,249277,249278,0,1,1
71136,3,3,249280,249280,249283,0,3,2
71137,6,3,249286,249286,249289,0,3,3
71138,3,2,249289,249289,249291,0,2,0
71139,1,2,249290,249291,249293,1,3,0
71140,4,1,249294,249294,249295,0,1,1
71141,4,3,249298,249298,249301,0,3,3
71142,2,2,249300,249301,249303,1,3,0
71143,4,2,249304,249304,249306,0,2,1
71144,2,3,249306,249306,249309,0,3,0
71145,4,2,249310,249310,249312,0,2,1
71146,6,1,249316,249316,249317,0,1,4
71147,2,2,249318,249318,249320,0,2,1
71148,4,3,249322,249322,249325,0,3,2
71149,4,3,249326,249326,249329,0,3,1
71150,3,1,249329,249329,249330,0,1,0
71151,4,3,249333,249333,249336,0,3,3
71152,5,2,249338,249338,249340,0,2,2
71153,5,1,249343,249343,249344,0,1,3
71154,3,2,249346,249346,249348,0,2,2
71155,4,1,249350,249350,249351,0,1,2
71156,6,3,249356,249356,249359,0,3,5
71157,1,3,249357,249359,249362,2,5,0
71158,5,2,249362,249362,249364,0,2,0
71159,4,2,249366,249366,249368,0,2,2
71160,2,2,249368,249368,249370,0,2,0
71161,6,2,249374,249374,249376,0,2,4
71162,6,3,249380,249380,249383,0,3,4
71163,1,3,249381,249383,249386,2,5,0
71164,6,3,249387,249387,249390,0,3,1
71165,1,2,249388,249390,249392,2,4,0
71166,2,2,249390,249392,249394,2,4,0
71167,2,3,249392,249394,249397,2,5,0
71168,3,3,249395,249397,249400,2,5,0
71169,2,2,249397,249400,249402,3,5,0
71170,3,3,249400,249402,249405,2,5,0
71171,2,2,249402,249405,249407,3,5,0
71172,5,3,249407,249407,249410,0,3,0
71173,2,3,249409,249410,249413,1,4,0
71174,4,3,249413,249413,249416,0,3,0
71175,2,2,249415,249416,249418,1,3,0
71176,3,2,249418,249418,249420,0,2,0
71177,3,1,249421,249421,249422,0,1,1
71178,4,1,249425,249425,249426,0,1,3
71179,2,2,249427,249427,249429,0,2,1
71180,4,3,249431,249431,249434,0,3,2
71181,4,2,249435,249435,249437,0,2,1
71182,5,3,249440,249440,249443,0,3,3
71183,6,1,249446,249446,249447,0,1,3
71184,2,1,249448,249448,249449,0,1,1
71185,5,2,249453,249453,249455,0,2,4
71186,4,1,249457,249457,249458,0,1,2
71187,3,2,249460,249460,249462,0,2,2
71188,1,3,249461,249462,249465,1,4,0
71189,5,2,249466,249466,249468,0,2,1
71190,3,1,249469,249469,249470,0,1,1
71191,6,2,249475,249475,249477,0,2,5
71192,5,2,249480,249480,249482,0,2,3
71193,1,2,249481,249482,249484,1,3,0
71194,1,3,249482,249484,249487,2,5,0
71195,2,3,249484,249487,249490,3,6,0
71196,5,1,249489,249490,249491,1,2,0
71197,6,3,249495,249495,249498,0,3,4
71198,5,1,249500,249500,249501,0,1,2
71199,1,3,249501,249501,249504,0,3,0
71200,5,2,249506,249506,249508,0,2,2
71201,6,1,249512,249512,249513,0,1,4
71202,2,3,249514,249514,249517,0,3,1
71203,6,2,249520,249520,249522,0,2,3
71204,4,3,249524,249524,249527,0,3,2
71205,6,2,249530,249530,249532,0,2,3
71206,2,3,249532,249532,249535,0,3,0
71207,6,2,249538,249538,249540,0,2,3
71208,2,1,249540,249540,249541,0,1,0
71209,2,2,249542,249542,249544,0,2,1
71210,2,1,249544,249544,249545,0,1,0
71211,5,1,249549,249549,249550,0,1,4
71212,4,3,249553,249553,249556,0,3,3
71213,4,3,249557,249557,249560,0,3,1
71214,6,1,249563,249563,249564,0,1,3
71215,1,3,249564,249564,249567,0,3,0
71216,2,2,249566,249567,249569,1,3,0
71217,2,1,249568,249569,249570,1,2,0
71218,1,3,249569,249570,249573,1,4,0
71219,3,2,249572,249573,249575,1,3,0
71220,1,1,249573,249575,249576,2,3,0
71221,1,1,249574,249576,249577,2,3,0
71222,4,2,249578,249578,249580,0,2,1
71223,5,1,249583,249583,249584,0,1,3
71224,6,3,249589,249589,249592,0,3,5
71225,2,1,249591,249592,249593,1,2,0
71226,5,2,249596,249596,249598,0,2,3
71227,6,3,249602,249602,249605,0,3,4
71228,1,1,249603,249605,249606,2,3,0
71229,1,2,249604,249606,249608,2,4,0
71230,6,1,249610,249610,249611,0,1,2
71231,2,2,249612,249612,249614,0,2,1
71232,6,2,249618,249618,249620,0,2,4
71233,3,1,249621,249621,249622,0,1,1
71234,3,3,249624,249624,249627,0,3,2
71235,5,3,249629,249629,249632,0,3,2
71236,2,2,249631,249632,249634,1,3,0
71237,6,3,249637,249637,249640,0,3,3
71238,6,2,249643,249643,249645,0,2,3
71239,4,3,249647,249647,249650,0,3,2
71240,3,3,249650,249650,249653,0,3,0
71241,1,1,249651,249653,249654,2,3,0
71242,1,2,249652,249654,249656,2,4,0
71243,5,1,249657,249657,249658,0,1,1
71244,6,1,249663,249663,249664,0,1,5
71245,1,1,249664,249664,249665,0,1,0
71246,5,2,249669,249669,249671,0,2,4
71247,3,1,249672,249672,249673,0,1,1
71248,5,3,249677,249677,249680,0,3,4
71249,6,3,249683,249683,249686,0,3,3
71250,3,1,249686,249686,249687,0,1,0
71251,6,1,249692,249692,249693,0,1,5
71252,3,3,249695,249695,249698,0,3,2
71253,3,1,249698,249698,249699,0,1,0
71254,6,3,249704,249704,249707,0,3,5
71255,5,3,249709,249709,249712,0,3,2
71256,6,3,249715,249715,249718,0,3,3
71257,4,3,249719,249719,249722,0,3,1
71258,3,1,249722,249722,249723,0,1,0
71259,4,3,249726,249726,249729,0,3,3
71260,6,1,249732,249732,249733,0,1,3
71261,3,3,249735,249735,249738,0,3,2
71262,5,3,249740,249740,249743,0,3,2
71263,6,2,249746,249746,249748,0,2,3
71264,6,3,249752,249752,249755,0,3,4
71265,1,1,249753,249755,249756,2,3,0
71266,4,3,249757,249757,249760,0,3,1
71267,4,3,249761,249761,249764,0,3,1
71268,4,2,249765,249765,249767,0,2,1
71269,3,2,249768,249768,249770,0,2,1
71270,1,3,249769,249770,249773,1,4,0
71271,3,1,249772,249773,249774,1,2,0
71272,4,3,249776,249776,249779,0,3,2
71273,5,1,249781,249781,249782,0,1,2
71274,5,3,249786,249786,249789,0,3,4
71275,2,2,249788,249789,249791,1,3,0
71276,4,2,249792,249792,249794,0,2,1
71277,4,2,249796,249796,249798,0,2,2
71278,6,3,249802,249802,249805,0,3,4
71279,6,1,249808,249808,249809,0,1,3
71280,6,3,249814,249814,249817,0,3,5
71281,4,1,249818,249818,249819,0,1,1
71282,1,1,249819,249819,249820,0,1,0
71283,1,2,249820,249820,249822,0,2,0
71284,5,1,249825,249825,249826,0,1,3
71285,2,1,249827,249827,249828,0,1,1
71286,2,1,249829,249829,249830,0,1,1
71287,2,3,249831,249831,249834,0,3,1
71288,2,2,249833,249834,249836,1,3,0
71289,1,3,249834,249836,249839,2,5,0
71290,3,1,249837,249839,249840,2,3,0
71291,2,3,249839,249840,249843,1,4,0
71292,4,3,249843,249843,249846,0,3,0
71293,4,2,249847,249847,249849,0,2,1
71294,1,3,249848,249849,249852,1,4,0
71295,6,1,249854,249854,249855,0,1,2
71296,6,2,249860,249860,249862,0,2,5
71297,5,2,249865,249865,249867,0,2,3
71298,3,1,249868,249868,249869,0,1,1
71299,4,1,249872,249872,249873,0,1,3
71300,4,1,249876,249876,249877,0,1,3
71301,1,2,249877,249877,249879,0,2,0
71302,6,1,249883,249883,249884,0,1,4
71303,2,3,249885,249885,249888,0,3,1
71304,6,1,249891,249891,249892,0,1,3
71305,2,1,249893,249893,249894,0,1,1
71306,4,2,249897,249897,249899,0,2,3
71307,4,1,249901,249901,249902,0,1,2
71308,3,2,249904,249904,249906,0,2,2
71309,2,2,249906,249906,249908,0,2,0
71310,1,3,249907,249908,249911,1,4,0
71311,2,2,249909,249911,249913,2,4,0
71312,4,1,249913,249913,249914,0,1,0
71313,4,2,249917,249917,249919,0,2,3
71314,3,3,249920,249920,249923,0,3,1
71315,5,2,249925,249925,249927,0,2,2
71316,6,2,249931,249931,249933,0,2,4
71317,2,2,249933,249933,249935,0,2,0
71318,1,2,249934,249935,249937,1,3,0
71319,3,2,249937,249937,249939,0,2,0
71320,3,1,249940,249940,249941,0,1,1
71321,1,2,249941,249941,249943,0,2,0
71322,6,2,249947,249947,249949,0,2,4
71323,1,3,249948,249949,249952,1,4,0
71324,6,2,249954,249954,249956,0,2,2
71325,3,2,249957,249957,249959,0,2,1
71326,2,3,249959,249959,249962,0,3,0
71327,4,2,249963,249963,249965,0,2,1
71328,2,1,249965,249965,249966,0,1,0
71329,1,3,249966,249966,249969,0,3,0
71330,4,2,249970,249970,249972,0,2,1
71331,5,3,249975,249975,249978,0,3,3
71332,6,2,249981,249981,249983,0,2,3
71333,3,2,249984,249984,249986,0,2,1
71334,4,1,249988,249988,249989,0,1,2
71335,1,1,249989,249989,249990,0,1,0
71336,3,2,249992,249992,249994,0,2,2
71337,6,1,249998,249998,249999,0,1,4
71338,6,2,250004,250004,250006,0,2,5
71339,6,3,250010,250010,250013,0,3,4
71340,4,3,250014,250014,250017,0,3,1
71341,4,2,250018,250018,250020,0,2,1
71342,1,3,250019,250020,250023,1,4,0
71343,1,3,250020,250023,250026,3,6,0
71344,1,3,250021,250026,250029,5,8,0
71345,1,1,250022,250029,250030,7,8,0
71346,1,3,250023,250030,250033,7,10,0
71347,1,2,250024,250033,250035,9,11,0
71348,4,1,250028,250035,250036,7,8,0
71349,3,3,250031,250036,250039,5,8,0
71350,4,1,250035,250039,250040,4,5,0
71351,1,1,250036,250040,250041,4,5,0
71352,5,2,250041,250041,250043,0,2,0
71353,4,3,250045,250045,250048,0,3,2
71354,3,2,250048,250048,250050,0,2,0
71355,6,2,250054,250054,250056,0,2,4
71356,5,1,250059,250059,250060,0,1,3
71357,4,2,250063,250063,250065,0,2,3
71358,2,1,250065,250065,250066,0,1,0
71359,1,2,250066,250066,250068,0,2,0
71360,4,2,250070,250070,250072,0,2,2
71361,4,3,250074,250074,250077,0,3,2
71362,4,3,250078,250078,250081,0,3,1
71363,3,1,250081,250081,250082,0,1,0
71364,3,1,250084,250084,250085,0,1,2
71365,1,2,250085,250085,250087,0,2,0
71366,1,3,250086,250087,250090,1,4,0
71367,3,1,250089,250090,250091,1,2,0
71368,6,3,250095,250095,250098,0,3,4
71369,6,1,250101,250101,250102,0,1,3
71370,2,2,250103,250103,250105,0,2,1
71371,5,1,250108,250108,250109,0,1,3
71372,3,3,250111,250111,250114,0,3,2
71373,5,2,250116,250116,250118,0,2,2
71374,2,2,250118,250118,250120,0,2,0
71375,4,1,250122,250122,250123,0,1,2
71376,5,2,250127,250127,250129,0,2,4
71377,6,1,250133,250133,250134,0,1,4
71378,6,2,250139,250139,250141,0,2,5
71379,4,2,250143,250143,250145,0,2,2
71380,3,1,250146,250146,250147,0,1,1
71381,1,1,250147,250147,250148,0,1,0
71382,1,1,250148,250148,250149,0,1,0
71383,6,2,250154,250154,250156,0,2,5
71384,2,2,250156,250156,250158,0,2,0
71385,2,1,250158,250158,250159,0,1,0
71386,3,3,250161,250161,250164,0,3,2
71387,2,1,250163,250164,250165,1,2,0
71388,4,2,250167,250167,250169,0,2,2
71389,3,2,250170,250170,250172,0,2,1
71390,6,1,250176,250176,250177,0,1,4
71391,4,2,250180,250180,250182,0,2,3
71392,4,3,250184,250184,250187,0,3,2
71393,1,2,250185,250187,250189,2,4,0
71394,5,1,250190,250190,250191,0,1,1
71395,1,3,250191,250191,250194,0,3,0
71396,2,1,250193,250194,250195,1,2,0
71397,1,3,250194,250195,250198,1,4,0
71398,4,3,250198,250198,250201,0,3,0
71399,5,2,250203,250203,250205,0,2,2
71400,5,1,250208,250208,250209,0,1,3
71401,2,2,250210,250210,250212,0,2,1
71402,5,1,250215,250215,250216,0,1,3
71403,1,2,250216,250216,250218,0,2,0
71404,1,1,250217,250218,250219,1,2,0
71405,2,3,250219,250219,250222,0,3,0
71406,1,2,250220,250222,250224,2,4,0
71407,6,3,250226,250226,250229,0,3,2
71408,2,1,250228,250229,250230,1,2,0
71409,6,3,250234,250234,250237,0,3,4
71410,4,3,250238,250238,250241,0,3,1
71411,2,2,250240,250241,250243,1,3,0
71412,5,2,250245,250245,250247,0,2,2
71413,2,2,250247,250247,250249,0,2,0
71414,5,3,250252,250252,250255,0,3,3
71415,2,2,250254,250255,250257,1,3,0
71416,1,1,250255,250257,250258,2,3,0
71417,3,2,250258,250258,250260,0,2,0
71418,4,2,250262,250262,250264,0,2,2
71419,5,2,250267,250267,250269,0,2,3
71420,3,1,250270,250270,250271,0,1,1
71421,3,2,250273,250273,250275,0,2,2
71422,1,3,250274,250275,250278,1,4,0
71423,5,2,250279,250279,250281,0,2,1
71424,4,3,250283,250283,250286,0,3,2
71425,3,1,250286,250286,250287,0,1,0
71426,3,2,250289,250289,250291,0,2,2
71427,5,2,250294,250294,250296,0,2,3
71428,2,3,250296,250296,250299,0,3,0
71429,5,1,250301,250301,250302,0,1,2
71430,5,2,250306,250306,250308,0,2,4
71431,2,2,250308,250308,250310,0,2,0
71432,3,3,250311,250311,250314,0,3,1
71433,3,2,250314,250314,250316,0,2,0
71434,4,1,250318,250318,250319,0,1,2
71435,4,2,250322,250322,250324,0,2,3
71436,6,2,250328,250328,250330,0,2,4
71437,6,2,250334,250334,250336,0,2,4
71438,3,2,250337,250337,250339,0,2,1
71439,3,3,250340,250340,250343,0,3,1
71440,6,1,250346,250346,250347,0,1,3
71441,6,3,250352,250352,250355,0,3,5
71442,4,3,250356,250356,250359,0,3,1
71443,1,1,250357,250359,250360,2,3,0
71444,5,2,250362,250362,250364,0,2,2
71445,2,1,250364,250364,250365,0,1,0
71446,1,2,250365,250365,250367,0,2,0
71447,1,3,250366,250367,250370,1,4,0
71448,5,2,250371,250371,250373,0,2,1
71449,6,1,250377,250377,250378,0,1,4
71450,5,2,250382,250382,250384,0,2,4
71451,1,1,250383,250384,250385,1,2,0
71452,5,3,250388,250388,250391,0,3,3
71453,1,3,250389,250391,250394,2,5,0
71454,6,1,250395,250395,250396,0,1,1
71455,6,1,250401,250401,250402,0,1,5
71456,2,3,250403,250403,250406,0,3,1
71457,1,2,250404,250406,250408,2,4,0
71458,4,2,250408,250408,250410,0,2,0
71459,6,1,250414,250414,250415,0,1,4
71460,3,2,250417,250417,250419,0,2,2
71461,6,2,250423,250423,250425,0,2,4
71462,3,2,250426,250426,250428,0,2,1
71463,4,3,250430,250430,250433,0,3,2
71464,4,1,250434,250434,250435,0,1,1
71465,2,1,250436,250436,250437,0,1,1
71466,5,2,250441,250441,250443,0,2,4
71467,2,3,250443,250443,250446,0,3,0
71468,3,3,250446,250446,250449,0,3,0
71469,4,2,250450,250450,250452,0,2,1
71470,2,3,250452,250452,250455,0,3,0
71471,2,3,250454,250455,250458,1,4,0
71472,2,2,250456,250458,250460,2,4,0
71473,2,2,250458,250460,250462,2,4,0
71474,4,3,250462,250462,250465,0,3,0
71475,2,3,250464,250465,250468,1,4,0
71476,6,1,250470,250470,250471,0,1,2
71477,2,3,250472,250472,250475,0,3,1
71478,1,1,250473,250475,250476,2,3,0
71479,5,2,250478,250478,250480,0,2,2
71480,5,1,250483,250483,250484,0,1,3
71481,5,3,250488,250488,250491,0,3,4
71482,4,2,250492,250492,250494,0,2,1
71483,4,2,250496,250496,250498,0,2,2
71484,2,1,250498,250498,250499,0,1,0
71485,2,3,250500,250500,250503,0,3,1
71486,4,2,250504,250504,250506,0,2,1
71487,2,2,250506,250506,250508,0,2,0
71488,6,3,250512,250512,250515,0,3,4
71489,6,1,250518,250518,250519,0,1,3
71490,6,2,250524,250524,250526,0,2,5
71491,4,1,250528,250528,250529,0,1,2
71492,6,2,250534,250534,250536,0,2,5
71493,4,1,250538,250538,250539,0,1,2
71494,5,2,250543,250543,250545,0,2,4
71495,4,3,250547,250547,250550,0,3,2
71496,3,2,250550,250550,250552,0,2,0
71497,6,3,250556,250556,250559,0,3,4
71498,3,1,250559,250559,250560,0,1,0
71499,6,3,250565,250565,250568,0,3,5
71500,1,1,250566,250568,250569,2,3,0
71501,6,3,250572,250572,250575,0,3,3
71502,2,1,250574,250575,250576,1,2,0
71503,6,3,250580,250580,250583,0,3,4
71504,1,1,250581,250583,250584,2,3,0
71505,2,2,250583,250584,250586,1,3,0
71506,1,3,250584,250586,250589,2,5,0
71507,5,1,250589,250589,250590,0,1,0
71508,5,2,250594,250594,250596,0,2,4
71509,4,2,250598,250598,250600,0,2,2
71510,5,3,250603,250603,250606,0,3,3
71511,3,3,250606,250606,250609,0,3,0
71512,6,2,250612,250612,250614,0,2,3
71513,1,2,250613,250614,250616,1,3,0
71514,6,2,250619,250619,250621,0,2,3
71515,2,3,250621,250621,250624,0,3,0
71516,2,2,250623,250624,250626,1,3,0
71517,2,3,250625,250626,250629,1,4,0
71518,1,2,250626,250629,250631,3,5,0
71519,3,3,250629,250631,250634,2,5,0
71520,6,3,250635,250635,250638,0,3,1
71521,4,3,250639,250639,250642,0,3,1
71522,3,2,250642,250642,250644,0,2,0
71523,6,1,250648,250648,250649,0,1,4
71524,4,3,250652,250652,250655,0,3,3
71525,1,1,250653,250655,250656,2,3,0
71526,4,2,250657,250657,250659,0,2,1
71527,4,3,250661,250661,250664,0,3,2
71528,1,2,250662,250664,250666,2,4,0
71529,2,3,250664,250666,250669,2,5,0
71530,6,2,250670,250670,250672,0,2,1
71531,6,2,250676,250676,250678,0,2,4
71532,6,1,250682,250682,250683,0,1,4
71533,6,2,250688,250688,250690,0,2,5
71534,3,3,250691,250691,250694,0,3,1
71535,1,3,250692,250694,250697,2,5,0
71536,1,1,250693,250697,250698,4,5,0
71537,1,2,250694,250698,250700,4,6,0
71538,3,2,250697,250700,250702,3,5,0
71539,4,3,250701,250702,250705,1,4,0
71540,3,1,250704,250705,250706,1,2,0
71541,5,2,250709,250709,250711,0,2,3
71542,2,3,250711,250711,250714,0,3,0
71543,2,1,250713,250714,250715,1,2,0
71544,2,3,250715,250715,250718,0,3,0
71545,5,1,250720,250720,250721,0,1,2
71546,3,2,250723,250723,250725,0,2,2
71547,3,3,250726,250726,250729,0,3,1
71548,3,1,250729,250729,250730,0,1,0
71549,3,1,250732,250732,250733,0,1,2
71550,2,2,250734,250734,250736,0,2,1
71551,5,1,250739,250739,250740,0,1,3
71552,2,3,250741,250741,250744,0,3,1
71553,1,1,250742,250744,250745,2,3,0
71554,5,1,250747,250747,250748,0,1,2
71555,1,3,250748,250748,250751,0,3,0
71556,2,1,250750,250751,250752,1,2,0
71557,3,2,250753,250753,250755,0,2,1
71558,5,3,250758,250758,250761,0,3,3
71559,4,1,250762,250762,250763,0,1,1
71560,2,1,250764,250764,250765,0,1,1
71561,6,1,250770,250770,250771,0,1,5
71562,4,1,250774,250774,250775,0,1,3
71563,4,3,250778,250778,250781,0,3,3
71564,3,1,250781,250781,250782,0,1,0
71565,3,3,250784,250784,250787,0,3,2
71566,6,1,250790,250790,250791,0,1,3
71567,4,3,250794,250794,250797,0,3,3
71568,3,2,250797,250797,250799,0,2,0
71569,5,2,250802,250802,250804,0,2,3
71570,6,3,250808,250808,250811,0,3,4
71571,2,1,250810,250811,250812,1,2,0
71572,4,3,250814,250814,250817,0,3,2
71573,2,2,250816,250817,250819,1,3,0
71574,1,1,250817,250819,250820,2,3,0
71575,6,1,250823,250823,250824,0,1,3
71576,6,2,250829,250829,250831,0,2,5
71577,2,3,250831,250831,250834,0,3,0
71578,5,2,250836,250836,250838,0,2,2
71579,4,2,250840,250840,250842,0,2,2
71580,3,2,250843,250843,250845,0,2,1
71581,4,1,250847,250847,250848,0,1,2
71582,6,3,250853,250853,250856,0,3,5
71583,3,2,250856,250856,250858,0,2,0
71584,3,2,250859,250859,250861,0,2,1
71585,1,2,250860,250861,250863,1,3,0
71586,1,3,250861,250863,250866,2,5,0
71587,3,1,250864,250866,250867,2,3,0
71588,6,1,250870,250870,250871,0,1,3
71589,1,1,250871,250871,250872,0,1,0
71590,2,3,250873,250873,250876,0,3,1
71591,2,1,250875,250876,250877,1,2,0
71592,1,3,250876,250877,250880,1,4,0
71593,3,1,250879,250880,250881,1,2,0
71594,4,3,250883,250883,250886,0,3,2
71595,5,2,250888,250888,250890,0,2,2
71596,6,2,250894,250894,250896,0,2,4
71597,4,1,250898,250898,250899,0,1,2
71598,6,3,250904,250904,250907,0,3,5
71599,5,1,250909,250909,250910,0,1,2
71600,5,2,250914,250914,250916,0,2,4
71601,4,2,250918,250918,250920,0,2,2
71602,5,1,250923,250923,250924,0,1,3
71603,3,3,250926,250926,250929,0,3,2
71604,5,3,250931,250931,250934,0,3,2
71605,4,2,250935,250935,250937,0,2,1
71606,6,1,250941,250941,250942,0,1,4
71607,1,2,250942,250942,250944,0,2,0
71608,1,1,250943,250944,250945,1,2,0
71609,1,3,250944,250945,250948,1,4,0
71610,6,1,250950,250950,250951,0,1,2
71611,2,1,250952,250952,250953,0,1,1
71612,1,2,250953,250953,250955,0,2,0
71613,4,3,250957,250957,250960,0,3,2
71614,5,1,250962,250962,250963,0,1,2
71615,6,2,250968,250968,250970,0,2,5
71616,2,2,250970,250970,250972,0,2,0
71617,5,2,250975,250975,250977,0,2,3
71618,5,3,250980,250980,250983,0,3,3
71619,6,1,250986,250986,250987,0,1,3
71620,3,2,250989,250989,250991,0,2,2
71621,1,3,250990,250991,250994,1,4,0
71622,1,1,250991,250994,250995,3,4,0
71623,2,1,250993,250995,250996,2,3,0
71624,4,1,250997,250997,250998,0,1,1
71625,5,3,251002,251002,251005,0,3,4
71626,3,1,251005,251005,251006,0,1,0
71627,1,3,251006,251006,251009,0,3,0
71628,6,2,251012,251012,251014,0,2,3
71629,1,1,251013,251014,251015,1,2,0
71630,3,1,251016,251016,251017,0,1,1
71631,3,1,251019,251019,251020,0,1,2
71632,3,2,251022,251022,251024,0,2,2
71633,2,3,251024,251024,251027,0,3,0
71634,5,3,251029,251029,251032,0,3,2
71635,4,3,251033,251033,251036,0,3,1
71636,6,3,251039,251039,251042,0,3,3
71637,6,2,251045,251045,251047,0,2,3
71638,2,2,251047,251047,251049,0,2,0
71639,5,1,251052,251052,251053,0,1,3
71640,1,3,251053,251053,251056,0,3,0
71641,1,3,251054,251056,251059,2,5,0
71642,4,1,251058,251059,251060,1,2,0
71643,4,3,251062,251062,251065,0,3,2
71644,1,3,251063,251065,251068,2,5,0
71645,6,2,251069,251069,251071,0,2,1
71646,3,2,251072,251072,251074,0,2,1
71647,3,2,251075,251075,251077,0,2,1
71648,1,2,251076,251077,251079,1,3,0
71649,1,3,251077,251079,251082,2,5,0
71650,3,3,251080,251082,251085,2,5,0
71651,1,3,251081,251085,251088,4,7,0
71652,2,1,251083,251088,251089,5,6,0
71653,3,2,251086,251089,251091,3,5,0
71654,5,1,251091,251091,251092,0,1,0
71655,1,2,251092,251092,251094,0,2,0
71656,2,3,251094,251094,251097,0,3,0
71657,1,2,251095,251097,251099,2,4,0
71658,2,2,251097,251099,251101,2,4,0
71659,4,2,251101,251101,251103,0,2,0
71660,1,2,251102,251103,251105,1,3,0
71661,3,1,251105,251105,251106,0,1,0
71662,3,3,251108,251108,251111,0,3,2
71663,6,3,251114,251114,251117,0,3,3
71664,3,3,251117,251117,251120,0,3,0
71665,1,3,251118,251120,251123,2,5,0
71666,3,2,251121,251123,251125,2,4,0
71667,3,3,251124,251125,251128,1,4,0
71668,5,2,251129,251129,251131,0,2,1
71669,4,3,251133,251133,251136,0,3,2
71670,2,3,251135,251136,251139,1,4,0
71671,6,2,251141,251141,251143,0,2,2
71672,4,2,251145,251145,251147,0,2,2
71673,5,2,251150,251150,251152,0,2,3
71674,5,3,251155,251155,251158,0,3,3
71675,5,3,251160,251160,251163,0,3,2
71676,6,3,251166,251166,251169,0,3,3
71677,5,1,251171,251171,251172,0,1,2
71678,4,3,251175,251175,251178,0,3,3
71679,6,2,251181,251181,251183,0,2,3
71680,4,2,251185,251185,251187,0,2,2
71681,1,3,251186,251187,251190,1,4,0
71682,5,3,251191,251191,251194,0,3,1
71683,5,1,251196,251196,251197,0,1,2
71684,4,1,251200,251200,251201,0,1,3
71685,4,1,251204,251204,251205,0,1,3
71686,2,3,251206,251206,251209,0,3,1
71687,5,1,251211,251211,251212,0,1,2
71688,6,3,251217,251217,251220,0,3,5
71689,6,3,251223,251223,251226,0,3,3
71690,1,2,251224,251226,251228,2,4,0
71691,2,1,251226,251228,251229,2,3,0
71692,4,2,251230,251230,251232,0,2,1
71693,1,3,251231,251232,251235,1,4,0
71694,3,2,251234,251235,251237,1,3,0
71695,2,2,251236,251237,251239,1,3,0
71696,2,2,251238,251239,251241,1,3,0
71697,3,3,251241,251241,251244,0,3,0
71698,4,2,251245,251245,251247,0,2,1
71699,5,3,251250,251250,251253,0,3,3
71700,5,1,251255,251255,251256,0,1,2
71701,1,1,251256,251256,251257,0,1,0
71702,1,1,251257,251257,251258,0,1,0
71703,5,3,251262,251262,251265,0,3,4
71704,2,2,251264,251265,251267,1,3,0
71705,5,3,251269,251269,251272,0,3,2
71706,1,1,251270,251272,251273,2,3,0
71707,4,1,251274,251274,251275,0,1,1
71708,1,2,251275,251275,251277,0,2,0
71709,5,3,251280,251280,251283,0,3,3
71710,2,2,251282,251283,251285,1,3,0
71711,3,1,251285,251285,251286,0,1,0
71712,3,2,251288,251288,251290,0,2,2
71713,5,1,251293,251293,251294,0,1,3
71714,3,1,251296,251296,251297,0,1,2
71715,2,3,251298,251298,251301,0,3,1
71716,5,3,251303,251303,251306,0,3,2
71717,3,1,251306,251306,251307,0,1,0
71718,2,2,251308,251308,251310,0,2,1
71719,6,3,251314,251314,251317,0,3,4
71720,2,3,251316,251317,251320,1,4,0
71721,1,2,251317,251320,251322,3,5,0
71722,3,3,251320,251322,251325,2,5,0
71723,5,2,251325,251325,251327,0,2,0
71724,2,3,251327,251327,251330,0,3,0
71725,4,2,251331,251331,251333,0,2,1
71726,2,1,251333,251333,251334,0,1,0
71727,5,2,251338,251338,251340,0,2,4
71728,6,1,251344,251344,251345,0,1,4
71729,5,3,251349,251349,251352,0,3,4
71730,5,3,251354,251354,251357,0,3,2
71731,5,2,251359,251359,251361,0,2,2
71732,4,2,251363,251363,251365,0,2,2
71733,1,2,251364,251365,251367,1,3,0
71734,4,1,251368,251368,251369,0,1,1
71735,3,3,251371,251371,251374,0,3,2
71736,5,1,251376,251376,251377,0,1,2
71737,3,3,251379,251379,251382,0,3,2
71738,3,2,251382,251382,251384,0,2,0
71739,6,2,251388,251388,251390,0,2,4
71740,3,3,251391,251391,251394,0,3,1
71741,6,2,251397,251397,251399,0,2,3
71742,1,2,251398,251399,251401,1,3,0
71743,2,3,251400,251401,251404,1,4,0
71744,1,1,251401,251404,251405,3,4,0
71745,6,2,251407,251407,251409,0,2,2
71746,6,2,251413,251413,251415,0,2,4
71747,4,1,251417,251417,251418,0,1,2
71748,3,3,251420,251420,251423,0,3,2
71749,6,1,251426,251426,251427,0,1,3
71750,6,1,251432,251432,251433,0,1,5
71751,1,2,251433,251433,251435,0,2,0
71752,3,1,251436,251436,251437,0,1,1
71753,4,2,251440,251440,251442,0,2,3
71754,1,2,251441,251442,251444,1,3,0
71755,6,1,251447,251447,251448,0,1,3
71756,1,2,251448,251448,251450,0,2,0
71757,2,1,251450,251450,251451,0,1,0
71758,1,3,251451,251451,251454,0,3,0
71759,5,1,251456,251456,251457,0,1,2
71760,3,3,251459,251459,251462,0,3,2
71761,4,3,251463,251463,251466,0,3,1
71762,3,2,251466,251466,251468,0,2,0
71763,3,1,251469,251469,251470,0,1,1
71764,6,1,251475,251475,251476,0,1,5
71765,3,1,251478,251478,251479,0,1,2
71766,6,2,251484,251484,251486,0,2,5
71767,3,2,251487,251487,251489,0,2,1
71768,3,1,251490,251490,251491,0,1,1
71769,3,2,251493,251493,251495,0,2,2
71770,4,1,251497,251497,251498,0,1,2
71771,2,1,251499,251499,251500,0,1,1
71772,6,3,251505,251505,251508,0,3,5
71773,1,3,251506,251508,251511,2,5,0
71774,3,3,251509,251511,251514,2,5,0
71775,1,2,251510,251514,251516,4,6,0
71776,5,3,251515,251516,251519,1,4,0
71777,4,1,251519,251519,251520,0,1,0
71778,2,2,251521,251521,251523,0,2,1
71779,6,1,251527,251527,251528,0,1,4
71780,4,1,251531,251531,251532,0,1,3
71781,2,2,251533,251533,251535,0,2,1
71782,4,2,251537,251537,251539,0,2,2
71783,3,3,251540,251540,251543,0,3,1
71784,3,3,251543,251543,251546,0,3,0
71785,5,1,251548,251548,251549,0,1,2
71786,4,2,251552,251552,251554,0,2,3
71787,1,1,251553,251554,251555,1,2,0
71788,2,2,251555,251555,251557,0,2,0
71789,5,3,251560,251560,251563,0,3,3
71790,4,3,251564,251564,251567,0,3,1
71791,3,2,251567,251567,251569,0,2,0
71792,3,3,251570,251570,251573,0,3,1
71793,5,2,251575,251575,251577,0,2,2
71794,2,2,251577,251577,251579,0,2,0
71795,2,1,251579,251579,251580,0,1,0
71796,2,1,251581,251581,251582,0,1,1
71797,5,3,251586,251586,251589,0,3,4
71798,4,3,251590,251590,251593,0,3,1
71799,4,2,251594,251594,251596,0,2,1
71800,5,1,251599,251599,251600,0,1,3
71801,3,2,251602,251602,251604,0,2,2
71802,2,3,251604,251604,251607,0,3,0
71803,3,1,251607,251607,251608,0,1,0
71804,3,2,251610,251610,251612,0,2,2
71805,5,2,251615,251615,251617,0,2,3
71806,4,1,251619,251619,251620,0,1,2
71807,5,3,251624,251624,251627,0,3,4
71808,1,2,251625,251627,251629,2,4,0
71809,3,3,251628,251629,251632,1,4,0
71810,1,1,251629,251632,251633,3,4,0
71811,1,3,251630,251633,251636,3,6,0
71812,2,3,251632,251636,251639,4,7,0
71813,1,2,251633,251639,251641,6,8,0
71814,2,2,251635,251641,251643,6,8,0
71815,4,2,251639,251643,251645,4,6,0
71816,6,2,251645,251645,251647,0,2,0
71817,2,2,251647,251647,251649,0,2,0
71818,5,1,251652,251652,251653,0,1,3
71819,6,3,251658,251658,251661,0,3,5
71820,4,3,251662,251662,251665,0,3,1
71821,5,1,251667,251667,251668,0,1,2
71822,4,2,251671,251671,251673,0,2,3
71823,3,1,251674,251674,251675,0,1,1
71824,1,1,251675,251675,251676,0,1,0
71825,1,2,251676,251676,251678,0,2,0
71826,4,1,251680,251680,251681,0,1,2
71827,3,1,251683,251683,251684,0,1,2
71828,2,2,251685,251685,251687,0,2,1
71829,5,3,251690,251690,251693,0,3,3
71830,1,3,251691,251693,251696,2,5,0
71831,4,2,251695,251696,251698,1,3,0
71832,2,3,251697,251698,251701,1,4,0
71833,6,2,251703,251703,251705,0,2,2
71834,6,3,251709,251709,251712,0,3,4
71835,5,1,251714,251714,251715,0,1,2
71836,6,1,251720,251720,251721,0,1,5
71837,2,1,251722,251722,251723,0,1,1
71838,5,2,251727,251727,251729,0,2,4
71839,1,1,251728,251729,251730,1,2,0
71840,1,1,251729,251730,251731,1,2,0
71841,4,2,251733,251733,251735,0,2,2
71842,3,1,251736,251736,251737,0,1,1
71843,2,2,251738,251738,251740,0,2,1
71844,2,1,251740,251740,251741,0,1,0
71845,6,1,251746,251746,251747,0,1,5
71846,3,1,251749,251749,251750,0,1,2
71847,3,1,251752,251752,251753,0,1,2
71848,3,2,251755,251755,251757,0,2,2
71849,1,3,251756,251757,251760,1,4,0
71850,2,1,251758,251760,251761,2,3,0
71851,3,2,251761,251761,251763,0,2,0
71852,2,2,251763,251763,251765,0,2,0
71853,3,2,251766,251766,251768,0,2,1
71854,6,2,251772,251772,251774,0,2,4
71855,6,3,251778,251778,251781,0,3,4
71856,2,1,251780,251781,251782,1,2,0
71857,3,1,251783,251783,251784,0,1,1
71858,4,1,251787,251787,251788,0,1,3
71859,2,1,251789,251789,251790,0,1,1
71860,1,3,251790,251790,251793,0,3,0
71861,2,1,251792,251793,251794,1,2,0
71862,2,3,251794,251794,251797,0,3,0
71863,6,2,251800,251800,251802,0,2,3
71864,4,3,251804,251804,251807,0,3,2
71865,1,3,251805,251807,251810,2,5,0
71866,5,2,251810,251810,251812,0,2,0
71867,6,1,251816,251816,251817,0,1,4
71868,6,3,251822,251822,251825,0,3,5
71869,2,1,251824,251825,251826,1,2,0
71870,2,1,251826,251826,251827,0,1,0
71871,3,3,251829,251829,251832,0,3,2
71872,3,3,251832,251832,251835,0,3,0
71873,5,3,251837,251837,251840,0,3,2
71874,2,2,251839,251840,251842,1,3,0
71875,6,2,251845,251845,251847,0,2,3
71876,1,3,251846,251847,251850,1,4,0
71877,6,3,251852,251852,251855,0,3,2
71878,4,2,251856,251856,251858,0,2,1
71879,3,2,251859,251859,251861,0,2,1
71880,3,1,251862,251862,251863,0,1,1
71881,6,3,251868,251868,251871,0,3,5
71882,3,1,251871,251871,251872,0,1,0
71883,6,2,251877,251877,251879,0,2,5
71884,4,2,251881,251881,251883,0,2,2
71885,5,3,251886,251886,251889,0,3,3
71886,6,2,251892,251892,251894,0,2,3
71887,6,2,251898,251898,251900,0,2,4
71888,4,2,251902,251902,251904,0,2,2
71889,3,1,251905,251905,251906,0,1,1
71890,3,3,251908,251908,251911,0,3,2
71891,4,3,251912,251912,251915,0,3,1
71892,1,2,251913,251915,251917,2,4,0
71893,2,1,251915,251917,251918,2,3,0
71894,1,2,251916,251918,251920,2,4,0
71895,4,1,251920,251920,251921,0,1,0
71896,1,1,251921,251921,251922,0,1,0
71897,5,3,251926,251926,251929,0,3,4
71898,1,2,251927,251929,251931,2,4,0
71899,5,1,251932,251932,251933,0,1,1
71900,1,3,251933,251933,251936,0,3,0
71901,5,1,251938,251938,251939,0,1,2
71902,4,2,251942,251942,251944,0,2,3
71903,1,2,251943,251944,251946,1,3,0
71904,3,1,251946,251946,251947,0,1,0
71905,4,3,251950,251950,251953,0,3,3
71906,6,1,251956,251956,251957,0,1,3
71907,4,3,251960,251960,251963,0,3,3
71908,1,3,251961,251963,251966,2,5,0
71909,1,2,251962,251966,251968,4,6,0
71910,2,3,251964,251968,251971,4,7,0
71911,4,2,251968,251971,251973,3,5,0
71912,5,2,251973,251973,251975,0,2,0
71913,3,2,251976,251976,251978,0,2,1
71914,5,2,251981,251981,251983,0,2,3
71915,2,3,251983,251983,251986,0,3,0
71916,6,2,251989,251989,251991,0,2,3
71917,4,2,251993,251993,251995,0,2,2
71918,6,3,251999,251999,252002,0,3,4
71919,4,2,252003,252003,252005,0,2,1
71920,2,1,252005,252005,252006,0,1,0
71921,3,2,252008,252008,252010,0,2,2
71922,6,1,252014,252014,252015,0,1,4
71923,2,3,252016,252016,252019,0,3,1
71924,6,1,252022,252022,252023,0,1,3
71925,2,2,252024,252024,252026,0,2,1
71926,1,1,252025,252026,252027,1,2,0
71927,5,1,252030,252030,252031,0,1,3
71928,4,3,252034,252034,252037,0,3,3
71929,1,3,252035,252037,252040,2,5,0
71930,5,3,252040,252040,252043,0,3,0
71931,5,1,252045,252045,252046,0,1,2
71932,4,2,252049,252049,252051,0,2,3
71933,3,2,252052,252052,252054,0,2,1
71934,4,1,252056,252056,252057,0,1,2
71935,4,3,252060,252060,252063,0,3,3
71936,3,2,252063,252063,252065,0,2,0
71937,6,3,252069,252069,252072,0,3,4
71938,1,3,252070,252072,252075,2,5,0
71939,6,3,252076,252076,252079,0,3,1
71940,6,1,252082,252082,252083,0,1,3
71941,5,3,252087,252087,252090,0,3,4
71942,1,3,252088,252090,252093,2,5,0
71943,4,3,252092,252093,252096,1,4,0
71944,4,2,252096,252096,252098,0,2,0
71945,1,2,252097,252098,252100,1,3,0
71946,4,2,252101,252101,252103,0,2,1
71947,2,2,252103,252103,252105,0,2,0
71948,5,2,252108,252108,252110,0,2,3
71949,2,1,252110,252110,252111,0,1,0
71950,4,3,252114,252114,252117,0,3,3
71951,2,3,252116,252117,252120,1,4,0
71952,6,1,252122,252122,252123,0,1,2
71953,5,1,252127,252127,252128,0,1,4
71954,4,2,252131,252131,252133,0,2,3
71955,1,1,252132,252133,252134,1,2,0
71956,6,2,252138,252138,252140,0,2,4
71957,1,3,252139,252140,252143,1,4,0
71958,2,2,252141,252143,252145,2,4,0
71959,5,2,252146,252146,252148,0,2,1
71960,5,1,252151,252151,252152,0,1,3
71961,6,2,252157,252157,252159,0,2,5
71962,3,1,252160,252160,252161,0,1,1
71963,3,1,252163,252163,252164,0,1,2
71964,6,1,252169,252169,252170,0,1,5
71965,1,1,252170,252170,252171,0,1,0
71966,3,1,252173,252173,252174,0,1,2
71967,6,3,252179,252179,252182,0,3,5
71968,5,1,252184,252184,252185,0,1,2
71969,4,1,252188,252188,252189,0,1,3
71970,5,2,252193,252193,252195,0,2,4
71971,4,2,252197,252197,252199,0,2,2
71972,5,3,252202,252202,252205,0,3,3
71973,3,2,252205,252205,252207,0,2,0
71974,1,1,252206,252207,252208,1,2,0
71975,1,1,252207,252208,252209,1,2,0
71976,6,2,252213,252213,252215,0,2,4
71977,3,3,252216,252216,252219,0,3,1
71978,3,1,252219,252219,252220,0,1,0
71979,2,2,252221,252221,252223,0,2,1
71980,4,2,252225,252225,252227,0,2,2
71981,2,2,252227,252227,252229,0,2,0
71982,5,3,252232,252232,252235,0,3,3
71983,1,3,252233,252235,252238,2,5,0
71984,4,1,252237,252238,252239,1,2,0
71985,4,1,252241,252241,252242,0,1,2
71986,4,3,252245,252245,252248,0,3,3
71987,5,2,252250,252250,252252,0,2,2
71988,3,1,252253,252253,252254,0,1,1
71989,6,3,252259,252259,252262,0,3,5
71990,5,3,252264,252264,252267,0,3,2
71991,3,3,252267,252267,252270,0,3,0
71992,2,2,252269,252270,252272,1,3,0
71993,3,1,252272,252272,252273,0,1,0
71994,4,3,252276,252276,252279,0,3,3
71995,3,2,252279,252279,252281,0,2,0
71996,3,1,252282,252282,252283,0,1,1
71997,3,3,252285,252285,252288,0,3,2
71998,5,1,252290,252290,252291,0,1,2
71999,3,3,252293,252293,252296,0,3,2
72000,3,1,252296,252296,252297,0,1,0
72001,3,3,252299,252299,252302,0,3,2
72002,2,3,252301,252302,252305,1,4,0
72003,2,3,252303,252305,252308,2,5,0
72004,4,2,252307,252308,252310,1,3,0
72005,6,3,252313,252313,252316,0,3,3
72006,2,2,252315,252316,252318,1,3,0
72007,6,1,252321,252321,252322,0,1,3
72008,6,2,252327,252327,252329,0,2,5
72009,4,2,252331,252331,252333,0,2,2
72010,2,3,252333,252333,252336,0,3,0
72011,1,1,252334,252336,252337,2,3,0
72012,4,3,252338,252338,252341,0,3,1
72013,6,1,252344,252344,252345,0,1,3
72014,4,3,252348,252348,252351,0,3,3
72015,5,1,252353,252353,252354,0,1,2
72016,5,2,252358,252358,252360,0,2,4
72017,6,2,252364,252364,252366,0,2,4
72018,5,2,252369,252369,252371,0,2,3
72019,1,1,252370,252371,252372,1,2,0
72020,5,1,252375,252375,252376,0,1,3
72021,2,1,252377,252377,252378,0,1,1
72022,6,2,252383,252383,252385,0,2,5
72023,2,2,252385,252385,252387,0,2,0
72024,1,2,252386,252387,252389,1,3,0
72025,3,1,252389,252389,252390,0,1,0
72026,3,1,252392,252392,252393,0,1,2
72027,6,1,252398,252398,252399,0,1,5
72028,5,3,252403,252403,252406,0,3,4
72029,2,2,252405,252406,252408,1,3,0
72030,5,1,252410,252410,252411,0,1,2
72031,1,3,252411,252411,252414,0,3,0
72032,3,1,252414,252414,252415,0,1,0
72033,1,2,252415,252415,252417,0,2,0
72034,5,2,252420,252420,252422,0,2,3
72035,2,3,252422,252422,252425,0,3,0
72036,6,3,252428,252428,252431,0,3,3
72037,5,3,252433,252433,252436,0,3,2
72038,2,1,252435,252436,252437,1,2,0
72039,4,2,252439,252439,252441,0,2,2
72040,2,3,252441,252441,252444,0,3,0
72041,4,2,252445,252445,252447,0,2,1
72042,5,3,252450,252450,252453,0,3,3
72043,1,3,252451,252453,252456,2,5,0
72044,1,3,252452,252456,252459,4,7,0
72045,5,1,252457,252459,252460,2,3,0
72046,4,3,252461,252461,252464,0,3,1
72047,5,1,252466,252466,252467,0,1,2
72048,6,3,252472,252472,252475,0,3,5
72049,1,3,252473,252475,252478,2,5,0
72050,2,1,252475,252478,252479,3,4,0
72051,4,3,252479,252479,252482,0,3,0
72052,2,1,252481,252482,252483,1,2,0
72053,4,1,252485,252485,252486,0,1,2
72054,4,2,252489,252489,252491,0,2,3
72055,6,2,252495,252495,252497,0,2,4
72056,6,1,252501,252501,252502,0,1,4
72057,6,3,252507,252507,252510,0,3,5
72058,5,2,252512,252512,252514,0,2,2
72059,3,1,252515,252515,252516,0,1,1
72060,3,1,252518,252518,252519,0,1,2
72061,1,2,252519,252519,252521,0,2,0
72062,2,3,252521,252521,252524,0,3,0
72063,5,2,252526,252526,252528,0,2,2
72064,3,3,252529,252529,252532,0,3,1
72065,1,3,252530,252532,252535,2,5,0
72066,6,1,252536,252536,252537,0,1,1
72067,5,2,252541,252541,252543,0,2,4
72068,5,1,252546,252546,252547,0,1,3
72069,5,2,252551,252551,252553,0,2,4
72070,3,3,252554,252554,252557,0,3,1
72071,6,3,252560,252560,252563,0,3,3
72072,1,1,252561,252563,252564,2,3,0
72073,6,3,252567,252567,252570,0,3,3
72074,3,2,252570,252570,252572,0,2,0
72075,5,1,252575,252575,252576,0,1,3
72076,6,3,252581,252581,252584,0,3,5
72077,3,3,252584,252584,252587,0,3,0
72078,1,2,252585,252587,252589,2,4,0
72079,6,2,252591,252591,252593,0,2,2
72080,4,2,252595,252595,252597,0,2,2
72081,5,1,252600,252600,252601,0,1,3
72082,5,2,252605,252605,252607,0,2,4
72083,3,2,252608,252608,252610,0,2,1
72084,1,3,252609,252610,252613,1,4,0
72085,6,3,252615,252615,252618,0,3,2
72086,4,1,252619,252619,252620,0,1,1
72087,1,3,252620,252620,252623,0,3,0
72088,6,1,252626,252626,252627,0,1,3
72089,5,3,252631,252631,252634,0,3,4
72090,4,2,252635,252635,252637,0,2,1
72091,3,3,252638,252638,252641,0,3,1
72092,6,1,252644,252644,252645,0,1,3
72093,1,2,252645,252645,252647,0,2,0
72094,6,2,252651,252651,252653,0,2,4
72095,4,3,252655,252655,252658,0,3,2
72096,1,3,252656,252658,252661,2,5,0
72097,6,2,252662,252662,252664,0,2,1
72098,2,2,252664,252664,252666,0,2,0
72099,6,2,252670,252670,252672,0,2,4
72100,4,1,252674,252674,252675,0,1,2
72101,4,1,252678,252678,252679,0,1,3
72102,6,2,252684,252684,252686,0,2,5
72103,5,2,252689,252689,252691,0,2,3
72104,3,2,252692,252692,252694,0,2,1
72105,6,2,252698,252698,252700,0,2,4
72106,3,3,252701,252701,252704,0,3,1
72107,4,3,252705,252705,252708,0,3,1
72108,6,2,252711,252711,252713,0,2,3
72109,1,1,252712,252713,252714,1,2,0
72110,5,1,252717,252717,252718,0,1,3
72111,3,3,252720,252720,252723,0,3,2
72112,2,1,252722,252723,252724,1,2,0
72113,1,1,252723,252724,252725,1,2,0
72114,6,2,252729,252729,252731,0,2,4
72115,2,2,252731,252731,252733,0,2,0
72116,2,2,252733,252733,252735,0,2,0
72117,4,1,252737,252737,252738,0,1,2
72118,2,2,252739,252739,252741,0,2,1
72119,2,3,252741,252741,252744,0,3,0
72120,3,1,252744,252744,252745,0,1,0
72121,1,2,252745,252745,252747,0,2,0
72122,1,3,252746,252747,252750,1,4,0
72123,1,2,252747,252750,252752,3,5,0
72124,6,3,252753,252753,252756,0,3,1
72125,6,1,252759,252759,252760,0,1,3
72126,5,2,252764,252764,252766,0,2,4
72127,4,2,252768,252768,252770,0,2,2
72128,2,3,252770,252770,252773,0,3,0
72129,5,3,252775,252775,252778,0,3,2
72130,1,1,252776,252778,252779,2,3,0
72131,1,1,252777,252779,252780,2,3,0
72132,2,3,252779,252780,252783,1,4,0
72133,4,2,252783,252783,252785,0,2,0
72134,2,3,252785,252785,252788,0,3,0
72135,3,1,252788,252788,252789,0,1,0
72136,5,1,252793,252793,252794,0,1,4
72137,6,3,252799,252799,252802,0,3,5
72138,4,1,252803,252803,252804,0,1,1
72139,2,1,252805,252805,252806,0,1,1
72140,1,1,252806,252806,252807,0,1,0
72141,2,1,252808,252808,252809,0,1,1
72142,4,1,252812,252812,252813,0,1,3
72143,1,1,252813,252813,252814,0,1,0
72144,5,1,252818,252818,252819,0,1,4
72145,1,3,252819,252819,252822,0,3,0
72146,4,2,252823,252823,252825,0,2,1
72147,5,1,252828,252828,252829,0,1,3
72148,5,3,252833,252833,252836,0,3,4
72149,3,3,252836,252836,252839,0,3,0
72150,4,3,252840,252840,252843,0,3,1
72151,4,3,252844,252844,252847,0,3,1
72152,4,3,252848,252848,252851,0,3,1
72153,1,3,252849,252851,252854,2,5,0
72154,6,1,252855,252855,252856,0,1,1
72155,1,3,252856,252856,252859,0,3,0
72156,1,2,252857,252859,252861,2,4,0
72157,6,2,252863,252863,252865,0,2,2
72158,2,2,252865,252865,252867,0,2,0
72159,6,3,252871,252871,252874,0,3,4
72160,1,2,252872,252874,252876,2,4,0
72161,4,3,252876,252876,252879,0,3,0
72162,3,1,252879,252879,252880,0,1,0
72163,1,2,252880,252880,252882,0,2,0
72164,5,3,252885,252885,252888,0,3,3
72165,1,3,252886,252888,252891,2,5,0
72166,4,2,252890,252891,252893,1,3,0
72167,4,3,252894,252894,252897,0,3,1
72168,2,2,252896,252897,252899,1,3,0
72169,2,3,252898,252899,252902,1,4,0
72170,1,3,252899,252902,252905,3,6,0
72171,5,2,252904,252905,252907,1,3,0
72172,2,1,252906,252907,252908,1,2,0
72173,2,3,252908,252908,252911,0,3,0
72174,1,1,252909,252911,252912,2,3,0
72175,4,3,252913,252913,252916,0,3,1
72176,2,1,252915,252916,252917,1,2,0
72177,6,2,252921,252921,252923,0,2,4
72178,5,2,252926,252926,252928,0,2,3
72179,6,2,252932,252932,252934,0,2,4
72180,4,1,252936,252936,252937,0,1,2
72181,4,2,252940,252940,252942,0,2,3
72182,1,1,252941,252942,252943,1,2,0
72183,3,3,252944,252944,252947,0,3,1
72184,6,2,252950,252950,252952,0,2,3
72185,2,3,252952,252952,252955,0,3,0
72186,3,2,252955,252955,252957,0,2,0
72187,1,3,252956,252957,252960,1,4,0
72188,1,3,252957,252960,252963,3,6,0
72189,5,3,252962,252963,252966,1,4,0
72190,2,3,252964,252966,252969,2,5,0
72191,5,1,252969,252969,252970,0,1,0
72192,3,2,252972,252972,252974,0,2,2
72193,5,3,252977,252977,252980,0,3,3
72194,6,1,252983,252983,252984,0,1,3
72195,3,3,252986,252986,252989,0,3,2
72196,5,3,252991,252991,252994,0,3,2
72197,1,2,252992,252994,252996,2,4,0
72198,2,1,252994,252996,252997,2,3,0
72199,2,2,252996,252997,252999,1,3,0
72200,2,1,252998,252999,253000,1,2,0
72201,1,3,252999,253000,253003,1,4,0
72202,2,1,253001,253003,253004,2,3,0
72203,5,1,253006,253006,253007,0,1,2
72204,4,1,253010,253010,253011,0,1,3
72205,2,1,253012,253012,253013,0,1,1
72206,1,1,253013,253013,253014,0,1,0
72207,4,1,253017,253017,253018,0,1,3
72208,5,2,253022,253022,253024,0,2,4
72209,4,2,253026,253026,253028,0,2,2
72210,6,1,253032,253032,253033,0,1,4
72211,3,2,253035,253035,253037,0,2,2
72212,5,2,253040,253040,253042,0,2,3
72213,5,3,253045,253045,253048,0,3,3
72214,1,1,253046,253048,253049,2,3,0
72215,4,2,253050,253050,253052,0,2,1
72216,3,3,253053,253053,253056,0,3,1
72217,2,1,253055,253056,253057,1,2,0
72218,4,2,253059,253059,253061,0,2,2
72219,4,3,253063,253063,253066,0,3,2
72220,6,3,253069,253069,253072,0,3,3
72221,3,3,253072,253072,253075,0,3,0
72222,6,3,253078,253078,253081,0,3,3
72223,4,3,253082,253082,253085,0,3,1
72224,6,3,253088,253088,253091,0,3,3
72225,1,1,253089,253091,253092,2,3,0
72226,2,3,253091,253092,253095,1,4,0
72227,1,2,253092,253095,253097,3,5,0
72228,2,1,253094,253097,253098,3,4,0
72229,4,3,253098,253098,253101,0,3,0
72230,5,1,253103,253103,253104,0,1,2
72231,6,3,253109,253109,253112,0,3,5
72232,5,2,253114,253114,253116,0,2,2
72233,6,1,253120,253120,253121,0,1,4
72234,4,3,253124,253124,253127,0,3,3
72235,4,1,253128,253128,253129,0,1,1
72236,1,1,253129,253129,253130,0,1,0
72237,5,2,253134,253134,253136,0,2,4
72238,5,3,253139,253139,253142,0,3,3
72239,3,3,253142,253142,253145,0,3,0
72240,1,3,253143,253145,253148,2,5,0
72241,1,2,253144,253148,253150,4,6,0
72242,5,3,253149,253150,253153,1,4,0
72243,1,2,253150,253153,253155,3,5,0
72244,6,1,253156,253156,253157,0,1,1
72245,3,3,253159,253159,253162,0,3,2
72246,2,2,253161,253162,253164,1,3,0
72247,3,2,253164,253164,253166,0,2,0
72248,2,1,253166,253166,253167,0,1,0
72249,5,1,253171,253171,253172,0,1,4
72250,4,2,253175,253175,253177,0,2,3
72251,4,3,253179,253179,253182,0,3,2
72252,5,2,253184,253184,253186,0,2,2
72253,2,1,253186,253186,253187,0,1,0
72254,4,2,253190,253190,253192,0,2,3
72255,4,2,253194,253194,253196,0,2,2
72256,1,2,253195,253196,253198,1,3,0
72257,3,3,253198,253198,253201,0,3,0
72258,6,2,253204,253204,253206,0,2,3
72259,3,2,253207,253207,253209,0,2,1
72260,6,1,253213,253213,253214,0,1,4
72261,6,3,253219,253219,253222,0,3,5
72262,6,3,253225,253225,253228,0,3,3
72263,2,1,253227,253228,253229,1,2,0
72264,6,1,253233,253233,253234,0,1,4
72265,1,1,253234,253234,253235,0,1,0
72266,3,3,253237,253237,253240,0,3,2
72267,3,1,253240,253240,253241,0,1,0
72268,5,2,253245,253245,253247,0,2,4
72269,1,1,253246,253247,253248,1,2,0
72270,1,1,253247,253248,253249,1,2,0
72271,5,1,253252,253252,253253,0,1,3
72272,1,3,253253,253253,253256,0,3,0
72273,3,3,253256,253256,253259,0,3,0
72274,6,2,253262,253262,253264,0,2,3
72275,3,1,253265,253265,253266,0,1,1
72276,1,1,253266,253266,253267,0,1,0
72277,2,1,253268,253268,253269,0,1,1
72278,2,1,253270,253270,253271,0,1,1
72279,5,2,253275,253275,253277,0,2,4
72280,3,3,253278,253278,253281,0,3,1
72281,5,2,253283,253283,253285,0,2,2
72282,1,1,253284,253285,253286,1,2,0
72283,6,3,253290,253290,253293,0,3,4
72284,5,3,253295,253295,253298,0,3,2
72285,6,3,253301,253301,253304,0,3,3
72286,6,1,253307,253307,253308,0,1,3
72287,1,3,253308,253308,253311,0,3,0
72288,4,1,253312,253312,253313,0,1,1
72289,1,2,253313,253313,253315,0,2,0
72290,2,1,253315,253315,253316,0,1,0
72291,6,3,253321,253321,253324,0,3,5
72292,1,2,253322,253324,253326,2,4,0
72293,1,2,253323,253326,253328,3,5,0
72294,2,1,253325,253328,253329,3,4,0
72295,3,1,253328,253329,253330,1,2,0
72296,1,3,253329,253330,253333,1,4,0
72297,6,1,253335,253335,253336,0,1,2
72298,2,3,253337,253337,253340,0,3,1
72299,1,3,253338,253340,253343,2,5,0
72300,4,3,253342,253343,253346,1,4,0
72301,6,2,253348,253348,253350,0,2,2
72302,3,1,253351,253351,253352,0,1,1
72303,6,3,253357,253357,253360,0,3,5
72304,6,2,253363,253363,253365,0,2,3
72305,3,3,253366,253366,253369,0,3,1
72306,6,3,253372,253372,253375,0,3,3
72307,6,2,253378,253378,253380,0,2,3
72308,5,2,253383,253383,253385,0,2,3
72309,5,3,253388,253388,253391,0,3,3
72310,6,2,253394,253394,253396,0,2,3
72311,3,3,253397,253397,253400,0,3,1
72312,6,1,253403,253403,253404,0,1,3
72313,4,1,253407,253407,253408,0,1,3
72314,3,2,253410,253410,253412,0,2,2
72315,4,2,253414,253414,253416,0,2,2
72316,1,1,253415,253416,253417,1,2,0
72317,2,3,253417,253417,253420,0,3,0
72318,2,3,253419,253420,253423,1,4,0
72319,1,1,253420,253423,253424,3,4,0
72320,4,3,253424,253424,253427,0,3,0
72321,3,1,253427,253427,253428,0,1,0
72322,3,3,253430,253430,253433,0,3,2
72323,1,3,253431,253433,253436,2,5,0
72324,4,2,253435,253436,253438,1,3,0
72325,5,2,253440,253440,253442,0,2,2
72326,4,1,253444,253444,253445,0,1,2
72327,2,1,253446,253446,253447,0,1,1
72328,1,3,253447,253447,253450,0,3,0
72329,6,1,253453,253453,253454,0,1,3
72330,2,2,253455,253455,253457,0,2,1
72331,3,3,253458,253458,253461,0,3,1
72332,4,1,253462,253462,253463,0,1,1
72333,1,3,253463,253463,253466,0,3,0
72334,6,3,253469,253469,253472,0,3,3
72335,2,2,253471,253472,253474,1,3,0
72336,1,2,253472,253474,253476,2,4,0
72337,5,1,253477,253477,253478,0,1,1
72338,2,2,253479,253479,253481,0,2,1
72339,1,1,253480,253481,253482,1,2,0
72340,3,2,253483,253483,253485,0,2,1
72341,1,3,253484,253485,253488,1,4,0
72342,5,1,253489,253489,253490,0,1,1
72343,6,1,253495,253495,253496,0,1,5
72344,6,3,253501,253501,253504,0,3,5
72345,1,3,253502,253504,253507,2,5,0
72346,6,3,253508,253508,253511,0,3,1
72347,4,2,253512,253512,253514,0,2,1
72348,3,3,253515,253515,253518,0,3,1
72349,4,1,253519,253519,253520,0,1,1
72350,5,1,253524,253524,253525,0,1,4
72351,2,2,253526,253526,253528,0,2,1
72352,4,2,253530,253530,253532,0,2,2
72353,1,2,253531,253532,253534,1,3,0
72354,5,3,253536,253536,253539,0,3,2
72355,4,3,253540,253540,253543,0,3,1
72356,6,1,253546,253546,253547,0,1,3
72357,4,3,253550,253550,253553,0,3,3
72358,1,3,253551,253553,253556,2,5,0
72359,6,3,253557,253557,253560,0,3,1
72360,5,2,253562,253562,253564,0,2,2
72361,2,1,253564,253564,253565,0,1,0
72362,5,3,253569,253569,253572,0,3,4
72363,6,3,253575,253575,253578,0,3,3
72364,1,3,253576,253578,253581,2,5,0
72365,4,1,253580,253581,253582,1,2,0
72366,3,2,253583,253583,253585,0,2,1
72367,1,2,253584,253585,253587,1,3,0
72368,3,1,253587,253587,253588,0,1,0
72369,6,2,253593,253593,253595,0,2,5
72370,4,3,253597,253597,253600,0,3,2
72371,6,1,253603,253603,253604,0,1,3
72372,6,1,253609,253609,253610,0,1,5
72373,3,2,253612,253612,253614,0,2,2
72374,3,1,253615,253615,253616,0,1,1
72375,5,1,253620,253620,253621,0,1,4
72376,3,3,253623,253623,253626,0,3,2
72377,4,2,253627,253627,253629,0,2,1
72378,6,2,253633,253633,253635,0,2,4
72379,2,3,253635,253635,253638,0,3,0
72380,5,2,253640,253640,253642,0,2,2
72381,2,3,253642,253642,253645,0,3,0
72382,1,3,253643,253645,253648,2,5,0
72383,3,1,253646,253648,253649,2,3,0
72384,6,2,253652,253652,253654,0,2,3
72385,2,3,253654,253654,253657,0,3,0
72386,5,1,253659,253659,253660,0,1,2
72387,5,3,253664,253664,253667,0,3,4
72388,4,1,253668,253668,253669,0,1,1
72389,2,3,253670,253670,253673,0,3,1
72390,4,2,253674,253674,253676,0,2,1
72391,5,1,253679,253679,253680,0,1,3
72392,2,3,253681,253681,253684,0,3,1
72393,5,1,253686,253686,253687,0,1,2
72394,3,3,253689,253689,253692,0,3,2
72395,1,3,253690,253692,253695,2,5,0
72396,5,1,253695,253695,253696,0,1,0
72397,3,3,253698,253698,253701,0,3,2
72398,3,3,253701,253701,253704,0,3,0
72399,1,3,253702,253704,253707,2,5,0
72400,6,2,253708,253708,253710,0,2,1
72401,1,1,253709,253710,253711,1,2,0
72402,1,1,253710,253711,253712,1,2,0
72403,3,2,253713,253713,253715,0,2,1
72404,1,1,253714,253715,253716,1,2,0
72405,5,1,253719,253719,253720,0,1,3
72406,3,1,253722,253722,253723,0,1,2
72407,6,2,253728,253728,253730,0,2,5
72408,3,3,253731,253731,253734,0,3,1
72409,5,2,253736,253736,253738,0,2,2
72410,2,2,253738,253738,253740,0,2,0
72411,4,1,253742,253742,253743,0,1,2
72412,1,2,253743,253743,253745,0,2,0
72413,4,2,253747,253747,253749,0,2,2
72414,4,1,253751,253751,253752,0,1,2
72415,5,2,253756,253756,253758,0,2,4
72416,3,1,253759,253759,253760,0,1,1
72417,4,3,253763,253763,253766,0,3,3
72418,1,1,253764,253766,253767,2,3,0
72419,2,3,253766,253767,253770,1,4,0
72420,1,2,253767,253770,253772,3,5,0
72421,3,2,253770,253772,253774,2,4,0
72422,2,1,253772,253774,253775,2,3,0
72423,2,2,253774,253775,253777,1,3,0
72424,2,1,253776,253777,253778,1,2,0
72425,2,3,253778,253778,253781,0,3,0
72426,4,2,253782,253782,253784,0,2,1
72427,2,1,253784,253784,253785,0,1,0
72428,5,1,253789,253789,253790,0,1,4
72429,2,2,253791,253791,253793,0,2,1
72430,6,2,253797,253797,253799,0,2,4
72431,6,3,253803,253803,253806,0,3,4
72432,6,1,253809,253809,253810,0,1,3
72433,3,1,253812,253812,253813,0,1,2
72434,3,2,253815,253815,253817,0,2,2
72435,6,3,253821,253821,253824,0,3,4
72436,4,2,253825,253825,253827,0,2,1
72437,5,2,253830,253830,253832,0,2,3
72438,2,3,253832,253832,253835,0,3,0
72439,2,1,253834,253835,253836,1,2,0
72440,4,2,253838,253838,253840,0,2,2
72441,2,1,253840,253840,253841,0,1,0
72442,6,2,253846,253846,253848,0,2,5
72443,5,1,253851,253851,253852,0,1,3
72444,6,3,253857,253857,253860,0,3,5
72445,4,1,253861,253861,253862,0,1,1
72446,3,1,253864,253864,253865,0,1,2
72447,2,2,253866,253866,253868,0,2,1
72448,3,1,253869,253869,253870,0,1,1
72449,3,1,253872,253872,253873,0,1,2
72450,4,3,253876,253876,253879,0,3,3
72451,5,3,253881,253881,253884,0,3,2
72452,2,1,253883,253884,253885,1,2,0
72453,1,1,253884,253885,253886,1,2,0
72454,5,1,253889,253889,253890,0,1,3
72455,3,1,253892,253892,253893,0,1,2
72456,4,1,253896,253896,253897,0,1,3
72457,6,1,253902,253902,253903,0,1,5
72458,6,1,253908,253908,253909,0,1,5
72459,1,1,253909,253909,253910,0,1,0
72460,5,3,253914,253914,253917,0,3,4
72461,1,2,253915,253917,253919,2,4,0
72462,2,3,253917,253919,253922,2,5,0
72463,5,2,253922,253922,253924,0,2,0
72464,1,2,253923,253924,253926,1,3,0
72465,1,1,253924,253926,253927,2,3,0
72466,3,2,253927,253927,253929,0,2,0
72467,3,2,253930,253930,253932,0,2,1
72468,3,3,253933,253933,253936,0,3,1
72469,2,3,253935,253936,253939,1,4,0
72470,2,2,253937,253939,253941,2,4,0
72471,3,1,253940,253941,253942,1,2,0
72472,2,1,253942,253942,253943,0,1,0
72473,3,3,253945,253945,253948,0,3,2
72474,2,3,253947,253948,253951,1,4,0
72475,2,1,253949,253951,253952,2,3,0
72476,2,2,253951,253952,253954,1,3,0
72477,3,3,253954,253954,253957,0,3,0
72478,4,2,253958,253958,253960,0,2,1
72479,3,3,253961,253961,253964,0,3,1
72480,5,3,253966,253966,253969,0,3,2
72481,2,3,253968,253969,253972,1,4,0
72482,2,3,253970,253972,253975,2,5,0
72483,3,3,253973,253975,253978,2,5,0
72484,4,2,253977,253978,253980,1,3,0
72485,2,2,253979,253980,253982,1,3,0
72486,4,2,253983,253983,253985,0,2,1
72487,4,1,253987,253987,253988,0,1,2
72488,4,2,253991,253991,253993,0,2,3
72489,3,1,253994,253994,253995,0,1,1
72490,6,3,254000,254000,254003,0,3,5
72491,3,2,254003,254003,254005,0,2,0
72492,4,1,254007,254007,254008,0,1,2
72493,2,3,254009,254009,254012,0,3,1
72494,6,1,254015,254015,254016,0,1,3
72495,6,1,254021,254021,254022,0,1,5
72496,3,2,254024,254024,254026,0,2,2
72497,4,2,254028,254028,254030,0,2,2
72498,1,1,254029,254030,254031,1,2,0
72499,3,3,254032,254032,254035,0,3,1
72500,2,2,254034,254035,254037,1,3,0
72501,2,2,254036,254037,254039,1,3,0
72502,4,3,254040,254040,254043,0,3,1
72503,4,3,254044,254044,254047,0,3,1
72504,3,2,254047,254047,254049,0,2,0
72505,4,1,254051,254051,254052,0,1,2
72506,1,1,254052,254052,254053,0,1,0
72507,6,1,254058,254058,254059,0,1,5
72508,1,2,254059,254059,254061,0,2,0
72509,4,2,254063,254063,254065,0,2,2
72510,5,3,254068,254068,254071,0,3,3
72511,2,1,254070,254071,254072,1,2,0
72512,1,2,254071,254072,254074,1,3,0
72513,4,1,254075,254075,254076,0,1,1
72514,5,1,254080,254080,254081,0,1,4
72515,1,1,254081,254081,254082,0,1,0
72516,5,1,254086,254086,254087,0,1,4
72517,5,2,254091,254091,254093,0,2,4
72518,3,3,254094,254094,254097,0,3,1
72519,2,2,254096,254097,254099,1,3,0
72520,5,2,254101,254101,254103,0,2,2
72521,5,1,254106,254106,254107,0,1,3
72522,1,3,254107,254107,254110,0,3,0
72523,3,2,254110,254110,254112,0,2,0
72524,3,3,254113,254113,254116,0,3,1
72525,1,2,254114,254116,254118,2,4,0
72526,3,3,254117,254118,254121,1,4,0
72527,6,2,254123,254123,254125,0,2,2
72528,3,2,254126,254126,254128,0,2,1
72529,4,1,254130,254130,254131,0,1,2
72530,1,2,254131,254131,254133,0,2,0
72531,2,3,254133,254133,254136,0,3,0
72532,6,2,254139,254139,254141,0,2,3
72533,4,2,254143,254143,254145,0,2,2
72534,1,1,254144,254145,254146,1,2,0
72535,1,2,254145,254146,254148,1,3,0
72536,1,2,254146,254148,254150,2,4,0
72537,1,2,254147,254150,254152,3,5,0
72538,3,2,254150,254152,254154,2,4,0
72539,4,2,254154,254154,254156,0,2,0
72540,6,2,254160,254160,254162,0,2,4
72541,4,2,254164,254164,254166,0,2,2
72542,4,3,254168,254168,254171,0,3,2
72543,4,2,254172,254172,254174,0,2,1
72544,3,3,254175,254175,254178,0,3,1
72545,5,2,254180,254180,254182,0,2,2
72546,6,2,254186,254186,254188,0,2,4
72547,1,3,254187,254188,254191,1,4,0
72548,1,3,254188,254191,254194,3,6,0
72549,3,3,254191,254194,254197,3,6,0
72550,4,3,254195,254197,254200,2,5,0
72551,6,1,254201,254201,254202,0,1,1
72552,3,1,254204,254204,254205,0,1,2
72553,3,3,254207,254207,254210,0,3,2
72554,3,3,254210,254210,254213,0,3,0
72555,3,3,254213,254213,254216,0,3,0
72556,2,2,254215,254216,254218,1,3,0
72557,1,3,254216,254218,254221,2,5,0
72558,1,2,254217,254221,254223,4,6,0
72559,5,2,254222,254223,254225,1,3,0
72560,5,1,254227,254227,254228,0,1,2
72561,2,3,254229,254229,254232,0,3,1
72562,2,3,254231,254232,254235,1,4,0
72563,1,2,254232,254235,254237,3,5,0
72564,1,3,254233,254237,254240,4,7,0
72565,2,2,254235,254240,254242,5,7,0
72566,6,1,254241,254242,254243,1,2,0
72567,6,1,254247,254247,254248,0,1,4
72568,2,3,254249,254249,254252,0,3,1
72569,2,3,254251,254252,254255,1,4,0
72570,6,3,254257,254257,254260,0,3,2
72571,1,2,254258,254260,254262,2,4,0
72572,2,1,254260,254262,254263,2,3,0
72573,1,2,254261,254263,254265,2,4,0
72574,5,2,254266,254266,254268,0,2,1
72575,4,1,254270,254270,254271,0,1,2
72576,2,2,254272,254272,254274,0,2,1
72577,6,1,254278,254278,254279,0,1,4
72578,4,1,254282,254282,254283,0,1,3
72579,2,1,254284,254284,254285,0,1,1
72580,5,1,254289,254289,254290,0,1,4
72581,6,1,254295,254295,254296,0,1,5
72582,3,3,254298,254298,254301,0,3,2
72583,1,1,254299,254301,254302,2,3,0
72584,1,1,254300,254302,254303,2,3,0
72585,4,2,254304,254304,254306,0,2,1
72586,4,2,254308,254308,254310,0,2,2
72587,5,3,254313,254313,254316,0,3,3
72588,4,3,254317,254317,254320,0,3,1
72589,1,3,254318,254320,254323,2,5,0
72590,4,3,254322,254323,254326,1,4,0
72591,3,1,254325,254326,254327,1,2,0
72592,3,1,254328,254328,254329,0,1,1
72593,6,2,254334,254334,254336,0,2,5
72594,2,2,254336,254336,254338,0,2,0
72595,2,3,254338,254338,254341,0,3,0
72596,1,3,254339,254341,254344,2,5,0
72597,6,1,254345,254345,254346,0,1,1
72598,5,3,254350,254350,254353,0,3,4
72599,3,1,254353,254353,254354,0,1,0
72600,6,2,254359,254359,254361,0,2,5
72601,1,1,254360,254361,254362,1,2,0
72602,2,1,254362,254362,254363,0,1,0
72603,6,1,254368,254368,254369,0,1,5
72604,3,3,254371,254371,254374,0,3,2
72605,3,3,254374,254374,254377,0,3,0
72606,6,3,254380,254380,254383,0,3,3
72607,4,1,254384,254384,254385,0,1,1
72608,1,2,254385,254385,254387,0,2,0
72609,6,1,254391,254391,254392,0,1,4
72610,5,2,254396,254396,254398,0,2,4
72611,4,2,254400,254400,254402,0,2,2
72612,3,3,254403,254403,254406,0,3,1
72613,3,2,254406,254406,254408,0,2,0
72614,4,1,254410,254410,254411,0,1,2
72615,2,3,254412,254412,254415,0,3,1
72616,4,2,254416,254416,254418,0,2,1
72617,1,1,254417,254418,254419,1,2,0
72618,5,1,254422,254422,254423,0,1,3
72619,5,3,254427,254427,254430,0,3,4
72620,2,1,254429,254430,254431,1,2,0
72621,6,1,254435,254435,254436,0,1,4
72622,3,3,254438,254438,254441,0,3,2
72623,1,3,254439,254441,254444,2,5,0
72624,5,1,254444,254444,254445,0,1,0
72625,4,3,254448,254448,254451,0,3,3
72626,4,1,254452,254452,254453,0,1,1
72627,1,2,254453,254453,254455,0,2,0
72628,2,2,254455,254455,254457,0,2,0
72629,6,1,254461,254461,254462,0,1,4
72630,1,1,254462,254462,254463,0,1,0
72631,3,2,254465,254465,254467,0,2,2
72632,3,1,254468,254468,254469,0,1,1
72633,1,1,254469,254469,254470,0,1,0
72634,6,3,254475,254475,254478,0,3,5
72635,3,1,254478,254478,254479,0,1,0
72636,2,1,254480,254480,254481,0,1,1
72637,1,1,254481,254481,254482,0,1,0
72638,4,1,254485,254485,254486,0,1,3
72639,6,1,254491,254491,254492,0,1,5
72640,3,3,254494,254494,254497,0,3,2
72641,3,3,254497,254497,254500,0,3,0
72642,5,3,254502,254502,254505,0,3,2
72643,6,1,254508,254508,254509,0,1,3
72644,5,2,254513,254513,254515,0,2,4
72645,5,3,254518,254518,254521,0,3,3
72646,5,1,254523,254523,254524,0,1,2
72647,3,1,254526,254526,254527,0,1,2
72648,4,2,254530,254530,254532,0,2,3
72649,5,3,254535,254535,254538,0,3,3
72650,5,1,254540,254540,254541,0,1,2
72651,6,2,254546,254546,254548,0,2,5
72652,6,3,254552,254552,254555,0,3,4
72653,5,2,254557,254557,254559,0,2,2
72654,1,2,254558,254559,254561,1,3,0
72655,4,2,254562,254562,254564,0,2,1
72656,4,3,254566,254566,254569,0,3,2
72657,2,1,254568,254569,254570,1,2,0
72658,4,2,254572,254572,254574,0,2,2
72659,1,3,254573,254574,254577,1,4,0
72660,1,1,254574,254577,254578,3,4,0
72661,6,3,254580,254580,254583,0,3,2
72662,1,1,254581,254583,254584,2,3,0
72663,5,1,254586,254586,254587,0,1,2
72664,2,2,254588,254588,254590,0,2,1
72665,1,2,254589,254590,254592,1,3,0
72666,4,1,254593,254593,254594,0,1,1
72667,4,1,254597,254597,254598,0,1,3
72668,5,1,254602,254602,254603,0,1,4
72669,3,2,254605,254605,254607,0,2,2
72670,3,3,254608,254608,254611,0,3,1
72671,2,2,254610,254611,254613,1,3,0
72672,4,1,254614,254614,254615,0,1,1
72673,2,2,254616,254616,254618,0,2,1
72674,4,2,254620,254620,254622,0,2,2
72675,5,1,254625,254625,254626,0,1,3
72676,2,1,254627,254627,254628,0,1,1
72677,1,3,254628,254628,254631,0,3,0
72678,4,1,254632,254632,254633,0,1,1
72679,3,2,254635,254635,254637,0,2,2
72680,2,1,254637,254637,254638,0,1,0
72681,6,2,254643,254643,254645,0,2,5
72682,4,1,254647,254647,254648,0,1,2
72683,2,1,254649,254649,254650,0,1,1
72684,4,2,254653,254653,254655,0,2,3
72685,4,3,254657,254657,254660,0,3,2
72686,4,3,254661,254661,254664,0,3,1
72687,2,1,254663,254664,254665,1,2,0
72688,1,2,254664,254665,254667,1,3,0
72689,3,1,254667,254667,254668,0,1,0
72690,5,1,254672,254672,254673,0,1,4
72691,1,3,254673,254673,254676,0,3,0
72692,2,2,254675,254676,254678,1,3,0
72693,5,2,254680,254680,254682,0,2,2
72694,3,3,254683,254683,254686,0,3,1
72695,3,1,254686,254686,254687,0,1,0
72696,4,1,254690,254690,254691,0,1,3
72697,6,1,254696,254696,254697,0,1,5
72698,6,3,254702,254702,254705,0,3,5
72699,6,2,254708,254708,254710,0,2,3
72700,3,2,254711,254711,254713,0,2,1
72701,6,2,254717,254717,254719,0,2,4
72702,5,1,254722,254722,254723,0,1,3
72703,6,3,254728,254728,254731,0,3,5
72704,6,3,254734,254734,254737,0,3,3
72705,6,1,254740,254740,254741,0,1,3
72706,4,2,254744,254744,254746,0,2,3
72707,4,2,254748,254748,254750,0,2,2
72708,6,1,254754,254754,254755,0,1,4
72709,5,1,254759,254759,254760,0,1,4
72710,4,2,254763,254763,254765,0,2,3
72711,1,2,254764,254765,254767,1,3,0
72712,4,3,254768,254768,254771,0,3,1
72713,1,3,254769,254771,254774,2,5,0
72714,3,3,254772,254774,254777,2,5,0
72715,5,3,254777,254777,254780,0,3,0
72716,1,2,254778,254780,254782,2,4,0
72717,3,1,254781,254782,254783,1,2,0
72718,4,2,254785,254785,254787,0,2,2
72719,6,2,254791,254791,254793,0,2,4
72720,3,2,254794,254794,254796,0,2,1
72721,5,1,254799,254799,254800,0,1,3
72722,2,3,254801,254801,254804,0,3,1
72723,2,2,254803,254804,254806,1,3,0
72724,4,1,254807,254807,254808,0,1,1
72725,5,1,254812,254812,254813,0,1,4
72726,2,1,254814,254814,254815,0,1,1
72727,6,2,254820,254820,254822,0,2,5
72728,5,2,254825,254825,254827,0,2,3
72729,4,2,254829,254829,254831,0,2,2
72730,6,2,254835,254835,254837,0,2,4
72731,1,3,254836,254837,254840,1,4,0
72732,4,1,254840,254840,254841,0,1,0
72733,4,3,254844,254844,254847,0,3,3
72734,2,1,254846,254847,254848,1,2,0
72735,1,3,254847,254848,254851,1,4,0
72736,4,3,254851,254851,254854,0,3,0
72737,6,1,254857,254857,254858,0,1,3
72738,6,3,254863,254863,254866,0,3,5
72739,5,2,254868,254868,254870,0,2,2
72740,2,3,254870,254870,254873,0,3,0
72741,3,1,254873,254873,254874,0,1,0
72742,2,3,254875,254875,254878,0,3,1
72743,5,3,254880,254880,254883,0,3,2
72744,3,3,254883,254883,254886,0,3,0
72745,2,3,254885,254886,254889,1,4,0
72746,2,3,254887,254889,254892,2,5,0
72747,5,3,254892,254892,254895,0,3,0
72748,6,2,254898,254898,254900,0,2,3
72749,1,3,254899,254900,254903,1,4,0
72750,6,2,254905,254905,254907,0,2,2
72751,3,1,254908,254908,254909,0,1,1
72752,3,3,254911,254911,254914,0,3,2
72753,3,3,254914,254914,254917,0,3,0
72754,1,2,254915,254917,254919,2,4,0
72755,5,2,254920,254920,254922,0,2,1
72756,6,2,254926,254926,254928,0,2,4
72757,4,1,254930,254930,254931,0,1,2
72758,6,2,254936,254936,254938,0,2,5
72759,3,3,254939,254939,254942,0,3,1
72760,5,1,254944,254944,254945,0,1,2
72761,4,2,254948,254948,254950,0,2,3
72762,6,3,254954,254954,254957,0,3,4
72763,2,3,254956,254957,254960,1,4,0
72764,6,2,254962,254962,254964,0,2,2
72765,4,3,254966,254966,254969,0,3,2
72766,1,3,254967,254969,254972,2,5,0
72767,4,3,254971,254972,254975,1,4,0
72768,3,3,254974,254975,254978,1,4,0
72769,2,3,254976,254978,254981,2,5,0
72770,4,2,254980,254981,254983,1,3,0
72771,6,1,254986,254986,254987,0,1,3
72772,4,3,254990,254990,254993,0,3,3
72773,6,1,254996,254996,254997,0,1,3
72774,2,3,254998,254998,255001,0,3,1
72775,5,3,255003,255003,255006,0,3,2
72776,4,3,255007,255007,255010,0,3,1
72777,1,1,255008,255010,255011,2,3,0
72778,1,3,255009,255011,255014,2,5,0
72779,2,2,255011,255014,255016,3,5,0
72780,1,3,255012,255016,255019,4,7,0
72781,6,3,255018,255019,255022,1,4,0
72782,4,2,255022,255022,255024,0,2,0
72783,3,3,255025,255025,255028,0,3,1
72784,2,2,255027,255028,255030,1,3,0
72785,3,1,255030,255030,255031,0,1,0
72786,6,2,255036,255036,255038,0,2,5
72787,6,3,255042,255042,255045,0,3,4
72788,6,1,255048,255048,255049,0,1,3
72789,4,1,255052,255052,255053,0,1,3
72790,4,1,255056,255056,255057,0,1,3
72791,2,2,255058,255058,255060,0,2,1
72792,4,2,255062,255062,255064,0,2,2
72793,1,3,255063,255064,255067,1,4,0
72794,6,2,255069,255069,255071,0,2,2
72795,1,2,255070,255071,255073,1,3,0
72796,5,1,255075,255075,255076,0,1,2
72797,3,2,255078,255078,255080,0,2,2
72798,4,1,255082,255082,255083,0,1,2
72799,2,1,255084,255084,255085,0,1,1
72800,6,3,255090,255090,255093,0,3,5
72801,3,3,255093,255093,255096,0,3,0
72802,3,1,255096,255096,255097,0,1,0
72803,4,3,255100,255100,255103,0,3,3
72804,3,2,255103,255103,255105,0,2,0
72805,3,2,255106,255106,255108,0,2,1
72806,3,1,255109,255109,255110,0,1,1
72807,1,1,255110,255110,255111,0,1,0
72808,1,3,255111,255111,255114,0,3,0
72809,6,3,255117,255117,255120,0,3,3
72810,3,3,255120,255120,255123,0,3,0
72811,1,2,255121,255123,255125,2,4,0
72812,6,2,255127,255127,255129,0,2,2
72813,3,2,255130,255130,255132,0,2,1
72814,4,1,255134,255134,255135,0,1,2
72815,3,1,255137,255137,255138,0,1,2
72816,6,3,255143,255143,255146,0,3,5
72817,4,3,255147,255147,255150,0,3,1
72818,3,3,255150,255150,255153,0,3,0
72819,6,2,255156,255156,255158,0,2,3
72820,5,2,255161,255161,255163,0,2,3
72821,3,1,255164,255164,255165,0,1,1
72822,3,3,255167,255167,255170,0,3,2
72823,4,1,255171,255171,255172,0,1,1
72824,5,1,255176,255176,255177,0,1,4
72825,6,2,255182,255182,255184,0,2,5
72826,4,1,255186,255186,255187,0,1,2
72827,6,2,255192,255192,255194,0,2,5
72828,6,2,255198,255198,255200,0,2,4
72829,5,3,255203,255203,255206,0,3,3
72830,5,2,255208,255208,255210,0,2,2
72831,5,1,255213,255213,255214,0,1,3
72832,2,3,255215,255215,255218,0,3,1
72833,6,1,255221,255221,255222,0,1,3
72834,2,1,255223,255223,255224,0,1,1
72835,4,3,255227,255227,255230,0,3,3
72836,6,3,255233,255233,255236,0,3,3
72837,6,2,255239,255239,255241,0,2,3
72838,2,2,255241,255241,255243,0,2,0
72839,6,2,255247,255247,255249,0,2,4
72840,3,2,255250,255250,255252,0,2,1
72841,6,1,255256,255256,255257,0,1,4
72842,1,3,255257,255257,255260,0,3,0
72843,6,2,255263,255263,255265,0,2,3
72844,3,1,255266,255266,255267,0,1,1
72845,3,1,255269,255269,255270,0,1,2
72846,5,3,255274,255274,255277,0,3,4
72847,1,3,255275,255277,255280,2,5,0
72848,3,3,255278,255280,255283,2,5,0
72849,1,3,255279,255283,255286,4,7,0
72850,5,1,255284,255286,255287,2,3,0
72851,5,1,255289,255289,255290,0,1,2
72852,4,1,255293,255293,255294,0,1,3
72853,1,3,255294,255294,255297,0,3,0
72854,6,2,255300,255300,255302,0,2,3
72855,3,2,255303,255303,255305,0,2,1
72856,6,2,255309,255309,255311,0,2,4
72857,5,3,255314,255314,255317,0,3,3
72858,1,1,255315,255317,255318,2,3,0
72859,2,3,255317,255318,255321,1,4,0
72860,2,2,255319,255321,255323,2,4,0
72861,1,1,255320,255323,255324,3,4,0
72862,1,2,255321,255324,255326,3,5,0
72863,6,2,255327,255327,255329,0,2,1
72864,3,1,255330,255330,255331,0,1,1
72865,4,3,255334,255334,255337,0,3,3
72866,4,3,255338,255338,255341,0,3,1
72867,3,2,255341,255341,255343,0,2,0
72868,1,2,255342,255343,255345,1,3,0
72869,3,3,255345,255345,255348,0,3,0
72870,4,3,255349,255349,255352,0,3,1
72871,2,3,255351,255352,255355,1,4,0
72872,4,3,255355,255355,255358,0,3,0
72873,5,1,255360,255360,255361,0,1,2
72874,5,1,255365,255365,255366,0,1,4
72875,4,1,255369,255369,255370,0,1,3
72876,2,1,255371,255371,255372,0,1,1
72877,1,1,255372,255372,255373,0,1,0
72878,3,2,255375,255375,255377,0,2,2
72879,2,3,255377,255377,255380,0,3,0
72880,3,3,255380,255380,255383,0,3,0
72881,6,3,255386,255386,255389,0,3,3
72882,4,1,255390,255390,255391,0,1,1
72883,6,1,255396,255396,255397,0,1,5
72884,5,1,255401,255401,255402,0,1,4
72885,6,2,255407,255407,255409,0,2,5
72886,4,2,255411,255411,255413,0,2,2
72887,4,3,255415,255415,255418,0,3,2
72888,6,1,255421,255421,255422,0,1,3
72889,3,3,255424,255424,255427,0,3,2
72890,4,3,255428,255428,255431,0,3,1
72891,3,3,255431,255431,255434,0,3,0
72892,4,3,255435,255435,255438,0,3,1
72893,2,2,255437,255438,255440,1,3,0
72894,3,1,255440,255440,255441,0,1,0
72895,4,3,255444,255444,255447,0,3,3
72896,4,1,255448,255448,255449,0,1,1
72897,4,2,255452,255452,255454,0,2,3
72898,6,2,255458,255458,255460,0,2,4
72899,5,3,255463,255463,255466,0,3,3
72900,3,3,255466,255466,255469,0,3,0
72901,6,1,255472,255472,255473,0,1,3
72902,3,3,255475,255475,255478,0,3,2
72903,1,2,255476,255478,255480,2,4,0
72904,3,1,255479,255480,255481,1,2,0
72905,1,2,255480,255481,255483,1,3,0
72906,1,1,255481,255483,255484,2,3,0
72907,1,2,255482,255484,255486,2,4,0
72908,4,2,255486,255486,255488,0,2,0
72909,3,1,255489,255489,255490,0,1,1
72910,2,3,255491,255491,255494,0,3,1
72911,1,2,255492,255494,255496,2,4,0
72912,2,2,255494,255496,255498,2,4,0
72913,5,3,255499,255499,255502,0,3,1
72914,2,3,255501,255502,255505,1,4,0
72915,2,3,255503,255505,255508,2,5,0
72916,3,3,255506,255508,255511,2,5,0
72917,4,3,255510,255511,255514,1,4,0
72918,3,3,255513,255514,255517,1,4,0
72919,4,2,255517,255517,255519,0,2,0
72920,2,3,255519,255519,255522,0,3,0
72921,4,1,255523,255523,255524,0,1,1
72922,5,1,255528,255528,255529,0,1,4
72923,2,3,255530,255530,255533,0,3,1
72924,3,1,255533,255533,255534,0,1,0
72925,4,1,255537,255537,255538,0,1,3
72926,6,1,255543,255543,255544,0,1,5
72927,2,3,255545,255545,255548,0,3,1
72928,4,3,255549,255549,255552,0,3,1
72929,5,2,255554,255554,255556,0,2,2
72930,1,1,255555,255556,255557,1,2,0
72931,5,1,255560,255560,255561,0,1,3
72932,5,3,255565,255565,255568,0,3,4
72933,4,2,255569,255569,255571,0,2,1
72934,2,1,255571,255571,255572,0,1,0
72935,2,3,255573,255573,255576,0,3,1
72936,1,1,255574,255576,255577,2,3,0
72937,2,2,255576,255577,255579,1,3,0
72938,6,2,255582,255582,255584,0,2,3
72939,5,1,255587,255587,255588,0,1,3
72940,5,2,255592,255592,255594,0,2,4
72941,5,3,255597,255597,255600,0,3,3
72942,3,1,255600,255600,255601,0,1,0
72943,3,1,255603,255603,255604,0,1,2
72944,6,3,255609,255609,255612,0,3,5
72945,4,2,255613,255613,255615,0,2,1
72946,5,3,255618,255618,255621,0,3,3
72947,3,3,255621,255621,255624,0,3,0
72948,6,3,255627,255627,255630,0,3,3
72949,6,3,255633,255633,255636,0,3,3
72950,1,1,255634,255636,255637,2,3,0
72951,1,2,255635,255637,255639,2,4,0
72952,1,1,255636,255639,255640,3,4,0
72953,1,2,255637,255640,255642,3,5,0
72954,2,3,255639,255642,255645,3,6,0
72955,6,1,255645,255645,255646,0,1,0
72956,1,2,255646,255646,255648,0,2,0
72957,4,1,255650,255650,255651,0,1,2
72958,3,3,255653,255653,255656,0,3,2
72959,1,2,255654,255656,255658,2,4,0
72960,5,3,255659,255659,255662,0,3,1
72961,4,1,255663,255663,255664,0,1,1
72962,6,1,255669,255669,255670,0,1,5
72963,3,1,255672,255672,255673,0,1,2
72964,6,3,255678,255678,255681,0,3,5
72965,5,1,255683,255683,255684,0,1,2
72966,6,1,255689,255689,255690,0,1,5
72967,6,1,255695,255695,255696,0,1,5
72968,6,2,255701,255701,255703,0,2,5
72969,6,3,255707,255707,255710,0,3,4
72970,3,3,255710,255710,255713,0,3,0
72971,5,3,255715,255715,255718,0,3,2
72972,2,3,255717,255718,255721,1,4,0
72973,6,2,255723,255723,255725,0,2,2
72974,5,1,255728,255728,255729,0,1,3
72975,6,3,255734,255734,255737,0,3,5
72976,4,2,255738,255738,255740,0,2,1
72977,4,2,255742,255742,255744,0,2,2
72978,1,2,255743,255744,255746,1,3,0
72979,6,3,255749,255749,255752,0,3,3
72980,3,3,255752,255752,255755,0,3,0
72981,1,2,255753,255755,255757,2,4,0
72982,3,3,255756,255757,255760,1,4,0
72983,1,1,255757,255760,255761,3,4,0
72984,4,3,255761,255761,255764,0,3,0
72985,3,2,255764,255764,255766,0,2,0
72986,3,3,255767,255767,255770,0,3,1
72987,6,2,255773,255773,255775,0,2,3
72988,4,1,255777,255777,255778,0,1,2
72989,6,3,255783,255783,255786,0,3,5
72990,5,1,255788,255788,255789,0,1,2
72991,1,1,255789,255789,255790,0,1,0
72992,1,1,255790,255790,255791,0,1,0
72993,2,2,255792,255792,255794,0,2,1
72994,3,2,255795,255795,255797,0,2,1
72995,2,1,255797,255797,255798,0,1,0
72996,1,1,255798,255798,255799,0,1,0
72997,1,3,255799,255799,255802,0,3,0
72998,3,2,255802,255802,255804,0,2,0
72999,1,3,255803,255804,255807,1,4,0
73000,5,3,255808,255808,255811,0,3,1
73001,2,1,255810,255811,255812,1,2,0
73002,4,3,255814,255814,255817,0,3,2
73003,6,3,255820,255820,255823,0,3,3
73004,1,3,255821,255823,255826,2,5,0
73005,2,3,255823,255826,255829,3,6,0
73006,1,1,255824,255829,255830,5,6,0
73007,1,3,255825,255830,255833,5,8,0
73008,5,3,255830,255833,255836,3,6,0
73009,3,1,255833,255836,255837,3,4,0
73010,2,2,255835,255837,255839,2,4,0
73011,6,3,255841,255841,255844,0,3,2
73012,2,2,255843,255844,255846,1,3,0
73013,4,3,255847,255847,255850,0,3,1
73014,6,2,255853,255853,255855,0,2,3
73015,2,3,255855,255855,255858,0,3,0
73016,2,2,255857,255858,255860,1,3,0
73017,3,2,255860,255860,255862,0,2,0
73018,1,3,255861,255862,255865,1,4,0
73019,3,1,255864,255865,255866,1,2,0
73020,1,1,255865,255866,255867,1,2,0
73021,3,3,255868,255868,255871,0,3,1
73022,2,3,255870,255871,255874,1,4,0
73023,6,3,255876,255876,255879,0,3,2
73024,4,1,255880,255880,255881,0,1,1
73025,1,1,255881,255881,255882,0,1,0
73026,6,1,255887,255887,255888,0,1,5
73027,3,1,255890,255890,255891,0,1,2
73028,4,1,255894,255894,255895,0,1,3
73029,5,2,255899,255899,255901,0,2,4
73030,5,2,255904,255904,255906,0,2,3
73031,1,1,255905,255906,255907,1,2,0
73032,4,3,255909,255909,255912,0,3,2
73033,1,3,255910,255912,255915,2,5,0
73034,6,3,255916,255916,255919,0,3,1
73035,1,3,255917,255919,255922,2,5,0
73036,3,3,255920,255922,255925,2,5,0
73037,6,2,255926,255926,255928,0,2,1
73038,6,2,255932,255932,255934,0,2,4
73039,2,2,255934,255934,255936,0,2,0
73040,4,2,255938,255938,255940,0,2,2
73041,3,2,255941,255941,255943,0,2,1
73042,5,3,255946,255946,255949,0,3,3
73043,6,2,255952,255952,255954,0,2,3
73044,5,3,255957,255957,255960,0,3,3
73045,5,2,255962,255962,255964,0,2,2
73046,3,1,255965,255965,255966,0,1,1
73047,6,2,255971,255971,255973,0,2,5
73048,1,1,255972,255973,255974,1,2,0
73049,4,2,255976,255976,255978,0,2,2
73050,4,3,255980,255980,255983,0,3,2
73051,4,2,255984,255984,255986,0,2,1
73052,5,3,255989,255989,255992,0,3,3
73053,3,1,255992,255992,255993,0,1,0
73054,4,2,255996,255996,255998,0,2,3
73055,4,1,256000,256000,256001,0,1,2
73056,6,2,256006,256006,256008,0,2,5
73057,3,2,256009,256009,256011,0,2,1
73058,3,3,256012,256012,256015,0,3,1
73059,3,3,256015,256015,256018,0,3,0
73060,6,3,256021,256021,256024,0,3,3
73061,3,1,256024,256024,256025,0,1,0
73062,6,1,256030,256030,256031,0,1,5
73063,5,2,256035,256035,256037,0,2,4
73064,3,1,256038,256038,256039,0,1,1
73065,4,3,256042,256042,256045,0,3,3
73066,5,2,256047,256047,256049,0,2,2
73067,5,1,256052,256052,256053,0,1,3
73068,6,3,256058,256058,256061,0,3,5
73069,3,2,256061,256061,256063,0,2,0
73070,4,3,256065,256065,256068,0,3,2
73071,1,3,256066,256068,256071,2,5,0
73072,5,1,256071,256071,256072,0,1,0
73073,2,1,256073,256073,256074,0,1,1
73074,3,1,256076,256076,256077,0,1,2
73075,3,3,256079,256079,256082,0,3,2
73076,1,1,256080,256082,256083,2,3,0
73077,6,2,256086,256086,256088,0,2,3
73078,2,2,256088,256088,256090,0,2,0
73079,3,1,256091,256091,256092,0,1,1
73080,5,3,256096,256096,256099,0,3,4
73081,1,1,256097,256099,256100,2,3,0
73082,2,2,256099,256100,256102,1,3,0
73083,1,3,256100,256102,256105,2,5,0
73084,3,2,256103,256105,256107,2,4,0
73085,3,2,256106,256107,256109,1,3,0
73086,6,1,256112,256112,256113,0,1,3
73087,5,2,256117,256117,256119,0,2,4
73088,3,2,256120,256120,256122,0,2,1
73089,2,2,256122,256122,256124,0,2,0
73090,6,1,256128,256128,256129,0,1,4
73091,6,2,256134,256134,256136,0,2,5
73092,2,2,256136,256136,256138,0,2,0
73093,5,2,256141,256141,256143,0,2,3
73094,2,1,256143,256143,256144,0,1,0
73095,2,3,256145,256145,256148,0,3,1
73096,5,1,256150,256150,256151,0,1,2
73097,6,1,256156,256156,256157,0,1,5
73098,2,3,256158,256158,256161,0,3,1
73099,5,3,256163,256163,256166,0,3,2
73100,6,3,256169,256169,256172,0,3,3
73101,3,1,256172,256172,256173,0,1,0
73102,2,2,256174,256174,256176,0,2,1
73103,1,3,256175,256176,256179,1,4,0
73104,4,1,256179,256179,256180,0,1,0
73105,5,2,256184,256184,256186,0,2,4
73106,3,2,256187,256187,256189,0,2,1
73107,3,2,256190,256190,256192,0,2,1
73108,1,1,256191,256192,256193,1,2,0
73109,1,2,256192,256193,256195,1,3,0
73110,6,2,256198,256198,256200,0,2,3
73111,3,3,256201,256201,256204,0,3,1
73112,4,2,256205,256205,256207,0,2,1
73113,6,1,256211,256211,256212,0,1,4
73114,3,2,256214,256214,256216,0,2,2
73115,3,1,256217,256217,256218,0,1,1
73116,6,3,256223,256223,256226,0,3,5
73117,2,1,256225,256226,256227,1,2,0
73118,3,3,256228,256228,256231,0,3,1
73119,2,3,256230,256231,256234,1,4,0
73120,5,1,256235,256235,256236,0,1,1
73121,1,3,256236,256236,256239,0,3,0
73122,3,2,256239,256239,256241,0,2,0
73123,1,1,256240,256241,256242,1,2,0
73124,6,3,256246,256246,256249,0,3,4
73125,2,1,256248,256249,256250,1,2,0
73126,2,1,256250,256250,256251,0,1,0
73127,3,3,256253,256253,256256,0,3,2
73128,5,1,256258,256258,256259,0,1,2
73129,5,2,256263,256263,256265,0,2,4
73130,6,1,256269,256269,256270,0,1,4
73131,5,1,256274,256274,256275,0,1,4
73132,5,1,256279,256279,256280,0,1,4
73133,5,3,256284,256284,256287,0,3,4
73134,1,2,256285,256287,256289,2,4,0
73135,6,2,256291,256291,256293,0,2,2
73136,1,1,256292,256293,256294,1,2,0
73137,1,3,256293,256294,256297,1,4,0
73138,3,2,256296,256297,256299,1,3,0
73139,5,2,256301,256301,256303,0,2,2
73140,6,1,256307,256307,256308,0,1,4
73141,3,3,256310,256310,256313,0,3,2
73142,1,2,256311,256313,256315,2,4,0
73143,4,2,256315,256315,256317,0,2,0
73144,5,2,256320,256320,256322,0,2,3
73145,2,1,256322,256322,256323,0,1,0
73146,1,1,256323,256323,256324,0,1,0
73147,3,1,256326,256326,256327,0,1,2
73148,4,1,256330,256330,256331,0,1,3
73149,1,2,256331,256331,256333,0,2,0
73150,6,2,256337,256337,256339,0,2,4
73151,1,3,256338,256339,256342,1,4,0
73152,6,1,256344,256344,256345,0,1,2
73153,2,1,256346,256346,256347,0,1,1
73154,2,1,256348,256348,256349,0,1,1
73155,3,2,256351,256351,256353,0,2,2
73156,3,3,256354,256354,256357,0,3,1
73157,5,2,256359,256359,256361,0,2,2
73158,3,2,256362,256362,256364,0,2,1
73159,6,1,256368,256368,256369,0,1,4
73160,2,1,256370,256370,256371,0,1,1
73161,1,3,256371,256371,256374,0,3,0
73162,1,2,256372,256374,256376,2,4,0
73163,5,1,256377,256377,256378,0,1,1
73164,5,3,256382,256382,256385,0,3,4
73165,6,3,256388,256388,256391,0,3,3
73166,5,1,256393,256393,256394,0,1,2
73167,1,3,256394,256394,256397,0,3,0
73168,4,2,256398,256398,256400,0,2,1
73169,6,2,256404,256404,256406,0,2,4
73170,1,2,256405,256406,256408,1,3,0
73171,3,2,256408,256408,256410,0,2,0
73172,2,1,256410,256410,256411,0,1,0
73173,6,3,256416,256416,256419,0,3,5
73174,1,2,256417,256419,256421,2,4,0
73175,2,1,256419,256421,256422,2,3,0
73176,4,1,256423,256423,256424,0,1,1
73177,3,3,256426,256426,256429,0,3,2
73178,4,3,256430,256430,256433,0,3,1
73179,6,3,256436,256436,256439,0,3,3
73180,4,1,256440,256440,256441,0,1,1
73181,6,2,256446,256446,256448,0,2,5
73182,1,3,256447,256448,256451,1,4,0
73183,4,1,256451,256451,256452,0,1,0
73184,2,3,256453,256453,256456,0,3,1
73185,6,1,256459,256459,256460,0,1,3
73186,2,2,256461,256461,256463,0,2,1
73187,1,3,256462,256463,256466,1,4,0
73188,5,2,256467,256467,256469,0,2,1
73189,6,3,256473,256473,256476,0,3,4
73190,6,1,256479,256479,256480,0,1,3
73191,4,2,256483,256483,256485,0,2,3
73192,3,2,256486,256486,256488,0,2,1
73193,2,2,256488,256488,256490,0,2,0
73194,4,2,256492,256492,256494,0,2,2
73195,6,3,256498,256498,256501,0,3,4
73196,5,1,256503,256503,256504,0,1,2
73197,5,1,256508,256508,256509,0,1,4
73198,5,3,256513,256513,256516,0,3,4
73199,3,2,256516,256516,256518,0,2,0
73200,4,1,256520,256520,256521,0,1,2
73201,3,3,256523,256523,256526,0,3,2
73202,4,2,256527,256527,256529,0,2,1
73203,5,2,256532,256532,256534,0,2,3
73204,4,2,256536,256536,256538,0,2,2
73205,2,2,256538,256538,256540,0,2,0
73206,2,3,256540,256540,256543,0,3,0
73207,6,2,256546,256546,256548,0,2,3
73208,5,2,256551,256551,256553,0,2,3
73209,1,2,256552,256553,256555,1,3,0
73210,6,2,256558,256558,256560,0,2,3
73211,5,3,256563,256563,256566,0,3,3
73212,1,2,256564,256566,256568,2,4,0
73213,2,3,256566,256568,256571,2,5,0
73214,1,2,256567,256571,256573,4,6,0
73215,4,2,256571,256573,256575,2,4,0
73216,5,1,256576,256576,256577,0,1,1
73217,6,2,256582,256582,256584,0,2,5
73218,1,3,256583,256584,256587,1,4,0
73219,4,3,256587,256587,256590,0,3,0
73220,3,2,256590,256590,256592,0,2,0
73221,1,1,256591,256592,256593,1,2,0
73222,2,3,256593,256593,256596,0,3,0
73223,1,2,256594,256596,256598,2,4,0
73224,1,1,256595,256598,256599,3,4,0
73225,1,3,256596,256599,256602,3,6,0
73226,3,3,256599,256602,256605,3,6,0
73227,4,1,256603,256605,256606,2,3,0
73228,2,1,256605,256606,256607,1,2,0
73229,1,1,256606,256607,256608,1,2,0
73230,2,2,256608,256608,256610,0,2,0
73231,2,1,256610,256610,256611,0,1,0
73232,6,3,256616,256616,256619,0,3,5
73233,4,2,256620,256620,256622,0,2,1
73234,6,1,256626,256626,256627,0,1,4
73235,4,3,256630,256630,256633,0,3,3
73236,4,1,256634,256634,256635,0,1,1
73237,6,1,256640,256640,256641,0,1,5
73238,2,2,256642,256642,256644,0,2,1
73239,1,2,256643,256644,256646,1,3,0
73240,3,2,256646,256646,256648,0,2,0
73241,6,3,256652,256652,256655,0,3,4
73242,5,1,256657,256657,256658,0,1,2
73243,5,3,256662,256662,256665,0,3,4
73244,4,2,256666,256666,256668,0,2,1
73245,4,1,256670,256670,256671,0,1,2
73246,3,1,256673,256673,256674,0,1,2
73247,4,2,256677,256677,256679,0,2,3
73248,2,2,256679,256679,256681,0,2,0
73249,4,2,256683,256683,256685,0,2,2
73250,2,2,256685,256685,256687,0,2,0
73251,5,2,256690,256690,256692,0,2,3
73252,5,1,256695,256695,256696,0,1,3
73253,4,1,256699,256699,256700,0,1,3
73254,1,1,256700,256700,256701,0,1,0
73255,6,1,256706,256706,256707,0,1,5
73256,2,1,256708,256708,256709,0,1,1
73257,3,2,256711,256711,256713,0,2,2
73258,3,1,256714,256714,256715,0,1,1
73259,4,3,256718,256718,256721,0,3,3
73260,3,1,256721,256721,256722,0,1,0
73261,5,2,256726,256726,256728,0,2,4
73262,2,1,256728,256728,256729,0,1,0
73263,3,2,256731,256731,256733,0,2,2
73264,5,2,256736,256736,256738,0,2,3
73265,1,3,256737,256738,256741,1,4,0
73266,3,2,256740,256741,256743,1,3,0
73267,4,3,256744,256744,256747,0,3,1
73268,3,1,256747,256747,256748,0,1,0
73269,2,2,256749,256749,256751,0,2,1
73270,5,3,256754,256754,256757,0,3,3
73271,3,3,256757,256757,256760,0,3,0
73272,2,2,256759,256760,256762,1,3,0
73273,5,3,256764,256764,256767,0,3,2
73274,4,3,256768,256768,256771,0,3,1
73275,2,1,256770,256771,256772,1,2,0
73276,3,3,256773,256773,256776,0,3,1
73277,1,2,256774,256776,256778,2,4,0
73278,1,1,256775,256778,256779,3,4,0
73279,4,1,256779,256779,256780,0,1,0
73280,6,1,256785,256785,256786,0,1,5
73281,6,2,256791,256791,256793,0,2,5
73282,5,2,256796,256796,256798,0,2,3
73283,2,3,256798,256798,256801,0,3,0
73284,5,2,256803,256803,256805,0,2,2
73285,2,2,256805,256805,256807,0,2,0
73286,5,3,256810,256810,256813,0,3,3
73287,1,1,256811,256813,256814,2,3,0
73288,2,2,256813,256814,256816,1,3,0
73289,1,3,256814,256816,256819,2,5,0
73290,5,2,256819,256819,256821,0,2,0
73291,5,2,256824,256824,256826,0,2,3
73292,1,2,256825,256826,256828,1,3,0
73293,1,2,256826,256828,256830,2,4,0
73294,3,3,256829,256830,256833,1,4,0
73295,1,2,256830,256833,256835,3,5,0
73296,1,1,256831,256835,256836,4,5,0
73297,1,2,256832,256836,256838,4,6,0
73298,3,2,256835,256838,256840,3,5,0
73299,4,2,256839,256840,256842,1,3,0
73300,1,3,256840,256842,256845,2,5,0
73301,6,1,256846,256846,256847,0,1,1
73302,4,2,256850,256850,256852,0,2,3
73303,6,1,256856,256856,256857,0,1,4
73304,4,1,256860,256860,256861,0,1,3
73305,6,3,256866,256866,256869,0,3,5
73306,3,3,256869,256869,256872,0,3,0
73307,2,2,256871,256872,256874,1,3,0
73308,3,3,256874,256874,256877,0,3,0
73309,1,1,256875,256877,256878,2,3,0
73310,3,1,256878,256878,256879,0,1,0
73311,5,1,256883,256883,256884,0,1,4
73312,3,3,256886,256886,256889,0,3,2
73313,3,2,256889,256889,256891,0,2,0
73314,5,3,256894,256894,256897,0,3,3
73315,1,1,256895,256897,256898,2,3,0
73316,2,3,256897,256898,256901,1,4,0
73317,1,2,256898,256901,256903,3,5,0
73318,6,2,256904,256904,256906,0,2,1
73319,2,1,256906,256906,256907,0,1,0
73320,5,1,256911,256911,256912,0,1,4
73321,4,2,256915,256915,256917,0,2,3
73322,1,3,256916,256917,256920,1,4,0
73323,5,3,256921,256921,256924,0,3,1
73324,3,3,256924,256924,256927,0,3,0
73325,1,2,256925,256927,256929,2,4,0
73326,2,3,256927,256929,256932,2,5,0
73327,1,1,256928,256932,256933,4,5,0
73328,6,1,256934,256934,256935,0,1,1
73329,4,1,256938,256938,256939,0,1,3
73330,4,2,256942,256942,256944,0,2,3
73331,6,3,256948,256948,256951,0,3,4
73332,4,3,256952,256952,256955,0,3,1
73333,6,3,256958,256958,256961,0,3,3
73334,6,3,256964,256964,256967,0,3,3
73335,2,2,256966,256967,256969,1,3,0
73336,1,1,256967,256969,256970,2,3,0
73337,6,1,256973,256973,256974,0,1,3
73338,2,2,256975,256975,256977,0,2,1
73339,1,2,256976,256977,256979,1,3,0
73340,5,1,256981,256981,256982,0,1,2
73341,5,1,256986,256986,256987,0,1,4
73342,1,3,256987,256987,256990,0,3,0
73343,2,2,256989,256990,256992,1,3,0
73344,2,3,256991,256992,256995,1,4,0
73345,5,3,256996,256996,256999,0,3,1
73346,1,3,256997,256999,257002,2,5,0
73347,2,2,256999,257002,257004,3,5,0
73348,1,3,257000,257004,257007,4,7,0
73349,3,2,257003,257007,257009,4,6,0
73350,2,1,257005,257009,257010,4,5,0
73351,1,1,257006,257010,257011,4,5,0
73352,5,2,257011,257011,257013,0,2,0
73353,2,2,257013,257013,257015,0,2,0
73354,6,3,257019,257019,257022,0,3,4
73355,1,3,257020,257022,257025,2,5,0
73356,5,2,257025,257025,257027,0,2,0
73357,3,2,257028,257028,257030,0,2,1
73358,2,3,257030,257030,257033,0,3,0
73359,4,1,257034,257034,257035,0,1,1
73360,3,1,257037,257037,257038,0,1,2
73361,6,1,257043,257043,257044,0,1,5
73362,6,2,257049,257049,257051,0,2,5
73363,3,1,257052,257052,257053,0,1,1
73364,2,3,257054,257054,257057,0,3,1
73365,3,3,257057,257057,257060,0,3,0
73366,4,1,257061,257061,257062,0,1,1
73367,5,2,257066,257066,257068,0,2,4
73368,6,3,257072,257072,257075,0,3,4
73369,3,1,257075,257075,257076,0,1,0
73370,2,1,257077,257077,257078,0,1,1
73371,3,2,257080,257080,257082,0,2,2
73372,4,3,257084,257084,257087,0,3,2
73373,5,3,257089,257089,257092,0,3,2
73374,3,1,257092,257092,257093,0,1,0
73375,5,3,257097,257097,257100,0,3,4
73376,2,1,257099,257100,257101,1,2,0
73377,2,3,257101,257101,257104,0,3,0
73378,4,2,257105,257105,257107,0,2,1
73379,3,2,257108,257108,257110,0,2,1
73380,1,3,257109,257110,257113,1,4,0
73381,2,3,257111,257113,257116,2,5,0
73382,6,2,257117,257117,257119,0,2,1
73383,3,2,257120,257120,257122,0,2,1
73384,1,1,257121,257122,257123,1,2,0
73385,1,1,257122,257123,257124,1,2,0
73386,3,3,257125,257125,257128,0,3,1
73387,4,1,257129,257129,257130,0,1,1
73388,2,2,257131,257131,257133,0,2,1
73389,5,1,257136,257136,257137,0,1,3
73390,4,2,257140,257140,257142,0,2,3
73391,1,2,257141,257142,257144,1,3,0
73392,3,1,257144,257144,257145,0,1,0
73393,4,3,257148,257148,257151,0,3,3
73394,6,3,257154,257154,257157,0,3,3
73395,3,2,257157,257157,257159,0,2,0
73396,6,2,257163,257163,257165,0,2,4
73397,5,2,257168,257168,257170,0,2,3
73398,4,3,257172,257172,257175,0,3,2
73399,2,3,257174,257175,257178,1,4,0
73400,3,1,257177,257178,257179,1,2,0
73401,5,3,257182,257182,257185,0,3,3
73402,5,2,257187,257187,257189,0,2,2
73403,2,2,257189,257189,257191,0,2,0
73404,3,1,257192,257192,257193,0,1,1
73405,1,2,257193,257193,257195,0,2,0
73406,2,2,257195,257195,257197,0,2,0
73407,5,3,257200,257200,257203,0,3,3
73408,2,2,257202,257203,257205,1,3,0
73409,1,1,257203,257205,257206,2,3,0
73410,6,2,257209,257209,257211,0,2,3
73411,4,1,257213,257213,257214,0,1,2
73412,4,2,257217,257217,257219,0,2,3
73413,4,1,257221,257221,257222,0,1,2
73414,1,3,257222,257222,257225,0,3,0
73415,4,3,257226,257226,257229,0,3,1
73416,2,3,257228,257229,257232,1,4,0
73417,3,2,257231,257232,257234,1,3,0
73418,4,1,257235,257235,257236,0,1,1
73419,5,2,257240,257240,257242,0,2,4
73420,5,3,257245,257245,257248,0,3,3
73421,2,2,257247,257248,257250,1,3,0
73422,2,2,257249,257250,257252,1,3,0
73423,6,3,257255,257255,257258,0,3,3
73424,4,2,257259,257259,257261,0,2,1
73425,5,3,257264,257264,257267,0,3,3
73426,3,1,257267,257267,257268,0,1,0
73427,1,2,257268,257268,257270,0,2,0
73428,1,1,257269,257270,257271,1,2,0
73429,4,1,257273,257273,257274,0,1,2
73430,2,2,257275,257275,257277,0,2,1
73431,4,1,257279,257279,257280,0,1,2
73432,2,2,257281,257281,257283,0,2,1
73433,1,1,257282,257283,257284,1,2,0
73434,4,3,257286,257286,257289,0,3,2
73435,5,3,257291,257291,257294,0,3,2
73436,6,1,257297,257297,257298,0,1,3
73437,2,1,257299,257299,257300,0,1,1
73438,1,1,257300,257300,257301,0,1,0
73439,1,1,257301,257301,257302,0,1,0
73440,2,3,257303,257303,257306,0,3,1
73441,3,3,257306,257306,257309,0,3,0
73442,5,3,257311,257311,257314,0,3,2
73443,1,2,257312,257314,257316,2,4,0
73444,6,1,257318,257318,257319,0,1,2
73445,2,3,257320,257320,257323,0,3,1
73446,1,2,257321,257323,257325,2,4,0
73447,6,2,257327,257327,257329,0,2,2
73448,5,1,257332,257332,257333,0,1,3
73449,3,3,257335,257335,257338,0,3,2
73450,5,1,257340,257340,257341,0,1,2
73451,4,3,257344,257344,257347,0,3,3
73452,2,1,257346,257347,257348,1,2,0
73453,3,2,257349,257349,257351,0,2,1
73454,3,1,257352,257352,257353,0,1,1
73455,3,1,257355,257355,257356,0,1,2
73456,1,3,257356,257356,257359,0,3,0
73457,4,2,257360,257360,257362,0,2,1
73458,4,3,257364,257364,257367,0,3,2
73459,4,1,257368,257368,257369,0,1,1
73460,3,3,257371,257371,257374,0,3,2
73461,1,3,257372,257374,257377,2,5,0
73462,4,1,257376,257377,257378,1,2,0
73463,3,2,257379,257379,257381,0,2,1
73464,3,1,257382,257382,257383,0,1,1
73465,4,3,257386,257386,257389,0,3,3
73466,5,1,257391,257391,257392,0,1,2
73467,6,1,257397,257397,257398,0,1,5
73468,5,2,257402,257402,257404,0,2,4
73469,2,1,257404,257404,257405,0,1,0
73470,6,2,257410,257410,257412,0,2,5
73471,1,2,257411,257412,257414,1,3,0
73472,5,3,257416,257416,257419,0,3,2
73473,1,1,257417,257419,257420,2,3,0
73474,6,3,257423,257423,257426,0,3,3
73475,2,1,257425,257426,257427,1,2,0
73476,4,2,257429,257429,257431,0,2,2
73477,6,3,257435,257435,257438,0,3,4
73478,5,2,257440,257440,257442,0,2,2
73479,2,3,257442,257442,257445,0,3,0
73480,5,2,257447,257447,257449,0,2,2
73481,1,1,257448,257449,257450,1,2,0
73482,4,2,257452,257452,257454,0,2,2
73483,3,1,257455,257455,257456,0,1,1
73484,6,3,257461,257461,257464,0,3,5
73485,1,3,257462,257464,257467,2,5,0
73486,6,2,257468,257468,257470,0,2,1
73487,1,2,257469,257470,257472,1,3,0
73488,3,3,257472,257472,257475,0,3,0
73489,2,1,257474,257475,257476,1,2,0
73490,2,2,257476,257476,257478,0,2,0
73491,3,2,257479,257479,257481,0,2,1
73492,3,3,257482,257482,257485,0,3,1
73493,6,1,257488,257488,257489,0,1,3
73494,4,3,257492,257492,257495,0,3,3
73495,1,2,257493,257495,257497,2,4,0
73496,4,1,257497,257497,257498,0,1,0
73497,6,3,257503,257503,257506,0,3,5
73498,4,2,257507,257507,257509,0,2,1
73499,3,3,257510,257510,257513,0,3,1
73500,2,3,257512,257513,257516,1,4,0
73501,1,1,257513,257516,257517,3,4,0
73502,1,2,257514,257517,257519,3,5,0
73503,4,2,257518,257519,257521,1,3,0
73504,4,1,257522,257522,257523,0,1,1
73505,4,2,257526,257526,257528,0,2,3
73506,3,2,257529,257529,257531,0,2,1
73507,1,3,257530,257531,257534,1,4,0
73508,6,2,257536,257536,257538,0,2,2
73509,1,1,257537,257538,257539,1,2,0
73510,2,3,257539,257539,257542,0,3,0
73511,4,2,257543,257543,257545,0,2,1
73512,5,3,257548,257548,257551,0,3,3
73513,3,1,257551,257551,257552,0,1,0
73514,2,2,257553,257553,257555,0,2,1
73515,1,2,257554,257555,257557,1,3,0
73516,4,3,257558,257558,257561,0,3,1
73517,3,1,257561,257561,257562,0,1,0
73518,5,2,257566,257566,257568,0,2,4
73519,2,2,257568,257568,257570,0,2,0
73520,4,1,257572,257572,257573,0,1,2
73521,1,1,257573,257573,257574,0,1,0
73522,2,1,257575,257575,257576,0,1,1
73523,5,3,257580,257580,257583,0,3,4
73524,5,3,257585,257585,257588,0,3,2
73525,4,2,257589,257589,257591,0,2,1
73526,6,3,257595,257595,257598,0,3,4
73527,3,1,257598,257598,257599,0,1,0
73528,3,3,257601,257601,257604,0,3,2
73529,4,2,257605,257605,257607,0,2,1
73530,5,2,257610,257610,257612,0,2,3
73531,3,2,257613,257613,257615,0,2,1
73532,4,3,257617,257617,257620,0,3,2
73533,4,3,257621,257621,257624,0,3,1
73534,6,2,257627,257627,257629,0,2,3
73535,5,3,257632,257632,257635,0,3,3
73536,6,2,257638,257638,257640,0,2,3
73537,5,2,257643,257643,257645,0,2,3
73538,6,2,257649,257649,257651,0,2,4
73539,2,1,257651,257651,257652,0,1,0
73540,3,3,257654,257654,257657,0,3,2
73541,2,1,257656,257657,257658,1,2,0
73542,5,3,257661,257661,257664,0,3,3
73543,5,2,257666,257666,257668,0,2,2
73544,4,2,257670,257670,257672,0,2,2
73545,5,3,257675,257675,257678,0,3,3
73546,1,2,257676,257678,257680,2,4,0
73547,3,2,257679,257680,257682,1,3,0
73548,1,1,257680,257682,257683,2,3,0
73549,6,2,257686,257686,257688,0,2,3
73550,1,1,257687,257688,257689,1,2,0
73551,4,2,257691,257691,257693,0,2,2
73552,5,3,257696,257696,257699,0,3,3
73553,1,3,257697,257699,257702,2,5,0
73554,1,1,257698,257702,257703,4,5,0
73555,3,1,257701,257703,257704,2,3,0
73556,4,3,257705,257705,257708,0,3,1
73557,2,1,257707,257708,257709,1,2,0
73558,2,2,257709,257709,257711,0,2,0
73559,5,1,257714,257714,257715,0,1,3
73560,3,2,257717,257717,257719,0,2,2
73561,5,1,257722,257722,257723,0,1,3
73562,5,1,257727,257727,257728,0,1,4
73563,4,3,257731,257731,257734,0,3,3
73564,1,3,257732,257734,257737,2,5,0
73565,4,2,257736,257737,257739,1,3,0
73566,6,2,257742,257742,257744,0,2,3
73567,2,1,257744,257744,257745,0,1,0
73568,2,3,257746,257746,257749,0,3,1
73569,4,3,257750,257750,257753,0,3,1
73570,1,3,257751,257753,257756,2,5,0
73571,4,1,257755,257756,257757,1,2,0
73572,3,1,257758,257758,257759,0,1,1
73573,5,3,257763,257763,257766,0,3,4
73574,3,2,257766,257766,257768,0,2,0
73575,5,3,257771,257771,257774,0,3,3
73576,6,2,257777,257777,257779,0,2,3
73577,1,3,257778,257779,257782,1,4,0
73578,6,3,257784,257784,257787,0,3,2
73579,3,1,257787,257787,257788,0,1,0
73580,1,3,257788,257788,257791,0,3,0
73581,1,1,257789,257791,257792,2,3,0
73582,1,1,257790,257792,257793,2,3,0
73583,6,2,257796,257796,257798,0,2,3
73584,6,2,257802,257802,257804,0,2,4
73585,6,1,257808,257808,257809,0,1,4
73586,3,1,257811,257811,257812,0,1,2
73587,1,3,257812,257812,257815,0,3,0
73588,5,1,257817,257817,257818,0,1,2
73589,4,2,257821,257821,257823,0,2,3
73590,5,2,257826,257826,257828,0,2,3
73591,1,1,257827,257828,257829,1,2,0
73592,2,2,257829,257829,257831,0,2,0
73593,6,3,257835,257835,257838,0,3,4
73594,2,1,257837,257838,257839,1,2,0
73595,2,2,257839,257839,257841,0,2,0
73596,2,2,257841,257841,257843,0,2,0
73597,2,3,257843,257843,257846,0,3,0
73598,6,3,257849,257849,257852,0,3,3
73599,3,1,257852,257852,257853,0,1,0
73600,1,1,257853,257853,257854,0,1,0
73601,4,2,257857,257857,257859,0,2,3
73602,6,1,257863,257863,257864,0,1,4
73603,2,2,257865,257865,257867,0,2,1
73604,3,2,257868,257868,257870,0,2,1
73605,2,1,257870,257870,257871,0,1,0
73606,1,1,257871,257871,257872,0,1,0
73607,5,2,257876,257876,257878,0,2,4
73608,2,1,257878,257878,257879,0,1,0
73609,1,1,257879,257879,257880,0,1,0
73610,4,3,257883,257883,257886,0,3,3
73611,3,3,257886,257886,257889,0,3,0
73612,6,3,257892,257892,257895,0,3,3
73613,4,3,257896,257896,257899,0,3,1
73614,6,2,257902,257902,257904,0,2,3
73615,5,1,257907,257907,257908,0,1,3
73616,2,2,257909,257909,257911,0,2,1
73617,6,2,257915,257915,257917,0,2,4
73618,2,1,257917,257917,257918,0,1,0
73619,1,1,257918,257918,257919,0,1,0
73620,4,2,257922,257922,257924,0,2,3
73621,1,1,257923,257924,257925,1,2,0
73622,1,1,257924,257925,257926,1,2,0
73623,3,1,257927,257927,257928,0,1,1
73624,2,3,257929,257929,257932,0,3,1
73625,3,2,257932,257932,257934,0,2,0
73626,3,2,257935,257935,257937,0,2,1
73627,3,1,257938,257938,257939,0,1,1
73628,1,1,257939,257939,257940,0,1,0
73629,5,3,257944,257944,257947,0,3,4
73630,1,1,257945,257947,257948,2,3,0
73631,3,3,257948,257948,257951,0,3,0
73632,4,2,257952,257952,257954,0,2,1
73633,6,1,257958,257958,257959,0,1,4
73634,6,3,257964,257964,257967,0,3,5
73635,5,2,257969,257969,257971,0,2,2
73636,6,1,257975,257975,257976,0,1,4
73637,5,2,257980,257980,257982,0,2,4
73638,2,2,257982,257982,257984,0,2,0
73639,2,2,257984,257984,257986,0,2,0
73640,5,3,257989,257989,257992,0,3,3
73641,3,2,257992,257992,257994,0,2,0
73642,2,2,257994,257994,257996,0,2,0
73643,5,3,257999,257999,258002,0,3,3
73644,5,3,258004,258004,258007,0,3,2
73645,1,1,258005,258007,258008,2,3,0
73646,1,1,258006,258008,258009,2,3,0
73647,2,2,258008,258009,258011,1,3,0
73648,2,1,258010,258011,258012,1,2,0
73649,1,2,258011,258012,258014,1,3,0
73650,5,2,258016,258016,258018,0,2,2
73651,2,2,258018,258018,258020,0,2,0
73652,2,3,258020,258020,258023,0,3,0
73653,5,1,258025,258025,258026,0,1,2
73654,2,3,258027,258027,258030,0,3,1
73655,3,2,258030,258030,258032,0,2,0
73656,3,1,258033,258033,258034,0,1,1
73657,3,2,258036,258036,258038,0,2,2
73658,5,2,258041,258041,258043,0,2,3
73659,1,3,258042,258043,258046,1,4,0
73660,6,2,258048,258048,258050,0,2,2
73661,3,1,258051,258051,258052,0,1,1
73662,6,3,258057,258057,258060,0,3,5
73663,4,2,258061,258061,258063,0,2,1
73664,2,1,258063,258063,258064,0,1,0
73665,4,1,258067,258067,258068,0,1,3
73666,1,1,258068,258068,258069,0,1,0
73667,3,2,258071,258071,258073,0,2,2
73668,6,3,258077,258077,258080,0,3,4
73669,1,1,258078,258080,258081,2,3,0
73670,3,1,258081,258081,258082,0,1,0
73671,6,3,258087,258087,258090,0,3,5
73672,1,1,258088,258090,258091,2,3,0
73673,4,1,258092,258092,258093,0,1,1
73674,6,3,258098,258098,258101,0,3,5
73675,4,2,258102,258102,258104,0,2,1
73676,1,3,258103,258104,258107,1,4,0
73677,2,3,258105,258107,258110,2,5,0
73678,6,1,258111,258111,258112,0,1,1
73679,2,2,258113,258113,258115,0,2,1
73680,1,3,258114,258115,258118,1,4,0
73681,3,1,258117,258118,258119,1,2,0
73682,2,3,258119,258119,258122,0,3,0
73683,2,2,258121,258122,258124,1,3,0
73684,3,1,258124,258124,258125,0,1,0
73685,2,3,258126,258126,258129,0,3,1
73686,1,3,258127,258129,258132,2,5,0
73687,6,1,258133,258133,258134,0,1,1
73688,2,1,258135,258135,258136,0,1,1
73689,4,3,258139,258139,258142,0,3,3
73690,5,3,258144,258144,258147,0,3,2
73691,1,3,258145,258147,258150,2,5,0
73692,4,2,258149,258150,258152,1,3,0
73693,2,2,258151,258152,258154,1,3,0
73694,6,1,258157,258157,258158,0,1,3
73695,1,1,258158,258158,258159,0,1,0
73696,6,2,258164,258164,258166,0,2,5
73697,1,2,258165,258166,258168,1,3,0
73698,6,3,258171,258171,258174,0,3,3
73699,2,1,258173,258174,258175,1,2,0
73700,4,2,258177,258177,258179,0,2,2
73701,2,2,258179,258179,258181,0,2,0
73702,3,3,258182,258182,258185,0,3,1
73703,5,2,258187,258187,258189,0,2,2
73704,3,3,258190,258190,258193,0,3,1
73705,1,1,258191,258193,258194,2,3,0
73706,6,3,258197,258197,258200,0,3,3
73707,4,2,258201,258201,258203,0,2,1
73708,2,2,258203,258203,258205,0,2,0
73709,6,1,258209,258209,258210,0,1,4
73710,6,2,258215,258215,258217,0,2,5
73711,3,3,258218,258218,258221,0,3,1
73712,4,2,258222,258222,258224,0,2,1
73713,5,3,258227,258227,258230,0,3,3
73714,4,3,258231,258231,258234,0,3,1
73715,2,3,258233,258234,258237,1,4,0
73716,1,3,258234,258237,258240,3,6,0
73717,1,2,258235,258240,258242,5,7,0
73718,1,2,258236,258242,258244,6,8,0
73719,2,3,258238,258244,258247,6,9,0
73720,3,2,258241,258247,258249,6,8,0
73721,1,3,258242,258249,258252,7,10,0
73722,1,3,258243,258252,258255,9,12,0
73723,1,1,258244,258255,258256,11,12,0
73724,2,1,258246,258256,258257,10,11,0
73725,6,1,258252,258257,258258,5,6,0
73726,3,2,258255,258258,258260,3,5,0
73727,5,1,258260,258260,258261,0,1,0
73728,2,1,258262,258262,258263,0,1,1
73729,5,2,258267,258267,258269,0,2,4
73730,6,3,258273,258273,258276,0,3,4
73731,6,3,258279,258279,258282,0,3,3
73732,4,3,258283,258283,258286,0,3,1
73733,6,1,258289,258289,258290,0,1,3
73734,6,2,258295,258295,258297,0,2,5
73735,2,2,258297,258297,258299,0,2,0
73736,1,1,258298,258299,258300,1,2,0
73737,5,3,258303,258303,258306,0,3,3
73738,3,1,258306,258306,258307,0,1,0
73739,6,1,258312,258312,258313,0,1,5
73740,3,2,258315,258315,258317,0,2,2
73741,3,3,258318,258318,258321,0,3,1
73742,6,2,258324,258324,258326,0,2,3
73743,2,3,258326,258326,258329,0,3,0
73744,2,3,258328,258329,258332,1,4,0
73745,1,2,258329,258332,258334,3,5,0
73746,3,1,258332,258334,258335,2,3,0
73747,5,2,258337,258337,258339,0,2,2
73748,1,3,258338,258339,258342,1,4,0
73749,2,1,258340,258342,258343,2,3,0
73750,2,2,258342,258343,258345,1,3,0
73751,4,2,258346,258346,258348,0,2,1
73752,2,1,258348,258348,258349,0,1,0
73753,1,1,258349,258349,258350,0,1,0
73754,5,1,258354,258354,258355,0,1,4
73755,6,1,258360,258360,258361,0,1,5
73756,3,1,258363,258363,258364,0,1,2
73757,4,3,258367,258367,258370,0,3,3
73758,2,1,258369,258370,258371,1,2,0
73759,1,1,258370,258371,258372,1,2,0
73760,4,2,258374,258374,258376,0,2,2
73761,1,2,258375,258376,258378,1,3,0
73762,2,2,258377,258378,258380,1,3,0
73763,4,1,258381,258381,258382,0,1,1
73764,4,1,258385,258385,258386,0,1,3
73765,2,1,258387,258387,258388,0,1,1
73766,5,3,258392,258392,258395,0,3,4
73767,4,1,258396,258396,258397,0,1,1
73768,1,1,258397,258397,258398,0,1,0
73769,1,1,258398,258398,258399,0,1,0
73770,2,3,258400,258400,258403,0,3,1
73771,2,1,258402,258403,258404,1,2,0
73772,6,3,258408,258408,258411,0,3,4
73773,3,3,258411,258411,258414,0,3,0
73774,5,1,258416,258416,258417,0,1,2
73775,1,3,258417,258417,258420,0,3,0
73776,3,3,258420,258420,258423,0,3,0
73777,2,2,258422,258423,258425,1,3,0
73778,1,2,258423,258425,258427,2,4,0
73779,2,1,258425,258427,258428,2,3,0
73780,4,1,258429,258429,258430,0,1,1
73781,3,2,258432,258432,258434,0,2,2
73782,3,1,258435,258435,258436,0,1,1
73783,2,2,258437,258437,258439,0,2,1
73784,2,1,258439,258439,258440,0,1,0
73785,3,1,258442,258442,258443,0,1,2
73786,5,3,258447,258447,258450,0,3,4
73787,3,3,258450,258450,258453,0,3,0
73788,1,2,258451,258453,258455,2,4,0
73789,6,1,258457,258457,258458,0,1,2
73790,1,2,258458,258458,258460,0,2,0
73791,5,3,258463,258463,258466,0,3,3
73792,1,2,258464,258466,258468,2,4,0
73793,3,2,258467,258468,258470,1,3,0
73794,1,1,258468,258470,258471,2,3,0
73795,5,2,258473,258473,258475,0,2,2
73796,3,2,258476,258476,258478,0,2,1
73797,5,1,258481,258481,258482,0,1,3
73798,5,2,258486,258486,258488,0,2,4
73799,6,1,258492,258492,258493,0,1,4
73800,1,1,258493,258493,258494,0,1,0
73801,3,1,258496,258496,258497,0,1,2
73802,1,2,258497,258497,258499,0,2,0
73803,2,1,258499,258499,258500,0,1,0
73804,3,2,258502,258502,258504,0,2,2
73805,2,2,258504,258504,258506,0,2,0
73806,6,1,258510,258510,258511,0,1,4
73807,4,3,258514,258514,258517,0,3,3
73808,6,2,258520,258520,258522,0,2,3
73809,4,2,258524,258524,258526,0,2,2
73810,2,2,258526,258526,258528,0,2,0
73811,1,3,258527,258528,258531,1,4,0
73812,4,1,258531,258531,258532,0,1,0
73813,4,1,258535,258535,258536,0,1,3
73814,4,1,258539,258539,258540,0,1,3
73815,1,2,258540,258540,258542,0,2,0
73816,3,2,258543,258543,258545,0,2,1
73817,2,1,258545,258545,258546,0,1,0
73818,5,1,258550,258550,258551,0,1,4
73819,4,2,258554,258554,258556,0,2,3
73820,2,1,258556,258556,258557,0,1,0
73821,6,1,258562,258562,258563,0,1,5
73822,5,1,258567,258567,258568,0,1,4
73823,2,2,258569,258569,258571,0,2,1
73824,6,3,258575,258575,258578,0,3,4
73825,6,3,258581,258581,258584,0,3,3
73826,6,1,258587,258587,258588,0,1,3
73827,4,2,258591,258591,258593,0,2,3
73828,1,3,258592,258593,258596,1,4,0
73829,1,1,258593,258596,258597,3,4,0
73830,4,1,258597,258597,258598,0,1,0
73831,3,2,258600,258600,258602,0,2,2
73832,5,2,258605,258605,258607,0,2,3
73833,1,2,258606,258607,258609,1,3,0
73834,2,3,258608,258609,258612,1,4,0
73835,1,3,258609,258612,258615,3,6,0
73836,6,1,258615,258615,258616,0,1,0
73837,6,1,258621,258621,258622,0,1,5
73838,5,3,258626,258626,258629,0,3,4
73839,6,3,258632,258632,258635,0,3,3
73840,6,2,258638,258638,258640,0,2,3
73841,5,3,258643,258643,258646,0,3,3
73842,3,2,258646,258646,258648,0,2,0
73843,3,3,258649,258649,258652,0,3,1
73844,4,2,258653,258653,258655,0,2,1
73845,4,3,258657,258657,258660,0,3,2
73846,2,2,258659,258660,258662,1,3,0
73847,3,2,258662,258662,258664,0,2,0
73848,6,3,258668,258668,258671,0,3,4
73849,3,3,258671,258671,258674,0,3,0
73850,1,2,258672,258674,258676,2,4,0
73851,5,2,258677,258677,258679,0,2,1
73852,5,3,258682,258682,258685,0,3,3
73853,5,3,258687,258687,258690,0,3,2
73854,3,1,258690,258690,258691,0,1,0
73855,3,1,258693,258693,258694,0,1,2
73856,4,2,258697,258697,258699,0,2,3
73857,6,2,258703,258703,258705,0,2,4
73858,2,2,258705,258705,258707,0,2,0
73859,6,3,258711,258711,258714,0,3,4
73860,2,3,258713,258714,258717,1,4,0
73861,5,2,258718,258718,258720,0,2,1
73862,5,1,258723,258723,258724,0,1,3
73863,4,1,258727,258727,258728,0,1,3
73864,2,1,258729,258729,258730,0,1,1
73865,2,3,258731,258731,258734,0,3,1
73866,2,2,258733,258734,258736,1,3,0
73867,6,2,258739,258739,258741,0,2,3
73868,4,1,258743,258743,258744,0,1,2
73869,3,2,258746,258746,258748,0,2,2
73870,5,1,258751,258751,258752,0,1,3
73871,3,3,258754,258754,258757,0,3,2
73872,6,2,258760,258760,258762,0,2,3
73873,4,2,258764,258764,258766,0,2,2
73874,1,1,258765,258766,258767,1,2,0
73875,1,2,258766,258767,258769,1,3,0
73876,4,2,258770,258770,258772,0,2,1
73877,2,2,258772,258772,258774,0,2,0
73878,3,1,258775,258775,258776,0,1,1
73879,1,1,258776,258776,258777,0,1,0
73880,5,2,258781,258781,258783,0,2,4
73881,1,3,258782,258783,258786,1,4,0
73882,4,2,258786,258786,258788,0,2,0
73883,5,1,258791,258791,258792,0,1,3
73884,2,1,258793,258793,258794,0,1,1
73885,6,3,258799,258799,258802,0,3,5
73886,4,3,258803,258803,258806,0,3,1
73887,1,3,258804,258806,258809,2,5,0
73888,1,2,258805,258809,258811,4,6,0
73889,1,3,258806,258811,258814,5,8,0
73890,5,1,258811,258814,258815,3,4,0
73891,1,3,258812,258815,258818,3,6,0
73892,3,2,258815,258818,258820,3,5,0
73893,1,3,258816,258820,258823,4,7,0
73894,2,2,258818,258823,258825,5,7,0
73895,6,1,258824,258825,258826,1,2,0
73896,4,3,258828,258828,258831,0,3,2
73897,4,1,258832,258832,258833,0,1,1
73898,6,1,258838,258838,258839,0,1,5
73899,3,2,258841,258841,258843,0,2,2
73900,6,2,258847,258847,258849,0,2,4
73901,2,2,258849,258849,258851,0,2,0
73902,5,2,258854,258854,258856,0,2,3
73903,1,2,258855,258856,258858,1,3,0
73904,5,3,258860,258860,258863,0,3,2
73905,2,2,258862,258863,258865,1,3,0
73906,6,3,258868,258868,258871,0,3,3
73907,2,3,258870,258871,258874,1,4,0
73908,1,3,258871,258874,258877,3,6,0
73909,5,3,258876,258877,258880,1,4,0
73910,5,2,258881,258881,258883,0,2,1
73911,4,3,258885,258885,258888,0,3,2
73912,4,2,258889,258889,258891,0,2,1
73913,5,2,258894,258894,258896,0,2,3
73914,5,2,258899,258899,258901,0,2,3
73915,1,3,258900,258901,258904,1,4,0
73916,4,1,258904,258904,258905,0,1,0
73917,6,2,258910,258910,258912,0,2,5
73918,3,1,258913,258913,258914,0,1,1
73919,1,2,258914,258914,258916,0,2,0
73920,4,2,258918,258918,258920,0,2,2
73921,3,1,258921,258921,258922,0,1,1
73922,4,2,258925,258925,258927,0,2,3
73923,5,3,258930,258930,258933,0,3,3
73924,4,2,258934,258934,258936,0,2,1
73925,3,1,258937,258937,258938,0,1,1
73926,5,3,258942,258942,258945,0,3,4
73927,4,3,258946,258946,258949,0,3,1
73928,5,3,258951,258951,258954,0,3,2
73929,4,2,258955,258955,258957,0,2,1
73930,3,1,258958,258958,258959,0,1,1
73931,5,2,258963,258963,258965,0,2,4
73932,2,3,258965,258965,258968,0,3,0
73933,1,3,258966,258968,258971,2,5,0
73934,4,1,258970,258971,258972,1,2,0
73935,6,1,258976,258976,258977,0,1,4
73936,4,3,258980,258980,258983,0,3,3
73937,2,3,258982,258983,258986,1,4,0
73938,1,3,258983,258986,258989,3,6,0
73939,5,3,258988,258989,258992,1,4,0
73940,3,2,258991,258992,258994,1,3,0
73941,6,3,258997,258997,259000,0,3,3
73942,2,3,258999,259000,259003,1,4,0
73943,4,3,259003,259003,259006,0,3,0
73944,5,2,259008,259008,259010,0,2,2
73945,1,1,259009,259010,259011,1,2,0
73946,3,1,259012,259012,259013,0,1,1
73947,2,2,259014,259014,259016,0,2,1
73948,5,2,259019,259019,259021,0,2,3
73949,3,1,259022,259022,259023,0,1,1
73950,1,3,259023,259023,259026,0,3,0
73951,3,3,259026,259026,259029,0,3,0
73952,3,2,259029,259029,259031,0,2,0
73953,1,1,259030,259031,259032,1,2,0
73954,3,3,259033,259033,259036,0,3,1
73955,5,2,259038,259038,259040,0,2,2
73956,4,1,259042,259042,259043,0,1,2
73957,2,1,259044,259044,259045,0,1,1
73958,2,2,259046,259046,259048,0,2,1
73959,1,3,259047,259048,259051,1,4,0
73960,6,2,259053,259053,259055,0,2,2
73961,4,1,259057,259057,259058,0,1,2
73962,3,3,259060,259060,259063,0,3,2
73963,6,1,259066,259066,259067,0,1,3
73964,5,3,259071,259071,259074,0,3,4
73965,4,1,259075,259075,259076,0,1,1
73966,6,2,259081,259081,259083,0,2,5
73967,6,2,259087,259087,259089,0,2,4
73968,6,3,259093,259093,259096,0,3,4
73969,2,3,259095,259096,259099,1,4,0
73970,6,2,259101,259101,259103,0,2,2
73971,3,2,259104,259104,259106,0,2,1
73972,5,1,259109,259109,259110,0,1,3
73973,6,1,259115,259115,259116,0,1,5
73974,3,3,259118,259118,259121,0,3,2
73975,3,1,259121,259121,259122,0,1,0
73976,5,1,259126,259126,259127,0,1,4
73977,4,3,259130,259130,259133,0,3,3
73978,3,1,259133,259133,259134,0,1,0
73979,1,3,259134,259134,259137,0,3,0
73980,5,3,259139,259139,259142,0,3,2
73981,6,1,259145,259145,259146,0,1,3
73982,2,1,259147,259147,259148,0,1,1
73983,1,2,259148,259148,259150,0,2,0
73984,5,2,259153,259153,259155,0,2,3
73985,3,2,259156,259156,259158,0,2,1
73986,2,1,259158,259158,259159,0,1,0
73987,6,3,259164,259164,259167,0,3,5
73988,5,2,259169,259169,259171,0,2,2
73989,1,2,259170,259171,259173,1,3,0
73990,5,2,259175,259175,259177,0,2,2
73991,3,2,259178,259178,259180,0,2,1
73992,5,3,259183,259183,259186,0,3,3
73993,6,2,259189,259189,259191,0,2,3
73994,2,1,259191,259191,259192,0,1,0
73995,6,1,259197,259197,259198,0,1,5
73996,5,3,259202,259202,259205,0,3,4
73997,3,2,259205,259205,259207,0,2,0
73998,2,2,259207,259207,259209,0,2,0
73999,1,3,259208,259209,259212,1,4,0
74000,3,2,259211,259212,259214,1,3,0
74001,1,1,259212,259214,259215,2,3,0
74002,4,3,259216,259216,259219,0,3,1
74003,1,3,259217,259219,259222,2,5,0
74004,4,1,259221,259222,259223,1,2,0
74005,2,2,259223,259223,259225,0,2,0
74006,4,2,259227,259227,259229,0,2,2
74007,1,2,259228,259229,259231,1,3,0
74008,5,3,259233,259233,259236,0,3,2
74009,4,2,259237,259237,259239,0,2,1
74010,4,1,259241,259241,259242,0,1,2
74011,3,1,259244,259244,259245,0,1,2
74012,4,1,259248,259248,259249,0,1,3
74013,3,1,259251,259251,259252,0,1,2
74014,2,2,259253,259253,259255,0,2,1
74015,3,1,259256,259256,259257,0,1,1
74016,5,1,259261,259261,259262,0,1,4
74017,5,1,259266,259266,259267,0,1,4
74018,1,2,259267,259267,259269,0,2,0
74019,6,2,259273,259273,259275,0,2,4
74020,2,1,259275,259275,259276,0,1,0
74021,5,1,259280,259280,259281,0,1,4
74022,4,3,259284,259284,259287,0,3,3
74023,1,2,259285,259287,259289,2,4,0
74024,6,2,259291,259291,259293,0,2,2
74025,3,1,259294,259294,259295,0,1,1
74026,4,1,259298,259298,259299,0,1,3
74027,3,3,259301,259301,259304,0,3,2
74028,1,3,259302,259304,259307,2,5,0
74029,6,1,259308,259308,259309,0,1,1
74030,3,1,259311,259311,259312,0,1,2
74031,5,3,259316,259316,259319,0,3,4
74032,5,3,259321,259321,259324,0,3,2
74033,5,2,259326,259326,259328,0,2,2
74034,1,2,259327,259328,259330,1,3,0
74035,5,1,259332,259332,259333,0,1,2
74036,1,3,259333,259333,259336,0,3,0
74037,3,3,259336,259336,259339,0,3,0
74038,1,1,259337,259339,259340,2,3,0
74039,2,3,259339,259340,259343,1,4,0
74040,3,2,259342,259343,259345,1,3,0
74041,1,1,259343,259345,259346,2,3,0
74042,4,3,259347,259347,259350,0,3,1
74043,6,1,259353,259353,259354,0,1,3
74044,1,3,259354,259354,259357,0,3,0
74045,2,2,259356,259357,259359,1,3,0
74046,3,3,259359,259359,259362,0,3,0
74047,4,2,259363,259363,259365,0,2,1
74048,1,3,259364,259365,259368,1,4,0
74049,5,1,259369,259369,259370,0,1,1
74050,3,2,259372,259372,259374,0,2,2
74051,4,3,259376,259376,259379,0,3,2
74052,1,2,259377,259379,259381,2,4,0
74053,2,1,259379,259381,259382,2,3,0
74054,4,1,259383,259383,259384,0,1,1
74055,5,1,259388,259388,259389,0,1,4
74056,5,2,259393,259393,259395,0,2,4
74057,5,3,259398,259398,259401,0,3,3
74058,2,3,259400,259401,259404,1,4,0
74059,5,3,259405,259405,259408,0,3,1
74060,4,3,259409,259409,259412,0,3,1
74061,6,3,259415,259415,259418,0,3,3
74062,2,2,259417,259418,259420,1,3,0
74063,4,3,259421,259421,259424,0,3,1
74064,1,2,259422,259424,259426,2,4,0
74065,2,2,259424,259426,259428,2,4,0
74066,6,2,259430,259430,259432,0,2,2
74067,5,1,259435,259435,259436,0,1,3
74068,3,3,259438,259438,259441,0,3,2
74069,3,2,259441,259441,259443,0,2,0
74070,3,3,259444,259444,259447,0,3,1
74071,6,2,259450,259450,259452,0,2,3
74072,1,1,259451,259452,259453,1,2,0
74073,1,3,259452,259453,259456,1,4,0
74074,2,2,259454,259456,259458,2,4,0
74075,4,1,259458,259458,259459,0,1,0
74076,3,2,259461,259461,259463,0,2,2
74077,5,3,259466,259466,259469,0,3,3
74078,2,2,259468,259469,259471,1,3,0
74079,2,2,259470,259471,259473,1,3,0
74080,4,2,259474,259474,259476,0,2,1
74081,1,2,259475,259476,259478,1,3,0
74082,5,3,259480,259480,259483,0,3,2
74083,4,2,259484,259484,259486,0,2,1
74084,6,3,259490,259490,259493,0,3,4
74085,2,2,259492,259493,259495,1,3,0
74086,5,1,259497,259497,259498,0,1,2
74087,6,1,259503,259503,259504,0,1,5
74088,1,2,259504,259504,259506,0,2,0
74089,6,1,259510,259510,259511,0,1,4
74090,3,2,259513,259513,259515,0,2,2
74091,1,2,259514,259515,259517,1,3,0
74092,4,3,259518,259518,259521,0,3,1
74093,1,2,259519,259521,259523,2,4,0
74094,4,2,259523,259523,259525,0,2,0
74095,1,2,259524,259525,259527,1,3,0
74096,4,3,259528,259528,259531,0,3,1
74097,4,2,259532,259532,259534,0,2,1
74098,6,1,259538,259538,259539,0,1,4
74099,4,2,259542,259542,259544,0,2,3
74100,6,1,259548,259548,259549,0,1,4
74101,1,3,259549,259549,259552,0,3,0
74102,4,2,259553,259553,259555,0,2,1
74103,6,2,259559,259559,259561,0,2,4
74104,5,2,259564,259564,259566,0,2,3
74105,3,2,259567,259567,259569,0,2,1
74106,6,2,259573,259573,259575,0,2,4
74107,1,2,259574,259575,259577,1,3,0
74108,1,3,259575,259577,259580,2,5,0
74109,6,2,259581,259581,259583,0,2,1
74110,2,1,259583,259583,259584,0,1,0
74111,1,1,259584,259584,259585,0,1,0
74112,6,3,259590,259590,259593,0,3,5
74113,4,1,259594,259594,259595,0,1,1
74114,1,3,259595,259595,259598,0,3,0
74115,6,3,259601,259601,259604,0,3,3
74116,5,2,259606,259606,259608,0,2,2
74117,1,1,259607,259608,259609,1,2,0
74118,4,1,259611,259611,259612,0,1,2
74119,6,2,259617,259617,259619,0,2,5
74120,6,2,259623,259623,259625,0,2,4
74121,6,3,259629,259629,259632,0,3,4
74122,5,1,259634,259634,259635,0,1,2
74123,4,1,259638,259638,259639,0,1,3
74124,5,2,259643,259643,259645,0,2,4
74125,4,2,259647,259647,259649,0,2,2
74126,6,1,259653,259653,259654,0,1,4
74127,2,1,259655,259655,259656,0,1,1
74128,6,3,259661,259661,259664,0,3,5
74129,2,1,259663,259664,259665,1,2,0
74130,4,2,259667,259667,259669,0,2,2
74131,6,3,259673,259673,259676,0,3,4
74132,5,2,259678,259678,259680,0,2,2
74133,3,1,259681,259681,259682,0,1,1
74134,1,3,259682,259682,259685,0,3,0
74135,4,2,259686,259686,259688,0,2,1
74136,1,1,259687,259688,259689,1,2,0
74137,2,1,259689,259689,259690,0,1,0
74138,1,3,259690,259690,259693,0,3,0
74139,2,3,259692,259693,259696,1,4,0
74140,2,1,259694,259696,259697,2,3,0
74141,5,2,259699,259699,259701,0,2,2
74142,1,1,259700,259701,259702,1,2,0
74143,4,3,259704,259704,259707,0,3,2
74144,5,2,259709,259709,259711,0,2,2
74145,2,2,259711,259711,259713,0,2,0
74146,4,3,259715,259715,259718,0,3,2
74147,3,2,259718,259718,259720,0,2,0
74148,4,1,259722,259722,259723,0,1,2
74149,1,1,259723,259723,259724,0,1,0
74150,4,3,259727,259727,259730,0,3,3
74151,3,3,259730,259730,259733,0,3,0
74152,2,1,259732,259733,259734,1,2,0
74153,6,3,259738,259738,259741,0,3,4
74154,3,2,259741,259741,259743,0,2,0
74155,3,3,259744,259744,259747,0,3,1
74156,4,3,259748,259748,259751,0,3,1
74157,4,3,259752,259752,259755,0,3,1
74158,1,2,259753,259755,259757,2,4,0
74159,1,3,259754,259757,259760,3,6,0
74160,3,1,259757,259760,259761,3,4,0
74161,6,3,259763,259763,259766,0,3,2
74162,6,2,259769,259769,259771,0,2,3
74163,2,3,259771,259771,259774,0,3,0
74164,3,3,259774,259774,259777,0,3,0
74165,2,1,259776,259777,259778,1,2,0
74166,2,3,259778,259778,259781,0,3,0
74167,5,2,259783,259783,259785,0,2,2
74168,2,2,259785,259785,259787,0,2,0
74169,3,3,259788,259788,259791,0,3,1
74170,3,2,259791,259791,259793,0,2,0
74171,6,2,259797,259797,259799,0,2,4
74172,6,3,259803,259803,259806,0,3,4
74173,3,3,259806,259806,259809,0,3,0
74174,1,1,259807,259809,259810,2,3,0
74175,5,1,259812,259812,259813,0,1,2
74176,6,2,259818,259818,259820,0,2,5
74177,1,3,259819,259820,259823,1,4,0
74178,1,3,259820,259823,259826,3,6,0
74179,2,2,259822,259826,259828,4,6,0
74180,3,1,259825,259828,259829,3,4,0
74181,3,2,259828,259829,259831,1,3,0
74182,2,2,259830,259831,259833,1,3,0
74183,5,1,259835,259835,259836,0,1,2
74184,6,2,259841,259841,259843,0,2,5
74185,1,1,259842,259843,259844,1,2,0
74186,1,2,259843,259844,259846,1,3,0
74187,6,2,259849,259849,259851,0,2,3
74188,6,3,259855,259855,259858,0,3,4
74189,6,3,259861,259861,259864,0,3,3
74190,2,3,259863,259864,259867,1,4,0
74191,2,3,259865,259867,259870,2,5,0
74192,1,3,259866,259870,259873,4,7,0
74193,2,3,259868,259873,259876,5,8,0
74194,5,1,259873,259876,259877,3,4,0
74195,4,1,259877,259877,259878,0,1,0
74196,3,2,259880,259880,259882,0,2,2
74197,5,2,259885,259885,259887,0,2,3
74198,3,1,259888,259888,259889,0,1,1
74199,5,3,259893,259893,259896,0,3,4
74200,4,3,259897,259897,259900,0,3,1
74201,2,3,259899,259900,259903,1,4,0
74202,1,3,259900,259903,259906,3,6,0
74203,2,3,259902,259906,259909,4,7,0
74204,5,3,259907,259909,259912,2,5,0
74205,1,3,259908,259912,259915,4,7,0
74206,2,2,259910,259915,259917,5,7,0
74207,5,1,259915,259917,259918,2,3,0
74208,1,1,259916,259918,259919,2,3,0
74209,1,3,259917,259919,259922,2,5,0
74210,1,3,259918,259922,259925,4,7,0
74211,1,3,259919,259925,259928,6,9,0
74212,3,3,259922,259928,259931,6,9,0
74213,3,3,259925,259931,259934,6,9,0
74214,4,1,259929,259934,259935,5,6,0
74215,2,3,259931,259935,259938,4,7,0
74216,6,1,259937,259938,259939,1,2,0
74217,5,2,259942,259942,259944,0,2,3
74218,3,2,259945,259945,259947,0,2,1
74219,1,1,259946,259947,259948,1,2,0
74220,4,2,259950,259950,259952,0,2,2
74221,6,1,259956,259956,259957,0,1,4
74222,5,2,259961,259961,259963,0,2,4
74223,5,2,259966,259966,259968,0,2,3
74224,1,2,259967,259968,259970,1,3,0
74225,5,3,259972,259972,259975,0,3,2
74226,1,3,259973,259975,259978,2,5,0
74227,3,2,259976,259978,259980,2,4,0
74228,4,2,259980,259980,259982,0,2,0
74229,3,2,259983,259983,259985,0,2,1
74230,2,3,259985,259985,259988,0,3,0
74231,6,3,259991,259991,259994,0,3,3
74232,1,2,259992,259994,259996,2,4,0
74233,4,1,259996,259996,259997,0,1,0
74234,4,1,260000,260000,260001,0,1,3
74235,5,2,260005,260005,260007,0,2,4
74236,3,3,260008,260008,260011,0,3,1
74237,1,1,260009,260011,260012,2,3,0
74238,4,3,260013,260013,260016,0,3,1
74239,4,1,260017,260017,260018,0,1,1
74240,2,3,260019,260019,260022,0,3,1
74241,5,3,260024,260024,260027,0,3,2
74242,5,1,260029,260029,260030,0,1,2
74243,1,2,260030,260030,260032,0,2,0
74244,5,1,260035,260035,260036,0,1,3
74245,3,3,260038,260038,260041,0,3,2
74246,4,1,260042,260042,260043,0,1,1
74247,3,3,260045,260045,260048,0,3,2
74248,1,3,260046,260048,260051,2,5,0
74249,3,1,260049,260051,260052,2,3,0
74250,3,2,260052,260052,260054,0,2,0
74251,4,2,260056,260056,260058,0,2,2
74252,3,2,260059,260059,260061,0,2,1
74253,2,1,260061,260061,260062,0,1,0
74254,4,3,260065,260065,260068,0,3,3
74255,5,1,260070,260070,260071,0,1,2
74256,2,1,260072,260072,260073,0,1,1
74257,1,3,260073,260073,260076,0,3,0
74258,1,2,260074,260076,260078,2,4,0
74259,6,3,260080,260080,260083,0,3,2
74260,2,1,260082,260083,260084,1,2,0
74261,4,3,260086,260086,260089,0,3,2
74262,2,2,260088,260089,260091,1,3,0
74263,3,1,260091,260091,260092,0,1,0
74264,6,1,260097,260097,260098,0,1,5
74265,6,2,260103,260103,260105,0,2,5
74266,4,1,260107,260107,260108,0,1,2
74267,2,2,260109,260109,260111,0,2,1
74268,4,3,260113,260113,260116,0,3,2
74269,6,3,260119,260119,260122,0,3,3
74270,3,3,260122,260122,260125,0,3,0
74271,6,3,260128,260128,260131,0,3,3
74272,4,2,260132,260132,260134,0,2,1
74273,3,2,260135,260135,260137,0,2,1
74274,6,3,260141,260141,260144,0,3,4
74275,4,3,260145,260145,260148,0,3,1
74276,2,3,260147,260148,260151,1,4,0
74277,3,3,260150,260151,260154,1,4,0
74278,3,3,260153,260154,260157,1,4,0
74279,4,3,260157,260157,260160,0,3,0
74280,1,2,260158,260160,260162,2,4,0
74281,1,1,260159,260162,260163,3,4,0
74282,4,1,260163,260163,260164,0,1,0
74283,4,1,260167,260167,260168,0,1,3
74284,3,2,260170,260170,260172,0,2,2
74285,3,2,260173,260173,260175,0,2,1
74286,3,3,260176,260176,260179,0,3,1
74287,3,1,260179,260179,260180,0,1,0
74288,3,1,260182,260182,260183,0,1,2
74289,6,3,260188,260188,260191,0,3,5
74290,3,1,260191,260191,260192,0,1,0
74291,5,1,260196,260196,260197,0,1,4
74292,2,1,260198,260198,260199,0,1,1
74293,5,2,260203,260203,260205,0,2,4
74294,1,3,260204,260205,260208,1,4,0
74295,1,2,260205,260208,260210,3,5,0
74296,3,1,260208,260210,260211,2,3,0
74297,3,2,260211,260211,260213,0,2,0
74298,6,1,260217,260217,260218,0,1,4
74299,4,2,260221,260221,260223,0,2,3
74300,4,1,260225,260225,260226,0,1,2
74301,6,2,260231,260231,260233,0,2,5
74302,5,3,260236,260236,260239,0,3,3
74303,2,3,260238,260239,260242,1,4,0
74304,4,3,260242,260242,260245,0,3,0
74305,5,3,260247,260247,260250,0,3,2
74306,6,1,260253,260253,260254,0,1,3
74307,3,1,260256,260256,260257,0,1,2
74308,3,2,260259,260259,260261,0,2,2
74309,1,1,260260,260261,260262,1,2,0
74310,3,2,260263,260263,260265,0,2,1
74311,5,3,260268,260268,260271,0,3,3
74312,4,1,260272,260272,260273,0,1,1
74313,4,3,260276,260276,260279,0,3,3
74314,2,3,260278,260279,260282,1,4,0
74315,6,2,260284,260284,260286,0,2,2
74316,6,1,260290,260290,260291,0,1,4
74317,5,2,260295,260295,260297,0,2,4
74318,3,2,260298,260298,260300,0,2,1
74319,6,1,260304,260304,260305,0,1,4
74320,4,2,260308,260308,260310,0,2,3
74321,6,3,260314,260314,260317,0,3,4
74322,3,3,260317,260317,260320,0,3,0
74323,4,2,260321,260321,260323,0,2,1
74324,4,1,260325,260325,260326,0,1,2
74325,2,2,260327,260327,260329,0,2,1
74326,5,2,260332,260332,260334,0,2,3
74327,1,2,260333,260334,260336,1,3,0
74328,6,3,260339,260339,260342,0,3,3
74329,6,2,260345,260345,260347,0,2,3
74330,2,1,260347,260347,260348,0,1,0
74331,3,3,260350,260350,260353,0,3,2
74332,4,3,260354,260354,260357,0,3,1
74333,1,2,260355,260357,260359,2,4,0
74334,6,3,260361,260361,260364,0,3,2
74335,4,3,260365,260365,260368,0,3,1
74336,1,2,260366,260368,260370,2,4,0
74337,3,1,260369,260370,260371,1,2,0
74338,2,3,260371,260371,260374,0,3,0
74339,3,3,260374,260374,260377,0,3,0
74340,4,1,260378,260378,260379,0,1,1
74341,3,3,260381,260381,260384,0,3,2
74342,1,3,260382,260384,260387,2,5,0
74343,4,2,260386,260387,260389,1,3,0
74344,5,3,260391,260391,260394,0,3,2
74345,1,1,260392,260394,260395,2,3,0
74346,2,1,260394,260395,260396,1,2,0
74347,3,3,260397,260397,260400,0,3,1
74348,3,1,260400,260400,260401,0,1,0
74349,4,3,260404,260404,260407,0,3,3
74350,4,1,260408,260408,260409,0,1,1
74351,1,2,260409,260409,260411,0,2,0
74352,2,2,260411,260411,260413,0,2,0
74353,3,2,260414,260414,260416,0,2,1
74354,5,2,260419,260419,260421,0,2,3
74355,6,3,260425,260425,260428,0,3,4
74356,6,1,260431,260431,260432,0,1,3
74357,3,2,260434,260434,260436,0,2,2
74358,4,1,260438,260438,260439,0,1,2
74359,4,1,260442,260442,260443,0,1,3
74360,1,1,260443,260443,260444,0,1,0
74361,2,3,260445,260445,260448,0,3,1
74362,2,1,260447,260448,260449,1,2,0
74363,5,1,260452,260452,260453,0,1,3
74364,3,2,260455,260455,260457,0,2,2
74365,6,1,260461,260461,260462,0,1,4
74366,2,1,260463,260463,260464,0,1,1
74367,1,3,260464,260464,260467,0,3,0
74368,3,3,260467,260467,260470,0,3,0
74369,1,1,260468,260470,260471,2,3,0
74370,5,1,260473,260473,260474,0,1,2
74371,2,3,260475,260475,260478,0,3,1
74372,3,1,260478,260478,260479,0,1,0
74373,4,1,260482,260482,260483,0,1,3
74374,2,1,260484,260484,260485,0,1,1
74375,3,3,260487,260487,260490,0,3,2
74376,4,1,260491,260491,260492,0,1,1
74377,2,2,260493,260493,260495,0,2,1
74378,3,3,260496,260496,260499,0,3,1
74379,3,1,260499,260499,260500,0,1,0
74380,2,1,260501,260501,260502,0,1,1
74381,5,1,260506,260506,260507,0,1,4
74382,2,2,260508,260508,260510,0,2,1
74383,1,2,260509,260510,260512,1,3,0
74384,3,2,260512,260512,260514,0,2,0
74385,6,2,260518,260518,260520,0,2,4
74386,4,3,260522,260522,260525,0,3,2
74387,6,1,260528,260528,260529,0,1,3
74388,3,1,260531,260531,260532,0,1,2
74389,1,2,260532,260532,260534,0,2,0
74390,6,3,260538,260538,260541,0,3,4
74391,5,3,260543,260543,260546,0,3,2
74392,2,1,260545,260546,260547,1,2,0
74393,3,2,260548,260548,260550,0,2,1
74394,2,1,260550,260550,260551,0,1,0
74395,2,2,260552,260552,260554,0,2,1
74396,1,1,260553,260554,260555,1,2,0
74397,6,3,260559,260559,260562,0,3,4
74398,6,2,260565,260565,260567,0,2,3
74399,5,2,260570,260570,260572,0,2,3
74400,6,2,260576,260576,260578,0,2,4
74401,2,3,260578,260578,260581,0,3,0
74402,3,2,260581,260581,260583,0,2,0
74403,2,3,260583,260583,260586,0,3,0
74404,4,3,260587,260587,260590,0,3,1
74405,2,1,260589,260590,260591,1,2,0
74406,4,2,260593,260593,260595,0,2,2
74407,2,1,260595,260595,260596,0,1,0
74408,4,2,260599,260599,260601,0,2,3
74409,3,1,260602,260602,260603,0,1,1
74410,2,1,260604,260604,260605,0,1,1
74411,6,2,260610,260610,260612,0,2,5
74412,3,3,260613,260613,260616,0,3,1
74413,1,2,260614,260616,260618,2,4,0
74414,2,1,260616,260618,260619,2,3,0
74415,5,3,260621,260621,260624,0,3,2
74416,3,1,260624,260624,260625,0,1,0
74417,2,3,260626,260626,260629,0,3,1
74418,4,2,260630,260630,260632,0,2,1
74419,6,1,260636,260636,260637,0,1,4
74420,5,3,260641,260641,260644,0,3,4
74421,2,3,260643,260644,260647,1,4,0
74422,5,3,260648,260648,260651,0,3,1
74423,3,1,260651,260651,260652,0,1,0
74424,6,2,260657,260657,260659,0,2,5
74425,5,1,260662,260662,260663,0,1,3
74426,4,1,260666,260666,260667,0,1,3
74427,4,3,260670,260670,260673,0,3,3
74428,3,1,260673,260673,260674,0,1,0
74429,4,2,260677,260677,260679,0,2,3
74430,2,3,260679,260679,260682,0,3,0
74431,2,3,260681,260682,260685,1,4,0
74432,4,3,260685,260685,260688,0,3,0
74433,1,3,260686,260688,260691,2,5,0
74434,5,2,260691,260691,260693,0,2,0
74435,5,3,260696,260696,260699,0,3,3
74436,5,2,260701,260701,260703,0,2,2
74437,6,3,260707,260707,260710,0,3,4
74438,6,3,260713,260713,260716,0,3,3
74439,1,2,260714,260716,260718,2,4,0
74440,2,3,260716,260718,260721,2,5,0
74441,6,2,260722,260722,260724,0,2,1
74442,1,2,260723,260724,260726,1,3,0
74443,4,2,260727,260727,260729,0,2,1
74444,5,1,260732,260732,260733,0,1,3
74445,2,2,260734,260734,260736,0,2,1
74446,6,1,260740,260740,260741,0,1,4
74447,2,1,260742,260742,260743,0,1,1
74448,6,1,260748,260748,260749,0,1,5
74449,1,3,260749,260749,260752,0,3,0
74450,4,1,260753,260753,260754,0,1,1
74451,1,1,260754,260754,260755,0,1,0
74452,2,2,260756,260756,260758,0,2,1
74453,1,3,260757,260758,260761,1,4,0
74454,4,3,260761,260761,260764,0,3,0
74455,1,1,260762,260764,260765,2,3,0
74456,3,3,260765,260765,260768,0,3,0
74457,1,3,260766,260768,260771,2,5,0
74458,2,2,260768,260771,260773,3,5,0
74459,3,1,260771,260773,260774,2,3,0
74460,3,3,260774,260774,260777,0,3,0
74461,4,3,260778,260778,260781,0,3,1
74462,5,2,260783,260783,260785,0,2,2
74463,2,1,260785,260785,260786,0,1,0
74464,1,2,260786,260786,260788,0,2,0
74465,5,1,260791,260791,260792,0,1,3
74466,4,2,260795,260795,260797,0,2,3
74467,5,2,260800,260800,260802,0,2,3
74468,4,1,260804,260804,260805,0,1,2
74469,3,2,260807,260807,260809,0,2,2
74470,2,1,260809,260809,260810,0,1,0
74471,4,2,260813,260813,260815,0,2,3
74472,2,1,260815,260815,260816,0,1,0
74473,5,1,260820,260820,260821,0,1,4
74474,4,2,260824,260824,260826,0,2,3
74475,5,3,260829,260829,260832,0,3,3
74476,1,3,260830,260832,260835,2,5,0
74477,6,1,260836,260836,260837,0,1,1
74478,5,3,260841,260841,260844,0,3,4
74479,5,2,260846,260846,260848,0,2,2
74480,3,2,260849,260849,260851,0,2,1
74481,6,1,260855,260855,260856,0,1,4
74482,5,1,260860,260860,260861,0,1,4
74483,1,1,260861,260861,260862,0,1,0
74484,3,3,260864,260864,260867,0,3,2
74485,6,3,260870,260870,260873,0,3,3
74486,1,2,260871,260873,260875,2,4,0
74487,6,1,260877,260877,260878,0,1,2
74488,1,1,260878,260878,260879,0,1,0
74489,4,2,260882,260882,260884,0,2,3
74490,5,1,260887,260887,260888,0,1,3
74491,4,2,260891,260891,260893,0,2,3
74492,5,3,260896,260896,260899,0,3,3
74493,1,3,260897,260899,260902,2,5,0
74494,2,1,260899,260902,260903,3,4,0
74495,1,2,260900,260903,260905,3,5,0
74496,1,1,260901,260905,260906,4,5,0
74497,1,2,260902,260906,260908,4,6,0
74498,4,3,260906,260908,260911,2,5,0
74499,1,3,260907,260911,260914,4,7,0
74500,1,3,260908,260914,260917,6,9,0
74501,3,2,260911,260917,260919,6,8,0
74502,1,1,260912,260919,260920,7,8,0
74503,4,2,260916,260920,260922,4,6,0
74504,5,3,260921,260922,260925,1,4,0
74505,5,2,260926,260926,260928,0,2,1
74506,2,2,260928,260928,260930,0,2,0
74507,2,2,260930,260930,260932,0,2,0
74508,3,1,260933,260933,260934,0,1,1
74509,1,3,260934,260934,260937,0,3,0
74510,1,2,260935,260937,260939,2,4,0
74511,6,1,260941,260941,260942,0,1,2
74512,2,2,260943,260943,260945,0,2,1
74513,5,2,260948,260948,260950,0,2,3
74514,1,2,260949,260950,260952,1,3,0
74515,6,2,260955,260955,260957,0,2,3
74516,4,1,260959,260959,260960,0,1,2
74517,4,1,260963,260963,260964,0,1,3
74518,3,3,260966,260966,260969,0,3,2
74519,3,1,260969,260969,260970,0,1,0
74520,4,2,260973,260973,260975,0,2,3
74521,4,2,260977,260977,260979,0,2,2
74522,3,2,260980,260980,260982,0,2,1
74523,2,3,260982,260982,260985,0,3,0
74524,1,2,260983,260985,260987,2,4,0
74525,1,2,260984,260987,260989,3,5,0
74526,1,2,260985,260989,260991,4,6,0
74527,3,1,260988,260991,260992,3,4,0
74528,4,2,260992,260992,260994,0,2,0
74529,3,2,260995,260995,260997,0,2,1
74530,4,2,260999,260999,261001,0,2,2
74531,2,2,261001,261001,261003,0,2,0
74532,3,1,261004,261004,261005,0,1,1
74533,1,2,261005,261005,261007,0,2,0
74534,4,2,261009,261009,261011,0,2,2
74535,2,2,261011,261011,261013,0,2,0
74536,2,3,261013,261013,261016,0,3,0
74537,6,3,261019,261019,261022,0,3,3
74538,2,3,261021,261022,261025,1,4,0
74539,4,1,261025,261025,261026,0,1,0
74540,2,3,261027,261027,261030,0,3,1
74541,3,1,261030,261030,261031,0,1,0
74542,2,1,261032,261032,261033,0,1,1
74543,3,3,261035,261035,261038,0,3,2
74544,3,2,261038,261038,261040,0,2,0
74545,4,3,261042,261042,261045,0,3,2
74546,1,3,261043,261045,261048,2,5,0
74547,4,1,261047,261048,261049,1,2,0
74548,2,3,261049,261049,261052,0,3,0
74549,4,1,261053,261053,261054,0,1,1
74550,1,1,261054,261054,261055,0,1,0
74551,3,3,261057,261057,261060,0,3,2
74552,2,3,261059,261060,261063,1,4,0
74553,6,1,261065,261065,261066,0,1,2
74554,3,1,261068,261068,261069,0,1,2
74555,4,1,261072,261072,261073,0,1,3
74556,4,1,261076,261076,261077,0,1,3
74557,4,1,261080,261080,261081,0,1,3
74558,6,2,261086,261086,261088,0,2,5
74559,1,3,261087,261088,261091,1,4,0
74560,1,3,261088,261091,261094,3,6,0
74561,6,1,261094,261094,261095,0,1,0
74562,3,2,261097,261097,261099,0,2,2
74563,3,3,261100,261100,261103,0,3,1
74564,3,1,261103,261103,261104,0,1,0
74565,6,2,261109,261109,261111,0,2,5
74566,3,2,261112,261112,261114,0,2,1
74567,1,3,261113,261114,261117,1,4,0
74568,1,2,261114,261117,261119,3,5,0
74569,6,3,261120,261120,261123,0,3,1
74570,3,1,261123,261123,261124,0,1,0
74571,3,2,261126,261126,261128,0,2,2
74572,1,3,261127,261128,261131,1,4,0
74573,2,1,261129,261131,261132,2,3,0
74574,3,3,261132,261132,261135,0,3,0
74575,4,2,261136,261136,261138,0,2,1
74576,2,1,261138,261138,261139,0,1,0
74577,5,1,261143,261143,261144,0,1,4
74578,5,1,261148,261148,261149,0,1,4
74579,2,2,261150,261150,261152,0,2,1
74580,2,2,261152,261152,261154,0,2,0
74581,5,3,261157,261157,261160,0,3,3
74582,3,1,261160,261160,261161,0,1,0
74583,5,2,261165,261165,261167,0,2,4
74584,5,2,261170,261170,261172,0,2,3
74585,6,3,261176,261176,261179,0,3,4
74586,6,1,261182,261182,261183,0,1,3
74587,2,1,261184,261184,261185,0,1,1
74588,6,1,261190,261190,261191,0,1,5
74589,4,1,261194,261194,261195,0,1,3
74590,3,3,261197,261197,261200,0,3,2
74591,4,2,261201,261201,261203,0,2,1
74592,4,2,261205,261205,261207,0,2,2
74593,5,2,261210,261210,261212,0,2,3
74594,2,1,261212,261212,261213,0,1,0
74595,2,2,261214,261214,261216,0,2,1
74596,3,1,261217,261217,261218,0,1,1
74597,4,3,261221,261221,261224,0,3,3
74598,3,3,261224,261224,261227,0,3,0
74599,5,2,261229,261229,261231,0,2,2
74600,1,3,261230,261231,261234,1,4,0
74601,6,1,261236,261236,261237,0,1,2
74602,6,2,261242,261242,261244,0,2,5
74603,3,1,261245,261245,261246,0,1,1
74604,2,1,261247,261247,261248,0,1,1
74605,5,3,261252,261252,261255,0,3,4
74606,2,3,261254,261255,261258,1,4,0
74607,4,1,261258,261258,261259,0,1,0
74608,4,2,261262,261262,261264,0,2,3
74609,6,3,261268,261268,261271,0,3,4
74610,2,1,261270,261271,261272,1,2,0
74611,4,1,261274,261274,261275,0,1,2
74612,5,3,261279,261279,261282,0,3,4
74613,5,2,261284,261284,261286,0,2,2
74614,2,2,261286,261286,261288,0,2,0
74615,4,2,261290,261290,261292,0,2,2
74616,5,2,261295,261295,261297,0,2,3
74617,3,2,261298,261298,261300,0,2,1
74618,5,2,261303,261303,261305,0,2,3
74619,3,2,261306,261306,261308,0,2,1
74620,6,1,261312,261312,261313,0,1,4
74621,4,3,261316,261316,261319,0,3,3
74622,4,1,261320,261320,261321,0,1,1
74623,4,3,261324,261324,261327,0,3,3
74624,1,3,261325,261327,261330,2,5,0
74625,3,3,261328,261330,261333,2,5,0
74626,3,1,261331,261333,261334,2,3,0
74627,6,2,261337,261337,261339,0,2,3
74628,5,3,261342,261342,261345,0,3,3
74629,5,3,261347,261347,261350,0,3,2
74630,5,2,261352,261352,261354,0,2,2
74631,6,3,261358,261358,261361,0,3,4
74632,2,1,261360,261361,261362,1,2,0
74633,6,3,261366,261366,261369,0,3,4
74634,1,2,261367,261369,261371,2,4,0
74635,2,3,261369,261371,261374,2,5,0
74636,5,3,261374,261374,261377,0,3,0
74637,2,3,261376,261377,261380,1,4,0
74638,6,2,261382,261382,261384,0,2,2
74639,1,3,261383,261384,261387,1,4,0
74640,2,1,261385,261387,261388,2,3,0
74641,5,1,261390,261390,261391,0,1,2
74642,3,2,261393,261393,261395,0,2,2
74643,2,2,261395,261395,261397,0,2,0
74644,5,2,261400,261400,261402,0,2,3
74645,1,2,261401,261402,261404,1,3,0
74646,6,3,261407,261407,261410,0,3,3
74647,5,1,261412,261412,261413,0,1,2
74648,5,1,261417,261417,261418,0,1,4
74649,4,1,261421,261421,261422,0,1,3
74650,1,1,261422,261422,261423,0,1,0
74651,2,1,261424,261424,261425,0,1,1
74652,2,2,261426,261426,261428,0,2,1
74653,6,3,261432,261432,261435,0,3,4
74654,6,3,261438,261438,261441,0,3,3
74655,4,1,261442,261442,261443,0,1,1
74656,4,3,261446,261446,261449,0,3,3
74657,2,3,261448,261449,261452,1,4,0
74658,2,2,261450,261452,261454,2,4,0
74659,3,1,261453,261454,261455,1,2,0
74660,2,1,261455,261455,261456,0,1,0
74661,3,3,261458,261458,261461,0,3,2
74662,5,3,261463,261463,261466,0,3,2
74663,4,3,261467,261467,261470,0,3,1
74664,4,1,261471,261471,261472,0,1,1
74665,5,1,261476,261476,261477,0,1,4
74666,5,2,261481,261481,261483,0,2,4
74667,2,2,261483,261483,261485,0,2,0
74668,1,1,261484,261485,261486,1,2,0
74669,5,2,261489,261489,261491,0,2,3
74670,2,2,261491,261491,261493,0,2,0
74671,6,3,261497,261497,261500,0,3,4
74672,2,2,261499,261500,261502,1,3,0
74673,1,1,261500,261502,261503,2,3,0
74674,2,1,261502,261503,261504,1,2,0
74675,4,3,261506,261506,261509,0,3,2
74676,4,3,261510,261510,261513,0,3,1
74677,1,3,261511,261513,261516,2,5,0
74678,5,2,261516,261516,261518,0,2,0
74679,1,2,261517,261518,261520,1,3,0
74680,4,2,261521,261521,261523,0,2,1
74681,5,2,261526,261526,261528,0,2,3
74682,3,3,261529,261529,261532,0,3,1
74683,3,2,261532,261532,261534,0,2,0
74684,2,3,261534,261534,261537,0,3,0
74685,6,3,261540,261540,261543,0,3,3
74686,4,2,261544,261544,261546,0,2,1
74687,4,2,261548,261548,261550,0,2,2
74688,6,3,261554,261554,261557,0,3,4
74689,1,1,261555,261557,261558,2,3,0
74690,5,2,261560,261560,261562,0,2,2
74691,2,1,261562,261562,261563,0,1,0
74692,4,3,261566,261566,261569,0,3,3
74693,3,1,261569,261569,261570,0,1,0
74694,3,3,261572,261572,261575,0,3,2
74695,5,1,261577,261577,261578,0,1,2
74696,1,2,261578,261578,261580,0,2,0
74697,6,3,261584,261584,261587,0,3,4
74698,1,1,261585,261587,261588,2,3,0
74699,6,3,261591,261591,261594,0,3,3
74700,6,3,261597,261597,261600,0,3,3
74701,6,3,261603,261603,261606,0,3,3
74702,1,1,261604,261606,261607,2,3,0
74703,5,2,261609,261609,261611,0,2,2
74704,2,3,261611,261611,261614,0,3,0
74705,4,1,261615,261615,261616,0,1,1
74706,3,3,261618,261618,261621,0,3,2
74707,6,1,261624,261624,261625,0,1,3
74708,3,2,261627,261627,261629,0,2,2
74709,6,2,261633,261633,261635,0,2,4
74710,6,3,261639,261639,261642,0,3,4
74711,5,1,261644,261644,261645,0,1,2
74712,4,3,261648,261648,261651,0,3,3
74713,4,2,261652,261652,261654,0,2,1
74714,1,1,261653,261654,261655,1,2,0
74715,6,3,261659,261659,261662,0,3,4
74716,2,3,261661,261662,261665,1,4,0
74717,6,1,261667,261667,261668,0,1,2
74718,5,3,261672,261672,261675,0,3,4
74719,6,2,261678,261678,261680,0,2,3
74720,3,1,261681,261681,261682,0,1,1
74721,5,2,261686,261686,261688,0,2,4
74722,4,2,261690,261690,261692,0,2,2
74723,1,1,261691,261692,261693,1,2,0
74724,5,2,261696,261696,261698,0,2,3
74725,1,1,261697,261698,261699,1,2,0
74726,1,2,261698,261699,261701,1,3,0
74727,2,1,261700,261701,261702,1,2,0
74728,4,2,261704,261704,261706,0,2,2
74729,5,1,261709,261709,261710,0,1,3
74730,6,2,261715,261715,261717,0,2,5
74731,5,2,261720,261720,261722,0,2,3
74732,1,2,261721,261722,261724,1,3,0
74733,6,2,261727,261727,261729,0,2,3
74734,5,1,261732,261732,261733,0,1,3
74735,4,3,261736,261736,261739,0,3,3
74736,2,3,261738,261739,261742,1,4,0
74737,2,1,261740,261742,261743,2,3,0
74738,4,2,261744,261744,261746,0,2,1
74739,1,2,261745,261746,261748,1,3,0
74740,4,3,261749,261749,261752,0,3,1
74741,4,3,261753,261753,261756,0,3,1
74742,5,3,261758,261758,261761,0,3,2
74743,4,3,261762,261762,261765,0,3,1
74744,4,1,261766,261766,261767,0,1,1
74745,1,3,261767,261767,261770,0,3,0
74746,4,2,261771,261771,261773,0,2,1
74747,2,2,261773,261773,261775,0,2,0
74748,5,2,261778,261778,261780,0,2,3
74749,5,2,261783,261783,261785,0,2,3
74750,5,3,261788,261788,261791,0,3,3
74751,6,1,261794,261794,261795,0,1,3
74752,4,1,261798,261798,261799,0,1,3
74753,5,2,261803,261803,261805,0,2,4
74754,4,1,261807,261807,261808,0,1,2
74755,1,1,261808,261808,261809,0,1,0
74756,1,3,261809,261809,261812,0,3,0
74757,6,2,261815,261815,261817,0,2,3
74758,1,2,261816,261817,261819,1,3,0
74759,3,3,261819,261819,261822,0,3,0
74760,5,2,261824,261824,261826,0,2,2
74761,3,2,261827,261827,261829,0,2,1
74762,5,2,261832,261832,261834,0,2,3
74763,5,2,261837,261837,261839,0,2,3
74764,5,2,261842,261842,261844,0,2,3
74765,5,3,261847,261847,261850,0,3,3
74766,1,2,261848,261850,261852,2,4,0
74767,3,2,261851,261852,261854,1,3,0
74768,2,2,261853,261854,261856,1,3,0
74769,1,2,261854,261856,261858,2,4,0
74770,4,3,261858,261858,261861,0,3,0
74771,3,1,261861,261861,261862,0,1,0
74772,4,1,261865,261865,261866,0,1,3
74773,3,2,261868,261868,261870,0,2,2
74774,5,1,261873,261873,261874,0,1,3
74775,5,2,261878,261878,261880,0,2,4
74776,5,3,261883,261883,261886,0,3,3
74777,5,1,261888,261888,261889,0,1,2
74778,1,2,261889,261889,261891,0,2,0
74779,4,3,261893,261893,261896,0,3,2
74780,4,2,261897,261897,261899,0,2,1
74781,2,3,261899,261899,261902,0,3,0
74782,4,3,261903,261903,261906,0,3,1
74783,3,1,261906,261906,261907,0,1,0
74784,2,1,261908,261908,261909,0,1,1
74785,2,2,261910,261910,261912,0,2,1
74786,2,2,261912,261912,261914,0,2,0
74787,3,2,261915,261915,261917,0,2,1
74788,3,1,261918,261918,261919,0,1,1
74789,3,2,261921,261921,261923,0,2,2
74790,1,1,261922,261923,261924,1,2,0
74791,1,3,261923,261924,261927,1,4,0
74792,4,1,261927,261927,261928,0,1,0
74793,5,2,261932,261932,261934,0,2,4
74794,3,2,261935,261935,261937,0,2,1
74795,4,2,261939,261939,261941,0,2,2
74796,1,1,261940,261941,261942,1,2,0
74797,6,1,261946,261946,261947,0,1,4
74798,6,1,261952,261952,261953,0,1,5
74799,1,2,261953,261953,261955,0,2,0
74800,6,3,261959,261959,261962,0,3,4
74801,6,1,261965,261965,261966,0,1,3
74802,6,3,261971,261971,261974,0,3,5
74803,3,1,261974,261974,261975,0,1,0
74804,6,2,261980,261980,261982,0,2,5
74805,4,2,261984,261984,261986,0,2,2
74806,3,2,261987,261987,261989,0,2,1
74807,1,2,261988,261989,261991,1,3,0
74808,1,2,261989,261991,261993,2,4,0
74809,6,2,261995,261995,261997,0,2,2
74810,6,1,262001,262001,262002,0,1,4
74811,6,2,262007,262007,262009,0,2,5
74812,6,3,262013,262013,262016,0,3,4
74813,5,3,262018,262018,262021,0,3,2
74814,5,2,262023,262023,262025,0,2,2
74815,6,3,262029,262029,262032,0,3,4
74816,3,3,262032,262032,262035,0,3,0
74817,2,3,262034,262035,262038,1,4,0
74818,3,2,262037,262038,262040,1,3,0
74819,1,1,262038,262040,262041,2,3,0
74820,4,2,262042,262042,262044,0,2,1
74821,4,2,262046,262046,262048,0,2,2
74822,5,2,262051,262051,262053,0,2,3
74823,3,1,262054,262054,262055,0,1,1
74824,6,2,262060,262060,262062,0,2,5
74825,6,3,262066,262066,262069,0,3,4
74826,3,1,262069,262069,262070,0,1,0
74827,5,3,262074,262074,262077,0,3,4
74828,5,2,262079,262079,262081,0,2,2
74829,2,3,262081,262081,262084,0,3,0
74830,2,1,262083,262084,262085,1,2,0
74831,4,2,262087,262087,262089,0,2,2
74832,3,2,262090,262090,262092,0,2,1
74833,1,1,262091,262092,262093,1,2,0
74834,3,2,262094,262094,262096,0,2,1
74835,5,2,262099,262099,262101,0,2,3
74836,4,1,262103,262103,262104,0,1,2
74837,4,2,262107,262107,262109,0,2,3
74838,4,2,262111,262111,262113,0,2,2
74839,4,3,262115,262115,262118,0,3,2
74840,4,3,262119,262119,262122,0,3,1
74841,6,2,262125,262125,262127,0,2,3
74842,6,1,262131,262131,262132,0,1,4
74843,6,2,262137,262137,262139,0,2,5
74844,5,1,262142,262142,262143,0,1,3
74845,5,1,262147,262147,262148,0,1,4
74846,2,1,262149,262149,262150,0,1,1
74847,4,2,262153,262153,262155,0,2,3
74848,1,3,262154,262155,262158,1,4,0
74849,2,1,262156,262158,262159,2,3,0
74850,6,2,262162,262162,262164,0,2,3
74851,5,2,262167,262167,262169,0,2,3
74852,6,3,262173,262173,262176,0,3,4
74853,5,2,262178,262178,262180,0,2,2
74854,6,1,262184,262184,262185,0,1,4
74855,2,2,262186,262186,262188,0,2,1
74856,4,3,262190,262190,262193,0,3,2
74857,5,2,262195,262195,262197,0,2,2
74858,3,1,262198,262198,262199,0,1,1
74859,6,1,262204,262204,262205,0,1,5
74860,2,1,262206,262206,262207,0,1,1
74861,5,2,262211,262211,262213,0,2,4
74862,4,2,262215,262215,262217,0,2,2
74863,4,3,262219,262219,262222,0,3,2
74864,1,2,262220,262222,262224,2,4,0
74865,5,1,262225,262225,262226,0,1,1
74866,5,2,262230,262230,262232,0,2,4
74867,2,1,262232,262232,262233,0,1,0
74868,6,2,262238,262238,262240,0,2,5
74869,3,1,262241,262241,262242,0,1,1
74870,5,3,262246,262246,262249,0,3,4
74871,5,1,262251,262251,262252,0,1,2
74872,6,1,262257,262257,262258,0,1,5
74873,5,1,262262,262262,262263,0,1,4
74874,3,3,262265,262265,262268,0,3,2
74875,4,3,262269,262269,262272,0,3,1
74876,3,1,262272,262272,262273,0,1,0
74877,2,3,262274,262274,262277,0,3,1
74878,1,3,262275,262277,262280,2,5,0
74879,5,3,262280,262280,262283,0,3,0
74880,5,3,262285,262285,262288,0,3,2
74881,5,2,262290,262290,262292,0,2,2
74882,1,2,262291,262292,262294,1,3,0
74883,3,3,262294,262294,262297,0,3,0
74884,6,2,262300,262300,262302,0,2,3
74885,4,1,262304,262304,262305,0,1,2
74886,6,3,262310,262310,262313,0,3,5
74887,6,3,262316,262316,262319,0,3,3
74888,6,2,262322,262322,262324,0,2,3
74889,3,1,262325,262325,262326,0,1,1
74890,1,1,262326,262326,262327,0,1,0
74891,1,3,262327,262327,262330,0,3,0
74892,2,1,262329,262330,262331,1,2,0
74893,6,3,262335,262335,262338,0,3,4
74894,6,1,262341,262341,262342,0,1,3
74895,2,1,262343,262343,262344,0,1,1
74896,5,1,262348,262348,262349,0,1,4
74897,3,2,262351,262351,262353,0,2,2
74898,2,3,262353,262353,262356,0,3,0
74899,1,2,262354,262356,262358,2,4,0
74900,4,3,262358,262358,262361,0,3,0
74901,1,2,262359,262361,262363,2,4,0
74902,2,3,262361,262363,262366,2,5,0
74903,4,2,262365,262366,262368,1,3,0
74904,6,3,262371,262371,262374,0,3,3
74905,4,1,262375,262375,262376,0,1,1
74906,4,1,262379,262379,262380,0,1,3
74907,6,2,262385,262385,262387,0,2,5
74908,2,1,262387,262387,262388,0,1,0
74909,1,3,262388,262388,262391,0,3,0
74910,2,3,262390,262391,262394,1,4,0
74911,3,1,262393,262394,262395,1,2,0
74912,2,2,262395,262395,262397,0,2,0
74913,3,2,262398,262398,262400,0,2,1
74914,4,1,262402,262402,262403,0,1,2
74915,6,3,262408,262408,262411,0,3,5
74916,3,1,262411,262411,262412,0,1,0
74917,6,3,262417,262417,262420,0,3,5
74918,1,3,262418,262420,262423,2,5,0
74919,4,3,262422,262423,262426,1,4,0
74920,2,1,262424,262426,262427,2,3,0
74921,5,2,262429,262429,262431,0,2,2
74922,1,2,262430,262431,262433,1,3,0
74923,6,1,262436,262436,262437,0,1,3
74924,1,3,262437,262437,262440,0,3,0
74925,1,2,262438,262440,262442,2,4,0
74926,5,3,262443,262443,262446,0,3,1
74927,4,3,262447,262447,262450,0,3,1
74928,2,3,262449,262450,262453,1,4,0
74929,2,3,262451,262453,262456,2,5,0
74930,6,3,262457,262457,262460,0,3,1
74931,5,1,262462,262462,262463,0,1,2
74932,1,2,262463,262463,262465,0,2,0
74933,5,3,262468,262468,262471,0,3,3
74934,2,2,262470,262471,262473,1,3,0
74935,5,3,262475,262475,262478,0,3,2
74936,3,1,262478,262478,262479,0,1,0
74937,3,1,262481,262481,262482,0,1,2
74938,1,1,262482,262482,262483,0,1,0
74939,5,2,262487,262487,262489,0,2,4
74940,4,3,262491,262491,262494,0,3,2
74941,6,1,262497,262497,262498,0,1,3
74942,5,2,262502,262502,262504,0,2,4
74943,3,2,262505,262505,262507,0,2,1
74944,3,3,262508,262508,262511,0,3,1
74945,2,1,262510,262511,262512,1,2,0
74946,3,3,262513,262513,262516,0,3,1
74947,3,1,262516,262516,262517,0,1,0
74948,2,3,262518,262518,262521,0,3,1
74949,6,1,262524,262524,262525,0,1,3
74950,2,1,262526,262526,262527,0,1,1
74951,2,1,262528,262528,262529,0,1,1
74952,4,2,262532,262532,262534,0,2,3
74953,5,1,262537,262537,262538,0,1,3
74954,5,2,262542,262542,262544,0,2,4
74955,4,1,262546,262546,262547,0,1,2
74956,6,1,262552,262552,262553,0,1,5
74957,1,1,262553,262553,262554,0,1,0
74958,4,3,262557,262557,262560,0,3,3
74959,4,1,262561,262561,262562,0,1,1
74960,1,1,262562,262562,262563,0,1,0
74961,3,2,262565,262565,262567,0,2,2
74962,4,2,262569,262569,262571,0,2,2
74963,2,1,262571,262571,262572,0,1,0
74964,1,1,262572,262572,262573,0,1,0
74965,5,3,262577,262577,262580,0,3,4
74966,2,1,262579,262580,262581,1,2,0
74967,6,2,262585,262585,262587,0,2,4
74968,6,1,262591,262591,262592,0,1,4
74969,2,2,262593,262593,262595,0,2,1
74970,4,3,262597,262597,262600,0,3,2
74971,2,1,262599,262600,262601,1,2,0
74972,3,3,262602,262602,262605,0,3,1
74973,2,2,262604,262605,262607,1,3,0
74974,4,1,262608,262608,262609,0,1,1
74975,2,2,262610,262610,262612,0,2,1
74976,2,3,262612,262612,262615,0,3,0
74977,4,3,262616,262616,262619,0,3,1
74978,3,2,262619,262619,262621,0,2,0
74979,6,2,262625,262625,262627,0,2,4
74980,6,3,262631,262631,262634,0,3,4
74981,2,2,262633,262634,262636,1,3,0
74982,2,1,262635,262636,262637,1,2,0
74983,1,2,262636,262637,262639,1,3,0
74984,6,3,262642,262642,262645,0,3,3
74985,3,3,262645,262645,262648,0,3,0
74986,1,2,262646,262648,262650,2,4,0
74987,6,1,262652,262652,262653,0,1,2
74988,5,1,262657,262657,262658,0,1,4
74989,3,2,262660,262660,262662,0,2,2
74990,1,1,262661,262662,262663,1,2,0
74991,1,3,262662,262663,262666,1,4,0
74992,5,2,262667,262667,262669,0,2,1
74993,1,2,262668,262669,262671,1,3,0
74994,3,2,262671,262671,262673,0,2,0
74995,5,3,262676,262676,262679,0,3,3
74996,2,2,262678,262679,262681,1,3,0
74997,5,1,262683,262683,262684,0,1,2
74998,3,1,262686,262686,262687,0,1,2
74999,1,1,262687,262687,262688,0,1,0
75000,3,3,262690,262690,262693,0,3,2
75001,3,1,262693,262693,262694,0,1,0
75002,6,2,262699,262699,262701,0,2,5
75003,3,3,262702,262702,262705,0,3,1
75004,1,2,262703,262705,262707,2,4,0
75005,3,2,262706,262707,262709,1,3,0
75006,6,2,262712,262712,262714,0,2,3
75007,6,3,262718,262718,262721,0,3,4
75008,5,3,262723,262723,262726,0,3,2
75009,5,1,262728,262728,262729,0,1,2
75010,3,3,262731,262731,262734,0,3,2
75011,2,2,262733,262734,262736,1,3,0
75012,2,2,262735,262736,262738,1,3,0
75013,3,2,262738,262738,262740,0,2,0
75014,3,3,262741,262741,262744,0,3,1
75015,2,2,262743,262744,262746,1,3,0
75016,1,3,262744,262746,262749,2,5,0
75017,3,2,262747,262749,262751,2,4,0
75018,2,3,262749,262751,262754,2,5,0
75019,3,2,262752,262754,262756,2,4,0
75020,4,1,262756,262756,262757,0,1,0
75021,6,1,262762,262762,262763,0,1,5
75022,6,3,262768,262768,262771,0,3,5
75023,2,3,262770,262771,262774,1,4,0
75024,2,3,262772,262774,262777,2,5,0
75025,4,2,262776,262777,262779,1,3,0
75026,2,2,262778,262779,262781,1,3,0
75027,1,1,262779,262781,262782,2,3,0
75028,4,3,262783,262783,262786,0,3,1
75029,1,2,262784,262786,262788,2,4,0
75030,4,1,262788,262788,262789,0,1,0
75031,3,3,262791,262791,262794,0,3,2
75032,1,2,262792,262794,262796,2,4,0
75033,2,1,262794,262796,262797,2,3,0
75034,5,2,262799,262799,262801,0,2,2
75035,2,2,262801,262801,262803,0,2,0
75036,6,2,262807,262807,262809,0,2,4
75037,6,3,262813,262813,262816,0,3,4
75038,2,2,262815,262816,262818,1,3,0
75039,1,1,262816,262818,262819,2,3,0
75040,4,1,262820,262820,262821,0,1,1
75041,6,3,262826,262826,262829,0,3,5
75042,6,2,262832,262832,262834,0,2,3
75043,6,3,262838,262838,262841,0,3,4
75044,4,1,262842,262842,262843,0,1,1
75045,2,2,262844,262844,262846,0,2,1
75046,2,2,262846,262846,262848,0,2,0
75047,3,2,262849,262849,262851,0,2,1
75048,6,1,262855,262855,262856,0,1,4
75049,3,1,262858,262858,262859,0,1,2
75050,6,1,262864,262864,262865,0,1,5
75051,3,1,262867,262867,262868,0,1,2
75052,5,1,262872,262872,262873,0,1,4
75053,4,1,262876,262876,262877,0,1,3
75054,4,2,262880,262880,262882,0,2,3
75055,1,1,262881,262882,262883,1,2,0
75056,5,1,262886,262886,262887,0,1,3
75057,1,3,262887,262887,262890,0,3,0
75058,5,2,262892,262892,262894,0,2,2
75059,1,2,262893,262894,262896,1,3,0
75060,4,1,262897,262897,262898,0,1,1
75061,6,1,262903,262903,262904,0,1,5
75062,1,3,262904,262904,262907,0,3,0
75063,4,2,262908,262908,262910,0,2,1
75064,5,1,262913,262913,262914,0,1,3
75065,1,3,262914,262914,262917,0,3,0
75066,2,2,262916,262917,262919,1,3,0
75067,4,1,262920,262920,262921,0,1,1
75068,1,2,262921,262921,262923,0,2,0
75069,6,1,262927,262927,262928,0,1,4
75070,2,2,262929,262929,262931,0,2,1
75071,3,1,262932,262932,262933,0,1,1
75072,3,3,262935,262935,262938,0,3,2
75073,2,1,262937,262938,262939,1,2,0
75074,2,1,262939,262939,262940,0,1,0
75075,5,1,262944,262944,262945,0,1,4
75076,4,1,262948,262948,262949,0,1,3
75077,1,3,262949,262949,262952,0,3,0
75078,4,3,262953,262953,262956,0,3,1
75079,6,2,262959,262959,262961,0,2,3
75080,3,1,262962,262962,262963,0,1,1
75081,5,2,262967,262967,262969,0,2,4
75082,1,1,262968,262969,262970,1,2,0
75083,2,3,262970,262970,262973,0,3,0
75084,4,1,262974,262974,262975,0,1,1
75085,5,1,262979,262979,262980,0,1,4
75086,3,2,262982,262982,262984,0,2,2
75087,6,3,262988,262988,262991,0,3,4
75088,4,3,262992,262992,262995,0,3,1
75089,3,3,262995,262995,262998,0,3,0
75090,2,3,262997,262998,263001,1,4,0
75091,3,3,263000,263001,263004,1,4,0
75092,4,3,263004,263004,263007,0,3,0
75093,4,3,263008,263008,263011,0,3,1
75094,4,2,263012,263012,263014,0,2,1
75095,2,1,263014,263014,263015,0,1,0
75096,1,2,263015,263015,263017,0,2,0
75097,4,3,263019,263019,263022,0,3,2
75098,1,1,263020,263022,263023,2,3,0
75099,1,3,263021,263023,263026,2,5,0
75100,1,2,263022,263026,263028,4,6,0
75101,1,1,263023,263028,263029,5,6,0
75102,6,2,263029,263029,263031,0,2,0
75103,5,2,263034,263034,263036,0,2,3
75104,6,2,263040,263040,263042,0,2,4
75105,1,3,263041,263042,263045,1,4,0
75106,3,2,263044,263045,263047,1,3,0
75107,1,2,263045,263047,263049,2,4,0
75108,1,1,263046,263049,263050,3,4,0
75109,1,2,263047,263050,263052,3,5,0
75110,1,1,263048,263052,263053,4,5,0
75111,2,1,263050,263053,263054,3,4,0
75112,6,2,263056,263056,263058,0,2,2
75113,3,2,263059,263059,263061,0,2,1
75114,5,2,263064,263064,263066,0,2,3
75115,1,2,263065,263066,263068,1,3,0
75116,4,3,263069,263069,263072,0,3,1
75117,6,2,263075,263075,263077,0,2,3
75118,4,3,263079,263079,263082,0,3,2
75119,3,1,263082,263082,263083,0,1,0
75120,6,2,263088,263088,263090,0,2,5
75121,5,3,263093,263093,263096,0,3,3
75122,4,2,263097,263097,263099,0,2,1
75123,4,2,263101,263101,263103,0,2,2
75124,5,2,263106,263106,263108,0,2,3
75125,2,2,263108,263108,263110,0,2,0
75126,4,2,263112,263112,263114,0,2,2
75127,5,3,263117,263117,263120,0,3,3
75128,2,1,263119,263120,263121,1,2,0
75129,3,3,263122,263122,263125,0,3,1
75130,4,1,263126,263126,263127,0,1,1
75131,5,3,263131,263131,263134,0,3,4
75132,1,3,263132,263134,263137,2,5,0
75133,5,1,263137,263137,263138,0,1,0
75134,5,3,263142,263142,263145,0,3,4
75135,3,1,263145,263145,263146,0,1,0
75136,2,3,263147,263147,263150,0,3,1
75137,2,2,263149,263150,263152,1,3,0
75138,5,1,263154,263154,263155,0,1,2
75139,2,1,263156,263156,263157,0,1,1
75140,3,1,263159,263159,263160,0,1,2
75141,5,2,263164,263164,263166,0,2,4
75142,5,1,263169,263169,263170,0,1,3
75143,5,2,263174,263174,263176,0,2,4
75144,6,2,263180,263180,263182,0,2,4
75145,2,2,263182,263182,263184,0,2,0
75146,5,2,263187,263187,263189,0,2,3
75147,2,3,263189,263189,263192,0,3,0
75148,5,2,263194,263194,263196,0,2,2
75149,3,2,263197,263197,263199,0,2,1
75150,3,3,263200,263200,263203,0,3,1
75151,5,2,263205,263205,263207,0,2,2
75152,1,3,263206,263207,263210,1,4,0
75153,2,3,263208,263210,263213,2,5,0
75154,6,2,263214,263214,263216,0,2,1
75155,5,3,263219,263219,263222,0,3,3
75156,1,2,263220,263222,263224,2,4,0
75157,3,2,263223,263224,263226,1,3,0
75158,3,1,263226,263226,263227,0,1,0
75159,1,2,263227,263227,263229,0,2,0
75160,3,3,263230,263230,263233,0,3,1
75161,2,2,263232,263233,263235,1,3,0
75162,3,2,263235,263235,263237,0,2,0
75163,5,1,263240,263240,263241,0,1,3
75164,2,3,263242,263242,263245,0,3,1
75165,2,1,263244,263245,263246,1,2,0
75166,4,1,263248,263248,263249,0,1,2
75167,1,1,263249,263249,263250,0,1,0
75168,2,2,263251,263251,263253,0,2,1
75169,5,2,263256,263256,263258,0,2,3
75170,5,3,263261,263261,263264,0,3,3
75171,2,2,263263,263264,263266,1,3,0
75172,1,1,263264,263266,263267,2,3,0
75173,3,2,263267,263267,263269,0,2,0
75174,2,3,263269,263269,263272,0,3,0
75175,6,2,263275,263275,263277,0,2,3
75176,4,1,263279,263279,263280,0,1,2
75177,3,1,263282,263282,263283,0,1,2
75178,3,3,263285,263285,263288,0,3,2
75179,6,3,263291,263291,263294,0,3,3
75180,3,2,263294,263294,263296,0,2,0
75181,6,1,263300,263300,263301,0,1,4
75182,3,3,263303,263303,263306,0,3,2
75183,4,2,263307,263307,263309,0,2,1
75184,3,1,263310,263310,263311,0,1,1
75185,2,3,263312,263312,263315,0,3,1
75186,1,2,263313,263315,263317,2,4,0
75187,4,3,263317,263317,263320,0,3,0
75188,2,2,263319,263320,263322,1,3,0
75189,6,1,263325,263325,263326,0,1,3
75190,3,1,263328,263328,263329,0,1,2
75191,5,2,263333,263333,263335,0,2,4
75192,1,2,263334,263335,263337,1,3,0
75193,6,3,263340,263340,263343,0,3,3
75194,2,2,263342,263343,263345,1,3,0
75195,3,2,263345,263345,263347,0,2,0
75196,3,2,263348,263348,263350,0,2,1
75197,4,2,263352,263352,263354,0,2,2
75198,3,2,263355,263355,263357,0,2,1
75199,2,3,263357,263357,263360,0,3,0
75200,6,1,263363,263363,263364,0,1,3
75201,5,1,263368,263368,263369,0,1,4
75202,6,3,263374,263374,263377,0,3,5
75203,2,1,263376,263377,263378,1,2,0
75204,5,2,263381,263381,263383,0,2,3
75205,3,3,263384,263384,263387,0,3,1
75206,3,3,263387,263387,263390,0,3,0
75207,4,3,263391,263391,263394,0,3,1
75208,6,1,263397,263397,263398,0,1,3
75209,4,1,263401,263401,263402,0,1,3
75210,6,3,263407,263407,263410,0,3,5
75211,5,2,263412,263412,263414,0,2,2
75212,5,2,263417,263417,263419,0,2,3
75213,5,2,263422,263422,263424,0,2,3
75214,1,3,263423,263424,263427,1,4,0
75215,2,1,263425,263427,263428,2,3,0
75216,2,3,263427,263428,263431,1,4,0
75217,5,1,263432,263432,263433,0,1,1
75218,5,3,263437,263437,263440,0,3,4
75219,4,1,263441,263441,263442,0,1,1
75220,4,2,263445,263445,263447,0,2,3
75221,1,3,263446,263447,263450,1,4,0
75222,4,3,263450,263450,263453,0,3,0
75223,1,3,263451,263453,263456,2,5,0
75224,6,2,263457,263457,263459,0,2,1
75225,1,3,263458,263459,263462,1,4,0
75226,3,1,263461,263462,263463,1,2,0
75227,4,2,263465,263465,263467,0,2,2
75228,1,2,263466,263467,263469,1,3,0
75229,2,1,263468,263469,263470,1,2,0
75230,3,1,263471,263471,263472,0,1,1
75231,3,1,263474,263474,263475,0,1,2
75232,5,2,263479,263479,263481,0,2,4
75233,1,3,263480,263481,263484,1,4,0
75234,5,3,263485,263485,263488,0,3,1
75235,6,2,263491,263491,263493,0,2,3
75236,4,1,263495,263495,263496,0,1,2
75237,6,2,263501,263501,263503,0,2,5
75238,6,1,263507,263507,263508,0,1,4
75239,5,1,263512,263512,263513,0,1,4
75240,6,3,263518,263518,263521,0,3,5
75241,5,2,263523,263523,263525,0,2,2
75242,2,3,263525,263525,263528,0,3,0
75243,1,3,263526,263528,263531,2,5,0
75244,5,1,263531,263531,263532,0,1,0
75245,4,3,263535,263535,263538,0,3,3
75246,5,3,263540,263540,263543,0,3,2
75247,5,3,263545,263545,263548,0,3,2
75248,5,3,263550,263550,263553,0,3,2
75249,2,3,263552,263553,263556,1,4,0
75250,5,1,263557,263557,263558,0,1,1
75251,6,1,263563,263563,263564,0,1,5
75252,2,2,263565,263565,263567,0,2,1
75253,3,1,263568,263568,263569,0,1,1
75254,4,1,263572,263572,263573,0,1,3
75255,1,2,263573,263573,263575,0,2,0
75256,2,3,263575,263575,263578,0,3,0
75257,3,1,263578,263578,263579,0,1,0
75258,6,1,263584,263584,263585,0,1,5
75259,6,3,263590,263590,263593,0,3,5
75260,3,3,263593,263593,263596,0,3,0
75261,4,2,263597,263597,263599,0,2,1
75262,5,3,263602,263602,263605,0,3,3
75263,3,2,263605,263605,263607,0,2,0
75264,2,2,263607,263607,263609,0,2,0
75265,1,1,263608,263609,263610,1,2,0
75266,5,1,263613,263613,263614,0,1,3
75267,3,2,263616,263616,263618,0,2,2
75268,2,3,263618,263618,263621,0,3,0
75269,6,1,263624,263624,263625,0,1,3
75270,1,2,263625,263625,263627,0,2,0
75271,6,3,263631,263631,263634,0,3,4
75272,3,1,263634,263634,263635,0,1,0
75273,5,3,263639,263639,263642,0,3,4
75274,2,2,263641,263642,263644,1,3,0
75275,5,1,263646,263646,263647,0,1,2
75276,5,2,263651,263651,263653,0,2,4
75277,1,2,263652,263653,263655,1,3,0
75278,1,1,263653,263655,263656,2,3,0
75279,6,3,263659,263659,263662,0,3,3
75280,2,1,263661,263662,263663,1,2,0
75281,6,2,263667,263667,263669,0,2,4
75282,1,2,263668,263669,263671,1,3,0
75283,4,2,263672,263672,263674,0,2,1
75284,4,3,263676,263676,263679,0,3,2
75285,5,2,263681,263681,263683,0,2,2
75286,4,2,263685,263685,263687,0,2,2
75287,5,2,263690,263690,263692,0,2,3
75288,4,3,263694,263694,263697,0,3,2
75289,1,1,263695,263697,263698,2,3,0
75290,6,1,263701,263701,263702,0,1,3
75291,6,3,263707,263707,263710,0,3,5
75292,6,3,263713,263713,263716,0,3,3
75293,2,2,263715,263716,263718,1,3,0
75294,6,1,263721,263721,263722,0,1,3
75295,3,3,263724,263724,263727,0,3,2
75296,4,2,263728,263728,263730,0,2,1
75297,5,2,263733,263733,263735,0,2,3
75298,2,3,263735,263735,263738,0,3,0
75299,5,3,263740,263740,263743,0,3,2
75300,3,2,263743,263743,263745,0,2,0
75301,3,2,263746,263746,263748,0,2,1
75302,1,3,263747,263748,263751,1,4,0
75303,6,1,263753,263753,263754,0,1,2
75304,1,1,263754,263754,263755,0,1,0
75305,6,1,263760,263760,263761,0,1,5
75306,4,1,263764,263764,263765,0,1,3
75307,5,3,263769,263769,263772,0,3,4
75308,3,2,263772,263772,263774,0,2,0
75309,5,2,263777,263777,263779,0,2,3
75310,1,3,263778,263779,263782,1,4,0
75311,4,1,263782,263782,263783,0,1,0
75312,4,3,263786,263786,263789,0,3,3
75313,6,3,263792,263792,263795,0,3,3
75314,2,2,263794,263795,263797,1,3,0
75315,5,1,263799,263799,263800,0,1,2
75316,2,1,263801,263801,263802,0,1,1
75317,5,2,263806,263806,263808,0,2,4
75318,4,2,263810,263810,263812,0,2,2
75319,6,1,263816,263816,263817,0,1,4
75320,3,2,263819,263819,263821,0,2,2
75321,2,2,263821,263821,263823,0,2,0
75322,2,2,263823,263823,263825,0,2,0
75323,6,2,263829,263829,263831,0,2,4
75324,6,2,263835,263835,263837,0,2,4
75325,5,2,263840,263840,263842,0,2,3
75326,1,1,263841,263842,263843,1,2,0
75327,5,2,263846,263846,263848,0,2,3
75328,5,1,263851,263851,263852,0,1,3
75329,1,2,263852,263852,263854,0,2,0
75330,4,1,263856,263856,263857,0,1,2
75331,4,3,263860,263860,263863,0,3,3
75332,1,3,263861,263863,263866,2,5,0
75333,4,3,263865,263866,263869,1,4,0
75334,5,3,263870,263870,263873,0,3,1
75335,1,2,263871,263873,263875,2,4,0
75336,2,3,263873,263875,263878,2,5,0
75337,2,3,263875,263878,263881,3,6,0
75338,5,2,263880,263881,263883,1,3,0
75339,5,3,263885,263885,263888,0,3,2
75340,2,1,263887,263888,263889,1,2,0
75341,3,1,263890,263890,263891,0,1,1
75342,2,3,263892,263892,263895,0,3,1
75343,4,3,263896,263896,263899,0,3,1
75344,2,3,263898,263899,263902,1,4,0
75345,4,2,263902,263902,263904,0,2,0
75346,4,3,263906,263906,263909,0,3,2
75347,1,3,263907,263909,263912,2,5,0
75348,1,1,263908,263912,263913,4,5,0
75349,1,1,263909,263913,263914,4,5,0
75350,2,3,263911,263914,263917,3,6,0
75351,4,3,263915,263917,263920,2,5,0
75352,3,2,263918,263920,263922,2,4,0
75353,5,1,263923,263923,263924,0,1,1
75354,2,1,263925,263925,263926,0,1,1
75355,6,2,263931,263931,263933,0,2,5
75356,5,1,263936,263936,263937,0,1,3
75357,4,3,263940,263940,263943,0,3,3
75358,3,2,263943,263943,263945,0,2,0
75359,1,2,263944,263945,263947,1,3,0
75360,4,1,263948,263948,263949,0,1,1
75361,4,1,263952,263952,263953,0,1,3
75362,5,3,263957,263957,263960,0,3,4
75363,1,2,263958,263960,263962,2,4,0
75364,6,1,263964,263964,263965,0,1,2
75365,5,2,263969,263969,263971,0,2,4
75366,3,1,263972,263972,263973,0,1,1
75367,4,3,263976,263976,263979,0,3,3
75368,1,1,263977,263979,263980,2,3,0
75369,5,2,263982,263982,263984,0,2,2
75370,5,2,263987,263987,263989,0,2,3
75371,1,3,263988,263989,263992,1,4,0
75372,4,3,263992,263992,263995,0,3,0
75373,4,2,263996,263996,263998,0,2,1
75374,5,3,264001,264001,264004,0,3,3
75375,5,2,264006,264006,264008,0,2,2
75376,6,3,264012,264012,264015,0,3,4
75377,1,2,264013,264015,264017,2,4,0
75378,4,3,264017,264017,264020,0,3,0
75379,4,3,264021,264021,264024,0,3,1
75380,5,2,264026,264026,264028,0,2,2
75381,3,1,264029,264029,264030,0,1,1
75382,3,3,264032,264032,264035,0,3,2
75383,6,2,264038,264038,264040,0,2,3
75384,5,3,264043,264043,264046,0,3,3
75385,5,3,264048,264048,264051,0,3,2
75386,5,3,264053,264053,264056,0,3,2
75387,2,2,264055,264056,264058,1,3,0
75388,3,3,264058,264058,264061,0,3,0
75389,3,1,264061,264061,264062,0,1,0
75390,5,1,264066,264066,264067,0,1,4
75391,1,2,264067,264067,264069,0,2,0
75392,3,1,264070,264070,264071,0,1,1
75393,6,2,264076,264076,264078,0,2,5
75394,4,2,264080,264080,264082,0,2,2
75395,6,2,264086,264086,264088,0,2,4
75396,4,2,264090,264090,264092,0,2,2
75397,4,1,264094,264094,264095,0,1,2
75398,5,1,264099,264099,264100,0,1,4
75399,4,2,264103,264103,264105,0,2,3
75400,5,1,264108,264108,264109,0,1,3
75401,3,1,264111,264111,264112,0,1,2
75402,3,2,264114,264114,264116,0,2,2
75403,3,1,264117,264117,264118,0,1,1
75404,4,2,264121,264121,264123,0,2,3
75405,5,1,264126,264126,264127,0,1,3
75406,2,1,264128,264128,264129,0,1,1
75407,6,2,264134,264134,264136,0,2,5
75408,1,1,264135,264136,264137,1,2,0
75409,3,1,264138,264138,264139,0,1,1
75410,5,3,264143,264143,264146,0,3,4
75411,5,3,264148,264148,264151,0,3,2
75412,3,3,264151,264151,264154,0,3,0
75413,4,1,264155,264155,264156,0,1,1
75414,6,2,264161,264161,264163,0,2,5
75415,3,2,264164,264164,264166,0,2,1
75416,1,3,264165,264166,264169,1,4,0
75417,4,3,264169,264169,264172,0,3,0
75418,6,2,264175,264175,264177,0,2,3
75419,1,3,264176,264177,264180,1,4,0
75420,5,3,264181,264181,264184,0,3,1
75421,4,3,264185,264185,264188,0,3,1
75422,2,2,264187,264188,264190,1,3,0
75423,3,3,264190,264190,264193,0,3,0
75424,5,3,264195,264195,264198,0,3,2
75425,1,1,264196,264198,264199,2,3,0
75426,6,1,264202,264202,264203,0,1,3
75427,4,1,264206,264206,264207,0,1,3
75428,3,3,264209,264209,264212,0,3,2
75429,4,3,264213,264213,264216,0,3,1
75430,1,1,264214,264216,264217,2,3,0
75431,4,2,264218,264218,264220,0,2,1
75432,4,3,264222,264222,264225,0,3,2
75433,5,1,264227,264227,264228,0,1,2
75434,5,1,264232,264232,264233,0,1,4
75435,5,3,264237,264237,264240,0,3,4
75436,1,1,264238,264240,264241,2,3,0
75437,6,2,264244,264244,264246,0,2,3
75438,5,2,264249,264249,264251,0,2,3
75439,4,1,264253,264253,264254,0,1,2
75440,6,2,264259,264259,264261,0,2,5
75441,5,1,264264,264264,264265,0,1,3
75442,2,2,264266,264266,264268,0,2,1
75443,4,1,264270,264270,264271,0,1,2
75444,6,1,264276,264276,264277,0,1,5
75445,4,1,264280,264280,264281,0,1,3
75446,5,2,264285,264285,264287,0,2,4
75447,4,2,264289,264289,264291,0,2,2
75448,2,2,264291,264291,264293,0,2,0
75449,4,3,264295,264295,264298,0,3,2
75450,5,3,264300,264300,264303,0,3,2
75451,5,1,264305,264305,264306,0,1,2
75452,1,1,264306,264306,264307,0,1,0
75453,5,2,264311,264311,264313,0,2,4
75454,2,2,264313,264313,264315,0,2,0
75455,6,3,264319,264319,264322,0,3,4
75456,2,2,264321,264322,264324,1,3,0
75457,1,2,264322,264324,264326,2,4,0
75458,6,1,264328,264328,264329,0,1,2
75459,4,2,264332,264332,264334,0,2,3
75460,5,2,264337,264337,264339,0,2,3
75461,1,1,264338,264339,264340,1,2,0
75462,1,3,264339,264340,264343,1,4,0
75463,1,3,264340,264343,264346,3,6,0
75464,6,3,264346,264346,264349,0,3,0
75465,3,1,264349,264349,264350,0,1,0
75466,6,3,264355,264355,264358,0,3,5
75467,3,2,264358,264358,264360,0,2,0
75468,6,2,264364,264364,264366,0,2,4
75469,5,3,264369,264369,264372,0,3,3
75470,2,2,264371,264372,264374,1,3,0
75471,5,2,264376,264376,264378,0,2,2
75472,2,1,264378,264378,264379,0,1,0
75473,5,3,264383,264383,264386,0,3,4
75474,6,3,264389,264389,264392,0,3,3
75475,3,1,264392,264392,264393,0,1,0
75476,3,3,264395,264395,264398,0,3,2
75477,4,2,264399,264399,264401,0,2,1
75478,5,3,264404,264404,264407,0,3,3
75479,5,2,264409,264409,264411,0,2,2
75480,2,1,264411,264411,264412,0,1,0
75481,4,1,264415,264415,264416,0,1,3
75482,6,1,264421,264421,264422,0,1,5
75483,5,1,264426,264426,264427,0,1,4
75484,4,2,264430,264430,264432,0,2,3
75485,3,1,264433,264433,264434,0,1,1
75486,6,1,264439,264439,264440,0,1,5
75487,5,2,264444,264444,264446,0,2,4
75488,4,1,264448,264448,264449,0,1,2
75489,1,3,264449,264449,264452,0,3,0
75490,3,2,264452,264452,264454,0,2,0
75491,1,2,264453,264454,264456,1,3,0
75492,5,2,264458,264458,264460,0,2,2
75493,6,3,264464,264464,264467,0,3,4
75494,6,2,264470,264470,264472,0,2,3
75495,2,2,264472,264472,264474,0,2,0
75496,1,3,264473,264474,264477,1,4,0
75497,5,1,264478,264478,264479,0,1,1
75498,6,1,264484,264484,264485,0,1,5
75499,2,3,264486,264486,264489,0,3,1
75500,1,1,264487,264489,264490,2,3,0
75501,2,3,264489,264490,264493,1,4,0
75502,2,1,264491,264493,264494,2,3,0
75503,3,2,264494,264494,264496,0,2,0
75504,2,1,264496,264496,264497,0,1,0
75505,3,3,264499,264499,264502,0,3,2
75506,2,3,264501,264502,264505,1,4,0
75507,4,1,264505,264505,264506,0,1,0
75508,5,1,264510,264510,264511,0,1,4
75509,6,1,264516,264516,264517,0,1,5
75510,2,1,264518,264518,264519,0,1,1
75511,5,2,264523,264523,264525,0,2,4
75512,6,2,264529,264529,264531,0,2,4
75513,3,3,264532,264532,264535,0,3,1
75514,1,2,264533,264535,264537,2,4,0
75515,4,1,264537,264537,264538,0,1,0
75516,2,1,264539,264539,264540,0,1,1
75517,2,1,264541,264541,264542,0,1,1
75518,1,1,264542,264542,264543,0,1,0
75519,6,2,264548,264548,264550,0,2,5
75520,1,2,264549,264550,264552,1,3,0
75521,1,3,264550,264552,264555,2,5,0
75522,2,1,264552,264555,264556,3,4,0
75523,4,2,264556,264556,264558,0,2,0
75524,3,2,264559,264559,264561,0,2,1
75525,6,1,264565,264565,264566,0,1,4
75526,4,1,264569,264569,264570,0,1,3
75527,5,3,264574,264574,264577,0,3,4
75528,5,1,264579,264579,264580,0,1,2
75529,1,1,264580,264580,264581,0,1,0
75530,3,1,264583,264583,264584,0,1,2
75531,4,1,264587,264587,264588,0,1,3
75532,1,3,264588,264588,264591,0,3,0
75533,2,2,264590,264591,264593,1,3,0
75534,6,3,264596,264596,264599,0,3,3
75535,2,1,264598,264599,264600,1,2,0
75536,1,3,264599,264600,264603,1,4,0
75537,5,3,264604,264604,264607,0,3,1
75538,1,2,264605,264607,264609,2,4,0
75539,2,3,264607,264609,264612,2,5,0
75540,2,3,264609,264612,264615,3,6,0
75541,1,2,264610,264615,264617,5,7,0
75542,6,3,264616,264617,264620,1,4,0
75543,6,2,264622,264622,264624,0,2,2
75544,4,3,264626,264626,264629,0,3,2
75545,3,1,264629,264629,264630,0,1,0
75546,1,3,264630,264630,264633,0,3,0
75547,3,3,264633,264633,264636,0,3,0
75548,5,1,264638,264638,264639,0,1,2
75549,1,1,264639,264639,264640,0,1,0
75550,3,3,264642,264642,264645,0,3,2
75551,4,3,264646,264646,264649,0,3,1
75552,4,1,264650,264650,264651,0,1,1
75553,2,3,264652,264652,264655,0,3,1
75554,3,2,264655,264655,264657,0,2,0
75555,1,3,264656,264657,264660,1,4,0
75556,2,3,264658,264660,264663,2,5,0
75557,1,2,264659,264663,264665,4,6,0
75558,5,1,264664,264665,264666,1,2,0
75559,3,1,264667,264667,264668,0,1,1
75560,5,2,264672,264672,264674,0,2,4
75561,3,1,264675,264675,264676,0,1,1
75562,5,2,264680,264680,264682,0,2,4
75563,3,2,264683,264683,264685,0,2,1
75564,1,2,264684,264685,264687,1,3,0
75565,5,2,264689,264689,264691,0,2,2
75566,2,2,264691,264691,264693,0,2,0
75567,5,3,264696,264696,264699,0,3,3
75568,4,2,264700,264700,264702,0,2,1
75569,6,2,264706,264706,264708,0,2,4
75570,2,3,264708,264708,264711,0,3,0
75571,6,3,264714,264714,264717,0,3,3
75572,5,2,264719,264719,264721,0,2,2
75573,4,3,264723,264723,264726,0,3,2
75574,1,3,264724,264726,264729,2,5,0
75575,2,3,264726,264729,264732,3,6,0
75576,3,1,264729,264732,264733,3,4,0
75577,1,3,264730,264733,264736,3,6,0
75578,4,2,264734,264736,264738,2,4,0
75579,5,3,264739,264739,264742,0,3,1
75580,3,3,264742,264742,264745,0,3,0
75581,6,3,264748,264748,264751,0,3,3
75582,5,1,264753,264753,264754,0,1,2
75583,2,3,264755,264755,264758,0,3,1
75584,6,2,264761,264761,264763,0,2,3
75585,3,1,264764,264764,264765,0,1,1
75586,1,3,264765,264765,264768,0,3,0
75587,5,1,264770,264770,264771,0,1,2
75588,5,2,264775,264775,264777,0,2,4
75589,4,3,264779,264779,264782,0,3,2
75590,6,1,264785,264785,264786,0,1,3
75591,5,2,264790,264790,264792,0,2,4
75592,3,2,264793,264793,264795,0,2,1
75593,6,3,264799,264799,264802,0,3,4
75594,1,3,264800,264802,264805,2,5,0
75595,3,2,264803,264805,264807,2,4,0
75596,5,1,264808,264808,264809,0,1,1
75597,3,3,264811,264811,264814,0,3,2
75598,2,2,264813,264814,264816,1,3,0
75599,6,2,264819,264819,264821,0,2,3
75600,3,1,264822,264822,264823,0,1,1
75601,6,3,264828,264828,264831,0,3,5
75602,3,1,264831,264831,264832,0,1,0
75603,1,2,264832,264832,264834,0,2,0
75604,2,3,264834,264834,264837,0,3,0
75605,5,1,264839,264839,264840,0,1,2
75606,1,3,264840,264840,264843,0,3,0
75607,3,2,264843,264843,264845,0,2,0
75608,6,2,264849,264849,264851,0,2,4
75609,5,2,264854,264854,264856,0,2,3
75610,4,1,264858,264858,264859,0,1,2
75611,1,2,264859,264859,264861,0,2,0
75612,4,3,264863,264863,264866,0,3,2
75613,5,2,264868,264868,264870,0,2,2
75614,4,2,264872,264872,264874,0,2,2
75615,3,3,264875,264875,264878,0,3,1
75616,2,3,264877,264878,264881,1,4,0
75617,1,1,264878,264881,264882,3,4,0
75618,4,1,264882,264882,264883,0,1,0
75619,5,3,264887,264887,264890,0,3,4
75620,2,3,264889,264890,264893,1,4,0
75621,6,1,264895,264895,264896,0,1,2
75622,5,3,264900,264900,264903,0,3,4
75623,5,2,264905,264905,264907,0,2,2
75624,1,3,264906,264907,264910,1,4,0
75625,6,3,264912,264912,264915,0,3,2
75626,1,2,264913,264915,264917,2,4,0
75627,6,2,264919,264919,264921,0,2,2
75628,5,1,264924,264924,264925,0,1,3
75629,4,1,264928,264928,264929,0,1,3
75630,1,1,264929,264929,264930,0,1,0
75631,5,3,264934,264934,264937,0,3,4
75632,5,1,264939,264939,264940,0,1,2
75633,3,3,264942,264942,264945,0,3,2
75634,4,1,264946,264946,264947,0,1,1
75635,3,1,264949,264949,264950,0,1,2
75636,6,3,264955,264955,264958,0,3,5
75637,2,2,264957,264958,264960,1,3,0
75638,1,1,264958,264960,264961,2,3,0
75639,1,1,264959,264961,264962,2,3,0
75640,4,3,264963,264963,264966,0,3,1
75641,5,2,264968,264968,264970,0,2,2
75642,1,2,264969,264970,264972,1,3,0
75643,6,3,264975,264975,264978,0,3,3
75644,4,1,264979,264979,264980,0,1,1
75645,6,1,264985,264985,264986,0,1,5
75646,5,1,264990,264990,264991,0,1,4
75647,3,3,264993,264993,264996,0,3,2
75648,6,3,264999,264999,265002,0,3,3
75649,3,2,265002,265002,265004,0,2,0
75650,3,2,265005,265005,265007,0,2,1
75651,6,2,265011,265011,265013,0,2,4
75652,2,3,265013,265013,265016,0,3,0
75653,4,3,265017,265017,265020,0,3,1
75654,2,1,265019,265020,265021,1,2,0
75655,3,2,265022,265022,265024,0,2,1
75656,4,1,265026,265026,265027,0,1,2
75657,5,3,265031,265031,265034,0,3,4
75658,2,2,265033,265034,265036,1,3,0
75659,3,1,265036,265036,265037,0,1,0
75660,1,1,265037,265037,265038,0,1,0
75661,4,3,265041,265041,265044,0,3,3
75662,1,2,265042,265044,265046,2,4,0
75663,1,3,265043,265046,265049,3,6,0
75664,6,1,265049,265049,265050,0,1,0
75665,6,3,265055,265055,265058,0,3,5
75666,6,3,265061,265061,265064,0,3,3
75667,4,3,265065,265065,265068,0,3,1
75668,3,1,265068,265068,265069,0,1,0
75669,5,1,265073,265073,265074,0,1,4
75670,6,1,265079,265079,265080,0,1,5
75671,2,1,265081,265081,265082,0,1,1
75672,1,2,265082,265082,265084,0,2,0
75673,2,1,265084,265084,265085,0,1,0
75674,4,1,265088,265088,265089,0,1,3
75675,6,3,265094,265094,265097,0,3,5
75676,6,1,265100,265100,265101,0,1,3
75677,5,2,265105,265105,265107,0,2,4
75678,3,3,265108,265108,265111,0,3,1
75679,3,3,265111,265111,265114,0,3,0
75680,3,1,265114,265114,265115,0,1,0
75681,1,2,265115,265115,265117,0,2,0
75682,4,2,265119,265119,265121,0,2,2
75683,6,1,265125,265125,265126,0,1,4
75684,6,1,265131,265131,265132,0,1,5
75685,3,2,265134,265134,265136,0,2,2
75686,5,1,265139,265139,265140,0,1,3
75687,5,2,265144,265144,265146,0,2,4
75688,6,2,265150,265150,265152,0,2,4
75689,1,3,265151,265152,265155,1,4,0
75690,6,3,265157,265157,265160,0,3,2
75691,4,3,265161,265161,265164,0,3,1
75692,1,3,265162,265164,265167,2,5,0
75693,4,2,265166,265167,265169,1,3,0
75694,4,2,265170,265170,265172,0,2,1
75695,6,3,265176,265176,265179,0,3,4
75696,1,2,265177,265179,265181,2,4,0
75697,2,2,265179,265181,265183,2,4,0
75698,5,3,265184,265184,265187,0,3,1
75699,4,3,265188,265188,265191,0,3,1
75700,2,3,265190,265191,265194,1,4,0
75701,2,1,265192,265194,265195,2,3,0
75702,4,3,265196,265196,265199,0,3,1
75703,6,1,265202,265202,265203,0,1,3
75704,5,1,265207,265207,265208,0,1,4
75705,1,1,265208,265208,265209,0,1,0
75706,4,3,265212,265212,265215,0,3,3
75707,2,3,265214,265215,265218,1,4,0
75708,6,2,265220,265220,265222,0,2,2
75709,6,1,265226,265226,265227,0,1,4
75710,4,2,265230,265230,265232,0,2,3
75711,3,3,265233,265233,265236,0,3,1
75712,4,1,265237,265237,265238,0,1,1
75713,1,3,265238,265238,265241,0,3,0
75714,3,2,265241,265241,265243,0,2,0
75715,5,2,265246,265246,265248,0,2,3
75716,5,3,265251,265251,265254,0,3,3
75717,2,1,265253,265254,265255,1,2,0
75718,5,2,265258,265258,265260,0,2,3
75719,4,3,265262,265262,265265,0,3,2
75720,6,1,265268,265268,265269,0,1,3
75721,4,3,265272,265272,265275,0,3,3
75722,2,2,265274,265275,265277,1,3,0
75723,6,1,265280,265280,265281,0,1,3
75724,3,2,265283,265283,265285,0,2,2
75725,6,2,265289,265289,265291,0,2,4
75726,1,3,265290,265291,265294,1,4,0
75727,5,1,265295,265295,265296,0,1,1
75728,2,1,265297,265297,265298,0,1,1
75729,3,2,265300,265300,265302,0,2,2
75730,3,3,265303,265303,265306,0,3,1
75731,5,1,265308,265308,265309,0,1,2
75732,4,3,265312,265312,265315,0,3,3
75733,4,3,265316,265316,265319,0,3,1
75734,3,1,265319,265319,265320,0,1,0
75735,2,3,265321,265321,265324,0,3,1
75736,2,2,265323,265324,265326,1,3,0
75737,2,3,265325,265326,265329,1,4,0
75738,2,2,265327,265329,265331,2,4,0
75739,3,1,265330,265331,265332,1,2,0
75740,3,1,265333,265333,265334,0,1,1
75741,1,2,265334,265334,265336,0,2,0
75742,4,3,265338,265338,265341,0,3,2
75743,6,2,265344,265344,265346,0,2,3
75744,3,1,265347,265347,265348,0,1,1
75745,1,1,265348,265348,265349,0,1,0
75746,4,1,265352,265352,265353,0,1,3
75747,2,2,265354,265354,265356,0,2,1
75748,1,1,265355,265356,265357,1,2,0
75749,2,1,265357,265357,265358,0,1,0
75750,4,2,265361,265361,265363,0,2,3
75751,6,2,265367,265367,265369,0,2,4
75752,5,3,265372,265372,265375,0,3,3
75753,3,1,265375,265375,265376,0,1,0
75754,5,1,265380,265380,265381,0,1,4
75755,4,2,265384,265384,265386,0,2,3
75756,1,1,265385,265386,265387,1,2,0
75757,1,2,265386,265387,265389,1,3,0
75758,1,3,265387,265389,265392,2,5,0
75759,5,1,265392,265392,265393,0,1,0
75760,1,1,265393,265393,265394,0,1,0
75761,1,1,265394,265394,265395,0,1,0
75762,3,2,265397,265397,265399,0,2,2
75763,5,1,265402,265402,265403,0,1,3
75764,6,2,265408,265408,265410,0,2,5
75765,5,2,265413,265413,265415,0,2,3
75766,1,1,265414,265415,265416,1,2,0
75767,1,2,265415,265416,265418,1,3,0
75768,3,1,265418,265418,265419,0,1,0
75769,2,1,265420,265420,265421,0,1,1
75770,3,3,265423,265423,265426,0,3,2
75771,4,1,265427,265427,265428,0,1,1
75772,4,1,265431,265431,265432,0,1,3
75773,6,3,265437,265437,265440,0,3,5
75774,3,1,265440,265440,265441,0,1,0
75775,3,1,265443,265443,265444,0,1,2
75776,4,3,265447,265447,265450,0,3,3
75777,2,2,265449,265450,265452,1,3,0
75778,1,2,265450,265452,265454,2,4,0
75779,3,3,265453,265454,265457,1,4,0
75780,6,1,265459,265459,265460,0,1,2
75781,5,1,265464,265464,265465,0,1,4
75782,4,2,265468,265468,265470,0,2,3
75783,5,3,265473,265473,265476,0,3,3
75784,5,1,265478,265478,265479,0,1,2
75785,2,2,265480,265480,265482,0,2,1
75786,6,3,265486,265486,265489,0,3,4
75787,5,1,265491,265491,265492,0,1,2
75788,3,1,265494,265494,265495,0,1,2
75789,5,1,265499,265499,265500,0,1,4
75790,5,2,265504,265504,265506,0,2,4
75791,2,3,265506,265506,265509,0,3,0
75792,6,2,265512,265512,265514,0,2,3
75793,6,2,265518,265518,265520,0,2,4
75794,4,2,265522,265522,265524,0,2,2
75795,3,3,265525,265525,265528,0,3,1
75796,4,2,265529,265529,265531,0,2,1
75797,6,1,265535,265535,265536,0,1,4
75798,6,3,265541,265541,265544,0,3,5
75799,3,3,265544,265544,265547,0,3,0
75800,2,2,265546,265547,265549,1,3,0
75801,6,3,265552,265552,265555,0,3,3
75802,2,2,265554,265555,265557,1,3,0
75803,4,3,265558,265558,265561,0,3,1
75804,4,3,265562,265562,265565,0,3,1
75805,6,1,265568,265568,265569,0,1,3
75806,6,2,265574,265574,265576,0,2,5
75807,3,2,265577,265577,265579,0,2,1
75808,4,3,265581,265581,265584,0,3,2
75809,1,1,265582,265584,265585,2,3,0
75810,2,2,265584,265585,265587,1,3,0
75811,3,1,265587,265587,265588,0,1,0
75812,4,3,265591,265591,265594,0,3,3
75813,1,3,265592,265594,265597,2,5,0
75814,3,2,265595,265597,265599,2,4,0
75815,5,3,265600,265600,265603,0,3,1
75816,5,3,265605,265605,265608,0,3,2
75817,3,2,265608,265608,265610,0,2,0
75818,3,3,265611,265611,265614,0,3,1
75819,4,3,265615,265615,265618,0,3,1
75820,2,2,265617,265618,265620,1,3,0
75821,2,3,265619,265620,265623,1,4,0
75822,2,1,265621,265623,265624,2,3,0
75823,3,1,265624,265624,265625,0,1,0
75824,5,2,265629,265629,265631,0,2,4
75825,1,1,265630,265631,265632,1,2,0
75826,6,3,265636,265636,265639,0,3,4
75827,6,3,265642,265642,265645,0,3,3
75828,5,3,265647,265647,265650,0,3,2
75829,5,1,265652,265652,265653,0,1,2
75830,2,1,265654,265654,265655,0,1,1
75831,6,1,265660,265660,265661,0,1,5
75832,3,3,265663,265663,265666,0,3,2
75833,2,1,265665,265666,265667,1,2,0
75834,4,2,265669,265669,265671,0,2,2
75835,1,3,265670,265671,265674,1,4,0
75836,5,1,265675,265675,265676,0,1,1
75837,1,1,265676,265676,265677,0,1,0
75838,3,2,265679,265679,265681,0,2,2
75839,2,3,265681,265681,265684,0,3,0
75840,4,3,265685,265685,265688,0,3,1
75841,3,1,265688,265688,265689,0,1,0
75842,6,3,265694,265694,265697,0,3,5
75843,6,2,265700,265700,265702,0,2,3
75844,6,3,265706,265706,265709,0,3,4
75845,2,1,265708,265709,265710,1,2,0
75846,6,3,265714,265714,265717,0,3,4
75847,1,3,265715,265717,265720,2,5,0
75848,2,1,265717,265720,265721,3,4,0
75849,1,2,265718,265721,265723,3,5,0
75850,1,2,265719,265723,265725,4,6,0
75851,3,1,265722,265725,265726,3,4,0
75852,3,2,265725,265726,265728,1,3,0
75853,2,2,265727,265728,265730,1,3,0
75854,2,3,265729,265730,265733,1,4,0
75855,4,3,265733,265733,265736,0,3,0
75856,6,3,265739,265739,265742,0,3,3
75857,2,3,265741,265742,265745,1,4,0
75858,1,3,265742,265745,265748,3,6,0
75859,6,1,265748,265748,265749,0,1,0
75860,1,3,265749,265749,265752,0,3,0
75861,4,2,265753,265753,265755,0,2,1
75862,1,3,265754,265755,265758,1,4,0
75863,4,3,265758,265758,265761,0,3,0
75864,5,2,265763,265763,265765,0,2,2
75865,4,2,265767,265767,265769,0,2,2
75866,6,3,265773,265773,265776,0,3,4
75867,2,3,265775,265776,265779,1,4,0
75868,5,1,265780,265780,265781,0,1,1
75869,5,2,265785,265785,265787,0,2,4
75870,1,2,265786,265787,265789,1,3,0
75871,5,1,265791,265791,265792,0,1,2
75872,2,3,265793,265793,265796,0,3,1
75873,5,3,265798,265798,265801,0,3,2
75874,6,2,265804,265804,265806,0,2,3
75875,2,1,265806,265806,265807,0,1,0
75876,4,3,265810,265810,265813,0,3,3
75877,2,3,265812,265813,265816,1,4,0
75878,4,3,265816,265816,265819,0,3,0
75879,5,3,265821,265821,265824,0,3,2
75880,2,2,265823,265824,265826,1,3,0
75881,6,2,265829,265829,265831,0,2,3
75882,1,2,265830,265831,265833,1,3,0
75883,5,1,265835,265835,265836,0,1,2
75884,3,3,265838,265838,265841,0,3,2
75885,6,1,265844,265844,265845,0,1,3
75886,5,1,265849,265849,265850,0,1,4
75887,4,3,265853,265853,265856,0,3,3
75888,3,1,265856,265856,265857,0,1,0
75889,3,3,265859,265859,265862,0,3,2
75890,5,2,265864,265864,265866,0,2,2
75891,3,2,265867,265867,265869,0,2,1
75892,4,1,265871,265871,265872,0,1,2
75893,5,3,265876,265876,265879,0,3,4
75894,3,3,265879,265879,265882,0,3,0
75895,4,3,265883,265883,265886,0,3,1
75896,2,3,265885,265886,265889,1,4,0
75897,6,2,265891,265891,265893,0,2,2
75898,4,2,265895,265895,265897,0,2,2
75899,6,3,265901,265901,265904,0,3,4
75900,4,1,265905,265905,265906,0,1,1
75901,5,2,265910,265910,265912,0,2,4
75902,5,3,265915,265915,265918,0,3,3
75903,6,2,265921,265921,265923,0,2,3
75904,3,2,265924,265924,265926,0,2,1
75905,3,2,265927,265927,265929,0,2,1
75906,6,1,265933,265933,265934,0,1,4
75907,5,1,265938,265938,265939,0,1,4
75908,2,1,265940,265940,265941,0,1,1
75909,5,1,265945,265945,265946,0,1,4
75910,1,1,265946,265946,265947,0,1,0
75911,4,2,265950,265950,265952,0,2,3
75912,4,1,265954,265954,265955,0,1,2
75913,5,3,265959,265959,265962,0,3,4
75914,6,3,265965,265965,265968,0,3,3
75915,5,3,265970,265970,265973,0,3,2
75916,2,1,265972,265973,265974,1,2,0
75917,6,3,265978,265978,265981,0,3,4
75918,2,1,265980,265981,265982,1,2,0
75919,5,2,265985,265985,265987,0,2,3
75920,3,2,265988,265988,265990,0,2,1
75921,1,2,265989,265990,265992,1,3,0
75922,4,1,265993,265993,265994,0,1,1
75923,2,1,265995,265995,265996,0,1,1
75924,4,1,265999,265999,266000,0,1,3
75925,1,1,266000,266000,266001,0,1,0
75926,2,2,266002,266002,266004,0,2,1
75927,6,3,266008,266008,266011,0,3,4
75928,1,2,266009,266011,266013,2,4,0
75929,3,2,266012,266013,266015,1,3,0
75930,4,3,266016,266016,266019,0,3,1
75931,3,3,266019,266019,266022,0,3,0
75932,4,3,266023,266023,266026,0,3,1
75933,3,2,266026,266026,266028,0,2,0
75934,1,1,266027,266028,266029,1,2,0
75935,3,3,266030,266030,266033,0,3,1
75936,5,2,266035,266035,266037,0,2,2
75937,1,2,266036,266037,266039,1,3,0
75938,3,1,266039,266039,266040,0,1,0
75939,2,3,266041,266041,266044,0,3,1
75940,1,3,266042,266044,266047,2,5,0
75941,5,3,266047,266047,266050,0,3,0
75942,2,1,266049,266050,266051,1,2,0
75943,4,1,266053,266053,266054,0,1,2
75944,3,2,266056,266056,266058,0,2,2
75945,4,3,266060,266060,266063,0,3,2
75946,5,1,266065,266065,266066,0,1,2
75947,1,2,266066,266066,266068,0,2,0
75948,5,1,266071,266071,266072,0,1,3
75949,6,3,266077,266077,266080,0,3,5
75950,6,2,266083,266083,266085,0,2,3
75951,6,1,266089,266089,266090,0,1,4
75952,2,2,266091,266091,266093,0,2,1
75953,3,2,266094,266094,266096,0,2,1
75954,1,2,266095,266096,266098,1,3,0
75955,5,2,266100,266100,266102,0,2,2
75956,5,2,266105,266105,266107,0,2,3
75957,5,2,266110,266110,266112,0,2,3
75958,6,2,266116,266116,266118,0,2,4
75959,6,3,266122,266122,266125,0,3,4
75960,4,3,266126,266126,266129,0,3,1
75961,2,1,266128,266129,266130,1,2,0
75962,2,3,266130,266130,266133,0,3,0
75963,1,1,266131,266133,266134,2,3,0
75964,5,3,266136,266136,266139,0,3,2
75965,2,1,266138,266139,266140,1,2,0
75966,5,1,266143,266143,266144,0,1,3
75967,6,2,266149,266149,266151,0,2,5
75968,5,2,266154,266154,266156,0,2,3
75969,5,2,266159,266159,266161,0,2,3
75970,1,1,266160,266161,266162,1,2,0
75971,6,1,266166,266166,266167,0,1,4
75972,4,2,266170,266170,266172,0,2,3
75973,6,2,266176,266176,266178,0,2,4
75974,4,3,266180,266180,266183,0,3,2
75975,3,1,266183,266183,266184,0,1,0
75976,3,1,266186,266186,266187,0,1,2
75977,6,2,266192,266192,266194,0,2,5
75978,2,3,266194,266194,266197,0,3,0
75979,6,3,266200,266200,266203,0,3,3
75980,6,1,266206,266206,266207,0,1,3
75981,2,3,266208,266208,266211,0,3,1
75982,4,2,266212,266212,266214,0,2,1
75983,4,1,266216,266216,266217,0,1,2
75984,4,3,266220,266220,266223,0,3,3
75985,6,1,266226,266226,266227,0,1,3
75986,6,2,266232,266232,266234,0,2,5
75987,1,3,266233,266234,266237,1,4,0
75988,2,2,266235,266237,266239,2,4,0
75989,1,3,266236,266239,266242,3,6,0
75990,6,3,266242,266242,266245,0,3,0
75991,2,3,266244,266245,266248,1,4,0
75992,5,1,266249,266249,266250,0,1,1
75993,6,1,266255,266255,266256,0,1,5
75994,4,3,266259,266259,266262,0,3,3
75995,6,2,266265,266265,266267,0,2,3
75996,4,3,266269,266269,266272,0,3,2
75997,3,3,266272,266272,266275,0,3,0
75998,2,1,266274,266275,266276,1,2,0
75999,4,3,266278,266278,266281,0,3,2
76000,2,3,266280,266281,266284,1,4,0
76001,6,2,266286,266286,266288,0,2,2
76002,6,1,266292,266292,266293,0,1,4
76003,3,1,266295,266295,266296,0,1,2
76004,1,2,266296,266296,266298,0,2,0
76005,4,1,266300,266300,266301,0,1,2
76006,2,3,266302,266302,266305,0,3,1
76007,5,2,266307,266307,266309,0,2,2
76008,1,1,266308,266309,266310,1,2,0
76009,1,2,266309,266310,266312,1,3,0
76010,5,3,266314,266314,266317,0,3,2
76011,6,2,266320,266320,266322,0,2,3
76012,3,1,266323,266323,266324,0,1,1
76013,6,2,266329,266329,266331,0,2,5
76014,3,3,266332,266332,266335,0,3,1
76015,5,1,266337,266337,266338,0,1,2
76016,3,3,266340,266340,266343,0,3,2
76017,6,2,266346,266346,266348,0,2,3
76018,4,1,266350,266350,266351,0,1,2
76019,5,2,266355,266355,266357,0,2,4
76020,6,3,266361,266361,266364,0,3,4
76021,4,3,266365,266365,266368,0,3,1
76022,4,1,266369,266369,266370,0,1,1
76023,1,3,266370,266370,266373,0,3,0
76024,5,3,266375,266375,266378,0,3,2
76025,4,3,266379,266379,266382,0,3,1
76026,2,1,266381,266382,266383,1,2,0
76027,3,1,266384,266384,266385,0,1,1
76028,4,2,266388,266388,266390,0,2,3
76029,6,3,266394,266394,266397,0,3,4
76030,5,2,266399,266399,266401,0,2,2
76031,6,3,266405,266405,266408,0,3,4
76032,6,2,266411,266411,266413,0,2,3
76033,5,1,266416,266416,266417,0,1,3
76034,5,1,266421,266421,266422,0,1,4
76035,2,3,266423,266423,266426,0,3,1
76036,6,1,266429,266429,266430,0,1,3
76037,4,1,266433,266433,266434,0,1,3
76038,3,3,266436,266436,266439,0,3,2
76039,2,2,266438,266439,266441,1,3,0
76040,2,1,266440,266441,266442,1,2,0
76041,1,2,266441,266442,266444,1,3,0
76042,2,2,266443,266444,266446,1,3,0
76043,6,2,266449,266449,266451,0,2,3
76044,6,1,266455,266455,266456,0,1,4
76045,5,3,266460,266460,266463,0,3,4
76046,3,1,266463,266463,266464,0,1,0
76047,2,3,266465,266465,266468,0,3,1
76048,3,3,266468,266468,266471,0,3,0
76049,6,2,266474,266474,266476,0,2,3
76050,4,3,266478,266478,266481,0,3,2
76051,1,2,266479,266481,266483,2,4,0
76052,1,1,266480,266483,266484,3,4,0
76053,2,2,266482,266484,266486,2,4,0
76054,5,1,266487,266487,266488,0,1,1
76055,6,2,266493,266493,266495,0,2,5
76056,6,2,266499,266499,266501,0,2,4
76057,1,2,266500,266501,266503,1,3,0
76058,4,2,266504,266504,266506,0,2,1
76059,6,1,266510,266510,266511,0,1,4
76060,4,3,266514,266514,266517,0,3,3
76061,2,3,266516,266517,266520,1,4,0
76062,4,2,266520,266520,266522,0,2,0
76063,1,2,266521,266522,266524,1,3,0
76064,2,2,266523,266524,266526,1,3,0
76065,2,2,266525,266526,266528,1,3,0
76066,3,3,266528,266528,266531,0,3,0
76067,1,3,266529,266531,266534,2,5,0
76068,3,2,266532,266534,266536,2,4,0
76069,3,3,266535,266536,266539,1,4,0
76070,2,1,266537,266539,266540,2,3,0
76071,6,2,266543,266543,266545,0,2,3
76072,2,1,266545,266545,266546,0,1,0
76073,4,1,266549,266549,266550,0,1,3
76074,1,1,266550,266550,266551,0,1,0
76075,6,2,266556,266556,266558,0,2,5
76076,3,1,266559,266559,266560,0,1,1
76077,6,1,266565,266565,266566,0,1,5
76078,1,2,266566,266566,266568,0,2,0
76079,6,1,266572,266572,266573,0,1,4
76080,6,2,266578,266578,266580,0,2,5
76081,5,3,266583,266583,266586,0,3,3
76082,3,3,266586,266586,266589,0,3,0
76083,1,2,266587,266589,266591,2,4,0
76084,3,3,266590,266591,266594,1,4,0
76085,6,1,266596,266596,266597,0,1,2
76086,1,1,266597,266597,266598,0,1,0
76087,1,3,266598,266598,266601,0,3,0
76088,1,1,266599,266601,266602,2,3,0
76089,1,3,266600,266602,266605,2,5,0
76090,2,2,266602,266605,266607,3,5,0
76091,5,2,266607,266607,266609,0,2,0
76092,3,2,266610,266610,266612,0,2,1
76093,3,2,266613,266613,266615,0,2,1
76094,1,3,266614,266615,266618,1,4,0
76095,6,3,266620,266620,266623,0,3,2
76096,4,2,266624,266624,266626,0,2,1
76097,3,3,266627,266627,266630,0,3,1
76098,4,1,266631,266631,266632,0,1,1
76099,2,3,266633,266633,266636,0,3,1
76100,6,3,266639,266639,266642,0,3,3
76101,3,3,266642,266642,266645,0,3,0
76102,1,2,266643,266645,266647,2,4,0
76103,1,1,266644,266647,266648,3,4,0
76104,1,3,266645,266648,266651,3,6,0
76105,1,1,266646,266651,266652,5,6,0
76106,4,2,266650,266652,266654,2,4,0
76107,3,2,266653,266654,266656,1,3,0
76108,3,1,266656,266656,266657,0,1,0
76109,3,3,266659,266659,266662,0,3,2
76110,4,2,266663,266663,266665,0,2,1
76111,4,1,266667,266667,266668,0,1,2
76112,1,3,266668,266668,266671,0,3,0
76113,2,2,266670,266671,266673,1,3,0
76114,1,3,266671,266673,266676,2,5,0
76115,5,1,266676,266676,266677,0,1,0
76116,2,1,266678,266678,266679,0,1,1
76117,5,2,266683,266683,266685,0,2,4
76118,6,2,266689,266689,266691,0,2,4
76119,4,1,266693,266693,266694,0,1,2
76120,5,3,266698,266698,266701,0,3,4
76121,6,1,266704,266704,266705,0,1,3
76122,1,2,266705,266705,266707,0,2,0
76123,6,3,266711,266711,266714,0,3,4
76124,5,1,266716,266716,266717,0,1,2
76125,5,2,266721,266721,266723,0,2,4
76126,1,2,266722,266723,266725,1,3,0
76127,1,2,266723,266725,266727,2,4,0
76128,3,3,266726,266727,266730,1,4,0
76129,5,2,266731,266731,266733,0,2,1
76130,6,3,266737,266737,266740,0,3,4
76131,3,2,266740,266740,266742,0,2,0
76132,6,3,266746,266746,266749,0,3,4
76133,6,2,266752,266752,266754,0,2,3
76134,5,2,266757,266757,266759,0,2,3
76135,6,1,266763,266763,266764,0,1,4
76136,6,3,266769,266769,266772,0,3,5
76137,1,2,266770,266772,266774,2,4,0
76138,3,2,266773,266774,266776,1,3,0
76139,2,3,266775,266776,266779,1,4,0
76140,3,2,266778,266779,266781,1,3,0
76141,1,2,266779,266781,266783,2,4,0
76142,1,1,266780,266783,266784,3,4,0
76143,5,3,266785,266785,266788,0,3,1
76144,5,1,266790,266790,266791,0,1,2
76145,3,1,266793,266793,266794,0,1,2
76146,6,3,266799,266799,266802,0,3,5
76147,5,3,266804,266804,266807,0,3,2
76148,1,2,266805,266807,266809,2,4,0
76149,3,1,266808,266809,266810,1,2,0
76150,2,3,266810,266810,266813,0,3,0
76151,2,1,266812,266813,266814,1,2,0
76152,4,1,266816,266816,266817,0,1,2
76153,3,3,266819,266819,266822,0,3,2
76154,5,2,266824,266824,266826,0,2,2
76155,1,2,266825,266826,266828,1,3,0
76156,1,3,266826,266828,266831,2,5,0
76157,1,2,266827,266831,266833,4,6,0
76158,2,3,266829,266833,266836,4,7,0
76159,5,1,266834,266836,266837,2,3,0
76160,1,2,266835,266837,266839,2,4,0
76161,4,2,266839,266839,266841,0,2,0
76162,1,2,266840,266841,266843,1,3,0
76163,2,3,266842,266843,266846,1,4,0
76164,6,3,266848,266848,266851,0,3,2
76165,4,1,266852,266852,266853,0,1,1
76166,4,1,266856,266856,266857,0,1,3
76167,2,2,266858,266858,266860,0,2,1
76168,1,3,266859,266860,266863,1,4,0
76169,3,1,266862,266863,266864,1,2,0
76170,1,1,266863,266864,266865,1,2,0
76171,4,1,266867,266867,266868,0,1,2
76172,1,1,266868,266868,266869,0,1,0
76173,5,2,266873,266873,266875,0,2,4
76174,1,3,266874,266875,266878,1,4,0
76175,6,2,266880,266880,266882,0,2,2
76176,1,3,266881,266882,266885,1,4,0
76177,3,3,266884,266885,266888,1,4,0
76178,3,3,266887,266888,266891,1,4,0
76179,5,1,266892,266892,266893,0,1,1
76180,2,3,266894,266894,266897,0,3,1
76181,1,1,266895,266897,266898,2,3,0
76182,4,2,266899,266899,266901,0,2,1
76183,3,1,266902,266902,266903,0,1,1
76184,5,3,266907,266907,266910,0,3,4
76185,6,3,266913,266913,266916,0,3,3
76186,3,3,266916,266916,266919,0,3,0
76187,6,1,266922,266922,266923,0,1,3
76188,1,2,266923,266923,266925,0,2,0
76189,3,3,266926,266926,266929,0,3,1
76190,2,1,266928,266929,266930,1,2,0
76191,2,1,266930,266930,266931,0,1,0
76192,1,3,266931,266931,266934,0,3,0
76193,6,3,266937,266937,266940,0,3,3
76194,6,1,266943,266943,266944,0,1,3
76195,6,1,266949,266949,266950,0,1,5
76196,3,1,266952,266952,266953,0,1,2
76197,3,3,266955,266955,266958,0,3,2
76198,3,1,266958,266958,266959,0,1,0
76199,3,1,266961,266961,266962,0,1,2
76200,4,3,266965,266965,266968,0,3,3
76201,5,1,266970,266970,266971,0,1,2
76202,1,1,266971,266971,266972,0,1,0
76203,2,2,266973,266973,266975,0,2,1
76204,2,1,266975,266975,266976,0,1,0
76205,1,3,266976,266976,266979,0,3,0
76206,1,2,266977,266979,266981,2,4,0
76207,1,1,266978,266981,266982,3,4,0
76208,1,2,266979,266982,266984,3,5,0
76209,5,2,266984,266984,266986,0,2,0
76210,6,2,266990,266990,266992,0,2,4
76211,5,3,266995,266995,266998,0,3,3
76212,5,1,267000,267000,267001,0,1,2
76213,1,2,267001,267001,267003,0,2,0
76214,5,1,267006,267006,267007,0,1,3
76215,1,3,267007,267007,267010,0,3,0
76216,1,1,267008,267010,267011,2,3,0
76217,6,1,267014,267014,267015,0,1,3
76218,1,3,267015,267015,267018,0,3,0
76219,6,3,267021,267021,267024,0,3,3
76220,5,1,267026,267026,267027,0,1,2
76221,5,2,267031,267031,267033,0,2,4
76222,6,3,267037,267037,267040,0,3,4
76223,1,1,267038,267040,267041,2,3,0
76224,4,2,267042,267042,267044,0,2,1
76225,1,2,267043,267044,267046,1,3,0
76226,6,2,267049,267049,267051,0,2,3
76227,5,3,267054,267054,267057,0,3,3
76228,5,3,267059,267059,267062,0,3,2
76229,6,1,267065,267065,267066,0,1,3
76230,2,1,267067,267067,267068,0,1,1
76231,6,2,267073,267073,267075,0,2,5
76232,4,2,267077,267077,267079,0,2,2
76233,5,2,267082,267082,267084,0,2,3
76234,3,3,267085,267085,267088,0,3,1
76235,2,3,267087,267088,267091,1,4,0
76236,6,1,267093,267093,267094,0,1,2
76237,4,1,267097,267097,267098,0,1,3
76238,1,1,267098,267098,267099,0,1,0
76239,6,1,267104,267104,267105,0,1,5
76240,1,3,267105,267105,267108,0,3,0
76241,3,1,267108,267108,267109,0,1,0
76242,2,1,267110,267110,267111,0,1,1
76243,2,1,267112,267112,267113,0,1,1
76244,4,1,267116,267116,267117,0,1,3
76245,5,1,267121,267121,267122,0,1,4
76246,2,3,267123,267123,267126,0,3,1
76247,5,1,267128,267128,267129,0,1,2
76248,6,1,267134,267134,267135,0,1,5
76249,1,1,267135,267135,267136,0,1,0
76250,5,2,267140,267140,267142,0,2,4
76251,6,2,267146,267146,267148,0,2,4
76252,2,2,267148,267148,267150,0,2,0
76253,1,1,267149,267150,267151,1,2,0
76254,1,2,267150,267151,267153,1,3,0
76255,5,3,267155,267155,267158,0,3,2
76256,1,2,267156,267158,267160,2,4,0
76257,4,3,267160,267160,267163,0,3,0
76258,5,1,267165,267165,267166,0,1,2
76259,3,3,267168,267168,267171,0,3,2
76260,3,3,267171,267171,267174,0,3,0
76261,3,3,267174,267174,267177,0,3,0
76262,4,3,267178,267178,267181,0,3,1
76263,6,3,267184,267184,267187,0,3,3
76264,3,3,267187,267187,267190,0,3,0
76265,4,3,267191,267191,267194,0,3,1
76266,1,2,267192,267194,267196,2,4,0
76267,3,3,267195,267196,267199,1,4,0
76268,3,3,267198,267199,267202,1,4,0
76269,6,3,267204,267204,267207,0,3,2
76270,6,3,267210,267210,267213,0,3,3
76271,2,3,267212,267213,267216,1,4,0
76272,6,2,267218,267218,267220,0,2,2
76273,2,2,267220,267220,267222,0,2,0
76274,3,3,267223,267223,267226,0,3,1
76275,3,3,267226,267226,267229,0,3,0
76276,5,1,267231,267231,267232,0,1,2
76277,5,2,267236,267236,267238,0,2,4
76278,4,1,267240,267240,267241,0,1,2
76279,6,2,267246,267246,267248,0,2,5
76280,1,3,267247,267248,267251,1,4,0
76281,3,1,267250,267251,267252,1,2,0
76282,5,1,267255,267255,267256,0,1,3
76283,3,3,267258,267258,267261,0,3,2
76284,5,3,267263,267263,267266,0,3,2
76285,2,1,267265,267266,267267,1,2,0
76286,4,3,267269,267269,267272,0,3,2
76287,4,2,267273,267273,267275,0,2,1
76288,5,1,267278,267278,267279,0,1,3
76289,2,1,267280,267280,267281,0,1,1
76290,2,1,267282,267282,267283,0,1,1
76291,5,2,267287,267287,267289,0,2,4
76292,5,1,267292,267292,267293,0,1,3
76293,1,2,267293,267293,267295,0,2,0
76294,5,1,267298,267298,267299,0,1,3
76295,2,3,267300,267300,267303,0,3,1
76296,2,2,267302,267303,267305,1,3,0
76297,5,3,267307,267307,267310,0,3,2
76298,4,1,267311,267311,267312,0,1,1
76299,4,3,267315,267315,267318,0,3,3
76300,3,3,267318,267318,267321,0,3,0
76301,1,3,267319,267321,267324,2,5,0
76302,5,2,267324,267324,267326,0,2,0
76303,5,3,267329,267329,267332,0,3,3
76304,6,2,267335,267335,267337,0,2,3
76305,4,3,267339,267339,267342,0,3,2
76306,6,2,267345,267345,267347,0,2,3
76307,2,2,267347,267347,267349,0,2,0
76308,3,1,267350,267350,267351,0,1,1
76309,1,3,267351,267351,267354,0,3,0
76310,3,1,267354,267354,267355,0,1,0
76311,5,1,267359,267359,267360,0,1,4
76312,5,1,267364,267364,267365,0,1,4
76313,2,1,267366,267366,267367,0,1,1
76314,5,3,267371,267371,267374,0,3,4
76315,4,3,267375,267375,267378,0,3,1
76316,4,2,267379,267379,267381,0,2,1
76317,6,1,267385,267385,267386,0,1,4
76318,4,2,267389,267389,267391,0,2,3
76319,1,2,267390,267391,267393,1,3,0
76320,6,3,267396,267396,267399,0,3,3
76321,1,3,267397,267399,267402,2,5,0
76322,5,1,267402,267402,267403,0,1,0
76323,6,1,267408,267408,267409,0,1,5
76324,2,1,267410,267410,267411,0,1,1
76325,3,3,267413,267413,267416,0,3,2
76326,1,2,267414,267416,267418,2,4,0
76327,4,2,267418,267418,267420,0,2,0
76328,5,2,267423,267423,267425,0,2,3
76329,6,2,267429,267429,267431,0,2,4
76330,4,2,267433,267433,267435,0,2,2
76331,5,1,267438,267438,267439,0,1,3
76332,1,2,267439,267439,267441,0,2,0
76333,4,2,267443,267443,267445,0,2,2
76334,6,1,267449,267449,267450,0,1,4
76335,4,2,267453,267453,267455,0,2,3
76336,6,1,267459,267459,267460,0,1,4
76337,5,2,267464,267464,267466,0,2,4
76338,6,1,267470,267470,267471,0,1,4
76339,2,1,267472,267472,267473,0,1,1
76340,3,1,267475,267475,267476,0,1,2
76341,1,1,267476,267476,267477,0,1,0
76342,3,1,267479,267479,267480,0,1,2
76343,5,3,267484,267484,267487,0,3,4
76344,6,1,267490,267490,267491,0,1,3
76345,1,1,267491,267491,267492,0,1,0
76346,2,2,267493,267493,267495,0,2,1
76347,3,1,267496,267496,267497,0,1,1
76348,2,1,267498,267498,267499,0,1,1
76349,3,1,267501,267501,267502,0,1,2
76350,1,3,267502,267502,267505,0,3,0
76351,6,2,267508,267508,267510,0,2,3
76352,3,2,267511,267511,267513,0,2,1
76353,3,2,267514,267514,267516,0,2,1
76354,3,2,267517,267517,267519,0,2,1
76355,3,2,267520,267520,267522,0,2,1
76356,1,3,267521,267522,267525,1,4,0
76357,1,3,267522,267525,267528,3,6,0
76358,2,1,267524,267528,267529,4,5,0
76359,4,2,267528,267529,267531,1,3,0
76360,3,1,267531,267531,267532,0,1,0
76361,2,1,267533,267533,267534,0,1,1
76362,2,1,267535,267535,267536,0,1,1
76363,5,1,267540,267540,267541,0,1,4
76364,2,2,267542,267542,267544,0,2,1
76365,5,1,267547,267547,267548,0,1,3
76366,6,1,267553,267553,267554,0,1,5
76367,5,2,267558,267558,267560,0,2,4
76368,6,3,267564,267564,267567,0,3,4
76369,2,2,267566,267567,267569,1,3,0
76370,6,1,267572,267572,267573,0,1,3
76371,6,3,267578,267578,267581,0,3,5
76372,4,3,267582,267582,267585,0,3,1
76373,5,1,267587,267587,267588,0,1,2
76374,3,3,267590,267590,267593,0,3,2
76375,5,1,267595,267595,267596,0,1,2
76376,3,3,267598,267598,267601,0,3,2
76377,3,1,267601,267601,267602,0,1,0
76378,6,2,267607,267607,267609,0,2,5
76379,2,3,267609,267609,267612,0,3,0
76380,5,1,267614,267614,267615,0,1,2
76381,6,3,267620,267620,267623,0,3,5
76382,3,3,267623,267623,267626,0,3,0
76383,6,1,267629,267629,267630,0,1,3
76384,6,2,267635,267635,267637,0,2,5
76385,6,1,267641,267641,267642,0,1,4
76386,6,1,267647,267647,267648,0,1,5
76387,3,1,267650,267650,267651,0,1,2
76388,6,2,267656,267656,267658,0,2,5
76389,6,1,267662,267662,267663,0,1,4
76390,5,2,267667,267667,267669,0,2,4
76391,1,1,267668,267669,267670,1,2,0
76392,5,1,267673,267673,267674,0,1,3
76393,4,3,267677,267677,267680,0,3,3
76394,1,1,267678,267680,267681,2,3,0
76395,1,3,267679,267681,267684,2,5,0
76396,1,2,267680,267684,267686,4,6,0
76397,3,3,267683,267686,267689,3,6,0
76398,3,1,267686,267689,267690,3,4,0
76399,6,2,267692,267692,267694,0,2,2
76400,2,3,267694,267694,267697,0,3,0
76401,2,1,267696,267697,267698,1,2,0
76402,6,3,267702,267702,267705,0,3,4
76403,3,3,267705,267705,267708,0,3,0
76404,1,2,267706,267708,267710,2,4,0
76405,1,2,267707,267710,267712,3,5,0
76406,1,3,267708,267712,267715,4,7,0
76407,2,1,267710,267715,267716,5,6,0
76408,2,3,267712,267716,267719,4,7,0
76409,3,1,267715,267719,267720,4,5,0
76410,2,1,267717,267720,267721,3,4,0
76411,1,2,267718,267721,267723,3,5,0
76412,5,2,267723,267723,267725,0,2,0
76413,3,1,267726,267726,267727,0,1,1
76414,1,1,267727,267727,267728,0,1,0
76415,3,2,267730,267730,267732,0,2,2
76416,5,3,267735,267735,267738,0,3,3
76417,2,2,267737,267738,267740,1,3,0
76418,6,1,267743,267743,267744,0,1,3
76419,1,2,267744,267744,267746,0,2,0
76420,5,2,267749,267749,267751,0,2,3
76421,6,3,267755,267755,267758,0,3,4
76422,2,1,267757,267758,267759,1,2,0
76423,4,2,267761,267761,267763,0,2,2
76424,5,3,267766,267766,267769,0,3,3
76425,1,3,267767,267769,267772,2,5,0
76426,5,3,267772,267772,267775,0,3,0
76427,1,3,267773,267775,267778,2,5,0
76428,3,1,267776,267778,267779,2,3,0
76429,5,1,267781,267781,267782,0,1,2
76430,5,1,267786,267786,267787,0,1,4
76431,4,2,267790,267790,267792,0,2,3
76432,1,2,267791,267792,267794,1,3,0
76433,3,2,267794,267794,267796,0,2,0
76434,4,2,267798,267798,267800,0,2,2
76435,2,1,267800,267800,267801,0,1,0
76436,4,1,267804,267804,267805,0,1,3
76437,6,2,267810,267810,267812,0,2,5
76438,1,1,267811,267812,267813,1,2,0
76439,4,2,267815,267815,267817,0,2,2
76440,5,3,267820,267820,267823,0,3,3
76441,5,1,267825,267825,267826,0,1,2
76442,6,1,267831,267831,267832,0,1,5
76443,1,2,267832,267832,267834,0,2,0
76444,3,1,267835,267835,267836,0,1,1
76445,3,1,267838,267838,267839,0,1,2
76446,4,1,267842,267842,267843,0,1,3
76447,1,1,267843,267843,267844,0,1,0
76448,6,2,267849,267849,267851,0,2,5
76449,1,2,267850,267851,267853,1,3,0
76450,1,1,267851,267853,267854,2,3,0
76451,2,1,267853,267854,267855,1,2,0
76452,6,1,267859,267859,267860,0,1,4
76453,1,2,267860,267860,267862,0,2,0
76454,3,1,267863,267863,267864,0,1,1
76455,4,3,267867,267867,267870,0,3,3
76456,4,2,267871,267871,267873,0,2,1
76457,6,2,267877,267877,267879,0,2,4
76458,6,2,267883,267883,267885,0,2,4
76459,5,2,267888,267888,267890,0,2,3
76460,4,1,267892,267892,267893,0,1,2
76461,1,3,267893,267893,267896,0,3,0
76462,3,3,267896,267896,267899,0,3,0
76463,5,2,267901,267901,267903,0,2,2
76464,4,2,267905,267905,267907,0,2,2
76465,3,1,267908,267908,267909,0,1,1
76466,1,1,267909,267909,267910,0,1,0
76467,1,3,267910,267910,267913,0,3,0
76468,1,1,267911,267913,267914,2,3,0
76469,2,2,267913,267914,267916,1,3,0
76470,3,2,267916,267916,267918,0,2,0
76471,5,3,267921,267921,267924,0,3,3
76472,6,1,267927,267927,267928,0,1,3
76473,1,1,267928,267928,267929,0,1,0
76474,5,1,267933,267933,267934,0,1,4
76475,6,2,267939,267939,267941,0,2,5
76476,3,3,267942,267942,267945,0,3,1
76477,3,2,267945,267945,267947,0,2,0
76478,4,3,267949,267949,267952,0,3,2
76479,3,1,267952,267952,267953,0,1,0
76480,5,1,267957,267957,267958,0,1,4
76481,2,1,267959,267959,267960,0,1,1
76482,2,1,267961,267961,267962,0,1,1
76483,2,2,267963,267963,267965,0,2,1
76484,1,1,267964,267965,267966,1,2,0
76485,6,3,267970,267970,267973,0,3,4
76486,6,3,267976,267976,267979,0,3,3
76487,3,3,267979,267979,267982,0,3,0
76488,6,2,267985,267985,267987,0,2,3
76489,6,3,267991,267991,267994,0,3,4
76490,6,2,267997,267997,267999,0,2,3
76491,6,2,268003,268003,268005,0,2,4
76492,6,2,268009,268009,268011,0,2,4
76493,2,3,268011,268011,268014,0,3,0
76494,2,2,268013,268014,268016,1,3,0
76495,3,2,268016,268016,268018,0,2,0
76496,4,2,268020,268020,268022,0,2,2
76497,2,1,268022,268022,268023,0,1,0
76498,3,2,268025,268025,268027,0,2,2
76499,3,2,268028,268028,268030,0,2,1
76500,1,2,268029,268030,268032,1,3,0
76501,1,3,268030,268032,268035,2,5,0
76502,1,2,268031,268035,268037,4,6,0
76503,5,3,268036,268037,268040,1,4,0
76504,3,3,268039,268040,268043,1,4,0
76505,2,2,268041,268043,268045,2,4,0
76506,2,1,268043,268045,268046,2,3,0
76507,5,3,268048,268048,268051,0,3,2
76508,5,1,268053,268053,268054,0,1,2
76509,6,1,268059,268059,268060,0,1,5
76510,1,1,268060,268060,268061,0,1,0
76511,1,3,268061,268061,268064,0,3,0
76512,3,3,268064,268064,268067,0,3,0
76513,3,3,268067,268067,268070,0,3,0
76514,4,1,268071,268071,268072,0,1,1
76515,4,2,268075,268075,268077,0,2,3
76516,2,3,268077,268077,268080,0,3,0
76517,1,1,268078,268080,268081,2,3,0
76518,5,2,268083,268083,268085,0,2,2
76519,3,3,268086,268086,268089,0,3,1
76520,6,1,268092,268092,268093,0,1,3
76521,2,1,268094,268094,268095,0,1,1
76522,5,3,268099,268099,268102,0,3,4
76523,3,2,268102,268102,268104,0,2,0
76524,4,2,268106,268106,268108,0,2,2
76525,3,2,268109,268109,268111,0,2,1
76526,2,1,268111,268111,268112,0,1,0
76527,2,1,268113,268113,268114,0,1,1
76528,6,3,268119,268119,268122,0,3,5
76529,2,1,268121,268122,268123,1,2,0
76530,4,2,268125,268125,268127,0,2,2
76531,6,3,268131,268131,268134,0,3,4
76532,3,2,268134,268134,268136,0,2,0
76533,4,2,268138,268138,268140,0,2,2
76534,3,1,268141,268141,268142,0,1,1
76535,2,2,268143,268143,268145,0,2,1
76536,5,2,268148,268148,268150,0,2,3
76537,1,3,268149,268150,268153,1,4,0
76538,3,3,268152,268153,268156,1,4,0
76539,3,2,268155,268156,268158,1,3,0
76540,3,2,268158,268158,268160,0,2,0
76541,6,1,268164,268164,268165,0,1,4
76542,1,3,268165,268165,268168,0,3,0
76543,1,3,268166,268168,268171,2,5,0
76544,2,1,268168,268171,268172,3,4,0
76545,2,3,268170,268172,268175,2,5,0
76546,1,3,268171,268175,268178,4,7,0
76547,5,1,268176,268178,268179,2,3,0
76548,4,1,268180,268180,268181,0,1,1
76549,1,3,268181,268181,268184,0,3,0
76550,6,1,268187,268187,268188,0,1,3
76551,5,2,268192,268192,268194,0,2,4
76552,2,1,268194,268194,268195,0,1,0
76553,6,3,268200,268200,268203,0,3,5
76554,3,2,268203,268203,268205,0,2,0
76555,5,1,268208,268208,268209,0,1,3
76556,2,3,268210,268210,268213,0,3,1
76557,5,2,268215,268215,268217,0,2,2
76558,4,3,268219,268219,268222,0,3,2
76559,4,1,268223,268223,268224,0,1,1
76560,1,3,268224,268224,268227,0,3,0
76561,3,1,268227,268227,268228,0,1,0
76562,5,1,268232,268232,268233,0,1,4
76563,3,1,268235,268235,268236,0,1,2
76564,3,1,268238,268238,268239,0,1,2
76565,5,1,268243,268243,268244,0,1,4
76566,3,2,268246,268246,268248,0,2,2
76567,5,1,268251,268251,268252,0,1,3
76568,6,3,268257,268257,268260,0,3,5
76569,4,3,268261,268261,268264,0,3,1
76570,6,3,268267,268267,268270,0,3,3
76571,6,1,268273,268273,268274,0,1,3
76572,2,2,268275,268275,268277,0,2,1
76573,3,1,268278,268278,268279,0,1,1
76574,1,2,268279,268279,268281,0,2,0
76575,3,3,268282,268282,268285,0,3,1
76576,2,1,268284,268285,268286,1,2,0
76577,5,2,268289,268289,268291,0,2,3
76578,2,1,268291,268291,268292,0,1,0
76579,4,2,268295,268295,268297,0,2,3
76580,3,3,268298,268298,268301,0,3,1
76581,6,2,268304,268304,268306,0,2,3
76582,6,3,268310,268310,268313,0,3,4
76583,2,1,268312,268313,268314,1,2,0
76584,5,3,268317,268317,268320,0,3,3
76585,4,1,268321,268321,268322,0,1,1
76586,1,1,268322,268322,268323,0,1,0
76587,2,1,268324,268324,268325,0,1,1
76588,1,3,268325,268325,268328,0,3,0
76589,3,1,268328,268328,268329,0,1,0
76590,5,2,268333,268333,268335,0,2,4
76591,1,2,268334,268335,268337,1,3,0
76592,2,2,268336,268337,268339,1,3,0
76593,2,2,268338,268339,268341,1,3,0
76594,5,2,268343,268343,268345,0,2,2
76595,5,2,268348,268348,268350,0,2,3
76596,2,1,268350,268350,268351,0,1,0
76597,1,2,268351,268351,268353,0,2,0
76598,4,1,268355,268355,268356,0,1,2
76599,3,3,268358,268358,268361,0,3,2
76600,4,1,268362,268362,268363,0,1,1
76601,2,2,268364,268364,268366,0,2,1
76602,3,2,268367,268367,268369,0,2,1
76603,5,1,268372,268372,268373,0,1,3
76604,6,2,268378,268378,268380,0,2,5
76605,5,1,268383,268383,268384,0,1,3
76606,5,3,268388,268388,268391,0,3,4
76607,4,1,268392,268392,268393,0,1,1
76608,4,3,268396,268396,268399,0,3,3
76609,4,2,268400,268400,268402,0,2,1
76610,6,1,268406,268406,268407,0,1,4
76611,6,2,268412,268412,268414,0,2,5
76612,6,2,268418,268418,268420,0,2,4
76613,6,2,268424,268424,268426,0,2,4
76614,1,1,268425,268426,268427,1,2,0
76615,3,1,268428,268428,268429,0,1,1
76616,1,1,268429,268429,268430,0,1,0
76617,1,1,268430,268430,268431,0,1,0
76618,4,1,268434,268434,268435,0,1,3
76619,5,2,268439,268439,268441,0,2,4
76620,6,1,268445,268445,268446,0,1,4
76621,4,1,268449,268449,268450,0,1,3
76622,3,2,268452,268452,268454,0,2,2
76623,3,3,268455,268455,268458,0,3,1
76624,5,1,268460,268460,268461,0,1,2
76625,1,1,268461,268461,268462,0,1,0
76626,4,1,268465,268465,268466,0,1,3
76627,3,2,268468,268468,268470,0,2,2
76628,2,3,268470,268470,268473,0,3,0
76629,3,3,268473,268473,268476,0,3,0
76630,3,3,268476,268476,268479,0,3,0
76631,5,2,268481,268481,268483,0,2,2
76632,6,2,268487,268487,268489,0,2,4
76633,1,1,268488,268489,268490,1,2,0
76634,6,2,268494,268494,268496,0,2,4
76635,6,3,268500,268500,268503,0,3,4
76636,3,3,268503,268503,268506,0,3,0
76637,4,3,268507,268507,268510,0,3,1
76638,4,3,268511,268511,268514,0,3,1
76639,6,1,268517,268517,268518,0,1,3
76640,1,2,268518,268518,268520,0,2,0
76641,4,3,268522,268522,268525,0,3,2
76642,1,2,268523,268525,268527,2,4,0
76643,5,2,268528,268528,268530,0,2,1
76644,4,2,268532,268532,268534,0,2,2
76645,2,3,268534,268534,268537,0,3,0
76646,2,2,268536,268537,268539,1,3,0
76647,5,3,268541,268541,268544,0,3,2
76648,3,1,268544,268544,268545,0,1,0
76649,5,2,268549,268549,268551,0,2,4
76650,4,1,268553,268553,268554,0,1,2
76651,5,1,268558,268558,268559,0,1,4
76652,2,2,268560,268560,268562,0,2,1
76653,1,2,268561,268562,268564,1,3,0
76654,1,2,268562,268564,268566,2,4,0
76655,2,2,268564,268566,268568,2,4,0
76656,1,3,268565,268568,268571,3,6,0
76657,2,3,268567,268571,268574,4,7,0
76658,6,1,268573,268574,268575,1,2,0
76659,2,2,268575,268575,268577,0,2,0
76660,4,3,268579,268579,268582,0,3,2
76661,6,3,268585,268585,268588,0,3,3
76662,4,2,268589,268589,268591,0,2,1
76663,5,3,268594,268594,268597,0,3,3
76664,6,3,268600,268600,268603,0,3,3
76665,4,1,268604,268604,268605,0,1,1
76666,2,3,268606,268606,268609,0,3,1
76667,4,3,268610,268610,268613,0,3,1
76668,3,1,268613,268613,268614,0,1,0
76669,6,3,268619,268619,268622,0,3,5
76670,3,1,268622,268622,268623,0,1,0
76671,4,3,268626,268626,268629,0,3,3
76672,6,3,268632,268632,268635,0,3,3
76673,2,2,268634,268635,268637,1,3,0
76674,4,2,268638,268638,268640,0,2,1
76675,6,1,268644,268644,268645,0,1,4
76676,4,2,268648,268648,268650,0,2,3
76677,4,2,268652,268652,268654,0,2,2
76678,2,3,268654,268654,268657,0,3,0
76679,3,3,268657,268657,268660,0,3,0
76680,2,1,268659,268660,268661,1,2,0
76681,5,1,268664,268664,268665,0,1,3
76682,5,2,268669,268669,268671,0,2,4
76683,5,1,268674,268674,268675,0,1,3
76684,2,2,268676,268676,268678,0,2,1
76685,6,1,268682,268682,268683,0,1,4
76686,6,2,268688,268688,268690,0,2,5
76687,1,3,268689,268690,268693,1,4,0
76688,2,3,268691,268693,268696,2,5,0
76689,5,2,268696,268696,268698,0,2,0
76690,2,2,268698,268698,268700,0,2,0
76691,4,3,268702,268702,268705,0,3,2
76692,6,2,268708,268708,268710,0,2,3
76693,2,3,268710,268710,268713,0,3,0
76694,5,3,268715,268715,268718,0,3,2
76695,6,3,268721,268721,268724,0,3,3
76696,1,1,268722,268724,268725,2,3,0
76697,1,1,268723,268725,268726,2,3,0
76698,3,2,268726,268726,268728,0,2,0
76699,5,3,268731,268731,268734,0,3,3
76700,3,3,268734,268734,268737,0,3,0
76701,4,2,268738,268738,268740,0,2,1
76702,2,2,268740,268740,268742,0,2,0
76703,1,2,268741,268742,268744,1,3,0
76704,4,1,268745,268745,268746,0,1,1
76705,1,1,268746,268746,268747,0,1,0
76706,1,3,268747,268747,268750,0,3,0
76707,3,3,268750,268750,268753,0,3,0
76708,4,3,268754,268754,268757,0,3,1
76709,4,2,268758,268758,268760,0,2,1
76710,3,1,268761,268761,268762,0,1,1
76711,1,3,268762,268762,268765,0,3,0
76712,4,1,268766,268766,268767,0,1,1
76713,5,3,268771,268771,268774,0,3,4
76714,5,1,268776,268776,268777,0,1,2
76715,1,1,268777,268777,268778,0,1,0
76716,1,3,268778,268778,268781,0,3,0
76717,1,2,268779,268781,268783,2,4,0
76718,3,2,268782,268783,268785,1,3,0
76719,3,3,268785,268785,268788,0,3,0
76720,6,2,268791,268791,268793,0,2,3
76721,1,1,268792,268793,268794,1,2,0
76722,5,3,268797,268797,268800,0,3,3
76723,2,3,268799,268800,268803,1,4,0
76724,3,2,268802,268803,268805,1,3,0
76725,4,2,268806,268806,268808,0,2,1
76726,2,2,268808,268808,268810,0,2,0
76727,1,1,268809,268810,268811,1,2,0
76728,2,1,268811,268811,268812,0,1,0
76729,4,3,268815,268815,268818,0,3,3
76730,3,1,268818,268818,268819,0,1,0
76731,1,1,268819,268819,268820,0,1,0
76732,5,2,268824,268824,268826,0,2,4
76733,1,3,268825,268826,268829,1,4,0
76734,2,1,268827,268829,268830,2,3,0
76735,5,3,268832,268832,268835,0,3,2
76736,4,1,268836,268836,268837,0,1,1
76737,5,1,268841,268841,268842,0,1,4
76738,4,2,268845,268845,268847,0,2,3
76739,6,2,268851,268851,268853,0,2,4
76740,3,2,268854,268854,268856,0,2,1
76741,4,3,268858,268858,268861,0,3,2
76742,2,2,268860,268861,268863,1,3,0
76743,5,2,268865,268865,268867,0,2,2
76744,3,3,268868,268868,268871,0,3,1
76745,6,2,268874,268874,268876,0,2,3
76746,4,1,268878,268878,268879,0,1,2
76747,5,1,268883,268883,268884,0,1,4
76748,5,3,268888,268888,268891,0,3,4
76749,1,1,268889,268891,268892,2,3,0
76750,1,1,268890,268892,268893,2,3,0
76751,4,1,268894,268894,268895,0,1,1
76752,5,2,268899,268899,268901,0,2,4
76753,6,1,268905,268905,268906,0,1,4
76754,6,3,268911,268911,268914,0,3,5
76755,1,1,268912,268914,268915,2,3,0
76756,6,1,268918,268918,268919,0,1,3
76757,6,1,268924,268924,268925,0,1,5
76758,1,1,268925,268925,268926,0,1,0
76759,1,3,268926,268926,268929,0,3,0
76760,6,2,268932,268932,268934,0,2,3
76761,4,1,268936,268936,268937,0,1,2
76762,3,1,268939,268939,268940,0,1,2
76763,1,2,268940,268940,268942,0,2,0
76764,6,1,268946,268946,268947,0,1,4
76765,6,1,268952,268952,268953,0,1,5
76766,2,3,268954,268954,268957,0,3,1
76767,4,1,268958,268958,268959,0,1,1
76768,6,2,268964,268964,268966,0,2,5
76769,1,2,268965,268966,268968,1,3,0
76770,3,1,268968,268968,268969,0,1,0
76771,5,1,268973,268973,268974,0,1,4
76772,1,3,268974,268974,268977,0,3,0
76773,1,3,268975,268977,268980,2,5,0
76774,3,1,268978,268980,268981,2,3,0
76775,5,3,268983,268983,268986,0,3,2
76776,6,3,268989,268989,268992,0,3,3
76777,1,3,268990,268992,268995,2,5,0
76778,4,2,268994,268995,268997,1,3,0
76779,3,2,268997,268997,268999,0,2,0
76780,1,2,268998,268999,269001,1,3,0
76781,6,2,269004,269004,269006,0,2,3
76782,4,3,269008,269008,269011,0,3,2
76783,2,3,269010,269011,269014,1,4,0
76784,4,1,269014,269014,269015,0,1,0
76785,4,3,269018,269018,269021,0,3,3
76786,5,3,269023,269023,269026,0,3,2
76787,6,3,269029,269029,269032,0,3,3
76788,4,2,269033,269033,269035,0,2,1
76789,4,3,269037,269037,269040,0,3,2
76790,5,1,269042,269042,269043,0,1,2
76791,3,2,269045,269045,269047,0,2,2
76792,2,1,269047,269047,269048,0,1,0
76793,5,3,269052,269052,269055,0,3,4
76794,6,2,269058,269058,269060,0,2,3
76795,3,1,269061,269061,269062,0,1,1
76796,3,3,269064,269064,269067,0,3,2
76797,2,1,269066,269067,269068,1,2,0
76798,5,1,269071,269071,269072,0,1,3
76799,1,2,269072,269072,269074,0,2,0
76800,6,1,269078,269078,269079,0,1,4
76801,1,2,269079,269079,269081,0,2,0
76802,5,1,269084,269084,269085,0,1,3
76803,6,3,269090,269090,269093,0,3,5
76804,5,1,269095,269095,269096,0,1,2
76805,1,3,269096,269096,269099,0,3,0
76806,1,3,269097,269099,269102,2,5,0
76807,4,3,269101,269102,269105,1,4,0
76808,2,2,269103,269105,269107,2,4,0
76809,2,2,269105,269107,269109,2,4,0
76810,3,1,269108,269109,269110,1,2,0
76811,1,2,269109,269110,269112,1,3,0
76812,3,1,269112,269112,269113,0,1,0
76813,6,2,269118,269118,269120,0,2,5
76814,4,1,269122,269122,269123,0,1,2
76815,6,1,269128,269128,269129,0,1,5
76816,4,1,269132,269132,269133,0,1,3
76817,2,3,269134,269134,269137,0,3,1
76818,4,1,269138,269138,269139,0,1,1
76819,3,1,269141,269141,269142,0,1,2
76820,6,3,269147,269147,269150,0,3,5
76821,2,3,269149,269150,269153,1,4,0
76822,2,2,269151,269153,269155,2,4,0
76823,1,1,269152,269155,269156,3,4,0
76824,6,3,269158,269158,269161,0,3,2
76825,4,1,269162,269162,269163,0,1,1
76826,2,3,269164,269164,269167,0,3,1
76827,5,1,269169,269169,269170,0,1,2
76828,6,2,269175,269175,269177,0,2,5
76829,4,3,269179,269179,269182,0,3,2
76830,5,3,269184,269184,269187,0,3,2
76831,6,1,269190,269190,269191,0,1,3
76832,1,1,269191,269191,269192,0,1,0
76833,4,1,269195,269195,269196,0,1,3
76834,6,2,269201,269201,269203,0,2,5
76835,6,3,269207,269207,269210,0,3,4
76836,1,1,269208,269210,269211,2,3,0
76837,1,3,269209,269211,269214,2,5,0
76838,4,1,269213,269214,269215,1,2,0
76839,4,2,269217,269217,269219,0,2,2
76840,1,2,269218,269219,269221,1,3,0
76841,4,3,269222,269222,269225,0,3,1
76842,3,3,269225,269225,269228,0,3,0
76843,4,2,269229,269229,269231,0,2,1
76844,2,1,269231,269231,269232,0,1,0
76845,2,1,269233,269233,269234,0,1,1
76846,5,2,269238,269238,269240,0,2,4
76847,1,1,269239,269240,269241,1,2,0
76848,2,2,269241,269241,269243,0,2,0
76849,1,1,269242,269243,269244,1,2,0
76850,2,2,269244,269244,269246,0,2,0
76851,2,2,269246,269246,269248,0,2,0
76852,1,1,269247,269248,269249,1,2,0
76853,6,2,269253,269253,269255,0,2,4
76854,3,3,269256,269256,269259,0,3,1
76855,3,1,269259,269259,269260,0,1,0
76856,5,3,269264,269264,269267,0,3,4
76857,6,3,269270,269270,269273,0,3,3
76858,2,1,269272,269273,269274,1,2,0
76859,4,2,269276,269276,269278,0,2,2
76860,3,3,269279,269279,269282,0,3,1
76861,6,1,269285,269285,269286,0,1,3
76862,5,2,269290,269290,269292,0,2,4
76863,4,1,269294,269294,269295,0,1,2
76864,4,3,269298,269298,269301,0,3,3
76865,2,1,269300,269301,269302,1,2,0
76866,5,2,269305,269305,269307,0,2,3
76867,5,3,269310,269310,269313,0,3,3
76868,2,3,269312,269313,269316,1,4,0
76869,4,3,269316,269316,269319,0,3,0
76870,4,2,269320,269320,269322,0,2,1
76871,6,3,269326,269326,269329,0,3,4
76872,1,3,269327,269329,269332,2,5,0
76873,1,2,269328,269332,269334,4,6,0
76874,1,2,269329,269334,269336,5,7,0
76875,5,3,269334,269336,269339,2,5,0
76876,1,1,269335,269339,269340,4,5,0
76877,1,1,269336,269340,269341,4,5,0
76878,6,1,269342,269342,269343,0,1,1
76879,6,3,269348,269348,269351,0,3,5
76880,3,3,269351,269351,269354,0,3,0
76881,5,3,269356,269356,269359,0,3,2
76882,1,3,269357,269359,269362,2,5,0
76883,5,1,269362,269362,269363,0,1,0
76884,2,1,269364,269364,269365,0,1,1
76885,6,2,269370,269370,269372,0,2,5
76886,1,3,269371,269372,269375,1,4,0
76887,1,2,269372,269375,269377,3,5,0
76888,3,2,269375,269377,269379,2,4,0
76889,3,3,269378,269379,269382,1,4,0
76890,5,3,269383,269383,269386,0,3,1
76891,2,2,269385,269386,269388,1,3,0
76892,6,1,269391,269391,269392,0,1,3
76893,1,2,269392,269392,269394,0,2,0
76894,6,3,269398,269398,269401,0,3,4
76895,1,3,269399,269401,269404,2,5,0
76896,3,2,269402,269404,269406,2,4,0
76897,5,3,269407,269407,269410,0,3,1
76898,6,3,269413,269413,269416,0,3,3
76899,3,3,269416,269416,269419,0,3,0
76900,6,3,269422,269422,269425,0,3,3
76901,1,2,269423,269425,269427,2,4,0
76902,5,3,269428,269428,269431,0,3,1
76903,3,3,269431,269431,269434,0,3,0
76904,2,1,269433,269434,269435,1,2,0
76905,2,2,269435,269435,269437,0,2,0
76906,5,3,269440,269440,269443,0,3,3
76907,6,3,269446,269446,269449,0,3,3
76908,4,3,269450,269450,269453,0,3,1
76909,4,3,269454,269454,269457,0,3,1
76910,6,3,269460,269460,269463,0,3,3
76911,1,3,269461,269463,269466,2,5,0
76912,3,2,269464,269466,269468,2,4,0
76913,4,2,269468,269468,269470,0,2,0
76914,2,1,269470,269470,269471,0,1,0
76915,4,2,269474,269474,269476,0,2,3
76916,6,3,269480,269480,269483,0,3,4
76917,6,2,269486,269486,269488,0,2,3
76918,3,2,269489,269489,269491,0,2,1
76919,4,1,269493,269493,269494,0,1,2
76920,3,2,269496,269496,269498,0,2,2
76921,3,3,269499,269499,269502,0,3,1
76922,5,1,269504,269504,269505,0,1,2
76923,1,2,269505,269505,269507,0,2,0
76924,6,3,269511,269511,269514,0,3,4
76925,3,3,269514,269514,269517,0,3,0
76926,5,3,269519,269519,269522,0,3,2
76927,1,2,269520,269522,269524,2,4,0
76928,1,1,269521,269524,269525,3,4,0
76929,5,1,269526,269526,269527,0,1,1
76930,1,2,269527,269527,269529,0,2,0
76931,1,1,269528,269529,269530,1,2,0
76932,6,2,269534,269534,269536,0,2,4
76933,3,1,269537,269537,269538,0,1,1
76934,6,2,269543,269543,269545,0,2,5
76935,5,3,269548,269548,269551,0,3,3
76936,3,3,269551,269551,269554,0,3,0
76937,4,2,269555,269555,269557,0,2,1
76938,2,2,269557,269557,269559,0,2,0
76939,1,2,269558,269559,269561,1,3,0
76940,6,2,269564,269564,269566,0,2,3
76941,4,2,269568,269568,269570,0,2,2
76942,3,3,269571,269571,269574,0,3,1
76943,2,3,269573,269574,269577,1,4,0
76944,3,2,269576,269577,269579,1,3,0
76945,2,1,269578,269579,269580,1,2,0
76946,2,3,269580,269580,269583,0,3,0
76947,5,1,269585,269585,269586,0,1,2
76948,2,2,269587,269587,269589,0,2,1
76949,2,3,269589,269589,269592,0,3,0
76950,4,3,269593,269593,269596,0,3,1
76951,4,2,269597,269597,269599,0,2,1
76952,1,2,269598,269599,269601,1,3,0
76953,1,3,269599,269601,269604,2,5,0
76954,1,1,269600,269604,269605,4,5,0
76955,1,1,269601,269605,269606,4,5,0
76956,2,3,269603,269606,269609,3,6,0
76957,5,3,269608,269609,269612,1,4,0
76958,3,1,269611,269612,269613,1,2,0
76959,5,3,269616,269616,269619,0,3,3
76960,3,2,269619,269619,269621,0,2,0
76961,3,3,269622,269622,269625,0,3,1
76962,5,2,269627,269627,269629,0,2,2
76963,6,2,269633,269633,269635,0,2,4
76964,1,1,269634,269635,269636,1,2,0
76965,4,1,269638,269638,269639,0,1,2
76966,6,3,269644,269644,269647,0,3,5
76967,6,3,269650,269650,269653,0,3,3
76968,1,2,269651,269653,269655,2,4,0
76969,2,2,269653,269655,269657,2,4,0
76970,3,3,269656,269657,269660,1,4,0
76971,6,2,269662,269662,269664,0,2,2
76972,1,1,269663,269664,269665,1,2,0
76973,5,1,269668,269668,269669,0,1,3
76974,3,2,269671,269671,269673,0,2,2
76975,1,2,269672,269673,269675,1,3,0
76976,5,1,269677,269677,269678,0,1,2
76977,3,2,269680,269680,269682,0,2,2
76978,6,3,269686,269686,269689,0,3,4
76979,4,1,269690,269690,269691,0,1,1
76980,4,2,269694,269694,269696,0,2,3
76981,6,1,269700,269700,269701,0,1,4
76982,6,1,269706,269706,269707,0,1,5
76983,4,1,269710,269710,269711,0,1,3
76984,2,2,269712,269712,269714,0,2,1
76985,5,1,269717,269717,269718,0,1,3
76986,3,2,269720,269720,269722,0,2,2
76987,6,2,269726,269726,269728,0,2,4
76988,3,1,269729,269729,269730,0,1,1
76989,6,1,269735,269735,269736,0,1,5
76990,5,1,269740,269740,269741,0,1,4
76991,6,1,269746,269746,269747,0,1,5
76992,1,1,269747,269747,269748,0,1,0
76993,5,2,269752,269752,269754,0,2,4
76994,3,1,269755,269755,269756,0,1,1
76995,2,1,269757,269757,269758,0,1,1
76996,1,1,269758,269758,269759,0,1,0
76997,2,2,269760,269760,269762,0,2,1
76998,3,2,269763,269763,269765,0,2,1
76999,6,2,269769,269769,269771,0,2,4
77000,1,2,269770,269771,269773,1,3,0
77001,2,1,269772,269773,269774,1,2,0
77002,3,1,269775,269775,269776,0,1,1
77003,5,2,269780,269780,269782,0,2,4
77004,6,3,269786,269786,269789,0,3,4
77005,6,3,269792,269792,269795,0,3,3
77006,2,2,269794,269795,269797,1,3,0
77007,4,2,269798,269798,269800,0,2,1
77008,3,2,269801,269801,269803,0,2,1
77009,6,2,269807,269807,269809,0,2,4
77010,2,2,269809,269809,269811,0,2,0
77011,3,2,269812,269812,269814,0,2,1
77012,2,1,269814,269814,269815,0,1,0
77013,6,3,269820,269820,269823,0,3,5
77014,3,3,269823,269823,269826,0,3,0
77015,2,1,269825,269826,269827,1,2,0
77016,5,1,269830,269830,269831,0,1,3
77017,3,2,269833,269833,269835,0,2,2
77018,5,3,269838,269838,269841,0,3,3
77019,4,1,269842,269842,269843,0,1,1
77020,5,3,269847,269847,269850,0,3,4
77021,2,1,269849,269850,269851,1,2,0
77022,5,3,269854,269854,269857,0,3,3
77023,2,1,269856,269857,269858,1,2,0
77024,4,1,269860,269860,269861,0,1,2
77025,1,3,269861,269861,269864,0,3,0
77026,5,2,269866,269866,269868,0,2,2
77027,6,3,269872,269872,269875,0,3,4
77028,2,1,269874,269875,269876,1,2,0
77029,5,2,269879,269879,269881,0,2,3
77030,2,1,269881,269881,269882,0,1,0
77031,1,2,269882,269882,269884,0,2,0
77032,4,3,269886,269886,269889,0,3,2
77033,4,1,269890,269890,269891,0,1,1
77034,5,1,269895,269895,269896,0,1,4
77035,5,2,269900,269900,269902,0,2,4
77036,4,1,269904,269904,269905,0,1,2
77037,4,3,269908,269908,269911,0,3,3
77038,6,2,269914,269914,269916,0,2,3
77039,6,1,269920,269920,269921,0,1,4
77040,2,3,269922,269922,269925,0,3,1
77041,3,1,269925,269925,269926,0,1,0
77042,1,1,269926,269926,269927,0,1,0
77043,3,3,269929,269929,269932,0,3,2
77044,5,3,269934,269934,269937,0,3,2
77045,6,1,269940,269940,269941,0,1,3
77046,3,3,269943,269943,269946,0,3,2
77047,2,1,269945,269946,269947,1,2,0
77048,1,1,269946,269947,269948,1,2,0
77049,4,3,269950,269950,269953,0,3,2
77050,2,2,269952,269953,269955,1,3,0
77051,3,1,269955,269955,269956,0,1,0
77052,3,1,269958,269958,269959,0,1,2
77053,6,2,269964,269964,269966,0,2,5
77054,1,3,269965,269966,269969,1,4,0
77055,2,3,269967,269969,269972,2,5,0
77056,1,3,269968,269972,269975,4,7,0
77057,5,2,269973,269975,269977,2,4,0
77058,1,1,269974,269977,269978,3,4,0
77059,5,2,269979,269979,269981,0,2,1
77060,3,1,269982,269982,269983,0,1,1
77061,2,1,269984,269984,269985,0,1,1
77062,6,3,269990,269990,269993,0,3,5
77063,6,2,269996,269996,269998,0,2,3
77064,3,2,269999,269999,270001,0,2,1
77065,6,1,270005,270005,270006,0,1,4
77066,6,3,270011,270011,270014,0,3,5
77067,5,1,270016,270016,270017,0,1,2
77068,1,2,270017,270017,270019,0,2,0
77069,6,3,270023,270023,270026,0,3,4
77070,2,1,270025,270026,270027,1,2,0
77071,1,1,270026,270027,270028,1,2,0
77072,4,2,270030,270030,270032,0,2,2
77073,5,2,270035,270035,270037,0,2,3
77074,2,1,270037,270037,270038,0,1,0
77075,2,1,270039,270039,270040,0,1,1
77076,1,2,270040,270040,270042,0,2,0
77077,1,3,270041,270042,270045,1,4,0
77078,2,3,270043,270045,270048,2,5,0
77079,1,2,270044,270048,270050,4,6,0
77080,5,1,270049,270050,270051,1,2,0
77081,4,3,270053,270053,270056,0,3,2
77082,6,2,270059,270059,270061,0,2,3
77083,5,3,270064,270064,270067,0,3,3
77084,5,1,270069,270069,270070,0,1,2
77085,1,2,270070,270070,270072,0,2,0
77086,1,2,270071,270072,270074,1,3,0
77087,2,3,270073,270074,270077,1,4,0
77088,6,1,270079,270079,270080,0,1,2
77089,2,2,270081,270081,270083,0,2,1
77090,5,3,270086,270086,270089,0,3,3
77091,1,2,270087,270089,270091,2,4,0
77092,1,2,270088,270091,270093,3,5,0
77093,4,1,270092,270093,270094,1,2,0
77094,1,2,270093,270094,270096,1,3,0
77095,3,1,270096,270096,270097,0,1,0
77096,3,2,270099,270099,270101,0,2,2
77097,2,2,270101,270101,270103,0,2,0
77098,3,3,270104,270104,270107,0,3,1
77099,1,1,270105,270107,270108,2,3,0
77100,4,1,270109,270109,270110,0,1,1
77101,4,3,270113,270113,270116,0,3,3
77102,3,1,270116,270116,270117,0,1,0
77103,3,3,270119,270119,270122,0,3,2
77104,5,3,270124,270124,270127,0,3,2
77105,2,3,270126,270127,270130,1,4,0
77106,2,3,270128,270130,270133,2,5,0
77107,3,1,270131,270133,270134,2,3,0
77108,5,3,270136,270136,270139,0,3,2
77109,3,1,270139,270139,270140,0,1,0
77110,1,2,270140,270140,270142,0,2,0
77111,2,3,270142,270142,270145,0,3,0
77112,3,3,270145,270145,270148,0,3,0
77113,3,2,270148,270148,270150,0,2,0
77114,2,2,270150,270150,270152,0,2,0
77115,4,1,270154,270154,270155,0,1,2
77116,6,1,270160,270160,270161,0,1,5
77117,1,3,270161,270161,270164,0,3,0
77118,5,1,270166,270166,270167,0,1,2
77119,5,3,270171,270171,270174,0,3,4
77120,3,3,270174,270174,270177,0,3,0
77121,6,2,270180,270180,270182,0,2,3
77122,6,1,270186,270186,270187,0,1,4
77123,4,2,270190,270190,270192,0,2,3
77124,2,2,270192,270192,270194,0,2,0
77125,5,2,270197,270197,270199,0,2,3
77126,5,3,270202,270202,270205,0,3,3
77127,2,1,270204,270205,270206,1,2,0
77128,5,3,270209,270209,270212,0,3,3
77129,6,1,270215,270215,270216,0,1,3
77130,3,3,270218,270218,270221,0,3,2
77131,4,2,270222,270222,270224,0,2,1
77132,3,2,270225,270225,270227,0,2,1
77133,3,1,270228,270228,270229,0,1,1
77134,4,2,270232,270232,270234,0,2,3
77135,2,3,270234,270234,270237,0,3,0
77136,1,1,270235,270237,270238,2,3,0
77137,2,2,270237,270238,270240,1,3,0
77138,2,2,270239,270240,270242,1,3,0
77139,5,2,270244,270244,270246,0,2,2
77140,6,2,270250,270250,270252,0,2,4
77141,5,1,270255,270255,270256,0,1,3
77142,4,3,270259,270259,270262,0,3,3
77143,5,1,270264,270264,270265,0,1,2
77144,1,1,270265,270265,270266,0,1,0
77145,5,1,270270,270270,270271,0,1,4
77146,4,2,270274,270274,270276,0,2,3
77147,4,3,270278,270278,270281,0,3,2
77148,6,3,270284,270284,270287,0,3,3
77149,6,3,270290,270290,270293,0,3,3
77150,4,1,270294,270294,270295,0,1,1
77151,3,1,270297,270297,270298,0,1,2
77152,3,3,270300,270300,270303,0,3,2
77153,5,2,270305,270305,270307,0,2,2
77154,3,1,270308,270308,270309,0,1,1
77155,3,3,270311,270311,270314,0,3,2
77156,2,2,270313,270314,270316,1,3,0
77157,4,1,270317,270317,270318,0,1,1
77158,2,3,270319,270319,270322,0,3,1
77159,3,3,270322,270322,270325,0,3,0
77160,5,3,270327,270327,270330,0,3,2
77161,1,1,270328,270330,270331,2,3,0
77162,6,2,270334,270334,270336,0,2,3
77163,6,2,270340,270340,270342,0,2,4
77164,2,3,270342,270342,270345,0,3,0
77165,5,2,270347,270347,270349,0,2,2
77166,4,2,270351,270351,270353,0,2,2
77167,1,2,270352,270353,270355,1,3,0
77168,3,3,270355,270355,270358,0,3,0
77169,2,2,270357,270358,270360,1,3,0
77170,6,2,270363,270363,270365,0,2,3
77171,6,1,270369,270369,270370,0,1,4
77172,4,2,270373,270373,270375,0,2,3
77173,3,3,270376,270376,270379,0,3,1
77174,2,1,270378,270379,270380,1,2,0
77175,3,3,270381,270381,270384,0,3,1
77176,6,1,270387,270387,270388,0,1,3
77177,6,1,270393,270393,270394,0,1,5
77178,2,2,270395,270395,270397,0,2,1
77179,1,3,270396,270397,270400,1,4,0
77180,5,2,270401,270401,270403,0,2,1
77181,5,1,270406,270406,270407,0,1,3
77182,6,1,270412,270412,270413,0,1,5
77183,2,2,270414,270414,270416,0,2,1
77184,5,1,270419,270419,270420,0,1,3
77185,4,2,270423,270423,270425,0,2,3
77186,5,1,270428,270428,270429,0,1,3
77187,3,1,270431,270431,270432,0,1,2
77188,3,3,270434,270434,270437,0,3,2
77189,1,1,270435,270437,270438,2,3,0
77190,2,3,270437,270438,270441,1,4,0
77191,5,2,270442,270442,270444,0,2,1
77192,4,2,270446,270446,270448,0,2,2
77193,5,1,270451,270451,270452,0,1,3
77194,3,2,270454,270454,270456,0,2,2
77195,1,1,270455,270456,270457,1,2,0
77196,3,3,270458,270458,270461,0,3,1
77197,1,3,270459,270461,270464,2,5,0
77198,3,2,270462,270464,270466,2,4,0
77199,5,2,270467,270467,270469,0,2,1
77200,4,2,270471,270471,270473,0,2,2
77201,3,2,270474,270474,270476,0,2,1
77202,4,3,270478,270478,270481,0,3,2
77203,4,3,270482,270482,270485,0,3,1
77204,5,1,270487,270487,270488,0,1,2
77205,2,3,270489,270489,270492,0,3,1
77206,2,3,270491,270492,270495,1,4,0
77207,1,2,270492,270495,270497,3,5,0
77208,2,3,270494,270497,270500,3,6,0
77209,1,3,270495,270500,270503,5,8,0
77210,5,3,270500,270503,270506,3,6,0
77211,6,2,270506,270506,270508,0,2,0
77212,2,3,270508,270508,270511,0,3,0
77213,3,3,270511,270511,270514,0,3,0
77214,3,1,270514,270514,270515,0,1,0
77215,4,3,270518,270518,270521,0,3,3
77216,4,2,270522,270522,270524,0,2,1
77217,5,3,270527,270527,270530,0,3,3
77218,3,2,270530,270530,270532,0,2,0
77219,6,2,270536,270536,270538,0,2,4
77220,1,3,270537,270538,270541,1,4,0
77221,5,3,270542,270542,270545,0,3,1
77222,3,1,270545,270545,270546,0,1,0
77223,5,2,270550,270550,270552,0,2,4
77224,6,3,270556,270556,270559,0,3,4
77225,3,3,270559,270559,270562,0,3,0
77226,3,2,270562,270562,270564,0,2,0
77227,3,2,270565,270565,270567,0,2,1
77228,5,3,270570,270570,270573,0,3,3
77229,3,2,270573,270573,270575,0,2,0
77230,6,3,270579,270579,270582,0,3,4
77231,5,2,270584,270584,270586,0,2,2
77232,3,1,270587,270587,270588,0,1,1
77233,2,3,270589,270589,270592,0,3,1
77234,6,1,270595,270595,270596,0,1,3
77235,5,3,270600,270600,270603,0,3,4
77236,1,3,270601,270603,270606,2,5,0
77237,3,1,270604,270606,270607,2,3,0
77238,5,3,270609,270609,270612,0,3,2
77239,3,3,270612,270612,270615,0,3,0
77240,1,3,270613,270615,270618,2,5,0
77241,6,3,270619,270619,270622,0,3,1
77242,1,3,270620,270622,270625,2,5,0
77243,4,2,270624,270625,270627,1,3,0
77244,2,3,270626,270627,270630,1,4,0
77245,4,2,270630,270630,270632,0,2,0
77246,6,2,270636,270636,270638,0,2,4
77247,6,2,270642,270642,270644,0,2,4
77248,6,2,270648,270648,270650,0,2,4
77249,2,1,270650,270650,270651,0,1,0
77250,1,1,270651,270651,270652,0,1,0
77251,5,2,270656,270656,270658,0,2,4
77252,1,2,270657,270658,270660,1,3,0
77253,3,2,270660,270660,270662,0,2,0
77254,5,1,270665,270665,270666,0,1,3
77255,6,2,270671,270671,270673,0,2,5
77256,2,2,270673,270673,270675,0,2,0
77257,6,3,270679,270679,270682,0,3,4
77258,2,1,270681,270682,270683,1,2,0
77259,6,2,270687,270687,270689,0,2,4
77260,2,2,270689,270689,270691,0,2,0
77261,5,1,270694,270694,270695,0,1,3
77262,1,2,270695,270695,270697,0,2,0
77263,5,2,270700,270700,270702,0,2,3
77264,1,3,270701,270702,270705,1,4,0
77265,5,1,270706,270706,270707,0,1,1
77266,1,2,270707,270707,270709,0,2,0
77267,2,3,270709,270709,270712,0,3,0
77268,5,3,270714,270714,270717,0,3,2
77269,3,3,270717,270717,270720,0,3,0
77270,1,2,270718,270720,270722,2,4,0
77271,5,3,270723,270723,270726,0,3,1
77272,3,1,270726,270726,270727,0,1,0
77273,3,3,270729,270729,270732,0,3,2
77274,3,2,270732,270732,270734,0,2,0
77275,4,2,270736,270736,270738,0,2,2
77276,2,2,270738,270738,270740,0,2,0
77277,5,3,270743,270743,270746,0,3,3
77278,1,3,270744,270746,270749,2,5,0
77279,1,3,270745,270749,270752,4,7,0
77280,6,3,270751,270752,270755,1,4,0
77281,3,1,270754,270755,270756,1,2,0
77282,5,1,270759,270759,270760,0,1,3
77283,5,2,270764,270764,270766,0,2,4
77284,5,1,270769,270769,270770,0,1,3
77285,2,1,270771,270771,270772,0,1,1
77286,4,1,270775,270775,270776,0,1,3
77287,5,1,270780,270780,270781,0,1,4
77288,5,1,270785,270785,270786,0,1,4
77289,6,3,270791,270791,270794,0,3,5
77290,3,3,270794,270794,270797,0,3,0
77291,2,1,270796,270797,270798,1,2,0
77292,4,3,270800,270800,270803,0,3,2
77293,4,3,270804,270804,270807,0,3,1
77294,4,1,270808,270808,270809,0,1,1
77295,5,3,270813,270813,270816,0,3,4
77296,1,3,270814,270816,270819,2,5,0
77297,3,1,270817,270819,270820,2,3,0
77298,2,1,270819,270820,270821,1,2,0
77299,1,1,270820,270821,270822,1,2,0
77300,6,1,270826,270826,270827,0,1,4
77301,6,3,270832,270832,270835,0,3,5
77302,1,2,270833,270835,270837,2,4,0
77303,4,2,270837,270837,270839,0,2,0
77304,2,1,270839,270839,270840,0,1,0
77305,5,3,270844,270844,270847,0,3,4
77306,6,2,270850,270850,270852,0,2,3
77307,2,2,270852,270852,270854,0,2,0
77308,2,1,270854,270854,270855,0,1,0
77309,4,2,270858,270858,270860,0,2,3
77310,4,3,270862,270862,270865,0,3,2
77311,5,3,270867,270867,270870,0,3,2
77312,5,3,270872,270872,270875,0,3,2
77313,3,3,270875,270875,270878,0,3,0
77314,3,2,270878,270878,270880,0,2,0
77315,1,1,270879,270880,270881,1,2,0
77316,3,1,270882,270882,270883,0,1,1
77317,1,2,270883,270883,270885,0,2,0
77318,4,3,270887,270887,270890,0,3,2
77319,4,2,270891,270891,270893,0,2,1
77320,4,3,270895,270895,270898,0,3,2
77321,3,2,270898,270898,270900,0,2,0
77322,6,3,270904,270904,270907,0,3,4
77323,4,3,270908,270908,270911,0,3,1
77324,5,1,270913,270913,270914,0,1,2
77325,1,2,270914,270914,270916,0,2,0
77326,5,1,270919,270919,270920,0,1,3
77327,5,2,270924,270924,270926,0,2,4
77328,2,2,270926,270926,270928,0,2,0
77329,1,2,270927,270928,270930,1,3,0
77330,1,2,270928,270930,270932,2,4,0
77331,5,3,270933,270933,270936,0,3,1
77332,5,2,270938,270938,270940,0,2,2
77333,2,2,270940,270940,270942,0,2,0
77334,6,3,270946,270946,270949,0,3,4
77335,4,1,270950,270950,270951,0,1,1
77336,5,1,270955,270955,270956,0,1,4
77337,5,3,270960,270960,270963,0,3,4
77338,3,1,270963,270963,270964,0,1,0
77339,3,2,270966,270966,270968,0,2,2
77340,1,2,270967,270968,270970,1,3,0
77341,2,3,270969,270970,270973,1,4,0
77342,6,2,270975,270975,270977,0,2,2
77343,4,2,270979,270979,270981,0,2,2
77344,2,1,270981,270981,270982,0,1,0
77345,6,1,270987,270987,270988,0,1,5
77346,4,2,270991,270991,270993,0,2,3
77347,3,2,270994,270994,270996,0,2,1
77348,5,1,270999,270999,271000,0,1,3
77349,6,1,271005,271005,271006,0,1,5
77350,1,3,271006,271006,271009,0,3,0
77351,3,1,271009,271009,271010,0,1,0
77352,3,3,271012,271012,271015,0,3,2
77353,3,2,271015,271015,271017,0,2,0
77354,3,1,271018,271018,271019,0,1,1
77355,2,3,271020,271020,271023,0,3,1
77356,5,2,271025,271025,271027,0,2,2
77357,6,1,271031,271031,271032,0,1,4
77358,5,1,271036,271036,271037,0,1,4
77359,1,2,271037,271037,271039,0,2,0
77360,6,2,271043,271043,271045,0,2,4
77361,1,3,271044,271045,271048,1,4,0
77362,5,1,271049,271049,271050,0,1,1
77363,4,3,271053,271053,271056,0,3,3
77364,5,1,271058,271058,271059,0,1,2
77365,6,3,271064,271064,271067,0,3,5
77366,1,3,271065,271067,271070,2,5,0
77367,3,2,271068,271070,271072,2,4,0
77368,1,1,271069,271072,271073,3,4,0
77369,3,2,271072,271073,271075,1,3,0
77370,6,1,271078,271078,271079,0,1,3
77371,5,1,271083,271083,271084,0,1,4
77372,5,1,271088,271088,271089,0,1,4
77373,5,3,271093,271093,271096,0,3,4
77374,3,2,271096,271096,271098,0,2,0
77375,4,1,271100,271100,271101,0,1,2
77376,5,3,271105,271105,271108,0,3,4
77377,4,3,271109,271109,271112,0,3,1
77378,5,1,271114,271114,271115,0,1,2
77379,6,3,271120,271120,271123,0,3,5
77380,3,2,271123,271123,271125,0,2,0
77381,3,3,271126,271126,271129,0,3,1
77382,1,3,271127,271129,271132,2,5,0
77383,5,2,271132,271132,271134,0,2,0
77384,6,1,271138,271138,271139,0,1,4
77385,3,3,271141,271141,271144,0,3,2
77386,3,3,271144,271144,271147,0,3,0
77387,4,1,271148,271148,271149,0,1,1
77388,2,1,271150,271150,271151,0,1,1
77389,3,1,271153,271153,271154,0,1,2
77390,6,1,271159,271159,271160,0,1,5
77391,6,3,271165,271165,271168,0,3,5
77392,3,1,271168,271168,271169,0,1,0
77393,1,1,271169,271169,271170,0,1,0
77394,3,2,271172,271172,271174,0,2,2
77395,6,1,271178,271178,271179,0,1,4
77396,1,1,271179,271179,271180,0,1,0
77397,4,1,271183,271183,271184,0,1,3
77398,5,3,271188,271188,271191,0,3,4
77399,4,3,271192,271192,271195,0,3,1
77400,3,1,271195,271195,271196,0,1,0
77401,5,2,271200,271200,271202,0,2,4
77402,5,3,271205,271205,271208,0,3,3
77403,4,1,271209,271209,271210,0,1,1
77404,3,2,271212,271212,271214,0,2,2
77405,3,2,271215,271215,271217,0,2,1
77406,5,3,271220,271220,271223,0,3,3
77407,5,1,271225,271225,271226,0,1,2
77408,6,1,271231,271231,271232,0,1,5
77409,3,1,271234,271234,271235,0,1,2
77410,5,3,271239,271239,271242,0,3,4
77411,4,3,271243,271243,271246,0,3,1
77412,2,1,271245,271246,271247,1,2,0
77413,4,3,271249,271249,271252,0,3,2
77414,6,2,271255,271255,271257,0,2,3
77415,3,3,271258,271258,271261,0,3,1
77416,5,2,271263,271263,271265,0,2,2
77417,5,1,271268,271268,271269,0,1,3
77418,6,1,271274,271274,271275,0,1,5
77419,1,3,271275,271275,271278,0,3,0
77420,4,1,271279,271279,271280,0,1,1
77421,6,2,271285,271285,271287,0,2,5
77422,6,2,271291,271291,271293,0,2,4
77423,5,3,271296,271296,271299,0,3,3
77424,2,3,271298,271299,271302,1,4,0
77425,2,3,271300,271302,271305,2,5,0
77426,6,1,271306,271306,271307,0,1,1
77427,4,3,271310,271310,271313,0,3,3
77428,1,1,271311,271313,271314,2,3,0
77429,5,3,271316,271316,271319,0,3,2
77430,1,1,271317,271319,271320,2,3,0
77431,1,1,271318,271320,271321,2,3,0
77432,6,2,271324,271324,271326,0,2,3
77433,4,2,271328,271328,271330,0,2,2
77434,4,1,271332,271332,271333,0,1,2
77435,4,2,271336,271336,271338,0,2,3
77436,1,1,271337,271338,271339,1,2,0
77437,1,2,271338,271339,271341,1,3,0
77438,6,1,271344,271344,271345,0,1,3
77439,3,1,271347,271347,271348,0,1,2
77440,5,3,271352,271352,271355,0,3,4
77441,4,2,271356,271356,271358,0,2,1
77442,3,2,271359,271359,271361,0,2,1
77443,4,3,271363,271363,271366,0,3,2
77444,3,3,271366,271366,271369,0,3,0
77445,5,2,271371,271371,271373,0,2,2
77446,2,3,271373,271373,271376,0,3,0
77447,4,2,271377,271377,271379,0,2,1
77448,1,1,271378,271379,271380,1,2,0
77449,5,1,271383,271383,271384,0,1,3
77450,2,2,271385,271385,271387,0,2,1
77451,1,3,271386,271387,271390,1,4,0
77452,6,3,271392,271392,271395,0,3,2
77453,5,3,271397,271397,271400,0,3,2
77454,5,3,271402,271402,271405,0,3,2
77455,1,2,271403,271405,271407,2,4,0
77456,4,2,271407,271407,271409,0,2,0
77457,5,3,271412,271412,271415,0,3,3
77458,5,3,271417,271417,271420,0,3,2
77459,6,1,271423,271423,271424,0,1,3
77460,1,3,271424,271424,271427,0,3,0
77461,3,2,271427,271427,271429,0,2,0
77462,2,2,271429,271429,271431,0,2,0
77463,2,2,271431,271431,271433,0,2,0
77464,4,3,271435,271435,271438,0,3,2
77465,4,3,271439,271439,271442,0,3,1
77466,3,1,271442,271442,271443,0,1,0
77467,4,1,271446,271446,271447,0,1,3
77468,5,3,271451,271451,271454,0,3,4
77469,6,1,271457,271457,271458,0,1,3
77470,2,3,271459,271459,271462,0,3,1
77471,1,3,271460,271462,271465,2,5,0
77472,2,3,271462,271465,271468,3,6,0
77473,5,1,271467,271468,271469,1,2,0
77474,5,3,271472,271472,271475,0,3,3
77475,2,2,271474,271475,271477,1,3,0
77476,4,2,271478,271478,271480,0,2,1
77477,1,2,271479,271480,271482,1,3,0
77478,4,2,271483,271483,271485,0,2,1
77479,4,3,271487,271487,271490,0,3,2
77480,2,2,271489,271490,271492,1,3,0
77481,6,2,271495,271495,271497,0,2,3
77482,4,3,271499,271499,271502,0,3,2
77483,4,1,271503,271503,271504,0,1,1
77484,4,2,271507,271507,271509,0,2,3
77485,3,1,271510,271510,271511,0,1,1
77486,1,3,271511,271511,271514,0,3,0
77487,1,3,271512,271514,271517,2,5,0
77488,5,3,271517,271517,271520,0,3,0
77489,3,1,271520,271520,271521,0,1,0
77490,4,1,271524,271524,271525,0,1,3
77491,1,3,271525,271525,271528,0,3,0
77492,1,1,271526,271528,271529,2,3,0
77493,5,2,271531,271531,271533,0,2,2
77494,4,3,271535,271535,271538,0,3,2
77495,1,1,271536,271538,271539,2,3,0
77496,5,2,271541,271541,271543,0,2,2
77497,1,2,271542,271543,271545,1,3,0
77498,1,2,271543,271545,271547,2,4,0
77499,2,1,271545,271547,271548,2,3,0
77500,6,1,271551,271551,271552,0,1,3
77501,1,2,271552,271552,271554,0,2,0
77502,2,2,271554,271554,271556,0,2,0
77503,2,2,271556,271556,271558,0,2,0
77504,5,3,271561,271561,271564,0,3,3
77505,5,1,271566,271566,271567,0,1,2
77506,2,3,271568,271568,271571,0,3,1
77507,4,1,271572,271572,271573,0,1,1
77508,2,2,271574,271574,271576,0,2,1
77509,2,2,271576,271576,271578,0,2,0
77510,2,1,271578,271578,271579,0,1,0
77511,3,1,271581,271581,271582,0,1,2
77512,2,1,271583,271583,271584,0,1,1
77513,4,1,271587,271587,271588,0,1,3
77514,5,2,271592,271592,271594,0,2,4
77515,3,3,271595,271595,271598,0,3,1
77516,3,3,271598,271598,271601,0,3,0
77517,3,2,271601,271601,271603,0,2,0
77518,1,3,271602,271603,271606,1,4,0
77519,4,3,271606,271606,271609,0,3,0
77520,6,3,271612,271612,271615,0,3,3
77521,6,1,271618,271618,271619,0,1,3
77522,4,3,271622,271622,271625,0,3,3
77523,1,2,271623,271625,271627,2,4,0
77524,3,1,271626,271627,271628,1,2,0
77525,6,3,271632,271632,271635,0,3,4
77526,6,1,271638,271638,271639,0,1,3
77527,3,1,271641,271641,271642,0,1,2
77528,4,3,271645,271645,271648,0,3,3
77529,3,3,271648,271648,271651,0,3,0
77530,1,3,271649,271651,271654,2,5,0
77531,2,1,271651,271654,271655,3,4,0
77532,3,3,271654,271655,271658,1,4,0
77533,6,2,271660,271660,271662,0,2,2
77534,5,1,271665,271665,271666,0,1,3
77535,3,1,271668,271668,271669,0,1,2
77536,4,2,271672,271672,271674,0,2,3
77537,5,2,271677,271677,271679,0,2,3
77538,5,2,271682,271682,271684,0,2,3
77539,4,1,271686,271686,271687,0,1,2
77540,5,3,271691,271691,271694,0,3,4
77541,1,1,271692,271694,271695,2,3,0
77542,1,1,271693,271695,271696,2,3,0
77543,2,1,271695,271696,271697,1,2,0
77544,6,1,271701,271701,271702,0,1,4
77545,2,3,271703,271703,271706,0,3,1
77546,5,3,271708,271708,271711,0,3,2
77547,3,3,271711,271711,271714,0,3,0
77548,1,1,271712,271714,271715,2,3,0
77549,3,3,271715,271715,271718,0,3,0
77550,1,3,271716,271718,271721,2,5,0
77551,6,2,271722,271722,271724,0,2,1
77552,1,2,271723,271724,271726,1,3,0
77553,2,2,271725,271726,271728,1,3,0
77554,5,3,271730,271730,271733,0,3,2
77555,6,1,271736,271736,271737,0,1,3
77556,4,2,271740,271740,271742,0,2,3
77557,3,2,271743,271743,271745,0,2,1
77558,2,2,271745,271745,271747,0,2,0
77559,6,1,271751,271751,271752,0,1,4
77560,6,3,271757,271757,271760,0,3,5
77561,6,2,271763,271763,271765,0,2,3
77562,6,2,271769,271769,271771,0,2,4
77563,3,2,271772,271772,271774,0,2,1
77564,6,3,271778,271778,271781,0,3,4
77565,5,2,271783,271783,271785,0,2,2
77566,3,3,271786,271786,271789,0,3,1
77567,3,3,271789,271789,271792,0,3,0
77568,2,1,271791,271792,271793,1,2,0
77569,5,1,271796,271796,271797,0,1,3
77570,2,1,271798,271798,271799,0,1,1
77571,2,3,271800,271800,271803,0,3,1
77572,6,3,271806,271806,271809,0,3,3
77573,6,1,271812,271812,271813,0,1,3
77574,3,3,271815,271815,271818,0,3,2
77575,5,2,271820,271820,271822,0,2,2
77576,1,1,271821,271822,271823,1,2,0
77577,4,3,271825,271825,271828,0,3,2
77578,4,2,271829,271829,271831,0,2,1
77579,1,1,271830,271831,271832,1,2,0
77580,3,3,271833,271833,271836,0,3,1
77581,2,1,271835,271836,271837,1,2,0
77582,4,1,271839,271839,271840,0,1,2
77583,6,2,271845,271845,271847,0,2,5
77584,4,2,271849,271849,271851,0,2,2
77585,6,2,271855,271855,271857,0,2,4
77586,1,2,271856,271857,271859,1,3,0
77587,3,2,271859,271859,271861,0,2,0
77588,3,3,271862,271862,271865,0,3,1
77589,2,1,271864,271865,271866,1,2,0
77590,5,3,271869,271869,271872,0,3,3
77591,1,1,271870,271872,271873,2,3,0
77592,5,3,271875,271875,271878,0,3,2
77593,5,1,271880,271880,271881,0,1,2
77594,1,3,271881,271881,271884,0,3,0
77595,4,2,271885,271885,271887,0,2,1
77596,2,1,271887,271887,271888,0,1,0
77597,5,2,271892,271892,271894,0,2,4
77598,4,3,271896,271896,271899,0,3,2
77599,5,1,271901,271901,271902,0,1,2
77600,5,2,271906,271906,271908,0,2,4
77601,3,3,271909,271909,271912,0,3,1
77602,2,2,271911,271912,271914,1,3,0
77603,3,3,271914,271914,271917,0,3,0
77604,6,1,271920,271920,271921,0,1,3
77605,6,1,271926,271926,271927,0,1,5
77606,3,1,271929,271929,271930,0,1,2
77607,3,2,271932,271932,271934,0,2,2
77608,5,3,271937,271937,271940,0,3,3
77609,2,3,271939,271940,271943,1,4,0
77610,6,3,271945,271945,271948,0,3,2
77611,6,2,271951,271951,271953,0,2,3
77612,5,3,271956,271956,271959,0,3,3
77613,5,1,271961,271961,271962,0,1,2
77614,5,2,271966,271966,271968,0,2,4
77615,5,3,271971,271971,271974,0,3,3
77616,4,2,271975,271975,271977,0,2,1
77617,3,2,271978,271978,271980,0,2,1
77618,2,3,271980,271980,271983,0,3,0
77619,6,3,271986,271986,271989,0,3,3
77620,6,3,271992,271992,271995,0,3,3
77621,5,2,271997,271997,271999,0,2,2
77622,3,2,272000,272000,272002,0,2,1
77623,1,2,272001,272002,272004,1,3,0
77624,1,1,272002,272004,272005,2,3,0
77625,5,1,272007,272007,272008,0,1,2
77626,3,1,272010,272010,272011,0,1,2
77627,3,2,272013,272013,272015,0,2,2
77628,1,1,272014,272015,272016,1,2,0
77629,4,3,272018,272018,272021,0,3,2
77630,3,1,272021,272021,272022,0,1,0
77631,6,1,272027,272027,272028,0,1,5
77632,3,1,272030,272030,272031,0,1,2
77633,6,3,272036,272036,272039,0,3,5
77634,6,3,272042,272042,272045,0,3,3
77635,6,3,272048,272048,272051,0,3,3
77636,2,2,272050,272051,272053,1,3,0
77637,1,1,272051,272053,272054,2,3,0
77638,3,3,272054,272054,272057,0,3,0
77639,3,1,272057,272057,272058,0,1,0
77640,6,2,272063,272063,272065,0,2,5
77641,1,3,272064,272065,272068,1,4,0
77642,2,3,272066,272068,272071,2,5,0
77643,2,3,272068,272071,272074,3,6,0
77644,1,1,272069,272074,272075,5,6,0
77645,6,1,272075,272075,272076,0,1,0
77646,2,3,272077,272077,272080,0,3,1
77647,1,2,272078,272080,272082,2,4,0
77648,2,2,272080,272082,272084,2,4,0
77649,2,1,272082,272084,272085,2,3,0
77650,3,3,272085,272085,272088,0,3,0
77651,4,1,272089,272089,272090,0,1,1
77652,1,1,272090,272090,272091,0,1,0
77653,2,2,272092,272092,272094,0,2,1
77654,6,2,272098,272098,272100,0,2,4
77655,4,1,272102,272102,272103,0,1,2
77656,6,2,272108,272108,272110,0,2,5
77657,4,1,272112,272112,272113,0,1,2
77658,6,1,272118,272118,272119,0,1,5
77659,2,2,272120,272120,272122,0,2,1
77660,6,2,272126,272126,272128,0,2,4
77661,6,2,272132,272132,272134,0,2,4
77662,5,1,272137,272137,272138,0,1,3
77663,2,1,272139,272139,272140,0,1,1
77664,2,3,272141,272141,272144,0,3,1
77665,6,3,272147,272147,272150,0,3,3
77666,4,1,272151,272151,272152,0,1,1
77667,2,3,272153,272153,272156,0,3,1
77668,2,2,272155,272156,272158,1,3,0
77669,6,3,272161,272161,272164,0,3,3
77670,1,2,272162,272164,272166,2,4,0
77671,2,3,272164,272166,272169,2,5,0
77672,4,3,272168,272169,272172,1,4,0
77673,5,3,272173,272173,272176,0,3,1
77674,3,1,272176,272176,272177,0,1,0
77675,3,2,272179,272179,272181,0,2,2
77676,2,3,272181,272181,272184,0,3,0
77677,1,3,272182,272184,272187,2,5,0
77678,5,3,272187,272187,272190,0,3,0
77679,1,1,272188,272190,272191,2,3,0
77680,2,1,272190,272191,272192,1,2,0
77681,1,3,272191,272192,272195,1,4,0
77682,1,2,272192,272195,272197,3,5,0
77683,6,3,272198,272198,272201,0,3,1
77684,2,1,272200,272201,272202,1,2,0
77685,1,3,272201,272202,272205,1,4,0
77686,3,1,272204,272205,272206,1,2,0
77687,3,1,272207,272207,272208,0,1,1
77688,3,3,272210,272210,272213,0,3,2
77689,1,1,272211,272213,272214,2,3,0
77690,2,2,272213,272214,272216,1,3,0
77691,3,3,272216,272216,272219,0,3,0
77692,5,2,272221,272221,272223,0,2,2
77693,3,3,272224,272224,272227,0,3,1
77694,5,3,272229,272229,272232,0,3,2
77695,1,1,272230,272232,272233,2,3,0
77696,6,1,272236,272236,272237,0,1,3
77697,5,3,272241,272241,272244,0,3,4
77698,6,1,272247,272247,272248,0,1,3
77699,2,1,272249,272249,272250,0,1,1
77700,1,3,272250,272250,272253,0,3,0
77701,2,2,272252,272253,272255,1,3,0
77702,6,3,272258,272258,272261,0,3,3
77703,3,3,272261,272261,272264,0,3,0
77704,4,3,272265,272265,272268,0,3,1
77705,3,1,272268,272268,272269,0,1,0
77706,6,3,272274,272274,272277,0,3,5
77707,1,1,272275,272277,272278,2,3,0
77708,6,3,272281,272281,272284,0,3,3
77709,6,1,272287,272287,272288,0,1,3
77710,5,3,272292,272292,272295,0,3,4
77711,5,3,272297,272297,272300,0,3,2
77712,3,2,272300,272300,272302,0,2,0
77713,3,1,272303,272303,272304,0,1,1
77714,2,1,272305,272305,272306,0,1,1
77715,6,1,272311,272311,272312,0,1,5
77716,2,1,272313,272313,272314,0,1,1
77717,5,3,272318,272318,272321,0,3,4
77718,2,2,272320,272321,272323,1,3,0
77719,1,3,272321,272323,272326,2,5,0
77720,6,1,272327,272327,272328,0,1,1
77721,6,1,272333,272333,272334,0,1,5
77722,4,1,272337,272337,272338,0,1,3
77723,4,1,272341,272341,272342,0,1,3
77724,6,2,272347,272347,272349,0,2,5
77725,5,2,272352,272352,272354,0,2,3
77726,5,2,272357,272357,272359,0,2,3
77727,5,3,272362,272362,272365,0,3,3
77728,1,2,272363,272365,272367,2,4,0
77729,3,2,272366,272367,272369,1,3,0
77730,1,3,272367,272369,272372,2,5,0
77731,3,1,272370,272372,272373,2,3,0
77732,1,1,272371,272373,272374,2,3,0
77733,6,2,272377,272377,272379,0,2,3
77734,5,1,272382,272382,272383,0,1,3
77735,4,2,272386,272386,272388,0,2,3
77736,4,3,272390,272390,272393,0,3,2
77737,6,1,272396,272396,272397,0,1,3
77738,5,2,272401,272401,272403,0,2,4
77739,5,2,272406,272406,272408,0,2,3
77740,6,2,272412,272412,272414,0,2,4
77741,5,3,272417,272417,272420,0,3,3
77742,1,3,272418,272420,272423,2,5,0
77743,4,3,272422,272423,272426,1,4,0
77744,3,1,272425,272426,272427,1,2,0
77745,1,1,272426,272427,272428,1,2,0
77746,3,1,272429,272429,272430,0,1,1
77747,5,3,272434,272434,272437,0,3,4
77748,5,1,272439,272439,272440,0,1,2
77749,5,3,272444,272444,272447,0,3,4
77750,4,1,272448,272448,272449,0,1,1
77751,2,3,272450,272450,272453,0,3,1
77752,5,3,272455,272455,272458,0,3,2
77753,2,1,272457,272458,272459,1,2,0
77754,2,2,272459,272459,272461,0,2,0
77755,4,3,272463,272463,272466,0,3,2
77756,3,2,272466,272466,272468,0,2,0
77757,3,2,272469,272469,272471,0,2,1
77758,6,3,272475,272475,272478,0,3,4
77759,4,1,272479,272479,272480,0,1,1
77760,4,2,272483,272483,272485,0,2,3
77761,6,1,272489,272489,272490,0,1,4
77762,1,3,272490,272490,272493,0,3,0
77763,4,1,272494,272494,272495,0,1,1
77764,4,3,272498,272498,272501,0,3,3
77765,5,3,272503,272503,272506,0,3,2
77766,4,2,272507,272507,272509,0,2,1
77767,3,1,272510,272510,272511,0,1,1
77768,5,2,272515,272515,272517,0,2,4
77769,5,2,272520,272520,272522,0,2,3
77770,2,2,272522,272522,272524,0,2,0
77771,1,1,272523,272524,272525,1,2,0
77772,5,1,272528,272528,272529,0,1,3
77773,6,2,272534,272534,272536,0,2,5
77774,4,2,272538,272538,272540,0,2,2
77775,5,3,272543,272543,272546,0,3,3
77776,6,3,272549,272549,272552,0,3,3
77777,5,1,272554,272554,272555,0,1,2
77778,1,3,272555,272555,272558,0,3,0
77779,3,1,272558,272558,272559,0,1,0
77780,1,2,272559,272559,272561,0,2,0
77781,3,2,272562,272562,272564,0,2,1
77782,5,1,272567,272567,272568,0,1,3
77783,6,1,272573,272573,272574,0,1,5
77784,3,1,272576,272576,272577,0,1,2
77785,1,2,272577,272577,272579,0,2,0
77786,6,3,272583,272583,272586,0,3,4
77787,6,1,272589,272589,272590,0,1,3
77788,6,1,272595,272595,272596,0,1,5
77789,5,3,272600,272600,272603,0,3,4
77790,6,2,272606,272606,272608,0,2,3
77791,5,2,272611,272611,272613,0,2,3
77792,5,1,272616,272616,272617,0,1,3
77793,5,1,272621,272621,272622,0,1,4
77794,1,2,272622,272622,272624,0,2,0
77795,1,1,272623,272624,272625,1,2,0
77796,4,1,272627,272627,272628,0,1,2
77797,6,2,272633,272633,272635,0,2,5
77798,6,2,272639,272639,272641,0,2,4
77799,4,3,272643,272643,272646,0,3,2
77800,1,1,272644,272646,272647,2,3,0
77801,3,2,272647,272647,272649,0,2,0
77802,2,1,272649,272649,272650,0,1,0
77803,3,3,272652,272652,272655,0,3,2
77804,1,2,272653,272655,272657,2,4,0
77805,1,2,272654,272657,272659,3,5,0
77806,3,1,272657,272659,272660,2,3,0
77807,3,1,272660,272660,272661,0,1,0
77808,6,1,272666,272666,272667,0,1,5
77809,5,2,272671,272671,272673,0,2,4
77810,6,1,272677,272677,272678,0,1,4
77811,3,2,272680,272680,272682,0,2,2
77812,5,3,272685,272685,272688,0,3,3
77813,5,3,272690,272690,272693,0,3,2
77814,3,2,272693,272693,272695,0,2,0
77815,5,2,272698,272698,272700,0,2,3
77816,4,2,272702,272702,272704,0,2,2
77817,2,1,272704,272704,272705,0,1,0
77818,3,2,272707,272707,272709,0,2,2
77819,5,3,272712,272712,272715,0,3,3
77820,1,2,272713,272715,272717,2,4,0
77821,5,1,272718,272718,272719,0,1,1
77822,3,3,272721,272721,272724,0,3,2
77823,3,1,272724,272724,272725,0,1,0
77824,1,1,272725,272725,272726,0,1,0
77825,4,2,272729,272729,272731,0,2,3
77826,1,3,272730,272731,272734,1,4,0
77827,5,2,272735,272735,272737,0,2,1
77828,5,2,272740,272740,272742,0,2,3
77829,3,2,272743,272743,272745,0,2,1
77830,2,1,272745,272745,272746,0,1,0
77831,1,3,272746,272746,272749,0,3,0
77832,1,1,272747,272749,272750,2,3,0
77833,4,2,272751,272751,272753,0,2,1
77834,2,3,272753,272753,272756,0,3,0
77835,2,1,272755,272756,272757,1,2,0
77836,4,2,272759,272759,272761,0,2,2
77837,4,1,272763,272763,272764,0,1,2
77838,3,3,272766,272766,272769,0,3,2
77839,2,1,272768,272769,272770,1,2,0
77840,4,3,272772,272772,272775,0,3,2
77841,3,2,272775,272775,272777,0,2,0
77842,4,3,272779,272779,272782,0,3,2
77843,1,1,272780,272782,272783,2,3,0
77844,6,3,272786,272786,272789,0,3,3
77845,5,2,272791,272791,272793,0,2,2
77846,2,1,272793,272793,272794,0,1,0
77847,3,2,272796,272796,272798,0,2,2
77848,5,3,272801,272801,272804,0,3,3
77849,4,3,272805,272805,272808,0,3,1
77850,3,3,272808,272808,272811,0,3,0
77851,3,1,272811,272811,272812,0,1,0
77852,1,3,272812,272812,272815,0,3,0
77853,1,1,272813,272815,272816,2,3,0
77854,4,1,272817,272817,272818,0,1,1
77855,5,1,272822,272822,272823,0,1,4
77856,2,3,272824,272824,272827,0,3,1
77857,6,2,272830,272830,272832,0,2,3
77858,4,1,272834,272834,272835,0,1,2
77859,2,3,272836,272836,272839,0,3,1
77860,2,1,272838,272839,272840,1,2,0
77861,5,3,272843,272843,272846,0,3,3
77862,2,2,272845,272846,272848,1,3,0
77863,3,2,272848,272848,272850,0,2,0
77864,3,3,272851,272851,272854,0,3,1
77865,6,3,272857,272857,272860,0,3,3
77866,6,2,272863,272863,272865,0,2,3
77867,1,3,272864,272865,272868,1,4,0
77868,2,1,272866,272868,272869,2,3,0
77869,6,2,272872,272872,272874,0,2,3
77870,3,3,272875,272875,272878,0,3,1
77871,3,2,272878,272878,272880,0,2,0
77872,2,3,272880,272880,272883,0,3,0
77873,2,2,272882,272883,272885,1,3,0
77874,6,2,272888,272888,272890,0,2,3
77875,2,1,272890,272890,272891,0,1,0
77876,2,3,272892,272892,272895,0,3,1
77877,5,3,272897,272897,272900,0,3,2
77878,2,2,272899,272900,272902,1,3,0
77879,2,3,272901,272902,272905,1,4,0
77880,5,3,272906,272906,272909,0,3,1
77881,2,1,272908,272909,272910,1,2,0
77882,1,2,272909,272910,272912,1,3,0
77883,4,3,272913,272913,272916,0,3,1
77884,5,2,272918,272918,272920,0,2,2
77885,3,2,272921,272921,272923,0,2,1
77886,5,3,272926,272926,272929,0,3,3
77887,3,2,272929,272929,272931,0,2,0
77888,3,2,272932,272932,272934,0,2,1
77889,1,1,272933,272934,272935,1,2,0
77890,6,2,272939,272939,272941,0,2,4
77891,1,1,272940,272941,272942,1,2,0
77892,3,1,272943,272943,272944,0,1,1
77893,6,3,272949,272949,272952,0,3,5
77894,6,3,272955,272955,272958,0,3,3
77895,3,3,272958,272958,272961,0,3,0
77896,6,2,272964,272964,272966,0,2,3
77897,6,2,272970,272970,272972,0,2,4
77898,6,1,272976,272976,272977,0,1,4
77899,6,1,272982,272982,272983,0,1,5
77900,3,2,272985,272985,272987,0,2,2
77901,2,3,272987,272987,272990,0,3,0
77902,2,3,272989,272990,272993,1,4,0
77903,1,2,272990,272993,272995,3,5,0
77904,4,3,272994,272995,272998,1,4,0
77905,4,1,272998,272998,272999,0,1,0
77906,2,1,273000,273000,273001,0,1,1
77907,4,2,273004,273004,273006,0,2,3
77908,1,2,273005,273006,273008,1,3,0
77909,6,2,273011,273011,273013,0,2,3
77910,1,2,273012,273013,273015,1,3,0
77911,3,2,273015,273015,273017,0,2,0
77912,4,1,273019,273019,273020,0,1,2
77913,2,1,273021,273021,273022,0,1,1
77914,1,3,273022,273022,273025,0,3,0
77915,2,2,273024,273025,273027,1,3,0
77916,3,2,273027,273027,273029,0,2,0
77917,5,2,273032,273032,273034,0,2,3
77918,3,2,273035,273035,273037,0,2,1
77919,2,3,273037,273037,273040,0,3,0
77920,6,3,273043,273043,273046,0,3,3
77921,3,1,273046,273046,273047,0,1,0
77922,4,3,273050,273050,273053,0,3,3
77923,1,1,273051,273053,273054,2,3,0
77924,1,1,273052,273054,273055,2,3,0
77925,2,2,273054,273055,273057,1,3,0
77926,3,3,273057,273057,273060,0,3,0
77927,6,3,273063,273063,273066,0,3,3
77928,4,2,273067,273067,273069,0,2,1
77929,2,2,273069,273069,273071,0,2,0
77930,4,3,273073,273073,273076,0,3,2
77931,4,3,273077,273077,273080,0,3,1
77932,1,1,273078,273080,273081,2,3,0
77933,4,1,273082,273082,273083,0,1,1
77934,6,2,273088,273088,273090,0,2,5
77935,5,2,273093,273093,273095,0,2,3
77936,5,1,273098,273098,273099,0,1,3
77937,2,2,273100,273100,273102,0,2,1
77938,3,3,273103,273103,273106,0,3,1
77939,2,1,273105,273106,273107,1,2,0
77940,6,2,273111,273111,273113,0,2,4
77941,5,1,273116,273116,273117,0,1,3
77942,3,3,273119,273119,273122,0,3,2
77943,1,2,273120,273122,273124,2,4,0
77944,5,3,273125,273125,273128,0,3,1
77945,5,2,273130,273130,273132,0,2,2
77946,3,3,273133,273133,273136,0,3,1
77947,6,3,273139,273139,273142,0,3,3
77948,5,3,273144,273144,273147,0,3,2
77949,5,3,273149,273149,273152,0,3,2
77950,2,1,273151,273152,273153,1,2,0
77951,1,3,273152,273153,273156,1,4,0
77952,2,2,273154,273156,273158,2,4,0
77953,3,3,273157,273158,273161,1,4,0
77954,6,1,273163,273163,273164,0,1,2
77955,3,2,273166,273166,273168,0,2,2
77956,2,1,273168,273168,273169,0,1,0
77957,4,2,273172,273172,273174,0,2,3
77958,6,3,273178,273178,273181,0,3,4
77959,6,3,273184,273184,273187,0,3,3
77960,2,3,273186,273187,273190,1,4,0
77961,6,1,273192,273192,273193,0,1,2
77962,2,1,273194,273194,273195,0,1,1
77963,5,2,273199,273199,273201,0,2,4
77964,6,2,273205,273205,273207,0,2,4
77965,5,3,273210,273210,273213,0,3,3
77966,1,2,273211,273213,273215,2,4,0
77967,1,2,273212,273215,273217,3,5,0
77968,3,2,273215,273217,273219,2,4,0
77969,6,3,273221,273221,273224,0,3,2
77970,3,2,273224,273224,273226,0,2,0
77971,5,3,273229,273229,273232,0,3,3
77972,5,1,273234,273234,273235,0,1,2
77973,1,2,273235,273235,273237,0,2,0
77974,2,3,273237,273237,273240,0,3,0
77975,4,3,273241,273241,273244,0,3,1
77976,3,2,273244,273244,273246,0,2,0
77977,2,3,273246,273246,273249,0,3,0
77978,6,1,273252,273252,273253,0,1,3
77979,4,3,273256,273256,273259,0,3,3
77980,1,1,273257,273259,273260,2,3,0
77981,4,2,273261,273261,273263,0,2,1
77982,4,1,273265,273265,273266,0,1,2
77983,3,2,273268,273268,273270,0,2,2
77984,1,1,273269,273270,273271,1,2,0
77985,2,3,273271,273271,273274,0,3,0
77986,5,2,273276,273276,273278,0,2,2
77987,1,1,273277,273278,273279,1,2,0
77988,2,2,273279,273279,273281,0,2,0
77989,2,1,273281,273281,273282,0,1,0
77990,1,1,273282,273282,273283,0,1,0
77991,3,3,273285,273285,273288,0,3,2
77992,1,1,273286,273288,273289,2,3,0
77993,3,3,273289,273289,273292,0,3,0
77994,3,2,273292,273292,273294,0,2,0
77995,6,3,273298,273298,273301,0,3,4
77996,6,3,273304,273304,273307,0,3,3
77997,3,3,273307,273307,273310,0,3,0
77998,4,3,273311,273311,273314,0,3,1
77999,5,1,273316,273316,273317,0,1,2
78000,6,3,273322,273322,273325,0,3,5
78001,1,1,273323,273325,273326,2,3,0
78002,6,1,273329,273329,273330,0,1,3
78003,6,2,273335,273335,273337,0,2,5
78004,6,2,273341,273341,273343,0,2,4
78005,1,1,273342,273343,273344,1,2,0
78006,2,2,273344,273344,273346,0,2,0
78007,4,3,273348,273348,273351,0,3,2
78008,4,2,273352,273352,273354,0,2,1
78009,3,2,273355,273355,273357,0,2,1
78010,1,1,273356,273357,273358,1,2,0
78011,6,3,273362,273362,273365,0,3,4
78012,6,2,273368,273368,273370,0,2,3
78013,4,3,273372,273372,273375,0,3,2
78014,1,1,273373,273375,273376,2,3,0
78015,4,1,273377,273377,273378,0,1,1
78016,3,1,273380,273380,273381,0,1,2
78017,2,1,273382,273382,273383,0,1,1
78018,2,1,273384,273384,273385,0,1,1
78019,4,1,273388,273388,273389,0,1,3
78020,5,3,273393,273393,273396,0,3,4
78021,3,1,273396,273396,273397,0,1,0
78022,6,2,273402,273402,273404,0,2,5
78023,5,2,273407,273407,273409,0,2,3
78024,1,2,273408,273409,273411,1,3,0
78025,3,2,273411,273411,273413,0,2,0
78026,1,2,273412,273413,273415,1,3,0
78027,4,1,273416,273416,273417,0,1,1
78028,3,1,273419,273419,273420,0,1,2
78029,6,1,273425,273425,273426,0,1,5
78030,6,2,273431,273431,273433,0,2,5
78031,5,3,273436,273436,273439,0,3,3
78032,4,1,273440,273440,273441,0,1,1
78033,1,2,273441,273441,273443,0,2,0
78034,1,1,273442,273443,273444,1,2,0
78035,4,2,273446,273446,273448,0,2,2
78036,2,2,273448,273448,273450,0,2,0
78037,5,3,273453,273453,273456,0,3,3
78038,4,3,273457,273457,273460,0,3,1
78039,2,1,273459,273460,273461,1,2,0
78040,2,3,273461,273461,273464,0,3,0
78041,4,3,273465,273465,273468,0,3,1
78042,1,1,273466,273468,273469,2,3,0
78043,2,1,273468,273469,273470,1,2,0
78044,1,3,273469,273470,273473,1,4,0
78045,2,1,273471,273473,273474,2,3,0
78046,6,1,273477,273477,273478,0,1,3
78047,2,2,273479,273479,273481,0,2,1
78048,5,3,273484,273484,273487,0,3,3
78049,5,2,273489,273489,273491,0,2,2
78050,2,2,273491,273491,273493,0,2,0
78051,6,1,273497,273497,273498,0,1,4
78052,4,1,273501,273501,273502,0,1,3
78053,1,1,273502,273502,273503,0,1,0
78054,1,1,273503,273503,273504,0,1,0
78055,1,2,273504,273504,273506,0,2,0
78056,6,3,273510,273510,273513,0,3,4
78057,5,3,273515,273515,273518,0,3,2
78058,3,3,273518,273518,273521,0,3,0
78059,5,3,273523,273523,273526,0,3,2
78060,3,2,273526,273526,273528,0,2,0
78061,1,2,273527,273528,273530,1,3,0
78062,3,1,273530,273530,273531,0,1,0
78063,3,2,273533,273533,273535,0,2,2
78064,5,1,273538,273538,273539,0,1,3
78065,2,1,273540,273540,273541,0,1,1
78066,2,3,273542,273542,273545,0,3,1
78067,4,2,273546,273546,273548,0,2,1
78068,3,1,273549,273549,273550,0,1,1
78069,3,2,273552,273552,273554,0,2,2
78070,4,1,273556,273556,273557,0,1,2
78071,3,3,273559,273559,273562,0,3,2
78072,1,1,273560,273562,273563,2,3,0
78073,1,3,273561,273563,273566,2,5,0
78074,4,2,273565,273566,273568,1,3,0
78075,1,3,273566,273568,273571,2,5,0
78076,1,2,273567,273571,273573,4,6,0
78077,2,3,273569,273573,273576,4,7,0
78078,6,1,273575,273576,273577,1,2,0
78079,1,3,273576,273577,273580,1,4,0
78080,6,2,273582,273582,273584,0,2,2
78081,1,1,273583,273584,273585,1,2,0
78082,3,1,273586,273586,273587,0,1,1
78083,1,2,273587,273587,273589,0,2,0
78084,6,2,273593,273593,273595,0,2,4
78085,5,2,273598,273598,273600,0,2,3
78086,1,3,273599,273600,273603,1,4,0
78087,3,2,273602,273603,273605,1,3,0
78088,3,1,273605,273605,273606,0,1,0
78089,1,3,273606,273606,273609,0,3,0
78090,6,2,273612,273612,273614,0,2,3
78091,4,2,273616,273616,273618,0,2,2
78092,6,3,273622,273622,273625,0,3,4
78093,2,1,273624,273625,273626,1,2,0
78094,3,1,273627,273627,273628,0,1,1
78095,6,3,273633,273633,273636,0,3,5
78096,5,1,273638,273638,273639,0,1,2
78097,1,2,273639,273639,273641,0,2,0
78098,6,2,273645,273645,273647,0,2,4
78099,5,1,273650,273650,273651,0,1,3
78100,6,1,273656,273656,273657,0,1,5
78101,6,3,273662,273662,273665,0,3,5
78102,3,3,273665,273665,273668,0,3,0
78103,6,1,273671,273671,273672,0,1,3
78104,1,2,273672,273672,273674,0,2,0
78105,3,3,273675,273675,273678,0,3,1
78106,6,1,273681,273681,273682,0,1,3
78107,4,3,273685,273685,273688,0,3,3
78108,5,2,273690,273690,273692,0,2,2
78109,3,1,273693,273693,273694,0,1,1
78110,2,1,273695,273695,273696,0,1,1
78111,1,1,273696,273696,273697,0,1,0
78112,1,3,273697,273697,273700,0,3,0
78113,6,3,273703,273703,273706,0,3,3
78114,1,1,273704,273706,273707,2,3,0
78115,1,1,273705,273707,273708,2,3,0
78116,6,1,273711,273711,273712,0,1,3
78117,3,3,273714,273714,273717,0,3,2
78118,4,1,273718,273718,273719,0,1,1
78119,6,1,273724,273724,273725,0,1,5
78120,1,1,273725,273725,273726,0,1,0
78121,3,1,273728,273728,273729,0,1,2
78122,3,3,273731,273731,273734,0,3,2
78123,3,3,273734,273734,273737,0,3,0
78124,6,3,273740,273740,273743,0,3,3
78125,1,2,273741,273743,273745,2,4,0
78126,4,1,273745,273745,273746,0,1,0
78127,3,3,273748,273748,273751,0,3,2
78128,2,2,273750,273751,273753,1,3,0
78129,5,1,273755,273755,273756,0,1,2
78130,5,1,273760,273760,273761,0,1,4
78131,1,1,273761,273761,273762,0,1,0
78132,2,2,273763,273763,273765,0,2,1
78133,3,2,273766,273766,273768,0,2,1
78134,1,1,273767,273768,273769,1,2,0
78135,3,2,273770,273770,273772,0,2,1
78136,6,1,273776,273776,273777,0,1,4
78137,2,3,273778,273778,273781,0,3,1
78138,4,1,273782,273782,273783,0,1,1
78139,1,2,273783,273783,273785,0,2,0
78140,6,2,273789,273789,273791,0,2,4
78141,5,2,273794,273794,273796,0,2,3
78142,2,1,273796,273796,273797,0,1,0
78143,1,1,273797,273797,273798,0,1,0
78144,3,3,273800,273800,273803,0,3,2
78145,3,1,273803,273803,273804,0,1,0
78146,4,1,273807,273807,273808,0,1,3
78147,3,1,273810,273810,273811,0,1,2
78148,6,2,273816,273816,273818,0,2,5
78149,6,3,273822,273822,273825,0,3,4
78150,6,1,273828,273828,273829,0,1,3
78151,4,1,273832,273832,273833,0,1,3
78152,2,1,273834,273834,273835,0,1,1
78153,5,2,273839,273839,273841,0,2,4
78154,1,1,273840,273841,273842,1,2,0
78155,6,2,273846,273846,273848,0,2,4
78156,6,1,273852,273852,273853,0,1,4
78157,1,1,273853,273853,273854,0,1,0
78158,2,1,273855,273855,273856,0,1,1
78159,3,2,273858,273858,273860,0,2,2
78160,1,1,273859,273860,273861,1,2,0
78161,2,3,273861,273861,273864,0,3,0
78162,2,2,273863,273864,273866,1,3,0
78163,4,2,273867,273867,273869,0,2,1
78164,3,2,273870,273870,273872,0,2,1
78165,1,2,273871,273872,273874,1,3,0
78166,5,2,273876,273876,273878,0,2,2
78167,6,3,273882,273882,273885,0,3,4
78168,4,1,273886,273886,273887,0,1,1
78169,2,2,273888,273888,273890,0,2,1
78170,2,3,273890,273890,273893,0,3,0
78171,4,2,273894,273894,273896,0,2,1
78172,1,3,273895,273896,273899,1,4,0
78173,6,2,273901,273901,273903,0,2,2
78174,5,3,273906,273906,273909,0,3,3
78175,2,3,273908,273909,273912,1,4,0
78176,3,2,273911,273912,273914,1,3,0
78177,4,1,273915,273915,273916,0,1,1
78178,6,1,273921,273921,273922,0,1,5
78179,3,3,273924,273924,273927,0,3,2
78180,4,1,273928,273928,273929,0,1,1
78181,2,1,273930,273930,273931,0,1,1
78182,5,1,273935,273935,273936,0,1,4
78183,5,3,273940,273940,273943,0,3,4
78184,2,1,273942,273943,273944,1,2,0
78185,2,2,273944,273944,273946,0,2,0
78186,1,2,273945,273946,273948,1,3,0
78187,6,2,273951,273951,273953,0,2,3
78188,5,2,273956,273956,273958,0,2,3
78189,4,1,273960,273960,273961,0,1,2
78190,5,1,273965,273965,273966,0,1,4
78191,6,1,273971,273971,273972,0,1,5
78192,2,2,273973,273973,273975,0,2,1
78193,1,3,273974,273975,273978,1,4,0
78194,3,2,273977,273978,273980,1,3,0
78195,5,2,273982,273982,273984,0,2,2
78196,5,1,273987,273987,273988,0,1,3
78197,1,1,273988,273988,273989,0,1,0
78198,6,1,273994,273994,273995,0,1,5
78199,1,1,273995,273995,273996,0,1,0
78200,6,3,274001,274001,274004,0,3,5
78201,1,2,274002,274004,274006,2,4,0
78202,3,3,274005,274006,274009,1,4,0
78203,5,1,274010,274010,274011,0,1,1
78204,2,3,274012,274012,274015,0,3,1
78205,6,3,274018,274018,274021,0,3,3
78206,3,2,274021,274021,274023,0,2,0
78207,1,3,274022,274023,274026,1,4,0
78208,5,2,274027,274027,274029,0,2,1
78209,6,3,274033,274033,274036,0,3,4
78210,2,2,274035,274036,274038,1,3,0
78211,2,2,274037,274038,274040,1,3,0
78212,4,2,274041,274041,274043,0,2,1
78213,6,1,274047,274047,274048,0,1,4
78214,3,3,274050,274050,274053,0,3,2
78215,5,3,274055,274055,274058,0,3,2
78216,1,2,274056,274058,274060,2,4,0
78217,2,3,274058,274060,274063,2,5,0
78218,4,3,274062,274063,274066,1,4,0
78219,1,3,274063,274066,274069,3,6,0
78220,1,3,274064,274069,274072,5,8,0
78221,1,2,274065,274072,274074,7,9,0
78222,3,3,274068,274074,274077,6,9,0
78223,3,2,274071,274077,274079,6,8,0
78224,6,1,274077,274079,274080,2,3,0
78225,2,1,274079,274080,274081,1,2,0
78226,4,1,274083,274083,274084,0,1,2
78227,6,3,274089,274089,274092,0,3,5
78228,2,1,274091,274092,274093,1,2,0
78229,5,2,274096,274096,274098,0,2,3
78230,3,3,274099,274099,274102,0,3,1
78231,5,1,274104,274104,274105,0,1,2
78232,3,2,274107,274107,274109,0,2,2
78233,1,2,274108,274109,274111,1,3,0
78234,3,3,274111,274111,274114,0,3,0
78235,3,2,274114,274114,274116,0,2,0
78236,5,3,274119,274119,274122,0,3,3
78237,6,3,274125,274125,274128,0,3,3
78238,6,3,274131,274131,274134,0,3,3
78239,1,1,274132,274134,274135,2,3,0
78240,1,3,274133,274135,274138,2,5,0
78241,3,3,274136,274138,274141,2,5,0
78242,2,2,274138,274141,274143,3,5,0
78243,1,2,274139,274143,274145,4,6,0
78244,5,3,274144,274145,274148,1,4,0
78245,2,3,274146,274148,274151,2,5,0
78246,6,3,274152,274152,274155,0,3,1
78247,1,1,274153,274155,274156,2,3,0
78248,4,3,274157,274157,274160,0,3,1
78249,5,2,274162,274162,274164,0,2,2
78250,5,1,274167,274167,274168,0,1,3
78251,4,1,274171,274171,274172,0,1,3
78252,6,2,274177,274177,274179,0,2,5
78253,1,2,274178,274179,274181,1,3,0
78254,1,2,274179,274181,274183,2,4,0
78255,6,2,274185,274185,274187,0,2,2
78256,4,1,274189,274189,274190,0,1,2
78257,3,1,274192,274192,274193,0,1,2
78258,6,1,274198,274198,274199,0,1,5
78259,4,1,274202,274202,274203,0,1,3
78260,1,2,274203,274203,274205,0,2,0
78261,2,3,274205,274205,274208,0,3,0
78262,5,1,274210,274210,274211,0,1,2
78263,2,2,274212,274212,274214,0,2,1
78264,5,2,274217,274217,274219,0,2,3
78265,1,3,274218,274219,274222,1,4,0
78266,3,3,274221,274222,274225,1,4,0
78267,2,2,274223,274225,274227,2,4,0
78268,3,3,274226,274227,274230,1,4,0
78269,5,1,274231,274231,274232,0,1,1
78270,4,1,274235,274235,274236,0,1,3
78271,2,3,274237,274237,274240,0,3,1
78272,6,2,274243,274243,274245,0,2,3
78273,3,1,274246,274246,274247,0,1,1
78274,2,2,274248,274248,274250,0,2,1
78275,6,1,274254,274254,274255,0,1,4
78276,6,3,274260,274260,274263,0,3,5
78277,2,2,274262,274263,274265,1,3,0
78278,4,3,274266,274266,274269,0,3,1
78279,6,1,274272,274272,274273,0,1,3
78280,5,2,274277,274277,274279,0,2,4
78281,1,1,274278,274279,274280,1,2,0
78282,1,1,274279,274280,274281,1,2,0
78283,3,1,274282,274282,274283,0,1,1
78284,6,2,274288,274288,274290,0,2,5
78285,2,2,274290,274290,274292,0,2,0
78286,3,2,274293,274293,274295,0,2,1
78287,5,2,274298,274298,274300,0,2,3
78288,4,1,274302,274302,274303,0,1,2
78289,2,3,274304,274304,274307,0,3,1
78290,3,1,274307,274307,274308,0,1,0
78291,4,3,274311,274311,274314,0,3,3
78292,2,3,274313,274314,274317,1,4,0
78293,1,2,274314,274317,274319,3,5,0
78294,2,2,274316,274319,274321,3,5,0
78295,2,2,274318,274321,274323,3,5,0
78296,4,3,274322,274323,274326,1,4,0
78297,3,1,274325,274326,274327,1,2,0
78298,6,3,274331,274331,274334,0,3,4
78299,3,2,274334,274334,274336,0,2,0
78300,3,2,274337,274337,274339,0,2,1
78301,5,3,274342,274342,274345,0,3,3
78302,5,1,274347,274347,274348,0,1,2
78303,6,2,274353,274353,274355,0,2,5
78304,1,1,274354,274355,274356,1,2,0
78305,5,3,274359,274359,274362,0,3,3
78306,4,1,274363,274363,274364,0,1,1
78307,1,3,274364,274364,274367,0,3,0
78308,6,3,274370,274370,274373,0,3,3
78309,6,2,274376,274376,274378,0,2,3
78310,3,3,274379,274379,274382,0,3,1
78311,2,1,274381,274382,274383,1,2,0
78312,6,2,274387,274387,274389,0,2,4
78313,4,3,274391,274391,274394,0,3,2
78314,4,1,274395,274395,274396,0,1,1
78315,4,1,274399,274399,274400,0,1,3
78316,2,3,274401,274401,274404,0,3,1
78317,4,3,274405,274405,274408,0,3,1
78318,3,1,274408,274408,274409,0,1,0
78319,1,1,274409,274409,274410,0,1,0
78320,5,2,274414,274414,274416,0,2,4
78321,5,1,274419,274419,274420,0,1,3
78322,6,3,274425,274425,274428,0,3,5
78323,6,1,274431,274431,274432,0,1,3
78324,4,3,274435,274435,274438,0,3,3
78325,5,1,274440,274440,274441,0,1,2
78326,2,2,274442,274442,274444,0,2,1
78327,5,2,274447,274447,274449,0,2,3
78328,2,1,274449,274449,274450,0,1,0
78329,1,3,274450,274450,274453,0,3,0
78330,3,1,274453,274453,274454,0,1,0
78331,3,1,274456,274456,274457,0,1,2
78332,4,1,274460,274460,274461,0,1,3
78333,5,3,274465,274465,274468,0,3,4
78334,1,3,274466,274468,274471,2,5,0
78335,5,1,274471,274471,274472,0,1,0
78336,1,1,274472,274472,274473,0,1,0
78337,5,2,274477,274477,274479,0,2,4
78338,4,3,274481,274481,274484,0,3,2
78339,6,1,274487,274487,274488,0,1,3
78340,3,1,274490,274490,274491,0,1,2
78341,2,3,274492,274492,274495,0,3,1
78342,3,2,274495,274495,274497,0,2,0
78343,1,1,274496,274497,274498,1,2,0
78344,1,1,274497,274498,274499,1,2,0
78345,1,1,274498,274499,274500,1,2,0
78346,3,1,274501,274501,274502,0,1,1
78347,6,3,274507,274507,274510,0,3,5
78348,3,1,274510,274510,274511,0,1,0
78349,2,1,274512,274512,274513,0,1,1
78350,1,1,274513,274513,274514,0,1,0
78351,6,2,274519,274519,274521,0,2,5
78352,1,1,274520,274521,274522,1,2,0
78353,6,3,274526,274526,274529,0,3,4
78354,6,3,274532,274532,274535,0,3,3
78355,4,1,274536,274536,274537,0,1,1
78356,6,1,274542,274542,274543,0,1,5
78357,1,1,274543,274543,274544,0,1,0
78358,3,2,274546,274546,274548,0,2,2
78359,4,1,274550,274550,274551,0,1,2
78360,4,2,274554,274554,274556,0,2,3
78361,1,3,274555,274556,274559,1,4,0
78362,1,3,274556,274559,274562,3,6,0
78363,3,1,274559,274562,274563,3,4,0
78364,6,2,274565,274565,274567,0,2,2
78365,2,2,274567,274567,274569,0,2,0
78366,6,2,274573,274573,274575,0,2,4
78367,3,1,274576,274576,274577,0,1,1
78368,1,3,274577,274577,274580,0,3,0
78369,1,3,274578,274580,274583,2,5,0
78370,4,1,274582,274583,274584,1,2,0
78371,1,2,274583,274584,274586,1,3,0
78372,1,3,274584,274586,274589,2,5,0
78373,5,3,274589,274589,274592,0,3,0
78374,1,3,274590,274592,274595,2,5,0
78375,4,3,274594,274595,274598,1,4,0
78376,4,2,274598,274598,274600,0,2,0
78377,6,2,274604,274604,274606,0,2,4
78378,4,2,274608,274608,274610,0,2,2
78379,5,3,274613,274613,274616,0,3,3
78380,4,2,274617,274617,274619,0,2,1
78381,6,2,274623,274623,274625,0,2,4
78382,3,2,274626,274626,274628,0,2,1
78383,1,3,274627,274628,274631,1,4,0
78384,1,2,274628,274631,274633,3,5,0
78385,1,1,274629,274633,274634,4,5,0
78386,5,3,274634,274634,274637,0,3,0
78387,6,2,274640,274640,274642,0,2,3
78388,1,2,274641,274642,274644,1,3,0
78389,6,1,274647,274647,274648,0,1,3
78390,3,1,274650,274650,274651,0,1,2
78391,6,3,274656,274656,274659,0,3,5
78392,2,1,274658,274659,274660,1,2,0
78393,1,3,274659,274660,274663,1,4,0
78394,6,3,274665,274665,274668,0,3,2
78395,4,3,274669,274669,274672,0,3,1
78396,5,1,274674,274674,274675,0,1,2
78397,4,3,274678,274678,274681,0,3,3
78398,4,2,274682,274682,274684,0,2,1
78399,3,3,274685,274685,274688,0,3,1
78400,6,1,274691,274691,274692,0,1,3
78401,2,1,274693,274693,274694,0,1,1
78402,4,1,274697,274697,274698,0,1,3
78403,6,1,274703,274703,274704,0,1,5
78404,5,2,274708,274708,274710,0,2,4
78405,6,3,274714,274714,274717,0,3,4
78406,1,3,274715,274717,274720,2,5,0
78407,6,1,274721,274721,274722,0,1,1
78408,3,3,274724,274724,274727,0,3,2
78409,4,3,274728,274728,274731,0,3,1
78410,3,3,274731,274731,274734,0,3,0
78411,3,3,274734,274734,274737,0,3,0
78412,3,2,274737,274737,274739,0,2,0
78413,2,3,274739,274739,274742,0,3,0
78414,1,2,274740,274742,274744,2,4,0
78415,1,1,274741,274744,274745,3,4,0
78416,4,3,274745,274745,274748,0,3,0
78417,4,2,274749,274749,274751,0,2,1
78418,6,3,274755,274755,274758,0,3,4
78419,1,3,274756,274758,274761,2,5,0
78420,6,3,274762,274762,274765,0,3,1
78421,3,1,274765,274765,274766,0,1,0
78422,2,2,274767,274767,274769,0,2,1
78423,5,1,274772,274772,274773,0,1,3
78424,4,2,274776,274776,274778,0,2,3
78425,4,2,274780,274780,274782,0,2,2
78426,4,1,274784,274784,274785,0,1,2
78427,5,2,274789,274789,274791,0,2,4
78428,1,2,274790,274791,274793,1,3,0
78429,6,2,274796,274796,274798,0,2,3
78430,1,1,274797,274798,274799,1,2,0
78431,2,3,274799,274799,274802,0,3,0
78432,6,1,274805,274805,274806,0,1,3
78433,5,3,274810,274810,274813,0,3,4
78434,1,1,274811,274813,274814,2,3,0
78435,5,3,274816,274816,274819,0,3,2
78436,6,1,274822,274822,274823,0,1,3
78437,1,3,274823,274823,274826,0,3,0
78438,2,2,274825,274826,274828,1,3,0
78439,2,2,274827,274828,274830,1,3,0
78440,2,3,274829,274830,274833,1,4,0
78441,4,1,274833,274833,274834,0,1,0
78442,4,3,274837,274837,274840,0,3,3
78443,3,1,274840,274840,274841,0,1,0
78444,2,3,274842,274842,274845,0,3,1
78445,2,3,274844,274845,274848,1,4,0
78446,6,2,274850,274850,274852,0,2,2
78447,4,2,274854,274854,274856,0,2,2
78448,1,1,274855,274856,274857,1,2,0
78449,3,1,274858,274858,274859,0,1,1
78450,3,2,274861,274861,274863,0,2,2
78451,5,3,274866,274866,274869,0,3,3
78452,4,2,274870,274870,274872,0,2,1
78453,4,3,274874,274874,274877,0,3,2
78454,6,1,274880,274880,274881,0,1,3
78455,3,1,274883,274883,274884,0,1,2
78456,5,3,274888,274888,274891,0,3,4
78457,1,3,274889,274891,274894,2,5,0
78458,3,3,274892,274894,274897,2,5,0
78459,2,1,274894,274897,274898,3,4,0
78460,6,2,274900,274900,274902,0,2,2
78461,5,2,274905,274905,274907,0,2,3
78462,2,3,274907,274907,274910,0,3,0
78463,6,1,274913,274913,274914,0,1,3
78464,2,3,274915,274915,274918,0,3,1
78465,6,3,274921,274921,274924,0,3,3
78466,4,1,274925,274925,274926,0,1,1
78467,2,3,274927,274927,274930,0,3,1
78468,5,3,274932,274932,274935,0,3,2
78469,2,3,274934,274935,274938,1,4,0
78470,5,2,274939,274939,274941,0,2,1
78471,4,1,274943,274943,274944,0,1,2
78472,1,3,274944,274944,274947,0,3,0
78473,5,2,274949,274949,274951,0,2,2
78474,2,3,274951,274951,274954,0,3,0
78475,4,1,274955,274955,274956,0,1,1
78476,6,2,274961,274961,274963,0,2,5
78477,3,2,274964,274964,274966,0,2,1
78478,3,3,274967,274967,274970,0,3,1
78479,6,3,274973,274973,274976,0,3,3
78480,5,1,274978,274978,274979,0,1,2
78481,1,1,274979,274979,274980,0,1,0
78482,1,3,274980,274980,274983,0,3,0
78483,4,3,274984,274984,274987,0,3,1
78484,3,3,274987,274987,274990,0,3,0
78485,2,3,274989,274990,274993,1,4,0
78486,4,3,274993,274993,274996,0,3,0
78487,3,1,274996,274996,274997,0,1,0
78488,3,3,274999,274999,275002,0,3,2
78489,1,3,275000,275002,275005,2,5,0
78490,5,3,275005,275005,275008,0,3,0
78491,1,2,275006,275008,275010,2,4,0
78492,3,3,275009,275010,275013,1,4,0
78493,6,1,275015,275015,275016,0,1,2
78494,2,2,275017,275017,275019,0,2,1
78495,5,2,275022,275022,275024,0,2,3
78496,3,3,275025,275025,275028,0,3,1
78497,1,1,275026,275028,275029,2,3,0
78498,6,2,275032,275032,275034,0,2,3
78499,6,2,275038,275038,275040,0,2,4
78500,5,2,275043,275043,275045,0,2,3
78501,5,2,275048,275048,275050,0,2,3
78502,5,3,275053,275053,275056,0,3,3
78503,2,2,275055,275056,275058,1,3,0
78504,5,3,275060,275060,275063,0,3,2
78505,4,3,275064,275064,275067,0,3,1
78506,5,2,275069,275069,275071,0,2,2
78507,2,2,275071,275071,275073,0,2,0
78508,2,3,275073,275073,275076,0,3,0
78509,5,3,275078,275078,275081,0,3,2
78510,6,1,275084,275084,275085,0,1,3
78511,2,1,275086,275086,275087,0,1,1
78512,5,1,275091,275091,275092,0,1,4
78513,5,2,275096,275096,275098,0,2,4
78514,6,1,275102,275102,275103,0,1,4
78515,1,2,275103,275103,275105,0,2,0
78516,4,3,275107,275107,275110,0,3,2
78517,1,2,275108,275110,275112,2,4,0
78518,1,3,275109,275112,275115,3,6,0
78519,2,1,275111,275115,275116,4,5,0
78520,1,3,275112,275116,275119,4,7,0
78521,5,2,275117,275119,275121,2,4,0
78522,1,3,275118,275121,275124,3,6,0
78523,1,1,275119,275124,275125,5,6,0
78524,5,3,275124,275125,275128,1,4,0
78525,6,2,275130,275130,275132,0,2,2
78526,1,1,275131,275132,275133,1,2,0
78527,1,3,275132,275133,275136,1,4,0
78528,4,2,275136,275136,275138,0,2,0
78529,5,1,275141,275141,275142,0,1,3
78530,3,1,275144,275144,275145,0,1,2
78531,4,1,275148,275148,275149,0,1,3
78532,6,3,275154,275154,275157,0,3,5
78533,5,3,275159,275159,275162,0,3,2
78534,2,1,275161,275162,275163,1,2,0
78535,1,2,275162,275163,275165,1,3,0
78536,6,3,275168,275168,275171,0,3,3
78537,1,3,275169,275171,275174,2,5,0
78538,2,1,275171,275174,275175,3,4,0
78539,5,2,275176,275176,275178,0,2,1
78540,6,3,275182,275182,275185,0,3,4
78541,2,1,275184,275185,275186,1,2,0
78542,5,2,275189,275189,275191,0,2,3
78543,2,3,275191,275191,275194,0,3,0
78544,4,1,275195,275195,275196,0,1,1
78545,2,1,275197,275197,275198,0,1,1
78546,1,2,275198,275198,275200,0,2,0
78547,4,3,275202,275202,275205,0,3,2
78548,6,2,275208,275208,275210,0,2,3
78549,1,3,275209,275210,275213,1,4,0
78550,3,3,275212,275213,275216,1,4,0
78551,6,3,275218,275218,275221,0,3,2
78552,2,2,275220,275221,275223,1,3,0
78553,1,3,275221,275223,275226,2,5,0
78554,5,1,275226,275226,275227,0,1,0
78555,3,2,275229,275229,275231,0,2,2
78556,2,2,275231,275231,275233,0,2,0
78557,2,1,275233,275233,275234,0,1,0
78558,2,3,275235,275235,275238,0,3,1
78559,5,3,275240,275240,275243,0,3,2
78560,6,1,275246,275246,275247,0,1,3
78561,3,3,275249,275249,275252,0,3,2
78562,4,1,275253,275253,275254,0,1,1
78563,3,1,275256,275256,275257,0,1,2
78564,4,1,275260,275260,275261,0,1,3
78565,2,3,275262,275262,275265,0,3,1
78566,2,1,275264,275265,275266,1,2,0
78567,1,2,275265,275266,275268,1,3,0
78568,1,3,275266,275268,275271,2,5,0
78569,6,3,275272,275272,275275,0,3,1
78570,3,2,275275,275275,275277,0,2,0
78571,5,1,275280,275280,275281,0,1,3
78572,1,1,275281,275281,275282,0,1,0
78573,5,2,275286,275286,275288,0,2,4
78574,5,1,275291,275291,275292,0,1,3
78575,5,2,275296,275296,275298,0,2,4
78576,3,3,275299,275299,275302,0,3,1
78577,5,2,275304,275304,275306,0,2,2
78578,2,1,275306,275306,275307,0,1,0
78579,5,1,275311,275311,275312,0,1,4
78580,1,3,275312,275312,275315,0,3,0
78581,1,1,275313,275315,275316,2,3,0
78582,4,2,275317,275317,275319,0,2,1
78583,6,3,275323,275323,275326,0,3,4
78584,1,3,275324,275326,275329,2,5,0
78585,2,3,275326,275329,275332,3,6,0
78586,3,1,275329,275332,275333,3,4,0
78587,5,1,275334,275334,275335,0,1,1
78588,6,2,275340,275340,275342,0,2,5
78589,2,3,275342,275342,275345,0,3,0
78590,5,2,275347,275347,275349,0,2,2
78591,6,1,275353,275353,275354,0,1,4
78592,1,2,275354,275354,275356,0,2,0
78593,1,3,275355,275356,275359,1,4,0
78594,6,2,275361,275361,275363,0,2,2
78595,3,2,275364,275364,275366,0,2,1
78596,6,1,275370,275370,275371,0,1,4
78597,2,2,275372,275372,275374,0,2,1
78598,6,2,275378,275378,275380,0,2,4
78599,3,1,275381,275381,275382,0,1,1
78600,6,1,275387,275387,275388,0,1,5
78601,4,2,275391,275391,275393,0,2,3
78602,2,1,275393,275393,275394,0,1,0
78603,2,3,275395,275395,275398,0,3,1
78604,6,1,275401,275401,275402,0,1,3
78605,5,3,275406,275406,275409,0,3,4
78606,2,1,275408,275409,275410,1,2,0
78607,3,3,275411,275411,275414,0,3,1
78608,5,1,275416,275416,275417,0,1,2
78609,3,2,275419,275419,275421,0,2,2
78610,2,3,275421,275421,275424,0,3,0
78611,6,3,275427,275427,275430,0,3,3
78612,1,3,275428,275430,275433,2,5,0
78613,4,1,275432,275433,275434,1,2,0
78614,3,1,275435,275435,275436,0,1,1
78615,3,2,275438,275438,275440,0,2,2
78616,4,2,275442,275442,275444,0,2,2
78617,3,3,275445,275445,275448,0,3,1
78618,2,1,275447,275448,275449,1,2,0
78619,6,1,275453,275453,275454,0,1,4
78620,6,1,275459,275459,275460,0,1,5
78621,5,2,275464,275464,275466,0,2,4
78622,4,3,275468,275468,275471,0,3,2
78623,1,1,275469,275471,275472,2,3,0
78624,4,1,275473,275473,275474,0,1,1
78625,3,3,275476,275476,275479,0,3,2
78626,4,1,275480,275480,275481,0,1,1
78627,6,3,275486,275486,275489,0,3,5
78628,1,3,275487,275489,275492,2,5,0
78629,5,1,275492,275492,275493,0,1,0
78630,4,3,275496,275496,275499,0,3,3
78631,4,3,275500,275500,275503,0,3,1
78632,1,1,275501,275503,275504,2,3,0
78633,4,3,275505,275505,275508,0,3,1
78634,2,3,275507,275508,275511,1,4,0
78635,3,2,275510,275511,275513,1,3,0
78636,4,3,275514,275514,275517,0,3,1
78637,5,2,275519,275519,275521,0,2,2
78638,6,3,275525,275525,275528,0,3,4
78639,4,3,275529,275529,275532,0,3,1
78640,3,3,275532,275532,275535,0,3,0
78641,2,3,275534,275535,275538,1,4,0
78642,5,3,275539,275539,275542,0,3,1
78643,4,3,275543,275543,275546,0,3,1
78644,4,3,275547,275547,275550,0,3,1
78645,5,1,275552,275552,275553,0,1,2
78646,5,1,275557,275557,275558,0,1,4
78647,3,3,275560,275560,275563,0,3,2
78648,2,3,275562,275563,275566,1,4,0
78649,5,1,275567,275567,275568,0,1,1
78650,5,1,275572,275572,275573,0,1,4
78651,6,3,275578,275578,275581,0,3,5
78652,5,2,275583,275583,275585,0,2,2
78653,4,1,275587,275587,275588,0,1,2
78654,2,2,275589,275589,275591,0,2,1
78655,1,1,275590,275591,275592,1,2,0
78656,2,1,275592,275592,275593,0,1,0
78657,6,1,275598,275598,275599,0,1,5
78658,3,1,275601,275601,275602,0,1,2
78659,1,2,275602,275602,275604,0,2,0
78660,5,1,275607,275607,275608,0,1,3
78661,4,3,275611,275611,275614,0,3,3
78662,2,2,275613,275614,275616,1,3,0
78663,6,3,275619,275619,275622,0,3,3
78664,3,3,275622,275622,275625,0,3,0
78665,4,3,275626,275626,275629,0,3,1
78666,5,3,275631,275631,275634,0,3,2
78667,6,2,275637,275637,275639,0,2,3
78668,2,1,275639,275639,275640,0,1,0
78669,4,3,275643,275643,275646,0,3,3
78670,1,1,275644,275646,275647,2,3,0
78671,2,1,275646,275647,275648,1,2,0
78672,5,1,275651,275651,275652,0,1,3
78673,1,1,275652,275652,275653,0,1,0
78674,6,2,275658,275658,275660,0,2,5
78675,3,3,275661,275661,275664,0,3,1
78676,5,2,275666,275666,275668,0,2,2
78677,5,1,275671,275671,275672,0,1,3
78678,1,2,275672,275672,275674,0,2,0
78679,4,3,275676,275676,275679,0,3,2
78680,6,1,275682,275682,275683,0,1,3
78681,5,1,275687,275687,275688,0,1,4
78682,2,1,275689,275689,275690,0,1,1
78683,1,3,275690,275690,275693,0,3,0
78684,6,1,275696,275696,275697,0,1,3
78685,2,1,275698,275698,275699,0,1,1
78686,3,2,275701,275701,275703,0,2,2
78687,3,3,275704,275704,275707,0,3,1
78688,3,3,275707,275707,275710,0,3,0
78689,4,1,275711,275711,275712,0,1,1
78690,3,1,275714,275714,275715,0,1,2
78691,6,1,275720,275720,275721,0,1,5
78692,5,3,275725,275725,275728,0,3,4
78693,6,2,275731,275731,275733,0,2,3
78694,2,3,275733,275733,275736,0,3,0
78695,5,3,275738,275738,275741,0,3,2
78696,3,1,275741,275741,275742,0,1,0
78697,5,1,275746,275746,275747,0,1,4
78698,4,1,275750,275750,275751,0,1,3
78699,5,3,275755,275755,275758,0,3,4
78700,3,2,275758,275758,275760,0,2,0
78701,6,1,275764,275764,275765,0,1,4
78702,6,2,275770,275770,275772,0,2,5
78703,6,3,275776,275776,275779,0,3,4
78704,4,3,275780,275780,275783,0,3,1
78705,1,1,275781,275783,275784,2,3,0
78706,1,3,275782,275784,275787,2,5,0
78707,1,2,275783,275787,275789,4,6,0
78708,2,1,275785,275789,275790,4,5,0
78709,3,1,275788,275790,275791,2,3,0
78710,5,2,275793,275793,275795,0,2,2
78711,5,3,275798,275798,275801,0,3,3
78712,2,1,275800,275801,275802,1,2,0
78713,1,1,275801,275802,275803,1,2,0
78714,6,2,275807,275807,275809,0,2,4
78715,4,1,275811,275811,275812,0,1,2
78716,3,1,275814,275814,275815,0,1,2
78717,3,2,275817,275817,275819,0,2,2
78718,1,3,275818,275819,275822,1,4,0
78719,2,1,275820,275822,275823,2,3,0
78720,5,2,275825,275825,275827,0,2,2
78721,4,1,275829,275829,275830,0,1,2
78722,4,1,275833,275833,275834,0,1,3
78723,2,2,275835,275835,275837,0,2,1
78724,6,3,275841,275841,275844,0,3,4
78725,2,3,275843,275844,275847,1,4,0
78726,4,2,275847,275847,275849,0,2,0
78727,5,2,275852,275852,275854,0,2,3
78728,6,2,275858,275858,275860,0,2,4
78729,3,2,275861,275861,275863,0,2,1
78730,1,3,275862,275863,275866,1,4,0
78731,5,2,275867,275867,275869,0,2,1
78732,1,2,275868,275869,275871,1,3,0
78733,3,1,275871,275871,275872,0,1,0
78734,2,2,275873,275873,275875,0,2,1
78735,5,1,275878,275878,275879,0,1,3
78736,2,1,275880,275880,275881,0,1,1
78737,6,2,275886,275886,275888,0,2,5
78738,4,2,275890,275890,275892,0,2,2
78739,5,3,275895,275895,275898,0,3,3
78740,4,1,275899,275899,275900,0,1,1
78741,6,1,275905,275905,275906,0,1,5
78742,5,3,275910,275910,275913,0,3,4
78743,3,1,275913,275913,275914,0,1,0
78744,4,3,275917,275917,275920,0,3,3
78745,6,2,275923,275923,275925,0,2,3
78746,6,3,275929,275929,275932,0,3,4
78747,6,1,275935,275935,275936,0,1,3
78748,4,1,275939,275939,275940,0,1,3
78749,2,2,275941,275941,275943,0,2,1
78750,6,2,275947,275947,275949,0,2,4
78751,1,1,275948,275949,275950,1,2,0
78752,4,1,275952,275952,275953,0,1,2
78753,3,1,275955,275955,275956,0,1,2
78754,4,2,275959,275959,275961,0,2,3
78755,1,3,275960,275961,275964,1,4,0
78756,5,1,275965,275965,275966,0,1,1
78757,2,2,275967,275967,275969,0,2,1
78758,1,3,275968,275969,275972,1,4,0
78759,4,1,275972,275972,275973,0,1,0
78760,2,1,275974,275974,275975,0,1,1
78761,5,2,275979,275979,275981,0,2,4
78762,6,1,275985,275985,275986,0,1,4
78763,1,3,275986,275986,275989,0,3,0
78764,4,2,275990,275990,275992,0,2,1
78765,6,3,275996,275996,275999,0,3,4
78766,4,1,276000,276000,276001,0,1,1
78767,5,3,276005,276005,276008,0,3,4
78768,1,1,276006,276008,276009,2,3,0
78769,5,3,276011,276011,276014,0,3,2
78770,5,2,276016,276016,276018,0,2,2
78771,6,1,276022,276022,276023,0,1,4
78772,1,3,276023,276023,276026,0,3,0
78773,2,2,276025,276026,276028,1,3,0
78774,3,3,276028,276028,276031,0,3,0
78775,3,3,276031,276031,276034,0,3,0
78776,5,2,276036,276036,276038,0,2,2
78777,6,2,276042,276042,276044,0,2,4
78778,5,2,276047,276047,276049,0,2,3
78779,5,1,276052,276052,276053,0,1,3
78780,6,1,276058,276058,276059,0,1,5
78781,3,2,276061,276061,276063,0,2,2
78782,3,1,276064,276064,276065,0,1,1
78783,1,1,276065,276065,276066,0,1,0
78784,6,2,276071,276071,276073,0,2,5
78785,4,3,276075,276075,276078,0,3,2
78786,4,2,276079,276079,276081,0,2,1
78787,6,1,276085,276085,276086,0,1,4
78788,1,2,276086,276086,276088,0,2,0
78789,2,1,276088,276088,276089,0,1,0
78790,5,3,276093,276093,276096,0,3,4
78791,6,2,276099,276099,276101,0,2,3
78792,3,1,276102,276102,276103,0,1,1
78793,1,2,276103,276103,276105,0,2,0
78794,3,1,276106,276106,276107,0,1,1
78795,3,1,276109,276109,276110,0,1,2
78796,5,3,276114,276114,276117,0,3,4
78797,2,1,276116,276117,276118,1,2,0
78798,4,2,276120,276120,276122,0,2,2
78799,2,1,276122,276122,276123,0,1,0
78800,2,1,276124,276124,276125,0,1,1
78801,2,2,276126,276126,276128,0,2,1
78802,2,2,276128,276128,276130,0,2,0
78803,4,3,276132,276132,276135,0,3,2
78804,3,3,276135,276135,276138,0,3,0
78805,6,1,276141,276141,276142,0,1,3
78806,4,3,276145,276145,276148,0,3,3
78807,2,3,276147,276148,276151,1,4,0
78808,5,3,276152,276152,276155,0,3,1
78809,6,2,276158,276158,276160,0,2,3
78810,3,1,276161,276161,276162,0,1,1
78811,6,2,276167,276167,276169,0,2,5
78812,5,2,276172,276172,276174,0,2,3
78813,6,1,276178,276178,276179,0,1,4
78814,6,2,276184,276184,276186,0,2,5
78815,3,3,276187,276187,276190,0,3,1
78816,4,1,276191,276191,276192,0,1,1
78817,2,1,276193,276193,276194,0,1,1
78818,4,3,276197,276197,276200,0,3,3
78819,5,2,276202,276202,276204,0,2,2
78820,2,2,276204,276204,276206,0,2,0
78821,4,2,276208,276208,276210,0,2,2
78822,2,2,276210,276210,276212,0,2,0
78823,3,2,276213,276213,276215,0,2,1
78824,4,3,276217,276217,276220,0,3,2
78825,3,2,276220,276220,276222,0,2,0
78826,4,2,276224,276224,276226,0,2,2
78827,4,3,276228,276228,276231,0,3,2
78828,5,3,276233,276233,276236,0,3,2
78829,1,3,276234,276236,276239,2,5,0
78830,5,2,276239,276239,276241,0,2,0
78831,1,3,276240,276241,276244,1,4,0
78832,3,3,276243,276244,276247,1,4,0
78833,4,1,276247,276247,276248,0,1,0
78834,3,1,276250,276250,276251,0,1,2
78835,1,2,276251,276251,276253,0,2,0
78836,3,3,276254,276254,276257,0,3,1
78837,5,3,276259,276259,276262,0,3,2
78838,4,2,276263,276263,276265,0,2,1
78839,2,1,276265,276265,276266,0,1,0
78840,6,2,276271,276271,276273,0,2,5
78841,3,2,276274,276274,276276,0,2,1
78842,1,2,276275,276276,276278,1,3,0
78843,5,3,276280,276280,276283,0,3,2
78844,5,2,276285,276285,276287,0,2,2
78845,6,2,276291,276291,276293,0,2,4
78846,3,1,276294,276294,276295,0,1,1
78847,5,3,276299,276299,276302,0,3,4
78848,2,3,276301,276302,276305,1,4,0
78849,1,1,276302,276305,276306,3,4,0
78850,3,3,276305,276306,276309,1,4,0
78851,4,3,276309,276309,276312,0,3,0
78852,5,2,276314,276314,276316,0,2,2
78853,1,1,276315,276316,276317,1,2,0
78854,3,3,276318,276318,276321,0,3,1
78855,3,2,276321,276321,276323,0,2,0
78856,1,3,276322,276323,276326,1,4,0
78857,3,3,276325,276326,276329,1,4,0
78858,5,2,276330,276330,276332,0,2,1
78859,2,1,276332,276332,276333,0,1,0
78860,1,2,276333,276333,276335,0,2,0
78861,3,2,276336,276336,276338,0,2,1
78862,3,1,276339,276339,276340,0,1,1
78863,6,2,276345,276345,276347,0,2,5
78864,6,1,276351,276351,276352,0,1,4
78865,3,3,276354,276354,276357,0,3,2
78866,2,3,276356,276357,276360,1,4,0
78867,1,3,276357,276360,276363,3,6,0
78868,3,2,276360,276363,276365,3,5,0
78869,3,2,276363,276365,276367,2,4,0
78870,1,2,276364,276367,276369,3,5,0
78871,4,2,276368,276369,276371,1,3,0
78872,6,2,276374,276374,276376,0,2,3
78873,6,1,276380,276380,276381,0,1,4
78874,3,3,276383,276383,276386,0,3,2
78875,6,1,276389,276389,276390,0,1,3
78876,2,1,276391,276391,276392,0,1,1
78877,4,3,276395,276395,276398,0,3,3
78878,5,2,276400,276400,276402,0,2,2
78879,3,3,276403,276403,276406,0,3,1
78880,3,2,276406,276406,276408,0,2,0
78881,1,2,276407,276408,276410,1,3,0
78882,6,3,276413,276413,276416,0,3,3
78883,2,2,276415,276416,276418,1,3,0
78884,6,1,276421,276421,276422,0,1,3
78885,6,2,276427,276427,276429,0,2,5
78886,3,1,276430,276430,276431,0,1,1
78887,2,3,276432,276432,276435,0,3,1
78888,4,2,276436,276436,276438,0,2,1
78889,4,3,276440,276440,276443,0,3,2
78890,5,1,276445,276445,276446,0,1,2
78891,6,2,276451,276451,276453,0,2,5
78892,1,2,276452,276453,276455,1,3,0
78893,4,2,276456,276456,276458,0,2,1
78894,5,3,276461,276461,276464,0,3,3
78895,1,2,276462,276464,276466,2,4,0
78896,5,1,276467,276467,276468,0,1,1
78897,2,2,276469,276469,276471,0,2,1
78898,6,3,276475,276475,276478,0,3,4
78899,5,3,276480,276480,276483,0,3,2
78900,4,3,276484,276484,276487,0,3,1
78901,2,1,276486,276487,276488,1,2,0
78902,3,1,276489,276489,276490,0,1,1
78903,1,1,276490,276490,276491,0,1,0
78904,3,3,276493,276493,276496,0,3,2
78905,6,1,276499,276499,276500,0,1,3
78906,3,3,276502,276502,276505,0,3,2
78907,1,3,276503,276505,276508,2,5,0
78908,4,2,276507,276508,276510,1,3,0
78909,6,3,276513,276513,276516,0,3,3
78910,3,1,276516,276516,276517,0,1,0
78911,5,3,276521,276521,276524,0,3,4
78912,3,3,276524,276524,276527,0,3,0
78913,6,1,276530,276530,276531,0,1,3
78914,4,1,276534,276534,276535,0,1,3
78915,3,2,276537,276537,276539,0,2,2
78916,2,1,276539,276539,276540,0,1,0
78917,4,2,276543,276543,276545,0,2,3
78918,4,2,276547,276547,276549,0,2,2
78919,3,1,276550,276550,276551,0,1,1
78920,3,3,276553,276553,276556,0,3,2
78921,6,2,276559,276559,276561,0,2,3
78922,1,1,276560,276561,276562,1,2,0
78923,6,3,276566,276566,276569,0,3,4
78924,2,3,276568,276569,276572,1,4,0
78925,3,1,276571,276572,276573,1,2,0
78926,6,3,276577,276577,276580,0,3,4
78927,2,3,276579,276580,276583,1,4,0
78928,6,3,276585,276585,276588,0,3,2
78929,5,1,276590,276590,276591,0,1,2
78930,1,3,276591,276591,276594,0,3,0
78931,4,2,276595,276595,276597,0,2,1
78932,4,1,276599,276599,276600,0,1,2
78933,3,3,276602,276602,276605,0,3,2
78934,1,3,276603,276605,276608,2,5,0
78935,3,2,276606,276608,276610,2,4,0
78936,4,3,276610,276610,276613,0,3,0
78937,4,1,276614,276614,276615,0,1,1
78938,6,1,276620,276620,276621,0,1,5
78939,6,1,276626,276626,276627,0,1,5
78940,3,3,276629,276629,276632,0,3,2
78941,4,3,276633,276633,276636,0,3,1
78942,6,1,276639,276639,276640,0,1,3
78943,1,2,276640,276640,276642,0,2,0
78944,2,1,276642,276642,276643,0,1,0
78945,5,3,276647,276647,276650,0,3,4
78946,6,3,276653,276653,276656,0,3,3
78947,3,1,276656,276656,276657,0,1,0
78948,2,3,276658,276658,276661,0,3,1
78949,2,3,276660,276661,276664,1,4,0
78950,5,3,276665,276665,276668,0,3,1
78951,4,1,276669,276669,276670,0,1,1
78952,5,1,276674,276674,276675,0,1,4
78953,1,2,276675,276675,276677,0,2,0
78954,6,3,276681,276681,276684,0,3,4
78955,4,2,276685,276685,276687,0,2,1
78956,4,2,276689,276689,276691,0,2,2
78957,1,3,276690,276691,276694,1,4,0
78958,5,2,276695,276695,276697,0,2,1
78959,4,3,276699,276699,276702,0,3,2
78960,5,2,276704,276704,276706,0,2,2
78961,1,3,276705,276706,276709,1,4,0
78962,1,3,276706,276709,276712,3,6,0
78963,3,1,276709,276712,276713,3,4,0
78964,6,3,276715,276715,276718,0,3,2
78965,4,1,276719,276719,276720,0,1,1
78966,1,3,276720,276720,276723,0,3,0
78967,3,2,276723,276723,276725,0,2,0
78968,6,2,276729,276729,276731,0,2,4
78969,3,2,276732,276732,276734,0,2,1
78970,3,3,276735,276735,276738,0,3,1
78971,6,1,276741,276741,276742,0,1,3
78972,3,1,276744,276744,276745,0,1,2
78973,1,2,276745,276745,276747,0,2,0
78974,4,3,276749,276749,276752,0,3,2
78975,3,2,276752,276752,276754,0,2,0
78976,6,3,276758,276758,276761,0,3,4
78977,5,2,276763,276763,276765,0,2,2
78978,6,3,276769,276769,276772,0,3,4
78979,3,3,276772,276772,276775,0,3,0
78980,4,1,276776,276776,276777,0,1,1
78981,1,3,276777,276777,276780,0,3,0
78982,5,3,276782,276782,276785,0,3,2
78983,3,2,276785,276785,276787,0,2,0
78984,2,3,276787,276787,276790,0,3,0
78985,6,3,276793,276793,276796,0,3,3
78986,6,1,276799,276799,276800,0,1,3
78987,5,3,276804,276804,276807,0,3,4
78988,3,3,276807,276807,276810,0,3,0
78989,3,3,276810,276810,276813,0,3,0
78990,2,3,276812,276813,276816,1,4,0
78991,6,1,276818,276818,276819,0,1,2
78992,2,2,276820,276820,276822,0,2,1
78993,4,2,276824,276824,276826,0,2,2
78994,1,3,276825,276826,276829,1,4,0
78995,4,2,276829,276829,276831,0,2,0
78996,1,2,276830,276831,276833,1,3,0
78997,5,3,276835,276835,276838,0,3,2
78998,5,3,276840,276840,276843,0,3,2
78999,4,1,276844,276844,276845,0,1,1
79000,6,2,276850,276850,276852,0,2,5
79001,5,3,276855,276855,276858,0,3,3
79002,2,1,276857,276858,276859,1,2,0
79003,6,3,276863,276863,276866,0,3,4
79004,3,3,276866,276866,276869,0,3,0
79005,2,1,276868,276869,276870,1,2,0
79006,4,1,276872,276872,276873,0,1,2
79007,3,1,276875,276875,276876,0,1,2
79008,4,3,276879,276879,276882,0,3,3
79009,2,1,276881,276882,276883,1,2,0
79010,2,3,276883,276883,276886,0,3,0
79011,5,2,276888,276888,276890,0,2,2
79012,3,2,276891,276891,276893,0,2,1
79013,6,1,276897,276897,276898,0,1,4
79014,5,3,276902,276902,276905,0,3,4
79015,6,2,276908,276908,276910,0,2,3
79016,1,3,276909,276910,276913,1,4,0
79017,6,1,276915,276915,276916,0,1,2
79018,1,2,276916,276916,276918,0,2,0
79019,5,3,276921,276921,276924,0,3,3
79020,5,1,276926,276926,276927,0,1,2
79021,6,1,276932,276932,276933,0,1,5
79022,5,2,276937,276937,276939,0,2,4
79023,3,1,276940,276940,276941,0,1,1
79024,4,3,276944,276944,276947,0,3,3
79025,2,1,276946,276947,276948,1,2,0
79026,5,3,276951,276951,276954,0,3,3
79027,1,1,276952,276954,276955,2,3,0
79028,4,2,276956,276956,276958,0,2,1
79029,5,3,276961,276961,276964,0,3,3
79030,4,3,276965,276965,276968,0,3,1
79031,2,2,276967,276968,276970,1,3,0
79032,6,3,276973,276973,276976,0,3,3
79033,3,1,276976,276976,276977,0,1,0
79034,1,1,276977,276977,276978,0,1,0
79035,4,3,276981,276981,276984,0,3,3
79036,3,2,276984,276984,276986,0,2,0
79037,5,1,276989,276989,276990,0,1,3
79038,5,1,276994,276994,276995,0,1,4
79039,2,3,276996,276996,276999,0,3,1
79040,5,1,277001,277001,277002,0,1,2
79041,3,2,277004,277004,277006,0,2,2
79042,4,3,277008,277008,277011,0,3,2
79043,1,1,277009,277011,277012,2,3,0
79044,4,1,277013,277013,277014,0,1,1
79045,5,2,277018,277018,277020,0,2,4
79046,6,2,277024,277024,277026,0,2,4
79047,4,1,277028,277028,277029,0,1,2
79048,2,1,277030,277030,277031,0,1,1
79049,1,2,277031,277031,277033,0,2,0
79050,3,1,277034,277034,277035,0,1,1
79051,1,1,277035,277035,277036,0,1,0
79052,2,1,277037,277037,277038,0,1,1
79053,1,3,277038,277038,277041,0,3,0
79054,1,1,277039,277041,277042,2,3,0
79055,6,1,277045,277045,277046,0,1,3
79056,5,3,277050,277050,277053,0,3,4
79057,2,3,277052,277053,277056,1,4,0
79058,5,3,277057,277057,277060,0,3,1
79059,5,2,277062,277062,277064,0,2,2
79060,3,1,277065,277065,277066,0,1,1
79061,6,3,277071,277071,277074,0,3,5
79062,6,3,277077,277077,277080,0,3,3
79063,1,2,277078,277080,277082,2,4,0
79064,5,3,277083,277083,277086,0,3,1
79065,5,2,277088,277088,277090,0,2,2
79066,4,1,277092,277092,277093,0,1,2
79067,4,1,277096,277096,277097,0,1,3
79068,4,3,277100,277100,277103,0,3,3
79069,5,2,277105,277105,277107,0,2,2
79070,3,3,277108,277108,277111,0,3,1
79071,1,1,277109,277111,277112,2,3,0
79072,5,2,277114,277114,277116,0,2,2
79073,1,1,277115,277116,277117,1,2,0
79074,2,2,277117,277117,277119,0,2,0
79075,5,1,277122,277122,277123,0,1,3
79076,6,2,277128,277128,277130,0,2,5
79077,6,3,277134,277134,277137,0,3,4
79078,6,3,277140,277140,277143,0,3,3
79079,6,2,277146,277146,277148,0,2,3
79080,6,2,277152,277152,277154,0,2,4
79081,2,2,277154,277154,277156,0,2,0
79082,2,2,277156,277156,277158,0,2,0
79083,1,1,277157,277158,277159,1,2,0
79084,5,1,277162,277162,277163,0,1,3
79085,2,3,277164,277164,277167,0,3,1
79086,1,1,277165,277167,277168,2,3,0
79087,5,2,277170,277170,277172,0,2,2
79088,5,2,277175,277175,277177,0,2,3
79089,6,3,277181,277181,277184,0,3,4
79090,3,3,277184,277184,277187,0,3,0
79091,4,3,277188,277188,277191,0,3,1
79092,4,1,277192,277192,277193,0,1,1
79093,4,3,277196,277196,277199,0,3,3
79094,3,2,277199,277199,277201,0,2,0
79095,1,3,277200,277201,277204,1,4,0
79096,4,1,277204,277204,277205,0,1,0
79097,5,1,277209,277209,277210,0,1,4
79098,3,1,277212,277212,277213,0,1,2
79099,1,3,277213,277213,277216,0,3,0
79100,4,2,277217,277217,277219,0,2,1
79101,3,1,277220,277220,277221,0,1,1
79102,3,1,277223,277223,277224,0,1,2
79103,3,2,277226,277226,277228,0,2,2
79104,1,2,277227,277228,277230,1,3,0
79105,4,1,277231,277231,277232,0,1,1
79106,4,1,277235,277235,277236,0,1,3
79107,5,1,277240,277240,277241,0,1,4
79108,6,3,277246,277246,277249,0,3,5
79109,4,2,277250,277250,277252,0,2,1
79110,4,1,277254,277254,277255,0,1,2
79111,4,3,277258,277258,277261,0,3,3
79112,1,3,277259,277261,277264,2,5,0
79113,1,3,277260,277264,277267,4,7,0
79114,3,1,277263,277267,277268,4,5,0
79115,5,2,277268,277268,277270,0,2,0
79116,3,1,277271,277271,277272,0,1,1
79117,1,1,277272,277272,277273,0,1,0
79118,3,3,277275,277275,277278,0,3,2
79119,4,2,277279,277279,277281,0,2,1
79120,6,1,277285,277285,277286,0,1,4
79121,3,2,277288,277288,277290,0,2,2
79122,3,3,277291,277291,277294,0,3,1
79123,4,3,277295,277295,277298,0,3,1
79124,1,3,277296,277298,277301,2,5,0
79125,6,1,277302,277302,277303,0,1,1
79126,2,3,277304,277304,277307,0,3,1
79127,3,3,277307,277307,277310,0,3,0
79128,2,1,277309,277310,277311,1,2,0
79129,6,1,277315,277315,277316,0,1,4
79130,2,1,277317,277317,277318,0,1,1
79131,4,2,277321,277321,277323,0,2,3
79132,5,3,277326,277326,277329,0,3,3
79133,3,1,277329,277329,277330,0,1,0
79134,5,3,277334,277334,277337,0,3,4
79135,6,1,277340,277340,277341,0,1,3
79136,5,1,277345,277345,277346,0,1,4
79137,3,3,277348,277348,277351,0,3,2
79138,2,2,277350,277351,277353,1,3,0
79139,5,2,277355,277355,277357,0,2,2
79140,3,3,277358,277358,277361,0,3,1
79141,4,2,277362,277362,277364,0,2,1
79142,5,2,277367,277367,277369,0,2,3
79143,1,2,277368,277369,277371,1,3,0
79144,2,3,277370,277371,277374,1,4,0
79145,1,2,277371,277374,277376,3,5,0
79146,2,3,277373,277376,277379,3,6,0
79147,2,1,277375,277379,277380,4,5,0
79148,6,3,277381,277381,277384,0,3,1
79149,5,1,277386,277386,277387,0,1,2
79150,2,3,277388,277388,277391,0,3,1
79151,5,1,277393,277393,277394,0,1,2
79152,3,1,277396,277396,277397,0,1,2
79153,2,1,277398,277398,277399,0,1,1
79154,2,2,277400,277400,277402,0,2,1
79155,1,1,277401,277402,277403,1,2,0
79156,5,2,277406,277406,277408,0,2,3
79157,5,2,277411,277411,277413,0,2,3
79158,4,2,277415,277415,277417,0,2,2
79159,3,1,277418,277418,277419,0,1,1
79160,4,2,277422,277422,277424,0,2,3
79161,3,2,277425,277425,277427,0,2,1
79162,6,2,277431,277431,277433,0,2,4
79163,1,3,277432,277433,277436,1,4,0
79164,5,3,277437,277437,277440,0,3,1
79165,1,2,277438,277440,277442,2,4,0
79166,3,2,277441,277442,277444,1,3,0
79167,6,1,277447,277447,277448,0,1,3
79168,6,2,277453,277453,277455,0,2,5
79169,6,1,277459,277459,277460,0,1,4
79170,6,1,277465,277465,277466,0,1,5
79171,3,3,277468,277468,277471,0,3,2
79172,4,1,277472,277472,277473,0,1,1
79173,2,2,277474,277474,277476,0,2,1
79174,2,3,277476,277476,277479,0,3,0
79175,4,1,277480,277480,277481,0,1,1
79176,5,2,277485,277485,277487,0,2,4
79177,2,1,277487,277487,277488,0,1,0
79178,2,2,277489,277489,277491,0,2,1
79179,5,2,277494,277494,277496,0,2,3
79180,3,2,277497,277497,277499,0,2,1
79181,5,2,277502,277502,277504,0,2,3
79182,3,2,277505,277505,277507,0,2,1
79183,4,2,277509,277509,277511,0,2,2
79184,6,1,277515,277515,277516,0,1,4
79185,2,1,277517,277517,277518,0,1,1
79186,6,2,277523,277523,277525,0,2,5
79187,1,2,277524,277525,277527,1,3,0
79188,4,1,277528,277528,277529,0,1,1
79189,3,1,277531,277531,277532,0,1,2
79190,1,3,277532,277532,277535,0,3,0
79191,1,2,277533,277535,277537,2,4,0
79192,6,2,277539,277539,277541,0,2,2
79193,3,2,277542,277542,277544,0,2,1
79194,4,2,277546,277546,277548,0,2,2
79195,6,2,277552,277552,277554,0,2,4
79196,5,3,277557,277557,277560,0,3,3
79197,6,2,277563,277563,277565,0,2,3
79198,4,3,277567,277567,277570,0,3,2
79199,6,1,277573,277573,277574,0,1,3
79200,6,2,277579,277579,277581,0,2,5
79201,5,1,277584,277584,277585,0,1,3
79202,3,2,277587,277587,277589,0,2,2
79203,3,3,277590,277590,277593,0,3,1
79204,4,3,277594,277594,277597,0,3,1
79205,4,1,277598,277598,277599,0,1,1
79206,5,1,277603,277603,277604,0,1,4
79207,1,3,277604,277604,277607,0,3,0
79208,1,3,277605,277607,277610,2,5,0
79209,4,2,277609,277610,277612,1,3,0
79210,1,3,277610,277612,277615,2,5,0
79211,5,3,277615,277615,277618,0,3,0
79212,3,1,277618,277618,277619,0,1,0
79213,3,3,277621,277621,277624,0,3,2
79214,5,3,277626,277626,277629,0,3,2
79215,1,1,277627,277629,277630,2,3,0
79216,6,2,277633,277633,277635,0,2,3
79217,6,1,277639,277639,277640,0,1,4
79218,1,1,277640,277640,277641,0,1,0
79219,6,2,277646,277646,277648,0,2,5
79220,1,1,277647,277648,277649,1,2,0
79221,3,2,277650,277650,277652,0,2,1
79222,2,2,277652,277652,277654,0,2,0
79223,3,3,277655,277655,277658,0,3,1
79224,6,3,277661,277661,277664,0,3,3
79225,6,1,277667,277667,277668,0,1,3
79226,4,2,277671,277671,277673,0,2,3
79227,2,1,277673,277673,277674,0,1,0
79228,4,2,277677,277677,277679,0,2,3
79229,4,3,277681,277681,277684,0,3,2
79230,5,2,277686,277686,277688,0,2,2
79231,1,3,277687,277688,277691,1,4,0
79232,3,1,277690,277691,277692,1,2,0
79233,2,2,277692,277692,277694,0,2,0
79234,3,3,277695,277695,277698,0,3,1
79235,4,3,277699,277699,277702,0,3,1
79236,4,3,277703,277703,277706,0,3,1
79237,5,2,277708,277708,277710,0,2,2
79238,6,3,277714,277714,277717,0,3,4
79239,2,1,277716,277717,277718,1,2,0
79240,2,3,277718,277718,277721,0,3,0
79241,4,2,277722,277722,277724,0,2,1
79242,3,1,277725,277725,277726,0,1,1
79243,4,1,277729,277729,277730,0,1,3
79244,6,3,277735,277735,277738,0,3,5
79245,1,1,277736,277738,277739,2,3,0
79246,5,1,277741,277741,277742,0,1,2
79247,6,2,277747,277747,277749,0,2,5
79248,6,3,277753,277753,277756,0,3,4
79249,2,2,277755,277756,277758,1,3,0
79250,3,2,277758,277758,277760,0,2,0
79251,3,3,277761,277761,277764,0,3,1
79252,6,2,277767,277767,277769,0,2,3
79253,4,2,277771,277771,277773,0,2,2
79254,1,3,277772,277773,277776,1,4,0
79255,4,2,277776,277776,277778,0,2,0
79256,6,3,277782,277782,277785,0,3,4
79257,2,2,277784,277785,277787,1,3,0
79258,4,2,277788,277788,277790,0,2,1
79259,6,3,277794,277794,277797,0,3,4
79260,2,3,277796,277797,277800,1,4,0
79261,5,2,277801,277801,277803,0,2,1
79262,1,3,277802,277803,277806,1,4,0
79263,5,3,277807,277807,277810,0,3,1
79264,5,3,277812,277812,277815,0,3,2
79265,3,2,277815,277815,277817,0,2,0
79266,1,1,277816,277817,277818,1,2,0
79267,1,2,277817,277818,277820,1,3,0
79268,3,3,277820,277820,277823,0,3,0
79269,5,3,277825,277825,277828,0,3,2
79270,2,3,277827,277828,277831,1,4,0
79271,5,2,277832,277832,277834,0,2,1
79272,6,3,277838,277838,277841,0,3,4
79273,4,2,277842,277842,277844,0,2,1
79274,4,1,277846,277846,277847,0,1,2
79275,5,1,277851,277851,277852,0,1,4
79276,1,1,277852,277852,277853,0,1,0
79277,4,2,277856,277856,277858,0,2,3
79278,5,1,277861,277861,277862,0,1,3
79279,1,3,277862,277862,277865,0,3,0
79280,3,3,277865,277865,277868,0,3,0
79281,3,3,277868,277868,277871,0,3,0
79282,1,2,277869,277871,277873,2,4,0
79283,4,2,277873,277873,277875,0,2,0
79284,4,1,277877,277877,277878,0,1,2
79285,2,1,277879,277879,277880,0,1,1
79286,2,1,277881,277881,277882,0,1,1
79287,4,1,277885,277885,277886,0,1,3
79288,2,1,277887,277887,277888,0,1,1
79289,6,3,277893,277893,277896,0,3,5
79290,5,3,277898,277898,277901,0,3,2
79291,5,2,277903,277903,277905,0,2,2
79292,1,3,277904,277905,277908,1,4,0
79293,5,1,277909,277909,277910,0,1,1
79294,5,2,277914,277914,277916,0,2,4
79295,2,3,277916,277916,277919,0,3,0
79296,2,1,277918,277919,277920,1,2,0
79297,1,2,277919,277920,277922,1,3,0
79298,2,2,277921,277922,277924,1,3,0
79299,3,3,277924,277924,277927,0,3,0
79300,3,2,277927,277927,277929,0,2,0
79301,2,1,277929,277929,277930,0,1,0
79302,3,2,277932,277932,277934,0,2,2
79303,5,3,277937,277937,277940,0,3,3
79304,6,3,277943,277943,277946,0,3,3
79305,6,1,277949,277949,277950,0,1,3
79306,2,1,277951,277951,277952,0,1,1
79307,5,1,277956,277956,277957,0,1,4
79308,6,2,277962,277962,277964,0,2,5
79309,5,1,277967,277967,277968,0,1,3
79310,2,2,277969,277969,277971,0,2,1
79311,2,2,277971,277971,277973,0,2,0
79312,2,1,277973,277973,277974,0,1,0
79313,5,3,277978,277978,277981,0,3,4
79314,4,2,277982,277982,277984,0,2,1
79315,1,3,277983,277984,277987,1,4,0
79316,5,3,277988,277988,277991,0,3,1
79317,2,3,277990,277991,277994,1,4,0
79318,3,2,277993,277994,277996,1,3,0
79319,5,2,277998,277998,278000,0,2,2
79320,1,3,277999,278000,278003,1,4,0
79321,2,3,278001,278003,278006,2,5,0
79322,6,1,278007,278007,278008,0,1,1
79323,6,2,278013,278013,278015,0,2,5
79324,5,2,278018,278018,278020,0,2,3
79325,2,2,278020,278020,278022,0,2,0
79326,1,2,278021,278022,278024,1,3,0
79327,3,1,278024,278024,278025,0,1,0
79328,2,1,278026,278026,278027,0,1,1
79329,2,1,278028,278028,278029,0,1,1
79330,1,1,278029,278029,278030,0,1,0
79331,4,1,278033,278033,278034,0,1,3
79332,4,1,278037,278037,278038,0,1,3
79333,5,2,278042,278042,278044,0,2,4
79334,2,1,278044,278044,278045,0,1,0
79335,4,2,278048,278048,278050,0,2,3
79336,6,1,278054,278054,278055,0,1,4
79337,2,3,278056,278056,278059,0,3,1
79338,3,2,278059,278059,278061,0,2,0
79339,2,2,278061,278061,278063,0,2,0
79340,3,3,278064,278064,278067,0,3,1
79341,1,3,278065,278067,278070,2,5,0
79342,4,1,278069,278070,278071,1,2,0
79343,1,2,278070,278071,278073,1,3,0
79344,4,2,278074,278074,278076,0,2,1
79345,2,3,278076,278076,278079,0,3,0
79346,3,2,278079,278079,278081,0,2,0
79347,3,3,278082,278082,278085,0,3,1
79348,5,1,278087,278087,278088,0,1,2
79349,3,2,278090,278090,278092,0,2,2
79350,1,3,278091,278092,278095,1,4,0
79351,4,1,278095,278095,278096,0,1,0
79352,5,1,278100,278100,278101,0,1,4
79353,4,2,278104,278104,278106,0,2,3
79354,3,1,278107,278107,278108,0,1,1
79355,1,1,278108,278108,278109,0,1,0
79356,4,2,278112,278112,278114,0,2,3
79357,3,1,278115,278115,278116,0,1,1
79358,1,1,278116,278116,278117,0,1,0
79359,3,1,278119,278119,278120,0,1,2
79360,5,3,278124,278124,278127,0,3,4
79361,6,3,278130,278130,278133,0,3,3
79362,3,2,278133,278133,278135,0,2,0
79363,3,3,278136,278136,278139,0,3,1
79364,3,3,278139,278139,278142,0,3,0
79365,2,1,278141,278142,278143,1,2,0
79366,5,1,278146,278146,278147,0,1,3
79367,1,2,278147,278147,278149,0,2,0
79368,3,2,278150,278150,278152,0,2,1
79369,2,3,278152,278152,278155,0,3,0
79370,3,2,278155,278155,278157,0,2,0
79371,3,3,278158,278158,278161,0,3,1
79372,1,3,278159,278161,278164,2,5,0
79373,5,3,278164,278164,278167,0,3,0
79374,2,1,278166,278167,278168,1,2,0
79375,5,1,278171,278171,278172,0,1,3
79376,2,1,278173,278173,278174,0,1,1
79377,1,3,278174,278174,278177,0,3,0
79378,2,1,278176,278177,278178,1,2,0
79379,2,3,278178,278178,278181,0,3,0
79380,6,2,278184,278184,278186,0,2,3
79381,5,1,278189,278189,278190,0,1,3
79382,6,3,278195,278195,278198,0,3,5
79383,1,3,278196,278198,278201,2,5,0
79384,1,2,278197,278201,278203,4,6,0
79385,3,2,278200,278203,278205,3,5,0
79386,1,3,278201,278205,278208,4,7,0
79387,6,3,278207,278208,278211,1,4,0
79388,4,1,278211,278211,278212,0,1,0
79389,2,2,278213,278213,278215,0,2,1
79390,3,3,278216,278216,278219,0,3,1
79391,4,1,278220,278220,278221,0,1,1
79392,1,3,278221,278221,278224,0,3,0
79393,1,2,278222,278224,278226,2,4,0
79394,2,1,278224,278226,278227,2,3,0
79395,5,2,278229,278229,278231,0,2,2
79396,4,2,278233,278233,278235,0,2,2
79397,2,2,278235,278235,278237,0,2,0
79398,4,2,278239,278239,278241,0,2,2
79399,1,3,278240,278241,278244,1,4,0
79400,4,3,278244,278244,278247,0,3,0
79401,3,2,278247,278247,278249,0,2,0
79402,3,3,278250,278250,278253,0,3,1
79403,4,2,278254,278254,278256,0,2,1
79404,1,2,278255,278256,278258,1,3,0
79405,1,1,278256,278258,278259,2,3,0
79406,2,3,278258,278259,278262,1,4,0
79407,4,1,278262,278262,278263,0,1,0
79408,3,3,278265,278265,278268,0,3,2
79409,6,2,278271,278271,278273,0,2,3
79410,4,3,278275,278275,278278,0,3,2
79411,1,1,278276,278278,278279,2,3,0
79412,5,3,278281,278281,278284,0,3,2
79413,1,3,278282,278284,278287,2,5,0
79414,5,3,278287,278287,278290,0,3,0
79415,6,3,278293,278293,278296,0,3,3
79416,2,1,278295,278296,278297,1,2,0
79417,2,1,278297,278297,278298,0,1,0
79418,6,1,278303,278303,278304,0,1,5
79419,4,2,278307,278307,278309,0,2,3
79420,2,1,278309,278309,278310,0,1,0
79421,3,3,278312,278312,278315,0,3,2
79422,1,2,278313,278315,278317,2,4,0
79423,2,3,278315,278317,278320,2,5,0
79424,2,2,278317,278320,278322,3,5,0
79425,5,1,278322,278322,278323,0,1,0
79426,2,1,278324,278324,278325,0,1,1
79427,1,2,278325,278325,278327,0,2,0
79428,6,1,278331,278331,278332,0,1,4
79429,2,3,278333,278333,278336,0,3,1
79430,3,3,278336,278336,278339,0,3,0
79431,3,1,278339,278339,278340,0,1,0
79432,3,2,278342,278342,278344,0,2,2
79433,2,1,278344,278344,278345,0,1,0
79434,2,2,278346,278346,278348,0,2,1
79435,5,1,278351,278351,278352,0,1,3
79436,1,3,278352,278352,278355,0,3,0
79437,1,2,278353,278355,278357,2,4,0
79438,5,3,278358,278358,278361,0,3,1
79439,2,1,278360,278361,278362,1,2,0
79440,6,2,278366,278366,278368,0,2,4
79441,5,2,278371,278371,278373,0,2,3
79442,3,3,278374,278374,278377,0,3,1
79443,2,1,278376,278377,278378,1,2,0
79444,2,2,278378,278378,278380,0,2,0
79445,1,3,278379,278380,278383,1,4,0
79446,5,3,278384,278384,278387,0,3,1
79447,1,1,278385,278387,278388,2,3,0
79448,5,3,278390,278390,278393,0,3,2
79449,3,2,278393,278393,278395,0,2,0
79450,5,1,278398,278398,278399,0,1,3
79451,5,2,278403,278403,278405,0,2,4
79452,5,2,278408,278408,278410,0,2,3
79453,3,2,278411,278411,278413,0,2,1
79454,6,2,278417,278417,278419,0,2,4
79455,4,1,278421,278421,278422,0,1,2
79456,5,3,278426,278426,278429,0,3,4
79457,4,2,278430,278430,278432,0,2,1
79458,6,2,278436,278436,278438,0,2,4
79459,6,1,278442,278442,278443,0,1,4
79460,1,2,278443,278443,278445,0,2,0
79461,5,1,278448,278448,278449,0,1,3
79462,6,3,278454,278454,278457,0,3,5
79463,5,3,278459,278459,278462,0,3,2
79464,1,1,278460,278462,278463,2,3,0
79465,2,2,278462,278463,278465,1,3,0
79466,4,3,278466,278466,278469,0,3,1
79467,1,1,278467,278469,278470,2,3,0
79468,2,2,278469,278470,278472,1,3,0
79469,5,3,278474,278474,278477,0,3,2
79470,2,1,278476,278477,278478,1,2,0
79471,3,2,278479,278479,278481,0,2,1
79472,4,1,278483,278483,278484,0,1,2
79473,3,3,278486,278486,278489,0,3,2
79474,6,2,278492,278492,278494,0,2,3
79475,6,2,278498,278498,278500,0,2,4
79476,5,2,278503,278503,278505,0,2,3
79477,6,3,278509,278509,278512,0,3,4
79478,6,1,278515,278515,278516,0,1,3
79479,2,3,278517,278517,278520,0,3,1
79480,6,1,278523,278523,278524,0,1,3
79481,5,1,278528,278528,278529,0,1,4
79482,4,3,278532,278532,278535,0,3,3
79483,4,3,278536,278536,278539,0,3,1
79484,4,3,278540,278540,278543,0,3,1
79485,6,2,278546,278546,278548,0,2,3
79486,4,2,278550,278550,278552,0,2,2
79487,4,3,278554,278554,278557,0,3,2
79488,3,3,278557,278557,278560,0,3,0
79489,3,3,278560,278560,278563,0,3,0
79490,6,1,278566,278566,278567,0,1,3
79491,1,3,278567,278567,278570,0,3,0
79492,2,2,278569,278570,278572,1,3,0
79493,4,2,278573,278573,278575,0,2,1
79494,4,3,278577,278577,278580,0,3,2
79495,1,1,278578,278580,278581,2,3,0
79496,5,2,278583,278583,278585,0,2,2
79497,3,2,278586,278586,278588,0,2,1
79498,2,3,278588,278588,278591,0,3,0
79499,4,1,278592,278592,278593,0,1,1
79500,2,2,278594,278594,278596,0,2,1
79501,6,2,278600,278600,278602,0,2,4
79502,2,1,278602,278602,278603,0,1,0
79503,1,3,278603,278603,278606,0,3,0
79504,3,1,278606,278606,278607,0,1,0
79505,5,2,278611,278611,278613,0,2,4
79506,5,3,278616,278616,278619,0,3,3
79507,3,1,278619,278619,278620,0,1,0
79508,1,3,278620,278620,278623,0,3,0
79509,2,3,278622,278623,278626,1,4,0
79510,3,1,278625,278626,278627,1,2,0
79511,2,1,278627,278627,278628,0,1,0
79512,6,3,278633,278633,278636,0,3,5
79513,6,2,278639,278639,278641,0,2,3
79514,1,1,278640,278641,278642,1,2,0
79515,5,2,278645,278645,278647,0,2,3
79516,3,2,278648,278648,278650,0,2,1
79517,3,3,278651,278651,278654,0,3,1
79518,4,3,278655,278655,278658,0,3,1
79519,6,2,278661,278661,278663,0,2,3
79520,1,3,278662,278663,278666,1,4,0
79521,2,2,278664,278666,278668,2,4,0
79522,1,2,278665,278668,278670,3,5,0
79523,5,2,278670,278670,278672,0,2,0
79524,5,1,278675,278675,278676,0,1,3
79525,5,1,278680,278680,278681,0,1,4
79526,4,2,278684,278684,278686,0,2,3
79527,3,2,278687,278687,278689,0,2,1
79528,4,1,278691,278691,278692,0,1,2
79529,4,3,278695,278695,278698,0,3,3
79530,2,2,278697,278698,278700,1,3,0
79531,4,2,278701,278701,278703,0,2,1
79532,5,3,278706,278706,278709,0,3,3
79533,1,1,278707,278709,278710,2,3,0
79534,3,2,278710,278710,278712,0,2,0
79535,3,2,278713,278713,278715,0,2,1
79536,6,1,278719,278719,278720,0,1,4
79537,5,1,278724,278724,278725,0,1,4
79538,5,1,278729,278729,278730,0,1,4
79539,6,2,278735,278735,278737,0,2,5
79540,2,1,278737,278737,278738,0,1,0
79541,4,1,278741,278741,278742,0,1,3
79542,6,3,278747,278747,278750,0,3,5
79543,1,1,278748,278750,278751,2,3,0
79544,6,3,278754,278754,278757,0,3,3
79545,2,1,278756,278757,278758,1,2,0
79546,3,2,278759,278759,278761,0,2,1
79547,5,1,278764,278764,278765,0,1,3
79548,4,3,278768,278768,278771,0,3,3
79549,3,2,278771,278771,278773,0,2,0
79550,4,1,278775,278775,278776,0,1,2
79551,6,3,278781,278781,278784,0,3,5
79552,2,2,278783,278784,278786,1,3,0
79553,3,3,278786,278786,278789,0,3,0
79554,1,1,278787,278789,278790,2,3,0
79555,3,3,278790,278790,278793,0,3,0
79556,3,2,278793,278793,278795,0,2,0
79557,4,3,278797,278797,278800,0,3,2
79558,5,3,278802,278802,278805,0,3,2
79559,2,3,278804,278805,278808,1,4,0
79560,3,1,278807,278808,278809,1,2,0
79561,5,2,278812,278812,278814,0,2,3
79562,4,3,278816,278816,278819,0,3,2
79563,5,3,278821,278821,278824,0,3,2
79564,2,1,278823,278824,278825,1,2,0
79565,4,1,278827,278827,278828,0,1,2
79566,5,3,278832,278832,278835,0,3,4
79567,2,1,278834,278835,278836,1,2,0
79568,5,1,278839,278839,278840,0,1,3
79569,1,3,278840,278840,278843,0,3,0
79570,6,1,278846,278846,278847,0,1,3
79571,5,1,278851,278851,278852,0,1,4
79572,6,2,278857,278857,278859,0,2,5
79573,3,2,278860,278860,278862,0,2,1
79574,2,3,278862,278862,278865,0,3,0
79575,2,1,278864,278865,278866,1,2,0
79576,1,3,278865,278866,278869,1,4,0
79577,2,2,278867,278869,278871,2,4,0
79578,2,3,278869,278871,278874,2,5,0
79579,4,1,278873,278874,278875,1,2,0
79580,1,2,278874,278875,278877,1,3,0
79581,3,3,278877,278877,278880,0,3,0
79582,1,1,278878,278880,278881,2,3,0
79583,5,1,278883,278883,278884,0,1,2
79584,1,2,278884,278884,278886,0,2,0
79585,4,3,278888,278888,278891,0,3,2
79586,2,1,278890,278891,278892,1,2,0
79587,4,3,278894,278894,278897,0,3,2
79588,1,2,278895,278897,278899,2,4,0
79589,2,1,278897,278899,278900,2,3,0
79590,1,3,278898,278900,278903,2,5,0
79591,5,2,278903,278903,278905,0,2,0
79592,1,1,278904,278905,278906,1,2,0
79593,1,3,278905,278906,278909,1,4,0
79594,4,3,278909,278909,278912,0,3,0
79595,3,1,278912,278912,278913,0,1,0
79596,1,3,278913,278913,278916,0,3,0
79597,4,1,278917,278917,278918,0,1,1
79598,1,3,278918,278918,278921,0,3,0
79599,2,3,278920,278921,278924,1,4,0
79600,6,2,278926,278926,278928,0,2,2
79601,4,2,278930,278930,278932,0,2,2
79602,3,1,278933,278933,278934,0,1,1
79603,5,2,278938,278938,278940,0,2,4
79604,5,1,278943,278943,278944,0,1,3
79605,2,1,278945,278945,278946,0,1,1
79606,3,2,278948,278948,278950,0,2,2
79607,2,2,278950,278950,278952,0,2,0
79608,1,3,278951,278952,278955,1,4,0
79609,3,3,278954,278955,278958,1,4,0
79610,1,3,278955,278958,278961,3,6,0
79611,4,2,278959,278961,278963,2,4,0
79612,5,1,278964,278964,278965,0,1,1
79613,5,1,278969,278969,278970,0,1,4
79614,1,2,278970,278970,278972,0,2,0
79615,4,2,278974,278974,278976,0,2,2
79616,1,3,278975,278976,278979,1,4,0
79617,3,3,278978,278979,278982,1,4,0
79618,1,3,278979,278982,278985,3,6,0
79619,3,1,278982,278985,278986,3,4,0
79620,5,2,278987,278987,278989,0,2,1
79621,4,3,278991,278991,278994,0,3,2
79622,3,2,278994,278994,278996,0,2,0
79623,6,3,279000,279000,279003,0,3,4
79624,3,1,279003,279003,279004,0,1,0
79625,1,3,279004,279004,279007,0,3,0
79626,3,3,279007,279007,279010,0,3,0
79627,4,1,279011,279011,279012,0,1,1
79628,1,1,279012,279012,279013,0,1,0
79629,3,3,279015,279015,279018,0,3,2
79630,5,1,279020,279020,279021,0,1,2
79631,5,2,279025,279025,279027,0,2,4
79632,1,3,279026,279027,279030,1,4,0
79633,5,3,279031,279031,279034,0,3,1
79634,5,3,279036,279036,279039,0,3,2
79635,6,1,279042,279042,279043,0,1,3
79636,6,1,279048,279048,279049,0,1,5
79637,5,1,279053,279053,279054,0,1,4
79638,4,2,279057,279057,279059,0,2,3
79639,5,3,279062,279062,279065,0,3,3
79640,4,3,279066,279066,279069,0,3,1
79641,4,1,279070,279070,279071,0,1,1
79642,2,2,279072,279072,279074,0,2,1
79643,5,2,279077,279077,279079,0,2,3
79644,5,2,279082,279082,279084,0,2,3
79645,6,1,279088,279088,279089,0,1,4
79646,5,2,279093,279093,279095,0,2,4
79647,6,3,279099,279099,279102,0,3,4
79648,3,1,279102,279102,279103,0,1,0
79649,3,2,279105,279105,279107,0,2,2
79650,6,1,279111,279111,279112,0,1,4
79651,2,2,279113,279113,279115,0,2,1
79652,3,2,279116,279116,279118,0,2,1
79653,1,3,279117,279118,279121,1,4,0
79654,1,1,279118,279121,279122,3,4,0
79655,6,3,279124,279124,279127,0,3,2
79656,2,3,279126,279127,279130,1,4,0
79657,2,1,279128,279130,279131,2,3,0
79658,3,1,279131,279131,279132,0,1,0
79659,5,1,279136,279136,279137,0,1,4
79660,3,3,279139,279139,279142,0,3,2
79661,1,1,279140,279142,279143,2,3,0
79662,3,2,279143,279143,279145,0,2,0
79663,4,1,279147,279147,279148,0,1,2
79664,2,3,279149,279149,279152,0,3,1
79665,6,3,279155,279155,279158,0,3,3
79666,5,1,279160,279160,279161,0,1,2
79667,2,3,279162,279162,279165,0,3,1
79668,5,2,279167,279167,279169,0,2,2
79669,3,2,279170,279170,279172,0,2,1
79670,4,2,279174,279174,279176,0,2,2
79671,3,2,279177,279177,279179,0,2,1
79672,5,3,279182,279182,279185,0,3,3
79673,1,1,279183,279185,279186,2,3,0
79674,1,1,279184,279186,279187,2,3,0
79675,5,3,279189,279189,279192,0,3,2
79676,6,2,279195,279195,279197,0,2,3
79677,3,3,279198,279198,279201,0,3,1
79678,3,2,279201,279201,279203,0,2,0
79679,6,1,279207,279207,279208,0,1,4
79680,4,2,279211,279211,279213,0,2,3
79681,1,2,279212,279213,279215,1,3,0
79682,3,3,279215,279215,279218,0,3,0
79683,6,2,279221,279221,279223,0,2,3
79684,2,2,279223,279223,279225,0,2,0
79685,1,1,279224,279225,279226,1,2,0
79686,3,3,279227,279227,279230,0,3,1
79687,3,2,279230,279230,279232,0,2,0
79688,1,1,279231,279232,279233,1,2,0
79689,1,1,279232,279233,279234,1,2,0
79690,1,3,279233,279234,279237,1,4,0
79691,3,3,279236,279237,279240,1,4,0
79692,6,2,279242,279242,279244,0,2,2
79693,4,1,279246,279246,279247,0,1,2
79694,2,1,279248,279248,279249,0,1,1
79695,5,3,279253,279253,279256,0,3,4
79696,5,2,279258,279258,279260,0,2,2
79697,5,2,279263,279263,279265,0,2,3
79698,5,2,279268,279268,279270,0,2,3
79699,6,2,279274,279274,279276,0,2,4
79700,4,2,279278,279278,279280,0,2,2
79701,2,2,279280,279280,279282,0,2,0
79702,4,1,279284,279284,279285,0,1,2
79703,3,1,279287,279287,279288,0,1,2
79704,4,3,279291,279291,279294,0,3,3
79705,4,3,279295,279295,279298,0,3,1
79706,4,3,279299,279299,279302,0,3,1
79707,1,2,279300,279302,279304,2,4,0
79708,2,1,279302,279304,279305,2,3,0
79709,1,1,279303,279305,279306,2,3,0
79710,2,1,279305,279306,279307,1,2,0
79711,1,1,279306,279307,279308,1,2,0
79712,1,3,279307,279308,279311,1,4,0
79713,3,2,279310,279311,279313,1,3,0
79714,6,1,279316,279316,279317,0,1,3
79715,5,2,279321,279321,279323,0,2,4
79716,4,3,279325,279325,279328,0,3,2
79717,1,3,279326,279328,279331,2,5,0
79718,6,1,279332,279332,279333,0,1,1
79719,4,3,279336,279336,279339,0,3,3
79720,5,3,279341,279341,279344,0,3,2
79721,3,1,279344,279344,279345,0,1,0
79722,6,2,279350,279350,279352,0,2,5
79723,3,1,279353,279353,279354,0,1,1
79724,4,2,279357,279357,279359,0,2,3
79725,3,3,279360,279360,279363,0,3,1
79726,4,3,279364,279364,279367,0,3,1
79727,3,1,279367,279367,279368,0,1,0
79728,6,2,279373,279373,279375,0,2,5
79729,1,3,279374,279375,279378,1,4,0
79730,4,1,279378,279378,279379,0,1,0
79731,3,2,279381,279381,279383,0,2,2
79732,6,3,279387,279387,279390,0,3,4
79733,4,3,279391,279391,279394,0,3,1
79734,5,3,279396,279396,279399,0,3,2
79735,2,1,279398,279399,279400,1,2,0
79736,2,1,279400,279400,279401,0,1,0
79737,6,1,279406,279406,279407,0,1,5
79738,2,1,279408,279408,279409,0,1,1
79739,4,2,279412,279412,279414,0,2,3
79740,2,3,279414,279414,279417,0,3,0
79741,3,2,279417,279417,279419,0,2,0
79742,3,2,279420,279420,279422,0,2,1
79743,3,1,279423,279423,279424,0,1,1
79744,4,2,279427,279427,279429,0,2,3
79745,3,3,279430,279430,279433,0,3,1
79746,6,3,279436,279436,279439,0,3,3
79747,6,2,279442,279442,279444,0,2,3
79748,2,2,279444,279444,279446,0,2,0
79749,2,2,279446,279446,279448,0,2,0
79750,4,1,279450,279450,279451,0,1,2
79751,4,3,279454,279454,279457,0,3,3
79752,1,1,279455,279457,279458,2,3,0
79753,4,1,279459,279459,279460,0,1,1
79754,5,2,279464,279464,279466,0,2,4
79755,1,2,279465,279466,279468,1,3,0
79756,2,2,279467,279468,279470,1,3,0
79757,1,3,279468,279470,279473,2,5,0
79758,5,1,279473,279473,279474,0,1,0
79759,2,1,279475,279475,279476,0,1,1
79760,4,1,279479,279479,279480,0,1,3
79761,5,1,279484,279484,279485,0,1,4
79762,1,2,279485,279485,279487,0,2,0
79763,6,3,279491,279491,279494,0,3,4
79764,1,3,279492,279494,279497,2,5,0
79765,6,2,279498,279498,279500,0,2,1
79766,1,3,279499,279500,279503,1,4,0
79767,5,3,279504,279504,279507,0,3,1
79768,3,2,279507,279507,279509,0,2,0
79769,5,2,279512,279512,279514,0,2,3
79770,3,2,279515,279515,279517,0,2,1
79771,1,3,279516,279517,279520,1,4,0
79772,6,1,279522,279522,279523,0,1,2
79773,5,2,279527,279527,279529,0,2,4
79774,3,1,279530,279530,279531,0,1,1
79775,3,2,279533,279533,279535,0,2,2
79776,4,3,279537,279537,279540,0,3,2
79777,6,2,279543,279543,279545,0,2,3
79778,4,1,279547,279547,279548,0,1,2
79779,3,1,279550,279550,279551,0,1,2
79780,3,1,279553,279553,279554,0,1,2
79781,2,1,279555,279555,279556,0,1,1
79782,6,2,279561,279561,279563,0,2,5
79783,6,2,279567,279567,279569,0,2,4
79784,6,1,279573,279573,279574,0,1,4
79785,6,1,279579,279579,279580,0,1,5
79786,1,3,279580,279580,279583,0,3,0
79787,6,1,279586,279586,279587,0,1,3
79788,2,2,279588,279588,279590,0,2,1
79789,4,2,279592,279592,279594,0,2,2
79790,2,1,279594,279594,279595,0,1,0
79791,1,1,279595,279595,279596,0,1,0
79792,2,3,279597,279597,279600,0,3,1
79793,5,3,279602,279602,279605,0,3,2
79794,4,3,279606,279606,279609,0,3,1
79795,3,1,279609,279609,279610,0,1,0
79796,6,2,279615,279615,279617,0,2,5
79797,5,1,279620,279620,279621,0,1,3
79798,6,1,279626,279626,279627,0,1,5
79799,3,2,279629,279629,279631,0,2,2
79800,3,3,279632,279632,279635,0,3,1
79801,3,2,279635,279635,279637,0,2,0
79802,3,1,279638,279638,279639,0,1,1
79803,5,1,279643,279643,279644,0,1,4
79804,6,3,279649,279649,279652,0,3,5
79805,4,1,279653,279653,279654,0,1,1
79806,5,1,279658,279658,279659,0,1,4
79807,3,3,279661,279661,279664,0,3,2
79808,6,3,279667,279667,279670,0,3,3
79809,6,1,279673,279673,279674,0,1,3
79810,6,2,279679,279679,279681,0,2,5
79811,2,1,279681,279681,279682,0,1,0
79812,2,2,279683,279683,279685,0,2,1
79813,1,3,279684,279685,279688,1,4,0
79814,3,2,279687,279688,279690,1,3,0
79815,1,3,279688,279690,279693,2,5,0
79816,4,2,279692,279693,279695,1,3,0
79817,5,2,279697,279697,279699,0,2,2
79818,4,2,279701,279701,279703,0,2,2
79819,5,1,279706,279706,279707,0,1,3
79820,5,2,279711,279711,279713,0,2,4
79821,1,1,279712,279713,279714,1,2,0
79822,4,1,279716,279716,279717,0,1,2
79823,3,3,279719,279719,279722,0,3,2
79824,5,1,279724,279724,279725,0,1,2
79825,2,3,279726,279726,279729,0,3,1
79826,1,2,279727,279729,279731,2,4,0
79827,3,3,279730,279731,279734,1,4,0
79828,1,3,279731,279734,279737,3,6,0
79829,3,1,279734,279737,279738,3,4,0
79830,1,1,279735,279738,279739,3,4,0
79831,1,2,279736,279739,279741,3,5,0
79832,5,2,279741,279741,279743,0,2,0
79833,2,2,279743,279743,279745,0,2,0
79834,3,2,279746,279746,279748,0,2,1
79835,4,2,279750,279750,279752,0,2,2
79836,2,3,279752,279752,279755,0,3,0
79837,3,3,279755,279755,279758,0,3,0
79838,2,3,279757,279758,279761,1,4,0
79839,4,1,279761,279761,279762,0,1,0
79840,6,1,279767,279767,279768,0,1,5
79841,1,2,279768,279768,279770,0,2,0
79842,1,3,279769,279770,279773,1,4,0
79843,4,2,279773,279773,279775,0,2,0
79844,1,2,279774,279775,279777,1,3,0
79845,2,2,279776,279777,279779,1,3,0
79846,5,3,279781,279781,279784,0,3,2
79847,2,2,279783,279784,279786,1,3,0
79848,6,2,279789,279789,279791,0,2,3
79849,3,3,279792,279792,279795,0,3,1
79850,4,3,279796,279796,279799,0,3,1
79851,6,3,279802,279802,279805,0,3,3
79852,4,1,279806,279806,279807,0,1,1
79853,2,1,279808,279808,279809,0,1,1
79854,3,1,279811,279811,279812,0,1,2
79855,1,1,279812,279812,279813,0,1,0
79856,2,2,279814,279814,279816,0,2,1
79857,6,1,279820,279820,279821,0,1,4
79858,1,2,279821,279821,279823,0,2,0
79859,2,1,279823,279823,279824,0,1,0
79860,4,1,279827,279827,279828,0,1,3
79861,5,2,279832,279832,279834,0,2,4
79862,4,3,279836,279836,279839,0,3,2
79863,1,1,279837,279839,279840,2,3,0
79864,6,1,279843,279843,279844,0,1,3
79865,1,2,279844,279844,279846,0,2,0
79866,5,3,279849,279849,279852,0,3,3
79867,5,2,279854,279854,279856,0,2,2
79868,5,3,279859,279859,279862,0,3,3
79869,3,3,279862,279862,279865,0,3,0
79870,3,2,279865,279865,279867,0,2,0
79871,4,2,279869,279869,279871,0,2,2
79872,1,1,279870,279871,279872,1,2,0
79873,6,3,279876,279876,279879,0,3,4
79874,4,3,279880,279880,279883,0,3,1
79875,6,1,279886,279886,279887,0,1,3
79876,4,2,279890,279890,279892,0,2,3
79877,3,1,279893,279893,279894,0,1,1
79878,2,3,279895,279895,279898,0,3,1
79879,2,3,279897,279898,279901,1,4,0
79880,3,2,279900,279901,279903,1,3,0
79881,4,3,279904,279904,279907,0,3,1
79882,6,3,279910,279910,279913,0,3,3
79883,5,1,279915,279915,279916,0,1,2
79884,1,2,279916,279916,279918,0,2,0
79885,1,1,279917,279918,279919,1,2,0
79886,4,2,279921,279921,279923,0,2,2
79887,2,3,279923,279923,279926,0,3,0
79888,2,1,279925,279926,279927,1,2,0
79889,3,1,279928,279928,279929,0,1,1
79890,1,1,279929,279929,279930,0,1,0
79891,5,3,279934,279934,279937,0,3,4
79892,2,3,279936,279937,279940,1,4,0
79893,3,2,279939,279940,279942,1,3,0
79894,5,2,279944,279944,279946,0,2,2
79895,1,3,279945,279946,279949,1,4,0
79896,3,1,279948,279949,279950,1,2,0
79897,3,2,279951,279951,279953,0,2,1
79898,1,1,279952,279953,279954,1,2,0
79899,1,1,279953,279954,279955,1,2,0
79900,4,1,279957,279957,279958,0,1,2
79901,2,2,279959,279959,279961,0,2,1
79902,4,3,279963,279963,279966,0,3,2
79903,4,1,279967,279967,279968,0,1,1
79904,1,1,279968,279968,279969,0,1,0
79905,1,3,279969,279969,279972,0,3,0
79906,2,3,279971,279972,279975,1,4,0
79907,3,3,279974,279975,279978,1,4,0
79908,4,3,279978,279978,279981,0,3,0
79909,2,2,279980,279981,279983,1,3,0
79910,4,3,279984,279984,279987,0,3,1
79911,5,1,279989,279989,279990,0,1,2
79912,6,1,279995,279995,279996,0,1,5
79913,2,1,279997,279997,279998,0,1,1
79914,3,3,280000,280000,280003,0,3,2
79915,4,2,280004,280004,280006,0,2,1
79916,2,3,280006,280006,280009,0,3,0
79917,3,1,280009,280009,280010,0,1,0
79918,6,2,280015,280015,280017,0,2,5
79919,3,3,280018,280018,280021,0,3,1
79920,4,1,280022,280022,280023,0,1,1
79921,6,2,280028,280028,280030,0,2,5
79922,1,3,280029,280030,280033,1,4,0
79923,2,3,280031,280033,280036,2,5,0
79924,1,3,280032,280036,280039,4,7,0
79925,6,1,280038,280039,280040,1,2,0
79926,5,2,280043,280043,280045,0,2,3
79927,2,1,280045,280045,280046,0,1,0
79928,3,1,280048,280048,280049,0,1,2
79929,6,1,280054,280054,280055,0,1,5
79930,6,2,280060,280060,280062,0,2,5
79931,2,1,280062,280062,280063,0,1,0
79932,6,3,280068,280068,280071,0,3,5
79933,6,3,280074,280074,280077,0,3,3
79934,3,2,280077,280077,280079,0,2,0
79935,4,3,280081,280081,280084,0,3,2
79936,5,2,280086,280086,280088,0,2,2
79937,4,1,280090,280090,280091,0,1,2
79938,6,2,280096,280096,280098,0,2,5
79939,5,3,280101,280101,280104,0,3,3
79940,2,2,280103,280104,280106,1,3,0
79941,2,1,280105,280106,280107,1,2,0
79942,4,2,280109,280109,280111,0,2,2
79943,2,1,280111,280111,280112,0,1,0
79944,6,3,280117,280117,280120,0,3,5
79945,3,3,280120,280120,280123,0,3,0
79946,1,2,280121,280123,280125,2,4,0
79947,4,1,280125,280125,280126,0,1,0
79948,6,1,280131,280131,280132,0,1,5
79949,3,1,280134,280134,280135,0,1,2
79950,2,2,280136,280136,280138,0,2,1
79951,3,3,280139,280139,280142,0,3,1
79952,6,3,280145,280145,280148,0,3,3
79953,5,2,280150,280150,280152,0,2,2
79954,6,1,280156,280156,280157,0,1,4
79955,3,3,280159,280159,280162,0,3,2
79956,4,1,280163,280163,280164,0,1,1
79957,1,1,280164,280164,280165,0,1,0
79958,2,2,280166,280166,280168,0,2,1
79959,6,1,280172,280172,280173,0,1,4
79960,5,3,280177,280177,280180,0,3,4
79961,1,2,280178,280180,280182,2,4,0
79962,1,1,280179,280182,280183,3,4,0
79963,3,3,280182,280183,280186,1,4,0
79964,1,3,280183,280186,280189,3,6,0
79965,5,3,280188,280189,280192,1,4,0
79966,3,3,280191,280192,280195,1,4,0
79967,2,3,280193,280195,280198,2,5,0
79968,1,3,280194,280198,280201,4,7,0
79969,1,1,280195,280201,280202,6,7,0
79970,6,1,280201,280202,280203,1,2,0
79971,4,2,280205,280205,280207,0,2,2
79972,2,3,280207,280207,280210,0,3,0
79973,1,3,280208,280210,280213,2,5,0
79974,6,1,280214,280214,280215,0,1,1
79975,6,3,280220,280220,280223,0,3,5
79976,1,1,280221,280223,280224,2,3,0
79977,2,1,280223,280224,280225,1,2,0
79978,4,3,280227,280227,280230,0,3,2
79979,6,2,280233,280233,280235,0,2,3
79980,3,2,280236,280236,280238,0,2,1
79981,4,2,280240,280240,280242,0,2,2
79982,3,3,280243,280243,280246,0,3,1
79983,2,2,280245,280246,280248,1,3,0
79984,5,3,280250,280250,280253,0,3,2
79985,2,1,280252,280253,280254,1,2,0
79986,6,1,280258,280258,280259,0,1,4
79987,6,1,280264,280264,280265,0,1,5
79988,3,2,280267,280267,280269,0,2,2
79989,1,2,280268,280269,280271,1,3,0
79990,2,2,280270,280271,280273,1,3,0
79991,2,1,280272,280273,280274,1,2,0
79992,2,2,280274,280274,280276,0,2,0
79993,3,1,280277,280277,280278,0,1,1
79994,2,1,280279,280279,280280,0,1,1
79995,3,2,280282,280282,280284,0,2,2
79996,1,2,280283,280284,280286,1,3,0
79997,4,2,280287,280287,280289,0,2,1
79998,1,3,280288,280289,280292,1,4,0
79999,2,1,280290,280292,280293,2,3,0
80000,5,3,280295,280295,280298,0,3,2
80001,2,2,280297,280298,280300,1,3,0
80002,4,2,280301,280301,280303,0,2,1
80003,1,3,280302,280303,280306,1,4,0
80004,1,1,280303,280306,280307,3,4,0
80005,2,1,280305,280307,280308,2,3,0
80006,6,1,280311,280311,280312,0,1,3
80007,5,1,280316,280316,280317,0,1,4
80008,2,2,280318,280318,280320,0,2,1
80009,6,2,280324,280324,280326,0,2,4
80010,5,2,280329,280329,280331,0,2,3
80011,5,2,280334,280334,280336,0,2,3
80012,2,1,280336,280336,280337,0,1,0
80013,3,3,280339,280339,280342,0,3,2
80014,5,2,280344,280344,280346,0,2,2
80015,4,1,280348,280348,280349,0,1,2
80016,1,2,280349,280349,280351,0,2,0
80017,6,3,280355,280355,280358,0,3,4
80018,4,2,280359,280359,280361,0,2,1
80019,3,1,280362,280362,280363,0,1,1
80020,4,3,280366,280366,280369,0,3,3
80021,6,2,280372,280372,280374,0,2,3
80022,6,3,280378,280378,280381,0,3,4
80023,1,1,280379,280381,280382,2,3,0
80024,2,3,280381,280382,280385,1,4,0
80025,6,1,280387,280387,280388,0,1,2
80026,5,3,280392,280392,280395,0,3,4
80027,2,1,280394,280395,280396,1,2,0
80028,2,3,280396,280396,280399,0,3,0
80029,3,1,280399,280399,280400,0,1,0
80030,4,2,280403,280403,280405,0,2,3
80031,5,3,280408,280408,280411,0,3,3
80032,4,1,280412,280412,280413,0,1,1
80033,6,3,280418,280418,280421,0,3,5
80034,4,3,280422,280422,280425,0,3,1
80035,6,2,280428,280428,280430,0,2,3
80036,3,2,280431,280431,280433,0,2,1
80037,5,1,280436,280436,280437,0,1,3
80038,6,2,280442,280442,280444,0,2,5
80039,2,2,280444,280444,280446,0,2,0
80040,6,2,280450,280450,280452,0,2,4
80041,1,1,280451,280452,280453,1,2,0
80042,6,2,280457,280457,280459,0,2,4
80043,1,2,280458,280459,280461,1,3,0
80044,4,1,280462,280462,280463,0,1,1
80045,5,3,280467,280467,280470,0,3,4
80046,1,3,280468,280470,280473,2,5,0
80047,1,1,280469,280473,280474,4,5,0
80048,5,3,280474,280474,280477,0,3,0
80049,1,2,280475,280477,280479,2,4,0
80050,4,2,280479,280479,280481,0,2,0
80051,6,3,280485,280485,280488,0,3,4
80052,2,3,280487,280488,280491,1,4,0
80053,6,2,280493,280493,280495,0,2,2
80054,2,3,280495,280495,280498,0,3,0
80055,1,1,280496,280498,280499,2,3,0
80056,1,1,280497,280499,280500,2,3,0
80057,5,2,280502,280502,280504,0,2,2
80058,1,2,280503,280504,280506,1,3,0
80059,5,1,280508,280508,280509,0,1,2
80060,2,1,280510,280510,280511,0,1,1
80061,3,1,280513,280513,280514,0,1,2
80062,2,3,280515,280515,280518,0,3,1
80063,2,3,280517,280518,280521,1,4,0
80064,1,2,280518,280521,280523,3,5,0
80065,6,3,280524,280524,280527,0,3,1
80066,3,2,280527,280527,280529,0,2,0
80067,2,1,280529,280529,280530,0,1,0
80068,3,1,280532,280532,280533,0,1,2
80069,3,3,280535,280535,280538,0,3,2
80070,6,3,280541,280541,280544,0,3,3
80071,6,1,280547,280547,280548,0,1,3
80072,5,2,280552,280552,280554,0,2,4
80073,6,2,280558,280558,280560,0,2,4
80074,2,2,280560,280560,280562,0,2,0
80075,4,2,280564,280564,280566,0,2,2
80076,4,1,280568,280568,280569,0,1,2
80077,1,3,280569,280569,280572,0,3,0
80078,4,1,280573,280573,280574,0,1,1
80079,3,2,280576,280576,280578,0,2,2
80080,3,2,280579,280579,280581,0,2,1
80081,5,3,280584,280584,280587,0,3,3
80082,1,2,280585,280587,280589,2,4,0
80083,3,1,280588,280589,280590,1,2,0
80084,5,2,280593,280593,280595,0,2,3
80085,6,3,280599,280599,280602,0,3,4
80086,3,3,280602,280602,280605,0,3,0
80087,3,2,280605,280605,280607,0,2,0
80088,6,3,280611,280611,280614,0,3,4
80089,3,3,280614,280614,280617,0,3,0
80090,6,3,280620,280620,280623,0,3,3
80091,2,3,280622,280623,280626,1,4,0
80092,3,1,280625,280626,280627,1,2,0
80093,2,1,280627,280627,280628,0,1,0
80094,6,1,280633,280633,280634,0,1,5
80095,6,3,280639,280639,280642,0,3,5
80096,1,3,280640,280642,280645,2,5,0
80097,2,3,280642,280645,280648,3,6,0
80098,1,3,280643,280648,280651,5,8,0
80099,1,2,280644,280651,280653,7,9,0
80100,6,3,280650,280653,280656,3,6,0
80101,2,3,280652,280656,280659,4,7,0
80102,4,1,280656,280659,280660,3,4,0
80103,4,1,280660,280660,280661,0,1,0
80104,6,1,280666,280666,280667,0,1,5
80105,3,2,280669,280669,280671,0,2,2
80106,3,2,280672,280672,280674,0,2,1
80107,3,2,280675,280675,280677,0,2,1
80108,5,3,280680,280680,280683,0,3,3
80109,2,3,280682,280683,280686,1,4,0
80110,4,1,280686,280686,280687,0,1,0
80111,4,2,280690,280690,280692,0,2,3
80112,1,2,280691,280692,280694,1,3,0
80113,5,2,280696,280696,280698,0,2,2
80114,3,3,280699,280699,280702,0,3,1
80115,1,3,280700,280702,280705,2,5,0
80116,5,3,280705,280705,280708,0,3,0
80117,3,1,280708,280708,280709,0,1,0
80118,5,3,280713,280713,280716,0,3,4
80119,6,3,280719,280719,280722,0,3,3
80120,6,1,280725,280725,280726,0,1,3
80121,2,3,280727,280727,280730,0,3,1
80122,4,1,280731,280731,280732,0,1,1
80123,2,1,280733,280733,280734,0,1,1
80124,2,3,280735,280735,280738,0,3,1
80125,5,3,280740,280740,280743,0,3,2
80126,4,3,280744,280744,280747,0,3,1
80127,3,3,280747,280747,280750,0,3,0
80128,6,1,280753,280753,280754,0,1,3
80129,5,1,280758,280758,280759,0,1,4
80130,2,1,280760,280760,280761,0,1,1
80131,4,2,280764,280764,280766,0,2,3
80132,3,2,280767,280767,280769,0,2,1
80133,6,1,280773,280773,280774,0,1,4
80134,1,1,280774,280774,280775,0,1,0
80135,6,2,280780,280780,280782,0,2,5
80136,5,2,280785,280785,280787,0,2,3
80137,5,3,280790,280790,280793,0,3,3
80138,5,2,280795,280795,280797,0,2,2
80139,2,2,280797,280797,280799,0,2,0
80140,3,2,280800,280800,280802,0,2,1
80141,1,3,280801,280802,280805,1,4,0
80142,4,2,280805,280805,280807,0,2,0
80143,2,2,280807,280807,280809,0,2,0
80144,4,2,280811,280811,280813,0,2,2
80145,6,1,280817,280817,280818,0,1,4
80146,1,1,280818,280818,280819,0,1,0
80147,6,1,280824,280824,280825,0,1,5
80148,4,2,280828,280828,280830,0,2,3
80149,4,3,280832,280832,280835,0,3,2
80150,6,1,280838,280838,280839,0,1,3
80151,4,2,280842,280842,280844,0,2,3
80152,4,3,280846,280846,280849,0,3,2
80153,1,1,280847,280849,280850,2,3,0
80154,5,3,280852,280852,280855,0,3,2
80155,4,1,280856,280856,280857,0,1,1
80156,6,1,280862,280862,280863,0,1,5
80157,3,1,280865,280865,280866,0,1,2
80158,4,2,280869,280869,280871,0,2,3
80159,2,2,280871,280871,280873,0,2,0
80160,2,1,280873,280873,280874,0,1,0
80161,1,3,280874,280874,280877,0,3,0
80162,6,3,280880,280880,280883,0,3,3
80163,1,3,280881,280883,280886,2,5,0
80164,5,2,280886,280886,280888,0,2,0
80165,2,2,280888,280888,280890,0,2,0
80166,4,1,280892,280892,280893,0,1,2
80167,3,3,280895,280895,280898,0,3,2
80168,5,3,280900,280900,280903,0,3,2
80169,3,2,280903,280903,280905,0,2,0
80170,1,1,280904,280905,280906,1,2,0
80171,2,1,280906,280906,280907,0,1,0
80172,5,1,280911,280911,280912,0,1,4
80173,6,2,280917,280917,280919,0,2,5
80174,4,1,280921,280921,280922,0,1,2
80175,1,3,280922,280922,280925,0,3,0
80176,2,3,280924,280925,280928,1,4,0
80177,1,2,280925,280928,280930,3,5,0
80178,4,3,280929,280930,280933,1,4,0
80179,5,2,280934,280934,280936,0,2,1
80180,1,3,280935,280936,280939,1,4,0
80181,6,2,280941,280941,280943,0,2,2
80182,6,3,280947,280947,280950,0,3,4
80183,5,1,280952,280952,280953,0,1,2
80184,5,2,280957,280957,280959,0,2,4
80185,6,1,280963,280963,280964,0,1,4
80186,4,2,280967,280967,280969,0,2,3
80187,1,1,280968,280969,280970,1,2,0
80188,5,1,280973,280973,280974,0,1,3
80189,1,3,280974,280974,280977,0,3,0
80190,4,2,280978,280978,280980,0,2,1
80191,5,2,280983,280983,280985,0,2,3
80192,4,3,280987,280987,280990,0,3,2
80193,2,3,280989,280990,280993,1,4,0
80194,5,1,280994,280994,280995,0,1,1
80195,2,1,280996,280996,280997,0,1,1
80196,6,2,281002,281002,281004,0,2,5
80197,1,3,281003,281004,281007,1,4,0
80198,4,3,281007,281007,281010,0,3,0
80199,3,1,281010,281010,281011,0,1,0
80200,5,3,281015,281015,281018,0,3,4
80201,6,3,281021,281021,281024,0,3,3
80202,2,2,281023,281024,281026,1,3,0
80203,2,1,281025,281026,281027,1,2,0
80204,3,1,281028,281028,281029,0,1,1
80205,3,3,281031,281031,281034,0,3,2
80206,3,1,281034,281034,281035,0,1,0
80207,5,3,281039,281039,281042,0,3,4
80208,5,1,281044,281044,281045,0,1,2
80209,6,1,281050,281050,281051,0,1,5
80210,2,1,281052,281052,281053,0,1,1
80211,3,3,281055,281055,281058,0,3,2
80212,2,3,281057,281058,281061,1,4,0
80213,4,3,281061,281061,281064,0,3,0
80214,4,3,281065,281065,281068,0,3,1
80215,1,1,281066,281068,281069,2,3,0
80216,2,2,281068,281069,281071,1,3,0
80217,4,1,281072,281072,281073,0,1,1
80218,4,3,281076,281076,281079,0,3,3
80219,4,1,281080,281080,281081,0,1,1
80220,6,1,281086,281086,281087,0,1,5
80221,5,1,281091,281091,281092,0,1,4
80222,5,3,281096,281096,281099,0,3,4
80223,1,2,281097,281099,281101,2,4,0
80224,5,1,281102,281102,281103,0,1,1
80225,2,2,281104,281104,281106,0,2,1
80226,1,1,281105,281106,281107,1,2,0
80227,2,2,281107,281107,281109,0,2,0
80228,6,2,281113,281113,281115,0,2,4
80229,1,1,281114,281115,281116,1,2,0
80230,5,1,281119,281119,281120,0,1,3
80231,4,3,281123,281123,281126,0,3,3
80232,1,2,281124,281126,281128,2,4,0
80233,1,2,281125,281128,281130,3,5,0
80234,1,2,281126,281130,281132,4,6,0
80235,6,1,281132,281132,281133,0,1,0
80236,5,2,281137,281137,281139,0,2,4
80237,6,3,281143,281143,281146,0,3,4
80238,1,1,281144,281146,281147,2,3,0
80239,4,1,281148,281148,281149,0,1,1
80240,4,2,281152,281152,281154,0,2,3
80241,2,1,281154,281154,281155,0,1,0
80242,4,3,281158,281158,281161,0,3,3
80243,4,2,281162,281162,281164,0,2,1
80244,4,1,281166,281166,281167,0,1,2
80245,6,1,281172,281172,281173,0,1,5
80246,5,2,281177,281177,281179,0,2,4
80247,4,1,281181,281181,281182,0,1,2
80248,1,3,281182,281182,281185,0,3,0
80249,3,3,281185,281185,281188,0,3,0
80250,5,1,281190,281190,281191,0,1,2
80251,6,2,281196,281196,281198,0,2,5
80252,1,2,281197,281198,281200,1,3,0
80253,2,1,281199,281200,281201,1,2,0
80254,2,3,281201,281201,281204,0,3,0
80255,3,3,281204,281204,281207,0,3,0
80256,4,2,281208,281208,281210,0,2,1
80257,1,3,281209,281210,281213,1,4,0
80258,2,1,281211,281213,281214,2,3,0
80259,3,2,281214,281214,281216,0,2,0
80260,6,3,281220,281220,281223,0,3,4
80261,4,2,281224,281224,281226,0,2,1
80262,4,3,281228,281228,281231,0,3,2
80263,6,2,281234,281234,281236,0,2,3
80264,6,3,281240,281240,281243,0,3,4
80265,5,1,281245,281245,281246,0,1,2
80266,1,3,281246,281246,281249,0,3,0
80267,5,1,281251,281251,281252,0,1,2
80268,5,2,281256,281256,281258,0,2,4
80269,6,2,281262,281262,281264,0,2,4
80270,6,3,281268,281268,281271,0,3,4
80271,2,2,281270,281271,281273,1,3,0
80272,4,2,281274,281274,281276,0,2,1
80273,4,3,281278,281278,281281,0,3,2
80274,2,3,281280,281281,281284,1,4,0
80275,1,2,281281,281284,281286,3,5,0
80276,6,1,281287,281287,281288,0,1,1
80277,3,3,281290,281290,281293,0,3,2
80278,1,2,281291,281293,281295,2,4,0
80279,6,2,281297,281297,281299,0,2,2
80280,4,2,281301,281301,281303,0,2,2
80281,2,1,281303,281303,281304,0,1,0
80282,3,1,281306,281306,281307,0,1,2
80283,5,1,281311,281311,281312,0,1,4
80284,6,3,281317,281317,281320,0,3,5
80285,5,2,281322,281322,281324,0,2,2
80286,2,2,281324,281324,281326,0,2,0
80287,6,1,281330,281330,281331,0,1,4
80288,6,2,281336,281336,281338,0,2,5
80289,1,1,281337,281338,281339,1,2,0
80290,6,3,281343,281343,281346,0,3,4
80291,5,1,281348,281348,281349,0,1,2
80292,4,2,281352,281352,281354,0,2,3
80293,1,3,281353,281354,281357,1,4,0
80294,3,2,281356,281357,281359,1,3,0
80295,6,3,281362,281362,281365,0,3,3
80296,4,2,281366,281366,281368,0,2,1
80297,3,1,281369,281369,281370,0,1,1
80298,3,3,281372,281372,281375,0,3,2
80299,3,1,281375,281375,281376,0,1,0
80300,5,2,281380,281380,281382,0,2,4
80301,5,3,281385,281385,281388,0,3,3
80302,2,2,281387,281388,281390,1,3,0
80303,2,3,281389,281390,281393,1,4,0
80304,4,2,281393,281393,281395,0,2,0
80305,1,2,281394,281395,281397,1,3,0
80306,6,2,281400,281400,281402,0,2,3
80307,3,2,281403,281403,281405,0,2,1
80308,1,1,281404,281405,281406,1,2,0
80309,4,3,281408,281408,281411,0,3,2
80310,1,1,281409,281411,281412,2,3,0
80311,5,2,281414,281414,281416,0,2,2
80312,3,2,281417,281417,281419,0,2,1
80313,4,2,281421,281421,281423,0,2,2
80314,1,3,281422,281423,281426,1,4,0
80315,1,1,281423,281426,281427,3,4,0
80316,1,3,281424,281427,281430,3,6,0
80317,5,1,281429,281430,281431,1,2,0
80318,4,1,281433,281433,281434,0,1,2
80319,1,3,281434,281434,281437,0,3,0
80320,2,2,281436,281437,281439,1,3,0
80321,1,2,281437,281439,281441,2,4,0
80322,3,3,281440,281441,281444,1,4,0
80323,3,3,281443,281444,281447,1,4,0
80324,3,1,281446,281447,281448,1,2,0
80325,5,1,281451,281451,281452,0,1,3
80326,3,2,281454,281454,281456,0,2,2
80327,4,2,281458,281458,281460,0,2,2
80328,1,1,281459,281460,281461,1,2,0
80329,2,3,281461,281461,281464,0,3,0
80330,6,1,281467,281467,281468,0,1,3
80331,3,2,281470,281470,281472,0,2,2
80332,6,2,281476,281476,281478,0,2,4
80333,5,3,281481,281481,281484,0,3,3
80334,2,1,281483,281484,281485,1,2,0
80335,4,1,281487,281487,281488,0,1,2
80336,1,2,281488,281488,281490,0,2,0
80337,6,1,281494,281494,281495,0,1,4
80338,3,1,281497,281497,281498,0,1,2
80339,5,2,281502,281502,281504,0,2,4
80340,4,1,281506,281506,281507,0,1,2
80341,4,3,281510,281510,281513,0,3,3
80342,3,2,281513,281513,281515,0,2,0
80343,3,1,281516,281516,281517,0,1,1
80344,5,3,281521,281521,281524,0,3,4
80345,6,2,281527,281527,281529,0,2,3
80346,3,2,281530,281530,281532,0,2,1
80347,4,3,281534,281534,281537,0,3,2
80348,3,2,281537,281537,281539,0,2,0
80349,1,2,281538,281539,281541,1,3,0
80350,4,2,281542,281542,281544,0,2,1
80351,5,3,281547,281547,281550,0,3,3
80352,5,1,281552,281552,281553,0,1,2
80353,2,1,281554,281554,281555,0,1,1
80354,1,2,281555,281555,281557,0,2,0
80355,1,1,281556,281557,281558,1,2,0
80356,3,2,281559,281559,281561,0,2,1
80357,5,1,281564,281564,281565,0,1,3
80358,3,2,281567,281567,281569,0,2,2
80359,2,2,281569,281569,281571,0,2,0
80360,3,3,281572,281572,281575,0,3,1
80361,6,2,281578,281578,281580,0,2,3
80362,4,3,281582,281582,281585,0,3,2
80363,4,2,281586,281586,281588,0,2,1
80364,5,1,281591,281591,281592,0,1,3
80365,3,2,281594,281594,281596,0,2,2
80366,1,2,281595,281596,281598,1,3,0
80367,1,3,281596,281598,281601,2,5,0
80368,5,1,281601,281601,281602,0,1,0
80369,2,3,281603,281603,281606,0,3,1
80370,2,1,281605,281606,281607,1,2,0
80371,3,1,281608,281608,281609,0,1,1
80372,2,2,281610,281610,281612,0,2,1
80373,6,2,281616,281616,281618,0,2,4
80374,6,3,281622,281622,281625,0,3,4
80375,5,2,281627,281627,281629,0,2,2
80376,4,3,281631,281631,281634,0,3,2
80377,6,1,281637,281637,281638,0,1,3
80378,5,1,281642,281642,281643,0,1,4
80379,5,1,281647,281647,281648,0,1,4
80380,1,1,281648,281648,281649,0,1,0
80381,5,1,281653,281653,281654,0,1,4
80382,5,2,281658,281658,281660,0,2,4
80383,3,3,281661,281661,281664,0,3,1
80384,6,2,281667,281667,281669,0,2,3
80385,4,2,281671,281671,281673,0,2,2
80386,5,3,281676,281676,281679,0,3,3
80387,2,3,281678,281679,281682,1,4,0
80388,6,1,281684,281684,281685,0,1,2
80389,3,3,281687,281687,281690,0,3,2
80390,4,1,281691,281691,281692,0,1,1
80391,6,1,281697,281697,281698,0,1,5
80392,4,3,281701,281701,281704,0,3,3
80393,4,2,281705,281705,281707,0,2,1
80394,3,1,281708,281708,281709,0,1,1
80395,2,1,281710,281710,281711,0,1,1
80396,2,2,281712,281712,281714,0,2,1
80397,4,2,281716,281716,281718,0,2,2
80398,3,1,281719,281719,281720,0,1,1
80399,6,1,281725,281725,281726,0,1,5
80400,6,1,281731,281731,281732,0,1,5
80401,1,2,281732,281732,281734,0,2,0
80402,5,2,281737,281737,281739,0,2,3
80403,1,2,281738,281739,281741,1,3,0
80404,6,3,281744,281744,281747,0,3,3
80405,4,3,281748,281748,281751,0,3,1
80406,1,1,281749,281751,281752,2,3,0
80407,5,2,281754,281754,281756,0,2,2
80408,2,2,281756,281756,281758,0,2,0
80409,5,2,281761,281761,281763,0,2,3
80410,2,2,281763,281763,281765,0,2,0
80411,4,2,281767,281767,281769,0,2,2
80412,6,1,281773,281773,281774,0,1,4
80413,5,1,281778,281778,281779,0,1,4
80414,3,3,281781,281781,281784,0,3,2
80415,1,3,281782,281784,281787,2,5,0
80416,2,3,281784,281787,281790,3,6,0
80417,2,2,281786,281790,281792,4,6,0
80418,2,1,281788,281792,281793,4,5,0
80419,2,1,281790,281793,281794,3,4,0
80420,3,3,281793,281794,281797,1,4,0
80421,4,2,281797,281797,281799,0,2,0
80422,3,1,281800,281800,281801,0,1,1
80423,3,1,281803,281803,281804,0,1,2
80424,5,1,281808,281808,281809,0,1,4
80425,3,2,281811,281811,281813,0,2,2
80426,3,1,281814,281814,281815,0,1,1
80427,3,3,281817,281817,281820,0,3,2
80428,1,2,281818,281820,281822,2,4,0
80429,4,3,281822,281822,281825,0,3,0
80430,6,2,281828,281828,281830,0,2,3
80431,2,1,281830,281830,281831,0,1,0
80432,1,1,281831,281831,281832,0,1,0
80433,5,2,281836,281836,281838,0,2,4
80434,1,3,281837,281838,281841,1,4,0
80435,3,3,281840,281841,281844,1,4,0
80436,2,2,281842,281844,281846,2,4,0
80437,3,1,281845,281846,281847,1,2,0
80438,1,1,281846,281847,281848,1,2,0
80439,3,2,281849,281849,281851,0,2,1
80440,3,1,281852,281852,281853,0,1,1
80441,4,3,281856,281856,281859,0,3,3
80442,4,1,281860,281860,281861,0,1,1
80443,6,3,281866,281866,281869,0,3,5
80444,3,2,281869,281869,281871,0,2,0
80445,2,1,281871,281871,281872,0,1,0
80446,3,2,281874,281874,281876,0,2,2
80447,3,2,281877,281877,281879,0,2,1
80448,3,1,281880,281880,281881,0,1,1
80449,2,1,281882,281882,281883,0,1,1
80450,1,1,281883,281883,281884,0,1,0
80451,1,1,281884,281884,281885,0,1,0
80452,1,3,281885,281885,281888,0,3,0
80453,2,2,281887,281888,281890,1,3,0
80454,4,1,281891,281891,281892,0,1,1
80455,1,2,281892,281892,281894,0,2,0
80456,3,2,281895,281895,281897,0,2,1
80457,1,2,281896,281897,281899,1,3,0
80458,3,2,281899,281899,281901,0,2,0
80459,3,3,281902,281902,281905,0,3,1
80460,4,3,281906,281906,281909,0,3,1
80461,6,2,281912,281912,281914,0,2,3
80462,2,1,281914,281914,281915,0,1,0
80463,3,3,281917,281917,281920,0,3,2
80464,6,1,281923,281923,281924,0,1,3
80465,4,2,281927,281927,281929,0,2,3
80466,1,1,281928,281929,281930,1,2,0
80467,5,2,281933,281933,281935,0,2,3
80468,6,1,281939,281939,281940,0,1,4
80469,4,2,281943,281943,281945,0,2,3
80470,4,2,281947,281947,281949,0,2,2
80471,1,2,281948,281949,281951,1,3,0
80472,6,2,281954,281954,281956,0,2,3
80473,2,1,281956,281956,281957,0,1,0
80474,4,1,281960,281960,281961,0,1,3
80475,1,2,281961,281961,281963,0,2,0
80476,4,3,281965,281965,281968,0,3,2
80477,1,3,281966,281968,281971,2,5,0
80478,5,1,281971,281971,281972,0,1,0
80479,6,1,281977,281977,281978,0,1,5
80480,4,3,281981,281981,281984,0,3,3
80481,3,3,281984,281984,281987,0,3,0
80482,6,3,281990,281990,281993,0,3,3
80483,3,2,281993,281993,281995,0,2,0
80484,2,2,281995,281995,281997,0,2,0
80485,3,1,281998,281998,281999,0,1,1
80486,2,1,282000,282000,282001,0,1,1
80487,3,2,282003,282003,282005,0,2,2
80488,5,2,282008,282008,282010,0,2,3
80489,1,3,282009,282010,282013,1,4,0
80490,2,3,282011,282013,282016,2,5,0
80491,6,2,282017,282017,282019,0,2,1
80492,1,3,282018,282019,282022,1,4,0
80493,4,3,282022,282022,282025,0,3,0
80494,1,1,282023,282025,282026,2,3,0
80495,5,3,282028,282028,282031,0,3,2
80496,3,2,282031,282031,282033,0,2,0
80497,2,3,282033,282033,282036,0,3,0
80498,5,1,282038,282038,282039,0,1,2
80499,2,3,282040,282040,282043,0,3,1
80500,4,1,282044,282044,282045,0,1,1
80501,6,2,282050,282050,282052,0,2,5
80502,2,2,282052,282052,282054,0,2,0
80503,5,1,282057,282057,282058,0,1,3
80504,3,3,282060,282060,282063,0,3,2
80505,5,3,282065,282065,282068,0,3,2
80506,3,1,282068,282068,282069,0,1,0
80507,1,2,282069,282069,282071,0,2,0
80508,5,1,282074,282074,282075,0,1,3
80509,1,1,282075,282075,282076,0,1,0
80510,5,1,282080,282080,282081,0,1,4
80511,6,3,282086,282086,282089,0,3,5
80512,6,1,282092,282092,282093,0,1,3
80513,3,2,282095,282095,282097,0,2,2
80514,2,3,282097,282097,282100,0,3,0
80515,6,1,282103,282103,282104,0,1,3
80516,5,1,282108,282108,282109,0,1,4
80517,5,3,282113,282113,282116,0,3,4
80518,3,2,282116,282116,282118,0,2,0
80519,1,3,282117,282118,282121,1,4,0
80520,2,3,282119,282121,282124,2,5,0
80521,6,1,282125,282125,282126,0,1,1
80522,5,2,282130,282130,282132,0,2,4
80523,5,1,282135,282135,282136,0,1,3
80524,2,3,282137,282137,282140,0,3,1
80525,3,1,282140,282140,282141,0,1,0
80526,1,2,282141,282141,282143,0,2,0
80527,6,3,282147,282147,282150,0,3,4
80528,3,1,282150,282150,282151,0,1,0
80529,2,1,282152,282152,282153,0,1,1
80530,1,2,282153,282153,282155,0,2,0
80531,2,3,282155,282155,282158,0,3,0
80532,1,3,282156,282158,282161,2,5,0
80533,5,3,282161,282161,282164,0,3,0
80534,4,1,282165,282165,282166,0,1,1
80535,2,3,282167,282167,282170,0,3,1
80536,3,2,282170,282170,282172,0,2,0
80537,4,3,282174,282174,282177,0,3,2
80538,4,3,282178,282178,282181,0,3,1
80539,6,1,282184,282184,282185,0,1,3
80540,2,1,282186,282186,282187,0,1,1
80541,5,1,282191,282191,282192,0,1,4
80542,2,2,282193,282193,282195,0,2,1
80543,1,1,282194,282195,282196,1,2,0
80544,3,2,282197,282197,282199,0,2,1
80545,2,3,282199,282199,282202,0,3,0
80546,2,3,282201,282202,282205,1,4,0
80547,4,1,282205,282205,282206,0,1,0
80548,1,2,282206,282206,282208,0,2,0
80549,2,2,282208,282208,282210,0,2,0
80550,1,3,282209,282210,282213,1,4,0
80551,2,1,282211,282213,282214,2,3,0
80552,6,1,282217,282217,282218,0,1,3
80553,3,3,282220,282220,282223,0,3,2
80554,3,2,282223,282223,282225,0,2,0
80555,6,3,282229,282229,282232,0,3,4
80556,2,2,282231,282232,282234,1,3,0
80557,5,1,282236,282236,282237,0,1,2
80558,2,2,282238,282238,282240,0,2,1
80559,6,2,282244,282244,282246,0,2,4
80560,5,3,282249,282249,282252,0,3,3
80561,5,3,282254,282254,282257,0,3,2
80562,4,3,282258,282258,282261,0,3,1
80563,5,3,282263,282263,282266,0,3,2
80564,6,1,282269,282269,282270,0,1,3
80565,2,3,282271,282271,282274,0,3,1
80566,5,1,282276,282276,282277,0,1,2
80567,3,1,282279,282279,282280,0,1,2
80568,4,3,282283,282283,282286,0,3,3
80569,3,3,282286,282286,282289,0,3,0
80570,5,2,282291,282291,282293,0,2,2
80571,6,2,282297,282297,282299,0,2,4
80572,6,1,282303,282303,282304,0,1,4
80573,2,1,282305,282305,282306,0,1,1
80574,2,2,282307,282307,282309,0,2,1
80575,6,2,282313,282313,282315,0,2,4
80576,6,2,282319,282319,282321,0,2,4
80577,1,1,282320,282321,282322,1,2,0
80578,2,1,282322,282322,282323,0,1,0
80579,4,3,282326,282326,282329,0,3,3
80580,6,3,282332,282332,282335,0,3,3
80581,5,1,282337,282337,282338,0,1,2
80582,4,3,282341,282341,282344,0,3,3
80583,6,2,282347,282347,282349,0,2,3
80584,5,3,282352,282352,282355,0,3,3
80585,6,1,282358,282358,282359,0,1,3
80586,2,1,282360,282360,282361,0,1,1
80587,3,3,282363,282363,282366,0,3,2
80588,1,1,282364,282366,282367,2,3,0
80589,5,1,282369,282369,282370,0,1,2
80590,2,1,282371,282371,282372,0,1,1
80591,4,1,282375,282375,282376,0,1,3
80592,6,1,282381,282381,282382,0,1,5
80593,3,3,282384,282384,282387,0,3,2
80594,6,1,282390,282390,282391,0,1,3
80595,5,1,282395,282395,282396,0,1,4
80596,4,3,282399,282399,282402,0,3,3
80597,2,1,282401,282402,282403,1,2,0
80598,1,3,282402,282403,282406,1,4,0
80599,5,1,282407,282407,282408,0,1,1
80600,3,3,282410,282410,282413,0,3,2
80601,2,2,282412,282413,282415,1,3,0
80602,2,2,282414,282415,282417,1,3,0
80603,2,1,282416,282417,282418,1,2,0
80604,5,1,282421,282421,282422,0,1,3
80605,5,3,282426,282426,282429,0,3,4
80606,3,3,282429,282429,282432,0,3,0
80607,1,1,282430,282432,282433,2,3,0
80608,6,1,282436,282436,282437,0,1,3
80609,2,1,282438,282438,282439,0,1,1
80610,3,3,282441,282441,282444,0,3,2
80611,2,3,282443,282444,282447,1,4,0
80612,4,3,282447,282447,282450,0,3,0
80613,2,2,282449,282450,282452,1,3,0
80614,2,3,282451,282452,282455,1,4,0
80615,3,1,282454,282455,282456,1,2,0
80616,2,2,282456,282456,282458,0,2,0
80617,2,2,282458,282458,282460,0,2,0
80618,3,3,282461,282461,282464,0,3,1
80619,4,2,282465,282465,282467,0,2,1
80620,2,3,282467,282467,282470,0,3,0
80621,3,1,282470,282470,282471,0,1,0
80622,3,3,282473,282473,282476,0,3,2
80623,5,2,282478,282478,282480,0,2,2
80624,4,1,282482,282482,282483,0,1,2
80625,4,1,282486,282486,282487,0,1,3
80626,3,2,282489,282489,282491,0,2,2
80627,3,3,282492,282492,282495,0,3,1
80628,6,2,282498,282498,282500,0,2,3
80629,4,2,282502,282502,282504,0,2,2
80630,4,1,282506,282506,282507,0,1,2
80631,5,1,282511,282511,282512,0,1,4
80632,3,2,282514,282514,282516,0,2,2
80633,6,2,282520,282520,282522,0,2,4
80634,4,1,282524,282524,282525,0,1,2
80635,1,1,282525,282525,282526,0,1,0
80636,6,2,282531,282531,282533,0,2,5
80637,2,3,282533,282533,282536,0,3,0
80638,5,1,282538,282538,282539,0,1,2
80639,5,2,282543,282543,282545,0,2,4
80640,4,2,282547,282547,282549,0,2,2
80641,6,2,282553,282553,282555,0,2,4
80642,2,1,282555,282555,282556,0,1,0
80643,1,3,282556,282556,282559,0,3,0
80644,4,2,282560,282560,282562,0,2,1
80645,2,3,282562,282562,282565,0,3,0
80646,3,1,282565,282565,282566,0,1,0
80647,1,1,282566,282566,282567,0,1,0
80648,4,1,282570,282570,282571,0,1,3
80649,1,1,282571,282571,282572,0,1,0
80650,2,1,282573,282573,282574,0,1,1
80651,5,3,282578,282578,282581,0,3,4
80652,6,3,282584,282584,282587,0,3,3
80653,4,3,282588,282588,282591,0,3,1
80654,4,3,282592,282592,282595,0,3,1
80655,3,2,282595,282595,282597,0,2,0
80656,3,2,282598,282598,282600,0,2,1
80657,3,1,282601,282601,282602,0,1,1
80658,2,3,282603,282603,282606,0,3,1
80659,4,1,282607,282607,282608,0,1,1
80660,4,1,282611,282611,282612,0,1,3
80661,1,2,282612,282612,282614,0,2,0
80662,2,1,282614,282614,282615,0,1,0
80663,6,1,282620,282620,282621,0,1,5
80664,6,2,282626,282626,282628,0,2,5
80665,3,1,282629,282629,282630,0,1,1
80666,4,1,282633,282633,282634,0,1,3
80667,4,2,282637,282637,282639,0,2,3
80668,4,1,282641,282641,282642,0,1,2
80669,6,1,282647,282647,282648,0,1,5
80670,3,2,282650,282650,282652,0,2,2
80671,3,3,282653,282653,282656,0,3,1
80672,1,3,282654,282656,282659,2,5,0
80673,4,1,282658,282659,282660,1,2,0
80674,4,1,282662,282662,282663,0,1,2
80675,5,2,282667,282667,282669,0,2,4
80676,3,3,282670,282670,282673,0,3,1
80677,2,2,282672,282673,282675,1,3,0
80678,2,3,282674,282675,282678,1,4,0
80679,4,2,282678,282678,282680,0,2,0
80680,4,3,282682,282682,282685,0,3,2
80681,3,2,282685,282685,282687,0,2,0
80682,1,1,282686,282687,282688,1,2,0
80683,4,2,282690,282690,282692,0,2,2
80684,2,2,282692,282692,282694,0,2,0
80685,3,1,282695,282695,282696,0,1,1
80686,5,1,282700,282700,282701,0,1,4
80687,1,2,282701,282701,282703,0,2,0
80688,3,3,282704,282704,282707,0,3,1
80689,6,1,282710,282710,282711,0,1,3
80690,4,3,282714,282714,282717,0,3,3
80691,4,3,282718,282718,282721,0,3,1
80692,5,1,282723,282723,282724,0,1,2
80693,4,1,282727,282727,282728,0,1,3
80694,1,1,282728,282728,282729,0,1,0
80695,3,2,282731,282731,282733,0,2,2
80696,6,2,282737,282737,282739,0,2,4
80697,4,2,282741,282741,282743,0,2,2
80698,2,2,282743,282743,282745,0,2,0
80699,4,2,282747,282747,282749,0,2,2
80700,3,2,282750,282750,282752,0,2,1
80701,2,2,282752,282752,282754,0,2,0
80702,1,1,282753,282754,282755,1,2,0
80703,6,1,282759,282759,282760,0,1,4
80704,1,3,282760,282760,282763,0,3,0
80705,5,2,282765,282765,282767,0,2,2
80706,1,2,282766,282767,282769,1,3,0
80707,6,2,282772,282772,282774,0,2,3
80708,2,1,282774,282774,282775,0,1,0
80709,5,1,282779,282779,282780,0,1,4
80710,5,1,282784,282784,282785,0,1,4
80711,5,1,282789,282789,282790,0,1,4
80712,4,1,282793,282793,282794,0,1,3
80713,4,3,282797,282797,282800,0,3,3
80714,5,2,282802,282802,282804,0,2,2
80715,4,3,282806,282806,282809,0,3,2
80716,4,3,282810,282810,282813,0,3,1
80717,5,1,282815,282815,282816,0,1,2
80718,5,1,282820,282820,282821,0,1,4
80719,4,1,282824,282824,282825,0,1,3
80720,4,2,282828,282828,282830,0,2,3
80721,3,2,282831,282831,282833,0,2,1
80722,6,2,282837,282837,282839,0,2,4
80723,1,1,282838,282839,282840,1,2,0
80724,5,1,282843,282843,282844,0,1,3
80725,3,3,282846,282846,282849,0,3,2
80726,3,1,282849,282849,282850,0,1,0
80727,5,1,282854,282854,282855,0,1,4
80728,6,3,282860,282860,282863,0,3,5
80729,6,3,282866,282866,282869,0,3,3
80730,6,2,282872,282872,282874,0,2,3
80731,5,3,282877,282877,282880,0,3,3
80732,6,3,282883,282883,282886,0,3,3
80733,2,2,282885,282886,282888,1,3,0
80734,4,2,282889,282889,282891,0,2,1
80735,4,2,282893,282893,282895,0,2,2
80736,1,3,282894,282895,282898,1,4,0
80737,3,3,282897,282898,282901,1,4,0
80738,2,1,282899,282901,282902,2,3,0
80739,5,3,282904,282904,282907,0,3,2
80740,6,1,282910,282910,282911,0,1,3
80741,5,1,282915,282915,282916,0,1,4
80742,1,2,282916,282916,282918,0,2,0
80743,2,2,282918,282918,282920,0,2,0
80744,6,3,282924,282924,282927,0,3,4
80745,6,2,282930,282930,282932,0,2,3
80746,4,1,282934,282934,282935,0,1,2
80747,1,1,282935,282935,282936,0,1,0
80748,4,2,282939,282939,282941,0,2,3
80749,6,2,282945,282945,282947,0,2,4
80750,2,2,282947,282947,282949,0,2,0
80751,4,1,282951,282951,282952,0,1,2
80752,4,3,282955,282955,282958,0,3,3
80753,5,2,282960,282960,282962,0,2,2
80754,1,3,282961,282962,282965,1,4,0
80755,2,3,282963,282965,282968,2,5,0
80756,1,1,282964,282968,282969,4,5,0
80757,5,3,282969,282969,282972,0,3,0
80758,1,3,282970,282972,282975,2,5,0
80759,3,2,282973,282975,282977,2,4,0
80760,3,1,282976,282977,282978,1,2,0
80761,3,2,282979,282979,282981,0,2,1
80762,6,2,282985,282985,282987,0,2,4
80763,1,3,282986,282987,282990,1,4,0
80764,2,1,282988,282990,282991,2,3,0
80765,5,3,282993,282993,282996,0,3,2
80766,3,1,282996,282996,282997,0,1,0
80767,1,3,282997,282997,283000,0,3,0
80768,4,3,283001,283001,283004,0,3,1
80769,3,1,283004,283004,283005,0,1,0
80770,4,2,283008,283008,283010,0,2,3
80771,4,1,283012,283012,283013,0,1,2
80772,3,3,283015,283015,283018,0,3,2
80773,4,1,283019,283019,283020,0,1,1
80774,2,3,283021,283021,283024,0,3,1
80775,5,1,283026,283026,283027,0,1,2
80776,6,1,283032,283032,283033,0,1,5
80777,1,2,283033,283033,283035,0,2,0
80778,5,1,283038,283038,283039,0,1,3
80779,3,3,283041,283041,283044,0,3,2
80780,1,2,283042,283044,283046,2,4,0
80781,3,1,283045,283046,283047,1,2,0
80782,4,1,283049,283049,283050,0,1,2
80783,5,2,283054,283054,283056,0,2,4
80784,5,2,283059,283059,283061,0,2,3
80785,1,3,283060,283061,283064,1,4,0
80786,2,2,283062,283064,283066,2,4,0
80787,4,2,283066,283066,283068,0,2,0
80788,2,3,283068,283068,283071,0,3,0
80789,2,3,283070,283071,283074,1,4,0
80790,6,3,283076,283076,283079,0,3,2
80791,4,3,283080,283080,283083,0,3,1
80792,4,3,283084,283084,283087,0,3,1
80793,4,1,283088,283088,283089,0,1,1
80794,1,1,283089,283089,283090,0,1,0
80795,3,3,283092,283092,283095,0,3,2
80796,5,2,283097,283097,283099,0,2,2
80797,1,1,283098,283099,283100,1,2,0
80798,1,3,283099,283100,283103,1,4,0
80799,6,2,283105,283105,283107,0,2,2
80800,4,2,283109,283109,283111,0,2,2
80801,3,2,283112,283112,283114,0,2,1
80802,2,1,283114,283114,283115,0,1,0
80803,6,2,283120,283120,283122,0,2,5
80804,2,2,283122,283122,283124,0,2,0
80805,4,1,283126,283126,283127,0,1,2
80806,1,3,283127,283127,283130,0,3,0
80807,3,3,283130,283130,283133,0,3,0
80808,2,2,283132,283133,283135,1,3,0
80809,3,3,283135,283135,283138,0,3,0
80810,1,3,283136,283138,283141,2,5,0
80811,4,2,283140,283141,283143,1,3,0
80812,4,2,283144,283144,283146,0,2,1
80813,3,2,283147,283147,283149,0,2,1
80814,6,1,283153,283153,283154,0,1,4
80815,2,3,283155,283155,283158,0,3,1
80816,6,1,283161,283161,283162,0,1,3
80817,2,3,283163,283163,283166,0,3,1
80818,4,1,283167,283167,283168,0,1,1
80819,1,3,283168,283168,283171,0,3,0
80820,5,3,283173,283173,283176,0,3,2
80821,2,2,283175,283176,283178,1,3,0
80822,4,2,283179,283179,283181,0,2,1
80823,1,1,283180,283181,283182,1,2,0
80824,1,1,283181,283182,283183,1,2,0
80825,6,3,283187,283187,283190,0,3,4
80826,2,3,283189,283190,283193,1,4,0
80827,2,3,283191,283193,283196,2,5,0
80828,4,1,283195,283196,283197,1,2,0
80829,2,1,283197,283197,283198,0,1,0
80830,1,1,283198,283198,283199,0,1,0
80831,3,1,283201,283201,283202,0,1,2
80832,6,3,283207,283207,283210,0,3,5
80833,5,2,283212,283212,283214,0,2,2
80834,3,1,283215,283215,283216,0,1,1
80835,6,2,283221,283221,283223,0,2,5
80836,1,1,283222,283223,283224,1,2,0
80837,3,3,283225,283225,283228,0,3,1
80838,2,1,283227,283228,283229,1,2,0
80839,4,3,283231,283231,283234,0,3,2
80840,1,3,283232,283234,283237,2,5,0
80841,1,2,283233,283237,283239,4,6,0
80842,1,1,283234,283239,283240,5,6,0
80843,5,1,283239,283240,283241,1,2,0
80844,2,1,283241,283241,283242,0,1,0
80845,3,2,283244,283244,283246,0,2,2
80846,3,1,283247,283247,283248,0,1,1
80847,1,3,283248,283248,283251,0,3,0
80848,2,2,283250,283251,283253,1,3,0
80849,4,2,283254,283254,283256,0,2,1
80850,1,2,283255,283256,283258,1,3,0
80851,4,3,283259,283259,283262,0,3,1
80852,2,1,283261,283262,283263,1,2,0
80853,5,1,283266,283266,283267,0,1,3
80854,3,3,283269,283269,283272,0,3,2
80855,6,3,283275,283275,283278,0,3,3
80856,6,2,283281,283281,283283,0,2,3
80857,1,2,283282,283283,283285,1,3,0
80858,2,1,283284,283285,283286,1,2,0
80859,3,2,283287,283287,283289,0,2,1
80860,6,2,283293,283293,283295,0,2,4
80861,1,2,283294,283295,283297,1,3,0
80862,6,2,283300,283300,283302,0,2,3
80863,1,2,283301,283302,283304,1,3,0
80864,6,2,283307,283307,283309,0,2,3
80865,4,1,283311,283311,283312,0,1,2
80866,5,2,283316,283316,283318,0,2,4
80867,2,1,283318,283318,283319,0,1,0
80868,3,2,283321,283321,283323,0,2,2
80869,1,2,283322,283323,283325,1,3,0
80870,5,2,283327,283327,283329,0,2,2
80871,4,3,283331,283331,283334,0,3,2
80872,5,3,283336,283336,283339,0,3,2
80873,2,1,283338,283339,283340,1,2,0
80874,1,1,283339,283340,283341,1,2,0
80875,1,2,283340,283341,283343,1,3,0
80876,4,3,283344,283344,283347,0,3,1
80877,3,2,283347,283347,283349,0,2,0
80878,5,2,283352,283352,283354,0,2,3
80879,3,3,283355,283355,283358,0,3,1
80880,5,2,283360,283360,283362,0,2,2
80881,2,1,283362,283362,283363,0,1,0
80882,3,1,283365,283365,283366,0,1,2
80883,4,1,283369,283369,283370,0,1,3
80884,6,1,283375,283375,283376,0,1,5
80885,2,2,283377,283377,283379,0,2,1
80886,5,2,283382,283382,283384,0,2,3
80887,1,2,283383,283384,283386,1,3,0
80888,1,1,283384,283386,283387,2,3,0
80889,6,2,283390,283390,283392,0,2,3
80890,1,2,283391,283392,283394,1,3,0
80891,3,2,283394,283394,283396,0,2,0
80892,4,1,283398,283398,283399,0,1,2
80893,1,3,283399,283399,283402,0,3,0
80894,5,2,283404,283404,283406,0,2,2
80895,3,3,283407,283407,283410,0,3,1
80896,3,1,283410,283410,283411,0,1,0
80897,1,1,283411,283411,283412,0,1,0
80898,5,3,283416,283416,283419,0,3,4
80899,4,1,283420,283420,283421,0,1,1
80900,2,1,283422,283422,283423,0,1,1
80901,2,2,283424,283424,283426,0,2,1
80902,5,3,283429,283429,283432,0,3,3
80903,1,2,283430,283432,283434,2,4,0
80904,5,2,283435,283435,283437,0,2,1
80905,3,2,283438,283438,283440,0,2,1
80906,2,2,283440,283440,283442,0,2,0
80907,3,2,283443,283443,283445,0,2,1
80908,6,1,283449,283449,283450,0,1,4
80909,6,3,283455,283455,283458,0,3,5
80910,6,3,283461,283461,283464,0,3,3
80911,2,2,283463,283464,283466,1,3,0
80912,3,3,283466,283466,283469,0,3,0
80913,4,1,283470,283470,283471,0,1,1
80914,6,3,283476,283476,283479,0,3,5
80915,4,2,283480,283480,283482,0,2,1
80916,3,1,283483,283483,283484,0,1,1
80917,1,1,283484,283484,283485,0,1,0
80918,5,1,283489,283489,283490,0,1,4
80919,3,1,283492,283492,283493,0,1,2
80920,6,1,283498,283498,283499,0,1,5
80921,1,3,283499,283499,283502,0,3,0
80922,6,2,283505,283505,283507,0,2,3
80923,3,1,283508,283508,283509,0,1,1
80924,6,1,283514,283514,283515,0,1,5
80925,2,2,283516,283516,283518,0,2,1
80926,3,2,283519,283519,283521,0,2,1
80927,2,3,283521,283521,283524,0,3,0
80928,2,3,283523,283524,283527,1,4,0
80929,5,2,283528,283528,283530,0,2,1
80930,3,1,283531,283531,283532,0,1,1
80931,5,1,283536,283536,283537,0,1,4
80932,2,2,283538,283538,283540,0,2,1
80933,2,1,283540,283540,283541,0,1,0
80934,1,1,283541,283541,283542,0,1,0
80935,1,1,283542,283542,283543,0,1,0
80936,5,3,283547,283547,283550,0,3,4
80937,4,1,283551,283551,283552,0,1,1
80938,6,2,283557,283557,283559,0,2,5
80939,5,2,283562,283562,283564,0,2,3
80940,3,1,283565,283565,283566,0,1,1
80941,6,2,283571,283571,283573,0,2,5
80942,5,1,283576,283576,283577,0,1,3
80943,3,1,283579,283579,283580,0,1,2
80944,4,3,283583,283583,283586,0,3,3
80945,1,2,283584,283586,283588,2,4,0
80946,2,3,283586,283588,283591,2,5,0
80947,4,2,283590,283591,283593,1,3,0
80948,5,2,283595,283595,283597,0,2,2
80949,2,2,283597,283597,283599,0,2,0
80950,2,2,283599,283599,283601,0,2,0
80951,3,2,283602,283602,283604,0,2,1
80952,5,1,283607,283607,283608,0,1,3
80953,5,1,283612,283612,283613,0,1,4
80954,1,2,283613,283613,283615,0,2,0
80955,2,2,283615,283615,283617,0,2,0
80956,3,3,283618,283618,283621,0,3,1
80957,4,3,283622,283622,283625,0,3,1
80958,1,3,283623,283625,283628,2,5,0
80959,2,3,283625,283628,283631,3,6,0
80960,4,3,283629,283631,283634,2,5,0
80961,6,3,283635,283635,283638,0,3,1
80962,6,2,283641,283641,283643,0,2,3
80963,2,3,283643,283643,283646,0,3,0
80964,3,2,283646,283646,283648,0,2,0
80965,4,3,283650,283650,283653,0,3,2
80966,2,2,283652,283653,283655,1,3,0
80967,3,1,283655,283655,283656,0,1,0
80968,4,3,283659,283659,283662,0,3,3
80969,2,3,283661,283662,283665,1,4,0
80970,5,2,283666,283666,283668,0,2,1
80971,2,3,283668,283668,283671,0,3,0
80972,3,2,283671,283671,283673,0,2,0
80973,4,3,283675,283675,283678,0,3,2
80974,2,2,283677,283678,283680,1,3,0
80975,2,2,283679,283680,283682,1,3,0
80976,5,1,283684,283684,283685,0,1,2
80977,1,3,283685,283685,283688,0,3,0
80978,3,3,283688,283688,283691,0,3,0
80979,1,3,283689,283691,283694,2,5,0
80980,6,1,283695,283695,283696,0,1,1
80981,4,3,283699,283699,283702,0,3,3
80982,4,3,283703,283703,283706,0,3,1
80983,6,3,283709,283709,283712,0,3,3
80984,3,2,283712,283712,283714,0,2,0
80985,6,1,283718,283718,283719,0,1,4
80986,3,3,283721,283721,283724,0,3,2
80987,4,2,283725,283725,283727,0,2,1
80988,5,2,283730,283730,283732,0,2,3
80989,5,1,283735,283735,283736,0,1,3
80990,1,2,283736,283736,283738,0,2,0
80991,4,1,283740,283740,283741,0,1,2
80992,2,2,283742,283742,283744,0,2,1
80993,5,1,283747,283747,283748,0,1,3
80994,2,3,283749,283749,283752,0,3,1
80995,3,2,283752,283752,283754,0,2,0
80996,4,3,283756,283756,283759,0,3,2
80997,3,3,283759,283759,283762,0,3,0
80998,2,2,283761,283762,283764,1,3,0
80999,3,1,283764,283764,283765,0,1,0
81000,5,3,283769,283769,283772,0,3,4
81001,4,3,283773,283773,283776,0,3,1
81002,3,1,283776,283776,283777,0,1,0
81003,6,2,283782,283782,283784,0,2,5
81004,6,3,283788,283788,283791,0,3,4
81005,1,3,283789,283791,283794,2,5,0
81006,4,3,283793,283794,283797,1,4,0
81007,1,2,283794,283797,283799,3,5,0
81008,6,3,283800,283800,283803,0,3,1
81009,1,2,283801,283803,283805,2,4,0
81010,1,3,283802,283805,283808,3,6,0
81011,6,1,283808,283808,283809,0,1,0
81012,3,1,283811,283811,283812,0,1,2
81013,6,3,283817,283817,283820,0,3,5
81014,1,2,283818,283820,283822,2,4,0
81015,5,3,283823,283823,283826,0,3,1
81016,5,3,283828,283828,283831,0,3,2
81017,3,3,283831,283831,283834,0,3,0
81018,3,2,283834,283834,283836,0,2,0
81019,2,1,283836,283836,283837,0,1,0
81020,4,2,283840,283840,283842,0,2,3
81021,3,3,283843,283843,283846,0,3,1
81022,3,3,283846,283846,283849,0,3,0
81023,4,2,283850,283850,283852,0,2,1
81024,1,1,283851,283852,283853,1,2,0
81025,6,3,283857,283857,283860,0,3,4
81026,6,3,283863,283863,283866,0,3,3
81027,3,2,283866,283866,283868,0,2,0
81028,4,2,283870,283870,283872,0,2,2
81029,4,3,283874,283874,283877,0,3,2
81030,2,2,283876,283877,283879,1,3,0
81031,1,3,283877,283879,283882,2,5,0
81032,6,1,283883,283883,283884,0,1,1
81033,1,1,283884,283884,283885,0,1,0
81034,5,2,283889,283889,283891,0,2,4
81035,5,3,283894,283894,283897,0,3,3
81036,6,1,283900,283900,283901,0,1,3
81037,1,3,283901,283901,283904,0,3,0
81038,5,2,283906,283906,283908,0,2,2
81039,4,2,283910,283910,283912,0,2,2
81040,1,2,283911,283912,283914,1,3,0
81041,3,1,283914,283914,283915,0,1,0
81042,1,2,283915,283915,283917,0,2,0
81043,1,1,283916,283917,283918,1,2,0
81044,6,3,283922,283922,283925,0,3,4
81045,2,3,283924,283925,283928,1,4,0
81046,2,1,283926,283928,283929,2,3,0
81047,5,3,283931,283931,283934,0,3,2
81048,2,1,283933,283934,283935,1,2,0
81049,4,2,283937,283937,283939,0,2,2
81050,3,2,283940,283940,283942,0,2,1
81051,6,1,283946,283946,283947,0,1,4
81052,4,1,283950,283950,283951,0,1,3
81053,1,2,283951,283951,283953,0,2,0
81054,6,3,283957,283957,283960,0,3,4
81055,1,2,283958,283960,283962,2,4,0
81056,4,2,283962,283962,283964,0,2,0
81057,3,1,283965,283965,283966,0,1,1
81058,4,3,283969,283969,283972,0,3,3
81059,5,1,283974,283974,283975,0,1,2
81060,3,3,283977,283977,283980,0,3,2
81061,2,3,283979,283980,283983,1,4,0
81062,1,1,283980,283983,283984,3,4,0
81063,6,2,283986,283986,283988,0,2,2
81064,1,1,283987,283988,283989,1,2,0
81065,3,2,283990,283990,283992,0,2,1
81066,5,1,283995,283995,283996,0,1,3
81067,4,2,283999,283999,284001,0,2,3
81068,5,3,284004,284004,284007,0,3,3
81069,2,3,284006,284007,284010,1,4,0
81070,5,1,284011,284011,284012,0,1,1
81071,4,1,284015,284015,284016,0,1,3
81072,4,1,284019,284019,284020,0,1,3
81073,4,1,284023,284023,284024,0,1,3
81074,3,1,284026,284026,284027,0,1,2
81075,6,1,284032,284032,284033,0,1,5
81076,5,2,284037,284037,284039,0,2,4
81077,4,3,284041,284041,284044,0,3,2
81078,1,3,284042,284044,284047,2,5,0
81079,4,1,284046,284047,284048,1,2,0
81080,2,1,284048,284048,284049,0,1,0
81081,3,3,284051,284051,284054,0,3,2
81082,4,3,284055,284055,284058,0,3,1
81083,5,1,284060,284060,284061,0,1,2
81084,4,2,284064,284064,284066,0,2,3
81085,3,1,284067,284067,284068,0,1,1
81086,4,1,284071,284071,284072,0,1,3
81087,6,1,284077,284077,284078,0,1,5
81088,1,1,284078,284078,284079,0,1,0
81089,5,1,284083,284083,284084,0,1,4
81090,2,1,284085,284085,284086,0,1,1
81091,5,2,284090,284090,284092,0,2,4
81092,4,1,284094,284094,284095,0,1,2
81093,5,1,284099,284099,284100,0,1,4
81094,3,2,284102,284102,284104,0,2,2
81095,4,3,284106,284106,284109,0,3,2
81096,5,3,284111,284111,284114,0,3,2
81097,1,1,284112,284114,284115,2,3,0
81098,2,1,284114,284115,284116,1,2,0
81099,1,3,284115,284116,284119,1,4,0
81100,2,1,284117,284119,284120,2,3,0
81101,6,3,284123,284123,284126,0,3,3
81102,6,2,284129,284129,284131,0,2,3
81103,5,3,284134,284134,284137,0,3,3
81104,2,1,284136,284137,284138,1,2,0
81105,1,3,284137,284138,284141,1,4,0
81106,4,1,284141,284141,284142,0,1,0
81107,4,2,284145,284145,284147,0,2,3
81108,3,2,284148,284148,284150,0,2,1
81109,2,2,284150,284150,284152,0,2,0
81110,6,1,284156,284156,284157,0,1,4
81111,1,1,284157,284157,284158,0,1,0
81112,5,2,284162,284162,284164,0,2,4
81113,5,2,284167,284167,284169,0,2,3
81114,3,2,284170,284170,284172,0,2,1
81115,6,2,284176,284176,284178,0,2,4
81116,6,1,284182,284182,284183,0,1,4
81117,4,3,284186,284186,284189,0,3,3
81118,6,2,284192,284192,284194,0,2,3
81119,3,2,284195,284195,284197,0,2,1
81120,4,2,284199,284199,284201,0,2,2
81121,2,2,284201,284201,284203,0,2,0
81122,3,3,284204,284204,284207,0,3,1
81123,2,1,284206,284207,284208,1,2,0
81124,5,2,284211,284211,284213,0,2,3
81125,3,3,284214,284214,284217,0,3,1
81126,4,1,284218,284218,284219,0,1,1
81127,5,2,284223,284223,284225,0,2,4
81128,6,3,284229,284229,284232,0,3,4
81129,2,1,284231,284232,284233,1,2,0
81130,5,2,284236,284236,284238,0,2,3
81131,1,3,284237,284238,284241,1,4,0
81132,3,1,284240,284241,284242,1,2,0
81133,4,1,284244,284244,284245,0,1,2
81134,1,3,284245,284245,284248,0,3,0
81135,5,3,284250,284250,284253,0,3,2
81136,4,1,284254,284254,284255,0,1,1
81137,6,1,284260,284260,284261,0,1,5
81138,5,3,284265,284265,284268,0,3,4
81139,4,3,284269,284269,284272,0,3,1
81140,2,3,284271,284272,284275,1,4,0
81141,6,2,284277,284277,284279,0,2,2
81142,1,2,284278,284279,284281,1,3,0
81143,1,1,284279,284281,284282,2,3,0
81144,3,3,284282,284282,284285,0,3,0
81145,4,1,284286,284286,284287,0,1,1
81146,2,2,284288,284288,284290,0,2,1
81147,6,3,284294,284294,284297,0,3,4
81148,6,1,284300,284300,284301,0,1,3
81149,3,2,284303,284303,284305,0,2,2
81150,4,3,284307,284307,284310,0,3,2
81151,4,1,284311,284311,284312,0,1,1
81152,6,1,284317,284317,284318,0,1,5
81153,1,3,284318,284318,284321,0,3,0
81154,1,1,284319,284321,284322,2,3,0
81155,5,2,284324,284324,284326,0,2,2
81156,4,2,284328,284328,284330,0,2,2
81157,5,3,284333,284333,284336,0,3,3
81158,2,3,284335,284336,284339,1,4,0
81159,6,2,284341,284341,284343,0,2,2
81160,1,3,284342,284343,284346,1,4,0
81161,3,1,284345,284346,284347,1,2,0
81162,6,2,284351,284351,284353,0,2,4
81163,1,1,284352,284353,284354,1,2,0
81164,6,1,284358,284358,284359,0,1,4
81165,5,3,284363,284363,284366,0,3,4
81166,6,1,284369,284369,284370,0,1,3
81167,4,1,284373,284373,284374,0,1,3
81168,5,3,284378,284378,284381,0,3,4
81169,4,1,284382,284382,284383,0,1,1
81170,6,2,284388,284388,284390,0,2,5
81171,3,1,284391,284391,284392,0,1,1
81172,6,3,284397,284397,284400,0,3,5
81173,3,1,284400,284400,284401,0,1,0
81174,1,2,284401,284401,284403,0,2,0
81175,6,3,284407,284407,284410,0,3,4
81176,2,1,284409,284410,284411,1,2,0
81177,1,3,284410,284411,284414,1,4,0
81178,3,2,284413,284414,284416,1,3,0
81179,1,3,284414,284416,284419,2,5,0
81180,4,1,284418,284419,284420,1,2,0
81181,4,2,284422,284422,284424,0,2,2
81182,4,1,284426,284426,284427,0,1,2
81183,1,3,284427,284427,284430,0,3,0
81184,2,3,284429,284430,284433,1,4,0
81185,5,2,284434,284434,284436,0,2,1
81186,6,3,284440,284440,284443,0,3,4
81187,4,2,284444,284444,284446,0,2,1
81188,4,3,284448,284448,284451,0,3,2
81189,6,2,284454,284454,284456,0,2,3
81190,2,3,284456,284456,284459,0,3,0
81191,2,1,284458,284459,284460,1,2,0
81192,1,1,284459,284460,284461,1,2,0
81193,6,2,284465,284465,284467,0,2,4
81194,4,3,284469,284469,284472,0,3,2
81195,5,3,284474,284474,284477,0,3,2
81196,3,3,284477,284477,284480,0,3,0
81197,2,2,284479,284480,284482,1,3,0
81198,1,2,284480,284482,284484,2,4,0
81199,4,1,284484,284484,284485,0,1,0
81200,1,1,284485,284485,284486,0,1,0
81201,5,1,284490,284490,284491,0,1,4
81202,1,3,284491,284491,284494,0,3,0
81203,1,3,284492,284494,284497,2,5,0
81204,5,1,284497,284497,284498,0,1,0
81205,6,2,284503,284503,284505,0,2,5
81206,1,2,284504,284505,284507,1,3,0
81207,3,1,284507,284507,284508,0,1,0
81208,6,2,284513,284513,284515,0,2,5
81209,4,1,284517,284517,284518,0,1,2
81210,3,2,284520,284520,284522,0,2,2
81211,3,2,284523,284523,284525,0,2,1
81212,5,2,284528,284528,284530,0,2,3
81213,1,2,284529,284530,284532,1,3,0
81214,3,3,284532,284532,284535,0,3,0
81215,1,2,284533,284535,284537,2,4,0
81216,1,2,284534,284537,284539,3,5,0
81217,5,3,284539,284539,284542,0,3,0
81218,2,1,284541,284542,284543,1,2,0
81219,6,3,284547,284547,284550,0,3,4
81220,6,1,284553,284553,284554,0,1,3
81221,1,3,284554,284554,284557,0,3,0
81222,3,3,284557,284557,284560,0,3,0
81223,6,2,284563,284563,284565,0,2,3
81224,5,3,284568,284568,284571,0,3,3
81225,2,2,284570,284571,284573,1,3,0
81226,1,1,284571,284573,284574,2,3,0
81227,5,1,284576,284576,284577,0,1,2
81228,3,3,284579,284579,284582,0,3,2
81229,5,3,284584,284584,284587,0,3,2
81230,5,2,284589,284589,284591,0,2,2
81231,2,2,284591,284591,284593,0,2,0
81232,2,1,284593,284593,284594,0,1,0
81233,5,1,284598,284598,284599,0,1,4
81234,5,3,284603,284603,284606,0,3,4
81235,2,1,284605,284606,284607,1,2,0
81236,5,2,284610,284610,284612,0,2,3
81237,2,2,284612,284612,284614,0,2,0
81238,1,1,284613,284614,284615,1,2,0
81239,3,1,284616,284616,284617,0,1,1
81240,1,3,284617,284617,284620,0,3,0
81241,5,2,284622,284622,284624,0,2,2
81242,3,2,284625,284625,284627,0,2,1
81243,3,3,284628,284628,284631,0,3,1
81244,4,1,284632,284632,284633,0,1,1
81245,1,2,284633,284633,284635,0,2,0
81246,2,3,284635,284635,284638,0,3,0
81247,5,2,284640,284640,284642,0,2,2
81248,5,2,284645,284645,284647,0,2,3
81249,1,3,284646,284647,284650,1,4,0
81250,5,1,284651,284651,284652,0,1,1
81251,4,2,284655,284655,284657,0,2,3
81252,1,1,284656,284657,284658,1,2,0
81253,2,3,284658,284658,284661,0,3,0
81254,1,1,284659,284661,284662,2,3,0
81255,5,1,284664,284664,284665,0,1,2
81256,6,1,284670,284670,284671,0,1,5
81257,2,1,284672,284672,284673,0,1,1
81258,4,1,284676,284676,284677,0,1,3
81259,5,1,284681,284681,284682,0,1,4
81260,5,3,284686,284686,284689,0,3,4
81261,6,1,284692,284692,284693,0,1,3
81262,3,2,284695,284695,284697,0,2,2
81263,6,2,284701,284701,284703,0,2,4
81264,1,1,284702,284703,284704,1,2,0
81265,6,3,284708,284708,284711,0,3,4
81266,6,1,284714,284714,284715,0,1,3
81267,6,1,284720,284720,284721,0,1,5
81268,1,2,284721,284721,284723,0,2,0
81269,2,1,284723,284723,284724,0,1,0
81270,5,1,284728,284728,284729,0,1,4
81271,3,2,284731,284731,284733,0,2,2
81272,6,1,284737,284737,284738,0,1,4
81273,6,3,284743,284743,284746,0,3,5
81274,6,2,284749,284749,284751,0,2,3
81275,4,1,284753,284753,284754,0,1,2
81276,3,1,284756,284756,284757,0,1,2
81277,5,2,284761,284761,284763,0,2,4
81278,1,2,284762,284763,284765,1,3,0
81279,4,3,284766,284766,284769,0,3,1
81280,3,1,284769,284769,284770,0,1,0
81281,5,2,284774,284774,284776,0,2,4
81282,4,2,284778,284778,284780,0,2,2
81283,5,3,284783,284783,284786,0,3,3
81284,3,1,284786,284786,284787,0,1,0
81285,4,1,284790,284790,284791,0,1,3
81286,2,2,284792,284792,284794,0,2,1
81287,6,1,284798,284798,284799,0,1,4
81288,2,3,284800,284800,284803,0,3,1
81289,5,1,284805,284805,284806,0,1,2
81290,6,3,284811,284811,284814,0,3,5
81291,4,3,284815,284815,284818,0,3,1
81292,6,3,284821,284821,284824,0,3,3
81293,6,3,284827,284827,284830,0,3,3
81294,2,3,284829,284830,284833,1,4,0
81295,1,3,284830,284833,284836,3,6,0
81296,2,2,284832,284836,284838,4,6,0
81297,6,3,284838,284838,284841,0,3,0
81298,2,1,284840,284841,284842,1,2,0
81299,1,3,284841,284842,284845,1,4,0
81300,2,1,284843,284845,284846,2,3,0
81301,6,3,284849,284849,284852,0,3,3
81302,5,3,284854,284854,284857,0,3,2
81303,1,3,284855,284857,284860,2,5,0
81304,6,3,284861,284861,284864,0,3,1
81305,3,1,284864,284864,284865,0,1,0
81306,3,3,284867,284867,284870,0,3,2
81307,3,2,284870,284870,284872,0,2,0
81308,5,1,284875,284875,284876,0,1,3
81309,1,1,284876,284876,284877,0,1,0
81310,4,1,284880,284880,284881,0,1,3
81311,4,3,284884,284884,284887,0,3,3
81312,3,2,284887,284887,284889,0,2,0
81313,5,3,284892,284892,284895,0,3,3
81314,5,3,284897,284897,284900,0,3,2
81315,5,3,284902,284902,284905,0,3,2
81316,3,1,284905,284905,284906,0,1,0
81317,3,2,284908,284908,284910,0,2,2
81318,1,3,284909,284910,284913,1,4,0
81319,1,3,284910,284913,284916,3,6,0
81320,3,1,284913,284916,284917,3,4,0
81321,6,1,284919,284919,284920,0,1,2
81322,6,3,284925,284925,284928,0,3,5
81323,6,1,284931,284931,284932,0,1,3
81324,1,1,284932,284932,284933,0,1,0
81325,6,1,284938,284938,284939,0,1,5
81326,5,1,284943,284943,284944,0,1,4
81327,5,1,284948,284948,284949,0,1,4
81328,6,2,284954,284954,284956,0,2,5
81329,3,2,284957,284957,284959,0,2,1
81330,3,2,284960,284960,284962,0,2,1
81331,4,3,284964,284964,284967,0,3,2
81332,6,1,284970,284970,284971,0,1,3
81333,5,1,284975,284975,284976,0,1,4
81334,4,3,284979,284979,284982,0,3,3
81335,5,2,284984,284984,284986,0,2,2
81336,2,1,284986,284986,284987,0,1,0
81337,5,3,284991,284991,284994,0,3,4
81338,1,1,284992,284994,284995,2,3,0
81339,3,2,284995,284995,284997,0,2,0
81340,4,3,284999,284999,285002,0,3,2
81341,4,2,285003,285003,285005,0,2,1
81342,4,2,285007,285007,285009,0,2,2
81343,4,2,285011,285011,285013,0,2,2
81344,4,1,285015,285015,285016,0,1,2
81345,6,1,285021,285021,285022,0,1,5
81346,2,2,285023,285023,285025,0,2,1
81347,5,2,285028,285028,285030,0,2,3
81348,5,1,285033,285033,285034,0,1,3
81349,1,3,285034,285034,285037,0,3,0
81350,3,3,285037,285037,285040,0,3,0
81351,3,2,285040,285040,285042,0,2,0
81352,3,1,285043,285043,285044,0,1,1
81353,4,2,285047,285047,285049,0,2,3
81354,2,3,285049,285049,285052,0,3,0
81355,3,2,285052,285052,285054,0,2,0
81356,2,3,285054,285054,285057,0,3,0
81357,1,2,285055,285057,285059,2,4,0
81358,4,2,285059,285059,285061,0,2,0
81359,1,3,285060,285061,285064,1,4,0
81360,2,1,285062,285064,285065,2,3,0
81361,5,2,285067,285067,285069,0,2,2
81362,3,1,285070,285070,285071,0,1,1
81363,1,1,285071,285071,285072,0,1,0
81364,3,3,285074,285074,285077,0,3,2
81365,6,3,285080,285080,285083,0,3,3
81366,4,1,285084,285084,285085,0,1,1
81367,2,3,285086,285086,285089,0,3,1
81368,1,1,285087,285089,285090,2,3,0
81369,1,2,285088,285090,285092,2,4,0
81370,2,3,285090,285092,285095,2,5,0
81371,4,3,285094,285095,285098,1,4,0
81372,1,2,285095,285098,285100,3,5,0
81373,2,2,285097,285100,285102,3,5,0
81374,5,1,285102,285102,285103,0,1,0
81375,3,2,285105,285105,285107,0,2,2
81376,2,3,285107,285107,285110,0,3,0
81377,5,2,285112,285112,285114,0,2,2
81378,4,3,285116,285116,285119,0,3,2
81379,2,2,285118,285119,285121,1,3,0
81380,5,2,285123,285123,285125,0,2,2
81381,1,2,285124,285125,285127,1,3,0
81382,5,1,285129,285129,285130,0,1,2
81383,2,2,285131,285131,285133,0,2,1
81384,4,1,285135,285135,285136,0,1,2
81385,1,1,285136,285136,285137,0,1,0
81386,3,2,285139,285139,285141,0,2,2
81387,6,1,285145,285145,285146,0,1,4
81388,4,2,285149,285149,285151,0,2,3
81389,4,2,285153,285153,285155,0,2,2
81390,4,3,285157,285157,285160,0,3,2
81391,6,3,285163,285163,285166,0,3,3
81392,2,1,285165,285166,285167,1,2,0
81393,1,2,285166,285167,285169,1,3,0
81394,3,3,285169,285169,285172,0,3,0
81395,3,1,285172,285172,285173,0,1,0
81396,6,2,285178,285178,285180,0,2,5
81397,3,1,285181,285181,285182,0,1,1
81398,1,2,285182,285182,285184,0,2,0
81399,1,2,285183,285184,285186,1,3,0
81400,3,1,285186,285186,285187,0,1,0
81401,3,1,285189,285189,285190,0,1,2
81402,2,2,285191,285191,285193,0,2,1
81403,5,1,285196,285196,285197,0,1,3
81404,5,1,285201,285201,285202,0,1,4
81405,2,3,285203,285203,285206,0,3,1
81406,6,1,285209,285209,285210,0,1,3
81407,5,2,285214,285214,285216,0,2,4
81408,4,2,285218,285218,285220,0,2,2
81409,2,3,285220,285220,285223,0,3,0
81410,4,3,285224,285224,285227,0,3,1
81411,1,2,285225,285227,285229,2,4,0
81412,3,1,285228,285229,285230,1,2,0
81413,2,2,285230,285230,285232,0,2,0
81414,1,2,285231,285232,285234,1,3,0
81415,4,2,285235,285235,285237,0,2,1
81416,1,3,285236,285237,285240,1,4,0
81417,4,1,285240,285240,285241,0,1,0
81418,4,2,285244,285244,285246,0,2,3
81419,2,2,285246,285246,285248,0,2,0
81420,1,3,285247,285248,285251,1,4,0
81421,6,3,285253,285253,285256,0,3,2
81422,2,1,285255,285256,285257,1,2,0
81423,4,2,285259,285259,285261,0,2,2
81424,4,3,285263,285263,285266,0,3,2
81425,3,3,285266,285266,285269,0,3,0
81426,3,2,285269,285269,285271,0,2,0
81427,5,3,285274,285274,285277,0,3,3
81428,4,1,285278,285278,285279,0,1,1
81429,1,1,285279,285279,285280,0,1,0
81430,6,2,285285,285285,285287,0,2,5
81431,6,1,285291,285291,285292,0,1,4
81432,3,3,285294,285294,285297,0,3,2
81433,1,3,285295,285297,285300,2,5,0
81434,1,3,285296,285300,285303,4,7,0
81435,6,2,285302,285303,285305,1,3,0
81436,2,2,285304,285305,285307,1,3,0
81437,5,2,285309,285309,285311,0,2,2
81438,2,3,285311,285311,285314,0,3,0
81439,6,1,285317,285317,285318,0,1,3
81440,5,1,285322,285322,285323,0,1,4
81441,5,3,285327,285327,285330,0,3,4
81442,3,1,285330,285330,285331,0,1,0
81443,4,1,285334,285334,285335,0,1,3
81444,4,1,285338,285338,285339,0,1,3
81445,6,1,285344,285344,285345,0,1,5
81446,3,3,285347,285347,285350,0,3,2
81447,4,3,285351,285351,285354,0,3,1
81448,4,1,285355,285355,285356,0,1,1
81449,3,2,285358,285358,285360,0,2,2
81450,3,1,285361,285361,285362,0,1,1
81451,2,2,285363,285363,285365,0,2,1
81452,6,1,285369,285369,285370,0,1,4
81453,2,2,285371,285371,285373,0,2,1
81454,1,3,285372,285373,285376,1,4,0
81455,6,3,285378,285378,285381,0,3,2
81456,4,3,285382,285382,285385,0,3,1
81457,4,1,285386,285386,285387,0,1,1
81458,2,1,285388,285388,285389,0,1,1
81459,2,2,285390,285390,285392,0,2,1
81460,4,3,285394,285394,285397,0,3,2
81461,3,3,285397,285397,285400,0,3,0
81462,5,1,285402,285402,285403,0,1,2
81463,4,3,285406,285406,285409,0,3,3
81464,5,1,285411,285411,285412,0,1,2
81465,4,2,285415,285415,285417,0,2,3
81466,2,1,285417,285417,285418,0,1,0
81467,1,2,285418,285418,285420,0,2,0
81468,4,2,285422,285422,285424,0,2,2
81469,2,3,285424,285424,285427,0,3,0
81470,2,3,285426,285427,285430,1,4,0
81471,5,3,285431,285431,285434,0,3,1
81472,3,3,285434,285434,285437,0,3,0
81473,5,2,285439,285439,285441,0,2,2
81474,6,2,285445,285445,285447,0,2,4
81475,4,3,285449,285449,285452,0,3,2
81476,5,2,285454,285454,285456,0,2,2
81477,2,3,285456,285456,285459,0,3,0
81478,4,3,285460,285460,285463,0,3,1
81479,5,1,285465,285465,285466,0,1,2
81480,6,3,285471,285471,285474,0,3,5
81481,6,1,285477,285477,285478,0,1,3
81482,4,2,285481,285481,285483,0,2,3
81483,6,3,285487,285487,285490,0,3,4
81484,3,1,285490,285490,285491,0,1,0
81485,6,1,285496,285496,285497,0,1,5
81486,1,1,285497,285497,285498,0,1,0
81487,1,1,285498,285498,285499,0,1,0
81488,1,1,285499,285499,285500,0,1,0
81489,4,2,285503,285503,285505,0,2,3
81490,5,1,285508,285508,285509,0,1,3
81491,2,3,285510,285510,285513,0,3,1
81492,5,2,285515,285515,285517,0,2,2
81493,6,1,285521,285521,285522,0,1,4
81494,2,1,285523,285523,285524,0,1,1
81495,5,3,285528,285528,285531,0,3,4
81496,1,1,285529,285531,285532,2,3,0
81497,2,3,285531,285532,285535,1,4,0
81498,5,1,285536,285536,285537,0,1,1
81499,1,1,285537,285537,285538,0,1,0
81500,1,3,285538,285538,285541,0,3,0
81501,2,2,285540,285541,285543,1,3,0
81502,2,1,285542,285543,285544,1,2,0
81503,1,2,285543,285544,285546,1,3,0
81504,3,3,285546,285546,285549,0,3,0
81505,3,2,285549,285549,285551,0,2,0
81506,1,2,285550,285551,285553,1,3,0
81507,4,2,285554,285554,285556,0,2,1
81508,6,1,285560,285560,285561,0,1,4
81509,4,3,285564,285564,285567,0,3,3
81510,4,3,285568,285568,285571,0,3,1
81511,4,1,285572,285572,285573,0,1,1
81512,6,2,285578,285578,285580,0,2,5
81513,4,3,285582,285582,285585,0,3,2
81514,1,1,285583,285585,285586,2,3,0
81515,4,3,285587,285587,285590,0,3,1
81516,2,3,285589,285590,285593,1,4,0
81517,6,3,285595,285595,285598,0,3,2
81518,3,1,285598,285598,285599,0,1,0
81519,6,3,285604,285604,285607,0,3,5
81520,1,3,285605,285607,285610,2,5,0
81521,3,1,285608,285610,285611,2,3,0
81522,3,1,285611,285611,285612,0,1,0
81523,4,1,285615,285615,285616,0,1,3
81524,5,2,285620,285620,285622,0,2,4
81525,4,3,285624,285624,285627,0,3,2
81526,5,2,285629,285629,285631,0,2,2
81527,5,3,285634,285634,285637,0,3,3
81528,1,2,285635,285637,285639,2,4,0
81529,5,2,285640,285640,285642,0,2,1
81530,5,3,285645,285645,285648,0,3,3
81531,2,3,285647,285648,285651,1,4,0
81532,1,2,285648,285651,285653,3,5,0
81533,1,2,285649,285653,285655,4,6,0
81534,5,2,285654,285655,285657,1,3,0
81535,2,2,285656,285657,285659,1,3,0
81536,2,3,285658,285659,285662,1,4,0
81537,1,3,285659,285662,285665,3,6,0
81538,5,2,285664,285665,285667,1,3,0
81539,1,2,285665,285667,285669,2,4,0
81540,2,2,285667,285669,285671,2,4,0
81541,6,1,285673,285673,285674,0,1,2
81542,1,3,285674,285674,285677,0,3,0
81543,6,3,285680,285680,285683,0,3,3
81544,4,3,285684,285684,285687,0,3,1
81545,4,2,285688,285688,285690,0,2,1
81546,2,3,285690,285690,285693,0,3,0
81547,1,1,285691,285693,285694,2,3,0
81548,3,3,285694,285694,285697,0,3,0
81549,4,1,285698,285698,285699,0,1,1
81550,4,2,285702,285702,285704,0,2,3
81551,3,2,285705,285705,285707,0,2,1
81552,5,3,285710,285710,285713,0,3,3
81553,5,1,285715,285715,285716,0,1,2
81554,1,3,285716,285716,285719,0,3,0
81555,5,2,285721,285721,285723,0,2,2
81556,4,2,285725,285725,285727,0,2,2
81557,1,2,285726,285727,285729,1,3,0
81558,3,2,285729,285729,285731,0,2,0
81559,2,2,285731,285731,285733,0,2,0
81560,1,1,285732,285733,285734,1,2,0
81561,6,1,285738,285738,285739,0,1,4
81562,1,3,285739,285739,285742,0,3,0
81563,5,2,285744,285744,285746,0,2,2
81564,2,3,285746,285746,285749,0,3,0
81565,2,2,285748,285749,285751,1,3,0
81566,6,1,285754,285754,285755,0,1,3
81567,1,3,285755,285755,285758,0,3,0
81568,5,2,285760,285760,285762,0,2,2
81569,6,2,285766,285766,285768,0,2,4
81570,6,3,285772,285772,285775,0,3,4
81571,2,3,285774,285775,285778,1,4,0
81572,1,3,285775,285778,285781,3,6,0
81573,4,2,285779,285781,285783,2,4,0
81574,4,2,285783,285783,285785,0,2,0
81575,3,2,285786,285786,285788,0,2,1
81576,6,2,285792,285792,285794,0,2,4
81577,3,1,285795,285795,285796,0,1,1
81578,2,1,285797,285797,285798,0,1,1
81579,4,2,285801,285801,285803,0,2,3
81580,2,2,285803,285803,285805,0,2,0
81581,5,3,285808,285808,285811,0,3,3
81582,6,2,285814,285814,285816,0,2,3
81583,2,2,285816,285816,285818,0,2,0
81584,2,1,285818,285818,285819,0,1,0
81585,1,2,285819,285819,285821,0,2,0
81586,5,2,285824,285824,285826,0,2,3
81587,5,2,285829,285829,285831,0,2,3
81588,4,1,285833,285833,285834,0,1,2
81589,2,3,285835,285835,285838,0,3,1
81590,2,2,285837,285838,285840,1,3,0
81591,3,1,285840,285840,285841,0,1,0
81592,1,3,285841,285841,285844,0,3,0
81593,2,3,285843,285844,285847,1,4,0
81594,5,2,285848,285848,285850,0,2,1
81595,6,3,285854,285854,285857,0,3,4
81596,2,2,285856,285857,285859,1,3,0
81597,4,1,285860,285860,285861,0,1,1
81598,3,3,285863,285863,285866,0,3,2
81599,1,1,285864,285866,285867,2,3,0
81600,3,1,285867,285867,285868,0,1,0
81601,2,1,285869,285869,285870,0,1,1
81602,6,3,285875,285875,285878,0,3,5
81603,2,1,285877,285878,285879,1,2,0
81604,2,1,285879,285879,285880,0,1,0
81605,3,1,285882,285882,285883,0,1,2
81606,3,3,285885,285885,285888,0,3,2
81607,3,3,285888,285888,285891,0,3,0
81608,6,3,285894,285894,285897,0,3,3
81609,6,3,285900,285900,285903,0,3,3
81610,3,2,285903,285903,285905,0,2,0
81611,4,1,285907,285907,285908,0,1,2
81612,2,1,285909,285909,285910,0,1,1
81613,3,3,285912,285912,285915,0,3,2
81614,4,3,285916,285916,285919,0,3,1
81615,1,1,285917,285919,285920,2,3,0
81616,1,3,285918,285920,285923,2,5,0
81617,4,2,285922,285923,285925,1,3,0
81618,5,2,285927,285927,285929,0,2,2
81619,1,3,285928,285929,285932,1,4,0
81620,2,3,285930,285932,285935,2,5,0
81621,2,2,285932,285935,285937,3,5,0
81622,3,2,285935,285937,285939,2,4,0
81623,4,3,285939,285939,285942,0,3,0
81624,1,2,285940,285942,285944,2,4,0
81625,5,1,285945,285945,285946,0,1,1
81626,1,2,285946,285946,285948,0,2,0
81627,6,2,285952,285952,285954,0,2,4
81628,5,1,285957,285957,285958,0,1,3
81629,1,1,285958,285958,285959,0,1,0
81630,6,3,285964,285964,285967,0,3,5
81631,4,1,285968,285968,285969,0,1,1
81632,5,3,285973,285973,285976,0,3,4
81633,6,1,285979,285979,285980,0,1,3
81634,1,3,285980,285980,285983,0,3,0
81635,1,1,285981,285983,285984,2,3,0
81636,2,1,285983,285984,285985,1,2,0
81637,6,2,285989,285989,285991,0,2,4
81638,5,3,285994,285994,285997,0,3,3
81639,3,1,285997,285997,285998,0,1,0
81640,3,1,286000,286000,286001,0,1,2
81641,1,2,286001,286001,286003,0,2,0
81642,1,3,286002,286003,286006,1,4,0
81643,5,1,286007,286007,286008,0,1,1
81644,5,3,286012,286012,286015,0,3,4
81645,1,1,286013,286015,286016,2,3,0
81646,4,2,286017,286017,286019,0,2,1
81647,5,3,286022,286022,286025,0,3,3
81648,2,3,286024,286025,286028,1,4,0
81649,3,1,286027,286028,286029,1,2,0
81650,1,3,286028,286029,286032,1,4,0
81651,2,1,286030,286032,286033,2,3,0
81652,6,1,286036,286036,286037,0,1,3
81653,5,2,286041,286041,286043,0,2,4
81654,5,1,286046,286046,286047,0,1,3
81655,6,2,286052,286052,286054,0,2,5
81656,6,3,286058,286058,286061,0,3,4
81657,2,1,286060,286061,286062,1,2,0
81658,6,1,286066,286066,286067,0,1,4
81659,1,2,286067,286067,286069,0,2,0
81660,6,3,286073,286073,286076,0,3,4
81661,5,2,286078,286078,286080,0,2,2
81662,6,3,286084,286084,286087,0,3,4
81663,3,2,286087,286087,286089,0,2,0
81664,1,3,286088,286089,286092,1,4,0
81665,2,2,286090,286092,286094,2,4,0
81666,6,2,286096,286096,286098,0,2,2
81667,3,3,286099,286099,286102,0,3,1
81668,1,2,286100,286102,286104,2,4,0
81669,5,3,286105,286105,286108,0,3,1
81670,2,1,286107,286108,286109,1,2,0
81671,4,2,286111,286111,286113,0,2,2
81672,4,2,286115,286115,286117,0,2,2
81673,5,3,286120,286120,286123,0,3,3
81674,3,2,286123,286123,286125,0,2,0
81675,6,1,286129,286129,286130,0,1,4
81676,6,3,286135,286135,286138,0,3,5
81677,5,1,286140,286140,286141,0,1,2
81678,2,1,286142,286142,286143,0,1,1
81679,3,3,286145,286145,286148,0,3,2
81680,5,3,286150,286150,286153,0,3,2
81681,3,2,286153,286153,286155,0,2,0
81682,2,1,286155,286155,286156,0,1,0
81683,6,3,286161,286161,286164,0,3,5
81684,5,2,286166,286166,286168,0,2,2
81685,5,2,286171,286171,286173,0,2,3
81686,1,2,286172,286173,286175,1,3,0
81687,2,2,286174,286175,286177,1,3,0
81688,2,2,286176,286177,286179,1,3,0
81689,5,1,286181,286181,286182,0,1,2
81690,1,3,286182,286182,286185,0,3,0
81691,2,2,286184,286185,286187,1,3,0
81692,3,3,286187,286187,286190,0,3,0
81693,4,3,286191,286191,286194,0,3,1
81694,5,1,286196,286196,286197,0,1,2
81695,2,1,286198,286198,286199,0,1,1
81696,2,2,286200,286200,286202,0,2,1
81697,4,1,286204,286204,286205,0,1,2
81698,1,2,286205,286205,286207,0,2,0
81699,5,2,286210,286210,286212,0,2,3
81700,4,3,286214,286214,286217,0,3,2
81701,3,1,286217,286217,286218,0,1,0
81702,1,3,286218,286218,286221,0,3,0
81703,5,1,286223,286223,286224,0,1,2
81704,5,1,286228,286228,286229,0,1,4
81705,2,3,286230,286230,286233,0,3,1
81706,5,1,286235,286235,286236,0,1,2
81707,1,2,286236,286236,286238,0,2,0
81708,5,2,286241,286241,286243,0,2,3
81709,6,1,286247,286247,286248,0,1,4
81710,6,2,286253,286253,286255,0,2,5
81711,4,2,286257,286257,286259,0,2,2
81712,1,2,286258,286259,286261,1,3,0
81713,5,3,286263,286263,286266,0,3,2
81714,5,1,286268,286268,286269,0,1,2
81715,4,1,286272,286272,286273,0,1,3
81716,5,3,286277,286277,286280,0,3,4
81717,4,2,286281,286281,286283,0,2,1
81718,1,3,286282,286283,286286,1,4,0
81719,2,3,286284,286286,286289,2,5,0
81720,4,1,286288,286289,286290,1,2,0
81721,4,3,286292,286292,286295,0,3,2
81722,5,3,286297,286297,286300,0,3,2
81723,2,2,286299,286300,286302,1,3,0
81724,5,3,286304,286304,286307,0,3,2
81725,1,3,286305,286307,286310,2,5,0
81726,3,3,286308,286310,286313,2,5,0
81727,2,2,286310,286313,286315,3,5,0
81728,6,3,286316,286316,286319,0,3,1
81729,2,2,286318,286319,286321,1,3,0
81730,2,3,286320,286321,286324,1,4,0
81731,1,2,286321,286324,286326,3,5,0
81732,6,1,286327,286327,286328,0,1,1
81733,1,2,286328,286328,286330,0,2,0
81734,4,2,286332,286332,286334,0,2,2
81735,6,2,286338,286338,286340,0,2,4
81736,3,3,286341,286341,286344,0,3,1
81737,3,2,286344,286344,286346,0,2,0
81738,5,2,286349,286349,286351,0,2,3
81739,2,1,286351,286351,286352,0,1,0
81740,6,3,286357,286357,286360,0,3,5
81741,4,2,286361,286361,286363,0,2,1
81742,5,1,286366,286366,286367,0,1,3
81743,4,2,286370,286370,286372,0,2,3
81744,5,1,286375,286375,286376,0,1,3
81745,3,1,286378,286378,286379,0,1,2
81746,6,3,286384,286384,286387,0,3,5
81747,3,3,286387,286387,286390,0,3,0
81748,2,3,286389,286390,286393,1,4,0
81749,1,2,286390,286393,286395,3,5,0
81750,4,1,286394,286395,286396,1,2,0
81751,4,3,286398,286398,286401,0,3,2
81752,3,1,286401,286401,286402,0,1,0
81753,5,2,286406,286406,286408,0,2,4
81754,1,1,286407,286408,286409,1,2,0
81755,2,2,286409,286409,286411,0,2,0
81756,3,1,286412,286412,286413,0,1,1
81757,6,3,286418,286418,286421,0,3,5
81758,4,3,286422,286422,286425,0,3,1
81759,6,3,286428,286428,286431,0,3,3
81760,3,2,286431,286431,286433,0,2,0
81761,2,3,286433,286433,286436,0,3,0
81762,2,2,286435,286436,286438,1,3,0
81763,6,3,286441,286441,286444,0,3,3
81764,6,3,286447,286447,286450,0,3,3
81765,4,1,286451,286451,286452,0,1,1
81766,6,3,286457,286457,286460,0,3,5
81767,4,3,286461,286461,286464,0,3,1
81768,4,1,286465,286465,286466,0,1,1
81769,5,2,286470,286470,286472,0,2,4
81770,3,1,286473,286473,286474,0,1,1
81771,6,3,286479,286479,286482,0,3,5
81772,5,3,286484,286484,286487,0,3,2
81773,3,1,286487,286487,286488,0,1,0
81774,6,2,286493,286493,286495,0,2,5
81775,3,3,286496,286496,286499,0,3,1
81776,1,3,286497,286499,286502,2,5,0
81777,4,1,286501,286502,286503,1,2,0
81778,4,2,286505,286505,286507,0,2,2
81779,5,2,286510,286510,286512,0,2,3
81780,1,2,286511,286512,286514,1,3,0
81781,5,3,286516,286516,286519,0,3,2
81782,5,3,286521,286521,286524,0,3,2
81783,2,1,286523,286524,286525,1,2,0
81784,3,2,286526,286526,286528,0,2,1
81785,6,2,286532,286532,286534,0,2,4
81786,2,2,286534,286534,286536,0,2,0
81787,2,3,286536,286536,286539,0,3,0
81788,4,2,286540,286540,286542,0,2,1
81789,1,1,286541,286542,286543,1,2,0
81790,1,1,286542,286543,286544,1,2,0
81791,5,3,286547,286547,286550,0,3,3
81792,3,1,286550,286550,286551,0,1,0
81793,2,3,286552,286552,286555,0,3,1
81794,6,2,286558,286558,286560,0,2,3
81795,1,1,286559,286560,286561,1,2,0
81796,5,3,286564,286564,286567,0,3,3
81797,1,3,286565,286567,286570,2,5,0
81798,4,2,286569,286570,286572,1,3,0
81799,1,3,286570,286572,286575,2,5,0
81800,4,1,286574,286575,286576,1,2,0
81801,3,3,286577,286577,286580,0,3,1
81802,2,2,286579,286580,286582,1,3,0
81803,5,1,286584,286584,286585,0,1,2
81804,5,3,286589,286589,286592,0,3,4
81805,1,3,286590,286592,286595,2,5,0
81806,1,2,286591,286595,286597,4,6,0
81807,1,1,286592,286597,286598,5,6,0
81808,6,2,286598,286598,286600,0,2,0
81809,2,2,286600,286600,286602,0,2,0
81810,6,1,286606,286606,286607,0,1,4
81811,1,2,286607,286607,286609,0,2,0
81812,6,1,286613,286613,286614,0,1,4
81813,6,1,286619,286619,286620,0,1,5
81814,1,3,286620,286620,286623,0,3,0
81815,6,3,286626,286626,286629,0,3,3
81816,5,3,286631,286631,286634,0,3,2
81817,2,3,286633,286634,286637,1,4,0
81818,6,2,286639,286639,286641,0,2,2
81819,4,2,286643,286643,286645,0,2,2
81820,2,3,286645,286645,286648,0,3,0
81821,5,1,286650,286650,286651,0,1,2
81822,1,1,286651,286651,286652,0,1,0
81823,4,1,286655,286655,286656,0,1,3
81824,5,1,286660,286660,286661,0,1,4
81825,6,1,286666,286666,286667,0,1,5
81826,5,2,286671,286671,286673,0,2,4
81827,3,1,286674,286674,286675,0,1,1
81828,1,1,286675,286675,286676,0,1,0
81829,3,3,286678,286678,286681,0,3,2
81830,3,1,286681,286681,286682,0,1,0
81831,5,3,286686,286686,286689,0,3,4
81832,2,2,286688,286689,286691,1,3,0
81833,4,1,286692,286692,286693,0,1,1
81834,4,2,286696,286696,286698,0,2,3
81835,3,1,286699,286699,286700,0,1,1
81836,2,1,286701,286701,286702,0,1,1
81837,2,1,286703,286703,286704,0,1,1
81838,2,1,286705,286705,286706,0,1,1
81839,6,2,286711,286711,286713,0,2,5
81840,6,1,286717,286717,286718,0,1,4
81841,6,1,286723,286723,286724,0,1,5
81842,6,3,286729,286729,286732,0,3,5
81843,6,2,286735,286735,286737,0,2,3
81844,3,2,286738,286738,286740,0,2,1
81845,3,2,286741,286741,286743,0,2,1
81846,2,1,286743,286743,286744,0,1,0
81847,1,1,286744,286744,286745,0,1,0
81848,1,3,286745,286745,286748,0,3,0
81849,1,2,286746,286748,286750,2,4,0
81850,6,1,286752,286752,286753,0,1,2
81851,1,1,286753,286753,286754,0,1,0
81852,2,3,286755,286755,286758,0,3,1
81853,6,2,286761,286761,286763,0,2,3
81854,1,2,286762,286763,286765,1,3,0
81855,2,2,286764,286765,286767,1,3,0
81856,6,2,286770,286770,286772,0,2,3
81857,5,1,286775,286775,286776,0,1,3
81858,4,1,286779,286779,286780,0,1,3
81859,4,3,286783,286783,286786,0,3,3
81860,3,2,286786,286786,286788,0,2,0
81861,3,2,286789,286789,286791,0,2,1
81862,6,2,286795,286795,286797,0,2,4
81863,2,3,286797,286797,286800,0,3,0
81864,4,3,286801,286801,286804,0,3,1
81865,5,2,286806,286806,286808,0,2,2
81866,3,1,286809,286809,286810,0,1,1
81867,4,1,286813,286813,286814,0,1,3
81868,4,3,286817,286817,286820,0,3,3
81869,4,1,286821,286821,286822,0,1,1
81870,6,3,286827,286827,286830,0,3,5
81871,6,1,286833,286833,286834,0,1,3
81872,2,3,286835,286835,286838,0,3,1
81873,6,3,286841,286841,286844,0,3,3
81874,4,1,286845,286845,286846,0,1,1
81875,5,1,286850,286850,286851,0,1,4
81876,3,3,286853,286853,286856,0,3,2
81877,1,1,286854,286856,286857,2,3,0
81878,4,1,286858,286858,286859,0,1,1
81879,2,2,286860,286860,286862,0,2,1
81880,6,1,286866,286866,286867,0,1,4
81881,1,2,286867,286867,286869,0,2,0
81882,5,3,286872,286872,286875,0,3,3
81883,6,3,286878,286878,286881,0,3,3
81884,6,1,286884,286884,286885,0,1,3
81885,3,2,286887,286887,286889,0,2,2
81886,4,2,286891,286891,286893,0,2,2
81887,6,3,286897,286897,286900,0,3,4
81888,6,1,286903,286903,286904,0,1,3
81889,3,1,286906,286906,286907,0,1,2
81890,1,3,286907,286907,286910,0,3,0
81891,6,2,286913,286913,286915,0,2,3
81892,6,3,286919,286919,286922,0,3,4
81893,6,1,286925,286925,286926,0,1,3
81894,4,3,286929,286929,286932,0,3,3
81895,4,2,286933,286933,286935,0,2,1
81896,5,1,286938,286938,286939,0,1,3
81897,6,2,286944,286944,286946,0,2,5
81898,3,1,286947,286947,286948,0,1,1
81899,4,1,286951,286951,286952,0,1,3
81900,4,3,286955,286955,286958,0,3,3
81901,1,3,286956,286958,286961,2,5,0
81902,6,2,286962,286962,286964,0,2,1
81903,3,1,286965,286965,286966,0,1,1
81904,3,2,286968,286968,286970,0,2,2
81905,3,3,286971,286971,286974,0,3,1
81906,6,2,286977,286977,286979,0,2,3
81907,6,3,286983,286983,286986,0,3,4
81908,1,3,286984,286986,286989,2,5,0
81909,5,2,286989,286989,286991,0,2,0
81910,4,2,286993,286993,286995,0,2,2
81911,4,1,286997,286997,286998,0,1,2
81912,5,1,287002,287002,287003,0,1,4
81913,5,1,287007,287007,287008,0,1,4
81914,4,3,287011,287011,287014,0,3,3
81915,4,3,287015,287015,287018,0,3,1
81916,4,1,287019,287019,287020,0,1,1
81917,6,3,287025,287025,287028,0,3,5
81918,2,3,287027,287028,287031,1,4,0
81919,3,2,287030,287031,287033,1,3,0
81920,1,1,287031,287033,287034,2,3,0
81921,6,3,287037,287037,287040,0,3,3
81922,5,3,287042,287042,287045,0,3,2
81923,3,3,287045,287045,287048,0,3,0
81924,3,2,287048,287048,287050,0,2,0
81925,1,1,287049,287050,287051,1,2,0
81926,3,2,287052,287052,287054,0,2,1
81927,4,1,287056,287056,287057,0,1,2
81928,1,3,287057,287057,287060,0,3,0
81929,3,2,287060,287060,287062,0,2,0
81930,4,1,287064,287064,287065,0,1,2
81931,2,1,287066,287066,287067,0,1,1
81932,6,2,287072,287072,287074,0,2,5
81933,6,3,287078,287078,287081,0,3,4
81934,6,2,287084,287084,287086,0,2,3
81935,5,1,287089,287089,287090,0,1,3
81936,6,1,287095,287095,287096,0,1,5
81937,5,1,287100,287100,287101,0,1,4
81938,4,3,287104,287104,287107,0,3,3
81939,6,3,287110,287110,287113,0,3,3
81940,2,1,287112,287113,287114,1,2,0
81941,6,2,287118,287118,287120,0,2,4
81942,1,2,287119,287120,287122,1,3,0
81943,4,2,287123,287123,287125,0,2,1
81944,1,2,287124,287125,287127,1,3,0
81945,2,3,287126,287127,287130,1,4,0
81946,2,3,287128,287130,287133,2,5,0
81947,1,1,287129,287133,287134,4,5,0
81948,4,2,287133,287134,287136,1,3,0
81949,4,1,287137,287137,287138,0,1,1
81950,5,2,287142,287142,287144,0,2,4
81951,4,1,287146,287146,287147,0,1,2
81952,1,2,287147,287147,287149,0,2,0
81953,6,1,287153,287153,287154,0,1,4
81954,6,1,287159,287159,287160,0,1,5
81955,4,2,287163,287163,287165,0,2,3
81956,3,2,287166,287166,287168,0,2,1
81957,3,2,287169,287169,287171,0,2,1
81958,5,2,287174,287174,287176,0,2,3
81959,2,2,287176,287176,287178,0,2,0
81960,5,3,287181,287181,287184,0,3,3
81961,3,2,287184,287184,287186,0,2,0
81962,3,3,287187,287187,287190,0,3,1
81963,6,3,287193,287193,287196,0,3,3
81964,2,2,287195,287196,287198,1,3,0
81965,3,1,287198,287198,287199,0,1,0
81966,5,2,287203,287203,287205,0,2,4
81967,4,3,287207,287207,287210,0,3,2
81968,5,1,287212,287212,287213,0,1,2
81969,2,1,287214,287214,287215,0,1,1
81970,5,1,287219,287219,287220,0,1,4
81971,5,1,287224,287224,287225,0,1,4
81972,6,1,287230,287230,287231,0,1,5
81973,5,3,287235,287235,287238,0,3,4
81974,3,2,287238,287238,287240,0,2,0
81975,2,2,287240,287240,287242,0,2,0
81976,4,2,287244,287244,287246,0,2,2
81977,2,3,287246,287246,287249,0,3,0
81978,1,1,287247,287249,287250,2,3,0
81979,4,3,287251,287251,287254,0,3,1
81980,1,1,287252,287254,287255,2,3,0
81981,6,3,287258,287258,287261,0,3,3
81982,4,3,287262,287262,287265,0,3,1
81983,6,2,287268,287268,287270,0,2,3
81984,4,2,287272,287272,287274,0,2,2
81985,2,2,287274,287274,287276,0,2,0
81986,5,3,287279,287279,287282,0,3,3
81987,5,3,287284,287284,287287,0,3,2
81988,3,2,287287,287287,287289,0,2,0
81989,2,1,287289,287289,287290,0,1,0
81990,4,3,287293,287293,287296,0,3,3
81991,4,2,287297,287297,287299,0,2,1
81992,3,3,287300,287300,287303,0,3,1
81993,2,3,287302,287303,287306,1,4,0
81994,5,2,287307,287307,287309,0,2,1
81995,5,1,287312,287312,287313,0,1,3
81996,6,2,287318,287318,287320,0,2,5
81997,6,1,287324,287324,287325,0,1,4
81998,4,2,287328,287328,287330,0,2,3
81999,3,2,287331,287331,287333,0,2,1
82000,4,2,287335,287335,287337,0,2,2
82001,4,1,287339,287339,287340,0,1,2
82002,4,2,287343,287343,287345,0,2,3
82003,2,3,287345,287345,287348,0,3,0
82004,2,2,287347,287348,287350,1,3,0
82005,5,1,287352,287352,287353,0,1,2
82006,3,3,287355,287355,287358,0,3,2
82007,6,3,287361,287361,287364,0,3,3
82008,5,2,287366,287366,287368,0,2,2
82009,4,2,287370,287370,287372,0,2,2
82010,1,3,287371,287372,287375,1,4,0
82011,4,1,287375,287375,287376,0,1,0
82012,4,1,287379,287379,287380,0,1,3
82013,5,3,287384,287384,287387,0,3,4
82014,4,3,287388,287388,287391,0,3,1
82015,6,2,287394,287394,287396,0,2,3
82016,3,3,287397,287397,287400,0,3,1
82017,6,1,287403,287403,287404,0,1,3
82018,4,3,287407,287407,287410,0,3,3
82019,1,3,287408,287410,287413,2,5,0
82020,6,2,287414,287414,287416,0,2,1
82021,4,3,287418,287418,287421,0,3,2
82022,5,2,287423,287423,287425,0,2,2
82023,2,3,287425,287425,287428,0,3,0
82024,2,1,287427,287428,287429,1,2,0
82025,3,1,287430,287430,287431,0,1,1
82026,5,1,287435,287435,287436,0,1,4
82027,4,1,287439,287439,287440,0,1,3
82028,5,3,287444,287444,287447,0,3,4
82029,3,2,287447,287447,287449,0,2,0
82030,5,2,287452,287452,287454,0,2,3
82031,6,1,287458,287458,287459,0,1,4
82032,3,2,287461,287461,287463,0,2,2
82033,6,1,287467,287467,287468,0,1,4
82034,5,3,287472,287472,287475,0,3,4
82035,1,3,287473,287475,287478,2,5,0
82036,3,2,287476,287478,287480,2,4,0
82037,2,2,287478,287480,287482,2,4,0
82038,3,2,287481,287482,287484,1,3,0
82039,5,2,287486,287486,287488,0,2,2
82040,5,3,287491,287491,287494,0,3,3
82041,3,1,287494,287494,287495,0,1,0
82042,2,2,287496,287496,287498,0,2,1
82043,1,2,287497,287498,287500,1,3,0
82044,1,2,287498,287500,287502,2,4,0
82045,6,3,287504,287504,287507,0,3,2
82046,2,2,287506,287507,287509,1,3,0
82047,5,3,287511,287511,287514,0,3,2
82048,6,3,287517,287517,287520,0,3,3
82049,3,2,287520,287520,287522,0,2,0
82050,2,3,287522,287522,287525,0,3,0
82051,2,3,287524,287525,287528,1,4,0
82052,5,1,287529,287529,287530,0,1,1
82053,1,3,287530,287530,287533,0,3,0
82054,4,1,287534,287534,287535,0,1,1
82055,6,3,287540,287540,287543,0,3,5
82056,6,1,287546,287546,287547,0,1,3
82057,2,2,287548,287548,287550,0,2,1
82058,2,2,287550,287550,287552,0,2,0
82059,2,2,287552,287552,287554,0,2,0
82060,2,2,287554,287554,287556,0,2,0
82061,4,1,287558,287558,287559,0,1,2
82062,5,3,287563,287563,287566,0,3,4
82063,4,3,287567,287567,287570,0,3,1
82064,5,1,287572,287572,287573,0,1,2
82065,3,1,287575,287575,287576,0,1,2
82066,2,3,287577,287577,287580,0,3,1
82067,5,1,287582,287582,287583,0,1,2
82068,1,3,287583,287583,287586,0,3,0
82069,4,1,287587,287587,287588,0,1,1
82070,5,1,287592,287592,287593,0,1,4
82071,2,3,287594,287594,287597,0,3,1
82072,2,3,287596,287597,287600,1,4,0
82073,1,3,287597,287600,287603,3,6,0
82074,1,1,287598,287603,287604,5,6,0
82075,2,3,287600,287604,287607,4,7,0
82076,6,1,287606,287607,287608,1,2,0
82077,5,3,287611,287611,287614,0,3,3
82078,1,2,287612,287614,287616,2,4,0
82079,1,2,287613,287616,287618,3,5,0
82080,3,1,287616,287618,287619,2,3,0
82081,3,3,287619,287619,287622,0,3,0
82082,3,1,287622,287622,287623,0,1,0
82083,4,1,287626,287626,287627,0,1,3
82084,2,3,287628,287628,287631,0,3,1
82085,5,2,287633,287633,287635,0,2,2
82086,1,2,287634,287635,287637,1,3,0
82087,5,2,287639,287639,287641,0,2,2
82088,4,1,287643,287643,287644,0,1,2
82089,4,2,287647,287647,287649,0,2,3
82090,6,3,287653,287653,287656,0,3,4
82091,1,1,287654,287656,287657,2,3,0
82092,6,3,287660,287660,287663,0,3,3
82093,5,2,287665,287665,287667,0,2,2
82094,4,1,287669,287669,287670,0,1,2
82095,1,1,287670,287670,287671,0,1,0
82096,3,3,287673,287673,287676,0,3,2
82097,4,3,287677,287677,287680,0,3,1
82098,5,1,287682,287682,287683,0,1,2
82099,5,3,287687,287687,287690,0,3,4
82100,6,1,287693,287693,287694,0,1,3
82101,2,3,287695,287695,287698,0,3,1
82102,6,3,287701,287701,287704,0,3,3
82103,2,2,287703,287704,287706,1,3,0
82104,2,1,287705,287706,287707,1,2,0
82105,4,3,287709,287709,287712,0,3,2
82106,4,2,287713,287713,287715,0,2,1
82107,6,3,287719,287719,287722,0,3,4
82108,1,2,287720,287722,287724,2,4,0
82109,5,1,287725,287725,287726,0,1,1
82110,1,2,287726,287726,287728,0,2,0
82111,1,3,287727,287728,287731,1,4,0
82112,2,2,287729,287731,287733,2,4,0
82113,3,1,287732,287733,287734,1,2,0
82114,4,1,287736,287736,287737,0,1,2
82115,1,1,287737,287737,287738,0,1,0
82116,2,1,287739,287739,287740,0,1,1
82117,1,2,287740,287740,287742,0,2,0
82118,2,2,287742,287742,287744,0,2,0
82119,5,3,287747,287747,287750,0,3,3
82120,5,1,287752,287752,287753,0,1,2
82121,3,2,287755,287755,287757,0,2,2
82122,4,2,287759,287759,287761,0,2,2
82123,5,2,287764,287764,287766,0,2,3
82124,3,2,287767,287767,287769,0,2,1
82125,5,3,287772,287772,287775,0,3,3
82126,2,2,287774,287775,287777,1,3,0
82127,1,1,287775,287777,287778,2,3,0
82128,3,2,287778,287778,287780,0,2,0
82129,3,2,287781,287781,287783,0,2,1
82130,5,3,287786,287786,287789,0,3,3
82131,5,1,287791,287791,287792,0,1,2
82132,5,1,287796,287796,287797,0,1,4
82133,5,2,287801,287801,287803,0,2,4
82134,6,2,287807,287807,287809,0,2,4
82135,4,3,287811,287811,287814,0,3,2
82136,6,1,287817,287817,287818,0,1,3
82137,1,2,287818,287818,287820,0,2,0
82138,1,3,287819,287820,287823,1,4,0
82139,1,2,287820,287823,287825,3,5,0
82140,6,2,287826,287826,287828,0,2,1
82141,4,1,287830,287830,287831,0,1,2
82142,6,3,287836,287836,287839,0,3,5
82143,2,1,287838,287839,287840,1,2,0
82144,3,3,287841,287841,287844,0,3,1
82145,4,1,287845,287845,287846,0,1,1
82146,1,2,287846,287846,287848,0,2,0
82147,5,1,287851,287851,287852,0,1,3
82148,1,3,287852,287852,287855,0,3,0
82149,1,1,287853,287855,287856,2,3,0
82150,3,1,287856,287856,287857,0,1,0
82151,1,2,287857,287857,287859,0,2,0
82152,4,2,287861,287861,287863,0,2,2
82153,1,2,287862,287863,287865,1,3,0
82154,1,2,287863,287865,287867,2,4,0
82155,5,2,287868,287868,287870,0,2,1
82156,2,1,287870,287870,287871,0,1,0
82157,4,3,287874,287874,287877,0,3,3
82158,1,3,287875,287877,287880,2,5,0
82159,1,2,287876,287880,287882,4,6,0
82160,5,2,287881,287882,287884,1,3,0
82161,6,3,287887,287887,287890,0,3,3
82162,4,3,287891,287891,287894,0,3,1
82163,1,1,287892,287894,287895,2,3,0
82164,4,3,287896,287896,287899,0,3,1
82165,3,1,287899,287899,287900,0,1,0
82166,1,1,287900,287900,287901,0,1,0
82167,3,3,287903,287903,287906,0,3,2
82168,5,2,287908,287908,287910,0,2,2
82169,6,1,287914,287914,287915,0,1,4
82170,2,2,287916,287916,287918,0,2,1
82171,5,1,287921,287921,287922,0,1,3
82172,1,3,287922,287922,287925,0,3,0
82173,3,1,287925,287925,287926,0,1,0
82174,3,3,287928,287928,287931,0,3,2
82175,5,3,287933,287933,287936,0,3,2
82176,3,2,287936,287936,287938,0,2,0
82177,5,2,287941,287941,287943,0,2,3
82178,2,2,287943,287943,287945,0,2,0
82179,6,3,287949,287949,287952,0,3,4
82180,6,2,287955,287955,287957,0,2,3
82181,2,1,287957,287957,287958,0,1,0
82182,2,1,287959,287959,287960,0,1,1
82183,3,1,287962,287962,287963,0,1,2
82184,1,2,287963,287963,287965,0,2,0
82185,1,1,287964,287965,287966,1,2,0
82186,1,3,287965,287966,287969,1,4,0
82187,4,1,287969,287969,287970,0,1,0
82188,3,2,287972,287972,287974,0,2,2
82189,6,1,287978,287978,287979,0,1,4
82190,5,3,287983,287983,287986,0,3,4
82191,2,3,287985,287986,287989,1,4,0
82192,4,1,287989,287989,287990,0,1,0
82193,2,1,287991,287991,287992,0,1,1
82194,1,3,287992,287992,287995,0,3,0
82195,5,2,287997,287997,287999,0,2,2
82196,6,2,288003,288003,288005,0,2,4
82197,6,2,288009,288009,288011,0,2,4
82198,6,3,288015,288015,288018,0,3,4
82199,5,3,288020,288020,288023,0,3,2
82200,6,1,288026,288026,288027,0,1,3
82201,4,3,288030,288030,288033,0,3,3
82202,4,2,288034,288034,288036,0,2,1
82203,5,3,288039,288039,288042,0,3,3
82204,2,3,288041,288042,288045,1,4,0
82205,4,1,288045,288045,288046,0,1,0
82206,2,3,288047,288047,288050,0,3,1
82207,6,2,288053,288053,288055,0,2,3
82208,1,2,288054,288055,288057,1,3,0
82209,5,1,288059,288059,288060,0,1,2
82210,1,3,288060,288060,288063,0,3,0
82211,5,1,288065,288065,288066,0,1,2
82212,1,3,288066,288066,288069,0,3,0
82213,6,1,288072,288072,288073,0,1,3
82214,1,3,288073,288073,288076,0,3,0
82215,1,2,288074,288076,288078,2,4,0
82216,2,3,288076,288078,288081,2,5,0
82217,1,1,288077,288081,288082,4,5,0
82218,2,3,288079,288082,288085,3,6,0
82219,4,3,288083,288085,288088,2,5,0
82220,1,3,288084,288088,288091,4,7,0
82221,5,2,288089,288091,288093,2,4,0
82222,2,1,288091,288093,288094,2,3,0
82223,2,2,288093,288094,288096,1,3,0
82224,3,1,288096,288096,288097,0,1,0
82225,6,3,288102,288102,288105,0,3,5
82226,5,1,288107,288107,288108,0,1,2
82227,3,2,288110,288110,288112,0,2,2
82228,2,1,288112,288112,288113,0,1,0
82229,3,3,288115,288115,288118,0,3,2
82230,6,3,288121,288121,288124,0,3,3
82231,5,3,288126,288126,288129,0,3,2
82232,1,3,288127,288129,288132,2,5,0
82233,5,3,288132,288132,288135,0,3,0
82234,6,1,288138,288138,288139,0,1,3
82235,2,2,288140,288140,288142,0,2,1
82236,3,2,288143,288143,288145,0,2,1
82237,1,2,288144,288145,288147,1,3,0
82238,4,2,288148,288148,288150,0,2,1
82239,6,1,288154,288154,288155,0,1,4
82240,1,2,288155,288155,288157,0,2,0
82241,1,1,288156,288157,288158,1,2,0
82242,4,3,288160,288160,288163,0,3,2
82243,5,1,288165,288165,288166,0,1,2
82244,4,3,288169,288169,288172,0,3,3
82245,2,3,288171,288172,288175,1,4,0
82246,1,1,288172,288175,288176,3,4,0
82247,1,3,288173,288176,288179,3,6,0
82248,1,3,288174,288179,288182,5,8,0
82249,2,2,288176,288182,288184,6,8,0
82250,1,3,288177,288184,288187,7,10,0
82251,3,1,288180,288187,288188,7,8,0
82252,1,1,288181,288188,288189,7,8,0
82253,3,3,288184,288189,288192,5,8,0
82254,2,3,288186,288192,288195,6,9,0
82255,2,1,288188,288195,288196,7,8,0
82256,5,2,288193,288196,288198,3,5,0
82257,2,2,288195,288198,288200,3,5,0
82258,1,3,288196,288200,288203,4,7,0
82259,3,1,288199,288203,288204,4,5,0
82260,6,1,288205,288205,288206,0,1,1
82261,4,3,288209,288209,288212,0,3,3
82262,2,3,288211,288212,288215,1,4,0
82263,5,3,288216,288216,288219,0,3,1
82264,3,1,288219,288219,288220,0,1,0
82265,1,3,288220,288220,288223,0,3,0
82266,5,1,288225,288225,288226,0,1,2
82267,6,1,288231,288231,288232,0,1,5
82268,1,2,288232,288232,288234,0,2,0
82269,4,3,288236,288236,288239,0,3,2
82270,2,1,288238,288239,288240,1,2,0
82271,1,1,288239,288240,288241,1,2,0
82272,3,3,288242,288242,288245,0,3,1
82273,5,1,288247,288247,288248,0,1,2
82274,3,1,288250,288250,288251,0,1,2
82275,2,2,288252,288252,288254,0,2,1
82276,3,3,288255,288255,288258,0,3,1
82277,2,2,288257,288258,288260,1,3,0
82278,1,1,288258,288260,288261,2,3,0
82279,1,1,288259,288261,288262,2,3,0
82280,1,1,288260,288262,288263,2,3,0
82281,3,1,288263,288263,288264,0,1,0
82282,2,1,288265,288265,288266,0,1,1
82283,3,2,288268,288268,288270,0,2,2
82284,1,2,288269,288270,288272,1,3,0
82285,6,1,288275,288275,288276,0,1,3
82286,6,1,288281,288281,288282,0,1,5
82287,5,2,288286,288286,288288,0,2,4
82288,1,2,288287,288288,288290,1,3,0
82289,5,3,288292,288292,288295,0,3,2
82290,1,2,288293,288295,288297,2,4,0
82291,5,3,288298,288298,288301,0,3,1
82292,6,1,288304,288304,288305,0,1,3
82293,3,3,288307,288307,288310,0,3,2
82294,4,2,288311,288311,288313,0,2,1
82295,1,2,288312,288313,288315,1,3,0
82296,2,3,288314,288315,288318,1,4,0
82297,3,1,288317,288318,288319,1,2,0
82298,3,3,288320,288320,288323,0,3,1
82299,5,1,288325,288325,288326,0,1,2
82300,4,2,288329,288329,288331,0,2,3
82301,2,2,288331,288331,288333,0,2,0
82302,4,3,288335,288335,288338,0,3,2
82303,2,3,288337,288338,288341,1,4,0
82304,2,3,288339,288341,288344,2,5,0
82305,6,2,288345,288345,288347,0,2,1
82306,6,1,288351,288351,288352,0,1,4
82307,6,3,288357,288357,288360,0,3,5
82308,3,3,288360,288360,288363,0,3,0
82309,5,2,288365,288365,288367,0,2,2
82310,4,1,288369,288369,288370,0,1,2
82311,3,1,288372,288372,288373,0,1,2
82312,6,1,288378,288378,288379,0,1,5
82313,1,2,288379,288379,288381,0,2,0
82314,1,2,288380,288381,288383,1,3,0
82315,4,2,288384,288384,288386,0,2,1
82316,3,2,288387,288387,288389,0,2,1
82317,2,2,288389,288389,288391,0,2,0
82318,1,3,288390,288391,288394,1,4,0
82319,4,2,288394,288394,288396,0,2,0
82320,5,1,288399,288399,288400,0,1,3
82321,2,1,288401,288401,288402,0,1,1
82322,1,3,288402,288402,288405,0,3,0
82323,1,3,288403,288405,288408,2,5,0
82324,2,3,288405,288408,288411,3,6,0
82325,2,1,288407,288411,288412,4,5,0
82326,1,3,288408,288412,288415,4,7,0
82327,4,2,288412,288415,288417,3,5,0
82328,2,1,288414,288417,288418,3,4,0
82329,4,2,288418,288418,288420,0,2,0
82330,1,1,288419,288420,288421,1,2,0
82331,1,1,288420,288421,288422,1,2,0
82332,2,1,288422,288422,288423,0,1,0
82333,5,3,288427,288427,288430,0,3,4
82334,4,2,288431,288431,288433,0,2,1
82335,5,1,288436,288436,288437,0,1,3
82336,6,3,288442,288442,288445,0,3,5
82337,6,2,288448,288448,288450,0,2,3
82338,6,3,288454,288454,288457,0,3,4
82339,3,3,288457,288457,288460,0,3,0
82340,6,1,288463,288463,288464,0,1,3
82341,1,3,288464,288464,288467,0,3,0
82342,1,3,288465,288467,288470,2,5,0
82343,5,3,288470,288470,288473,0,3,0
82344,4,2,288474,288474,288476,0,2,1
82345,4,1,288478,288478,288479,0,1,2
82346,5,3,288483,288483,288486,0,3,4
82347,3,2,288486,288486,288488,0,2,0
82348,2,3,288488,288488,288491,0,3,0
82349,1,1,288489,288491,288492,2,3,0
82350,6,2,288495,288495,288497,0,2,3
82351,5,3,288500,288500,288503,0,3,3
82352,1,3,288501,288503,288506,2,5,0
82353,1,1,288502,288506,288507,4,5,0
82354,6,3,288508,288508,288511,0,3,1
82355,3,1,288511,288511,288512,0,1,0
82356,2,2,288513,288513,288515,0,2,1
82357,3,3,288516,288516,288519,0,3,1
82358,6,1,288522,288522,288523,0,1,3
82359,2,1,288524,288524,288525,0,1,1
82360,4,2,288528,288528,288530,0,2,3
82361,3,2,288531,288531,288533,0,2,1
82362,2,3,288533,288533,288536,0,3,0
82363,6,1,288539,288539,288540,0,1,3
82364,3,2,288542,288542,288544,0,2,2
82365,4,2,288546,288546,288548,0,2,2
82366,6,2,288552,288552,288554,0,2,4
82367,6,3,288558,288558,288561,0,3,4
82368,3,3,288561,288561,288564,0,3,0
82369,4,1,288565,288565,288566,0,1,1
82370,6,1,288571,288571,288572,0,1,5
82371,3,3,288574,288574,288577,0,3,2
82372,2,3,288576,288577,288580,1,4,0
82373,4,1,288580,288580,288581,0,1,0
82374,2,1,288582,288582,288583,0,1,1
82375,6,2,288588,288588,288590,0,2,5
82376,1,1,288589,288590,288591,1,2,0
82377,2,3,288591,288591,288594,0,3,0
82378,3,3,288594,288594,288597,0,3,0
82379,2,2,288596,288597,288599,1,3,0
82380,1,3,288597,288599,288602,2,5,0
82381,1,2,288598,288602,288604,4,6,0
82382,4,2,288602,288604,288606,2,4,0
82383,5,1,288607,288607,288608,0,1,1
82384,1,2,288608,288608,288610,0,2,0
82385,6,3,288614,288614,288617,0,3,4
82386,1,2,288615,288617,288619,2,4,0
82387,5,2,288620,288620,288622,0,2,1
82388,1,2,288621,288622,288624,1,3,0
82389,6,3,288627,288627,288630,0,3,3
82390,2,3,288629,288630,288633,1,4,0
82391,6,2,288635,288635,288637,0,2,2
82392,4,1,288639,288639,288640,0,1,2
82393,6,3,288645,288645,288648,0,3,5
82394,4,3,288649,288649,288652,0,3,1
82395,3,3,288652,288652,288655,0,3,0
82396,1,1,288653,288655,288656,2,3,0
82397,2,1,288655,288656,288657,1,2,0
82398,3,3,288658,288658,288661,0,3,1
82399,6,1,288664,288664,288665,0,1,3
82400,4,1,288668,288668,288669,0,1,3
82401,6,3,288674,288674,288677,0,3,5
82402,3,2,288677,288677,288679,0,2,0
82403,3,1,288680,288680,288681,0,1,1
82404,2,3,288682,288682,288685,0,3,1
82405,4,3,288686,288686,288689,0,3,1
82406,5,2,288691,288691,288693,0,2,2
82407,1,3,288692,288693,288696,1,4,0
82408,3,1,288695,288696,288697,1,2,0
82409,5,2,288700,288700,288702,0,2,3
82410,5,1,288705,288705,288706,0,1,3
82411,5,2,288710,288710,288712,0,2,4
82412,6,1,288716,288716,288717,0,1,4
82413,6,3,288722,288722,288725,0,3,5
82414,4,2,288726,288726,288728,0,2,1
82415,6,3,288732,288732,288735,0,3,4
82416,1,3,288733,288735,288738,2,5,0
82417,4,3,288737,288738,288741,1,4,0
82418,1,3,288738,288741,288744,3,6,0
82419,2,2,288740,288744,288746,4,6,0
82420,3,2,288743,288746,288748,3,5,0
82421,5,1,288748,288748,288749,0,1,0
82422,4,2,288752,288752,288754,0,2,3
82423,4,1,288756,288756,288757,0,1,2
82424,3,2,288759,288759,288761,0,2,2
82425,5,1,288764,288764,288765,0,1,3
82426,2,1,288766,288766,288767,0,1,1
82427,2,2,288768,288768,288770,0,2,1
82428,2,1,288770,288770,288771,0,1,0
82429,1,1,288771,288771,288772,0,1,0
82430,6,3,288777,288777,288780,0,3,5
82431,3,1,288780,288780,288781,0,1,0
82432,2,3,288782,288782,288785,0,3,1
82433,1,2,288783,288785,288787,2,4,0
82434,2,1,288785,288787,288788,2,3,0
82435,4,2,288789,288789,288791,0,2,1
82436,3,2,288792,288792,288794,0,2,1
82437,5,2,288797,288797,288799,0,2,3
82438,4,2,288801,288801,288803,0,2,2
82439,3,2,288804,288804,288806,0,2,1
82440,6,1,288810,288810,288811,0,1,4
82441,3,3,288813,288813,288816,0,3,2
82442,2,1,288815,288816,288817,1,2,0
82443,2,1,288817,288817,288818,0,1,0
82444,3,2,288820,288820,288822,0,2,2
82445,1,3,288821,288822,288825,1,4,0
82446,2,3,288823,288825,288828,2,5,0
82447,2,2,288825,288828,288830,3,5,0
82448,3,2,288828,288830,288832,2,4,0
82449,5,1,288833,288833,288834,0,1,1
82450,2,2,288835,288835,288837,0,2,1
82451,2,1,288837,288837,288838,0,1,0
82452,6,1,288843,288843,288844,0,1,5
82453,2,3,288845,288845,288848,0,3,1
82454,4,3,288849,288849,288852,0,3,1
82455,6,3,288855,288855,288858,0,3,3
82456,1,1,288856,288858,288859,2,3,0
82457,3,1,288859,288859,288860,0,1,0
82458,1,1,288860,288860,288861,0,1,0
82459,4,1,288864,288864,288865,0,1,3
82460,6,3,288870,288870,288873,0,3,5
82461,4,2,288874,288874,288876,0,2,1
82462,3,3,288877,288877,288880,0,3,1
82463,5,2,288882,288882,288884,0,2,2
82464,4,2,288886,288886,288888,0,2,2
82465,2,3,288888,288888,288891,0,3,0
82466,5,2,288893,288893,288895,0,2,2
82467,5,3,288898,288898,288901,0,3,3
82468,6,2,288904,288904,288906,0,2,3
82469,1,2,288905,288906,288908,1,3,0
82470,3,3,288908,288908,288911,0,3,0
82471,3,1,288911,288911,288912,0,1,0
82472,6,1,288917,288917,288918,0,1,5
82473,2,2,288919,288919,288921,0,2,1
82474,6,1,288925,288925,288926,0,1,4
82475,4,1,288929,288929,288930,0,1,3
82476,4,1,288933,288933,288934,0,1,3
82477,6,1,288939,288939,288940,0,1,5
82478,5,3,288944,288944,288947,0,3,4
82479,2,2,288946,288947,288949,1,3,0
82480,1,2,288947,288949,288951,2,4,0
82481,5,2,288952,288952,288954,0,2,1
82482,2,2,288954,288954,288956,0,2,0
82483,6,2,288960,288960,288962,0,2,4
82484,2,2,288962,288962,288964,0,2,0
82485,3,1,288965,288965,288966,0,1,1
82486,4,3,288969,288969,288972,0,3,3
82487,1,1,288970,288972,288973,2,3,0
82488,4,1,288974,288974,288975,0,1,1
82489,6,1,288980,288980,288981,0,1,5
82490,1,1,288981,288981,288982,0,1,0
82491,4,2,288985,288985,288987,0,2,3
82492,1,3,288986,288987,288990,1,4,0
82493,1,3,288987,288990,288993,3,6,0
82494,4,1,288991,288993,288994,2,3,0
82495,4,1,288995,288995,288996,0,1,1
82496,4,1,288999,288999,289000,0,1,3
82497,4,1,289003,289003,289004,0,1,3
82498,3,2,289006,289006,289008,0,2,2
82499,5,3,289011,289011,289014,0,3,3
82500,3,3,289014,289014,289017,0,3,0
82501,4,3,289018,289018,289021,0,3,1
82502,4,2,289022,289022,289024,0,2,1
82503,4,1,289026,289026,289027,0,1,2
82504,5,3,289031,289031,289034,0,3,4
82505,1,1,289032,289034,289035,2,3,0
82506,5,1,289037,289037,289038,0,1,2
82507,3,3,289040,289040,289043,0,3,2
82508,4,3,289044,289044,289047,0,3,1
82509,6,2,289050,289050,289052,0,2,3
82510,4,2,289054,289054,289056,0,2,2
82511,2,1,289056,289056,289057,0,1,0
82512,5,2,289061,289061,289063,0,2,4
82513,6,3,289067,289067,289070,0,3,4
82514,2,2,289069,289070,289072,1,3,0
82515,4,2,289073,289073,289075,0,2,1
82516,2,3,289075,289075,289078,0,3,0
82517,1,1,289076,289078,289079,2,3,0
82518,3,3,289079,289079,289082,0,3,0
82519,5,1,289084,289084,289085,0,1,2
82520,2,3,289086,289086,289089,0,3,1
82521,2,1,289088,289089,289090,1,2,0
82522,4,3,289092,289092,289095,0,3,2
82523,1,3,289093,289095,289098,2,5,0
82524,2,3,289095,289098,289101,3,6,0
82525,5,2,289100,289101,289103,1,3,0
82526,4,3,289104,289104,289107,0,3,1
82527,6,1,289110,289110,289111,0,1,3
82528,5,3,289115,289115,289118,0,3,4
82529,4,1,289119,289119,289120,0,1,1
82530,5,2,289124,289124,289126,0,2,4
82531,4,1,289128,289128,289129,0,1,2
82532,2,2,289130,289130,289132,0,2,1
82533,1,2,289131,289132,289134,1,3,0
82534,3,3,289134,289134,289137,0,3,0
82535,2,2,289136,289137,289139,1,3,0
82536,4,2,289140,289140,289142,0,2,1
82537,4,1,289144,289144,289145,0,1,2
82538,6,2,289150,289150,289152,0,2,5
82539,1,1,289151,289152,289153,1,2,0
82540,4,3,289155,289155,289158,0,3,2
82541,2,2,289157,289158,289160,1,3,0
82542,6,2,289163,289163,289165,0,2,3
82543,6,2,289169,289169,289171,0,2,4
82544,2,2,289171,289171,289173,0,2,0
82545,6,2,289177,289177,289179,0,2,4
82546,5,3,289182,289182,289185,0,3,3
82547,4,1,289186,289186,289187,0,1,1
82548,6,3,289192,289192,289195,0,3,5
82549,1,1,289193,289195,289196,2,3,0
82550,3,2,289196,289196,289198,0,2,0
82551,1,3,289197,289198,289201,1,4,0
82552,6,2,289203,289203,289205,0,2,2
82553,3,1,289206,289206,289207,0,1,1
82554,2,1,289208,289208,289209,0,1,1
82555,4,3,289212,289212,289215,0,3,3
82556,1,1,289213,289215,289216,2,3,0
82557,3,3,289216,289216,289219,0,3,0
82558,1,3,289217,289219,289222,2,5,0
82559,6,1,289223,289223,289224,0,1,1
82560,2,2,289225,289225,289227,0,2,1
82561,6,3,289231,289231,289234,0,3,4
82562,3,3,289234,289234,289237,0,3,0
82563,1,3,289235,289237,289240,2,5,0
82564,5,1,289240,289240,289241,0,1,0
82565,3,3,289243,289243,289246,0,3,2
82566,5,1,289248,289248,289249,0,1,2
82567,5,2,289253,289253,289255,0,2,4
82568,3,3,289256,289256,289259,0,3,1
82569,3,2,289259,289259,289261,0,2,0
82570,5,2,289264,289264,289266,0,2,3
82571,4,3,289268,289268,289271,0,3,2
82572,2,2,289270,289271,289273,1,3,0
82573,1,3,289271,289273,289276,2,5,0
82574,6,1,289277,289277,289278,0,1,1
82575,6,1,289283,289283,289284,0,1,5
82576,2,2,289285,289285,289287,0,2,1
82577,4,1,289289,289289,289290,0,1,2
82578,2,2,289291,289291,289293,0,2,1
82579,6,2,289297,289297,289299,0,2,4
82580,3,2,289300,289300,289302,0,2,1
82581,6,2,289306,289306,289308,0,2,4
82582,6,1,289312,289312,289313,0,1,4
82583,1,1,289313,289313,289314,0,1,0
82584,6,2,289319,289319,289321,0,2,5
82585,1,1,289320,289321,289322,1,2,0
82586,4,3,289324,289324,289327,0,3,2
82587,1,2,289325,289327,289329,2,4,0
82588,4,2,289329,289329,289331,0,2,0
82589,4,3,289333,289333,289336,0,3,2
82590,3,3,289336,289336,289339,0,3,0
82591,5,3,289341,289341,289344,0,3,2
82592,6,3,289347,289347,289350,0,3,3
82593,2,1,289349,289350,289351,1,2,0
82594,1,2,289350,289351,289353,1,3,0
82595,4,3,289354,289354,289357,0,3,1
82596,6,1,289360,289360,289361,0,1,3
82597,4,2,289364,289364,289366,0,2,3
82598,6,1,289370,289370,289371,0,1,4
82599,3,3,289373,289373,289376,0,3,2
82600,6,2,289379,289379,289381,0,2,3
82601,5,2,289384,289384,289386,0,2,3
82602,2,1,289386,289386,289387,0,1,0
82603,1,3,289387,289387,289390,0,3,0
82604,4,2,289391,289391,289393,0,2,1
82605,2,3,289393,289393,289396,0,3,0
82606,1,2,289394,289396,289398,2,4,0
82607,6,1,289400,289400,289401,0,1,2
82608,2,1,289402,289402,289403,0,1,1
82609,3,3,289405,289405,289408,0,3,2
82610,1,2,289406,289408,289410,2,4,0
82611,4,2,289410,289410,289412,0,2,0
82612,6,2,289416,289416,289418,0,2,4
82613,6,2,289422,289422,289424,0,2,4
82614,5,3,289427,289427,289430,0,3,3
82615,6,3,289433,289433,289436,0,3,3
82616,5,2,289438,289438,289440,0,2,2
82617,4,1,289442,289442,289443,0,1,2
82618,2,3,289444,289444,289447,0,3,1
82619,2,2,289446,289447,289449,1,3,0
82620,6,2,289452,289452,289454,0,2,3
82621,6,3,289458,289458,289461,0,3,4
82622,5,2,289463,289463,289465,0,2,2
82623,3,3,289466,289466,289469,0,3,1
82624,6,2,289472,289472,289474,0,2,3
82625,4,1,289476,289476,289477,0,1,2
82626,4,2,289480,289480,289482,0,2,3
82627,3,2,289483,289483,289485,0,2,1
82628,1,3,289484,289485,289488,1,4,0
82629,2,1,289486,289488,289489,2,3,0
82630,4,1,289490,289490,289491,0,1,1
82631,4,3,289494,289494,289497,0,3,3
82632,2,2,289496,289497,289499,1,3,0
82633,6,2,289502,289502,289504,0,2,3
82634,3,3,289505,289505,289508,0,3,1
82635,5,3,289510,289510,289513,0,3,2
82636,4,1,289514,289514,289515,0,1,1
82637,2,3,289516,289516,289519,0,3,1
82638,3,1,289519,289519,289520,0,1,0
82639,2,1,289521,289521,289522,0,1,1
82640,3,2,289524,289524,289526,0,2,2
82641,2,1,289526,289526,289527,0,1,0
82642,2,2,289528,289528,289530,0,2,1
82643,1,1,289529,289530,289531,1,2,0
82644,1,1,289530,289531,289532,1,2,0
82645,3,1,289533,289533,289534,0,1,1
82646,6,2,289539,289539,289541,0,2,5
82647,3,1,289542,289542,289543,0,1,1
82648,6,1,289548,289548,289549,0,1,5
82649,3,3,289551,289551,289554,0,3,2
82650,5,2,289556,289556,289558,0,2,2
82651,3,2,289559,289559,289561,0,2,1
82652,4,2,289563,289563,289565,0,2,2
82653,1,3,289564,289565,289568,1,4,0
82654,6,2,289570,289570,289572,0,2,2
82655,4,2,289574,289574,289576,0,2,2
82656,3,3,289577,289577,289580,0,3,1
82657,4,1,289581,289581,289582,0,1,1
82658,3,1,289584,289584,289585,0,1,2
82659,6,3,289590,289590,289593,0,3,5
82660,3,2,289593,289593,289595,0,2,0
82661,6,2,289599,289599,289601,0,2,4
82662,3,3,289602,289602,289605,0,3,1
82663,3,3,289605,289605,289608,0,3,0
82664,3,2,289608,289608,289610,0,2,0
82665,4,2,289612,289612,289614,0,2,2
82666,2,2,289614,289614,289616,0,2,0
82667,3,2,289617,289617,289619,0,2,1
82668,5,1,289622,289622,289623,0,1,3
82669,5,2,289627,289627,289629,0,2,4
82670,3,2,289630,289630,289632,0,2,1
82671,6,1,289636,289636,289637,0,1,4
82672,5,3,289641,289641,289644,0,3,4
82673,3,2,289644,289644,289646,0,2,0
82674,3,1,289647,289647,289648,0,1,1
82675,2,3,289649,289649,289652,0,3,1
82676,2,1,289651,289652,289653,1,2,0
82677,3,3,289654,289654,289657,0,3,1
82678,1,1,289655,289657,289658,2,3,0
82679,2,1,289657,289658,289659,1,2,0
82680,6,1,289663,289663,289664,0,1,4
82681,2,2,289665,289665,289667,0,2,1
82682,2,3,289667,289667,289670,0,3,0
82683,1,1,289668,289670,289671,2,3,0
82684,5,1,289673,289673,289674,0,1,2
82685,6,3,289679,289679,289682,0,3,5
82686,4,1,289683,289683,289684,0,1,1
82687,4,1,289687,289687,289688,0,1,3
82688,2,2,289689,289689,289691,0,2,1
82689,1,1,289690,289691,289692,1,2,0
82690,5,3,289695,289695,289698,0,3,3
82691,6,2,289701,289701,289703,0,2,3
82692,4,3,289705,289705,289708,0,3,2
82693,2,2,289707,289708,289710,1,3,0
82694,1,1,289708,289710,289711,2,3,0
82695,2,2,289710,289711,289713,1,3,0
82696,3,2,289713,289713,289715,0,2,0
82697,3,2,289716,289716,289718,0,2,1
82698,6,1,289722,289722,289723,0,1,4
82699,4,3,289726,289726,289729,0,3,3
82700,1,3,289727,289729,289732,2,5,0
82701,1,2,289728,289732,289734,4,6,0
82702,4,2,289732,289734,289736,2,4,0
82703,6,1,289738,289738,289739,0,1,2
82704,6,2,289744,289744,289746,0,2,5
82705,6,1,289750,289750,289751,0,1,4
82706,5,2,289755,289755,289757,0,2,4
82707,3,1,289758,289758,289759,0,1,1
82708,5,3,289763,289763,289766,0,3,4
82709,1,3,289764,289766,289769,2,5,0
82710,1,1,289765,289769,289770,4,5,0
82711,6,1,289771,289771,289772,0,1,1
82712,6,2,289777,289777,289779,0,2,5
82713,4,2,289781,289781,289783,0,2,2
82714,1,3,289782,289783,289786,1,4,0
82715,3,3,289785,289786,289789,1,4,0
82716,3,2,289788,289789,289791,1,3,0
82717,1,2,289789,289791,289793,2,4,0
82718,6,1,289795,289795,289796,0,1,2
82719,3,2,289798,289798,289800,0,2,2
82720,1,2,289799,289800,289802,1,3,0
82721,6,1,289805,289805,289806,0,1,3
82722,5,1,289810,289810,289811,0,1,4
82723,3,2,289813,289813,289815,0,2,2
82724,4,1,289817,289817,289818,0,1,2
82725,1,3,289818,289818,289821,0,3,0
82726,4,2,289822,289822,289824,0,2,1
82727,4,3,289826,289826,289829,0,3,2
82728,4,2,289830,289830,289832,0,2,1
82729,5,2,289835,289835,289837,0,2,3
82730,3,3,289838,289838,289841,0,3,1
82731,2,2,289840,289841,289843,1,3,0
82732,4,2,289844,289844,289846,0,2,1
82733,6,3,289850,289850,289853,0,3,4
82734,4,2,289854,289854,289856,0,2,1
82735,6,1,289860,289860,289861,0,1,4
82736,3,1,289863,289863,289864,0,1,2
82737,3,2,289866,289866,289868,0,2,2
82738,2,3,289868,289868,289871,0,3,0
82739,4,3,289872,289872,289875,0,3,1
82740,2,1,289874,289875,289876,1,2,0
82741,6,2,289880,289880,289882,0,2,4
82742,2,1,289882,289882,289883,0,1,0
82743,4,3,289886,289886,289889,0,3,3
82744,2,3,289888,289889,289892,1,4,0
82745,2,3,289890,289892,289895,2,5,0
82746,5,2,289895,289895,289897,0,2,0
82747,3,3,289898,289898,289901,0,3,1
82748,3,1,289901,289901,289902,0,1,0
82749,3,3,289904,289904,289907,0,3,2
82750,3,2,289907,289907,289909,0,2,0
82751,1,1,289908,289909,289910,1,2,0
82752,3,2,289911,289911,289913,0,2,1
82753,5,2,289916,289916,289918,0,2,3
82754,2,1,289918,289918,289919,0,1,0
82755,5,3,289923,289923,289926,0,3,4
82756,4,1,289927,289927,289928,0,1,1
82757,6,2,289933,289933,289935,0,2,5
82758,3,1,289936,289936,289937,0,1,1
82759,2,1,289938,289938,289939,0,1,1
82760,2,3,289940,289940,289943,0,3,1
82761,6,3,289946,289946,289949,0,3,3
82762,6,2,289952,289952,289954,0,2,3
82763,3,2,289955,289955,289957,0,2,1
82764,4,2,289959,289959,289961,0,2,2
82765,4,2,289963,289963,289965,0,2,2
82766,2,1,289965,289965,289966,0,1,0
82767,6,3,289971,289971,289974,0,3,5
82768,2,3,289973,289974,289977,1,4,0
82769,2,2,289975,289977,289979,2,4,0
82770,3,1,289978,289979,289980,1,2,0
82771,2,3,289980,289980,289983,0,3,0
82772,5,2,289985,289985,289987,0,2,2
82773,2,2,289987,289987,289989,0,2,0
82774,4,1,289991,289991,289992,0,1,2
82775,2,1,289993,289993,289994,0,1,1
82776,5,1,289998,289998,289999,0,1,4
82777,1,3,289999,289999,290002,0,3,0
82778,2,3,290001,290002,290005,1,4,0
82779,4,3,290005,290005,290008,0,3,0
82780,3,3,290008,290008,290011,0,3,0
82781,3,2,290011,290011,290013,0,2,0
82782,6,2,290017,290017,290019,0,2,4
82783,3,2,290020,290020,290022,0,2,1
82784,4,2,290024,290024,290026,0,2,2
82785,5,3,290029,290029,290032,0,3,3
82786,1,1,290030,290032,290033,2,3,0
82787,4,3,290034,290034,290037,0,3,1
82788,6,2,290040,290040,290042,0,2,3
82789,1,2,290041,290042,290044,1,3,0
82790,3,3,290044,290044,290047,0,3,0
82791,3,1,290047,290047,290048,0,1,0
82792,3,2,290050,290050,290052,0,2,2
82793,1,2,290051,290052,290054,1,3,0
82794,3,3,290054,290054,290057,0,3,0
82795,6,3,290060,290060,290063,0,3,3
82796,2,2,290062,290063,290065,1,3,0
82797,4,1,290066,290066,290067,0,1,1
82798,3,1,290069,290069,290070,0,1,2
82799,3,1,290072,290072,290073,0,1,2
82800,3,3,290075,290075,290078,0,3,2
82801,5,2,290080,290080,290082,0,2,2
82802,3,3,290083,290083,290086,0,3,1
82803,4,3,290087,290087,290090,0,3,1
82804,6,2,290093,290093,290095,0,2,3
82805,5,3,290098,290098,290101,0,3,3
82806,4,3,290102,290102,290105,0,3,1
82807,1,2,290103,290105,290107,2,4,0
82808,3,1,290106,290107,290108,1,2,0
82809,6,1,290112,290112,290113,0,1,4
82810,1,3,290113,290113,290116,0,3,0
82811,4,2,290117,290117,290119,0,2,1
82812,6,1,290123,290123,290124,0,1,4
82813,4,2,290127,290127,290129,0,2,3
82814,6,1,290133,290133,290134,0,1,4
82815,2,3,290135,290135,290138,0,3,1
82816,2,2,290137,290138,290140,1,3,0
82817,6,1,290143,290143,290144,0,1,3
82818,5,1,290148,290148,290149,0,1,4
82819,6,3,290154,290154,290157,0,3,5
82820,1,2,290155,290157,290159,2,4,0
82821,1,2,290156,290159,290161,3,5,0
82822,2,3,290158,290161,290164,3,6,0
82823,3,3,290161,290164,290167,3,6,0
82824,2,1,290163,290167,290168,4,5,0
82825,3,3,290166,290168,290171,2,5,0
82826,4,2,290170,290171,290173,1,3,0
82827,4,2,290174,290174,290176,0,2,1
82828,1,3,290175,290176,290179,1,4,0
82829,3,3,290178,290179,290182,1,4,0
82830,1,3,290179,290182,290185,3,6,0
82831,3,3,290182,290185,290188,3,6,0
82832,6,1,290188,290188,290189,0,1,0
82833,4,1,290192,290192,290193,0,1,3
82834,1,3,290193,290193,290196,0,3,0
82835,2,3,290195,290196,290199,1,4,0
82836,6,3,290201,290201,290204,0,3,2
82837,6,2,290207,290207,290209,0,2,3
82838,6,3,290213,290213,290216,0,3,4
82839,5,2,290218,290218,290220,0,2,2
82840,1,1,290219,290220,290221,1,2,0
82841,6,2,290225,290225,290227,0,2,4
82842,6,3,290231,290231,290234,0,3,4
82843,4,1,290235,290235,290236,0,1,1
82844,2,2,290237,290237,290239,0,2,1
82845,5,2,290242,290242,290244,0,2,3
82846,1,3,290243,290244,290247,1,4,0
82847,6,3,290249,290249,290252,0,3,2
82848,6,3,290255,290255,290258,0,3,3
82849,4,2,290259,290259,290261,0,2,1
82850,6,3,290265,290265,290268,0,3,4
82851,3,3,290268,290268,290271,0,3,0
82852,6,1,290274,290274,290275,0,1,3
82853,6,1,290280,290280,290281,0,1,5
82854,5,1,290285,290285,290286,0,1,4
82855,1,3,290286,290286,290289,0,3,0
82856,6,3,290292,290292,290295,0,3,3
82857,3,1,290295,290295,290296,0,1,0
82858,3,3,290298,290298,290301,0,3,2
82859,5,2,290303,290303,290305,0,2,2
82860,1,1,290304,290305,290306,1,2,0
82861,4,3,290308,290308,290311,0,3,2
82862,4,3,290312,290312,290315,0,3,1
82863,6,1,290318,290318,290319,0,1,3
82864,1,2,290319,290319,290321,0,2,0
82865,5,1,290324,290324,290325,0,1,3
82866,6,2,290330,290330,290332,0,2,5
82867,1,3,290331,290332,290335,1,4,0
82868,5,3,290336,290336,290339,0,3,1
82869,4,1,290340,290340,290341,0,1,1
82870,3,2,290343,290343,290345,0,2,2
82871,1,1,290344,290345,290346,1,2,0
82872,1,3,290345,290346,290349,1,4,0
82873,6,1,290351,290351,290352,0,1,2
82874,6,1,290357,290357,290358,0,1,5
82875,1,1,290358,290358,290359,0,1,0
82876,5,1,290363,290363,290364,0,1,4
82877,1,3,290364,290364,290367,0,3,0
82878,1,3,290365,290367,290370,2,5,0
82879,6,3,290371,290371,290374,0,3,1
82880,2,2,290373,290374,290376,1,3,0
82881,3,1,290376,290376,290377,0,1,0
82882,4,3,290380,290380,290383,0,3,3
82883,4,3,290384,290384,290387,0,3,1
82884,5,1,290389,290389,290390,0,1,2
82885,1,1,290390,290390,290391,0,1,0
82886,4,2,290394,290394,290396,0,2,3
82887,1,2,290395,290396,290398,1,3,0
82888,1,2,290396,290398,290400,2,4,0
82889,2,3,290398,290400,290403,2,5,0
82890,5,1,290403,290403,290404,0,1,0
82891,4,2,290407,290407,290409,0,2,3
82892,3,3,290410,290410,290413,0,3,1
82893,1,1,290411,290413,290414,2,3,0
82894,1,1,290412,290414,290415,2,3,0
82895,1,2,290413,290415,290417,2,4,0
82896,2,1,290415,290417,290418,2,3,0
82897,4,1,290419,290419,290420,0,1,1
82898,5,1,290424,290424,290425,0,1,4
82899,3,1,290427,290427,290428,0,1,2
82900,5,1,290432,290432,290433,0,1,4
82901,2,2,290434,290434,290436,0,2,1
82902,3,2,290437,290437,290439,0,2,1
82903,2,2,290439,290439,290441,0,2,0
82904,3,3,290442,290442,290445,0,3,1
82905,2,1,290444,290445,290446,1,2,0
82906,6,1,290450,290450,290451,0,1,4
82907,2,3,290452,290452,290455,0,3,1
82908,3,3,290455,290455,290458,0,3,0
82909,3,3,290458,290458,290461,0,3,0
82910,1,1,290459,290461,290462,2,3,0
82911,6,1,290465,290465,290466,0,1,3
82912,6,1,290471,290471,290472,0,1,5
82913,1,1,290472,290472,290473,0,1,0
82914,5,1,290477,290477,290478,0,1,4
82915,4,1,290481,290481,290482,0,1,3
82916,6,1,290487,290487,290488,0,1,5
82917,2,3,290489,290489,290492,0,3,1
82918,3,1,290492,290492,290493,0,1,0
82919,5,1,290497,290497,290498,0,1,4
82920,2,3,290499,290499,290502,0,3,1
82921,6,2,290505,290505,290507,0,2,3
82922,3,2,290508,290508,290510,0,2,1
82923,5,1,290513,290513,290514,0,1,3
82924,6,2,290519,290519,290521,0,2,5
82925,6,1,290525,290525,290526,0,1,4
82926,6,2,290531,290531,290533,0,2,5
82927,2,2,290533,290533,290535,0,2,0
82928,2,1,290535,290535,290536,0,1,0
82929,1,3,290536,290536,290539,0,3,0
82930,5,2,290541,290541,290543,0,2,2
82931,1,1,290542,290543,290544,1,2,0
82932,2,3,290544,290544,290547,0,3,0
82933,6,1,290550,290550,290551,0,1,3
82934,5,3,290555,290555,290558,0,3,4
82935,2,3,290557,290558,290561,1,4,0
82936,2,2,290559,290561,290563,2,4,0
82937,4,2,290563,290563,290565,0,2,0
82938,2,1,290565,290565,290566,0,1,0
82939,4,2,290569,290569,290571,0,2,3
82940,4,2,290573,290573,290575,0,2,2
82941,3,1,290576,290576,290577,0,1,1
82942,3,3,290579,290579,290582,0,3,2
82943,4,3,290583,290583,290586,0,3,1
82944,1,3,290584,290586,290589,2,5,0
82945,1,1,290585,290589,290590,4,5,0
82946,5,3,290590,290590,290593,0,3,0
82947,1,1,290591,290593,290594,2,3,0
82948,3,1,290594,290594,290595,0,1,0
82949,6,3,290600,290600,290603,0,3,5
82950,5,3,290605,290605,290608,0,3,2
82951,2,1,290607,290608,290609,1,2,0
82952,1,1,290608,290609,290610,1,2,0
82953,2,1,290610,290610,290611,0,1,0
82954,5,1,290615,290615,290616,0,1,4
82955,4,2,290619,290619,290621,0,2,3
82956,6,1,290625,290625,290626,0,1,4
82957,4,1,290629,290629,290630,0,1,3
82958,4,3,290633,290633,290636,0,3,3
82959,1,1,290634,290636,290637,2,3,0
82960,3,1,290637,290637,290638,0,1,0
82961,2,2,290639,290639,290641,0,2,1
82962,1,2,290640,290641,290643,1,3,0
82963,1,2,290641,290643,290645,2,4,0
82964,6,3,290647,290647,290650,0,3,2
82965,1,2,290648,290650,290652,2,4,0
82966,5,2,290653,290653,290655,0,2,1
82967,5,2,290658,290658,290660,0,2,3
82968,2,3,290660,290660,290663,0,3,0
82969,6,1,290666,290666,290667,0,1,3
82970,2,1,290668,290668,290669,0,1,1
82971,4,2,290672,290672,290674,0,2,3
82972,6,2,290678,290678,290680,0,2,4
82973,6,3,290684,290684,290687,0,3,4
82974,4,2,290688,290688,290690,0,2,1
82975,4,1,290692,290692,290693,0,1,2
82976,5,2,290697,290697,290699,0,2,4
82977,5,1,290702,290702,290703,0,1,3
82978,2,1,290704,290704,290705,0,1,1
82979,6,3,290710,290710,290713,0,3,5
82980,1,1,290711,290713,290714,2,3,0
82981,1,1,290712,290714,290715,2,3,0
82982,1,1,290713,290715,290716,2,3,0
82983,4,1,290717,290717,290718,0,1,1
82984,5,1,290722,290722,290723,0,1,4
82985,2,3,290724,290724,290727,0,3,1
82986,4,3,290728,290728,290731,0,3,1
82987,5,2,290733,290733,290735,0,2,2
82988,6,1,290739,290739,290740,0,1,4
82989,6,2,290745,290745,290747,0,2,5
82990,3,2,290748,290748,290750,0,2,1
82991,1,1,290749,290750,290751,1,2,0
82992,5,2,290754,290754,290756,0,2,3
82993,3,1,290757,290757,290758,0,1,1
82994,1,1,290758,290758,290759,0,1,0
82995,2,1,290760,290760,290761,0,1,1
82996,4,2,290764,290764,290766,0,2,3
82997,2,1,290766,290766,290767,0,1,0
82998,5,2,290771,290771,290773,0,2,4
82999,6,1,290777,290777,290778,0,1,4
83000,2,2,290779,290779,290781,0,2,1
83001,2,1,290781,290781,290782,0,1,0
83002,3,2,290784,290784,290786,0,2,2
83003,4,3,290788,290788,290791,0,3,2
83004,6,3,290794,290794,290797,0,3,3
83005,4,1,290798,290798,290799,0,1,1
83006,1,2,290799,290799,290801,0,2,0
83007,6,3,290805,290805,290808,0,3,4
83008,5,2,290810,290810,290812,0,2,2
83009,6,1,290816,290816,290817,0,1,4
83010,5,2,290821,290821,290823,0,2,4
83011,4,3,290825,290825,290828,0,3,2
83012,6,3,290831,290831,290834,0,3,3
83013,1,1,290832,290834,290835,2,3,0
83014,5,1,290837,290837,290838,0,1,2
83015,3,3,290840,290840,290843,0,3,2
83016,6,2,290846,290846,290848,0,2,3
83017,6,3,290852,290852,290855,0,3,4
83018,6,2,290858,290858,290860,0,2,3
83019,3,3,290861,290861,290864,0,3,1
83020,5,1,290866,290866,290867,0,1,2
83021,6,3,290872,290872,290875,0,3,5
83022,1,1,290873,290875,290876,2,3,0
83023,2,1,290875,290876,290877,1,2,0
83024,1,3,290876,290877,290880,1,4,0
83025,1,2,290877,290880,290882,3,5,0
83026,4,3,290881,290882,290885,1,4,0
83027,4,2,290885,290885,290887,0,2,0
83028,3,2,290888,290888,290890,0,2,1
83029,4,1,290892,290892,290893,0,1,2
83030,3,1,290895,290895,290896,0,1,2
83031,4,2,290899,290899,290901,0,2,3
83032,2,2,290901,290901,290903,0,2,0
83033,3,2,290904,290904,290906,0,2,1
83034,2,1,290906,290906,290907,0,1,0
83035,4,3,290910,290910,290913,0,3,3
83036,4,3,290914,290914,290917,0,3,1
83037,3,2,290917,290917,290919,0,2,0
83038,3,3,290920,290920,290923,0,3,1
83039,1,3,290921,290923,290926,2,5,0
83040,1,1,290922,290926,290927,4,5,0
83041,4,1,290926,290927,290928,1,2,0
83042,1,1,290927,290928,290929,1,2,0
83043,4,2,290931,290931,290933,0,2,2
83044,6,2,290937,290937,290939,0,2,4
83045,4,3,290941,290941,290944,0,3,2
83046,5,2,290946,290946,290948,0,2,2
83047,6,3,290952,290952,290955,0,3,4
83048,6,2,290958,290958,290960,0,2,3
83049,4,2,290962,290962,290964,0,2,2
83050,3,2,290965,290965,290967,0,2,1
83051,2,3,290967,290967,290970,0,3,0
83052,1,3,290968,290970,290973,2,5,0
83053,2,1,290970,290973,290974,3,4,0
83054,4,2,290974,290974,290976,0,2,0
83055,5,2,290979,290979,290981,0,2,3
83056,5,3,290984,290984,290987,0,3,3
83057,4,3,290988,290988,290991,0,3,1
83058,3,2,290991,290991,290993,0,2,0
83059,4,2,290995,290995,290997,0,2,2
83060,3,2,290998,290998,291000,0,2,1
83061,3,1,291001,291001,291002,0,1,1
83062,3,3,291004,291004,291007,0,3,2
83063,5,1,291009,291009,291010,0,1,2
83064,4,3,291013,291013,291016,0,3,3
83065,2,3,291015,291016,291019,1,4,0
83066,5,3,291020,291020,291023,0,3,1
83067,1,2,291021,291023,291025,2,4,0
83068,3,2,291024,291025,291027,1,3,0
83069,2,2,291026,291027,291029,1,3,0
83070,2,3,291028,291029,291032,1,4,0
83071,3,1,291031,291032,291033,1,2,0
83072,4,3,291035,291035,291038,0,3,2
83073,4,3,291039,291039,291042,0,3,1
83074,5,1,291044,291044,291045,0,1,2
83075,2,1,291046,291046,291047,0,1,1
83076,4,1,291050,291050,291051,0,1,3
83077,4,3,291054,291054,291057,0,3,3
83078,1,1,291055,291057,291058,2,3,0
83079,3,1,291058,291058,291059,0,1,0
83080,5,2,291063,291063,291065,0,2,4
83081,1,3,291064,291065,291068,1,4,0
83082,4,3,291068,291068,291071,0,3,0
83083,4,1,291072,291072,291073,0,1,1
83084,1,2,291073,291073,291075,0,2,0
83085,2,1,291075,291075,291076,0,1,0
83086,3,2,291078,291078,291080,0,2,2
83087,6,2,291084,291084,291086,0,2,4
83088,5,1,291089,291089,291090,0,1,3
83089,6,1,291095,291095,291096,0,1,5
83090,5,1,291100,291100,291101,0,1,4
83091,4,3,291104,291104,291107,0,3,3
83092,6,1,291110,291110,291111,0,1,3
83093,3,3,291113,291113,291116,0,3,2
83094,4,1,291117,291117,291118,0,1,1
83095,4,1,291121,291121,291122,0,1,3
83096,5,2,291126,291126,291128,0,2,4
83097,2,2,291128,291128,291130,0,2,0
83098,4,1,291132,291132,291133,0,1,2
83099,4,1,291136,291136,291137,0,1,3
83100,6,3,291142,291142,291145,0,3,5
83101,3,3,291145,291145,291148,0,3,0
83102,6,1,291151,291151,291152,0,1,3
83103,3,3,291154,291154,291157,0,3,2
83104,2,3,291156,291157,291160,1,4,0
83105,3,3,291159,291160,291163,1,4,0
83106,1,3,291160,291163,291166,3,6,0
83107,4,2,291164,291166,291168,2,4,0
83108,3,1,291167,291168,291169,1,2,0
83109,5,2,291172,291172,291174,0,2,3
83110,2,2,291174,291174,291176,0,2,0
83111,6,3,291180,291180,291183,0,3,4
83112,2,3,291182,291183,291186,1,4,0
83113,2,1,291184,291186,291187,2,3,0
83114,5,3,291189,291189,291192,0,3,2
83115,6,1,291195,291195,291196,0,1,3
83116,1,1,291196,291196,291197,0,1,0
83117,1,1,291197,291197,291198,0,1,0
83118,1,3,291198,291198,291201,0,3,0
83119,3,2,291201,291201,291203,0,2,0
83120,2,2,291203,291203,291205,0,2,0
83121,1,3,291204,291205,291208,1,4,0
83122,4,2,291208,291208,291210,0,2,0
83123,5,1,291213,291213,291214,0,1,3
83124,5,2,291218,291218,291220,0,2,4
83125,6,3,291224,291224,291227,0,3,4
83126,1,2,291225,291227,291229,2,4,0
83127,6,1,291231,291231,291232,0,1,2
83128,3,1,291234,291234,291235,0,1,2
83129,4,3,291238,291238,291241,0,3,3
83130,3,3,291241,291241,291244,0,3,0
83131,5,1,291246,291246,291247,0,1,2
83132,2,3,291248,291248,291251,0,3,1
83133,3,3,291251,291251,291254,0,3,0
83134,1,3,291252,291254,291257,2,5,0
83135,1,3,291253,291257,291260,4,7,0
83136,5,2,291258,291260,291262,2,4,0
83137,6,2,291264,291264,291266,0,2,2
83138,1,2,291265,291266,291268,1,3,0
83139,1,3,291266,291268,291271,2,5,0
83140,3,2,291269,291271,291273,2,4,0
83141,6,2,291275,291275,291277,0,2,2
83142,3,3,291278,291278,291281,0,3,1
83143,6,1,291284,291284,291285,0,1,3
83144,5,2,291289,291289,291291,0,2,4
83145,2,3,291291,291291,291294,0,3,0
83146,2,2,291293,291294,291296,1,3,0
83147,1,2,291294,291296,291298,2,4,0
83148,2,1,291296,291298,291299,2,3,0
83149,1,2,291297,291299,291301,2,4,0
83150,6,2,291303,291303,291305,0,2,2
83151,2,3,291305,291305,291308,0,3,0
83152,4,1,291309,291309,291310,0,1,1
83153,6,2,291315,291315,291317,0,2,5
83154,4,2,291319,291319,291321,0,2,2
83155,2,2,291321,291321,291323,0,2,0
83156,6,3,291327,291327,291330,0,3,4
83157,6,1,291333,291333,291334,0,1,3
83158,3,1,291336,291336,291337,0,1,2
83159,3,1,291339,291339,291340,0,1,2
83160,4,3,291343,291343,291346,0,3,3
83161,6,3,291349,291349,291352,0,3,3
83162,4,3,291353,291353,291356,0,3,1
83163,5,2,291358,291358,291360,0,2,2
83164,3,1,291361,291361,291362,0,1,1
83165,2,1,291363,291363,291364,0,1,1
83166,1,3,291364,291364,291367,0,3,0
83167,5,3,291369,291369,291372,0,3,2
83168,3,3,291372,291372,291375,0,3,0
83169,4,2,291376,291376,291378,0,2,1
83170,4,1,291380,291380,291381,0,1,2
83171,4,1,291384,291384,291385,0,1,3
83172,6,3,291390,291390,291393,0,3,5
83173,6,3,291396,291396,291399,0,3,3
83174,6,2,291402,291402,291404,0,2,3
83175,3,1,291405,291405,291406,0,1,1
83176,5,2,291410,291410,291412,0,2,4
83177,6,1,291416,291416,291417,0,1,4
83178,1,1,291417,291417,291418,0,1,0
83179,3,2,291420,291420,291422,0,2,2
83180,3,3,291423,291423,291426,0,3,1
83181,2,1,291425,291426,291427,1,2,0
83182,6,2,291431,291431,291433,0,2,4
83183,4,3,291435,291435,291438,0,3,2
83184,6,1,291441,291441,291442,0,1,3
83185,1,2,291442,291442,291444,0,2,0
83186,1,1,291443,291444,291445,1,2,0
83187,6,1,291449,291449,291450,0,1,4
83188,1,3,291450,291450,291453,0,3,0
83189,2,1,291452,291453,291454,1,2,0
83190,6,2,291458,291458,291460,0,2,4
83191,3,3,291461,291461,291464,0,3,1
83192,1,2,291462,291464,291466,2,4,0
83193,3,2,291465,291466,291468,1,3,0
83194,5,2,291470,291470,291472,0,2,2
83195,5,3,291475,291475,291478,0,3,3
83196,3,2,291478,291478,291480,0,2,0
83197,2,3,291480,291480,291483,0,3,0
83198,5,3,291485,291485,291488,0,3,2
83199,1,1,291486,291488,291489,2,3,0
83200,3,3,291489,291489,291492,0,3,0
83201,5,1,291494,291494,291495,0,1,2
83202,4,3,291498,291498,291501,0,3,3
83203,2,2,291500,291501,291503,1,3,0
83204,5,2,291505,291505,291507,0,2,2
83205,5,1,291510,291510,291511,0,1,3
83206,2,3,291512,291512,291515,0,3,1
83207,5,3,291517,291517,291520,0,3,2
83208,6,2,291523,291523,291525,0,2,3
83209,2,3,291525,291525,291528,0,3,0
83210,1,3,291526,291528,291531,2,5,0
83211,2,1,291528,291531,291532,3,4,0
83212,2,1,291530,291532,291533,2,3,0
83213,2,3,291532,291533,291536,1,4,0
83214,1,1,291533,291536,291537,3,4,0
83215,6,3,291539,291539,291542,0,3,2
83216,3,1,291542,291542,291543,0,1,0
83217,1,3,291543,291543,291546,0,3,0
83218,6,2,291549,291549,291551,0,2,3
83219,4,1,291553,291553,291554,0,1,2
83220,6,2,291559,291559,291561,0,2,5
83221,6,2,291565,291565,291567,0,2,4
83222,3,1,291568,291568,291569,0,1,1
83223,6,1,291574,291574,291575,0,1,5
83224,3,2,291577,291577,291579,0,2,2
83225,4,1,291581,291581,291582,0,1,2
83226,3,1,291584,291584,291585,0,1,2
83227,3,3,291587,291587,291590,0,3,2
83228,1,3,291588,291590,291593,2,5,0
83229,3,2,291591,291593,291595,2,4,0
83230,3,1,291594,291595,291596,1,2,0
83231,4,2,291598,291598,291600,0,2,2
83232,5,1,291603,291603,291604,0,1,3
83233,3,1,291606,291606,291607,0,1,2
83234,6,1,291612,291612,291613,0,1,5
83235,3,3,291615,291615,291618,0,3,2
83236,2,3,291617,291618,291621,1,4,0
83237,1,3,291618,291621,291624,3,6,0
83238,5,1,291623,291624,291625,1,2,0
83239,4,2,291627,291627,291629,0,2,2
83240,1,2,291628,291629,291631,1,3,0
83241,3,1,291631,291631,291632,0,1,0
83242,2,1,291633,291633,291634,0,1,1
83243,1,3,291634,291634,291637,0,3,0
83244,2,2,291636,291637,291639,1,3,0
83245,4,2,291640,291640,291642,0,2,1
83246,4,1,291644,291644,291645,0,1,2
83247,3,2,291647,291647,291649,0,2,2
83248,3,2,291650,291650,291652,0,2,1
83249,2,1,291652,291652,291653,0,1,0
83250,3,2,291655,291655,291657,0,2,2
83251,1,1,291656,291657,291658,1,2,0
83252,2,3,291658,291658,291661,0,3,0
83253,4,3,291662,291662,291665,0,3,1
83254,6,2,291668,291668,291670,0,2,3
83255,2,1,291670,291670,291671,0,1,0
83256,2,1,291672,291672,291673,0,1,1
83257,4,1,291676,291676,291677,0,1,3
83258,3,1,291679,291679,291680,0,1,2
83259,6,1,291685,291685,291686,0,1,5
83260,5,1,291690,291690,291691,0,1,4
83261,5,3,291695,291695,291698,0,3,4
83262,5,3,291700,291700,291703,0,3,2
83263,2,3,291702,291703,291706,1,4,0
83264,2,1,291704,291706,291707,2,3,0
83265,5,3,291709,291709,291712,0,3,2
83266,6,3,291715,291715,291718,0,3,3
83267,5,1,291720,291720,291721,0,1,2
83268,5,2,291725,291725,291727,0,2,4
83269,5,1,291730,291730,291731,0,1,3
83270,3,1,291733,291733,291734,0,1,2
83271,1,3,291734,291734,291737,0,3,0
83272,5,1,291739,291739,291740,0,1,2
83273,6,2,291745,291745,291747,0,2,5
83274,5,2,291750,291750,291752,0,2,3
83275,4,2,291754,291754,291756,0,2,2
83276,6,3,291760,291760,291763,0,3,4
83277,2,2,291762,291763,291765,1,3,0
83278,4,1,291766,291766,291767,0,1,1
83279,5,1,291771,291771,291772,0,1,4
83280,5,2,291776,291776,291778,0,2,4
83281,3,1,291779,291779,291780,0,1,1
83282,3,3,291782,291782,291785,0,3,2
83283,5,2,291787,291787,291789,0,2,2
83284,1,1,291788,291789,291790,1,2,0
83285,4,3,291792,291792,291795,0,3,2
83286,2,1,291794,291795,291796,1,2,0
83287,5,1,291799,291799,291800,0,1,3
83288,5,3,291804,291804,291807,0,3,4
83289,2,2,291806,291807,291809,1,3,0
83290,6,3,291812,291812,291815,0,3,3
83291,5,3,291817,291817,291820,0,3,2
83292,4,1,291821,291821,291822,0,1,1
83293,1,3,291822,291822,291825,0,3,0
83294,6,1,291828,291828,291829,0,1,3
83295,1,3,291829,291829,291832,0,3,0
83296,4,1,291833,291833,291834,0,1,1
83297,4,1,291837,291837,291838,0,1,3
83298,3,3,291840,291840,291843,0,3,2
83299,2,2,291842,291843,291845,1,3,0
83300,6,1,291848,291848,291849,0,1,3
83301,3,1,291851,291851,291852,0,1,2
83302,5,1,291856,291856,291857,0,1,4
83303,2,1,291858,291858,291859,0,1,1
83304,4,1,291862,291862,291863,0,1,3
83305,4,1,291866,291866,291867,0,1,3
83306,4,3,291870,291870,291873,0,3,3
83307,6,1,291876,291876,291877,0,1,3
83308,5,3,291881,291881,291884,0,3,4
83309,6,2,291887,291887,291889,0,2,3
83310,5,3,291892,291892,291895,0,3,3
83311,4,3,291896,291896,291899,0,3,1
83312,4,3,291900,291900,291903,0,3,1
83313,3,2,291903,291903,291905,0,2,0
83314,1,2,291904,291905,291907,1,3,0
83315,6,1,291910,291910,291911,0,1,3
83316,6,3,291916,291916,291919,0,3,5
83317,3,1,291919,291919,291920,0,1,0
83318,6,3,291925,291925,291928,0,3,5
83319,3,3,291928,291928,291931,0,3,0
83320,4,2,291932,291932,291934,0,2,1
83321,6,2,291938,291938,291940,0,2,4
83322,5,1,291943,291943,291944,0,1,3
83323,1,1,291944,291944,291945,0,1,0
83324,3,2,291947,291947,291949,0,2,2
83325,6,3,291953,291953,291956,0,3,4
83326,2,2,291955,291956,291958,1,3,0
83327,3,3,291958,291958,291961,0,3,0
83328,4,3,291962,291962,291965,0,3,1
83329,2,2,291964,291965,291967,1,3,0
83330,1,3,291965,291967,291970,2,5,0
83331,2,2,291967,291970,291972,3,5,0
83332,3,3,291970,291972,291975,2,5,0
83333,6,1,291976,291976,291977,0,1,1
83334,1,1,291977,291977,291978,0,1,0
83335,1,2,291978,291978,291980,0,2,0
83336,6,1,291984,291984,291985,0,1,4
83337,1,1,291985,291985,291986,0,1,0
83338,1,3,291986,291986,291989,0,3,0
83339,4,3,291990,291990,291993,0,3,1
83340,3,1,291993,291993,291994,0,1,0
83341,6,2,291999,291999,292001,0,2,5
83342,5,1,292004,292004,292005,0,1,3
83343,4,2,292008,292008,292010,0,2,3
83344,6,2,292014,292014,292016,0,2,4
83345,3,1,292017,292017,292018,0,1,1
83346,5,2,292022,292022,292024,0,2,4
83347,6,1,292028,292028,292029,0,1,4
83348,4,3,292032,292032,292035,0,3,3
83349,2,3,292034,292035,292038,1,4,0
83350,4,3,292038,292038,292041,0,3,0
83351,4,2,292042,292042,292044,0,2,1
83352,4,2,292046,292046,292048,0,2,2
83353,1,1,292047,292048,292049,1,2,0
83354,1,3,292048,292049,292052,1,4,0
83355,2,1,292050,292052,292053,2,3,0
83356,4,2,292054,292054,292056,0,2,1
83357,1,3,292055,292056,292059,1,4,0
83358,2,3,292057,292059,292062,2,5,0
83359,3,1,292060,292062,292063,2,3,0
83360,3,3,292063,292063,292066,0,3,0
83361,1,1,292064,292066,292067,2,3,0
83362,6,3,292070,292070,292073,0,3,3
83363,4,1,292074,292074,292075,0,1,1
83364,4,1,292078,292078,292079,0,1,3
83365,2,1,292080,292080,292081,0,1,1
83366,5,1,292085,292085,292086,0,1,4
83367,3,3,292088,292088,292091,0,3,2
83368,4,1,292092,292092,292093,0,1,1
83369,6,3,292098,292098,292101,0,3,5
83370,6,2,292104,292104,292106,0,2,3
83371,4,1,292108,292108,292109,0,1,2
83372,1,3,292109,292109,292112,0,3,0
83373,1,3,292110,292112,292115,2,5,0
83374,6,1,292116,292116,292117,0,1,1
83375,3,2,292119,292119,292121,0,2,2
83376,4,1,292123,292123,292124,0,1,2
83377,2,1,292125,292125,292126,0,1,1
83378,5,2,292130,292130,292132,0,2,4
83379,3,2,292133,292133,292135,0,2,1
83380,6,1,292139,292139,292140,0,1,4
83381,1,1,292140,292140,292141,0,1,0
83382,4,2,292144,292144,292146,0,2,3
83383,1,3,292145,292146,292149,1,4,0
83384,2,2,292147,292149,292151,2,4,0
83385,6,1,292153,292153,292154,0,1,2
83386,1,2,292154,292154,292156,0,2,0
83387,5,1,292159,292159,292160,0,1,3
83388,2,3,292161,292161,292164,0,3,1
83389,4,1,292165,292165,292166,0,1,1
83390,5,2,292170,292170,292172,0,2,4
83391,1,2,292171,292172,292174,1,3,0
83392,4,1,292175,292175,292176,0,1,1
83393,5,1,292180,292180,292181,0,1,4
83394,6,3,292186,292186,292189,0,3,5
83395,6,2,292192,292192,292194,0,2,3
83396,5,3,292197,292197,292200,0,3,3
83397,2,1,292199,292200,292201,1,2,0
83398,4,3,292203,292203,292206,0,3,2
83399,3,2,292206,292206,292208,0,2,0
83400,2,2,292208,292208,292210,0,2,0
83401,4,2,292212,292212,292214,0,2,2
83402,6,2,292218,292218,292220,0,2,4
83403,2,2,292220,292220,292222,0,2,0
83404,4,2,292224,292224,292226,0,2,2
83405,3,2,292227,292227,292229,0,2,1
83406,5,2,292232,292232,292234,0,2,3
83407,1,3,292233,292234,292237,1,4,0
83408,2,1,292235,292237,292238,2,3,0
83409,2,3,292237,292238,292241,1,4,0
83410,3,2,292240,292241,292243,1,3,0
83411,6,1,292246,292246,292247,0,1,3
83412,1,1,292247,292247,292248,0,1,0
83413,4,3,292251,292251,292254,0,3,3
83414,4,2,292255,292255,292257,0,2,1
83415,5,3,292260,292260,292263,0,3,3
83416,3,3,292263,292263,292266,0,3,0
83417,4,3,292267,292267,292270,0,3,1
83418,6,3,292273,292273,292276,0,3,3
83419,2,2,292275,292276,292278,1,3,0
83420,6,2,292281,292281,292283,0,2,3
83421,2,3,292283,292283,292286,0,3,0
83422,4,2,292287,292287,292289,0,2,1
83423,6,3,292293,292293,292296,0,3,4
83424,2,3,292295,292296,292299,1,4,0
83425,3,1,292298,292299,292300,1,2,0
83426,1,3,292299,292300,292303,1,4,0
83427,5,1,292304,292304,292305,0,1,1
83428,3,1,292307,292307,292308,0,1,2
83429,2,1,292309,292309,292310,0,1,1
83430,1,3,292310,292310,292313,0,3,0
83431,2,1,292312,292313,292314,1,2,0
83432,4,1,292316,292316,292317,0,1,2
83433,1,2,292317,292317,292319,0,2,0
83434,1,3,292318,292319,292322,1,4,0
83435,6,2,292324,292324,292326,0,2,2
83436,2,1,292326,292326,292327,0,1,0
83437,2,1,292328,292328,292329,0,1,1
83438,6,1,292334,292334,292335,0,1,5
83439,2,2,292336,292336,292338,0,2,1
83440,2,2,292338,292338,292340,0,2,0
83441,6,3,292344,292344,292347,0,3,4
83442,4,3,292348,292348,292351,0,3,1
83443,4,3,292352,292352,292355,0,3,1
83444,5,1,292357,292357,292358,0,1,2
83445,2,2,292359,292359,292361,0,2,1
83446,5,3,292364,292364,292367,0,3,3
83447,4,3,292368,292368,292371,0,3,1
83448,2,1,292370,292371,292372,1,2,0
83449,4,3,292374,292374,292377,0,3,2
83450,1,1,292375,292377,292378,2,3,0
83451,4,2,292379,292379,292381,0,2,1
83452,3,2,292382,292382,292384,0,2,1
83453,3,2,292385,292385,292387,0,2,1
83454,4,2,292389,292389,292391,0,2,2
83455,5,3,292394,292394,292397,0,3,3
83456,2,2,292396,292397,292399,1,3,0
83457,6,3,292402,292402,292405,0,3,3
83458,1,1,292403,292405,292406,2,3,0
83459,2,3,292405,292406,292409,1,4,0
83460,2,2,292407,292409,292411,2,4,0
83461,5,1,292412,292412,292413,0,1,1
83462,5,1,292417,292417,292418,0,1,4
83463,3,3,292420,292420,292423,0,3,2
83464,5,2,292425,292425,292427,0,2,2
83465,3,3,292428,292428,292431,0,3,1
83466,3,3,292431,292431,292434,0,3,0
83467,1,2,292432,292434,292436,2,4,0
83468,5,2,292437,292437,292439,0,2,1
83469,1,1,292438,292439,292440,1,2,0
83470,6,3,292444,292444,292447,0,3,4
83471,4,1,292448,292448,292449,0,1,1
83472,6,3,292454,292454,292457,0,3,5
83473,3,3,292457,292457,292460,0,3,0
83474,2,3,292459,292460,292463,1,4,0
83475,1,2,292460,292463,292465,3,5,0
83476,6,3,292466,292466,292469,0,3,1
83477,5,2,292471,292471,292473,0,2,2
83478,3,3,292474,292474,292477,0,3,1
83479,2,3,292476,292477,292480,1,4,0
83480,1,1,292477,292480,292481,3,4,0
83481,1,1,292478,292481,292482,3,4,0
83482,6,2,292484,292484,292486,0,2,2
83483,6,2,292490,292490,292492,0,2,4
83484,2,2,292492,292492,292494,0,2,0
83485,3,3,292495,292495,292498,0,3,1
83486,3,3,292498,292498,292501,0,3,0
83487,2,1,292500,292501,292502,1,2,0
83488,1,2,292501,292502,292504,1,3,0
83489,6,3,292507,292507,292510,0,3,3
83490,5,2,292512,292512,292514,0,2,2
83491,2,3,292514,292514,292517,0,3,0
83492,3,2,292517,292517,292519,0,2,0
83493,4,3,292521,292521,292524,0,3,2
83494,5,1,292526,292526,292527,0,1,2
83495,1,2,292527,292527,292529,0,2,0
83496,2,1,292529,292529,292530,0,1,0
83497,4,1,292533,292533,292534,0,1,3
83498,2,2,292535,292535,292537,0,2,1
83499,4,2,292539,292539,292541,0,2,2
83500,4,2,292543,292543,292545,0,2,2
83501,4,3,292547,292547,292550,0,3,2
83502,3,2,292550,292550,292552,0,2,0
83503,5,2,292555,292555,292557,0,2,3
83504,2,2,292557,292557,292559,0,2,0
83505,2,3,292559,292559,292562,0,3,0
83506,1,2,292560,292562,292564,2,4,0
83507,5,1,292565,292565,292566,0,1,1
83508,6,3,292571,292571,292574,0,3,5
83509,6,1,292577,292577,292578,0,1,3
83510,6,3,292583,292583,292586,0,3,5
83511,5,1,292588,292588,292589,0,1,2
83512,6,1,292594,292594,292595,0,1,5
83513,4,1,292598,292598,292599,0,1,3
83514,2,1,292600,292600,292601,0,1,1
83515,5,3,292605,292605,292608,0,3,4
83516,3,3,292608,292608,292611,0,3,0
83517,3,2,292611,292611,292613,0,2,0
83518,4,2,292615,292615,292617,0,2,2
83519,3,1,292618,292618,292619,0,1,1
83520,3,3,292621,292621,292624,0,3,2
83521,6,3,292627,292627,292630,0,3,3
83522,6,3,292633,292633,292636,0,3,3
83523,1,1,292634,292636,292637,2,3,0
83524,1,3,292635,292637,292640,2,5,0
83525,1,2,292636,292640,292642,4,6,0
83526,6,1,292642,292642,292643,0,1,0
83527,3,2,292645,292645,292647,0,2,2
83528,5,3,292650,292650,292653,0,3,3
83529,2,2,292652,292653,292655,1,3,0
83530,6,2,292658,292658,292660,0,2,3
83531,3,3,292661,292661,292664,0,3,1
83532,2,1,292663,292664,292665,1,2,0
83533,4,1,292667,292667,292668,0,1,2
83534,3,3,292670,292670,292673,0,3,2
83535,5,1,292675,292675,292676,0,1,2
83536,5,1,292680,292680,292681,0,1,4
83537,4,1,292684,292684,292685,0,1,3
83538,1,3,292685,292685,292688,0,3,0
83539,1,1,292686,292688,292689,2,3,0
83540,5,2,292691,292691,292693,0,2,2
83541,3,3,292694,292694,292697,0,3,1
83542,6,3,292700,292700,292703,0,3,3
83543,5,2,292705,292705,292707,0,2,2
83544,6,1,292711,292711,292712,0,1,4
83545,6,3,292717,292717,292720,0,3,5
83546,6,2,292723,292723,292725,0,2,3
83547,4,2,292727,292727,292729,0,2,2
83548,4,3,292731,292731,292734,0,3,2
83549,6,2,292737,292737,292739,0,2,3
83550,3,2,292740,292740,292742,0,2,1
83551,4,3,292744,292744,292747,0,3,2
83552,2,3,292746,292747,292750,1,4,0
83553,6,1,292752,292752,292753,0,1,2
83554,3,2,292755,292755,292757,0,2,2
83555,5,2,292760,292760,292762,0,2,3
83556,1,3,292761,292762,292765,1,4,0
83557,6,3,292767,292767,292770,0,3,2
83558,4,3,292771,292771,292774,0,3,1
83559,5,1,292776,292776,292777,0,1,2
83560,3,1,292779,292779,292780,0,1,2
83561,1,2,292780,292780,292782,0,2,0
83562,1,1,292781,292782,292783,1,2,0
83563,1,2,292782,292783,292785,1,3,0
83564,5,3,292787,292787,292790,0,3,2
83565,1,3,292788,292790,292793,2,5,0
83566,3,1,292791,292793,292794,2,3,0
83567,6,2,292797,292797,292799,0,2,3
83568,1,2,292798,292799,292801,1,3,0
83569,6,3,292804,292804,292807,0,3,3
83570,2,3,292806,292807,292810,1,4,0
83571,4,2,292810,292810,292812,0,2,0
83572,6,1,292816,292816,292817,0,1,4
83573,5,3,292821,292821,292824,0,3,4
83574,1,2,292822,292824,292826,2,4,0
83575,6,2,292828,292828,292830,0,2,2
83576,6,1,292834,292834,292835,0,1,4
83577,6,2,292840,292840,292842,0,2,5
83578,4,3,292844,292844,292847,0,3,2
83579,1,3,292845,292847,292850,2,5,0
83580,1,2,292846,292850,292852,4,6,0
83581,3,1,292849,292852,292853,3,4,0
83582,4,2,292853,292853,292855,0,2,0
83583,2,2,292855,292855,292857,0,2,0
83584,5,1,292860,292860,292861,0,1,3
83585,4,1,292864,292864,292865,0,1,3
83586,6,1,292870,292870,292871,0,1,5
83587,3,3,292873,292873,292876,0,3,2
83588,4,2,292877,292877,292879,0,2,1
83589,3,2,292880,292880,292882,0,2,1
83590,4,3,292884,292884,292887,0,3,2
83591,4,3,292888,292888,292891,0,3,1
83592,1,2,292889,292891,292893,2,4,0
83593,2,1,292891,292893,292894,2,3,0
83594,2,2,292893,292894,292896,1,3,0
83595,5,1,292898,292898,292899,0,1,2
83596,5,1,292903,292903,292904,0,1,4
83597,3,2,292906,292906,292908,0,2,2
83598,3,2,292909,292909,292911,0,2,1
83599,3,2,292912,292912,292914,0,2,1
83600,4,1,292916,292916,292917,0,1,2
83601,5,2,292921,292921,292923,0,2,4
83602,6,2,292927,292927,292929,0,2,4
83603,2,3,292929,292929,292932,0,3,0
83604,1,1,292930,292932,292933,2,3,0
83605,1,2,292931,292933,292935,2,4,0
83606,3,2,292934,292935,292937,1,3,0
83607,3,3,292937,292937,292940,0,3,0
83608,3,1,292940,292940,292941,0,1,0
83609,5,3,292945,292945,292948,0,3,4
83610,2,1,292947,292948,292949,1,2,0
83611,5,3,292952,292952,292955,0,3,3
83612,2,3,292954,292955,292958,1,4,0
83613,1,2,292955,292958,292960,3,5,0
83614,6,3,292961,292961,292964,0,3,1
83615,1,3,292962,292964,292967,2,5,0
83616,6,3,292968,292968,292971,0,3,1
83617,3,1,292971,292971,292972,0,1,0
83618,3,1,292974,292974,292975,0,1,2
83619,5,2,292979,292979,292981,0,2,4
83620,4,2,292983,292983,292985,0,2,2
83621,1,3,292984,292985,292988,1,4,0
83622,5,2,292989,292989,292991,0,2,1
83623,4,1,292993,292993,292994,0,1,2
83624,6,2,292999,292999,293001,0,2,5
83625,5,2,293004,293004,293006,0,2,3
83626,1,3,293005,293006,293009,1,4,0
83627,5,3,293010,293010,293013,0,3,1
83628,2,2,293012,293013,293015,1,3,0
83629,6,3,293018,293018,293021,0,3,3
83630,6,2,293024,293024,293026,0,2,3
83631,4,3,293028,293028,293031,0,3,2
83632,1,2,293029,293031,293033,2,4,0
83633,4,1,293033,293033,293034,0,1,0
83634,4,3,293037,293037,293040,0,3,3
83635,3,1,293040,293040,293041,0,1,0
83636,2,2,293042,293042,293044,0,2,1
83637,1,2,293043,293044,293046,1,3,0
83638,3,2,293046,293046,293048,0,2,0
83639,3,2,293049,293049,293051,0,2,1
83640,4,2,293053,293053,293055,0,2,2
83641,6,1,293059,293059,293060,0,1,4
83642,5,3,293064,293064,293067,0,3,4
83643,5,2,293069,293069,293071,0,2,2
83644,1,2,293070,293071,293073,1,3,0
83645,4,3,293074,293074,293077,0,3,1
83646,4,1,293078,293078,293079,0,1,1
83647,4,2,293082,293082,293084,0,2,3
83648,1,1,293083,293084,293085,1,2,0
83649,3,2,293086,293086,293088,0,2,1
83650,1,2,293087,293088,293090,1,3,0
83651,5,1,293092,293092,293093,0,1,2
83652,6,3,293098,293098,293101,0,3,5
83653,5,3,293103,293103,293106,0,3,2
83654,6,3,293109,293109,293112,0,3,3
83655,3,2,293112,293112,293114,0,2,0
83656,5,1,293117,293117,293118,0,1,3
83657,6,1,293123,293123,293124,0,1,5
83658,3,3,293126,293126,293129,0,3,2
83659,2,2,293128,293129,293131,1,3,0
83660,2,2,293130,293131,293133,1,3,0
83661,6,1,293136,293136,293137,0,1,3
83662,1,1,293137,293137,293138,0,1,0
83663,1,3,293138,293138,293141,0,3,0
83664,2,1,293140,293141,293142,1,2,0
83665,2,2,293142,293142,293144,0,2,0
83666,4,1,293146,293146,293147,0,1,2
83667,6,3,293152,293152,293155,0,3,5
83668,4,2,293156,293156,293158,0,2,1
83669,1,3,293157,293158,293161,1,4,0
83670,2,1,293159,293161,293162,2,3,0
83671,1,2,293160,293162,293164,2,4,0
83672,4,2,293164,293164,293166,0,2,0
83673,1,2,293165,293166,293168,1,3,0
83674,3,3,293168,293168,293171,0,3,0
83675,5,3,293173,293173,293176,0,3,2
83676,4,2,293177,293177,293179,0,2,1
83677,1,1,293178,293179,293180,1,2,0
83678,5,1,293183,293183,293184,0,1,3
83679,5,1,293188,293188,293189,0,1,4
83680,4,3,293192,293192,293195,0,3,3
83681,2,1,293194,293195,293196,1,2,0
83682,3,3,293197,293197,293200,0,3,1
83683,5,1,293202,293202,293203,0,1,2
83684,1,1,293203,293203,293204,0,1,0
83685,6,3,293209,293209,293212,0,3,5
83686,4,3,293213,293213,293216,0,3,1
83687,3,3,293216,293216,293219,0,3,0
83688,5,1,293221,293221,293222,0,1,2
83689,3,3,293224,293224,293227,0,3,2
83690,2,2,293226,293227,293229,1,3,0
83691,6,3,293232,293232,293235,0,3,3
83692,4,2,293236,293236,293238,0,2,1
83693,3,1,293239,293239,293240,0,1,1
83694,6,2,293245,293245,293247,0,2,5
83695,6,2,293251,293251,293253,0,2,4
83696,6,3,293257,293257,293260,0,3,4
83697,3,1,293260,293260,293261,0,1,0
83698,3,3,293263,293263,293266,0,3,2
83699,5,2,293268,293268,293270,0,2,2
83700,3,3,293271,293271,293274,0,3,1
83701,2,1,293273,293274,293275,1,2,0
83702,2,2,293275,293275,293277,0,2,0
83703,6,3,293281,293281,293284,0,3,4
83704,2,2,293283,293284,293286,1,3,0
83705,3,2,293286,293286,293288,0,2,0
83706,3,1,293289,293289,293290,0,1,1
83707,6,2,293295,293295,293297,0,2,5
83708,3,3,293298,293298,293301,0,3,1
83709,4,3,293302,293302,293305,0,3,1
83710,4,1,293306,293306,293307,0,1,1
83711,3,2,293309,293309,293311,0,2,2
83712,2,2,293311,293311,293313,0,2,0
83713,4,2,293315,293315,293317,0,2,2
83714,1,3,293316,293317,293320,1,4,0
83715,1,3,293317,293320,293323,3,6,0
83716,6,3,293323,293323,293326,0,3,0
83717,1,3,293324,293326,293329,2,5,0
83718,1,2,293325,293329,293331,4,6,0
83719,6,2,293331,293331,293333,0,2,0
83720,1,2,293332,293333,293335,1,3,0
83721,2,2,293334,293335,293337,1,3,0
83722,4,3,293338,293338,293341,0,3,1
83723,4,2,293342,293342,293344,0,2,1
83724,3,2,293345,293345,293347,0,2,1
83725,2,1,293347,293347,293348,0,1,0
83726,6,3,293353,293353,293356,0,3,5
83727,6,2,293359,293359,293361,0,2,3
83728,5,2,293364,293364,293366,0,2,3
83729,3,2,293367,293367,293369,0,2,1
83730,5,1,293372,293372,293373,0,1,3
83731,5,2,293377,293377,293379,0,2,4
83732,2,3,293379,293379,293382,0,3,0
83733,4,1,293383,293383,293384,0,1,1
83734,1,1,293384,293384,293385,0,1,0
83735,2,1,293386,293386,293387,0,1,1
83736,6,3,293392,293392,293395,0,3,5
83737,2,1,293394,293395,293396,1,2,0
83738,6,2,293400,293400,293402,0,2,4
83739,1,1,293401,293402,293403,1,2,0
83740,3,1,293404,293404,293405,0,1,1
83741,4,3,293408,293408,293411,0,3,3
83742,4,3,293412,293412,293415,0,3,1
83743,2,3,293414,293415,293418,1,4,0
83744,4,3,293418,293418,293421,0,3,0
83745,1,3,293419,293421,293424,2,5,0
83746,2,3,293421,293424,293427,3,6,0
83747,6,2,293427,293427,293429,0,2,0
83748,3,2,293430,293430,293432,0,2,1
83749,5,3,293435,293435,293438,0,3,3
83750,3,1,293438,293438,293439,0,1,0
83751,5,1,293443,293443,293444,0,1,4
83752,4,3,293447,293447,293450,0,3,3
83753,1,3,293448,293450,293453,2,5,0
83754,1,1,293449,293453,293454,4,5,0
83755,1,3,293450,293454,293457,4,7,0
83756,5,2,293455,293457,293459,2,4,0
83757,6,3,293461,293461,293464,0,3,2
83758,6,1,293467,293467,293468,0,1,3
83759,5,1,293472,293472,293473,0,1,4
83760,4,3,293476,293476,293479,0,3,3
83761,4,1,293480,293480,293481,0,1,1
83762,5,3,293485,293485,293488,0,3,4
83763,6,3,293491,293491,293494,0,3,3
83764,2,3,293493,293494,293497,1,4,0
83765,2,2,293495,293497,293499,2,4,0
83766,6,2,293501,293501,293503,0,2,2
83767,3,3,293504,293504,293507,0,3,1
83768,3,2,293507,293507,293509,0,2,0
83769,3,2,293510,293510,293512,0,2,1
83770,6,3,293516,293516,293519,0,3,4
83771,1,1,293517,293519,293520,2,3,0
83772,1,1,293518,293520,293521,2,3,0
83773,2,3,293520,293521,293524,1,4,0
83774,1,3,293521,293524,293527,3,6,0
83775,4,3,293525,293527,293530,2,5,0
83776,3,3,293528,293530,293533,2,5,0
83777,5,2,293533,293533,293535,0,2,0
83778,5,2,293538,293538,293540,0,2,3
83779,4,2,293542,293542,293544,0,2,2
83780,6,3,293548,293548,293551,0,3,4
83781,3,3,293551,293551,293554,0,3,0
83782,2,2,293553,293554,293556,1,3,0
83783,4,2,293557,293557,293559,0,2,1
83784,1,1,293558,293559,293560,1,2,0
83785,4,3,293562,293562,293565,0,3,2
83786,6,3,293568,293568,293571,0,3,3
83787,6,2,293574,293574,293576,0,2,3
83788,1,2,293575,293576,293578,1,3,0
83789,1,3,293576,293578,293581,2,5,0
83790,1,1,293577,293581,293582,4,5,0
83791,4,2,293581,293582,293584,1,3,0
83792,5,2,293586,293586,293588,0,2,2
83793,3,1,293589,293589,293590,0,1,1
83794,4,3,293593,293593,293596,0,3,3
83795,2,1,293595,293596,293597,1,2,0
83796,2,1,293597,293597,293598,0,1,0
83797,4,3,293601,293601,293604,0,3,3
83798,3,2,293604,293604,293606,0,2,0
83799,6,1,293610,293610,293611,0,1,4
83800,5,2,293615,293615,293617,0,2,4
83801,2,1,293617,293617,293618,0,1,0
83802,2,1,293619,293619,293620,0,1,1
83803,6,2,293625,293625,293627,0,2,5
83804,2,2,293627,293627,293629,0,2,0
83805,4,3,293631,293631,293634,0,3,2
83806,5,1,293636,293636,293637,0,1,2
83807,3,3,293639,293639,293642,0,3,2
83808,4,3,293643,293643,293646,0,3,1
83809,4,2,293647,293647,293649,0,2,1
83810,2,2,293649,293649,293651,0,2,0
83811,3,2,293652,293652,293654,0,2,1
83812,3,3,293655,293655,293658,0,3,1
83813,3,1,293658,293658,293659,0,1,0
83814,2,1,293660,293660,293661,0,1,1
83815,4,2,293664,293664,293666,0,2,3
83816,1,2,293665,293666,293668,1,3,0
83817,3,3,293668,293668,293671,0,3,0
83818,2,1,293670,293671,293672,1,2,0
83819,5,2,293675,293675,293677,0,2,3
83820,6,2,293681,293681,293683,0,2,4
83821,4,2,293685,293685,293687,0,2,2
83822,2,2,293687,293687,293689,0,2,0
83823,4,1,293691,293691,293692,0,1,2
83824,3,3,293694,293694,293697,0,3,2
83825,1,3,293695,293697,293700,2,5,0
83826,3,3,293698,293700,293703,2,5,0
83827,6,1,293704,293704,293705,0,1,1
83828,1,3,293705,293705,293708,0,3,0
83829,6,2,293711,293711,293713,0,2,3
83830,1,3,293712,293713,293716,1,4,0
83831,1,3,293713,293716,293719,3,6,0
83832,3,3,293716,293719,293722,3,6,0
83833,5,3,293721,293722,293725,1,4,0
83834,2,2,293723,293725,293727,2,4,0
83835,5,3,293728,293728,293731,0,3,1
83836,5,2,293733,293733,293735,0,2,2
83837,5,3,293738,293738,293741,0,3,3
83838,6,1,293744,293744,293745,0,1,3
83839,2,3,293746,293746,293749,0,3,1
83840,3,3,293749,293749,293752,0,3,0
83841,4,1,293753,293753,293754,0,1,1
83842,1,1,293754,293754,293755,0,1,0
83843,3,2,293757,293757,293759,0,2,2
83844,5,3,293762,293762,293765,0,3,3
83845,1,2,293763,293765,293767,2,4,0
83846,1,3,293764,293767,293770,3,6,0
83847,4,2,293768,293770,293772,2,4,0
83848,5,3,293773,293773,293776,0,3,1
83849,1,2,293774,293776,293778,2,4,0
83850,2,1,293776,293778,293779,2,3,0
83851,3,2,293779,293779,293781,0,2,0
83852,3,3,293782,293782,293785,0,3,1
83853,4,1,293786,293786,293787,0,1,1
83854,1,3,293787,293787,293790,0,3,0
83855,6,3,293793,293793,293796,0,3,3
83856,4,2,293797,293797,293799,0,2,1
83857,5,2,293802,293802,293804,0,2,3
83858,2,3,293804,293804,293807,0,3,0
83859,4,2,293808,293808,293810,0,2,1
83860,2,2,293810,293810,293812,0,2,0
83861,4,1,293814,293814,293815,0,1,2
83862,3,3,293817,293817,293820,0,3,2
83863,1,3,293818,293820,293823,2,5,0
83864,2,2,293820,293823,293825,3,5,0
83865,3,2,293823,293825,293827,2,4,0
83866,1,2,293824,293827,293829,3,5,0
83867,5,3,293829,293829,293832,0,3,0
83868,2,3,293831,293832,293835,1,4,0
83869,4,2,293835,293835,293837,0,2,0
83870,2,1,293837,293837,293838,0,1,0
83871,5,2,293842,293842,293844,0,2,4
83872,4,1,293846,293846,293847,0,1,2
83873,5,3,293851,293851,293854,0,3,4
83874,6,3,293857,293857,293860,0,3,3
83875,6,1,293863,293863,293864,0,1,3
83876,5,1,293868,293868,293869,0,1,4
83877,6,1,293874,293874,293875,0,1,5
83878,2,2,293876,293876,293878,0,2,1
83879,6,2,293882,293882,293884,0,2,4
83880,6,2,293888,293888,293890,0,2,4
83881,1,1,293889,293890,293891,1,2,0
83882,3,3,293892,293892,293895,0,3,1
83883,2,1,293894,293895,293896,1,2,0
83884,4,2,293898,293898,293900,0,2,2
83885,3,2,293901,293901,293903,0,2,1
83886,6,3,293907,293907,293910,0,3,4
83887,3,1,293910,293910,293911,0,1,0
83888,2,1,293912,293912,293913,0,1,1
83889,2,1,293914,293914,293915,0,1,1
83890,2,2,293916,293916,293918,0,2,1
83891,2,3,293918,293918,293921,0,3,0
83892,1,3,293919,293921,293924,2,5,0
83893,3,1,293922,293924,293925,2,3,0
83894,5,3,293927,293927,293930,0,3,2
83895,1,2,293928,293930,293932,2,4,0
83896,5,1,293933,293933,293934,0,1,1
83897,1,1,293934,293934,293935,0,1,0
83898,4,2,293938,293938,293940,0,2,3
83899,1,3,293939,293940,293943,1,4,0
83900,2,3,293941,293943,293946,2,5,0
83901,1,2,293942,293946,293948,4,6,0
83902,1,3,293943,293948,293951,5,8,0
83903,6,2,293949,293951,293953,2,4,0
83904,2,1,293951,293953,293954,2,3,0
83905,6,3,293957,293957,293960,0,3,3
83906,5,3,293962,293962,293965,0,3,2
83907,1,2,293963,293965,293967,2,4,0
83908,5,2,293968,293968,293970,0,2,1
83909,4,1,293972,293972,293973,0,1,2
83910,6,3,293978,293978,293981,0,3,5
83911,6,3,293984,293984,293987,0,3,3
83912,3,3,293987,293987,293990,0,3,0
83913,6,1,293993,293993,293994,0,1,3
83914,3,1,293996,293996,293997,0,1,2
83915,5,2,294001,294001,294003,0,2,4
83916,1,1,294002,294003,294004,1,2,0
83917,1,2,294003,294004,294006,1,3,0
83918,6,2,294009,294009,294011,0,2,3
83919,2,2,294011,294011,294013,0,2,0
83920,5,3,294016,294016,294019,0,3,3
83921,6,3,294022,294022,294025,0,3,3
83922,1,2,294023,294025,294027,2,4,0
83923,1,1,294024,294027,294028,3,4,0
83924,1,3,294025,294028,294031,3,6,0
83925,5,3,294030,294031,294034,1,4,0
83926,1,1,294031,294034,294035,3,4,0
83927,4,1,294035,294035,294036,0,1,0
83928,6,3,294041,294041,294044,0,3,5
83929,6,3,294047,294047,294050,0,3,3
83930,4,2,294051,294051,294053,0,2,1
83931,2,3,294053,294053,294056,0,3,0
83932,4,3,294057,294057,294060,0,3,1
83933,4,2,294061,294061,294063,0,2,1
83934,6,2,294067,294067,294069,0,2,4
83935,2,1,294069,294069,294070,0,1,0
83936,2,3,294071,294071,294074,0,3,1
83937,2,3,294073,294074,294077,1,4,0
83938,6,3,294079,294079,294082,0,3,2
83939,4,3,294083,294083,294086,0,3,1
83940,2,1,294085,294086,294087,1,2,0
83941,4,3,294089,294089,294092,0,3,2
83942,5,3,294094,294094,294097,0,3,2
83943,3,1,294097,294097,294098,0,1,0
83944,4,2,294101,294101,294103,0,2,3
83945,1,3,294102,294103,294106,1,4,0
83946,4,1,294106,294106,294107,0,1,0
83947,5,1,294111,294111,294112,0,1,4
83948,1,1,294112,294112,294113,0,1,0
83949,6,2,294118,294118,294120,0,2,5
83950,3,1,294121,294121,294122,0,1,1
83951,6,3,294127,294127,294130,0,3,5
83952,3,3,294130,294130,294133,0,3,0
83953,1,1,294131,294133,294134,2,3,0
83954,3,3,294134,294134,294137,0,3,0
83955,2,3,294136,294137,294140,1,4,0
83956,6,3,294142,294142,294145,0,3,2
83957,6,1,294148,294148,294149,0,1,3
83958,6,2,294154,294154,294156,0,2,5
83959,6,2,294160,294160,294162,0,2,4
83960,1,2,294161,294162,294164,1,3,0
83961,3,1,294164,294164,294165,0,1,0
83962,3,1,294167,294167,294168,0,1,2
83963,1,1,294168,294168,294169,0,1,0
83964,5,2,294173,294173,294175,0,2,4
83965,1,3,294174,294175,294178,1,4,0
83966,5,1,294179,294179,294180,0,1,1
83967,3,1,294182,294182,294183,0,1,2
83968,1,2,294183,294183,294185,0,2,0
83969,2,1,294185,294185,294186,0,1,0
83970,3,3,294188,294188,294191,0,3,2
83971,2,1,294190,294191,294192,1,2,0
83972,3,2,294193,294193,294195,0,2,1
83973,5,3,294198,294198,294201,0,3,3
83974,1,1,294199,294201,294202,2,3,0
83975,6,2,294205,294205,294207,0,2,3
83976,3,2,294208,294208,294210,0,2,1
83977,2,3,294210,294210,294213,0,3,0
83978,3,1,294213,294213,294214,0,1,0
83979,4,3,294217,294217,294220,0,3,3
83980,2,1,294219,294220,294221,1,2,0
83981,4,3,294223,294223,294226,0,3,2
83982,3,1,294226,294226,294227,0,1,0
83983,6,2,294232,294232,294234,0,2,5
83984,1,1,294233,294234,294235,1,2,0
83985,1,1,294234,294235,294236,1,2,0
83986,3,3,294237,294237,294240,0,3,1
83987,3,3,294240,294240,294243,0,3,0
83988,2,3,294242,294243,294246,1,4,0
83989,1,2,294243,294246,294248,3,5,0
83990,2,1,294245,294248,294249,3,4,0
83991,2,1,294247,294249,294250,2,3,0
83992,4,3,294251,294251,294254,0,3,1
83993,3,3,294254,294254,294257,0,3,0
83994,5,3,294259,294259,294262,0,3,2
83995,5,3,294264,294264,294267,0,3,2
83996,4,2,294268,294268,294270,0,2,1
83997,1,3,294269,294270,294273,1,4,0
83998,3,1,294272,294273,294274,1,2,0
83999,6,2,294278,294278,294280,0,2,4
84000,5,3,294283,294283,294286,0,3,3
84001,3,3,294286,294286,294289,0,3,0
84002,6,2,294292,294292,294294,0,2,3
84003,6,2,294298,294298,294300,0,2,4
84004,2,1,294300,294300,294301,0,1,0
84005,4,2,294304,294304,294306,0,2,3
84006,5,2,294309,294309,294311,0,2,3
84007,1,3,294310,294311,294314,1,4,0
84008,3,3,294313,294314,294317,1,4,0
84009,5,3,294318,294318,294321,0,3,1
84010,5,3,294323,294323,294326,0,3,2
84011,6,2,294329,294329,294331,0,2,3
84012,3,1,294332,294332,294333,0,1,1
84013,2,2,294334,294334,294336,0,2,1
84014,6,2,294340,294340,294342,0,2,4
84015,4,1,294344,294344,294345,0,1,2
84016,4,3,294348,294348,294351,0,3,3
84017,2,1,294350,294351,294352,1,2,0
84018,5,1,294355,294355,294356,0,1,3
84019,4,3,294359,294359,294362,0,3,3
84020,5,1,294364,294364,294365,0,1,2
84021,3,1,294367,294367,294368,0,1,2
84022,4,1,294371,294371,294372,0,1,3
84023,6,2,294377,294377,294379,0,2,5
84024,1,3,294378,294379,294382,1,4,0
84025,5,2,294383,294383,294385,0,2,1
84026,2,1,294385,294385,294386,0,1,0
84027,5,3,294390,294390,294393,0,3,4
84028,4,2,294394,294394,294396,0,2,1
84029,1,3,294395,294396,294399,1,4,0
84030,3,1,294398,294399,294400,1,2,0
84031,1,1,294399,294400,294401,1,2,0
84032,1,3,294400,294401,294404,1,4,0
84033,5,3,294405,294405,294408,0,3,1
84034,5,2,294410,294410,294412,0,2,2
84035,5,1,294415,294415,294416,0,1,3
84036,1,2,294416,294416,294418,0,2,0
84037,5,2,294421,294421,294423,0,2,3
84038,6,2,294427,294427,294429,0,2,4
84039,6,2,294433,294433,294435,0,2,4
84040,3,1,294436,294436,294437,0,1,1
84041,2,1,294438,294438,294439,0,1,1
84042,5,2,294443,294443,294445,0,2,4
84043,4,1,294447,294447,294448,0,1,2
84044,2,3,294449,294449,294452,0,3,1
84045,2,1,294451,294452,294453,1,2,0
84046,1,1,294452,294453,294454,1,2,0
84047,2,2,294454,294454,294456,0,2,0
84048,6,2,294460,294460,294462,0,2,4
84049,6,1,294466,294466,294467,0,1,4
84050,5,1,294471,294471,294472,0,1,4
84051,3,3,294474,294474,294477,0,3,2
84052,2,2,294476,294477,294479,1,3,0
84053,6,3,294482,294482,294485,0,3,3
84054,4,2,294486,294486,294488,0,2,1
84055,5,1,294491,294491,294492,0,1,3
84056,6,2,294497,294497,294499,0,2,5
84057,5,2,294502,294502,294504,0,2,3
84058,5,2,294507,294507,294509,0,2,3
84059,2,2,294509,294509,294511,0,2,0
84060,1,3,294510,294511,294514,1,4,0
84061,1,1,294511,294514,294515,3,4,0
84062,4,2,294515,294515,294517,0,2,0
84063,3,1,294518,294518,294519,0,1,1
84064,4,2,294522,294522,294524,0,2,3
84065,2,2,294524,294524,294526,0,2,0
84066,3,2,294527,294527,294529,0,2,1
84067,4,2,294531,294531,294533,0,2,2
84068,4,2,294535,294535,294537,0,2,2
84069,3,2,294538,294538,294540,0,2,1
84070,5,3,294543,294543,294546,0,3,3
84071,3,1,294546,294546,294547,0,1,0
84072,3,3,294549,294549,294552,0,3,2
84073,5,3,294554,294554,294557,0,3,2
84074,6,1,294560,294560,294561,0,1,3
84075,6,2,294566,294566,294568,0,2,5
84076,5,2,294571,294571,294573,0,2,3
84077,5,2,294576,294576,294578,0,2,3
84078,5,3,294581,294581,294584,0,3,3
84079,3,3,294584,294584,294587,0,3,0
84080,2,2,294586,294587,294589,1,3,0
84081,1,1,294587,294589,294590,2,3,0
84082,1,2,294588,294590,294592,2,4,0
84083,6,3,294594,294594,294597,0,3,2
84084,1,2,294595,294597,294599,2,4,0
84085,1,2,294596,294599,294601,3,5,0
84086,6,1,294602,294602,294603,0,1,1
84087,2,3,294604,294604,294607,0,3,1
84088,5,3,294609,294609,294612,0,3,2
84089,4,1,294613,294613,294614,0,1,1
84090,3,1,294616,294616,294617,0,1,2
84091,2,2,294618,294618,294620,0,2,1
84092,1,1,294619,294620,294621,1,2,0
84093,2,1,294621,294621,294622,0,1,0
84094,2,2,294623,294623,294625,0,2,1
84095,2,1,294625,294625,294626,0,1,0
84096,3,3,294628,294628,294631,0,3,2
84097,2,3,294630,294631,294634,1,4,0
84098,5,2,294635,294635,294637,0,2,1
84099,6,3,294641,294641,294644,0,3,4
84100,6,3,294647,294647,294650,0,3,3
84101,1,1,294648,294650,294651,2,3,0
84102,6,1,294654,294654,294655,0,1,3
84103,4,2,294658,294658,294660,0,2,3
84104,1,2,294659,294660,294662,1,3,0
84105,2,1,294661,294662,294663,1,2,0
84106,2,2,294663,294663,294665,0,2,0
84107,2,2,294665,294665,294667,0,2,0
84108,6,3,294671,294671,294674,0,3,4
84109,3,1,294674,294674,294675,0,1,0
84110,5,2,294679,294679,294681,0,2,4
84111,4,2,294683,294683,294685,0,2,2
84112,4,2,294687,294687,294689,0,2,2
84113,4,2,294691,294691,294693,0,2,2
84114,5,2,294696,294696,294698,0,2,3
84115,5,3,294701,294701,294704,0,3,3
84116,3,3,294704,294704,294707,0,3,0
84117,3,2,294707,294707,294709,0,2,0
84118,2,1,294709,294709,294710,0,1,0
84119,5,2,294714,294714,294716,0,2,4
84120,4,1,294718,294718,294719,0,1,2
84121,6,1,294724,294724,294725,0,1,5
84122,4,1,294728,294728,294729,0,1,3
84123,2,3,294730,294730,294733,0,3,1
84124,3,1,294733,294733,294734,0,1,0
84125,4,1,294737,294737,294738,0,1,3
84126,5,1,294742,294742,294743,0,1,4
84127,6,1,294748,294748,294749,0,1,5
84128,4,1,294752,294752,294753,0,1,3
84129,4,1,294756,294756,294757,0,1,3
84130,1,2,294757,294757,294759,0,2,0
84131,5,2,294762,294762,294764,0,2,3
84132,1,1,294763,294764,294765,1,2,0
84133,3,3,294766,294766,294769,0,3,1
84134,5,3,294771,294771,294774,0,3,2
84135,5,1,294776,294776,294777,0,1,2
84136,3,3,294779,294779,294782,0,3,2
84137,2,1,294781,294782,294783,1,2,0
84138,6,3,294787,294787,294790,0,3,4
84139,1,1,294788,294790,294791,2,3,0
84140,3,3,294791,294791,294794,0,3,0
84141,3,3,294794,294794,294797,0,3,0
84142,4,1,294798,294798,294799,0,1,1
84143,5,3,294803,294803,294806,0,3,4
84144,5,1,294808,294808,294809,0,1,2
84145,2,1,294810,294810,294811,0,1,1
84146,3,2,294813,294813,294815,0,2,2
84147,2,2,294815,294815,294817,0,2,0
84148,5,2,294820,294820,294822,0,2,3
84149,2,3,294822,294822,294825,0,3,0
84150,6,1,294828,294828,294829,0,1,3
84151,5,1,294833,294833,294834,0,1,4
84152,2,1,294835,294835,294836,0,1,1
84153,5,2,294840,294840,294842,0,2,4
84154,2,1,294842,294842,294843,0,1,0
84155,3,2,294845,294845,294847,0,2,2
84156,5,2,294850,294850,294852,0,2,3
84157,5,2,294855,294855,294857,0,2,3
84158,6,2,294861,294861,294863,0,2,4
84159,4,1,294865,294865,294866,0,1,2
84160,1,3,294866,294866,294869,0,3,0
84161,6,3,294872,294872,294875,0,3,3
84162,1,1,294873,294875,294876,2,3,0
84163,1,1,294874,294876,294877,2,3,0
84164,6,2,294880,294880,294882,0,2,3
84165,1,3,294881,294882,294885,1,4,0
84166,6,3,294887,294887,294890,0,3,2
84167,5,2,294892,294892,294894,0,2,2
84168,4,1,294896,294896,294897,0,1,2
84169,5,1,294901,294901,294902,0,1,4
84170,1,2,294902,294902,294904,0,2,0
84171,2,3,294904,294904,294907,0,3,0
84172,4,3,294908,294908,294911,0,3,1
84173,5,1,294913,294913,294914,0,1,2
84174,2,3,294915,294915,294918,0,3,1
84175,6,1,294921,294921,294922,0,1,3
84176,6,3,294927,294927,294930,0,3,5
84177,6,3,294933,294933,294936,0,3,3
84178,3,1,294936,294936,294937,0,1,0
84179,6,1,294942,294942,294943,0,1,5
84180,2,3,294944,294944,294947,0,3,1
84181,2,1,294946,294947,294948,1,2,0
84182,2,2,294948,294948,294950,0,2,0
84183,1,3,294949,294950,294953,1,4,0
84184,2,1,294951,294953,294954,2,3,0
84185,2,1,294953,294954,294955,1,2,0
84186,4,1,294957,294957,294958,0,1,2
84187,1,1,294958,294958,294959,0,1,0
84188,5,2,294963,294963,294965,0,2,4
84189,5,1,294968,294968,294969,0,1,3
84190,6,2,294974,294974,294976,0,2,5
84191,5,2,294979,294979,294981,0,2,3
84192,4,3,294983,294983,294986,0,3,2
84193,6,3,294989,294989,294992,0,3,3
84194,4,2,294993,294993,294995,0,2,1
84195,6,3,294999,294999,295002,0,3,4
84196,6,3,295005,295005,295008,0,3,3
84197,4,3,295009,295009,295012,0,3,1
84198,5,1,295014,295014,295015,0,1,2
84199,2,3,295016,295016,295019,0,3,1
84200,5,3,295021,295021,295024,0,3,2
84201,2,2,295023,295024,295026,1,3,0
84202,5,3,295028,295028,295031,0,3,2
84203,3,2,295031,295031,295033,0,2,0
84204,1,1,295032,295033,295034,1,2,0
84205,4,1,295036,295036,295037,0,1,2
84206,5,2,295041,295041,295043,0,2,4
84207,4,1,295045,295045,295046,0,1,2
84208,3,1,295048,295048,295049,0,1,2
84209,2,2,295050,295050,295052,0,2,1
84210,5,1,295055,295055,295056,0,1,3
84211,3,1,295058,295058,295059,0,1,2
84212,4,2,295062,295062,295064,0,2,3
84213,3,1,295065,295065,295066,0,1,1
84214,3,1,295068,295068,295069,0,1,2
84215,1,3,295069,295069,295072,0,3,0
84216,1,1,295070,295072,295073,2,3,0
84217,4,1,295074,295074,295075,0,1,1
84218,1,2,295075,295075,295077,0,2,0
84219,1,3,295076,295077,295080,1,4,0
84220,3,2,295079,295080,295082,1,3,0
84221,4,1,295083,295083,295084,0,1,1
84222,6,3,295089,295089,295092,0,3,5
84223,4,3,295093,295093,295096,0,3,1
84224,3,1,295096,295096,295097,0,1,0
84225,4,3,295100,295100,295103,0,3,3
84226,6,3,295106,295106,295109,0,3,3
84227,5,2,295111,295111,295113,0,2,2
84228,2,3,295113,295113,295116,0,3,0
84229,2,2,295115,295116,295118,1,3,0
84230,3,2,295118,295118,295120,0,2,0
84231,5,1,295123,295123,295124,0,1,3
84232,4,2,295127,295127,295129,0,2,3
84233,3,1,295130,295130,295131,0,1,1
84234,5,1,295135,295135,295136,0,1,4
84235,5,1,295140,295140,295141,0,1,4
84236,3,2,295143,295143,295145,0,2,2
84237,3,2,295146,295146,295148,0,2,1
84238,5,1,295151,295151,295152,0,1,3
84239,4,1,295155,295155,295156,0,1,3
84240,3,2,295158,295158,295160,0,2,2
84241,2,1,295160,295160,295161,0,1,0
84242,6,1,295166,295166,295167,0,1,5
84243,1,1,295167,295167,295168,0,1,0
84244,4,3,295171,295171,295174,0,3,3
84245,2,3,295173,295174,295177,1,4,0
84246,3,2,295176,295177,295179,1,3,0
84247,4,3,295180,295180,295183,0,3,1
84248,4,3,295184,295184,295187,0,3,1
84249,5,1,295189,295189,295190,0,1,2
84250,6,2,295195,295195,295197,0,2,5
84251,4,1,295199,295199,295200,0,1,2
84252,3,1,295202,295202,295203,0,1,2
84253,4,3,295206,295206,295209,0,3,3
84254,2,3,295208,295209,295212,1,4,0
84255,5,3,295213,295213,295216,0,3,1
84256,5,3,295218,295218,295221,0,3,2
84257,6,2,295224,295224,295226,0,2,3
84258,5,2,295229,295229,295231,0,2,3
84259,4,3,295233,295233,295236,0,3,2
84260,1,1,295234,295236,295237,2,3,0
84261,2,3,295236,295237,295240,1,4,0
84262,6,1,295242,295242,295243,0,1,2
84263,3,2,295245,295245,295247,0,2,2
84264,6,1,295251,295251,295252,0,1,4
84265,5,3,295256,295256,295259,0,3,4
84266,1,1,295257,295259,295260,2,3,0
84267,1,1,295258,295260,295261,2,3,0
84268,6,3,295264,295264,295267,0,3,3
84269,6,2,295270,295270,295272,0,2,3
84270,1,1,295271,295272,295273,1,2,0
84271,1,2,295272,295273,295275,1,3,0
84272,4,3,295276,295276,295279,0,3,1
84273,3,2,295279,295279,295281,0,2,0
84274,6,2,295285,295285,295287,0,2,4
84275,1,2,295286,295287,295289,1,3,0
84276,3,3,295289,295289,295292,0,3,0
84277,4,1,295293,295293,295294,0,1,1
84278,5,2,295298,295298,295300,0,2,4
84279,5,1,295303,295303,295304,0,1,3
84280,1,2,295304,295304,295306,0,2,0
84281,4,3,295308,295308,295311,0,3,2
84282,6,3,295314,295314,295317,0,3,3
84283,6,1,295320,295320,295321,0,1,3
84284,3,1,295323,295323,295324,0,1,2
84285,3,2,295326,295326,295328,0,2,2
84286,1,1,295327,295328,295329,1,2,0
84287,5,2,295332,295332,295334,0,2,3
84288,3,2,295335,295335,295337,0,2,1
84289,4,1,295339,295339,295340,0,1,2
84290,4,1,295343,295343,295344,0,1,3
84291,6,1,295349,295349,295350,0,1,5
84292,2,2,295351,295351,295353,0,2,1
84293,1,1,295352,295353,295354,1,2,0
84294,2,2,295354,295354,295356,0,2,0
84295,3,3,295357,295357,295360,0,3,1
84296,5,3,295362,295362,295365,0,3,2
84297,5,3,295367,295367,295370,0,3,2
84298,4,2,295371,295371,295373,0,2,1
84299,4,1,295375,295375,295376,0,1,2
84300,3,1,295378,295378,295379,0,1,2
84301,2,3,295380,295380,295383,0,3,1
84302,4,1,295384,295384,295385,0,1,1
84303,3,1,295387,295387,295388,0,1,2
84304,6,3,295393,295393,295396,0,3,5
84305,3,3,295396,295396,295399,0,3,0
84306,4,1,295400,295400,295401,0,1,1
84307,5,3,295405,295405,295408,0,3,4
84308,3,1,295408,295408,295409,0,1,0
84309,3,3,295411,295411,295414,0,3,2
84310,5,2,295416,295416,295418,0,2,2
84311,4,1,295420,295420,295421,0,1,2
84312,5,3,295425,295425,295428,0,3,4
84313,3,2,295428,295428,295430,0,2,0
84314,6,2,295434,295434,295436,0,2,4
84315,2,2,295436,295436,295438,0,2,0
84316,2,1,295438,295438,295439,0,1,0
84317,6,2,295444,295444,295446,0,2,5
84318,6,3,295450,295450,295453,0,3,4
84319,1,3,295451,295453,295456,2,5,0
84320,2,1,295453,295456,295457,3,4,0
84321,5,2,295458,295458,295460,0,2,1
84322,3,3,295461,295461,295464,0,3,1
84323,2,3,295463,295464,295467,1,4,0
84324,6,3,295469,295469,295472,0,3,2
84325,2,2,295471,295472,295474,1,3,0
84326,2,1,295473,295474,295475,1,2,0
84327,6,1,295479,295479,295480,0,1,4
84328,6,3,295485,295485,295488,0,3,5
84329,3,1,295488,295488,295489,0,1,0
84330,5,2,295493,295493,295495,0,2,4
84331,6,1,295499,295499,295500,0,1,4
84332,4,2,295503,295503,295505,0,2,3
84333,6,1,295509,295509,295510,0,1,4
84334,1,1,295510,295510,295511,0,1,0
84335,5,3,295515,295515,295518,0,3,4
84336,2,2,295517,295518,295520,1,3,0
84337,6,3,295523,295523,295526,0,3,3
84338,4,1,295527,295527,295528,0,1,1
84339,3,2,295530,295530,295532,0,2,2
84340,6,1,295536,295536,295537,0,1,4
84341,3,2,295539,295539,295541,0,2,2
84342,4,3,295543,295543,295546,0,3,2
84343,6,2,295549,295549,295551,0,2,3
84344,3,3,295552,295552,295555,0,3,1
84345,5,2,295557,295557,295559,0,2,2
84346,6,1,295563,295563,295564,0,1,4
84347,1,1,295564,295564,295565,0,1,0
84348,4,3,295568,295568,295571,0,3,3
84349,6,2,295574,295574,295576,0,2,3
84350,5,3,295579,295579,295582,0,3,3
84351,2,2,295581,295582,295584,1,3,0
84352,2,1,295583,295584,295585,1,2,0
84353,3,3,295586,295586,295589,0,3,1
84354,1,2,295587,295589,295591,2,4,0
84355,4,1,295591,295591,295592,0,1,0
84356,4,3,295595,295595,295598,0,3,3
84357,6,1,295601,295601,295602,0,1,3
84358,3,2,295604,295604,295606,0,2,2
84359,2,2,295606,295606,295608,0,2,0
84360,3,1,295609,295609,295610,0,1,1
84361,4,1,295613,295613,295614,0,1,3
84362,2,3,295615,295615,295618,0,3,1
84363,1,3,295616,295618,295621,2,5,0
84364,2,1,295618,295621,295622,3,4,0
84365,2,3,295620,295622,295625,2,5,0
84366,3,1,295623,295625,295626,2,3,0
84367,2,1,295625,295626,295627,1,2,0
84368,5,2,295630,295630,295632,0,2,3
84369,6,1,295636,295636,295637,0,1,4
84370,1,1,295637,295637,295638,0,1,0
84371,5,1,295642,295642,295643,0,1,4
84372,5,3,295647,295647,295650,0,3,4
84373,5,2,295652,295652,295654,0,2,2
84374,4,1,295656,295656,295657,0,1,2
84375,3,1,295659,295659,295660,0,1,2
84376,1,3,295660,295660,295663,0,3,0
84377,5,3,295665,295665,295668,0,3,2
84378,5,1,295670,295670,295671,0,1,2
84379,3,2,295673,295673,295675,0,2,2
84380,3,3,295676,295676,295679,0,3,1
84381,5,3,295681,295681,295684,0,3,2
84382,5,1,295686,295686,295687,0,1,2
84383,2,2,295688,295688,295690,0,2,1
84384,5,3,295693,295693,295696,0,3,3
84385,5,3,295698,295698,295701,0,3,2
84386,3,1,295701,295701,295702,0,1,0
84387,6,3,295707,295707,295710,0,3,5
84388,5,1,295712,295712,295713,0,1,2
84389,6,1,295718,295718,295719,0,1,5
84390,5,1,295723,295723,295724,0,1,4
84391,2,3,295725,295725,295728,0,3,1
84392,5,3,295730,295730,295733,0,3,2
84393,4,1,295734,295734,295735,0,1,1
84394,1,2,295735,295735,295737,0,2,0
84395,3,3,295738,295738,295741,0,3,1
84396,4,2,295742,295742,295744,0,2,1
84397,4,1,295746,295746,295747,0,1,2
84398,2,3,295748,295748,295751,0,3,1
84399,3,2,295751,295751,295753,0,2,0
84400,3,2,295754,295754,295756,0,2,1
84401,5,1,295759,295759,295760,0,1,3
84402,1,1,295760,295760,295761,0,1,0
84403,6,2,295766,295766,295768,0,2,5
84404,6,2,295772,295772,295774,0,2,4
84405,4,2,295776,295776,295778,0,2,2
84406,1,2,295777,295778,295780,1,3,0
84407,5,1,295782,295782,295783,0,1,2
84408,3,3,295785,295785,295788,0,3,2
84409,4,3,295789,295789,295792,0,3,1
84410,3,3,295792,295792,295795,0,3,0
84411,1,2,295793,295795,295797,2,4,0
84412,5,2,295798,295798,295800,0,2,1
84413,4,3,295802,295802,295805,0,3,2
84414,2,2,295804,295805,295807,1,3,0
84415,2,3,295806,295807,295810,1,4,0
84416,1,3,295807,295810,295813,3,6,0
84417,5,2,295812,295813,295815,1,3,0
84418,6,2,295818,295818,295820,0,2,3
84419,5,1,295823,295823,295824,0,1,3
84420,5,1,295828,295828,295829,0,1,4
84421,3,3,295831,295831,295834,0,3,2
84422,4,2,295835,295835,295837,0,2,1
84423,1,1,295836,295837,295838,1,2,0
84424,5,3,295841,295841,295844,0,3,3
84425,1,1,295842,295844,295845,2,3,0
84426,6,3,295848,295848,295851,0,3,3
84427,5,2,295853,295853,295855,0,2,2
84428,4,2,295857,295857,295859,0,2,2
84429,3,3,295860,295860,295863,0,3,1
84430,3,3,295863,295863,295866,0,3,0
84431,1,2,295864,295866,295868,2,4,0
84432,1,1,295865,295868,295869,3,4,0
84433,3,2,295868,295869,295871,1,3,0
84434,2,1,295870,295871,295872,1,2,0
84435,6,2,295876,295876,295878,0,2,4
84436,5,3,295881,295881,295884,0,3,3
84437,6,3,295887,295887,295890,0,3,3
84438,1,1,295888,295890,295891,2,3,0
84439,5,2,295893,295893,295895,0,2,2
84440,5,2,295898,295898,295900,0,2,3
84441,2,3,295900,295900,295903,0,3,0
84442,6,2,295906,295906,295908,0,2,3
84443,1,3,295907,295908,295911,1,4,0
84444,3,1,295910,295911,295912,1,2,0
84445,1,1,295911,295912,295913,1,2,0
84446,3,2,295914,295914,295916,0,2,1
84447,5,2,295919,295919,295921,0,2,3
84448,2,2,295921,295921,295923,0,2,0
84449,6,3,295927,295927,295930,0,3,4
84450,3,1,295930,295930,295931,0,1,0
84451,2,1,295932,295932,295933,0,1,1
84452,1,2,295933,295933,295935,0,2,0
84453,1,2,295934,295935,295937,1,3,0
84454,1,2,295935,295937,295939,2,4,0
84455,6,3,295941,295941,295944,0,3,2
84456,5,3,295946,295946,295949,0,3,2
84457,4,1,295950,295950,295951,0,1,1
84458,2,1,295952,295952,295953,0,1,1
84459,4,2,295956,295956,295958,0,2,3
84460,4,3,295960,295960,295963,0,3,2
84461,2,2,295962,295963,295965,1,3,0
84462,5,3,295967,295967,295970,0,3,2
84463,5,1,295972,295972,295973,0,1,2
84464,6,3,295978,295978,295981,0,3,5
84465,3,1,295981,295981,295982,0,1,0
84466,4,2,295985,295985,295987,0,2,3
84467,6,1,295991,295991,295992,0,1,4
84468,3,3,295994,295994,295997,0,3,2
84469,2,2,295996,295997,295999,1,3,0
84470,2,3,295998,295999,296002,1,4,0
84471,5,2,296003,296003,296005,0,2,1
84472,3,1,296006,296006,296007,0,1,1
84473,6,1,296012,296012,296013,0,1,5
84474,2,1,296014,296014,296015,0,1,1
84475,2,1,296016,296016,296017,0,1,1
84476,5,2,296021,296021,296023,0,2,4
84477,5,3,296026,296026,296029,0,3,3
84478,5,1,296031,296031,296032,0,1,2
84479,5,2,296036,296036,296038,0,2,4
84480,4,3,296040,296040,296043,0,3,2
84481,6,2,296046,296046,296048,0,2,3
84482,3,3,296049,296049,296052,0,3,1
84483,3,3,296052,296052,296055,0,3,0
84484,3,3,296055,296055,296058,0,3,0
84485,5,3,296060,296060,296063,0,3,2
84486,6,1,296066,296066,296067,0,1,3
84487,2,1,296068,296068,296069,0,1,1
84488,2,3,296070,296070,296073,0,3,1
84489,6,1,296076,296076,296077,0,1,3
84490,4,2,296080,296080,296082,0,2,3
84491,4,3,296084,296084,296087,0,3,2
84492,4,2,296088,296088,296090,0,2,1
84493,3,1,296091,296091,296092,0,1,1
84494,6,2,296097,296097,296099,0,2,5
84495,3,2,296100,296100,296102,0,2,1
84496,2,1,296102,296102,296103,0,1,0
84497,1,1,296103,296103,296104,0,1,0
84498,5,2,296108,296108,296110,0,2,4
84499,1,3,296109,296110,296113,1,4,0
84500,6,2,296115,296115,296117,0,2,2
84501,3,2,296118,296118,296120,0,2,1
84502,6,3,296124,296124,296127,0,3,4
84503,4,1,296128,296128,296129,0,1,1
84504,6,2,296134,296134,296136,0,2,5
84505,1,3,296135,296136,296139,1,4,0
84506,1,1,296136,296139,296140,3,4,0
84507,5,3,296141,296141,296144,0,3,1
84508,6,1,296147,296147,296148,0,1,3
84509,1,2,296148,296148,296150,0,2,0
84510,4,1,296152,296152,296153,0,1,2
84511,2,3,296154,296154,296157,0,3,1
84512,6,2,296160,296160,296162,0,2,3
84513,1,1,296161,296162,296163,1,2,0
84514,5,3,296166,296166,296169,0,3,3
84515,2,2,296168,296169,296171,1,3,0
84516,5,1,296173,296173,296174,0,1,2
84517,6,1,296179,296179,296180,0,1,5
84518,5,3,296184,296184,296187,0,3,4
84519,3,3,296187,296187,296190,0,3,0
84520,4,2,296191,296191,296193,0,2,1
84521,1,2,296192,296193,296195,1,3,0
84522,1,3,296193,296195,296198,2,5,0
84523,3,2,296196,296198,296200,2,4,0
84524,2,2,296198,296200,296202,2,4,0
84525,3,2,296201,296202,296204,1,3,0
84526,4,1,296205,296205,296206,0,1,1
84527,6,2,296211,296211,296213,0,2,5
84528,6,1,296217,296217,296218,0,1,4
84529,2,2,296219,296219,296221,0,2,1
84530,4,2,296223,296223,296225,0,2,2
84531,3,1,296226,296226,296227,0,1,1
84532,1,3,296227,296227,296230,0,3,0
84533,1,1,296228,296230,296231,2,3,0
84534,4,2,296232,296232,296234,0,2,1
84535,4,3,296236,296236,296239,0,3,2
84536,2,3,296238,296239,296242,1,4,0
84537,6,1,296244,296244,296245,0,1,2
84538,6,3,296250,296250,296253,0,3,5
84539,4,2,296254,296254,296256,0,2,1
84540,4,3,296258,296258,296261,0,3,2
84541,5,3,296263,296263,296266,0,3,2
84542,3,2,296266,296266,296268,0,2,0
84543,1,2,296267,296268,296270,1,3,0
84544,6,2,296273,296273,296275,0,2,3
84545,3,1,296276,296276,296277,0,1,1
84546,1,3,296277,296277,296280,0,3,0
84547,6,3,296283,296283,296286,0,3,3
84548,3,3,296286,296286,296289,0,3,0
84549,6,3,296292,296292,296295,0,3,3
84550,5,2,296297,296297,296299,0,2,2
84551,3,3,296300,296300,296303,0,3,1
84552,4,1,296304,296304,296305,0,1,1
84553,3,2,296307,296307,296309,0,2,2
84554,1,3,296308,296309,296312,1,4,0
84555,5,1,296313,296313,296314,0,1,1
84556,1,1,296314,296314,296315,0,1,0
84557,4,1,296318,296318,296319,0,1,3
84558,6,2,296324,296324,296326,0,2,5
84559,6,3,296330,296330,296333,0,3,4
84560,6,1,296336,296336,296337,0,1,3
84561,4,2,296340,296340,296342,0,2,3
84562,4,2,296344,296344,296346,0,2,2
84563,6,1,296350,296350,296351,0,1,4
84564,4,2,296354,296354,296356,0,2,3
84565,5,2,296359,296359,296361,0,2,3
84566,3,1,296362,296362,296363,0,1,1
84567,2,1,296364,296364,296365,0,1,1
84568,3,2,296367,296367,296369,0,2,2
84569,1,1,296368,296369,296370,1,2,0
84570,6,2,296374,296374,296376,0,2,4
84571,4,3,296378,296378,296381,0,3,2
84572,2,1,296380,296381,296382,1,2,0
84573,6,1,296386,296386,296387,0,1,4
84574,1,2,296387,296387,296389,0,2,0
84575,2,3,296389,296389,296392,0,3,0
84576,4,1,296393,296393,296394,0,1,1
84577,2,1,296395,296395,296396,0,1,1
84578,3,2,296398,296398,296400,0,2,2
84579,3,3,296401,296401,296404,0,3,1
84580,2,2,296403,296404,296406,1,3,0
84581,3,3,296406,296406,296409,0,3,0
84582,1,3,296407,296409,296412,2,5,0
84583,3,1,296410,296412,296413,2,3,0
84584,3,1,296413,296413,296414,0,1,0
84585,1,3,296414,296414,296417,0,3,0
84586,5,3,296419,296419,296422,0,3,2
84587,5,3,296424,296424,296427,0,3,2
84588,6,1,296430,296430,296431,0,1,3
84589,6,1,296436,296436,296437,0,1,5
84590,2,3,296438,296438,296441,0,3,1
84591,2,2,296440,296441,296443,1,3,0
84592,5,2,296445,296445,296447,0,2,2
84593,3,3,296448,296448,296451,0,3,1
84594,3,2,296451,296451,296453,0,2,0
84595,4,2,296455,296455,296457,0,2,2
84596,4,3,296459,296459,296462,0,3,2
84597,4,1,296463,296463,296464,0,1,1
84598,1,2,296464,296464,296466,0,2,0
84599,5,3,296469,296469,296472,0,3,3
84600,2,1,296471,296472,296473,1,2,0
84601,5,3,296476,296476,296479,0,3,3
84602,3,1,296479,296479,296480,0,1,0
84603,1,2,296480,296480,296482,0,2,0
84604,1,3,296481,296482,296485,1,4,0
84605,6,3,296487,296487,296490,0,3,2
84606,6,3,296493,296493,296496,0,3,3
84607,4,2,296497,296497,296499,0,2,1
84608,2,1,296499,296499,296500,0,1,0
84609,1,1,296500,296500,296501,0,1,0
84610,3,1,296503,296503,296504,0,1,2
84611,4,3,296507,296507,296510,0,3,3
84612,1,2,296508,296510,296512,2,4,0
84613,2,3,296510,296512,296515,2,5,0
84614,3,3,296513,296515,296518,2,5,0
84615,6,1,296519,296519,296520,0,1,1
84616,6,3,296525,296525,296528,0,3,5
84617,3,2,296528,296528,296530,0,2,0
84618,4,1,296532,296532,296533,0,1,2
84619,2,1,296534,296534,296535,0,1,1
84620,3,1,296537,296537,296538,0,1,2
84621,5,2,296542,296542,296544,0,2,4
84622,2,3,296544,296544,296547,0,3,0
84623,1,3,296545,296547,296550,2,5,0
84624,6,2,296551,296551,296553,0,2,1
84625,6,1,296557,296557,296558,0,1,4
84626,3,1,296560,296560,296561,0,1,2
84627,5,1,296565,296565,296566,0,1,4
84628,2,3,296567,296567,296570,0,3,1
84629,3,3,296570,296570,296573,0,3,0
84630,1,1,296571,296573,296574,2,3,0
84631,1,2,296572,296574,296576,2,4,0
84632,1,3,296573,296576,296579,3,6,0
84633,2,2,296575,296579,296581,4,6,0
84634,6,1,296581,296581,296582,0,1,0
84635,4,1,296585,296585,296586,0,1,3
84636,4,3,296589,296589,296592,0,3,3
84637,2,1,296591,296592,296593,1,2,0
84638,6,3,296597,296597,296600,0,3,4
84639,6,3,296603,296603,296606,0,3,3
84640,3,2,296606,296606,296608,0,2,0
84641,1,3,296607,296608,296611,1,4,0
84642,5,1,296612,296612,296613,0,1,1
84643,5,1,296617,296617,296618,0,1,4
84644,3,2,296620,296620,296622,0,2,2
84645,6,1,296626,296626,296627,0,1,4
84646,6,3,296632,296632,296635,0,3,5
84647,4,3,296636,296636,296639,0,3,1
84648,6,3,296642,296642,296645,0,3,3
84649,5,2,296647,296647,296649,0,2,2
84650,1,1,296648,296649,296650,1,2,0
84651,4,1,296652,296652,296653,0,1,2
84652,4,2,296656,296656,296658,0,2,3
84653,6,2,296662,296662,296664,0,2,4
84654,6,1,296668,296668,296669,0,1,4
84655,2,2,296670,296670,296672,0,2,1
84656,1,1,296671,296672,296673,1,2,0
84657,1,3,296672,296673,296676,1,4,0
84658,1,1,296673,296676,296677,3,4,0
84659,6,2,296679,296679,296681,0,2,2
84660,4,2,296683,296683,296685,0,2,2
84661,6,2,296689,296689,296691,0,2,4
84662,6,2,296695,296695,296697,0,2,4
84663,4,1,296699,296699,296700,0,1,2
84664,2,2,296701,296701,296703,0,2,1
84665,6,1,296707,296707,296708,0,1,4
84666,1,2,296708,296708,296710,0,2,0
84667,2,2,296710,296710,296712,0,2,0
84668,2,1,296712,296712,296713,0,1,0
84669,4,2,296716,296716,296718,0,2,3
84670,6,2,296722,296722,296724,0,2,4
84671,6,3,296728,296728,296731,0,3,4
84672,3,3,296731,296731,296734,0,3,0
84673,1,3,296732,296734,296737,2,5,0
84674,2,2,296734,296737,296739,3,5,0
84675,3,2,296737,296739,296741,2,4,0
84676,1,2,296738,296741,296743,3,5,0
84677,6,3,296744,296744,296747,0,3,1
84678,6,1,296750,296750,296751,0,1,3
84679,4,1,296754,296754,296755,0,1,3
84680,6,2,296760,296760,296762,0,2,5
84681,2,1,296762,296762,296763,0,1,0
84682,6,2,296768,296768,296770,0,2,5
84683,3,1,296771,296771,296772,0,1,1
84684,5,3,296776,296776,296779,0,3,4
84685,4,3,296780,296780,296783,0,3,1
84686,5,3,296785,296785,296788,0,3,2
84687,6,3,296791,296791,296794,0,3,3
84688,4,3,296795,296795,296798,0,3,1
84689,3,1,296798,296798,296799,0,1,0
84690,3,3,296801,296801,296804,0,3,2
84691,4,3,296805,296805,296808,0,3,1
84692,5,3,296810,296810,296813,0,3,2
84693,4,3,296814,296814,296817,0,3,1
84694,3,1,296817,296817,296818,0,1,0
84695,5,3,296822,296822,296825,0,3,4
84696,3,2,296825,296825,296827,0,2,0
84697,3,2,296828,296828,296830,0,2,1
84698,3,2,296831,296831,296833,0,2,1
84699,2,1,296833,296833,296834,0,1,0
84700,2,1,296835,296835,296836,0,1,1
84701,1,3,296836,296836,296839,0,3,0
84702,3,1,296839,296839,296840,0,1,0
84703,3,3,296842,296842,296845,0,3,2
84704,2,3,296844,296845,296848,1,4,0
84705,5,3,296849,296849,296852,0,3,1
84706,1,1,296850,296852,296853,2,3,0
84707,6,1,296856,296856,296857,0,1,3
84708,2,3,296858,296858,296861,0,3,1
84709,4,1,296862,296862,296863,0,1,1
84710,2,1,296864,296864,296865,0,1,1
84711,5,3,296869,296869,296872,0,3,4
84712,2,2,296871,296872,296874,1,3,0
84713,2,2,296873,296874,296876,1,3,0
84714,2,3,296875,296876,296879,1,4,0
84715,3,3,296878,296879,296882,1,4,0
84716,5,1,296883,296883,296884,0,1,1
84717,6,2,296889,296889,296891,0,2,5
84718,2,2,296891,296891,296893,0,2,0
84719,3,2,296894,296894,296896,0,2,1
84720,1,3,296895,296896,296899,1,4,0
84721,5,2,296900,296900,296902,0,2,1
84722,1,3,296901,296902,296905,1,4,0
84723,5,3,296906,296906,296909,0,3,1
84724,1,1,296907,296909,296910,2,3,0
84725,4,2,296911,296911,296913,0,2,1
84726,6,1,296917,296917,296918,0,1,4
84727,1,2,296918,296918,296920,0,2,0
84728,6,1,296924,296924,296925,0,1,4
84729,2,1,296926,296926,296927,0,1,1
84730,4,3,296930,296930,296933,0,3,3
84731,2,3,296932,296933,296936,1,4,0
84732,4,1,296936,296936,296937,0,1,0
84733,2,1,296938,296938,296939,0,1,1
84734,1,1,296939,296939,296940,0,1,0
84735,1,3,296940,296940,296943,0,3,0
84736,6,1,296946,296946,296947,0,1,3
84737,5,1,296951,296951,296952,0,1,4
84738,1,2,296952,296952,296954,0,2,0
84739,5,3,296957,296957,296960,0,3,3
84740,1,1,296958,296960,296961,2,3,0
84741,5,1,296963,296963,296964,0,1,2
84742,4,1,296967,296967,296968,0,1,3
84743,6,1,296973,296973,296974,0,1,5
84744,2,3,296975,296975,296978,0,3,1
84745,5,3,296980,296980,296983,0,3,2
84746,3,2,296983,296983,296985,0,2,0
84747,5,1,296988,296988,296989,0,1,3
84748,4,1,296992,296992,296993,0,1,3
84749,4,1,296996,296996,296997,0,1,3
84750,2,3,296998,296998,297001,0,3,1
84751,4,2,297002,297002,297004,0,2,1
84752,4,3,297006,297006,297009,0,3,2
84753,3,2,297009,297009,297011,0,2,0
84754,2,3,297011,297011,297014,0,3,0
84755,3,3,297014,297014,297017,0,3,0
84756,3,3,297017,297017,297020,0,3,0
84757,6,2,297023,297023,297025,0,2,3
84758,1,2,297024,297025,297027,1,3,0
84759,6,2,297030,297030,297032,0,2,3
84760,3,2,297033,297033,297035,0,2,1
84761,6,1,297039,297039,297040,0,1,4
84762,1,2,297040,297040,297042,0,2,0
84763,4,1,297044,297044,297045,0,1,2
84764,2,1,297046,297046,297047,0,1,1
84765,6,1,297052,297052,297053,0,1,5
84766,5,1,297057,297057,297058,0,1,4
84767,6,2,297063,297063,297065,0,2,5
84768,2,2,297065,297065,297067,0,2,0
84769,4,3,297069,297069,297072,0,3,2
84770,3,2,297072,297072,297074,0,2,0
84771,5,3,297077,297077,297080,0,3,3
84772,1,3,297078,297080,297083,2,5,0
84773,4,3,297082,297083,297086,1,4,0
84774,2,3,297084,297086,297089,2,5,0
84775,6,2,297090,297090,297092,0,2,1
84776,6,2,297096,297096,297098,0,2,4
84777,3,2,297099,297099,297101,0,2,1
84778,5,2,297104,297104,297106,0,2,3
84779,3,2,297107,297107,297109,0,2,1
84780,4,3,297111,297111,297114,0,3,2
84781,6,2,297117,297117,297119,0,2,3
84782,1,2,297118,297119,297121,1,3,0
84783,2,2,297120,297121,297123,1,3,0
84784,5,1,297125,297125,297126,0,1,2
84785,2,1,297127,297127,297128,0,1,1
84786,5,3,297132,297132,297135,0,3,4
84787,4,1,297136,297136,297137,0,1,1
84788,6,2,297142,297142,297144,0,2,5
84789,3,1,297145,297145,297146,0,1,1
84790,4,2,297149,297149,297151,0,2,3
84791,5,1,297154,297154,297155,0,1,3
84792,1,1,297155,297155,297156,0,1,0
84793,2,1,297157,297157,297158,0,1,1
84794,4,2,297161,297161,297163,0,2,3
84795,6,2,297167,297167,297169,0,2,4
84796,2,1,297169,297169,297170,0,1,0
84797,3,2,297172,297172,297174,0,2,2
84798,3,1,297175,297175,297176,0,1,1
84799,1,1,297176,297176,297177,0,1,0
84800,6,2,297182,297182,297184,0,2,5
84801,5,2,297187,297187,297189,0,2,3
84802,2,3,297189,297189,297192,0,3,0
84803,2,2,297191,297192,297194,1,3,0
84804,5,3,297196,297196,297199,0,3,2
84805,3,3,297199,297199,297202,0,3,0
84806,2,3,297201,297202,297205,1,4,0
84807,6,2,297207,297207,297209,0,2,2
84808,4,3,297211,297211,297214,0,3,2
84809,6,1,297217,297217,297218,0,1,3
84810,3,2,297220,297220,297222,0,2,2
84811,3,3,297223,297223,297226,0,3,1
84812,1,2,297224,297226,297228,2,4,0
84813,5,1,297229,297229,297230,0,1,1
84814,6,1,297235,297235,297236,0,1,5
84815,1,2,297236,297236,297238,0,2,0
84816,3,1,297239,297239,297240,0,1,1
84817,1,2,297240,297240,297242,0,2,0
84818,5,2,297245,297245,297247,0,2,3
84819,1,1,297246,297247,297248,1,2,0
84820,4,2,297250,297250,297252,0,2,2
84821,4,2,297254,297254,297256,0,2,2
84822,2,2,297256,297256,297258,0,2,0
84823,3,2,297259,297259,297261,0,2,1
84824,1,1,297260,297261,297262,1,2,0
84825,3,1,297263,297263,297264,0,1,1
84826,4,1,297267,297267,297268,0,1,3
84827,5,1,297272,297272,297273,0,1,4
84828,4,3,297276,297276,297279,0,3,3
84829,2,2,297278,297279,297281,1,3,0
84830,2,3,297280,297281,297284,1,4,0
84831,3,1,297283,297284,297285,1,2,0
84832,2,2,297285,297285,297287,0,2,0
84833,3,3,297288,297288,297291,0,3,1
84834,5,3,297293,297293,297296,0,3,2
84835,2,2,297295,297296,297298,1,3,0
84836,6,2,297301,297301,297303,0,2,3
84837,6,2,297307,297307,297309,0,2,4
84838,3,3,297310,297310,297313,0,3,1
84839,4,3,297314,297314,297317,0,3,1
84840,2,2,297316,297317,297319,1,3,0
84841,5,2,297321,297321,297323,0,2,2
84842,3,3,297324,297324,297327,0,3,1
84843,2,3,297326,297327,297330,1,4,0
84844,2,3,297328,297330,297333,2,5,0
84845,2,2,297330,297333,297335,3,5,0
84846,4,2,297334,297335,297337,1,3,0
84847,5,1,297339,297339,297340,0,1,2
84848,4,1,297343,297343,297344,0,1,3
84849,2,2,297345,297345,297347,0,2,1
84850,1,1,297346,297347,297348,1,2,0
84851,2,1,297348,297348,297349,0,1,0
84852,6,2,297354,297354,297356,0,2,5
84853,5,1,297359,297359,297360,0,1,3
84854,1,2,297360,297360,297362,0,2,0
84855,5,3,297365,297365,297368,0,3,3
84856,3,2,297368,297368,297370,0,2,0
84857,1,2,297369,297370,297372,1,3,0
84858,1,2,297370,297372,297374,2,4,0
84859,1,2,297371,297374,297376,3,5,0
84860,3,3,297374,297376,297379,2,5,0
84861,2,1,297376,297379,297380,3,4,0
84862,3,1,297379,297380,297381,1,2,0
84863,2,1,297381,297381,297382,0,1,0
84864,4,2,297385,297385,297387,0,2,3
84865,3,1,297388,297388,297389,0,1,1
84866,3,1,297391,297391,297392,0,1,2
84867,1,2,297392,297392,297394,0,2,0
84868,1,1,297393,297394,297395,1,2,0
84869,2,2,297395,297395,297397,0,2,0
84870,1,2,297396,297397,297399,1,3,0
84871,3,3,297399,297399,297402,0,3,0
84872,2,2,297401,297402,297404,1,3,0
84873,4,1,297405,297405,297406,0,1,1
84874,6,1,297411,297411,297412,0,1,5
84875,2,3,297413,297413,297416,0,3,1
84876,4,2,297417,297417,297419,0,2,1
84877,3,3,297420,297420,297423,0,3,1
84878,1,1,297421,297423,297424,2,3,0
84879,3,2,297424,297424,297426,0,2,0
84880,5,1,297429,297429,297430,0,1,3
84881,2,1,297431,297431,297432,0,1,1
84882,4,1,297435,297435,297436,0,1,3
84883,3,2,297438,297438,297440,0,2,2
84884,3,3,297441,297441,297444,0,3,1
84885,2,2,297443,297444,297446,1,3,0
84886,5,3,297448,297448,297451,0,3,2
84887,6,1,297454,297454,297455,0,1,3
84888,1,1,297455,297455,297456,0,1,0
84889,4,2,297459,297459,297461,0,2,3
84890,6,2,297465,297465,297467,0,2,4
84891,4,1,297469,297469,297470,0,1,2
84892,5,3,297474,297474,297477,0,3,4
84893,5,2,297479,297479,297481,0,2,2
84894,3,1,297482,297482,297483,0,1,1
84895,1,1,297483,297483,297484,0,1,0
84896,5,2,297488,297488,297490,0,2,4
84897,1,2,297489,297490,297492,1,3,0
84898,3,3,297492,297492,297495,0,3,0
84899,3,2,297495,297495,297497,0,2,0
84900,3,2,297498,297498,297500,0,2,1
84901,5,1,297503,297503,297504,0,1,3
84902,4,1,297507,297507,297508,0,1,3
84903,3,3,297510,297510,297513,0,3,2
84904,2,1,297512,297513,297514,1,2,0
84905,4,3,297516,297516,297519,0,3,2
84906,6,3,297522,297522,297525,0,3,3
84907,4,2,297526,297526,297528,0,2,1
84908,6,3,297532,297532,297535,0,3,4
84909,6,1,297538,297538,297539,0,1,3
84910,2,2,297540,297540,297542,0,2,1
84911,5,3,297545,297545,297548,0,3,3
84912,4,2,297549,297549,297551,0,2,1
84913,1,3,297550,297551,297554,1,4,0
84914,6,3,297556,297556,297559,0,3,2
84915,3,2,297559,297559,297561,0,2,0
84916,4,3,297563,297563,297566,0,3,2
84917,3,3,297566,297566,297569,0,3,0
84918,5,3,297571,297571,297574,0,3,2
84919,3,3,297574,297574,297577,0,3,0
84920,1,2,297575,297577,297579,2,4,0
84921,2,1,297577,297579,297580,2,3,0
84922,6,3,297583,297583,297586,0,3,3
84923,5,2,297588,297588,297590,0,2,2
84924,2,3,297590,297590,297593,0,3,0
84925,5,2,297595,297595,297597,0,2,2
84926,3,2,297598,297598,297600,0,2,1
84927,6,3,297604,297604,297607,0,3,4
84928,3,2,297607,297607,297609,0,2,0
84929,3,2,297610,297610,297612,0,2,1
84930,6,3,297616,297616,297619,0,3,4
84931,1,1,297617,297619,297620,2,3,0
84932,6,2,297623,297623,297625,0,2,3
84933,1,2,297624,297625,297627,1,3,0
84934,3,3,297627,297627,297630,0,3,0
84935,2,3,297629,297630,297633,1,4,0
84936,4,2,297633,297633,297635,0,2,0
84937,5,3,297638,297638,297641,0,3,3
84938,4,1,297642,297642,297643,0,1,1
84939,3,1,297645,297645,297646,0,1,2
84940,5,2,297650,297650,297652,0,2,4
84941,1,3,297651,297652,297655,1,4,0
84942,1,3,297652,297655,297658,3,6,0
84943,6,3,297658,297658,297661,0,3,0
84944,4,3,297662,297662,297665,0,3,1
84945,1,3,297663,297665,297668,2,5,0
84946,4,1,297667,297668,297669,1,2,0
84947,1,2,297668,297669,297671,1,3,0
84948,4,3,297672,297672,297675,0,3,1
84949,1,3,297673,297675,297678,2,5,0
84950,4,3,297677,297678,297681,1,4,0
84951,3,2,297680,297681,297683,1,3,0
84952,5,1,297685,297685,297686,0,1,2
84953,2,1,297687,297687,297688,0,1,1
84954,1,1,297688,297688,297689,0,1,0
84955,6,1,297694,297694,297695,0,1,5
84956,4,3,297698,297698,297701,0,3,3
84957,6,3,297704,297704,297707,0,3,3
84958,4,2,297708,297708,297710,0,2,1
84959,3,1,297711,297711,297712,0,1,1
84960,3,1,297714,297714,297715,0,1,2
84961,2,1,297716,297716,297717,0,1,1
84962,6,2,297722,297722,297724,0,2,5
84963,2,3,297724,297724,297727,0,3,0
84964,3,2,297727,297727,297729,0,2,0
84965,2,1,297729,297729,297730,0,1,0
84966,1,1,297730,297730,297731,0,1,0
84967,3,2,297733,297733,297735,0,2,2
84968,2,2,297735,297735,297737,0,2,0
84969,1,2,297736,297737,297739,1,3,0
84970,5,3,297741,297741,297744,0,3,2
84971,3,3,297744,297744,297747,0,3,0
84972,1,2,297745,297747,297749,2,4,0
84973,6,2,297751,297751,297753,0,2,2
84974,2,2,297753,297753,297755,0,2,0
84975,4,3,297757,297757,297760,0,3,2
84976,1,3,297758,297760,297763,2,5,0
84977,3,3,297761,297763,297766,2,5,0
84978,4,3,297765,297766,297769,1,4,0
84979,2,1,297767,297769,297770,2,3,0
84980,3,3,297770,297770,297773,0,3,0
84981,6,2,297776,297776,297778,0,2,3
84982,1,3,297777,297778,297781,1,4,0
84983,3,1,297780,297781,297782,1,2,0
84984,3,1,297783,297783,297784,0,1,1
84985,2,2,297785,297785,297787,0,2,1
84986,1,3,297786,297787,297790,1,4,0
84987,4,1,297790,297790,297791,0,1,0
84988,4,3,297794,297794,297797,0,3,3
84989,2,1,297796,297797,297798,1,2,0
84990,2,3,297798,297798,297801,0,3,0
84991,3,3,297801,297801,297804,0,3,0
84992,3,2,297804,297804,297806,0,2,0
84993,4,1,297808,297808,297809,0,1,2
84994,4,1,297812,297812,297813,0,1,3
84995,1,2,297813,297813,297815,0,2,0
84996,2,1,297815,297815,297816,0,1,0
84997,5,3,297820,297820,297823,0,3,4
84998,5,3,297825,297825,297828,0,3,2
84999,6,3,297831,297831,297834,0,3,3
85000,3,2,297834,297834,297836,0,2,0
85001,1,1,297835,297836,297837,1,2,0
85002,6,3,297841,297841,297844,0,3,4
85003,4,1,297845,297845,297846,0,1,1
85004,4,3,297849,297849,297852,0,3,3
85005,4,3,297853,297853,297856,0,3,1
85006,1,1,297854,297856,297857,2,3,0
85007,3,1,297857,297857,297858,0,1,0
85008,3,2,297860,297860,297862,0,2,2
85009,3,1,297863,297863,297864,0,1,1
85010,1,3,297864,297864,297867,0,3,0
85011,5,2,297869,297869,297871,0,2,2
85012,6,3,297875,297875,297878,0,3,4
85013,3,1,297878,297878,297879,0,1,0
85014,3,1,297881,297881,297882,0,1,2
85015,4,1,297885,297885,297886,0,1,3
85016,3,3,297888,297888,297891,0,3,2
85017,5,2,297893,297893,297895,0,2,2
85018,5,2,297898,297898,297900,0,2,3
85019,2,1,297900,297900,297901,0,1,0
85020,1,3,297901,297901,297904,0,3,0
85021,2,2,297903,297904,297906,1,3,0
85022,5,3,297908,297908,297911,0,3,2
85023,5,1,297913,297913,297914,0,1,2
85024,6,3,297919,297919,297922,0,3,5
85025,3,3,297922,297922,297925,0,3,0
85026,1,1,297923,297925,297926,2,3,0
85027,3,2,297926,297926,297928,0,2,0
85028,6,1,297932,297932,297933,0,1,4
85029,1,1,297933,297933,297934,0,1,0
85030,5,1,297938,297938,297939,0,1,4
85031,1,2,297939,297939,297941,0,2,0
85032,4,1,297943,297943,297944,0,1,2
85033,6,3,297949,297949,297952,0,3,5
85034,1,1,297950,297952,297953,2,3,0
85035,3,2,297953,297953,297955,0,2,0
85036,1,3,297954,297955,297958,1,4,0
85037,2,2,297956,297958,297960,2,4,0
85038,6,1,297962,297962,297963,0,1,2
85039,6,1,297968,297968,297969,0,1,5
85040,1,2,297969,297969,297971,0,2,0
85041,1,1,297970,297971,297972,1,2,0
85042,4,2,297974,297974,297976,0,2,2
85043,3,2,297977,297977,297979,0,2,1
85044,1,3,297978,297979,297982,1,4,0
85045,5,3,297983,297983,297986,0,3,1
85046,2,1,297985,297986,297987,1,2,0
85047,6,2,297991,297991,297993,0,2,4
85048,1,1,297992,297993,297994,1,2,0
85049,2,3,297994,297994,297997,0,3,0
85050,4,1,297998,297998,297999,0,1,1
85051,5,3,298003,298003,298006,0,3,4
85052,1,2,298004,298006,298008,2,4,0
85053,5,1,298009,298009,298010,0,1,1
85054,3,3,298012,298012,298015,0,3,2
85055,6,3,298018,298018,298021,0,3,3
85056,5,1,298023,298023,298024,0,1,2
85057,4,1,298027,298027,298028,0,1,3
85058,6,2,298033,298033,298035,0,2,5
85059,6,2,298039,298039,298041,0,2,4
85060,4,3,298043,298043,298046,0,3,2
85061,3,1,298046,298046,298047,0,1,0
85062,1,3,298047,298047,298050,0,3,0
85063,3,2,298050,298050,298052,0,2,0
85064,4,3,298054,298054,298057,0,3,2
85065,4,2,298058,298058,298060,0,2,1
85066,5,3,298063,298063,298066,0,3,3
85067,4,3,298067,298067,298070,0,3,1
85068,4,2,298071,298071,298073,0,2,1
85069,1,3,298072,298073,298076,1,4,0
85070,5,2,298077,298077,298079,0,2,1
85071,4,1,298081,298081,298082,0,1,2
85072,3,3,298084,298084,298087,0,3,2
85073,2,2,298086,298087,298089,1,3,0
85074,4,3,298090,298090,298093,0,3,1
85075,1,3,298091,298093,298096,2,5,0
85076,6,2,298097,298097,298099,0,2,1
85077,1,3,298098,298099,298102,1,4,0
85078,4,2,298102,298102,298104,0,2,0
85079,2,1,298104,298104,298105,0,1,0
85080,4,3,298108,298108,298111,0,3,3
85081,5,2,298113,298113,298115,0,2,2
85082,5,1,298118,298118,298119,0,1,3
85083,3,2,298121,298121,298123,0,2,2
85084,2,1,298123,298123,298124,0,1,0
85085,1,1,298124,298124,298125,0,1,0
85086,3,1,298127,298127,298128,0,1,2
85087,1,3,298128,298128,298131,0,3,0
85088,5,3,298133,298133,298136,0,3,2
85089,4,3,298137,298137,298140,0,3,1
85090,3,3,298140,298140,298143,0,3,0
85091,4,3,298144,298144,298147,0,3,1
85092,2,3,298146,298147,298150,1,4,0
85093,4,2,298150,298150,298152,0,2,0
85094,4,3,298154,298154,298157,0,3,2
85095,6,3,298160,298160,298163,0,3,3
85096,5,2,298165,298165,298167,0,2,2
85097,6,2,298171,298171,298173,0,2,4
85098,6,1,298177,298177,298178,0,1,4
85099,2,2,298179,298179,298181,0,2,1
85100,6,1,298185,298185,298186,0,1,4
85101,6,2,298191,298191,298193,0,2,5
85102,4,1,298195,298195,298196,0,1,2
85103,5,3,298200,298200,298203,0,3,4
85104,1,3,298201,298203,298206,2,5,0
85105,2,3,298203,298206,298209,3,6,0
85106,5,1,298208,298209,298210,1,2,0
85107,6,1,298214,298214,298215,0,1,4
85108,5,3,298219,298219,298222,0,3,4
85109,2,3,298221,298222,298225,1,4,0
85110,1,2,298222,298225,298227,3,5,0
85111,2,1,298224,298227,298228,3,4,0
85112,1,1,298225,298228,298229,3,4,0
85113,2,2,298227,298229,298231,2,4,0
85114,1,1,298228,298231,298232,3,4,0
85115,3,3,298231,298232,298235,1,4,0
85116,1,3,298232,298235,298238,3,6,0
85117,4,1,298236,298238,298239,2,3,0
85118,6,1,298242,298242,298243,0,1,3
85119,5,2,298247,298247,298249,0,2,4
85120,6,1,298253,298253,298254,0,1,4
85121,2,1,298255,298255,298256,0,1,1
85122,2,2,298257,298257,298259,0,2,1
85123,6,3,298263,298263,298266,0,3,4
85124,3,3,298266,298266,298269,0,3,0
85125,4,1,298270,298270,298271,0,1,1
85126,4,1,298274,298274,298275,0,1,3
85127,3,2,298277,298277,298279,0,2,2
85128,5,3,298282,298282,298285,0,3,3
85129,3,3,298285,298285,298288,0,3,0
85130,5,2,298290,298290,298292,0,2,2
85131,4,3,298294,298294,298297,0,3,2
85132,4,1,298298,298298,298299,0,1,1
85133,4,3,298302,298302,298305,0,3,3
85134,2,2,298304,298305,298307,1,3,0
85135,1,1,298305,298307,298308,2,3,0
85136,5,3,298310,298310,298313,0,3,2
85137,2,2,298312,298313,298315,1,3,0
85138,1,2,298313,298315,298317,2,4,0
85139,2,1,298315,298317,298318,2,3,0
85140,3,1,298318,298318,298319,0,1,0
85141,4,2,298322,298322,298324,0,2,3
85142,4,3,298326,298326,298329,0,3,2
85143,4,1,298330,298330,298331,0,1,1
85144,4,2,298334,298334,298336,0,2,3
85145,1,1,298335,298336,298337,1,2,0
85146,2,1,298337,298337,298338,0,1,0
85147,6,1,298343,298343,298344,0,1,5
85148,6,1,298349,298349,298350,0,1,5
85149,3,1,298352,298352,298353,0,1,2
85150,4,3,298356,298356,298359,0,3,3
85151,1,3,298357,298359,298362,2,5,0
85152,6,1,298363,298363,298364,0,1,1
85153,2,3,298365,298365,298368,0,3,1
85154,5,1,298370,298370,298371,0,1,2
85155,3,3,298373,298373,298376,0,3,2
85156,4,1,298377,298377,298378,0,1,1
85157,3,2,298380,298380,298382,0,2,2
85158,3,2,298383,298383,298385,0,2,1
85159,6,3,298389,298389,298392,0,3,4
85160,1,1,298390,298392,298393,2,3,0
85161,2,2,298392,298393,298395,1,3,0
85162,1,2,298393,298395,298397,2,4,0
85163,1,2,298394,298397,298399,3,5,0
85164,3,1,298397,298399,298400,2,3,0
85165,6,1,298403,298403,298404,0,1,3
85166,4,1,298407,298407,298408,0,1,3
85167,3,1,298410,298410,298411,0,1,2
85168,6,3,298416,298416,298419,0,3,5
85169,5,1,298421,298421,298422,0,1,2
85170,4,2,298425,298425,298427,0,2,3
85171,6,3,298431,298431,298434,0,3,4
85172,2,1,298433,298434,298435,1,2,0
85173,4,2,298437,298437,298439,0,2,2
85174,3,2,298440,298440,298442,0,2,1
85175,6,2,298446,298446,298448,0,2,4
85176,1,1,298447,298448,298449,1,2,0
85177,2,2,298449,298449,298451,0,2,0
85178,1,2,298450,298451,298453,1,3,0
85179,1,3,298451,298453,298456,2,5,0
85180,5,1,298456,298456,298457,0,1,0
85181,4,1,298460,298460,298461,0,1,3
85182,4,2,298464,298464,298466,0,2,3
85183,3,2,298467,298467,298469,0,2,1
85184,5,1,298472,298472,298473,0,1,3
85185,1,3,298473,298473,298476,0,3,0
85186,4,1,298477,298477,298478,0,1,1
85187,1,3,298478,298478,298481,0,3,0
85188,3,1,298481,298481,298482,0,1,0
85189,5,1,298486,298486,298487,0,1,4
85190,1,3,298487,298487,298490,0,3,0
85191,2,1,298489,298490,298491,1,2,0
85192,3,2,298492,298492,298494,0,2,1
85193,4,3,298496,298496,298499,0,3,2
85194,2,2,298498,298499,298501,1,3,0
85195,3,2,298501,298501,298503,0,2,0
85196,6,2,298507,298507,298509,0,2,4
85197,6,3,298513,298513,298516,0,3,4
85198,2,1,298515,298516,298517,1,2,0
85199,5,2,298520,298520,298522,0,2,3
85200,6,3,298526,298526,298529,0,3,4
85201,5,2,298531,298531,298533,0,2,2
85202,3,2,298534,298534,298536,0,2,1
85203,3,1,298537,298537,298538,0,1,1
85204,6,2,298543,298543,298545,0,2,5
85205,4,2,298547,298547,298549,0,2,2
85206,6,2,298553,298553,298555,0,2,4
85207,3,1,298556,298556,298557,0,1,1
85208,2,1,298558,298558,298559,0,1,1
85209,6,2,298564,298564,298566,0,2,5
85210,3,2,298567,298567,298569,0,2,1
85211,1,2,298568,298569,298571,1,3,0
85212,2,2,298570,298571,298573,1,3,0
85213,5,1,298575,298575,298576,0,1,2
85214,5,1,298580,298580,298581,0,1,4
85215,6,1,298586,298586,298587,0,1,5
85216,2,2,298588,298588,298590,0,2,1
85217,2,2,298590,298590,298592,0,2,0
85218,3,1,298593,298593,298594,0,1,1
85219,4,1,298597,298597,298598,0,1,3
85220,3,3,298600,298600,298603,0,3,2
85221,5,2,298605,298605,298607,0,2,2
85222,4,3,298609,298609,298612,0,3,2
85223,1,1,298610,298612,298613,2,3,0
85224,5,1,298615,298615,298616,0,1,2
85225,5,1,298620,298620,298621,0,1,4
85226,5,2,298625,298625,298627,0,2,4
85227,4,2,298629,298629,298631,0,2,2
85228,5,2,298634,298634,298636,0,2,3
85229,3,1,298637,298637,298638,0,1,1
85230,3,2,298640,298640,298642,0,2,2
85231,3,3,298643,298643,298646,0,3,1
85232,1,3,298644,298646,298649,2,5,0
85233,3,1,298647,298649,298650,2,3,0
85234,4,2,298651,298651,298653,0,2,1
85235,4,3,298655,298655,298658,0,3,2
85236,5,2,298660,298660,298662,0,2,2
85237,6,2,298666,298666,298668,0,2,4
85238,3,1,298669,298669,298670,0,1,1
85239,5,1,298674,298674,298675,0,1,4
85240,4,2,298678,298678,298680,0,2,3
85241,6,2,298684,298684,298686,0,2,4
85242,2,1,298686,298686,298687,0,1,0
85243,3,2,298689,298689,298691,0,2,2
85244,5,1,298694,298694,298695,0,1,3
85245,4,1,298698,298698,298699,0,1,3
85246,1,3,298699,298699,298702,0,3,0
85247,3,1,298702,298702,298703,0,1,0
85248,6,1,298708,298708,298709,0,1,5
85249,5,3,298713,298713,298716,0,3,4
85250,4,3,298717,298717,298720,0,3,1
85251,3,2,298720,298720,298722,0,2,0
85252,6,3,298726,298726,298729,0,3,4
85253,2,2,298728,298729,298731,1,3,0
85254,6,2,298734,298734,298736,0,2,3
85255,2,1,298736,298736,298737,0,1,0
85256,6,1,298742,298742,298743,0,1,5
85257,6,2,298748,298748,298750,0,2,5
85258,3,2,298751,298751,298753,0,2,1
85259,3,1,298754,298754,298755,0,1,1
85260,4,2,298758,298758,298760,0,2,3
85261,2,2,298760,298760,298762,0,2,0
85262,3,1,298763,298763,298764,0,1,1
85263,6,3,298769,298769,298772,0,3,5
85264,4,2,298773,298773,298775,0,2,1
85265,5,1,298778,298778,298779,0,1,3
85266,3,3,298781,298781,298784,0,3,2
85267,2,3,298783,298784,298787,1,4,0
85268,2,2,298785,298787,298789,2,4,0
85269,3,3,298788,298789,298792,1,4,0
85270,4,3,298792,298792,298795,0,3,0
85271,1,3,298793,298795,298798,2,5,0
85272,3,2,298796,298798,298800,2,4,0
85273,1,3,298797,298800,298803,3,6,0
85274,2,1,298799,298803,298804,4,5,0
85275,1,1,298800,298804,298805,4,5,0
85276,5,1,298805,298805,298806,0,1,0
85277,4,2,298809,298809,298811,0,2,3
85278,4,2,298813,298813,298815,0,2,2
85279,6,2,298819,298819,298821,0,2,4
85280,2,1,298821,298821,298822,0,1,0
85281,3,1,298824,298824,298825,0,1,2
85282,6,2,298830,298830,298832,0,2,5
85283,5,2,298835,298835,298837,0,2,3
85284,4,3,298839,298839,298842,0,3,2
85285,6,3,298845,298845,298848,0,3,3
85286,4,2,298849,298849,298851,0,2,1
85287,6,3,298855,298855,298858,0,3,4
85288,1,1,298856,298858,298859,2,3,0
85289,1,2,298857,298859,298861,2,4,0
85290,4,2,298861,298861,298863,0,2,0
85291,5,3,298866,298866,298869,0,3,3
85292,2,2,298868,298869,298871,1,3,0
85293,1,1,298869,298871,298872,2,3,0
85294,6,1,298875,298875,298876,0,1,3
85295,5,1,298880,298880,298881,0,1,4
85296,6,3,298886,298886,298889,0,3,5
85297,3,1,298889,298889,298890,0,1,0
85298,2,3,298891,298891,298894,0,3,1
85299,5,1,298896,298896,298897,0,1,2
85300,2,3,298898,298898,298901,0,3,1
85301,3,1,298901,298901,298902,0,1,0
85302,2,1,298903,298903,298904,0,1,1
85303,6,1,298909,298909,298910,0,1,5
85304,3,1,298912,298912,298913,0,1,2
85305,5,1,298917,298917,298918,0,1,4
85306,6,1,298923,298923,298924,0,1,5
85307,1,2,298924,298924,298926,0,2,0
85308,2,1,298926,298926,298927,0,1,0
85309,1,1,298927,298927,298928,0,1,0
85310,4,2,298931,298931,298933,0,2,3
85311,1,3,298932,298933,298936,1,4,0
85312,3,1,298935,298936,298937,1,2,0
85313,5,1,298940,298940,298941,0,1,3
85314,2,2,298942,298942,298944,0,2,1
85315,1,2,298943,298944,298946,1,3,0
85316,3,3,298946,298946,298949,0,3,0
85317,2,3,298948,298949,298952,1,4,0
85318,3,1,298951,298952,298953,1,2,0
85319,4,3,298955,298955,298958,0,3,2
85320,4,1,298959,298959,298960,0,1,1
85321,1,1,298960,298960,298961,0,1,0
85322,2,1,298962,298962,298963,0,1,1
85323,5,3,298967,298967,298970,0,3,4
85324,6,3,298973,298973,298976,0,3,3
85325,5,1,298978,298978,298979,0,1,2
85326,5,3,298983,298983,298986,0,3,4
85327,1,2,298984,298986,298988,2,4,0
85328,4,3,298988,298988,298991,0,3,0
85329,4,1,298992,298992,298993,0,1,1
85330,6,2,298998,298998,299000,0,2,5
85331,4,2,299002,299002,299004,0,2,2
85332,1,2,299003,299004,299006,1,3,0
85333,2,3,299005,299006,299009,1,4,0
85334,3,2,299008,299009,299011,1,3,0
85335,3,1,299011,299011,299012,0,1,0
85336,5,2,299016,299016,299018,0,2,4
85337,6,2,299022,299022,299024,0,2,4
85338,2,3,299024,299024,299027,0,3,0
85339,6,1,299030,299030,299031,0,1,3
85340,5,2,299035,299035,299037,0,2,4
85341,6,2,299041,299041,299043,0,2,4
85342,5,3,299046,299046,299049,0,3,3
85343,3,1,299049,299049,299050,0,1,0
85344,6,2,299055,299055,299057,0,2,5
85345,6,2,299061,299061,299063,0,2,4
85346,1,1,299062,299063,299064,1,2,0
85347,1,3,299063,299064,299067,1,4,0
85348,2,1,299065,299067,299068,2,3,0
85349,1,1,299066,299068,299069,2,3,0
85350,1,2,299067,299069,299071,2,4,0
85351,1,3,299068,299071,299074,3,6,0
85352,1,2,299069,299074,299076,5,7,0
85353,4,1,299073,299076,299077,3,4,0
85354,1,2,299074,299077,299079,3,5,0
85355,1,1,299075,299079,299080,4,5,0
85356,3,2,299078,299080,299082,2,4,0
85357,2,3,299080,299082,299085,2,5,0
85358,5,2,299085,299085,299087,0,2,0
85359,6,2,299091,299091,299093,0,2,4
85360,6,3,299097,299097,299100,0,3,4
85361,6,2,299103,299103,299105,0,2,3
85362,6,3,299109,299109,299112,0,3,4
85363,5,3,299114,299114,299117,0,3,2
85364,2,3,299116,299117,299120,1,4,0
85365,6,1,299122,299122,299123,0,1,2
85366,1,2,299123,299123,299125,0,2,0
85367,5,1,299128,299128,299129,0,1,3
85368,3,1,299131,299131,299132,0,1,2
85369,6,1,299137,299137,299138,0,1,5
85370,6,1,299143,299143,299144,0,1,5
85371,2,2,299145,299145,299147,0,2,1
85372,6,2,299151,299151,299153,0,2,4
85373,2,1,299153,299153,299154,0,1,0
85374,5,2,299158,299158,299160,0,2,4
85375,3,2,299161,299161,299163,0,2,1
85376,6,3,299167,299167,299170,0,3,4
85377,2,3,299169,299170,299173,1,4,0
85378,1,3,299170,299173,299176,3,6,0
85379,4,2,299174,299176,299178,2,4,0
85380,2,3,299176,299178,299181,2,5,0
85381,2,1,299178,299181,299182,3,4,0
85382,4,1,299182,299182,299183,0,1,0
85383,4,3,299186,299186,299189,0,3,3
85384,6,2,299192,299192,299194,0,2,3
85385,3,2,299195,299195,299197,0,2,1
85386,5,1,299200,299200,299201,0,1,3
85387,6,3,299206,299206,299209,0,3,5
85388,6,1,299212,299212,299213,0,1,3
85389,2,3,299214,299214,299217,0,3,1
85390,3,3,299217,299217,299220,0,3,0
85391,2,1,299219,299220,299221,1,2,0
85392,2,1,299221,299221,299222,0,1,0
85393,1,1,299222,299222,299223,0,1,0
85394,4,3,299226,299226,299229,0,3,3
85395,1,2,299227,299229,299231,2,4,0
85396,5,1,299232,299232,299233,0,1,1
85397,6,1,299238,299238,299239,0,1,5
85398,6,3,299244,299244,299247,0,3,5
85399,3,2,299247,299247,299249,0,2,0
85400,5,2,299252,299252,299254,0,2,3
85401,1,1,299253,299254,299255,1,2,0
85402,4,3,299257,299257,299260,0,3,2
85403,5,3,299262,299262,299265,0,3,2
85404,4,2,299266,299266,299268,0,2,1
85405,2,3,299268,299268,299271,0,3,0
85406,1,1,299269,299271,299272,2,3,0
85407,4,1,299273,299273,299274,0,1,1
85408,6,1,299279,299279,299280,0,1,5
85409,6,2,299285,299285,299287,0,2,5
85410,6,3,299291,299291,299294,0,3,4
85411,1,2,299292,299294,299296,2,4,0
85412,6,2,299298,299298,299300,0,2,2
85413,5,1,299303,299303,299304,0,1,3
85414,4,3,299307,299307,299310,0,3,3
85415,5,1,299312,299312,299313,0,1,2
85416,6,3,299318,299318,299321,0,3,5
85417,3,2,299321,299321,299323,0,2,0
85418,6,3,299327,299327,299330,0,3,4
85419,5,3,299332,299332,299335,0,3,2
85420,6,1,299338,299338,299339,0,1,3
85421,6,2,299344,299344,299346,0,2,5
85422,1,1,299345,299346,299347,1,2,0
85423,1,2,299346,299347,299349,1,3,0
85424,2,1,299348,299349,299350,1,2,0
85425,2,1,299350,299350,299351,0,1,0
85426,2,3,299352,299352,299355,0,3,1
85427,5,2,299357,299357,299359,0,2,2
85428,2,1,299359,299359,299360,0,1,0
85429,6,2,299365,299365,299367,0,2,5
85430,2,3,299367,299367,299370,0,3,0
85431,5,3,299372,299372,299375,0,3,2
85432,1,2,299373,299375,299377,2,4,0
85433,2,1,299375,299377,299378,2,3,0
85434,3,2,299378,299378,299380,0,2,0
85435,2,3,299380,299380,299383,0,3,0
85436,3,3,299383,299383,299386,0,3,0
85437,6,2,299389,299389,299391,0,2,3
85438,1,2,299390,299391,299393,1,3,0
85439,5,3,299395,299395,299398,0,3,2
85440,2,2,299397,299398,299400,1,3,0
85441,3,2,299400,299400,299402,0,2,0
85442,1,2,299401,299402,299404,1,3,0
85443,5,2,299406,299406,299408,0,2,2
85444,5,3,299411,299411,299414,0,3,3
85445,5,3,299416,299416,299419,0,3,2
85446,2,2,299418,299419,299421,1,3,0
85447,2,1,299420,299421,299422,1,2,0
85448,4,3,299424,299424,299427,0,3,2
85449,1,1,299425,299427,299428,2,3,0
85450,5,2,299430,299430,299432,0,2,2
85451,6,3,299436,299436,299439,0,3,4
85452,6,3,299442,299442,299445,0,3,3
85453,6,1,299448,299448,299449,0,1,3
85454,3,2,299451,299451,299453,0,2,2
85455,5,3,299456,299456,299459,0,3,3
85456,4,3,299460,299460,299463,0,3,1
85457,3,1,299463,299463,299464,0,1,0
85458,2,1,299465,299465,299466,0,1,1
85459,4,1,299469,299469,299470,0,1,3
85460,2,1,299471,299471,299472,0,1,1
85461,3,3,299474,299474,299477,0,3,2
85462,4,1,299478,299478,299479,0,1,1
85463,5,1,299483,299483,299484,0,1,4
85464,4,2,299487,299487,299489,0,2,3
85465,6,3,299493,299493,299496,0,3,4
85466,4,3,299497,299497,299500,0,3,1
85467,5,2,299502,299502,299504,0,2,2
85468,2,3,299504,299504,299507,0,3,0
85469,4,1,299508,299508,299509,0,1,1
85470,2,1,299510,299510,299511,0,1,1
85471,3,3,299513,299513,299516,0,3,2
85472,6,1,299519,299519,299520,0,1,3
85473,6,3,299525,299525,299528,0,3,5
85474,6,2,299531,299531,299533,0,2,3
85475,5,2,299536,299536,299538,0,2,3
85476,4,2,299540,299540,299542,0,2,2
85477,1,2,299541,299542,299544,1,3,0
85478,6,1,299547,299547,299548,0,1,3
85479,2,2,299549,299549,299551,0,2,1
85480,6,3,299555,299555,299558,0,3,4
85481,6,1,299561,299561,299562,0,1,3
85482,5,1,299566,299566,299567,0,1,4
85483,6,2,299572,299572,299574,0,2,5
85484,6,3,299578,299578,299581,0,3,4
85485,5,3,299583,299583,299586,0,3,2
85486,3,2,299586,299586,299588,0,2,0
85487,3,2,299589,299589,299591,0,2,1
85488,5,1,299594,299594,299595,0,1,3
85489,6,1,299600,299600,299601,0,1,5
85490,2,3,299602,299602,299605,0,3,1
85491,4,2,299606,299606,299608,0,2,1
85492,2,1,299608,299608,299609,0,1,0
85493,4,2,299612,299612,299614,0,2,3
85494,4,3,299616,299616,299619,0,3,2
85495,6,1,299622,299622,299623,0,1,3
85496,3,3,299625,299625,299628,0,3,2
85497,1,3,299626,299628,299631,2,5,0
85498,6,3,299632,299632,299635,0,3,1
85499,4,3,299636,299636,299639,0,3,1
85500,4,2,299640,299640,299642,0,2,1
85501,1,1,299641,299642,299643,1,2,0
85502,1,3,299642,299643,299646,1,4,0
85503,5,2,299647,299647,299649,0,2,1
85504,1,2,299648,299649,299651,1,3,0
85505,1,1,299649,299651,299652,2,3,0
85506,3,3,299652,299652,299655,0,3,0
85507,6,3,299658,299658,299661,0,3,3
85508,2,1,299660,299661,299662,1,2,0
85509,5,1,299665,299665,299666,0,1,3
85510,2,3,299667,299667,299670,0,3,1
85511,2,2,299669,299670,299672,1,3,0
85512,2,3,299671,299672,299675,1,4,0
85513,1,1,299672,299675,299676,3,4,0
85514,6,2,299678,299678,299680,0,2,2
85515,5,3,299683,299683,299686,0,3,3
85516,5,1,299688,299688,299689,0,1,2
85517,6,1,299694,299694,299695,0,1,5
85518,5,1,299699,299699,299700,0,1,4
85519,5,1,299704,299704,299705,0,1,4
85520,5,3,299709,299709,299712,0,3,4
85521,4,2,299713,299713,299715,0,2,1
85522,5,2,299718,299718,299720,0,2,3
85523,2,3,299720,299720,299723,0,3,0
85524,4,2,299724,299724,299726,0,2,1
85525,4,2,299728,299728,299730,0,2,2
85526,3,1,299731,299731,299732,0,1,1
85527,1,3,299732,299732,299735,0,3,0
85528,6,3,299738,299738,299741,0,3,3
85529,1,3,299739,299741,299744,2,5,0
85530,5,2,299744,299744,299746,0,2,0
85531,6,1,299750,299750,299751,0,1,4
85532,1,1,299751,299751,299752,0,1,0
85533,6,3,299757,299757,299760,0,3,5
85534,1,2,299758,299760,299762,2,4,0
85535,1,3,299759,299762,299765,3,6,0
85536,2,3,299761,299765,299768,4,7,0
85537,6,3,299767,299768,299771,1,4,0
85538,1,1,299768,299771,299772,3,4,0
85539,3,2,299771,299772,299774,1,3,0
85540,3,1,299774,299774,299775,0,1,0
85541,3,1,299777,299777,299778,0,1,2
85542,4,3,299781,299781,299784,0,3,3
85543,4,1,299785,299785,299786,0,1,1
85544,2,2,299787,299787,299789,0,2,1
85545,5,2,299792,299792,299794,0,2,3
85546,2,1,299794,299794,299795,0,1,0
85547,3,2,299797,299797,299799,0,2,2
85548,3,3,299800,299800,299803,0,3,1
85549,6,3,299806,299806,299809,0,3,3
85550,1,2,299807,299809,299811,2,4,0
85551,4,2,299811,299811,299813,0,2,0
85552,1,3,299812,299813,299816,1,4,0
85553,3,2,299815,299816,299818,1,3,0
85554,1,3,299816,299818,299821,2,5,0
85555,2,2,299818,299821,299823,3,5,0
85556,5,3,299823,299823,299826,0,3,0
85557,2,3,299825,299826,299829,1,4,0
85558,1,3,299826,299829,299832,3,6,0
85559,2,1,299828,299832,299833,4,5,0
85560,1,2,299829,299833,299835,4,6,0
85561,3,3,299832,299835,299838,3,6,0
85562,3,3,299835,299838,299841,3,6,0
85563,1,3,299836,299841,299844,5,8,0
85564,1,2,299837,299844,299846,7,9,0
85565,4,1,299841,299846,299847,5,6,0
85566,4,1,299845,299847,299848,2,3,0
85567,5,3,299850,299850,299853,0,3,2
85568,5,2,299855,299855,299857,0,2,2
85569,6,1,299861,299861,299862,0,1,4
85570,4,2,299865,299865,299867,0,2,3
85571,3,3,299868,299868,299871,0,3,1
85572,3,3,299871,299871,299874,0,3,0
85573,6,3,299877,299877,299880,0,3,3
85574,3,3,299880,299880,299883,0,3,0
85575,3,3,299883,299883,299886,0,3,0
85576,4,3,299887,299887,299890,0,3,1
85577,1,3,299888,299890,299893,2,5,0
85578,1,1,299889,299893,299894,4,5,0
85579,1,3,299890,299894,299897,4,7,0
85580,5,1,299895,299897,299898,2,3,0
85581,4,3,299899,299899,299902,0,3,1
85582,1,3,299900,299902,299905,2,5,0
85583,5,2,299905,299905,299907,0,2,0
85584,6,2,299911,299911,299913,0,2,4
85585,3,3,299914,299914,299917,0,3,1
85586,4,1,299918,299918,299919,0,1,1
85587,5,2,299923,299923,299925,0,2,4
85588,3,1,299926,299926,299927,0,1,1
85589,6,2,299932,299932,299934,0,2,5
85590,6,3,299938,299938,299941,0,3,4
85591,6,2,299944,299944,299946,0,2,3
85592,5,2,299949,299949,299951,0,2,3
85593,4,2,299953,299953,299955,0,2,2
85594,2,1,299955,299955,299956,0,1,0
85595,5,1,299960,299960,299961,0,1,4
85596,3,1,299963,299963,299964,0,1,2
85597,6,2,299969,299969,299971,0,2,5
85598,2,2,299971,299971,299973,0,2,0
85599,3,2,299974,299974,299976,0,2,1
85600,1,3,299975,299976,299979,1,4,0
85601,5,2,299980,299980,299982,0,2,1
85602,6,3,299986,299986,299989,0,3,4
85603,3,1,299989,299989,299990,0,1,0
85604,5,3,299994,299994,299997,0,3,4
85605,3,2,299997,299997,299999,0,2,0
85606,2,2,299999,299999,300001,0,2,0
85607,1,3,300000,300001,300004,1,4,0
85608,2,2,300002,300004,300006,2,4,0
85609,6,2,300008,300008,300010,0,2,2
85610,3,3,300011,300011,300014,0,3,1
85611,4,3,300015,300015,300018,0,3,1
85612,3,3,300018,300018,300021,0,3,0
85613,2,3,300020,300021,300024,1,4,0
85614,1,3,300021,300024,300027,3,6,0
85615,3,2,300024,300027,300029,3,5,0
85616,6,2,300030,300030,300032,0,2,1
85617,3,2,300033,300033,300035,0,2,1
85618,5,1,300038,300038,300039,0,1,3
85619,2,1,300040,300040,300041,0,1,1
85620,1,1,300041,300041,300042,0,1,0
85621,3,1,300044,300044,300045,0,1,2
85622,2,1,300046,300046,300047,0,1,1
85623,1,3,300047,300047,300050,0,3,0
85624,2,1,300049,300050,300051,1,2,0
85625,3,1,300052,300052,300053,0,1,1
85626,2,2,300054,300054,300056,0,2,1
85627,4,2,300058,300058,300060,0,2,2
85628,3,3,300061,300061,300064,0,3,1
85629,1,2,300062,300064,300066,2,4,0
85630,5,3,300067,300067,300070,0,3,1
85631,4,1,300071,300071,300072,0,1,1
85632,5,2,300076,300076,300078,0,2,4
85633,4,2,300080,300080,300082,0,2,2
85634,6,3,300086,300086,300089,0,3,4
85635,5,2,300091,300091,300093,0,2,2
85636,5,1,300096,300096,300097,0,1,3
85637,6,2,300102,300102,300104,0,2,5
85638,4,2,300106,300106,300108,0,2,2
85639,2,1,300108,300108,300109,0,1,0
85640,5,2,300113,300113,300115,0,2,4
85641,3,1,300116,300116,300117,0,1,1
85642,6,3,300122,300122,300125,0,3,5
85643,3,2,300125,300125,300127,0,2,0
85644,4,1,300129,300129,300130,0,1,2
85645,3,1,300132,300132,300133,0,1,2
85646,5,2,300137,300137,300139,0,2,4
85647,2,1,300139,300139,300140,0,1,0
85648,6,1,300145,300145,300146,0,1,5
85649,2,3,300147,300147,300150,0,3,1
85650,2,1,300149,300150,300151,1,2,0
85651,4,2,300153,300153,300155,0,2,2
85652,2,3,300155,300155,300158,0,3,0
85653,2,3,300157,300158,300161,1,4,0
85654,1,2,300158,300161,300163,3,5,0
85655,3,2,300161,300163,300165,2,4,0
85656,6,3,300167,300167,300170,0,3,2
85657,5,2,300172,300172,300174,0,2,2
85658,1,2,300173,300174,300176,1,3,0
85659,3,3,300176,300176,300179,0,3,0
85660,1,2,300177,300179,300181,2,4,0
85661,1,3,300178,300181,300184,3,6,0
85662,4,3,300182,300184,300187,2,5,0
85663,4,3,300186,300187,300190,1,4,0
85664,1,1,300187,300190,300191,3,4,0
85665,2,3,300189,300191,300194,2,5,0
85666,2,2,300191,300194,300196,3,5,0
85667,6,1,300197,300197,300198,0,1,1
85668,3,2,300200,300200,300202,0,2,2
85669,3,2,300203,300203,300205,0,2,1
85670,6,3,300209,300209,300212,0,3,4
85671,1,1,300210,300212,300213,2,3,0
85672,5,3,300215,300215,300218,0,3,2
85673,3,3,300218,300218,300221,0,3,0
85674,1,1,300219,300221,300222,2,3,0
85675,6,3,300225,300225,300228,0,3,3
85676,5,1,300230,300230,300231,0,1,2
85677,4,2,300234,300234,300236,0,2,3
85678,3,3,300237,300237,300240,0,3,1
85679,5,1,300242,300242,300243,0,1,2
85680,4,1,300246,300246,300247,0,1,3
85681,3,2,300249,300249,300251,0,2,2
85682,6,3,300255,300255,300258,0,3,4
85683,5,3,300260,300260,300263,0,3,2
85684,5,3,300265,300265,300268,0,3,2
85685,6,2,300271,300271,300273,0,2,3
85686,3,3,300274,300274,300277,0,3,1
85687,1,2,300275,300277,300279,2,4,0
85688,1,2,300276,300279,300281,3,5,0
85689,4,1,300280,300281,300282,1,2,0
85690,3,1,300283,300283,300284,0,1,1
85691,2,1,300285,300285,300286,0,1,1
85692,2,3,300287,300287,300290,0,3,1
85693,4,3,300291,300291,300294,0,3,1
85694,3,3,300294,300294,300297,0,3,0
85695,2,1,300296,300297,300298,1,2,0
85696,4,2,300300,300300,300302,0,2,2
85697,2,1,300302,300302,300303,0,1,0
85698,4,1,300306,300306,300307,0,1,3
85699,4,1,300310,300310,300311,0,1,3
85700,1,3,300311,300311,300314,0,3,0
85701,3,3,300314,300314,300317,0,3,0
85702,6,2,300320,300320,300322,0,2,3
85703,5,3,300325,300325,300328,0,3,3
85704,5,3,300330,300330,300333,0,3,2
85705,2,2,300332,300333,300335,1,3,0
85706,4,3,300336,300336,300339,0,3,1
85707,2,2,300338,300339,300341,1,3,0
85708,3,1,300341,300341,300342,0,1,0
85709,5,1,300346,300346,300347,0,1,4
85710,6,1,300352,300352,300353,0,1,5
85711,2,1,300354,300354,300355,0,1,1
85712,1,1,300355,300355,300356,0,1,0
85713,4,1,300359,300359,300360,0,1,3
85714,4,1,300363,300363,300364,0,1,3
85715,4,1,300367,300367,300368,0,1,3
85716,5,2,300372,300372,300374,0,2,4
85717,1,1,300373,300374,300375,1,2,0
85718,1,1,300374,300375,300376,1,2,0
85719,4,3,300378,300378,300381,0,3,2
85720,2,3,300380,300381,300384,1,4,0
85721,5,2,300385,300385,300387,0,2,1
85722,3,3,300388,300388,300391,0,3,1
85723,3,2,300391,300391,300393,0,2,0
85724,2,2,300393,300393,300395,0,2,0
85725,4,1,300397,300397,300398,0,1,2
85726,3,2,300400,300400,300402,0,2,2
85727,6,1,300406,300406,300407,0,1,4
85728,4,2,300410,300410,300412,0,2,3
85729,2,2,300412,300412,300414,0,2,0
85730,6,3,300418,300418,300421,0,3,4
85731,5,3,300423,300423,300426,0,3,2
85732,3,1,300426,300426,300427,0,1,0
85733,4,1,300430,300430,300431,0,1,3
85734,4,3,300434,300434,300437,0,3,3
85735,6,1,300440,300440,300441,0,1,3
85736,4,1,300444,300444,300445,0,1,3
85737,4,2,300448,300448,300450,0,2,3
85738,6,2,300454,300454,300456,0,2,4
85739,4,2,300458,300458,300460,0,2,2
85740,2,3,300460,300460,300463,0,3,0
85741,4,3,300464,300464,300467,0,3,1
85742,6,2,300470,300470,300472,0,2,3
85743,1,3,300471,300472,300475,1,4,0
85744,2,3,300473,300475,300478,2,5,0
85745,3,3,300476,300478,300481,2,5,0
85746,2,3,300478,300481,300484,3,6,0
85747,3,3,300481,300484,300487,3,6,0
85748,1,1,300482,300487,300488,5,6,0
85749,4,1,300486,300488,300489,2,3,0
85750,6,2,300492,300492,300494,0,2,3
85751,4,2,300496,300496,300498,0,2,2
85752,3,1,300499,300499,300500,0,1,1
85753,5,1,300504,300504,300505,0,1,4
85754,1,1,300505,300505,300506,0,1,0
85755,4,2,300509,300509,300511,0,2,3
85756,1,3,300510,300511,300514,1,4,0
85757,2,1,300512,300514,300515,2,3,0
85758,2,3,300514,300515,300518,1,4,0
85759,1,2,300515,300518,300520,3,5,0
85760,2,2,300517,300520,300522,3,5,0
85761,6,3,300523,300523,300526,0,3,1
85762,6,1,300529,300529,300530,0,1,3
85763,1,1,300530,300530,300531,0,1,0
85764,2,2,300532,300532,300534,0,2,1
85765,3,1,300535,300535,300536,0,1,1
85766,4,2,300539,300539,300541,0,2,3
85767,5,2,300544,300544,300546,0,2,3
85768,3,3,300547,300547,300550,0,3,1
85769,2,1,300549,300550,300551,1,2,0
85770,3,2,300552,300552,300554,0,2,1
85771,5,2,300557,300557,300559,0,2,3
85772,1,3,300558,300559,300562,1,4,0
85773,3,1,300561,300562,300563,1,2,0
85774,6,1,300567,300567,300568,0,1,4
85775,5,3,300572,300572,300575,0,3,4
85776,6,2,300578,300578,300580,0,2,3
85777,4,3,300582,300582,300585,0,3,2
85778,6,3,300588,300588,300591,0,3,3
85779,4,1,300592,300592,300593,0,1,1
85780,2,3,300594,300594,300597,0,3,1
85781,3,3,300597,300597,300600,0,3,0
85782,5,3,300602,300602,300605,0,3,2
85783,6,2,300608,300608,300610,0,2,3
85784,1,3,300609,300610,300613,1,4,0
85785,6,2,300615,300615,300617,0,2,2
85786,4,1,300619,300619,300620,0,1,2
85787,2,3,300621,300621,300624,0,3,1
85788,3,3,300624,300624,300627,0,3,0
85789,1,3,300625,300627,300630,2,5,0
85790,1,1,300626,300630,300631,4,5,0
85791,4,2,300630,300631,300633,1,3,0
85792,2,1,300632,300633,300634,1,2,0
85793,1,2,300633,300634,300636,1,3,0
85794,1,2,300634,300636,300638,2,4,0
85795,5,2,300639,300639,300641,0,2,1
85796,2,3,300641,300641,300644,0,3,0
85797,3,1,300644,300644,300645,0,1,0
85798,2,3,300646,300646,300649,0,3,1
85799,6,2,300652,300652,300654,0,2,3
85800,2,3,300654,300654,300657,0,3,0
85801,2,3,300656,300657,300660,1,4,0
85802,5,3,300661,300661,300664,0,3,1
85803,4,1,300665,300665,300666,0,1,1
85804,5,3,300670,300670,300673,0,3,4
85805,4,1,300674,300674,300675,0,1,1
85806,6,2,300680,300680,300682,0,2,5
85807,4,2,300684,300684,300686,0,2,2
85808,5,2,300689,300689,300691,0,2,3
85809,2,3,300691,300691,300694,0,3,0
85810,1,1,300692,300694,300695,2,3,0
85811,1,3,300693,300695,300698,2,5,0
85812,4,3,300697,300698,300701,1,4,0
85813,6,3,300703,300703,300706,0,3,2
85814,6,2,300709,300709,300711,0,2,3
85815,6,2,300715,300715,300717,0,2,4
85816,4,1,300719,300719,300720,0,1,2
85817,3,1,300722,300722,300723,0,1,2
85818,1,1,300723,300723,300724,0,1,0
85819,3,3,300726,300726,300729,0,3,2
85820,5,2,300731,300731,300733,0,2,2
85821,3,3,300734,300734,300737,0,3,1
85822,5,3,300739,300739,300742,0,3,2
85823,2,1,300741,300742,300743,1,2,0
85824,2,1,300743,300743,300744,0,1,0
85825,6,3,300749,300749,300752,0,3,5
85826,5,1,300754,300754,300755,0,1,2
85827,3,1,300757,300757,300758,0,1,2
85828,1,3,300758,300758,300761,0,3,0
85829,1,1,300759,300761,300762,2,3,0
85830,4,2,300763,300763,300765,0,2,1
85831,2,1,300765,300765,300766,0,1,0
85832,1,2,300766,300766,300768,0,2,0
85833,6,1,300772,300772,300773,0,1,4
85834,2,3,300774,300774,300777,0,3,1
85835,4,3,300778,300778,300781,0,3,1
85836,5,3,300783,300783,300786,0,3,2
85837,5,2,300788,300788,300790,0,2,2
85838,6,3,300794,300794,300797,0,3,4
85839,1,1,300795,300797,300798,2,3,0
85840,4,2,300799,300799,300801,0,2,1
85841,2,2,300801,300801,300803,0,2,0
85842,6,3,300807,300807,300810,0,3,4
85843,3,1,300810,300810,300811,0,1,0
85844,4,2,300814,300814,300816,0,2,3
85845,3,3,300817,300817,300820,0,3,1
85846,1,3,300818,300820,300823,2,5,0
85847,6,2,300824,300824,300826,0,2,1
85848,1,2,300825,300826,300828,1,3,0
85849,5,1,300830,300830,300831,0,1,2
85850,5,3,300835,300835,300838,0,3,4
85851,6,3,300841,300841,300844,0,3,3
85852,6,2,300847,300847,300849,0,2,3
85853,3,3,300850,300850,300853,0,3,1
85854,6,2,300856,300856,300858,0,2,3
85855,5,3,300861,300861,300864,0,3,3
85856,1,1,300862,300864,300865,2,3,0
85857,4,2,300866,300866,300868,0,2,1
85858,6,1,300872,300872,300873,0,1,4
85859,2,1,300874,300874,300875,0,1,1
85860,6,2,300880,300880,300882,0,2,5
85861,2,3,300882,300882,300885,0,3,0
85862,6,3,300888,300888,300891,0,3,3
85863,5,3,300893,300893,300896,0,3,2
85864,2,3,300895,300896,300899,1,4,0
85865,3,1,300898,300899,300900,1,2,0
85866,3,3,300901,300901,300904,0,3,1
85867,2,2,300903,300904,300906,1,3,0
85868,2,3,300905,300906,300909,1,4,0
85869,5,3,300910,300910,300913,0,3,1
85870,1,1,300911,300913,300914,2,3,0
85871,1,2,300912,300914,300916,2,4,0
85872,1,1,300913,300916,300917,3,4,0
85873,4,2,300917,300917,300919,0,2,0
85874,5,1,300922,300922,300923,0,1,3
85875,1,1,300923,300923,300924,0,1,0
85876,6,2,300929,300929,300931,0,2,5
85877,2,3,300931,300931,300934,0,3,0
85878,4,2,300935,300935,300937,0,2,1
85879,5,1,300940,300940,300941,0,1,3
85880,1,3,300941,300941,300944,0,3,0
85881,4,1,300945,300945,300946,0,1,1
85882,5,2,300950,300950,300952,0,2,4
85883,1,3,300951,300952,300955,1,4,0
85884,3,3,300954,300955,300958,1,4,0
85885,3,1,300957,300958,300959,1,2,0
85886,2,1,300959,300959,300960,0,1,0
85887,4,1,300963,300963,300964,0,1,3
85888,6,2,300969,300969,300971,0,2,5
85889,5,1,300974,300974,300975,0,1,3
85890,6,2,300980,300980,300982,0,2,5
85891,1,1,300981,300982,300983,1,2,0
85892,5,1,300986,300986,300987,0,1,3
85893,5,3,300991,300991,300994,0,3,4
85894,3,2,300994,300994,300996,0,2,0
85895,4,2,300998,300998,301000,0,2,2
85896,3,1,301001,301001,301002,0,1,1
85897,1,2,301002,301002,301004,0,2,0
85898,6,1,301008,301008,301009,0,1,4
85899,2,1,301010,301010,301011,0,1,1
85900,2,2,301012,301012,301014,0,2,1
85901,4,3,301016,301016,301019,0,3,2
85902,3,2,301019,301019,301021,0,2,0
85903,5,3,301024,301024,301027,0,3,3
85904,1,1,301025,301027,301028,2,3,0
85905,6,3,301031,301031,301034,0,3,3
85906,4,3,301035,301035,301038,0,3,1
85907,3,3,301038,301038,301041,0,3,0
85908,4,3,301042,301042,301045,0,3,1
85909,2,2,301044,301045,301047,1,3,0
85910,6,3,301050,301050,301053,0,3,3
85911,4,1,301054,301054,301055,0,1,1
85912,2,3,301056,301056,301059,0,3,1
85913,3,2,301059,301059,301061,0,2,0
85914,2,2,301061,301061,301063,0,2,0
85915,6,1,301067,301067,301068,0,1,4
85916,6,2,301073,301073,301075,0,2,5
85917,6,1,301079,301079,301080,0,1,4
85918,4,3,301083,301083,301086,0,3,3
85919,2,1,301085,301086,301087,1,2,0
85920,3,3,301088,301088,301091,0,3,1
85921,4,2,301092,301092,301094,0,2,1
85922,4,3,301096,301096,301099,0,3,2
85923,5,3,301101,301101,301104,0,3,2
85924,5,1,301106,301106,301107,0,1,2
85925,3,1,301109,301109,301110,0,1,2
85926,4,3,301113,301113,301116,0,3,3
85927,3,1,301116,301116,301117,0,1,0
85928,6,2,301122,301122,301124,0,2,5
85929,2,2,301124,301124,301126,0,2,0
85930,3,1,301127,301127,301128,0,1,1
85931,5,2,301132,301132,301134,0,2,4
85932,4,2,301136,301136,301138,0,2,2
85933,1,1,301137,301138,301139,1,2,0
85934,2,2,301139,301139,301141,0,2,0
85935,6,3,301145,301145,301148,0,3,4
85936,3,2,301148,301148,301150,0,2,0
85937,4,3,301152,301152,301155,0,3,2
85938,5,1,301157,301157,301158,0,1,2
85939,3,3,301160,301160,301163,0,3,2
85940,3,3,301163,301163,301166,0,3,0
85941,2,3,301165,301166,301169,1,4,0
85942,3,2,301168,301169,301171,1,3,0
85943,2,3,301170,301171,301174,1,4,0
85944,1,1,301171,301174,301175,3,4,0
85945,5,2,301176,301176,301178,0,2,1
85946,6,1,301182,301182,301183,0,1,4
85947,1,2,301183,301183,301185,0,2,0
85948,2,1,301185,301185,301186,0,1,0
85949,4,2,301189,301189,301191,0,2,3
85950,1,3,301190,301191,301194,1,4,0
85951,4,3,301194,301194,301197,0,3,0
85952,6,3,301200,301200,301203,0,3,3
85953,4,3,301204,301204,301207,0,3,1
85954,4,2,301208,301208,301210,0,2,1
85955,5,3,301213,301213,301216,0,3,3
85956,4,2,301217,301217,301219,0,2,1
85957,2,3,301219,301219,301222,0,3,0
85958,1,1,301220,301222,301223,2,3,0
85959,5,1,301225,301225,301226,0,1,2
85960,6,2,301231,301231,301233,0,2,5
85961,5,2,301236,301236,301238,0,2,3
85962,1,3,301237,301238,301241,1,4,0
85963,5,1,301242,301242,301243,0,1,1
85964,2,2,301244,301244,301246,0,2,1
85965,2,2,301246,301246,301248,0,2,0
85966,4,3,301250,301250,301253,0,3,2
85967,6,3,301256,301256,301259,0,3,3
85968,4,2,301260,301260,301262,0,2,1
85969,2,3,301262,301262,301265,0,3,0
85970,1,3,301263,301265,301268,2,5,0
85971,5,2,301268,301268,301270,0,2,0
85972,4,2,301272,301272,301274,0,2,2
85973,2,1,301274,301274,301275,0,1,0
85974,1,2,301275,301275,301277,0,2,0
85975,4,3,301279,301279,301282,0,3,2
85976,1,3,301280,301282,301285,2,5,0
85977,5,2,301285,301285,301287,0,2,0
85978,6,3,301291,301291,301294,0,3,4
85979,4,1,301295,301295,301296,0,1,1
85980,5,3,301300,301300,301303,0,3,4
85981,4,2,301304,301304,301306,0,2,1
85982,1,3,301305,301306,301309,1,4,0
85983,4,3,301309,301309,301312,0,3,0
85984,1,1,301310,301312,301313,2,3,0
85985,5,1,301315,301315,301316,0,1,2
85986,2,2,301317,301317,301319,0,2,1
85987,6,1,301323,301323,301324,0,1,4
85988,6,3,301329,301329,301332,0,3,5
85989,6,3,301335,301335,301338,0,3,3
85990,4,2,301339,301339,301341,0,2,1
85991,3,2,301342,301342,301344,0,2,1
85992,1,1,301343,301344,301345,1,2,0
85993,1,2,301344,301345,301347,1,3,0
85994,4,2,301348,301348,301350,0,2,1
85995,4,3,301352,301352,301355,0,3,2
85996,4,3,301356,301356,301359,0,3,1
85997,1,3,301357,301359,301362,2,5,0
85998,3,1,301360,301362,301363,2,3,0
85999,4,3,301364,301364,301367,0,3,1
86000,3,3,301367,301367,301370,0,3,0
86001,3,3,301370,301370,301373,0,3,0
86002,5,3,301375,301375,301378,0,3,2
86003,5,2,301380,301380,301382,0,2,2
86004,1,2,301381,301382,301384,1,3,0
86005,6,1,301387,301387,301388,0,1,3
86006,1,3,301388,301388,301391,0,3,0
86007,4,1,301392,301392,301393,0,1,1
86008,6,2,301398,301398,301400,0,2,5
86009,4,1,301402,301402,301403,0,1,2
86010,2,2,301404,301404,301406,0,2,1
86011,1,2,301405,301406,301408,1,3,0
86012,2,1,301407,301408,301409,1,2,0
86013,4,2,301411,301411,301413,0,2,2
86014,3,1,301414,301414,301415,0,1,1
86015,2,3,301416,301416,301419,0,3,1
86016,2,2,301418,301419,301421,1,3,0
86017,3,3,301421,301421,301424,0,3,0
86018,4,1,301425,301425,301426,0,1,1
86019,2,2,301427,301427,301429,0,2,1
86020,5,3,301432,301432,301435,0,3,3
86021,2,3,301434,301435,301438,1,4,0
86022,6,3,301440,301440,301443,0,3,2
86023,2,2,301442,301443,301445,1,3,0
86024,3,2,301445,301445,301447,0,2,0
86025,6,1,301451,301451,301452,0,1,4
86026,4,1,301455,301455,301456,0,1,3
86027,6,2,301461,301461,301463,0,2,5
86028,5,2,301466,301466,301468,0,2,3
86029,5,2,301471,301471,301473,0,2,3
86030,2,1,301473,301473,301474,0,1,0
86031,4,3,301477,301477,301480,0,3,3
86032,4,2,301481,301481,301483,0,2,1
86033,2,3,301483,301483,301486,0,3,0
86034,6,1,301489,301489,301490,0,1,3
86035,2,3,301491,301491,301494,0,3,1
86036,4,2,301495,301495,301497,0,2,1
86037,6,1,301501,301501,301502,0,1,4
86038,1,3,301502,301502,301505,0,3,0
86039,6,2,301508,301508,301510,0,2,3
86040,1,1,301509,301510,301511,1,2,0
86041,2,3,301511,301511,301514,0,3,0
86042,6,1,301517,301517,301518,0,1,3
86043,3,3,301520,301520,301523,0,3,2
86044,3,3,301523,301523,301526,0,3,0
86045,4,2,301527,301527,301529,0,2,1
86046,1,3,301528,301529,301532,1,4,0
86047,3,2,301531,301532,301534,1,3,0
86048,3,2,301534,301534,301536,0,2,0
86049,3,1,301537,301537,301538,0,1,1
86050,1,2,301538,301538,301540,0,2,0
86051,1,2,301539,301540,301542,1,3,0
86052,4,2,301543,301543,301545,0,2,1
86053,2,3,301545,301545,301548,0,3,0
86054,1,2,301546,301548,301550,2,4,0
86055,4,2,301550,301550,301552,0,2,0
86056,5,3,301555,301555,301558,0,3,3
86057,5,1,301560,301560,301561,0,1,2
86058,4,1,301564,301564,301565,0,1,3
86059,5,1,301569,301569,301570,0,1,4
86060,6,1,301575,301575,301576,0,1,5
86061,3,3,301578,301578,301581,0,3,2
86062,5,2,301583,301583,301585,0,2,2
86063,6,1,301589,301589,301590,0,1,4
86064,6,1,301595,301595,301596,0,1,5
86065,6,3,301601,301601,301604,0,3,5
86066,1,2,301602,301604,301606,2,4,0
86067,3,1,301605,301606,301607,1,2,0
86068,6,1,301611,301611,301612,0,1,4
86069,3,1,301614,301614,301615,0,1,2
86070,1,1,301615,301615,301616,0,1,0
86071,4,3,301619,301619,301622,0,3,3
86072,2,2,301621,301622,301624,1,3,0
86073,5,1,301626,301626,301627,0,1,2
86074,2,3,301628,301628,301631,0,3,1
86075,5,1,301633,301633,301634,0,1,2
86076,4,2,301637,301637,301639,0,2,3
86077,6,3,301643,301643,301646,0,3,4
86078,6,2,301649,301649,301651,0,2,3
86079,1,2,301650,301651,301653,1,3,0
86080,6,1,301656,301656,301657,0,1,3
86081,5,3,301661,301661,301664,0,3,4
86082,2,2,301663,301664,301666,1,3,0
86083,1,3,301664,301666,301669,2,5,0
86084,6,1,301670,301670,301671,0,1,1
86085,3,2,301673,301673,301675,0,2,2
86086,4,2,301677,301677,301679,0,2,2
86087,1,2,301678,301679,301681,1,3,0
86088,2,3,301680,301681,301684,1,4,0
86089,2,3,301682,301684,301687,2,5,0
86090,6,3,301688,301688,301691,0,3,1
86091,4,3,301692,301692,301695,0,3,1
86092,1,2,301693,301695,301697,2,4,0
86093,2,2,301695,301697,301699,2,4,0
86094,2,1,301697,301699,301700,2,3,0
86095,1,3,301698,301700,301703,2,5,0
86096,1,2,301699,301703,301705,4,6,0
86097,2,2,301701,301705,301707,4,6,0
86098,5,3,301706,301707,301710,1,4,0
86099,5,1,301711,301711,301712,0,1,1
86100,6,1,301717,301717,301718,0,1,5
86101,1,1,301718,301718,301719,0,1,0
86102,1,2,301719,301719,301721,0,2,0
86103,1,3,301720,301721,301724,1,4,0
86104,3,2,301723,301724,301726,1,3,0
86105,2,2,301725,301726,301728,1,3,0
86106,6,1,301731,301731,301732,0,1,3
86107,1,1,301732,301732,301733,0,1,0
86108,3,1,301735,301735,301736,0,1,2
86109,2,1,301737,301737,301738,0,1,1
86110,6,3,301743,301743,301746,0,3,5
86111,3,1,301746,301746,301747,0,1,0
86112,5,2,301751,301751,301753,0,2,4
86113,5,1,301756,301756,301757,0,1,3
86114,2,1,301758,301758,301759,0,1,1
86115,6,2,301764,301764,301766,0,2,5
86116,5,1,301769,301769,301770,0,1,3
86117,5,3,301774,301774,301777,0,3,4
86118,5,3,301779,301779,301782,0,3,2
86119,2,3,301781,301782,301785,1,4,0
86120,1,3,301782,301785,301788,3,6,0
86121,3,3,301785,301788,301791,3,6,0
86122,3,1,301788,301791,301792,3,4,0
86123,5,3,301793,301793,301796,0,3,1
86124,5,1,301798,301798,301799,0,1,2
86125,6,3,301804,301804,301807,0,3,5
86126,5,1,301809,301809,301810,0,1,2
86127,6,3,301815,301815,301818,0,3,5
86128,4,3,301819,301819,301822,0,3,1
86129,3,2,301822,301822,301824,0,2,0
86130,2,3,301824,301824,301827,0,3,0
86131,6,3,301830,301830,301833,0,3,3
86132,4,1,301834,301834,301835,0,1,1
86133,3,1,301837,301837,301838,0,1,2
86134,5,2,301842,301842,301844,0,2,4
86135,5,2,301847,301847,301849,0,2,3
86136,2,3,301849,301849,301852,0,3,0
86137,3,3,301852,301852,301855,0,3,0
86138,6,2,301858,301858,301860,0,2,3
86139,2,3,301860,301860,301863,0,3,0
86140,6,2,301866,301866,301868,0,2,3
86141,5,1,301871,301871,301872,0,1,3
86142,3,3,301874,301874,301877,0,3,2
86143,2,2,301876,301877,301879,1,3,0
86144,4,1,301880,301880,301881,0,1,1
86145,1,3,301881,301881,301884,0,3,0
86146,4,1,301885,301885,301886,0,1,1
86147,3,1,301888,301888,301889,0,1,2
86148,4,3,301892,301892,301895,0,3,3
86149,4,3,301896,301896,301899,0,3,1
86150,1,3,301897,301899,301902,2,5,0
86151,5,2,301902,301902,301904,0,2,0
86152,4,3,301906,301906,301909,0,3,2
86153,1,3,301907,301909,301912,2,5,0
86154,6,2,301913,301913,301915,0,2,1
86155,3,1,301916,301916,301917,0,1,1
86156,5,2,301921,301921,301923,0,2,4
86157,5,1,301926,301926,301927,0,1,3
86158,1,3,301927,301927,301930,0,3,0
86159,4,2,301931,301931,301933,0,2,1
86160,3,2,301934,301934,301936,0,2,1
86161,5,2,301939,301939,301941,0,2,3
86162,5,2,301944,301944,301946,0,2,3
86163,6,1,301950,301950,301951,0,1,4
86164,3,3,301953,301953,301956,0,3,2
86165,1,1,301954,301956,301957,2,3,0
86166,4,1,301958,301958,301959,0,1,1
86167,6,2,301964,301964,301966,0,2,5
86168,6,2,301970,301970,301972,0,2,4
86169,4,2,301974,301974,301976,0,2,2
86170,4,2,301978,301978,301980,0,2,2
86171,3,3,301981,301981,301984,0,3,1
86172,1,2,301982,301984,301986,2,4,0
86173,3,2,301985,301986,301988,1,3,0
86174,4,3,301989,301989,301992,0,3,1
86175,3,2,301992,301992,301994,0,2,0
86176,6,1,301998,301998,301999,0,1,4
86177,4,3,302002,302002,302005,0,3,3
86178,4,2,302006,302006,302008,0,2,1
86179,3,2,302009,302009,302011,0,2,1
86180,1,3,302010,302011,302014,1,4,0
86181,3,2,302013,302014,302016,1,3,0
86182,6,1,302019,302019,302020,0,1,3
86183,1,3,302020,302020,302023,0,3,0
86184,4,1,302024,302024,302025,0,1,1
86185,2,1,302026,302026,302027,0,1,1
86186,6,1,302032,302032,302033,0,1,5
86187,2,2,302034,302034,302036,0,2,1
86188,4,1,302038,302038,302039,0,1,2
86189,5,2,302043,302043,302045,0,2,4
86190,2,2,302045,302045,302047,0,2,0
86191,1,1,302046,302047,302048,1,2,0
86192,4,2,302050,302050,302052,0,2,2
86193,3,1,302053,302053,302054,0,1,1
86194,5,3,302058,302058,302061,0,3,4
86195,4,2,302062,302062,302064,0,2,1
86196,2,2,302064,302064,302066,0,2,0
86197,3,2,302067,302067,302069,0,2,1
86198,4,2,302071,302071,302073,0,2,2
86199,1,1,302072,302073,302074,1,2,0
86200,6,3,302078,302078,302081,0,3,4
86201,1,2,302079,302081,302083,2,4,0
86202,2,1,302081,302083,302084,2,3,0
86203,4,2,302085,302085,302087,0,2,1
86204,1,3,302086,302087,302090,1,4,0
86205,3,3,302089,302090,302093,1,4,0
86206,5,1,302094,302094,302095,0,1,1
86207,6,1,302100,302100,302101,0,1,5
86208,6,1,302106,302106,302107,0,1,5
86209,1,2,302107,302107,302109,0,2,0
86210,6,3,302113,302113,302116,0,3,4
86211,5,2,302118,302118,302120,0,2,2
86212,5,1,302123,302123,302124,0,1,3
86213,1,2,302124,302124,302126,0,2,0
86214,6,3,302130,302130,302133,0,3,4
86215,5,1,302135,302135,302136,0,1,2
86216,3,2,302138,302138,302140,0,2,2
86217,1,3,302139,302140,302143,1,4,0
86218,1,2,302140,302143,302145,3,5,0
86219,2,1,302142,302145,302146,3,4,0
86220,1,3,302143,302146,302149,3,6,0
86221,2,2,302145,302149,302151,4,6,0
86222,5,2,302150,302151,302153,1,3,0
86223,5,3,302155,302155,302158,0,3,2
86224,5,3,302160,302160,302163,0,3,2
86225,1,3,302161,302163,302166,2,5,0
86226,5,1,302166,302166,302167,0,1,0
86227,4,3,302170,302170,302173,0,3,3
86228,4,2,302174,302174,302176,0,2,1
86229,5,2,302179,302179,302181,0,2,3
86230,4,2,302183,302183,302185,0,2,2
86231,6,2,302189,302189,302191,0,2,4
86232,5,1,302194,302194,302195,0,1,3
86233,5,1,302199,302199,302200,0,1,4
86234,2,1,302201,302201,302202,0,1,1
86235,5,1,302206,302206,302207,0,1,4
86236,1,2,302207,302207,302209,0,2,0
86237,6,1,302213,302213,302214,0,1,4
86238,6,3,302219,302219,302222,0,3,5
86239,4,3,302223,302223,302226,0,3,1
86240,5,2,302228,302228,302230,0,2,2
86241,3,2,302231,302231,302233,0,2,1
86242,3,3,302234,302234,302237,0,3,1
86243,4,3,302238,302238,302241,0,3,1
86244,4,3,302242,302242,302245,0,3,1
86245,2,2,302244,302245,302247,1,3,0
86246,4,1,302248,302248,302249,0,1,1
86247,2,1,302250,302250,302251,0,1,1
86248,3,2,302253,302253,302255,0,2,2
86249,2,1,302255,302255,302256,0,1,0
86250,5,3,302260,302260,302263,0,3,4
86251,6,1,302266,302266,302267,0,1,3
86252,1,3,302267,302267,302270,0,3,0
86253,2,2,302269,302270,302272,1,3,0
86254,6,3,302275,302275,302278,0,3,3
86255,6,2,302281,302281,302283,0,2,3
86256,5,3,302286,302286,302289,0,3,3
86257,5,1,302291,302291,302292,0,1,2
86258,1,1,302292,302292,302293,0,1,0
86259,5,1,302297,302297,302298,0,1,4
86260,3,2,302300,302300,302302,0,2,2
86261,5,2,302305,302305,302307,0,2,3
86262,3,3,302308,302308,302311,0,3,1
86263,2,2,302310,302311,302313,1,3,0
86264,6,2,302316,302316,302318,0,2,3
86265,2,1,302318,302318,302319,0,1,0
86266,2,1,302320,302320,302321,0,1,1
86267,4,3,302324,302324,302327,0,3,3
86268,2,3,302326,302327,302330,1,4,0
86269,6,2,302332,302332,302334,0,2,2
86270,2,3,302334,302334,302337,0,3,0
86271,3,2,302337,302337,302339,0,2,0
86272,3,1,302340,302340,302341,0,1,1
86273,4,1,302344,302344,302345,0,1,3
86274,3,2,302347,302347,302349,0,2,2
86275,6,3,302353,302353,302356,0,3,4
86276,6,1,302359,302359,302360,0,1,3
86277,2,2,302361,302361,302363,0,2,1
86278,1,1,302362,302363,302364,1,2,0
86279,4,1,302366,302366,302367,0,1,2
86280,2,1,302368,302368,302369,0,1,1
86281,2,2,302370,302370,302372,0,2,1
86282,2,2,302372,302372,302374,0,2,0
86283,1,2,302373,302374,302376,1,3,0
86284,2,3,302375,302376,302379,1,4,0
86285,1,2,302376,302379,302381,3,5,0
86286,4,1,302380,302381,302382,1,2,0
86287,5,1,302385,302385,302386,0,1,3
86288,3,2,302388,302388,302390,0,2,2
86289,1,2,302389,302390,302392,1,3,0
86290,5,3,302394,302394,302397,0,3,2
86291,5,3,302399,302399,302402,0,3,2
86292,1,1,302400,302402,302403,2,3,0
86293,2,3,302402,302403,302406,1,4,0
86294,1,1,302403,302406,302407,3,4,0
86295,6,3,302409,302409,302412,0,3,2
86296,6,3,302415,302415,302418,0,3,3
86297,1,1,302416,302418,302419,2,3,0
86298,6,1,302422,302422,302423,0,1,3
86299,6,3,302428,302428,302431,0,3,5
86300,6,1,302434,302434,302435,0,1,3
86301,2,1,302436,302436,302437,0,1,1
86302,3,3,302439,302439,302442,0,3,2
86303,4,1,302443,302443,302444,0,1,1
86304,4,2,302447,302447,302449,0,2,3
86305,1,3,302448,302449,302452,1,4,0
86306,3,1,302451,302452,302453,1,2,0
86307,5,3,302456,302456,302459,0,3,3
86308,3,2,302459,302459,302461,0,2,0
86309,4,2,302463,302463,302465,0,2,2
86310,6,3,302469,302469,302472,0,3,4
86311,3,2,302472,302472,302474,0,2,0
86312,5,1,302477,302477,302478,0,1,3
86313,5,1,302482,302482,302483,0,1,4
86314,2,2,302484,302484,302486,0,2,1
86315,3,2,302487,302487,302489,0,2,1
86316,4,3,302491,302491,302494,0,3,2
86317,1,3,302492,302494,302497,2,5,0
86318,2,2,302494,302497,302499,3,5,0
86319,4,2,302498,302499,302501,1,3,0
86320,2,2,302500,302501,302503,1,3,0
86321,2,2,302502,302503,302505,1,3,0
86322,3,3,302505,302505,302508,0,3,0
86323,4,1,302509,302509,302510,0,1,1
86324,6,1,302515,302515,302516,0,1,5
86325,5,3,302520,302520,302523,0,3,4
86326,1,2,302521,302523,302525,2,4,0
86327,3,3,302524,302525,302528,1,4,0
86328,4,2,302528,302528,302530,0,2,0
86329,1,3,302529,302530,302533,1,4,0
86330,3,2,302532,302533,302535,1,3,0
86331,6,2,302538,302538,302540,0,2,3
86332,1,3,302539,302540,302543,1,4,0
86333,4,1,302543,302543,302544,0,1,0
86334,3,1,302546,302546,302547,0,1,2
86335,5,3,302551,302551,302554,0,3,4
86336,6,1,302557,302557,302558,0,1,3
86337,5,3,302562,302562,302565,0,3,4
86338,1,2,302563,302565,302567,2,4,0
86339,6,2,302569,302569,302571,0,2,2
86340,6,1,302575,302575,302576,0,1,4
86341,2,3,302577,302577,302580,0,3,1
86342,1,2,302578,302580,302582,2,4,0
86343,2,3,302580,302582,302585,2,5,0
86344,4,1,302584,302585,302586,1,2,0
86345,4,2,302588,302588,302590,0,2,2
86346,5,1,302593,302593,302594,0,1,3
86347,4,3,302597,302597,302600,0,3,3
86348,6,1,302603,302603,302604,0,1,3
86349,2,2,302605,302605,302607,0,2,1
86350,5,2,302610,302610,302612,0,2,3
86351,3,2,302613,302613,302615,0,2,1
86352,4,3,302617,302617,302620,0,3,2
86353,3,2,302620,302620,302622,0,2,0
86354,3,2,302623,302623,302625,0,2,1
86355,6,2,302629,302629,302631,0,2,4
86356,4,3,302633,302633,302636,0,3,2
86357,1,1,302634,302636,302637,2,3,0
86358,1,1,302635,302637,302638,2,3,0
86359,6,1,302641,302641,302642,0,1,3
86360,3,1,302644,302644,302645,0,1,2
86361,3,3,302647,302647,302650,0,3,2
86362,1,1,302648,302650,302651,2,3,0
86363,3,3,302651,302651,302654,0,3,0
86364,1,1,302652,302654,302655,2,3,0
86365,1,1,302653,302655,302656,2,3,0
86366,1,2,302654,302656,302658,2,4,0
86367,1,1,302655,302658,302659,3,4,0
86368,5,3,302660,302660,302663,0,3,1
86369,5,2,302665,302665,302667,0,2,2
86370,6,1,302671,302671,302672,0,1,4
86371,3,3,302674,302674,302677,0,3,2
86372,5,1,302679,302679,302680,0,1,2
86373,4,1,302683,302683,302684,0,1,3
86374,1,2,302684,302684,302686,0,2,0
86375,2,1,302686,302686,302687,0,1,0
86376,3,3,302689,302689,302692,0,3,2
86377,2,3,302691,302692,302695,1,4,0
86378,4,2,302695,302695,302697,0,2,0
86379,6,2,302701,302701,302703,0,2,4
86380,2,2,302703,302703,302705,0,2,0
86381,4,1,302707,302707,302708,0,1,2
86382,3,3,302710,302710,302713,0,3,2
86383,5,1,302715,302715,302716,0,1,2
86384,5,1,302720,302720,302721,0,1,4
86385,4,1,302724,302724,302725,0,1,3
86386,5,3,302729,302729,302732,0,3,4
86387,3,2,302732,302732,302734,0,2,0
86388,6,3,302738,302738,302741,0,3,4
86389,6,3,302744,302744,302747,0,3,3
86390,1,2,302745,302747,302749,2,4,0
86391,6,2,302751,302751,302753,0,2,2
86392,5,3,302756,302756,302759,0,3,3
86393,1,1,302757,302759,302760,2,3,0
86394,4,1,302761,302761,302762,0,1,1
86395,5,2,302766,302766,302768,0,2,4
86396,5,3,302771,302771,302774,0,3,3
86397,3,3,302774,302774,302777,0,3,0
86398,3,2,302777,302777,302779,0,2,0
86399,1,2,302778,302779,302781,1,3,0
86400,5,2,302783,302783,302785,0,2,2
86401,2,3,302785,302785,302788,0,3,0
86402,3,3,302788,302788,302791,0,3,0
86403,2,3,302790,302791,302794,1,4,0
86404,4,2,302794,302794,302796,0,2,0
86405,3,2,302797,302797,302799,0,2,1
86406,6,2,302803,302803,302805,0,2,4
86407,4,2,302807,302807,302809,0,2,2
86408,6,3,302813,302813,302816,0,3,4
86409,6,2,302819,302819,302821,0,2,3
86410,5,1,302824,302824,302825,0,1,3
86411,3,1,302827,302827,302828,0,1,2
86412,6,2,302833,302833,302835,0,2,5
86413,1,1,302834,302835,302836,1,2,0
86414,4,1,302838,302838,302839,0,1,2
86415,3,1,302841,302841,302842,0,1,2
86416,1,1,302842,302842,302843,0,1,0
86417,5,1,302847,302847,302848,0,1,4
86418,2,3,302849,302849,302852,0,3,1
86419,6,1,302855,302855,302856,0,1,3
86420,3,1,302858,302858,302859,0,1,2
86421,6,1,302864,302864,302865,0,1,5
86422,4,2,302868,302868,302870,0,2,3
86423,1,3,302869,302870,302873,1,4,0
86424,4,2,302873,302873,302875,0,2,0
86425,1,3,302874,302875,302878,1,4,0
86426,3,2,302877,302878,302880,1,3,0
86427,4,1,302881,302881,302882,0,1,1
86428,2,1,302883,302883,302884,0,1,1
86429,2,2,302885,302885,302887,0,2,1
86430,1,3,302886,302887,302890,1,4,0
86431,5,2,302891,302891,302893,0,2,1
86432,2,2,302893,302893,302895,0,2,0
86433,1,3,302894,302895,302898,1,4,0
86434,3,3,302897,302898,302901,1,4,0
86435,5,2,302902,302902,302904,0,2,1
86436,2,3,302904,302904,302907,0,3,0
86437,4,2,302908,302908,302910,0,2,1
86438,6,2,302914,302914,302916,0,2,4
86439,1,2,302915,302916,302918,1,3,0
86440,5,2,302920,302920,302922,0,2,2
86441,2,3,302922,302922,302925,0,3,0
86442,5,3,302927,302927,302930,0,3,2
86443,4,3,302931,302931,302934,0,3,1
86444,6,3,302937,302937,302940,0,3,3
86445,4,3,302941,302941,302944,0,3,1
86446,1,1,302942,302944,302945,2,3,0
86447,4,1,302946,302946,302947,0,1,1
86448,4,3,302950,302950,302953,0,3,3
86449,2,2,302952,302953,302955,1,3,0
86450,5,3,302957,302957,302960,0,3,2
86451,4,1,302961,302961,302962,0,1,1
86452,2,2,302963,302963,302965,0,2,1
86453,4,2,302967,302967,302969,0,2,2
86454,1,2,302968,302969,302971,1,3,0
86455,2,2,302970,302971,302973,1,3,0
86456,3,1,302973,302973,302974,0,1,0
86457,2,3,302975,302975,302978,0,3,1
86458,3,3,302978,302978,302981,0,3,0
86459,6,2,302984,302984,302986,0,2,3
86460,2,1,302986,302986,302987,0,1,0
86461,6,3,302992,302992,302995,0,3,5
86462,5,1,302997,302997,302998,0,1,2
86463,5,3,303002,303002,303005,0,3,4
86464,1,2,303003,303005,303007,2,4,0
86465,5,1,303008,303008,303009,0,1,1
86466,4,3,303012,303012,303015,0,3,3
86467,4,2,303016,303016,303018,0,2,1
86468,3,1,303019,303019,303020,0,1,1
86469,2,3,303021,303021,303024,0,3,1
86470,4,2,303025,303025,303027,0,2,1
86471,5,1,303030,303030,303031,0,1,3
86472,3,2,303033,303033,303035,0,2,2
86473,3,1,303036,303036,303037,0,1,1
86474,6,3,303042,303042,303045,0,3,5
86475,6,3,303048,303048,303051,0,3,3
86476,3,3,303051,303051,303054,0,3,0
86477,2,1,303053,303054,303055,1,2,0
86478,5,2,303058,303058,303060,0,2,3
86479,1,1,303059,303060,303061,1,2,0
86480,1,3,303060,303061,303064,1,4,0
86481,1,2,303061,303064,303066,3,5,0
86482,5,2,303066,303066,303068,0,2,0
86483,4,2,303070,303070,303072,0,2,2
86484,3,3,303073,303073,303076,0,3,1
86485,3,1,303076,303076,303077,0,1,0
86486,1,1,303077,303077,303078,0,1,0
86487,1,1,303078,303078,303079,0,1,0
86488,6,3,303084,303084,303087,0,3,5
86489,3,2,303087,303087,303089,0,2,0
86490,5,3,303092,303092,303095,0,3,3
86491,3,3,303095,303095,303098,0,3,0
86492,1,1,303096,303098,303099,2,3,0
86493,3,2,303099,303099,303101,0,2,0
86494,1,2,303100,303101,303103,1,3,0
86495,4,3,303104,303104,303107,0,3,1
86496,3,2,303107,303107,303109,0,2,0
86497,2,3,303109,303109,303112,0,3,0
86498,4,3,303113,303113,303116,0,3,1
86499,1,3,303114,303116,303119,2,5,0
86500,6,3,303120,303120,303123,0,3,1
86501,2,3,303122,303123,303126,1,4,0
86502,1,2,303123,303126,303128,3,5,0
86503,2,1,303125,303128,303129,3,4,0
86504,6,2,303131,303131,303133,0,2,2
86505,3,2,303134,303134,303136,0,2,1
86506,1,2,303135,303136,303138,1,3,0
86507,2,2,303137,303138,303140,1,3,0
86508,2,2,303139,303140,303142,1,3,0
86509,4,1,303143,303143,303144,0,1,1
86510,2,3,303145,303145,303148,0,3,1
86511,6,2,303151,303151,303153,0,2,3
86512,3,3,303154,303154,303157,0,3,1
86513,5,3,303159,303159,303162,0,3,2
86514,1,2,303160,303162,303164,2,4,0
86515,4,1,303164,303164,303165,0,1,0
86516,5,2,303169,303169,303171,0,2,4
86517,1,2,303170,303171,303173,1,3,0
86518,2,1,303172,303173,303174,1,2,0
86519,3,1,303175,303175,303176,0,1,1
86520,6,2,303181,303181,303183,0,2,5
86521,5,1,303186,303186,303187,0,1,3
86522,1,1,303187,303187,303188,0,1,0
86523,1,1,303188,303188,303189,0,1,0
86524,2,2,303190,303190,303192,0,2,1
86525,3,2,303193,303193,303195,0,2,1
86526,1,2,303194,303195,303197,1,3,0
86527,4,2,303198,303198,303200,0,2,1
86528,6,1,303204,303204,303205,0,1,4
86529,4,1,303208,303208,303209,0,1,3
86530,4,1,303212,303212,303213,0,1,3
86531,1,1,303213,303213,303214,0,1,0
86532,3,1,303216,303216,303217,0,1,2
86533,3,2,303219,303219,303221,0,2,2
86534,1,2,303220,303221,303223,1,3,0
86535,4,3,303224,303224,303227,0,3,1
86536,3,2,303227,303227,303229,0,2,0
86537,5,2,303232,303232,303234,0,2,3
86538,6,1,303238,303238,303239,0,1,4
86539,6,3,303244,303244,303247,0,3,5
86540,5,1,303249,303249,303250,0,1,2
86541,2,2,303251,303251,303253,0,2,1
86542,4,3,303255,303255,303258,0,3,2
86543,5,2,303260,303260,303262,0,2,2
86544,1,1,303261,303262,303263,1,2,0
86545,2,2,303263,303263,303265,0,2,0
86546,4,3,303267,303267,303270,0,3,2
86547,2,2,303269,303270,303272,1,3,0
86548,2,3,303271,303272,303275,1,4,0
86549,6,2,303277,303277,303279,0,2,2
86550,3,2,303280,303280,303282,0,2,1
86551,2,3,303282,303282,303285,0,3,0
86552,6,3,303288,303288,303291,0,3,3
86553,5,2,303293,303293,303295,0,2,2
86554,3,1,303296,303296,303297,0,1,1
86555,2,1,303298,303298,303299,0,1,1
86556,4,1,303302,303302,303303,0,1,3
86557,2,2,303304,303304,303306,0,2,1
86558,1,1,303305,303306,303307,1,2,0
86559,6,1,303311,303311,303312,0,1,4
86560,3,3,303314,303314,303317,0,3,2
86561,6,3,303320,303320,303323,0,3,3
86562,4,3,303324,303324,303327,0,3,1
86563,3,2,303327,303327,303329,0,2,0
86564,3,2,303330,303330,303332,0,2,1
86565,5,1,303335,303335,303336,0,1,3
86566,6,1,303341,303341,303342,0,1,5
86567,1,3,303342,303342,303345,0,3,0
86568,2,2,303344,303345,303347,1,3,0
86569,4,1,303348,303348,303349,0,1,1
86570,5,1,303353,303353,303354,0,1,4
86571,3,1,303356,303356,303357,0,1,2
86572,6,2,303362,303362,303364,0,2,5
86573,3,2,303365,303365,303367,0,2,1
86574,2,1,303367,303367,303368,0,1,0
86575,6,3,303373,303373,303376,0,3,5
86576,4,3,303377,303377,303380,0,3,1
86577,4,1,303381,303381,303382,0,1,1
86578,1,2,303382,303382,303384,0,2,0
86579,2,3,303384,303384,303387,0,3,0
86580,4,1,303388,303388,303389,0,1,1
86581,5,3,303393,303393,303396,0,3,4
86582,5,2,303398,303398,303400,0,2,2
86583,1,2,303399,303400,303402,1,3,0
86584,1,3,303400,303402,303405,2,5,0
86585,2,3,303402,303405,303408,3,6,0
86586,2,2,303404,303408,303410,4,6,0
86587,4,2,303408,303410,303412,2,4,0
86588,2,1,303410,303412,303413,2,3,0
86589,6,2,303416,303416,303418,0,2,3
86590,1,1,303417,303418,303419,1,2,0
86591,2,1,303419,303419,303420,0,1,0
86592,6,3,303425,303425,303428,0,3,5
86593,1,1,303426,303428,303429,2,3,0
86594,2,3,303428,303429,303432,1,4,0
86595,1,2,303429,303432,303434,3,5,0
86596,2,2,303431,303434,303436,3,5,0
86597,3,2,303434,303436,303438,2,4,0
86598,4,3,303438,303438,303441,0,3,0
86599,5,1,303443,303443,303444,0,1,2
86600,2,1,303445,303445,303446,0,1,1
86601,4,3,303449,303449,303452,0,3,3
86602,1,1,303450,303452,303453,2,3,0
86603,1,3,303451,303453,303456,2,5,0
86604,6,1,303457,303457,303458,0,1,1
86605,2,2,303459,303459,303461,0,2,1
86606,4,1,303463,303463,303464,0,1,2
86607,6,1,303469,303469,303470,0,1,5
86608,4,1,303473,303473,303474,0,1,3
86609,2,2,303475,303475,303477,0,2,1
86610,4,3,303479,303479,303482,0,3,2
86611,5,1,303484,303484,303485,0,1,2
86612,4,3,303488,303488,303491,0,3,3
86613,4,3,303492,303492,303495,0,3,1
86614,5,2,303497,303497,303499,0,2,2
86615,5,3,303502,303502,303505,0,3,3
86616,1,1,303503,303505,303506,2,3,0
86617,6,3,303509,303509,303512,0,3,3
86618,3,3,303512,303512,303515,0,3,0
86619,1,2,303513,303515,303517,2,4,0
86620,3,3,303516,303517,303520,1,4,0
86621,2,1,303518,303520,303521,2,3,0
86622,2,3,303520,303521,303524,1,4,0
86623,6,2,303526,303526,303528,0,2,2
86624,2,1,303528,303528,303529,0,1,0
86625,2,2,303530,303530,303532,0,2,1
86626,5,2,303535,303535,303537,0,2,3
86627,2,2,303537,303537,303539,0,2,0
86628,4,1,303541,303541,303542,0,1,2
86629,3,2,303544,303544,303546,0,2,2
86630,6,3,303550,303550,303553,0,3,4
86631,5,1,303555,303555,303556,0,1,2
86632,3,1,303558,303558,303559,0,1,2
86633,6,2,303564,303564,303566,0,2,5
86634,2,3,303566,303566,303569,0,3,0
86635,2,1,303568,303569,303570,1,2,0
86636,1,3,303569,303570,303573,1,4,0
86637,6,1,303575,303575,303576,0,1,2
86638,1,1,303576,303576,303577,0,1,0
86639,2,2,303578,303578,303580,0,2,1
86640,5,1,303583,303583,303584,0,1,3
86641,6,3,303589,303589,303592,0,3,5
86642,5,2,303594,303594,303596,0,2,2
86643,2,2,303596,303596,303598,0,2,0
86644,4,3,303600,303600,303603,0,3,2
86645,1,2,303601,303603,303605,2,4,0
86646,2,2,303603,303605,303607,2,4,0
86647,3,3,303606,303607,303610,1,4,0
86648,3,1,303609,303610,303611,1,2,0
86649,5,3,303614,303614,303617,0,3,3
86650,6,2,303620,303620,303622,0,2,3
86651,2,3,303622,303622,303625,0,3,0
86652,5,1,303627,303627,303628,0,1,2
86653,4,1,303631,303631,303632,0,1,3
86654,5,2,303636,303636,303638,0,2,4
86655,2,3,303638,303638,303641,0,3,0
86656,4,1,303642,303642,303643,0,1,1
86657,5,3,303647,303647,303650,0,3,4
86658,3,1,303650,303650,303651,0,1,0
86659,4,2,303654,303654,303656,0,2,3
86660,5,1,303659,303659,303660,0,1,3
86661,1,1,303660,303660,303661,0,1,0
86662,2,3,303662,303662,303665,0,3,1
86663,3,3,303665,303665,303668,0,3,0
86664,4,3,303669,303669,303672,0,3,1
86665,4,1,303673,303673,303674,0,1,1
86666,5,1,303678,303678,303679,0,1,4
86667,5,2,303683,303683,303685,0,2,4
86668,3,2,303686,303686,303688,0,2,1
86669,3,1,303689,303689,303690,0,1,1
86670,2,1,303691,303691,303692,0,1,1
86671,3,3,303694,303694,303697,0,3,2
86672,5,2,303699,303699,303701,0,2,2
86673,5,1,303704,303704,303705,0,1,3
86674,2,1,303706,303706,303707,0,1,1
86675,5,3,303711,303711,303714,0,3,4
86676,6,2,303717,303717,303719,0,2,3
86677,3,3,303720,303720,303723,0,3,1
86678,3,1,303723,303723,303724,0,1,0
86679,1,3,303724,303724,303727,0,3,0
86680,2,3,303726,303727,303730,1,4,0
86681,4,1,303730,303730,303731,0,1,0
86682,1,1,303731,303731,303732,0,1,0
86683,4,2,303735,303735,303737,0,2,3
86684,4,1,303739,303739,303740,0,1,2
86685,6,1,303745,303745,303746,0,1,5
86686,4,2,303749,303749,303751,0,2,3
86687,5,1,303754,303754,303755,0,1,3
86688,1,3,303755,303755,303758,0,3,0
86689,1,1,303756,303758,303759,2,3,0
86690,5,2,303761,303761,303763,0,2,2
86691,1,2,303762,303763,303765,1,3,0
86692,3,1,303765,303765,303766,0,1,0
86693,4,2,303769,303769,303771,0,2,3
86694,6,2,303775,303775,303777,0,2,4
86695,5,2,303780,303780,303782,0,2,3
86696,4,1,303784,303784,303785,0,1,2
86697,3,3,303787,303787,303790,0,3,2
86698,2,1,303789,303790,303791,1,2,0
86699,1,1,303790,303791,303792,1,2,0
86700,3,1,303793,303793,303794,0,1,1
86701,1,1,303794,303794,303795,0,1,0
86702,3,3,303797,303797,303800,0,3,2
86703,2,2,303799,303800,303802,1,3,0
86704,3,3,303802,303802,303805,0,3,0
86705,3,1,303805,303805,303806,0,1,0
86706,2,1,303807,303807,303808,0,1,1
86707,6,2,303813,303813,303815,0,2,5
86708,1,1,303814,303815,303816,1,2,0
86709,3,2,303817,303817,303819,0,2,1
86710,6,1,303823,303823,303824,0,1,4
86711,2,2,303825,303825,303827,0,2,1
86712,4,1,303829,303829,303830,0,1,2
86713,5,1,303834,303834,303835,0,1,4
86714,2,3,303836,303836,303839,0,3,1
86715,3,3,303839,303839,303842,0,3,0
86716,5,2,303844,303844,303846,0,2,2
86717,2,3,303846,303846,303849,0,3,0
86718,2,3,303848,303849,303852,1,4,0
86719,5,2,303853,303853,303855,0,2,1
86720,2,1,303855,303855,303856,0,1,0
86721,2,2,303857,303857,303859,0,2,1
86722,6,2,303863,303863,303865,0,2,4
86723,2,1,303865,303865,303866,0,1,0
86724,3,2,303868,303868,303870,0,2,2
86725,4,3,303872,303872,303875,0,3,2
86726,2,3,303874,303875,303878,1,4,0
86727,5,3,303879,303879,303882,0,3,1
86728,2,1,303881,303882,303883,1,2,0
86729,6,3,303887,303887,303890,0,3,4
86730,3,2,303890,303890,303892,0,2,0
86731,4,2,303894,303894,303896,0,2,2
86732,3,3,303897,303897,303900,0,3,1
86733,3,1,303900,303900,303901,0,1,0
86734,1,2,303901,303901,303903,0,2,0
86735,2,3,303903,303903,303906,0,3,0
86736,5,3,303908,303908,303911,0,3,2
86737,3,1,303911,303911,303912,0,1,0
86738,5,1,303916,303916,303917,0,1,4
86739,2,2,303918,303918,303920,0,2,1
86740,4,3,303922,303922,303925,0,3,2
86741,5,1,303927,303927,303928,0,1,2
86742,3,2,303930,303930,303932,0,2,2
86743,4,2,303934,303934,303936,0,2,2
86744,1,1,303935,303936,303937,1,2,0
86745,3,1,303938,303938,303939,0,1,1
86746,1,3,303939,303939,303942,0,3,0
86747,4,1,303943,303943,303944,0,1,1
86748,1,2,303944,303944,303946,0,2,0
86749,6,2,303950,303950,303952,0,2,4
86750,1,2,303951,303952,303954,1,3,0
86751,3,3,303954,303954,303957,0,3,0
86752,2,2,303956,303957,303959,1,3,0
86753,5,1,303961,303961,303962,0,1,2
86754,3,2,303964,303964,303966,0,2,2
86755,5,1,303969,303969,303970,0,1,3
86756,5,3,303974,303974,303977,0,3,4
86757,6,3,303980,303980,303983,0,3,3
86758,1,2,303981,303983,303985,2,4,0
86759,6,3,303987,303987,303990,0,3,2
86760,4,2,303991,303991,303993,0,2,1
86761,5,2,303996,303996,303998,0,2,3
86762,2,1,303998,303998,303999,0,1,0
86763,3,1,304001,304001,304002,0,1,2
86764,1,2,304002,304002,304004,0,2,0
86765,6,1,304008,304008,304009,0,1,4
86766,2,3,304010,304010,304013,0,3,1
86767,4,1,304014,304014,304015,0,1,1
86768,6,1,304020,304020,304021,0,1,5
86769,6,2,304026,304026,304028,0,2,5
86770,1,3,304027,304028,304031,1,4,0
86771,5,2,304032,304032,304034,0,2,1
86772,4,2,304036,304036,304038,0,2,2
86773,1,1,304037,304038,304039,1,2,0
86774,6,1,304043,304043,304044,0,1,4
86775,1,1,304044,304044,304045,0,1,0
86776,4,1,304048,304048,304049,0,1,3
86777,5,1,304053,304053,304054,0,1,4
86778,6,1,304059,304059,304060,0,1,5
86779,6,1,304065,304065,304066,0,1,5
86780,2,2,304067,304067,304069,0,2,1
86781,1,2,304068,304069,304071,1,3,0
86782,1,1,304069,304071,304072,2,3,0
86783,1,3,304070,304072,304075,2,5,0
86784,2,1,304072,304075,304076,3,4,0
86785,1,3,304073,304076,304079,3,6,0
86786,4,2,304077,304079,304081,2,4,0
86787,2,1,304079,304081,304082,2,3,0
86788,5,3,304084,304084,304087,0,3,2
86789,6,2,304090,304090,304092,0,2,3
86790,5,3,304095,304095,304098,0,3,3
86791,1,3,304096,304098,304101,2,5,0
86792,1,1,304097,304101,304102,4,5,0
86793,6,3,304103,304103,304106,0,3,1
86794,1,1,304104,304106,304107,2,3,0
86795,3,3,304107,304107,304110,0,3,0
86796,1,2,304108,304110,304112,2,4,0
86797,3,3,304111,304112,304115,1,4,0
86798,3,1,304114,304115,304116,1,2,0
86799,2,2,304116,304116,304118,0,2,0
86800,4,3,304120,304120,304123,0,3,2
86801,1,1,304121,304123,304124,2,3,0
86802,3,2,304124,304124,304126,0,2,0
86803,2,3,304126,304126,304129,0,3,0
86804,3,3,304129,304129,304132,0,3,0
86805,4,2,304133,304133,304135,0,2,1
86806,5,3,304138,304138,304141,0,3,3
86807,4,2,304142,304142,304144,0,2,1
86808,6,1,304148,304148,304149,0,1,4
86809,3,3,304151,304151,304154,0,3,2
86810,3,2,304154,304154,304156,0,2,0
86811,3,1,304157,304157,304158,0,1,1
86812,6,2,304163,304163,304165,0,2,5
86813,5,2,304168,304168,304170,0,2,3
86814,6,3,304174,304174,304177,0,3,4
86815,2,1,304176,304177,304178,1,2,0
86816,5,3,304181,304181,304184,0,3,3
86817,3,3,304184,304184,304187,0,3,0
86818,6,1,304190,304190,304191,0,1,3
86819,4,3,304194,304194,304197,0,3,3
86820,6,2,304200,304200,304202,0,2,3
86821,6,1,304206,304206,304207,0,1,4
86822,5,2,304211,304211,304213,0,2,4
86823,4,2,304215,304215,304217,0,2,2
86824,5,3,304220,304220,304223,0,3,3
86825,1,3,304221,304223,304226,2,5,0
86826,4,3,304225,304226,304229,1,4,0
86827,3,2,304228,304229,304231,1,3,0
86828,5,1,304233,304233,304234,0,1,2
86829,4,3,304237,304237,304240,0,3,3
86830,3,3,304240,304240,304243,0,3,0
86831,5,3,304245,304245,304248,0,3,2
86832,4,1,304249,304249,304250,0,1,1
86833,2,2,304251,304251,304253,0,2,1
86834,4,2,304255,304255,304257,0,2,2
86835,3,2,304258,304258,304260,0,2,1
86836,4,1,304262,304262,304263,0,1,2
86837,5,3,304267,304267,304270,0,3,4
86838,4,2,304271,304271,304273,0,2,1
86839,6,1,304277,304277,304278,0,1,4
86840,4,1,304281,304281,304282,0,1,3
86841,5,2,304286,304286,304288,0,2,4
86842,3,3,304289,304289,304292,0,3,1
86843,1,1,304290,304292,304293,2,3,0
86844,3,2,304293,304293,304295,0,2,0
86845,3,3,304296,304296,304299,0,3,1
86846,4,3,304300,304300,304303,0,3,1
86847,3,3,304303,304303,304306,0,3,0
86848,3,2,304306,304306,304308,0,2,0
86849,6,3,304312,304312,304315,0,3,4
86850,4,1,304316,304316,304317,0,1,1
86851,1,1,304317,304317,304318,0,1,0
86852,1,3,304318,304318,304321,0,3,0
86853,1,3,304319,304321,304324,2,5,0
86854,6,1,304325,304325,304326,0,1,1
86855,1,1,304326,304326,304327,0,1,0
86856,4,1,304330,304330,304331,0,1,3
86857,2,3,304332,304332,304335,0,3,1
86858,5,2,304337,304337,304339,0,2,2
86859,2,1,304339,304339,304340,0,1,0
86860,2,2,304341,304341,304343,0,2,1
86861,5,2,304346,304346,304348,0,2,3
86862,1,1,304347,304348,304349,1,2,0
86863,5,2,304352,304352,304354,0,2,3
86864,3,2,304355,304355,304357,0,2,1
86865,2,3,304357,304357,304360,0,3,0
86866,2,1,304359,304360,304361,1,2,0
86867,4,2,304363,304363,304365,0,2,2
86868,3,2,304366,304366,304368,0,2,1
86869,3,3,304369,304369,304372,0,3,1
86870,4,3,304373,304373,304376,0,3,1
86871,5,1,304378,304378,304379,0,1,2
86872,6,1,304384,304384,304385,0,1,5
86873,1,1,304385,304385,304386,0,1,0
86874,6,1,304391,304391,304392,0,1,5
86875,1,2,304392,304392,304394,0,2,0
86876,3,2,304395,304395,304397,0,2,1
86877,5,2,304400,304400,304402,0,2,3
86878,4,1,304404,304404,304405,0,1,2
86879,6,3,304410,304410,304413,0,3,5
86880,5,3,304415,304415,304418,0,3,2
86881,3,2,304418,304418,304420,0,2,0
86882,3,2,304421,304421,304423,0,2,1
86883,1,2,304422,304423,304425,1,3,0
86884,3,3,304425,304425,304428,0,3,0
86885,2,2,304427,304428,304430,1,3,0
86886,1,2,304428,304430,304432,2,4,0
86887,5,1,304433,304433,304434,0,1,1
86888,2,2,304435,304435,304437,0,2,1
86889,4,1,304439,304439,304440,0,1,2
86890,1,1,304440,304440,304441,0,1,0
86891,3,3,304443,304443,304446,0,3,2
86892,5,1,304448,304448,304449,0,1,2
86893,1,1,304449,304449,304450,0,1,0
86894,2,3,304451,304451,304454,0,3,1
86895,1,3,304452,304454,304457,2,5,0
86896,3,3,304455,304457,304460,2,5,0
86897,1,2,304456,304460,304462,4,6,0
86898,4,3,304460,304462,304465,2,5,0
86899,1,2,304461,304465,304467,4,6,0
86900,4,2,304465,304467,304469,2,4,0
86901,1,2,304466,304469,304471,3,5,0
86902,1,3,304467,304471,304474,4,7,0
86903,2,1,304469,304474,304475,5,6,0
86904,3,3,304472,304475,304478,3,6,0
86905,3,3,304475,304478,304481,3,6,0
86906,2,2,304477,304481,304483,4,6,0
86907,4,1,304481,304483,304484,2,3,0
86908,2,1,304483,304484,304485,1,2,0
86909,6,3,304489,304489,304492,0,3,4
86910,5,2,304494,304494,304496,0,2,2
86911,6,3,304500,304500,304503,0,3,4
86912,6,3,304506,304506,304509,0,3,3
86913,3,2,304509,304509,304511,0,2,0
86914,5,1,304514,304514,304515,0,1,3
86915,6,1,304520,304520,304521,0,1,5
86916,5,1,304525,304525,304526,0,1,4
86917,4,2,304529,304529,304531,0,2,3
86918,1,3,304530,304531,304534,1,4,0
86919,6,3,304536,304536,304539,0,3,2
86920,5,2,304541,304541,304543,0,2,2
86921,6,2,304547,304547,304549,0,2,4
86922,1,3,304548,304549,304552,1,4,0
86923,5,3,304553,304553,304556,0,3,1
86924,6,3,304559,304559,304562,0,3,3
86925,2,3,304561,304562,304565,1,4,0
86926,6,1,304567,304567,304568,0,1,2
86927,6,1,304573,304573,304574,0,1,5
86928,3,2,304576,304576,304578,0,2,2
86929,3,1,304579,304579,304580,0,1,1
86930,3,1,304582,304582,304583,0,1,2
86931,3,3,304585,304585,304588,0,3,2
86932,5,1,304590,304590,304591,0,1,2
86933,5,1,304595,304595,304596,0,1,4
86934,5,3,304600,304600,304603,0,3,4
86935,2,1,304602,304603,304604,1,2,0
86936,5,2,304607,304607,304609,0,2,3
86937,3,3,304610,304610,304613,0,3,1
86938,3,2,304613,304613,304615,0,2,0
86939,5,3,304618,304618,304621,0,3,3
86940,1,2,304619,304621,304623,2,4,0
86941,2,3,304621,304623,304626,2,5,0
86942,4,3,304625,304626,304629,1,4,0
86943,4,3,304629,304629,304632,0,3,0
86944,2,1,304631,304632,304633,1,2,0
86945,2,3,304633,304633,304636,0,3,0
86946,6,3,304639,304639,304642,0,3,3
86947,5,2,304644,304644,304646,0,2,2
86948,3,2,304647,304647,304649,0,2,1
86949,2,1,304649,304649,304650,0,1,0
86950,5,1,304654,304654,304655,0,1,4
86951,1,1,304655,304655,304656,0,1,0
86952,2,1,304657,304657,304658,0,1,1
86953,4,1,304661,304661,304662,0,1,3
86954,1,1,304662,304662,304663,0,1,0
86955,6,3,304668,304668,304671,0,3,5
86956,6,2,304674,304674,304676,0,2,3
86957,1,1,304675,304676,304677,1,2,0
86958,2,1,304677,304677,304678,0,1,0
86959,4,1,304681,304681,304682,0,1,3
86960,5,1,304686,304686,304687,0,1,4
86961,6,1,304692,304692,304693,0,1,5
86962,2,2,304694,304694,304696,0,2,1
86963,5,2,304699,304699,304701,0,2,3
86964,3,3,304702,304702,304705,0,3,1
86965,4,2,304706,304706,304708,0,2,1
86966,3,2,304709,304709,304711,0,2,1
86967,3,2,304712,304712,304714,0,2,1
86968,1,1,304713,304714,304715,1,2,0
86969,4,1,304717,304717,304718,0,1,2
86970,3,2,304720,304720,304722,0,2,2
86971,3,2,304723,304723,304725,0,2,1
86972,1,2,304724,304725,304727,1,3,0
86973,4,3,304728,304728,304731,0,3,1
86974,3,1,304731,304731,304732,0,1,0
86975,1,2,304732,304732,304734,0,2,0
86976,3,1,304735,304735,304736,0,1,1
86977,3,1,304738,304738,304739,0,1,2
86978,5,2,304743,304743,304745,0,2,4
86979,6,1,304749,304749,304750,0,1,4
86980,2,1,304751,304751,304752,0,1,1
86981,4,1,304755,304755,304756,0,1,3
86982,4,2,304759,304759,304761,0,2,3
86983,3,2,304762,304762,304764,0,2,1
86984,4,2,304766,304766,304768,0,2,2
86985,2,3,304768,304768,304771,0,3,0
86986,2,3,304770,304771,304774,1,4,0
86987,4,1,304774,304774,304775,0,1,0
86988,1,1,304775,304775,304776,0,1,0
86989,4,2,304779,304779,304781,0,2,3
86990,3,3,304782,304782,304785,0,3,1
86991,5,2,304787,304787,304789,0,2,2
86992,3,1,304790,304790,304791,0,1,1
86993,5,1,304795,304795,304796,0,1,4
86994,4,1,304799,304799,304800,0,1,3
86995,2,2,304801,304801,304803,0,2,1
86996,2,3,304803,304803,304806,0,3,0
86997,6,1,304809,304809,304810,0,1,3
86998,1,1,304810,304810,304811,0,1,0
86999,4,2,304814,304814,304816,0,2,3
87000,5,1,304819,304819,304820,0,1,3
87001,6,3,304825,304825,304828,0,3,5
87002,1,1,304826,304828,304829,2,3,0
87003,4,3,304830,304830,304833,0,3,1
87004,6,2,304836,304836,304838,0,2,3
87005,1,1,304837,304838,304839,1,2,0
87006,1,1,304838,304839,304840,1,2,0
87007,1,3,304839,304840,304843,1,4,0
87008,3,2,304842,304843,304845,1,3,0
87009,6,3,304848,304848,304851,0,3,3
87010,6,3,304854,304854,304857,0,3,3
87011,2,1,304856,304857,304858,1,2,0
87012,1,2,304857,304858,304860,1,3,0
87013,3,3,304860,304860,304863,0,3,0
87014,2,2,304862,304863,304865,1,3,0
87015,1,2,304863,304865,304867,2,4,0
87016,5,2,304868,304868,304870,0,2,1
87017,5,2,304873,304873,304875,0,2,3
87018,1,1,304874,304875,304876,1,2,0
87019,3,1,304877,304877,304878,0,1,1
87020,2,2,304879,304879,304881,0,2,1
87021,2,3,304881,304881,304884,0,3,0
87022,3,1,304884,304884,304885,0,1,0
87023,1,3,304885,304885,304888,0,3,0
87024,4,1,304889,304889,304890,0,1,1
87025,4,3,304893,304893,304896,0,3,3
87026,5,2,304898,304898,304900,0,2,2
87027,3,2,304901,304901,304903,0,2,1
87028,3,2,304904,304904,304906,0,2,1
87029,5,2,304909,304909,304911,0,2,3
87030,6,1,304915,304915,304916,0,1,4
87031,5,3,304920,304920,304923,0,3,4
87032,5,3,304925,304925,304928,0,3,2
87033,1,1,304926,304928,304929,2,3,0
87034,6,1,304932,304932,304933,0,1,3
87035,5,1,304937,304937,304938,0,1,4
87036,5,2,304942,304942,304944,0,2,4
87037,4,3,304946,304946,304949,0,3,2
87038,3,1,304949,304949,304950,0,1,0
87039,4,2,304953,304953,304955,0,2,3
87040,1,3,304954,304955,304958,1,4,0
87041,4,2,304958,304958,304960,0,2,0
87042,3,1,304961,304961,304962,0,1,1
87043,4,2,304965,304965,304967,0,2,3
87044,6,1,304971,304971,304972,0,1,4
87045,5,2,304976,304976,304978,0,2,4
87046,3,1,304979,304979,304980,0,1,1
87047,6,1,304985,304985,304986,0,1,5
87048,6,3,304991,304991,304994,0,3,5
87049,1,1,304992,304994,304995,2,3,0
87050,3,3,304995,304995,304998,0,3,0
87051,6,3,305001,305001,305004,0,3,3
87052,4,2,305005,305005,305007,0,2,1
87053,6,1,305011,305011,305012,0,1,4
87054,3,3,305014,305014,305017,0,3,2
87055,6,3,305020,305020,305023,0,3,3
87056,2,3,305022,305023,305026,1,4,0
87057,1,1,305023,305026,305027,3,4,0
87058,3,2,305026,305027,305029,1,3,0
87059,4,3,305030,305030,305033,0,3,1
87060,5,3,305035,305035,305038,0,3,2
87061,1,1,305036,305038,305039,2,3,0
87062,6,3,305042,305042,305045,0,3,3
87063,2,1,305044,305045,305046,1,2,0
87064,2,2,305046,305046,305048,0,2,0
87065,5,1,305051,305051,305052,0,1,3
87066,4,3,305055,305055,305058,0,3,3
87067,4,3,305059,305059,305062,0,3,1
87068,4,1,305063,305063,305064,0,1,1
87069,5,3,305068,305068,305071,0,3,4
87070,2,3,305070,305071,305074,1,4,0
87071,1,3,305071,305074,305077,3,6,0
87072,4,1,305075,305077,305078,2,3,0
87073,5,1,305080,305080,305081,0,1,2
87074,3,1,305083,305083,305084,0,1,2
87075,4,2,305087,305087,305089,0,2,3
87076,4,2,305091,305091,305093,0,2,2
87077,1,2,305092,305093,305095,1,3,0
87078,2,3,305094,305095,305098,1,4,0
87079,2,3,305096,305098,305101,2,5,0
87080,6,1,305102,305102,305103,0,1,1
87081,3,1,305105,305105,305106,0,1,2
87082,1,3,305106,305106,305109,0,3,0
87083,2,2,305108,305109,305111,1,3,0
87084,5,1,305113,305113,305114,0,1,2
87085,5,1,305118,305118,305119,0,1,4
87086,4,3,305122,305122,305125,0,3,3
87087,3,3,305125,305125,305128,0,3,0
87088,6,1,305131,305131,305132,0,1,3
87089,1,2,305132,305132,305134,0,2,0
87090,3,3,305135,305135,305138,0,3,1
87091,2,2,305137,305138,305140,1,3,0
87092,6,2,305143,305143,305145,0,2,3
87093,3,1,305146,305146,305147,0,1,1
87094,5,1,305151,305151,305152,0,1,4
87095,2,2,305153,305153,305155,0,2,1
87096,3,3,305156,305156,305159,0,3,1
87097,3,2,305159,305159,305161,0,2,0
87098,4,3,305163,305163,305166,0,3,2
87099,4,1,305167,305167,305168,0,1,1
87100,3,3,305170,305170,305173,0,3,2
87101,1,2,305171,305173,305175,2,4,0
87102,2,3,305173,305175,305178,2,5,0
87103,1,1,305174,305178,305179,4,5,0
87104,3,1,305177,305179,305180,2,3,0
87105,5,2,305182,305182,305184,0,2,2
87106,1,2,305183,305184,305186,1,3,0
87107,5,1,305188,305188,305189,0,1,2
87108,4,1,305192,305192,305193,0,1,3
87109,3,2,305195,305195,305197,0,2,2
87110,3,2,305198,305198,305200,0,2,1
87111,5,2,305203,305203,305205,0,2,3
87112,6,1,305209,305209,305210,0,1,4
87113,3,1,305212,305212,305213,0,1,2
87114,1,2,305213,305213,305215,0,2,0
87115,1,1,305214,305215,305216,1,2,0
87116,2,3,305216,305216,305219,0,3,0
87117,2,2,305218,305219,305221,1,3,0
87118,6,3,305224,305224,305227,0,3,3
87119,3,1,305227,305227,305228,0,1,0
87120,6,1,305233,305233,305234,0,1,5
87121,3,2,305236,305236,305238,0,2,2
87122,5,1,305241,305241,305242,0,1,3
87123,3,3,305244,305244,305247,0,3,2
87124,2,2,305246,305247,305249,1,3,0
87125,1,3,305247,305249,305252,2,5,0
87126,5,3,305252,305252,305255,0,3,0
87127,4,1,305256,305256,305257,0,1,1
87128,1,2,305257,305257,305259,0,2,0
87129,1,3,305258,305259,305262,1,4,0
87130,4,1,305262,305262,305263,0,1,0
87131,6,2,305268,305268,305270,0,2,5
87132,2,1,305270,305270,305271,0,1,0
87133,6,3,305276,305276,305279,0,3,5
87134,5,2,305281,305281,305283,0,2,2
87135,3,1,305284,305284,305285,0,1,1
87136,3,1,305287,305287,305288,0,1,2
87137,3,1,305290,305290,305291,0,1,2
87138,2,2,305292,305292,305294,0,2,1
87139,3,1,305295,305295,305296,0,1,1
87140,2,3,305297,305297,305300,0,3,1
87141,2,1,305299,305300,305301,1,2,0
87142,2,3,305301,305301,305304,0,3,0
87143,2,1,305303,305304,305305,1,2,0
87144,2,1,305305,305305,305306,0,1,0
87145,2,1,305307,305307,305308,0,1,1
87146,5,3,305312,305312,305315,0,3,4
87147,1,2,305313,305315,305317,2,4,0
87148,4,3,305317,305317,305320,0,3,0
87149,2,3,305319,305320,305323,1,4,0
87150,5,2,305324,305324,305326,0,2,1
87151,1,3,305325,305326,305329,1,4,0
87152,6,1,305331,305331,305332,0,1,2
87153,3,2,305334,305334,305336,0,2,2
87154,3,1,305337,305337,305338,0,1,1
87155,5,2,305342,305342,305344,0,2,4
87156,1,1,305343,305344,305345,1,2,0
87157,1,2,305344,305345,305347,1,3,0
87158,6,2,305350,305350,305352,0,2,3
87159,4,3,305354,305354,305357,0,3,2
87160,4,3,305358,305358,305361,0,3,1
87161,3,2,305361,305361,305363,0,2,0
87162,3,2,305364,305364,305366,0,2,1
87163,4,2,305368,305368,305370,0,2,2
87164,3,1,305371,305371,305372,0,1,1
87165,5,1,305376,305376,305377,0,1,4
87166,6,2,305382,305382,305384,0,2,5
87167,2,2,305384,305384,305386,0,2,0
87168,1,2,305385,305386,305388,1,3,0
87169,6,2,305391,305391,305393,0,2,3
87170,3,2,305394,305394,305396,0,2,1
87171,4,3,305398,305398,305401,0,3,2
87172,5,2,305403,305403,305405,0,2,2
87173,6,1,305409,305409,305410,0,1,4
87174,3,3,305412,305412,305415,0,3,2
87175,3,2,305415,305415,305417,0,2,0
87176,2,2,305417,305417,305419,0,2,0
87177,6,1,305423,305423,305424,0,1,4
87178,1,3,305424,305424,305427,0,3,0
87179,2,1,305426,305427,305428,1,2,0
87180,6,1,305432,305432,305433,0,1,4
87181,4,3,305436,305436,305439,0,3,3
87182,3,1,305439,305439,305440,0,1,0
87183,2,3,305441,305441,305444,0,3,1
87184,4,2,305445,305445,305447,0,2,1
87185,2,3,305447,305447,305450,0,3,0
87186,4,2,305451,305451,305453,0,2,1
87187,3,1,305454,305454,305455,0,1,1
87188,2,3,305456,305456,305459,0,3,1
87189,1,3,305457,305459,305462,2,5,0
87190,1,1,305458,305462,305463,4,5,0
87191,1,2,305459,305463,305465,4,6,0
87192,6,2,305465,305465,305467,0,2,0
87193,4,1,305469,305469,305470,0,1,2
87194,5,2,305474,305474,305476,0,2,4
87195,1,1,305475,305476,305477,1,2,0
87196,4,2,305479,305479,305481,0,2,2
87197,4,2,305483,305483,305485,0,2,2
87198,5,3,305488,305488,305491,0,3,3
87199,1,2,305489,305491,305493,2,4,0
87200,2,3,305491,305493,305496,2,5,0
87201,6,3,305497,305497,305500,0,3,1
87202,5,2,305502,305502,305504,0,2,2
87203,1,2,305503,305504,305506,1,3,0
87204,5,2,305508,305508,305510,0,2,2
87205,6,1,305514,305514,305515,0,1,4
87206,3,3,305517,305517,305520,0,3,2
87207,4,3,305521,305521,305524,0,3,1
87208,1,2,305522,305524,305526,2,4,0
87209,3,3,305525,305526,305529,1,4,0
87210,4,3,305529,305529,305532,0,3,0
87211,6,1,305535,305535,305536,0,1,3
87212,1,3,305536,305536,305539,0,3,0
87213,6,3,305542,305542,305545,0,3,3
87214,4,2,305546,305546,305548,0,2,1
87215,4,2,305550,305550,305552,0,2,2
87216,1,1,305551,305552,305553,1,2,0
87217,5,1,305556,305556,305557,0,1,3
87218,6,3,305562,305562,305565,0,3,5
87219,1,1,305563,305565,305566,2,3,0
87220,2,2,305565,305566,305568,1,3,0
87221,2,2,305567,305568,305570,1,3,0
87222,1,2,305568,305570,305572,2,4,0
87223,2,1,305570,305572,305573,2,3,0
87224,5,1,305575,305575,305576,0,1,2
87225,2,3,305577,305577,305580,0,3,1
87226,5,3,305582,305582,305585,0,3,2
87227,6,1,305588,305588,305589,0,1,3
87228,1,2,305589,305589,305591,0,2,0
87229,3,2,305592,305592,305594,0,2,1
87230,2,3,305594,305594,305597,0,3,0
87231,5,2,305599,305599,305601,0,2,2
87232,5,2,305604,305604,305606,0,2,3
87233,1,2,305605,305606,305608,1,3,0
87234,2,3,305607,305608,305611,1,4,0
87235,2,2,305609,305611,305613,2,4,0
87236,3,2,305612,305613,305615,1,3,0
87237,2,2,305614,305615,305617,1,3,0
87238,2,3,305616,305617,305620,1,4,0
87239,6,3,305622,305622,305625,0,3,2
87240,1,3,305623,305625,305628,2,5,0
87241,6,1,305629,305629,305630,0,1,1
87242,6,2,305635,305635,305637,0,2,5
87243,2,3,305637,305637,305640,0,3,0
87244,2,2,305639,305640,305642,1,3,0
87245,3,3,305642,305642,305645,0,3,0
87246,1,3,305643,305645,305648,2,5,0
87247,6,1,305649,305649,305650,0,1,1
87248,5,1,305654,305654,305655,0,1,4
87249,4,3,305658,305658,305661,0,3,3
87250,6,2,305664,305664,305666,0,2,3
87251,5,2,305669,305669,305671,0,2,3
87252,3,1,305672,305672,305673,0,1,1
87253,3,3,305675,305675,305678,0,3,2
87254,5,3,305680,305680,305683,0,3,2
87255,4,1,305684,305684,305685,0,1,1
87256,6,2,305690,305690,305692,0,2,5
87257,2,2,305692,305692,305694,0,2,0
87258,2,3,305694,305694,305697,0,3,0
87259,5,1,305699,305699,305700,0,1,2
87260,1,1,305700,305700,305701,0,1,0
87261,1,3,305701,305701,305704,0,3,0
87262,4,3,305705,305705,305708,0,3,1
87263,2,1,305707,305708,305709,1,2,0
87264,4,3,305711,305711,305714,0,3,2
87265,1,1,305712,305714,305715,2,3,0
87266,6,2,305718,305718,305720,0,2,3
87267,3,1,305721,305721,305722,0,1,1
87268,4,2,305725,305725,305727,0,2,3
87269,5,1,305730,305730,305731,0,1,3
87270,4,2,305734,305734,305736,0,2,3
87271,3,1,305737,305737,305738,0,1,1
87272,6,2,305743,305743,305745,0,2,5
87273,3,3,305746,305746,305749,0,3,1
87274,1,3,305747,305749,305752,2,5,0
87275,3,3,305750,305752,305755,2,5,0
87276,5,3,305755,305755,305758,0,3,0
87277,1,1,305756,305758,305759,2,3,0
87278,2,2,305758,305759,305761,1,3,0
87279,5,3,305763,305763,305766,0,3,2
87280,3,3,305766,305766,305769,0,3,0
87281,5,2,305771,305771,305773,0,2,2
87282,4,3,305775,305775,305778,0,3,2
87283,4,1,305779,305779,305780,0,1,1
87284,6,3,305785,305785,305788,0,3,5
87285,4,3,305789,305789,305792,0,3,1
87286,5,3,305794,305794,305797,0,3,2
87287,6,1,305800,305800,305801,0,1,3
87288,1,3,305801,305801,305804,0,3,0
87289,6,2,305807,305807,305809,0,2,3
87290,1,1,305808,305809,305810,1,2,0
87291,2,3,305810,305810,305813,0,3,0
87292,5,2,305815,305815,305817,0,2,2
87293,5,3,305820,305820,305823,0,3,3
87294,6,3,305826,305826,305829,0,3,3
87295,2,1,305828,305829,305830,1,2,0
87296,2,3,305830,305830,305833,0,3,0
87297,4,1,305834,305834,305835,0,1,1
87298,3,2,305837,305837,305839,0,2,2
87299,3,1,305840,305840,305841,0,1,1
87300,6,3,305846,305846,305849,0,3,5
87301,3,2,305849,305849,305851,0,2,0
87302,1,2,305850,305851,305853,1,3,0
87303,6,3,305856,305856,305859,0,3,3
87304,1,2,305857,305859,305861,2,4,0
87305,3,3,305860,305861,305864,1,4,0
87306,2,3,305862,305864,305867,2,5,0
87307,4,3,305866,305867,305870,1,4,0
87308,3,3,305869,305870,305873,1,4,0
87309,1,2,305870,305873,305875,3,5,0
87310,2,3,305872,305875,305878,3,6,0
87311,4,2,305876,305878,305880,2,4,0
87312,6,2,305882,305882,305884,0,2,2
87313,1,3,305883,305884,305887,1,4,0
87314,1,2,305884,305887,305889,3,5,0
87315,5,1,305889,305889,305890,0,1,0
87316,2,3,305891,305891,305894,0,3,1
87317,2,2,305893,305894,305896,1,3,0
87318,3,1,305896,305896,305897,0,1,0
87319,5,2,305901,305901,305903,0,2,4
87320,4,3,305905,305905,305908,0,3,2
87321,2,1,305907,305908,305909,1,2,0
87322,5,2,305912,305912,305914,0,2,3
87323,6,1,305918,305918,305919,0,1,4
87324,4,3,305922,305922,305925,0,3,3
87325,6,2,305928,305928,305930,0,2,3
87326,1,3,305929,305930,305933,1,4,0
87327,4,2,305933,305933,305935,0,2,0
87328,5,2,305938,305938,305940,0,2,3
87329,6,1,305944,305944,305945,0,1,4
87330,6,3,305950,305950,305953,0,3,5
87331,5,2,305955,305955,305957,0,2,2
87332,5,1,305960,305960,305961,0,1,3
87333,3,1,305963,305963,305964,0,1,2
87334,3,3,305966,305966,305969,0,3,2
87335,3,2,305969,305969,305971,0,2,0
87336,2,1,305971,305971,305972,0,1,0
87337,5,3,305976,305976,305979,0,3,4
87338,4,1,305980,305980,305981,0,1,1
87339,3,1,305983,305983,305984,0,1,2
87340,6,1,305989,305989,305990,0,1,5
87341,4,2,305993,305993,305995,0,2,3
87342,6,1,305999,305999,306000,0,1,4
87343,3,1,306002,306002,306003,0,1,2
87344,4,2,306006,306006,306008,0,2,3
87345,3,3,306009,306009,306012,0,3,1
87346,2,2,306011,306012,306014,1,3,0
87347,4,2,306015,306015,306017,0,2,1
87348,6,3,306021,306021,306024,0,3,4
87349,1,2,306022,306024,306026,2,4,0
87350,5,3,306027,306027,306030,0,3,1
87351,5,3,306032,306032,306035,0,3,2
87352,1,1,306033,306035,306036,2,3,0
87353,3,2,306036,306036,306038,0,2,0
87354,6,3,306042,306042,306045,0,3,4
87355,6,2,306048,306048,306050,0,2,3
87356,6,1,306054,306054,306055,0,1,4
87357,4,3,306058,306058,306061,0,3,3
87358,6,1,306064,306064,306065,0,1,3
87359,4,3,306068,306068,306071,0,3,3
87360,3,2,306071,306071,306073,0,2,0
87361,4,1,306075,306075,306076,0,1,2
87362,1,3,306076,306076,306079,0,3,0
87363,3,3,306079,306079,306082,0,3,0
87364,4,2,306083,306083,306085,0,2,1
87365,3,2,306086,306086,306088,0,2,1
87366,4,2,306090,306090,306092,0,2,2
87367,4,1,306094,306094,306095,0,1,2
87368,3,2,306097,306097,306099,0,2,2
87369,3,1,306100,306100,306101,0,1,1
87370,2,3,306102,306102,306105,0,3,1
87371,3,2,306105,306105,306107,0,2,0
87372,4,2,306109,306109,306111,0,2,2
87373,2,2,306111,306111,306113,0,2,0
87374,6,1,306117,306117,306118,0,1,4
87375,1,2,306118,306118,306120,0,2,0
87376,6,2,306124,306124,306126,0,2,4
87377,3,2,306127,306127,306129,0,2,1
87378,4,1,306131,306131,306132,0,1,2
87379,1,2,306132,306132,306134,0,2,0
87380,1,1,306133,306134,306135,1,2,0
87381,2,2,306135,306135,306137,0,2,0
87382,6,1,306141,306141,306142,0,1,4
87383,1,1,306142,306142,306143,0,1,0
87384,2,1,306144,306144,306145,0,1,1
87385,3,1,306147,306147,306148,0,1,2
87386,6,2,306153,306153,306155,0,2,5
87387,2,1,306155,306155,306156,0,1,0
87388,2,3,306157,306157,306160,0,3,1
87389,1,1,306158,306160,306161,2,3,0
87390,5,3,306163,306163,306166,0,3,2
87391,6,2,306169,306169,306171,0,2,3
87392,5,3,306174,306174,306177,0,3,3
87393,4,2,306178,306178,306180,0,2,1
87394,5,1,306183,306183,306184,0,1,3
87395,5,3,306188,306188,306191,0,3,4
87396,6,2,306194,306194,306196,0,2,3
87397,4,3,306198,306198,306201,0,3,2
87398,5,2,306203,306203,306205,0,2,2
87399,3,2,306206,306206,306208,0,2,1
87400,1,2,306207,306208,306210,1,3,0
87401,3,3,306210,306210,306213,0,3,0
87402,5,1,306215,306215,306216,0,1,2
87403,1,1,306216,306216,306217,0,1,0
87404,2,2,306218,306218,306220,0,2,1
87405,6,3,306224,306224,306227,0,3,4
87406,6,1,306230,306230,306231,0,1,3
87407,1,1,306231,306231,306232,0,1,0
87408,6,1,306237,306237,306238,0,1,5
87409,2,3,306239,306239,306242,0,3,1
87410,1,3,306240,306242,306245,2,5,0
87411,4,1,306244,306245,306246,1,2,0
87412,5,2,306249,306249,306251,0,2,3
87413,2,1,306251,306251,306252,0,1,0
87414,1,2,306252,306252,306254,0,2,0
87415,1,2,306253,306254,306256,1,3,0
87416,1,3,306254,306256,306259,2,5,0
87417,6,2,306260,306260,306262,0,2,1
87418,3,1,306263,306263,306264,0,1,1
87419,4,1,306267,306267,306268,0,1,3
87420,3,2,306270,306270,306272,0,2,2
87421,6,2,306276,306276,306278,0,2,4
87422,6,3,306282,306282,306285,0,3,4
87423,4,2,306286,306286,306288,0,2,1
87424,2,1,306288,306288,306289,0,1,0
87425,6,2,306294,306294,306296,0,2,5
87426,4,2,306298,306298,306300,0,2,2
87427,2,2,306300,306300,306302,0,2,0
87428,5,3,306305,306305,306308,0,3,3
87429,2,2,306307,306308,306310,1,3,0
87430,5,3,306312,306312,306315,0,3,2
87431,5,3,306317,306317,306320,0,3,2
87432,3,1,306320,306320,306321,0,1,0
87433,1,2,306321,306321,306323,0,2,0
87434,4,2,306325,306325,306327,0,2,2
87435,4,2,306329,306329,306331,0,2,2
87436,2,2,306331,306331,306333,0,2,0
87437,3,3,306334,306334,306337,0,3,1
87438,2,1,306336,306337,306338,1,2,0
87439,1,3,306337,306338,306341,1,4,0
87440,5,1,306342,306342,306343,0,1,1
87441,4,3,306346,306346,306349,0,3,3
87442,4,1,306350,306350,306351,0,1,1
87443,3,1,306353,306353,306354,0,1,2
87444,4,2,306357,306357,306359,0,2,3
87445,1,1,306358,306359,306360,1,2,0
87446,3,1,306361,306361,306362,0,1,1
87447,4,3,306365,306365,306368,0,3,3
87448,2,2,306367,306368,306370,1,3,0
87449,5,3,306372,306372,306375,0,3,2
87450,5,1,306377,306377,306378,0,1,2
87451,2,3,306379,306379,306382,0,3,1
87452,3,3,306382,306382,306385,0,3,0
87453,2,3,306384,306385,306388,1,4,0
87454,5,1,306389,306389,306390,0,1,1
87455,6,2,306395,306395,306397,0,2,5
87456,6,3,306401,306401,306404,0,3,4
87457,2,1,306403,306404,306405,1,2,0
87458,5,1,306408,306408,306409,0,1,3
87459,4,3,306412,306412,306415,0,3,3
87460,1,3,306413,306415,306418,2,5,0
87461,4,3,306417,306418,306421,1,4,0
87462,5,3,306422,306422,306425,0,3,1
87463,5,2,306427,306427,306429,0,2,2
87464,6,2,306433,306433,306435,0,2,4
87465,5,1,306438,306438,306439,0,1,3
87466,1,3,306439,306439,306442,0,3,0
87467,6,2,306445,306445,306447,0,2,3
87468,4,2,306449,306449,306451,0,2,2
87469,3,2,306452,306452,306454,0,2,1
87470,3,2,306455,306455,306457,0,2,1
87471,5,3,306460,306460,306463,0,3,3
87472,5,1,306465,306465,306466,0,1,2
87473,3,1,306468,306468,306469,0,1,2
87474,5,1,306473,306473,306474,0,1,4
87475,1,1,306474,306474,306475,0,1,0
87476,3,1,306477,306477,306478,0,1,2
87477,1,3,306478,306478,306481,0,3,0
87478,1,3,306479,306481,306484,2,5,0
87479,4,3,306483,306484,306487,1,4,0
87480,1,3,306484,306487,306490,3,6,0
87481,6,3,306490,306490,306493,0,3,0
87482,3,2,306493,306493,306495,0,2,0
87483,5,1,306498,306498,306499,0,1,3
87484,2,1,306500,306500,306501,0,1,1
87485,5,2,306505,306505,306507,0,2,4
87486,4,3,306509,306509,306512,0,3,2
87487,5,3,306514,306514,306517,0,3,2
87488,4,1,306518,306518,306519,0,1,1
87489,6,1,306524,306524,306525,0,1,5
87490,3,3,306527,306527,306530,0,3,2
87491,6,1,306533,306533,306534,0,1,3
87492,4,1,306537,306537,306538,0,1,3
87493,2,1,306539,306539,306540,0,1,1
87494,5,1,306544,306544,306545,0,1,4
87495,1,2,306545,306545,306547,0,2,0
87496,5,2,306550,306550,306552,0,2,3
87497,2,2,306552,306552,306554,0,2,0
87498,5,3,306557,306557,306560,0,3,3
87499,4,1,306561,306561,306562,0,1,1
87500,3,3,306564,306564,306567,0,3,2
87501,2,3,306566,306567,306570,1,4,0
87502,3,3,306569,306570,306573,1,4,0
87503,1,1,306570,306573,306574,3,4,0
87504,6,2,306576,306576,306578,0,2,2
87505,1,1,306577,306578,306579,1,2,0
87506,6,3,306583,306583,306586,0,3,4
87507,2,2,306585,306586,306588,1,3,0
87508,2,3,306587,306588,306591,1,4,0
87509,1,1,306588,306591,306592,3,4,0
87510,3,1,306591,306592,306593,1,2,0
87511,3,3,306594,306594,306597,0,3,1
87512,3,2,306597,306597,306599,0,2,0
87513,6,2,306603,306603,306605,0,2,4
87514,5,2,306608,306608,306610,0,2,3
87515,6,2,306614,306614,306616,0,2,4
87516,3,2,306617,306617,306619,0,2,1
87517,1,2,306618,306619,306621,1,3,0
87518,1,2,306619,306621,306623,2,4,0
87519,6,2,306625,306625,306627,0,2,2
87520,4,1,306629,306629,306630,0,1,2
87521,2,3,306631,306631,306634,0,3,1
87522,5,1,306636,306636,306637,0,1,2
87523,4,2,306640,306640,306642,0,2,3
87524,1,1,306641,306642,306643,1,2,0
87525,1,1,306642,306643,306644,1,2,0
87526,1,1,306643,306644,306645,1,2,0
87527,3,1,306646,306646,306647,0,1,1
87528,5,2,306651,306651,306653,0,2,4
87529,5,3,306656,306656,306659,0,3,3
87530,5,3,306661,306661,306664,0,3,2
87531,2,2,306663,306664,306666,1,3,0
87532,2,2,306665,306666,306668,1,3,0
87533,5,1,306670,306670,306671,0,1,2
87534,3,2,306673,306673,306675,0,2,2
87535,5,3,306678,306678,306681,0,3,3
87536,5,1,306683,306683,306684,0,1,2
87537,4,2,306687,306687,306689,0,2,3
87538,5,3,306692,306692,306695,0,3,3
87539,5,2,306697,306697,306699,0,2,2
87540,6,3,306703,306703,306706,0,3,4
87541,4,2,306707,306707,306709,0,2,1
87542,4,2,306711,306711,306713,0,2,2
87543,5,3,306716,306716,306719,0,3,3
87544,4,1,306720,306720,306721,0,1,1
87545,5,2,306725,306725,306727,0,2,4
87546,6,1,306731,306731,306732,0,1,4
87547,1,1,306732,306732,306733,0,1,0
87548,5,1,306737,306737,306738,0,1,4
87549,2,2,306739,306739,306741,0,2,1
87550,5,1,306744,306744,306745,0,1,3
87551,4,1,306748,306748,306749,0,1,3
87552,1,3,306749,306749,306752,0,3,0
87553,4,3,306753,306753,306756,0,3,1
87554,2,1,306755,306756,306757,1,2,0
87555,6,1,306761,306761,306762,0,1,4
87556,1,1,306762,306762,306763,0,1,0
87557,4,2,306766,306766,306768,0,2,3
87558,2,3,306768,306768,306771,0,3,0
87559,2,2,306770,306771,306773,1,3,0
87560,1,1,306771,306773,306774,2,3,0
87561,1,1,306772,306774,306775,2,3,0
87562,4,3,306776,306776,306779,0,3,1
87563,3,3,306779,306779,306782,0,3,0
87564,1,3,306780,306782,306785,2,5,0
87565,5,3,306785,306785,306788,0,3,0
87566,1,1,306786,306788,306789,2,3,0
87567,2,3,306788,306789,306792,1,4,0
87568,4,2,306792,306792,306794,0,2,0
87569,2,1,306794,306794,306795,0,1,0
87570,4,2,306798,306798,306800,0,2,3
87571,5,3,306803,306803,306806,0,3,3
87572,6,2,306809,306809,306811,0,2,3
87573,1,1,306810,306811,306812,1,2,0
87574,4,3,306814,306814,306817,0,3,2
87575,6,2,306820,306820,306822,0,2,3
87576,4,1,306824,306824,306825,0,1,2
87577,2,2,306826,306826,306828,0,2,1
87578,5,3,306831,306831,306834,0,3,3
87579,3,2,306834,306834,306836,0,2,0
87580,5,2,306839,306839,306841,0,2,3
87581,6,3,306845,306845,306848,0,3,4
87582,3,2,306848,306848,306850,0,2,0
87583,1,3,306849,306850,306853,1,4,0
87584,3,2,306852,306853,306855,1,3,0
87585,6,3,306858,306858,306861,0,3,3
87586,5,2,306863,306863,306865,0,2,2
87587,5,1,306868,306868,306869,0,1,3
87588,3,3,306871,306871,306874,0,3,2
87589,3,1,306874,306874,306875,0,1,0
87590,6,3,306880,306880,306883,0,3,5
87591,6,3,306886,306886,306889,0,3,3
87592,5,2,306891,306891,306893,0,2,2
87593,2,3,306893,306893,306896,0,3,0
87594,3,1,306896,306896,306897,0,1,0
87595,2,2,306898,306898,306900,0,2,1
87596,1,2,306899,306900,306902,1,3,0
87597,3,1,306902,306902,306903,0,1,0
87598,4,1,306906,306906,306907,0,1,3
87599,6,1,306912,306912,306913,0,1,5
87600,2,1,306914,306914,306915,0,1,1
87601,5,3,306919,306919,306922,0,3,4
87602,2,1,306921,306922,306923,1,2,0
87603,5,2,306926,306926,306928,0,2,3
87604,1,3,306927,306928,306931,1,4,0
87605,3,1,306930,306931,306932,1,2,0
87606,3,2,306933,306933,306935,0,2,1
87607,4,3,306937,306937,306940,0,3,2
87608,6,1,306943,306943,306944,0,1,3
87609,4,2,306947,306947,306949,0,2,3
87610,1,1,306948,306949,306950,1,2,0
87611,5,1,306953,306953,306954,0,1,3
87612,1,1,306954,306954,306955,0,1,0
87613,6,1,306960,306960,306961,0,1,5
87614,1,2,306961,306961,306963,0,2,0
87615,5,3,306966,306966,306969,0,3,3
87616,4,3,306970,306970,306973,0,3,1
87617,5,1,306975,306975,306976,0,1,2
87618,6,1,306981,306981,306982,0,1,5
87619,5,1,306986,306986,306987,0,1,4
87620,3,3,306989,306989,306992,0,3,2
87621,4,2,306993,306993,306995,0,2,1
87622,1,2,306994,306995,306997,1,3,0
87623,4,1,306998,306998,306999,0,1,1
87624,5,1,307003,307003,307004,0,1,4
87625,6,1,307009,307009,307010,0,1,5
87626,5,3,307014,307014,307017,0,3,4
87627,4,2,307018,307018,307020,0,2,1
87628,6,2,307024,307024,307026,0,2,4
87629,1,1,307025,307026,307027,1,2,0
87630,4,1,307029,307029,307030,0,1,2
87631,2,3,307031,307031,307034,0,3,1
87632,1,2,307032,307034,307036,2,4,0
87633,3,3,307035,307036,307039,1,4,0
87634,3,2,307038,307039,307041,1,3,0
87635,1,3,307039,307041,307044,2,5,0
87636,4,2,307043,307044,307046,1,3,0
87637,1,3,307044,307046,307049,2,5,0
87638,5,1,307049,307049,307050,0,1,0
87639,6,1,307055,307055,307056,0,1,5
87640,4,2,307059,307059,307061,0,2,3
87641,4,3,307063,307063,307066,0,3,2
87642,1,3,307064,307066,307069,2,5,0
87643,1,2,307065,307069,307071,4,6,0
87644,3,3,307068,307071,307074,3,6,0
87645,2,3,307070,307074,307077,4,7,0
87646,3,3,307073,307077,307080,4,7,0
87647,6,1,307079,307080,307081,1,2,0
87648,1,3,307080,307081,307084,1,4,0
87649,3,3,307083,307084,307087,1,4,0
87650,2,2,307085,307087,307089,2,4,0
87651,2,3,307087,307089,307092,2,5,0
87652,3,3,307090,307092,307095,2,5,0
87653,1,2,307091,307095,307097,4,6,0
87654,2,2,307093,307097,307099,4,6,0
87655,1,2,307094,307099,307101,5,7,0
87656,3,2,307097,307101,307103,4,6,0
87657,4,2,307101,307103,307105,2,4,0
87658,1,2,307102,307105,307107,3,5,0
87659,5,1,307107,307107,307108,0,1,0
87660,4,2,307111,307111,307113,0,2,3
87661,2,2,307113,307113,307115,0,2,0
87662,6,2,307119,307119,307121,0,2,4
87663,4,2,307123,307123,307125,0,2,2
87664,6,3,307129,307129,307132,0,3,4
87665,1,3,307130,307132,307135,2,5,0
87666,4,2,307134,307135,307137,1,3,0
87667,2,3,307136,307137,307140,1,4,0
87668,1,1,307137,307140,307141,3,4,0
87669,5,2,307142,307142,307144,0,2,1
87670,6,2,307148,307148,307150,0,2,4
87671,4,1,307152,307152,307153,0,1,2
87672,3,1,307155,307155,307156,0,1,2
87673,1,1,307156,307156,307157,0,1,0
87674,1,1,307157,307157,307158,0,1,0
87675,4,2,307161,307161,307163,0,2,3
87676,5,1,307166,307166,307167,0,1,3
87677,5,2,307171,307171,307173,0,2,4
87678,4,2,307175,307175,307177,0,2,2
87679,2,1,307177,307177,307178,0,1,0
87680,4,2,307181,307181,307183,0,2,3
87681,4,2,307185,307185,307187,0,2,2
87682,2,3,307187,307187,307190,0,3,0
87683,1,1,307188,307190,307191,2,3,0
87684,1,2,307189,307191,307193,2,4,0
87685,1,3,307190,307193,307196,3,6,0
87686,4,2,307194,307196,307198,2,4,0
87687,4,1,307198,307198,307199,0,1,0
87688,2,2,307200,307200,307202,0,2,1
87689,2,2,307202,307202,307204,0,2,0
87690,1,1,307203,307204,307205,1,2,0
87691,5,1,307208,307208,307209,0,1,3
87692,2,2,307210,307210,307212,0,2,1
87693,2,1,307212,307212,307213,0,1,0
87694,5,1,307217,307217,307218,0,1,4
87695,2,3,307219,307219,307222,0,3,1
87696,5,3,307224,307224,307227,0,3,2
87697,3,2,307227,307227,307229,0,2,0
87698,6,1,307233,307233,307234,0,1,4
87699,6,1,307239,307239,307240,0,1,5
87700,3,1,307242,307242,307243,0,1,2
87701,4,1,307246,307246,307247,0,1,3
87702,5,2,307251,307251,307253,0,2,4
87703,1,2,307252,307253,307255,1,3,0
87704,5,3,307257,307257,307260,0,3,2
87705,1,2,307258,307260,307262,2,4,0
87706,1,3,307259,307262,307265,3,6,0
87707,3,2,307262,307265,307267,3,5,0
87708,1,1,307263,307267,307268,4,5,0
87709,5,2,307268,307268,307270,0,2,0
87710,6,1,307274,307274,307275,0,1,4
87711,3,3,307277,307277,307280,0,3,2
87712,2,1,307279,307280,307281,1,2,0
87713,5,1,307284,307284,307285,0,1,3
87714,3,3,307287,307287,307290,0,3,2
87715,1,2,307288,307290,307292,2,4,0
87716,5,3,307293,307293,307296,0,3,1
87717,4,1,307297,307297,307298,0,1,1
87718,6,2,307303,307303,307305,0,2,5
87719,4,3,307307,307307,307310,0,3,2
87720,5,2,307312,307312,307314,0,2,2
87721,6,2,307318,307318,307320,0,2,4
87722,1,2,307319,307320,307322,1,3,0
87723,4,2,307323,307323,307325,0,2,1
87724,5,3,307328,307328,307331,0,3,3
87725,2,3,307330,307331,307334,1,4,0
87726,2,3,307332,307334,307337,2,5,0
87727,6,3,307338,307338,307341,0,3,1
87728,2,1,307340,307341,307342,1,2,0
87729,6,1,307346,307346,307347,0,1,4
87730,2,1,307348,307348,307349,0,1,1
87731,4,1,307352,307352,307353,0,1,3
87732,1,3,307353,307353,307356,0,3,0
87733,4,1,307357,307357,307358,0,1,1
87734,6,3,307363,307363,307366,0,3,5
87735,3,2,307366,307366,307368,0,2,0
87736,2,3,307368,307368,307371,0,3,0
87737,2,1,307370,307371,307372,1,2,0
87738,6,3,307376,307376,307379,0,3,4
87739,1,1,307377,307379,307380,2,3,0
87740,6,1,307383,307383,307384,0,1,3
87741,2,3,307385,307385,307388,0,3,1
87742,6,2,307391,307391,307393,0,2,3
87743,4,1,307395,307395,307396,0,1,2
87744,4,3,307399,307399,307402,0,3,3
87745,1,3,307400,307402,307405,2,5,0
87746,2,2,307402,307405,307407,3,5,0
87747,2,1,307404,307407,307408,3,4,0
87748,5,2,307409,307409,307411,0,2,1
87749,4,1,307413,307413,307414,0,1,2
87750,5,2,307418,307418,307420,0,2,4
87751,2,3,307420,307420,307423,0,3,0
87752,4,1,307424,307424,307425,0,1,1
87753,2,1,307426,307426,307427,0,1,1
87754,1,3,307427,307427,307430,0,3,0
87755,6,1,307433,307433,307434,0,1,3
87756,2,3,307435,307435,307438,0,3,1
87757,3,3,307438,307438,307441,0,3,0
87758,5,2,307443,307443,307445,0,2,2
87759,1,3,307444,307445,307448,1,4,0
87760,1,2,307445,307448,307450,3,5,0
87761,4,2,307449,307450,307452,1,3,0
87762,5,3,307454,307454,307457,0,3,2
87763,5,3,307459,307459,307462,0,3,2
87764,2,1,307461,307462,307463,1,2,0
87765,2,2,307463,307463,307465,0,2,0
87766,2,2,307465,307465,307467,0,2,0
87767,5,2,307470,307470,307472,0,2,3
87768,4,2,307474,307474,307476,0,2,2
87769,1,1,307475,307476,307477,1,2,0
87770,5,1,307480,307480,307481,0,1,3
87771,2,2,307482,307482,307484,0,2,1
87772,2,2,307484,307484,307486,0,2,0
87773,1,1,307485,307486,307487,1,2,0
87774,3,2,307488,307488,307490,0,2,1
87775,4,1,307492,307492,307493,0,1,2
87776,1,3,307493,307493,307496,0,3,0
87777,6,1,307499,307499,307500,0,1,3
87778,4,2,307503,307503,307505,0,2,3
87779,6,3,307509,307509,307512,0,3,4
87780,4,2,307513,307513,307515,0,2,1
87781,5,2,307518,307518,307520,0,2,3
87782,4,2,307522,307522,307524,0,2,2
87783,4,3,307526,307526,307529,0,3,2
87784,6,3,307532,307532,307535,0,3,3
87785,2,2,307534,307535,307537,1,3,0
87786,2,1,307536,307537,307538,1,2,0
87787,3,2,307539,307539,307541,0,2,1
87788,3,2,307542,307542,307544,0,2,1
87789,6,3,307548,307548,307551,0,3,4
87790,3,1,307551,307551,307552,0,1,0
87791,4,3,307555,307555,307558,0,3,3
87792,4,1,307559,307559,307560,0,1,1
87793,5,1,307564,307564,307565,0,1,4
87794,3,3,307567,307567,307570,0,3,2
87795,4,2,307571,307571,307573,0,2,1
87796,2,3,307573,307573,307576,0,3,0
87797,5,2,307578,307578,307580,0,2,2
87798,6,1,307584,307584,307585,0,1,4
87799,2,2,307586,307586,307588,0,2,1
87800,5,2,307591,307591,307593,0,2,3
87801,2,1,307593,307593,307594,0,1,0
87802,6,2,307599,307599,307601,0,2,5
87803,6,3,307605,307605,307608,0,3,4
87804,3,1,307608,307608,307609,0,1,0
87805,2,2,307610,307610,307612,0,2,1
87806,2,3,307612,307612,307615,0,3,0
87807,3,3,307615,307615,307618,0,3,0
87808,4,3,307619,307619,307622,0,3,1
87809,1,2,307620,307622,307624,2,4,0
87810,1,3,307621,307624,307627,3,6,0
87811,4,3,307625,307627,307630,2,5,0
87812,3,3,307628,307630,307633,2,5,0
87813,2,1,307630,307633,307634,3,4,0
87814,4,3,307634,307634,307637,0,3,0
87815,2,3,307636,307637,307640,1,4,0
87816,2,2,307638,307640,307642,2,4,0
87817,2,3,307640,307642,307645,2,5,0
87818,2,3,307642,307645,307648,3,6,0
87819,6,3,307648,307648,307651,0,3,0
87820,1,2,307649,307651,307653,2,4,0
87821,1,1,307650,307653,307654,3,4,0
87822,2,2,307652,307654,307656,2,4,0
87823,6,3,307658,307658,307661,0,3,2
87824,3,3,307661,307661,307664,0,3,0
87825,2,3,307663,307664,307667,1,4,0
87826,4,2,307667,307667,307669,0,2,0
87827,3,1,307670,307670,307671,0,1,1
87828,1,2,307671,307671,307673,0,2,0
87829,4,1,307675,307675,307676,0,1,2
87830,3,2,307678,307678,307680,0,2,2
87831,2,1,307680,307680,307681,0,1,0
87832,3,1,307683,307683,307684,0,1,2
87833,2,2,307685,307685,307687,0,2,1
87834,6,3,307691,307691,307694,0,3,4
87835,1,1,307692,307694,307695,2,3,0
87836,1,2,307693,307695,307697,2,4,0
87837,3,2,307696,307697,307699,1,3,0
87838,2,1,307698,307699,307700,1,2,0
87839,6,2,307704,307704,307706,0,2,4
87840,6,3,307710,307710,307713,0,3,4
87841,3,2,307713,307713,307715,0,2,0
87842,3,2,307716,307716,307718,0,2,1
87843,4,3,307720,307720,307723,0,3,2
87844,2,2,307722,307723,307725,1,3,0
87845,2,3,307724,307725,307728,1,4,0
87846,2,2,307726,307728,307730,2,4,0
87847,2,1,307728,307730,307731,2,3,0
87848,5,3,307733,307733,307736,0,3,2
87849,2,3,307735,307736,307739,1,4,0
87850,6,2,307741,307741,307743,0,2,2
87851,5,3,307746,307746,307749,0,3,3
87852,5,3,307751,307751,307754,0,3,2
87853,2,3,307753,307754,307757,1,4,0
87854,5,2,307758,307758,307760,0,2,1
87855,4,1,307762,307762,307763,0,1,2
87856,5,3,307767,307767,307770,0,3,4
87857,6,1,307773,307773,307774,0,1,3
87858,5,2,307778,307778,307780,0,2,4
87859,1,3,307779,307780,307783,1,4,0
87860,2,1,307781,307783,307784,2,3,0
87861,2,3,307783,307784,307787,1,4,0
87862,2,2,307785,307787,307789,2,4,0
87863,2,1,307787,307789,307790,2,3,0
87864,6,3,307793,307793,307796,0,3,3
87865,1,1,307794,307796,307797,2,3,0
87866,3,2,307797,307797,307799,0,2,0
87867,4,2,307801,307801,307803,0,2,2
87868,6,2,307807,307807,307809,0,2,4
87869,3,3,307810,307810,307813,0,3,1
87870,6,2,307816,307816,307818,0,2,3
87871,5,3,307821,307821,307824,0,3,3
87872,4,3,307825,307825,307828,0,3,1
87873,3,1,307828,307828,307829,0,1,0
87874,5,2,307833,307833,307835,0,2,4
87875,1,3,307834,307835,307838,1,4,0
87876,5,2,307839,307839,307841,0,2,1
87877,4,3,307843,307843,307846,0,3,2
87878,1,1,307844,307846,307847,2,3,0
87879,2,1,307846,307847,307848,1,2,0
87880,4,3,307850,307850,307853,0,3,2
87881,1,3,307851,307853,307856,2,5,0
87882,2,1,307853,307856,307857,3,4,0
87883,3,2,307856,307857,307859,1,3,0
87884,6,2,307862,307862,307864,0,2,3
87885,3,2,307865,307865,307867,0,2,1
87886,1,3,307866,307867,307870,1,4,0
87887,3,3,307869,307870,307873,1,4,0
87888,6,1,307875,307875,307876,0,1,2
87889,5,2,307880,307880,307882,0,2,4
87890,2,2,307882,307882,307884,0,2,0
87891,5,2,307887,307887,307889,0,2,3
87892,2,2,307889,307889,307891,0,2,0
87893,4,2,307893,307893,307895,0,2,2
87894,1,2,307894,307895,307897,1,3,0
87895,1,3,307895,307897,307900,2,5,0
87896,3,3,307898,307900,307903,2,5,0
87897,4,3,307902,307903,307906,1,4,0
87898,2,2,307904,307906,307908,2,4,0
87899,1,1,307905,307908,307909,3,4,0
87900,6,1,307911,307911,307912,0,1,2
87901,1,1,307912,307912,307913,0,1,0
87902,2,3,307914,307914,307917,0,3,1
87903,3,3,307917,307917,307920,0,3,0
87904,5,3,307922,307922,307925,0,3,2
87905,1,3,307923,307925,307928,2,5,0
87906,3,2,307926,307928,307930,2,4,0
87907,5,3,307931,307931,307934,0,3,1
87908,6,1,307937,307937,307938,0,1,3
87909,4,2,307941,307941,307943,0,2,3
87910,1,3,307942,307943,307946,1,4,0
87911,2,2,307944,307946,307948,2,4,0
87912,3,2,307947,307948,307950,1,3,0
87913,5,1,307952,307952,307953,0,1,2
87914,2,2,307954,307954,307956,0,2,1
87915,3,3,307957,307957,307960,0,3,1
87916,6,3,307963,307963,307966,0,3,3
87917,2,1,307965,307966,307967,1,2,0
87918,2,3,307967,307967,307970,0,3,0
87919,5,1,307972,307972,307973,0,1,2
87920,5,2,307977,307977,307979,0,2,4
87921,4,1,307981,307981,307982,0,1,2
87922,3,3,307984,307984,307987,0,3,2
87923,1,2,307985,307987,307989,2,4,0
87924,4,2,307989,307989,307991,0,2,0
87925,6,1,307995,307995,307996,0,1,4
87926,5,2,308000,308000,308002,0,2,4
87927,5,3,308005,308005,308008,0,3,3
87928,3,2,308008,308008,308010,0,2,0
87929,4,3,308012,308012,308015,0,3,2
87930,1,2,308013,308015,308017,2,4,0
87931,4,1,308017,308017,308018,0,1,0
87932,6,2,308023,308023,308025,0,2,5
87933,3,1,308026,308026,308027,0,1,1
87934,6,2,308032,308032,308034,0,2,5
87935,6,2,308038,308038,308040,0,2,4
87936,1,3,308039,308040,308043,1,4,0
87937,2,1,308041,308043,308044,2,3,0
87938,3,3,308044,308044,308047,0,3,0
87939,1,3,308045,308047,308050,2,5,0
87940,6,2,308051,308051,308053,0,2,1
87941,3,2,308054,308054,308056,0,2,1
87942,3,2,308057,308057,308059,0,2,1
87943,1,3,308058,308059,308062,1,4,0
87944,4,1,308062,308062,308063,0,1,0
87945,2,3,308064,308064,308067,0,3,1
87946,5,1,308069,308069,308070,0,1,2
87947,2,1,308071,308071,308072,0,1,1
87948,6,2,308077,308077,308079,0,2,5
87949,1,2,308078,308079,308081,1,3,0
87950,3,2,308081,308081,308083,0,2,0
87951,6,1,308087,308087,308088,0,1,4
87952,1,3,308088,308088,308091,0,3,0
87953,3,3,308091,308091,308094,0,3,0
87954,3,1,308094,308094,308095,0,1,0
87955,3,2,308097,308097,308099,0,2,2
87956,4,1,308101,308101,308102,0,1,2
87957,3,3,308104,308104,308107,0,3,2
87958,5,2,308109,308109,308111,0,2,2
87959,5,1,308114,308114,308115,0,1,3
87960,6,2,308120,308120,308122,0,2,5
87961,6,1,308126,308126,308127,0,1,4
87962,2,1,308128,308128,308129,0,1,1
87963,6,3,308134,308134,308137,0,3,5
87964,5,1,308139,308139,308140,0,1,2
87965,5,1,308144,308144,308145,0,1,4
87966,4,2,308148,308148,308150,0,2,3
87967,3,3,308151,308151,308154,0,3,1
87968,6,3,308157,308157,308160,0,3,3
87969,1,2,308158,308160,308162,2,4,0
87970,1,1,308159,308162,308163,3,4,0
87971,2,2,308161,308163,308165,2,4,0
87972,1,1,308162,308165,308166,3,4,0
87973,1,3,308163,308166,308169,3,6,0
87974,3,1,308166,308169,308170,3,4,0
87975,5,1,308171,308171,308172,0,1,1
87976,4,3,308175,308175,308178,0,3,3
87977,3,2,308178,308178,308180,0,2,0
87978,1,2,308179,308180,308182,1,3,0
87979,2,1,308181,308182,308183,1,2,0
87980,2,1,308183,308183,308184,0,1,0
87981,1,1,308184,308184,308185,0,1,0
87982,3,2,308187,308187,308189,0,2,2
87983,2,2,308189,308189,308191,0,2,0
87984,3,2,308192,308192,308194,0,2,1
87985,6,2,308198,308198,308200,0,2,4
87986,2,3,308200,308200,308203,0,3,0
87987,1,3,308201,308203,308206,2,5,0
87988,5,3,308206,308206,308209,0,3,0
87989,4,2,308210,308210,308212,0,2,1
87990,1,1,308211,308212,308213,1,2,0
87991,2,3,308213,308213,308216,0,3,0
87992,4,2,308217,308217,308219,0,2,1
87993,2,3,308219,308219,308222,0,3,0
87994,5,2,308224,308224,308226,0,2,2
87995,5,1,308229,308229,308230,0,1,3
87996,4,2,308233,308233,308235,0,2,3
87997,1,2,308234,308235,308237,1,3,0
87998,4,1,308238,308238,308239,0,1,1
87999,5,3,308243,308243,308246,0,3,4
88000,4,3,308247,308247,308250,0,3,1
88001,4,3,308251,308251,308254,0,3,1
88002,5,2,308256,308256,308258,0,2,2
88003,5,2,308261,308261,308263,0,2,3
88004,1,2,308262,308263,308265,1,3,0
88005,1,3,308263,308265,308268,2,5,0
88006,1,3,308264,308268,308271,4,7,0
88007,4,1,308268,308271,308272,3,4,0
88008,2,3,308270,308272,308275,2,5,0
88009,2,1,308272,308275,308276,3,4,0
88010,3,3,308275,308276,308279,1,4,0
88011,5,2,308280,308280,308282,0,2,1
88012,3,2,308283,308283,308285,0,2,1
88013,1,3,308284,308285,308288,1,4,0
88014,2,3,308286,308288,308291,2,5,0
88015,2,1,308288,308291,308292,3,4,0
88016,4,1,308292,308292,308293,0,1,0
88017,2,1,308294,308294,308295,0,1,1
88018,6,1,308300,308300,308301,0,1,5
88019,3,1,308303,308303,308304,0,1,2
88020,5,3,308308,308308,308311,0,3,4
88021,1,1,308309,308311,308312,2,3,0
88022,1,3,308310,308312,308315,2,5,0
88023,6,3,308316,308316,308319,0,3,1
88024,5,2,308321,308321,308323,0,2,2
88025,6,2,308327,308327,308329,0,2,4
88026,3,3,308330,308330,308333,0,3,1
88027,6,1,308336,308336,308337,0,1,3
88028,1,1,308337,308337,308338,0,1,0
88029,3,3,308340,308340,308343,0,3,2
88030,1,3,308341,308343,308346,2,5,0
88031,3,3,308344,308346,308349,2,5,0
88032,5,3,308349,308349,308352,0,3,0
88033,3,3,308352,308352,308355,0,3,0
88034,6,3,308358,308358,308361,0,3,3
88035,1,2,308359,308361,308363,2,4,0
88036,4,2,308363,308363,308365,0,2,0
88037,4,1,308367,308367,308368,0,1,2
88038,5,1,308372,308372,308373,0,1,4
88039,5,2,308377,308377,308379,0,2,4
88040,6,3,308383,308383,308386,0,3,4
88041,1,3,308384,308386,308389,2,5,0
88042,2,2,308386,308389,308391,3,5,0
88043,5,2,308391,308391,308393,0,2,0
88044,6,3,308397,308397,308400,0,3,4
88045,5,1,308402,308402,308403,0,1,2
88046,6,3,308408,308408,308411,0,3,5
88047,3,1,308411,308411,308412,0,1,0
88048,5,1,308416,308416,308417,0,1,4
88049,6,3,308422,308422,308425,0,3,5
88050,3,2,308425,308425,308427,0,2,0
88051,3,3,308428,308428,308431,0,3,1
88052,4,2,308432,308432,308434,0,2,1
88053,6,1,308438,308438,308439,0,1,4
88054,1,2,308439,308439,308441,0,2,0
88055,5,1,308444,308444,308445,0,1,3
88056,6,2,308450,308450,308452,0,2,5
88057,5,3,308455,308455,308458,0,3,3
88058,5,2,308460,308460,308462,0,2,2
88059,6,3,308466,308466,308469,0,3,4
88060,3,1,308469,308469,308470,0,1,0
88061,3,3,308472,308472,308475,0,3,2
88062,5,3,308477,308477,308480,0,3,2
88063,4,3,308481,308481,308484,0,3,1
88064,2,2,308483,308484,308486,1,3,0
88065,3,3,308486,308486,308489,0,3,0
88066,5,1,308491,308491,308492,0,1,2
88067,1,3,308492,308492,308495,0,3,0
88068,2,2,308494,308495,308497,1,3,0
88069,6,1,308500,308500,308501,0,1,3
88070,6,1,308506,308506,308507,0,1,5
88071,5,1,308511,308511,308512,0,1,4
88072,6,3,308517,308517,308520,0,3,5
88073,2,1,308519,308520,308521,1,2,0
88074,3,2,308522,308522,308524,0,2,1
88075,5,1,308527,308527,308528,0,1,3
88076,3,1,308530,308530,308531,0,1,2
88077,4,3,308534,308534,308537,0,3,3
88078,5,1,308539,308539,308540,0,1,2
88079,5,1,308544,308544,308545,0,1,4
88080,5,3,308549,308549,308552,0,3,4
88081,6,1,308555,308555,308556,0,1,3
88082,1,1,308556,308556,308557,0,1,0
88083,5,2,308561,308561,308563,0,2,4
88084,1,2,308562,308563,308565,1,3,0
88085,6,3,308568,308568,308571,0,3,3
88086,3,2,308571,308571,308573,0,2,0
88087,6,3,308577,308577,308580,0,3,4
88088,5,1,308582,308582,308583,0,1,2
88089,1,3,308583,308583,308586,0,3,0
88090,5,1,308588,308588,308589,0,1,2
88091,6,1,308594,308594,308595,0,1,5
88092,1,3,308595,308595,308598,0,3,0
88093,2,3,308597,308598,308601,1,4,0
88094,4,2,308601,308601,308603,0,2,0
88095,6,2,308607,308607,308609,0,2,4
88096,1,2,308608,308609,308611,1,3,0
88097,4,3,308612,308612,308615,0,3,1
88098,6,1,308618,308618,308619,0,1,3
88099,6,2,308624,308624,308626,0,2,5
88100,6,1,308630,308630,308631,0,1,4
88101,4,2,308634,308634,308636,0,2,3
88102,3,2,308637,308637,308639,0,2,1
88103,1,1,308638,308639,308640,1,2,0
88104,4,3,308642,308642,308645,0,3,2
88105,6,3,308648,308648,308651,0,3,3
88106,2,3,308650,308651,308654,1,4,0
88107,6,2,308656,308656,308658,0,2,2
88108,5,3,308661,308661,308664,0,3,3
88109,1,3,308662,308664,308667,2,5,0
88110,1,2,308663,308667,308669,4,6,0
88111,1,3,308664,308669,308672,5,8,0
88112,1,3,308665,308672,308675,7,10,0
88113,1,3,308666,308675,308678,9,12,0
88114,3,1,308669,308678,308679,9,10,0
88115,3,3,308672,308679,308682,7,10,0
88116,6,2,308678,308682,308684,4,6,0
88117,1,1,308679,308684,308685,5,6,0
88118,4,3,308683,308685,308688,2,5,0
88119,4,2,308687,308688,308690,1,3,0
88120,1,3,308688,308690,308693,2,5,0
88121,4,2,308692,308693,308695,1,3,0
88122,2,1,308694,308695,308696,1,2,0
88123,2,2,308696,308696,308698,0,2,0
88124,3,2,308699,308699,308701,0,2,1
88125,6,3,308705,308705,308708,0,3,4
88126,4,3,308709,308709,308712,0,3,1
88127,4,3,308713,308713,308716,0,3,1
88128,5,1,308718,308718,308719,0,1,2
88129,2,1,308720,308720,308721,0,1,1
88130,3,2,308723,308723,308725,0,2,2
88131,3,3,308726,308726,308729,0,3,1
88132,5,1,308731,308731,308732,0,1,2
88133,5,1,308736,308736,308737,0,1,4
88134,3,2,308739,308739,308741,0,2,2
88135,4,2,308743,308743,308745,0,2,2
88136,5,3,308748,308748,308751,0,3,3
88137,4,3,308752,308752,308755,0,3,1
88138,3,1,308755,308755,308756,0,1,0
88139,2,1,308757,308757,308758,0,1,1
88140,3,2,308760,308760,308762,0,2,2
88141,3,1,308763,308763,308764,0,1,1
88142,6,1,308769,308769,308770,0,1,5
88143,1,3,308770,308770,308773,0,3,0
88144,3,2,308773,308773,308775,0,2,0
88145,4,3,308777,308777,308780,0,3,2
88146,6,1,308783,308783,308784,0,1,3
88147,1,2,308784,308784,308786,0,2,0
88148,5,3,308789,308789,308792,0,3,3
88149,4,1,308793,308793,308794,0,1,1
88150,5,2,308798,308798,308800,0,2,4
88151,6,1,308804,308804,308805,0,1,4
88152,4,2,308808,308808,308810,0,2,3
88153,1,2,308809,308810,308812,1,3,0
88154,5,1,308814,308814,308815,0,1,2
88155,3,3,308817,308817,308820,0,3,2
88156,3,1,308820,308820,308821,0,1,0
88157,5,1,308825,308825,308826,0,1,4
88158,2,1,308827,308827,308828,0,1,1
88159,6,3,308833,308833,308836,0,3,5
88160,4,2,308837,308837,308839,0,2,1
88161,1,1,308838,308839,308840,1,2,0
88162,3,1,308841,308841,308842,0,1,1
88163,5,2,308846,308846,308848,0,2,4
88164,5,2,308851,308851,308853,0,2,3
88165,3,3,308854,308854,308857,0,3,1
88166,4,3,308858,308858,308861,0,3,1
88167,1,3,308859,308861,308864,2,5,0
88168,4,3,308863,308864,308867,1,4,0
88169,2,1,308865,308867,308868,2,3,0
88170,2,2,308867,308868,308870,1,3,0
88171,5,3,308872,308872,308875,0,3,2
88172,1,2,308873,308875,308877,2,4,0
88173,6,1,308879,308879,308880,0,1,2
88174,3,2,308882,308882,308884,0,2,2
88175,1,3,308883,308884,308887,1,4,0
88176,1,1,308884,308887,308888,3,4,0
88177,4,1,308888,308888,308889,0,1,0
88178,6,2,308894,308894,308896,0,2,5
88179,4,2,308898,308898,308900,0,2,2
88180,1,1,308899,308900,308901,1,2,0
88181,2,1,308901,308901,308902,0,1,0
88182,5,1,308906,308906,308907,0,1,4
88183,6,3,308912,308912,308915,0,3,5
88184,5,2,308917,308917,308919,0,2,2
88185,2,2,308919,308919,308921,0,2,0
88186,1,2,308920,308921,308923,1,3,0
88187,3,3,308923,308923,308926,0,3,0
88188,5,2,308928,308928,308930,0,2,2
88189,4,3,308932,308932,308935,0,3,2
88190,3,1,308935,308935,308936,0,1,0
88191,6,2,308941,308941,308943,0,2,5
88192,5,1,308946,308946,308947,0,1,3
88193,1,2,308947,308947,308949,0,2,0
88194,3,3,308950,308950,308953,0,3,1
88195,4,1,308954,308954,308955,0,1,1
88196,4,1,308958,308958,308959,0,1,3
88197,4,2,308962,308962,308964,0,2,3
88198,3,1,308965,308965,308966,0,1,1
88199,6,1,308971,308971,308972,0,1,5
88200,4,1,308975,308975,308976,0,1,3
88201,6,3,308981,308981,308984,0,3,5
88202,5,1,308986,308986,308987,0,1,2
88203,5,2,308991,308991,308993,0,2,4
88204,1,2,308992,308993,308995,1,3,0
88205,6,1,308998,308998,308999,0,1,3
88206,3,3,309001,309001,309004,0,3,2
88207,2,3,309003,309004,309007,1,4,0
88208,2,1,309005,309007,309008,2,3,0
88209,5,2,309010,309010,309012,0,2,2
88210,3,3,309013,309013,309016,0,3,1
88211,3,3,309016,309016,309019,0,3,0
88212,5,1,309021,309021,309022,0,1,2
88213,3,2,309024,309024,309026,0,2,2
88214,5,3,309029,309029,309032,0,3,3
88215,1,1,309030,309032,309033,2,3,0
88216,4,1,309034,309034,309035,0,1,1
88217,3,3,309037,309037,309040,0,3,2
88218,1,3,309038,309040,309043,2,5,0
88219,2,1,309040,309043,309044,3,4,0
88220,1,1,309041,309044,309045,3,4,0
88221,5,3,309046,309046,309049,0,3,1
88222,5,2,309051,309051,309053,0,2,2
88223,4,2,309055,309055,309057,0,2,2
88224,4,1,309059,309059,309060,0,1,2
88225,4,3,309063,309063,309066,0,3,3
88226,1,2,309064,309066,309068,2,4,0
88227,3,3,309067,309068,309071,1,4,0
88228,2,2,309069,309071,309073,2,4,0
88229,5,2,309074,309074,309076,0,2,1
88230,4,2,309078,309078,309080,0,2,2
88231,3,1,309081,309081,309082,0,1,1
88232,5,2,309086,309086,309088,0,2,4
88233,5,3,309091,309091,309094,0,3,3
88234,6,2,309097,309097,309099,0,2,3
88235,3,3,309100,309100,309103,0,3,1
88236,3,1,309103,309103,309104,0,1,0
88237,2,1,309105,309105,309106,0,1,1
88238,2,3,309107,309107,309110,0,3,1
88239,6,3,309113,309113,309116,0,3,3
88240,3,3,309116,309116,309119,0,3,0
88241,5,1,309121,309121,309122,0,1,2
88242,1,1,309122,309122,309123,0,1,0
88243,1,2,309123,309123,309125,0,2,0
88244,5,1,309128,309128,309129,0,1,3
88245,2,3,309130,309130,309133,0,3,1
88246,6,1,309136,309136,309137,0,1,3
88247,6,1,309142,309142,309143,0,1,5
88248,5,1,309147,309147,309148,0,1,4
88249,5,2,309152,309152,309154,0,2,4
88250,1,1,309153,309154,309155,1,2,0
88251,5,2,309158,309158,309160,0,2,3
88252,1,2,309159,309160,309162,1,3,0
88253,2,2,309161,309162,309164,1,3,0
88254,2,1,309163,309164,309165,1,2,0
88255,6,3,309169,309169,309172,0,3,4
88256,2,2,309171,309172,309174,1,3,0
88257,3,1,309174,309174,309175,0,1,0
88258,6,2,309180,309180,309182,0,2,5
88259,6,2,309186,309186,309188,0,2,4
88260,6,3,309192,309192,309195,0,3,4
88261,5,3,309197,309197,309200,0,3,2
88262,4,1,309201,309201,309202,0,1,1
88263,3,3,309204,309204,309207,0,3,2
88264,3,2,309207,309207,309209,0,2,0
88265,2,1,309209,309209,309210,0,1,0
88266,4,3,309213,309213,309216,0,3,3
88267,1,2,309214,309216,309218,2,4,0
88268,5,1,309219,309219,309220,0,1,1
88269,6,1,309225,309225,309226,0,1,5
88270,4,3,309229,309229,309232,0,3,3
88271,3,1,309232,309232,309233,0,1,0
88272,4,2,309236,309236,309238,0,2,3
88273,2,1,309238,309238,309239,0,1,0
88274,2,2,309240,309240,309242,0,2,1
88275,4,3,309244,309244,309247,0,3,2
88276,5,1,309249,309249,309250,0,1,2
88277,5,2,309254,309254,309256,0,2,4
88278,2,3,309256,309256,309259,0,3,0
88279,6,3,309262,309262,309265,0,3,3
88280,5,3,309267,309267,309270,0,3,2
88281,6,1,309273,309273,309274,0,1,3
88282,2,3,309275,309275,309278,0,3,1
88283,2,3,309277,309278,309281,1,4,0
88284,5,3,309282,309282,309285,0,3,1
88285,5,1,309287,309287,309288,0,1,2
88286,1,2,309288,309288,309290,0,2,0
88287,5,3,309293,309293,309296,0,3,3
88288,6,1,309299,309299,309300,0,1,3
88289,1,3,309300,309300,309303,0,3,0
88290,5,3,309305,309305,309308,0,3,2
88291,2,1,309307,309308,309309,1,2,0
88292,4,3,309311,309311,309314,0,3,2
88293,1,3,309312,309314,309317,2,5,0
88294,1,2,309313,309317,309319,4,6,0
88295,6,1,309319,309319,309320,0,1,0
88296,4,3,309323,309323,309326,0,3,3
88297,2,1,309325,309326,309327,1,2,0
88298,5,2,309330,309330,309332,0,2,3
88299,6,1,309336,309336,309337,0,1,4
88300,4,2,309340,309340,309342,0,2,3
88301,5,2,309345,309345,309347,0,2,3
88302,5,3,309350,309350,309353,0,3,3
88303,1,1,309351,309353,309354,2,3,0
88304,5,2,309356,309356,309358,0,2,2
88305,2,3,309358,309358,309361,0,3,0
88306,6,1,309364,309364,309365,0,1,3
88307,4,1,309368,309368,309369,0,1,3
88308,1,1,309369,309369,309370,0,1,0
88309,6,1,309375,309375,309376,0,1,5
88310,5,3,309380,309380,309383,0,3,4
88311,4,1,309384,309384,309385,0,1,1
88312,5,3,309389,309389,309392,0,3,4
88313,4,3,309393,309393,309396,0,3,1
88314,3,2,309396,309396,309398,0,2,0
88315,5,1,309401,309401,309402,0,1,3
88316,2,1,309403,309403,309404,0,1,1
88317,3,2,309406,309406,309408,0,2,2
88318,2,1,309408,309408,309409,0,1,0
88319,5,1,309413,309413,309414,0,1,4
88320,2,3,309415,309415,309418,0,3,1
88321,2,2,309417,309418,309420,1,3,0
88322,4,2,309421,309421,309423,0,2,1
88323,4,3,309425,309425,309428,0,3,2
88324,4,2,309429,309429,309431,0,2,1
88325,5,3,309434,309434,309437,0,3,3
88326,3,3,309437,309437,309440,0,3,0
88327,2,2,309439,309440,309442,1,3,0
88328,5,2,309444,309444,309446,0,2,2
88329,5,2,309449,309449,309451,0,2,3
88330,5,3,309454,309454,309457,0,3,3
88331,6,3,309460,309460,309463,0,3,3
88332,5,3,309465,309465,309468,0,3,2
88333,1,3,309466,309468,309471,2,5,0
88334,2,2,309468,309471,309473,3,5,0
88335,3,3,309471,309473,309476,2,5,0
88336,1,3,309472,309476,309479,4,7,0
88337,3,2,309475,309479,309481,4,6,0
88338,2,3,309477,309481,309484,4,7,0
88339,5,2,309482,309484,309486,2,4,0
88340,4,3,309486,309486,309489,0,3,0
88341,1,3,309487,309489,309492,2,5,0
88342,5,1,309492,309492,309493,0,1,0
88343,1,1,309493,309493,309494,0,1,0
88344,3,3,309496,309496,309499,0,3,2
88345,1,2,309497,309499,309501,2,4,0
88346,1,2,309498,309501,309503,3,5,0
88347,1,3,309499,309503,309506,4,7,0
88348,2,3,309501,309506,309509,5,8,0
88349,1,1,309502,309509,309510,7,8,0
88350,6,2,309508,309510,309512,2,4,0
88351,5,1,309513,309513,309514,0,1,1
88352,2,3,309515,309515,309518,0,3,1
88353,2,3,309517,309518,309521,1,4,0
88354,2,1,309519,309521,309522,2,3,0
88355,1,3,309520,309522,309525,2,5,0
88356,1,3,309521,309525,309528,4,7,0
88357,3,3,309524,309528,309531,4,7,0
88358,2,2,309526,309531,309533,5,7,0
88359,5,2,309531,309533,309535,2,4,0
88360,5,1,309536,309536,309537,0,1,1
88361,4,1,309540,309540,309541,0,1,3
88362,1,1,309541,309541,309542,0,1,0
88363,4,2,309545,309545,309547,0,2,3
88364,3,3,309548,309548,309551,0,3,1
88365,1,1,309549,309551,309552,2,3,0
88366,1,1,309550,309552,309553,2,3,0
88367,2,2,309552,309553,309555,1,3,0
88368,6,1,309558,309558,309559,0,1,3
88369,1,3,309559,309559,309562,0,3,0
88370,3,2,309562,309562,309564,0,2,0
88371,1,2,309563,309564,309566,1,3,0
88372,3,1,309566,309566,309567,0,1,0
88373,3,2,309569,309569,309571,0,2,2
88374,1,1,309570,309571,309572,1,2,0
88375,4,1,309574,309574,309575,0,1,2
88376,4,1,309578,309578,309579,0,1,3
88377,6,1,309584,309584,309585,0,1,5
88378,4,2,309588,309588,309590,0,2,3
88379,4,1,309592,309592,309593,0,1,2
88380,5,1,309597,309597,309598,0,1,4
88381,3,3,309600,309600,309603,0,3,2
88382,5,3,309605,309605,309608,0,3,2
88383,1,3,309606,309608,309611,2,5,0
88384,3,1,309609,309611,309612,2,3,0
88385,5,3,309614,309614,309617,0,3,2
88386,4,1,309618,309618,309619,0,1,1
88387,4,2,309622,309622,309624,0,2,3
88388,1,3,309623,309624,309627,1,4,0
88389,5,1,309628,309628,309629,0,1,1
88390,6,2,309634,309634,309636,0,2,5
88391,1,1,309635,309636,309637,1,2,0
88392,6,1,309641,309641,309642,0,1,4
88393,4,2,309645,309645,309647,0,2,3
88394,1,3,309646,309647,309650,1,4,0
88395,6,1,309652,309652,309653,0,1,2
88396,4,3,309656,309656,309659,0,3,3
88397,1,3,309657,309659,309662,2,5,0
88398,5,1,309662,309662,309663,0,1,0
88399,4,2,309666,309666,309668,0,2,3
88400,1,1,309667,309668,309669,1,2,0
88401,2,1,309669,309669,309670,0,1,0
88402,3,3,309672,309672,309675,0,3,2
88403,3,3,309675,309675,309678,0,3,0
88404,5,1,309680,309680,309681,0,1,2
88405,1,3,309681,309681,309684,0,3,0
88406,1,3,309682,309684,309687,2,5,0
88407,4,1,309686,309687,309688,1,2,0
88408,5,2,309691,309691,309693,0,2,3
88409,3,2,309694,309694,309696,0,2,1
88410,5,2,309699,309699,309701,0,2,3
88411,2,3,309701,309701,309704,0,3,0
88412,1,1,309702,309704,309705,2,3,0
88413,3,3,309705,309705,309708,0,3,0
88414,1,3,309706,309708,309711,2,5,0
88415,3,1,309709,309711,309712,2,3,0
88416,1,3,309710,309712,309715,2,5,0
88417,2,3,309712,309715,309718,3,6,0
88418,5,3,309717,309718,309721,1,4,0
88419,1,3,309718,309721,309724,3,6,0
88420,6,1,309724,309724,309725,0,1,0
88421,6,2,309730,309730,309732,0,2,5
88422,5,2,309735,309735,309737,0,2,3
88423,6,1,309741,309741,309742,0,1,4
88424,3,1,309744,309744,309745,0,1,2
88425,2,2,309746,309746,309748,0,2,1
88426,3,2,309749,309749,309751,0,2,1
88427,3,3,309752,309752,309755,0,3,1
88428,4,1,309756,309756,309757,0,1,1
88429,5,3,309761,309761,309764,0,3,4
88430,2,3,309763,309764,309767,1,4,0
88431,1,3,309764,309767,309770,3,6,0
88432,4,3,309768,309770,309773,2,5,0
88433,2,2,309770,309773,309775,3,5,0
88434,2,1,309772,309775,309776,3,4,0
88435,1,1,309773,309776,309777,3,4,0
88436,5,2,309778,309778,309780,0,2,1
88437,6,1,309784,309784,309785,0,1,4
88438,1,2,309785,309785,309787,0,2,0
88439,5,3,309790,309790,309793,0,3,3
88440,3,3,309793,309793,309796,0,3,0
88441,3,3,309796,309796,309799,0,3,0
88442,3,2,309799,309799,309801,0,2,0
88443,2,3,309801,309801,309804,0,3,0
88444,1,3,309802,309804,309807,2,5,0
88445,4,2,309806,309807,309809,1,3,0
88446,2,2,309808,309809,309811,1,3,0
88447,3,2,309811,309811,309813,0,2,0
88448,1,2,309812,309813,309815,1,3,0
88449,3,3,309815,309815,309818,0,3,0
88450,2,1,309817,309818,309819,1,2,0
88451,4,1,309821,309821,309822,0,1,2
88452,3,2,309824,309824,309826,0,2,2
88453,3,3,309827,309827,309830,0,3,1
88454,4,1,309831,309831,309832,0,1,1
88455,2,1,309833,309833,309834,0,1,1
88456,4,2,309837,309837,309839,0,2,3
88457,4,1,309841,309841,309842,0,1,2
88458,1,3,309842,309842,309845,0,3,0
88459,5,3,309847,309847,309850,0,3,2
88460,1,1,309848,309850,309851,2,3,0
88461,2,3,309850,309851,309854,1,4,0
88462,2,1,309852,309854,309855,2,3,0
88463,1,3,309853,309855,309858,2,5,0
88464,2,1,309855,309858,309859,3,4,0
88465,6,3,309861,309861,309864,0,3,2
88466,6,1,309867,309867,309868,0,1,3
88467,6,2,309873,309873,309875,0,2,5
88468,1,2,309874,309875,309877,1,3,0
88469,6,3,309880,309880,309883,0,3,3
88470,6,2,309886,309886,309888,0,2,3
88471,1,1,309887,309888,309889,1,2,0
88472,2,3,309889,309889,309892,0,3,0
88473,1,2,309890,309892,309894,2,4,0
88474,6,1,309896,309896,309897,0,1,2
88475,3,1,309899,309899,309900,0,1,2
88476,1,1,309900,309900,309901,0,1,0
88477,5,2,309905,309905,309907,0,2,4
88478,5,2,309910,309910,309912,0,2,3
88479,4,2,309914,309914,309916,0,2,2
88480,5,1,309919,309919,309920,0,1,3
88481,2,2,309921,309921,309923,0,2,1
88482,1,1,309922,309923,309924,1,2,0
88483,3,1,309925,309925,309926,0,1,1
88484,2,1,309927,309927,309928,0,1,1
88485,1,3,309928,309928,309931,0,3,0
88486,6,1,309934,309934,309935,0,1,3
88487,4,1,309938,309938,309939,0,1,3
88488,1,2,309939,309939,309941,0,2,0
88489,3,1,309942,309942,309943,0,1,1
88490,3,1,309945,309945,309946,0,1,2
88491,1,3,309946,309946,309949,0,3,0
88492,5,1,309951,309951,309952,0,1,2
88493,4,3,309955,309955,309958,0,3,3
88494,5,3,309960,309960,309963,0,3,2
88495,6,2,309966,309966,309968,0,2,3
88496,2,1,309968,309968,309969,0,1,0
88497,4,3,309972,309972,309975,0,3,3
88498,1,1,309973,309975,309976,2,3,0
88499,6,2,309979,309979,309981,0,2,3
88500,1,2,309980,309981,309983,1,3,0
88501,4,3,309984,309984,309987,0,3,1
88502,2,3,309986,309987,309990,1,4,0
88503,2,1,309988,309990,309991,2,3,0
88504,1,2,309989,309991,309993,2,4,0
88505,6,3,309995,309995,309998,0,3,2
88506,5,1,310000,310000,310001,0,1,2
88507,3,1,310003,310003,310004,0,1,2
88508,4,2,310007,310007,310009,0,2,3
88509,3,2,310010,310010,310012,0,2,1
88510,6,1,310016,310016,310017,0,1,4
88511,1,1,310017,310017,310018,0,1,0
88512,5,3,310022,310022,310025,0,3,4
88513,4,2,310026,310026,310028,0,2,1
88514,1,3,310027,310028,310031,1,4,0
88515,6,3,310033,310033,310036,0,3,2
88516,4,1,310037,310037,310038,0,1,1
88517,2,1,310039,310039,310040,0,1,1
88518,4,3,310043,310043,310046,0,3,3
88519,3,1,310046,310046,310047,0,1,0
88520,6,3,310052,310052,310055,0,3,5
88521,2,3,310054,310055,310058,1,4,0
88522,3,2,310057,310058,310060,1,3,0
88523,4,2,310061,310061,310063,0,2,1
88524,4,3,310065,310065,310068,0,3,2
88525,2,3,310067,310068,310071,1,4,0
88526,1,2,310068,310071,310073,3,5,0
88527,4,1,310072,310073,310074,1,2,0
88528,2,1,310074,310074,310075,0,1,0
88529,2,1,310076,310076,310077,0,1,1
88530,2,3,310078,310078,310081,0,3,1
88531,2,2,310080,310081,310083,1,3,0
88532,6,1,310086,310086,310087,0,1,3
88533,3,3,310089,310089,310092,0,3,2
88534,6,2,310095,310095,310097,0,2,3
88535,1,2,310096,310097,310099,1,3,0
88536,3,1,310099,310099,310100,0,1,0
88537,6,1,310105,310105,310106,0,1,5
88538,4,1,310109,310109,310110,0,1,3
88539,3,3,310112,310112,310115,0,3,2
88540,3,1,310115,310115,310116,0,1,0
88541,1,1,310116,310116,310117,0,1,0
88542,2,2,310118,310118,310120,0,2,1
88543,2,3,310120,310120,310123,0,3,0
88544,2,1,310122,310123,310124,1,2,0
88545,5,1,310127,310127,310128,0,1,3
88546,4,3,310131,310131,310134,0,3,3
88547,4,1,310135,310135,310136,0,1,1
88548,2,1,310137,310137,310138,0,1,1
88549,6,2,310143,310143,310145,0,2,5
88550,1,2,310144,310145,310147,1,3,0
88551,2,3,310146,310147,310150,1,4,0
88552,4,3,310150,310150,310153,0,3,0
88553,3,3,310153,310153,310156,0,3,0
88554,1,2,310154,310156,310158,2,4,0
88555,2,2,310156,310158,310160,2,4,0
88556,5,2,310161,310161,310163,0,2,1
88557,1,3,310162,310163,310166,1,4,0
88558,3,1,310165,310166,310167,1,2,0
88559,2,3,310167,310167,310170,0,3,0
88560,5,3,310172,310172,310175,0,3,2
88561,2,1,310174,310175,310176,1,2,0
88562,3,2,310177,310177,310179,0,2,1
88563,6,3,310183,310183,310186,0,3,4
88564,1,3,310184,310186,310189,2,5,0
88565,6,2,310190,310190,310192,0,2,1
88566,2,1,310192,310192,310193,0,1,0
88567,3,3,310195,310195,310198,0,3,2
88568,2,3,310197,310198,310201,1,4,0
88569,2,1,310199,310201,310202,2,3,0
88570,5,1,310204,310204,310205,0,1,2
88571,5,3,310209,310209,310212,0,3,4
88572,4,3,310213,310213,310216,0,3,1
88573,6,2,310219,310219,310221,0,2,3
88574,3,3,310222,310222,310225,0,3,1
88575,2,3,310224,310225,310228,1,4,0
88576,5,1,310229,310229,310230,0,1,1
88577,6,2,310235,310235,310237,0,2,5
88578,2,3,310237,310237,310240,0,3,0
88579,3,3,310240,310240,310243,0,3,0
88580,4,1,310244,310244,310245,0,1,1
88581,6,2,310250,310250,310252,0,2,5
88582,3,1,310253,310253,310254,0,1,1
88583,6,2,310259,310259,310261,0,2,5
88584,4,3,310263,310263,310266,0,3,2
88585,1,3,310264,310266,310269,2,5,0
88586,5,3,310269,310269,310272,0,3,0
88587,6,3,310275,310275,310278,0,3,3
88588,5,2,310280,310280,310282,0,2,2
88589,4,1,310284,310284,310285,0,1,2
88590,3,1,310287,310287,310288,0,1,2
88591,6,2,310293,310293,310295,0,2,5
88592,5,1,310298,310298,310299,0,1,3
88593,3,1,310301,310301,310302,0,1,2
88594,6,2,310307,310307,310309,0,2,5
88595,2,1,310309,310309,310310,0,1,0
88596,4,1,310313,310313,310314,0,1,3
88597,6,2,310319,310319,310321,0,2,5
88598,4,3,310323,310323,310326,0,3,2
88599,1,1,310324,310326,310327,2,3,0
88600,1,3,310325,310327,310330,2,5,0
88601,2,2,310327,310330,310332,3,5,0
88602,1,2,310328,310332,310334,4,6,0
88603,5,3,310333,310334,310337,1,4,0
88604,6,3,310339,310339,310342,0,3,2
88605,6,3,310345,310345,310348,0,3,3
88606,6,2,310351,310351,310353,0,2,3
88607,4,1,310355,310355,310356,0,1,2
88608,1,2,310356,310356,310358,0,2,0
88609,4,2,310360,310360,310362,0,2,2
88610,3,3,310363,310363,310366,0,3,1
88611,4,2,310367,310367,310369,0,2,1
88612,2,2,310369,310369,310371,0,2,0
88613,3,3,310372,310372,310375,0,3,1
88614,5,3,310377,310377,310380,0,3,2
88615,3,3,310380,310380,310383,0,3,0
88616,3,2,310383,310383,310385,0,2,0
88617,1,2,310384,310385,310387,1,3,0
88618,5,3,310389,310389,310392,0,3,2
88619,1,3,310390,310392,310395,2,5,0
88620,4,3,310394,310395,310398,1,4,0
88621,4,3,310398,310398,310401,0,3,0
88622,6,1,310404,310404,310405,0,1,3
88623,4,2,310408,310408,310410,0,2,3
88624,3,1,310411,310411,310412,0,1,1
88625,5,1,310416,310416,310417,0,1,4
88626,4,2,310420,310420,310422,0,2,3
88627,1,1,310421,310422,310423,1,2,0
88628,6,2,310427,310427,310429,0,2,4
88629,3,2,310430,310430,310432,0,2,1
88630,2,2,310432,310432,310434,0,2,0
88631,5,1,310437,310437,310438,0,1,3
88632,1,2,310438,310438,310440,0,2,0
88633,2,3,310440,310440,310443,0,3,0
88634,5,3,310445,310445,310448,0,3,2
88635,4,3,310449,310449,310452,0,3,1
88636,5,2,310454,310454,310456,0,2,2
88637,2,1,310456,310456,310457,0,1,0
88638,2,1,310458,310458,310459,0,1,1
88639,1,1,310459,310459,310460,0,1,0
88640,3,1,310462,310462,310463,0,1,2
88641,6,3,310468,310468,310471,0,3,5
88642,1,2,310469,310471,310473,2,4,0
88643,4,3,310473,310473,310476,0,3,0
88644,6,2,310479,310479,310481,0,2,3
88645,2,1,310481,310481,310482,0,1,0
88646,6,1,310487,310487,310488,0,1,5
88647,6,2,310493,310493,310495,0,2,5
88648,4,3,310497,310497,310500,0,3,2
88649,1,2,310498,310500,310502,2,4,0
88650,4,2,310502,310502,310504,0,2,0
88651,5,1,310507,310507,310508,0,1,3
88652,1,1,310508,310508,310509,0,1,0
88653,2,3,310510,310510,310513,0,3,1
88654,4,3,310514,310514,310517,0,3,1
88655,2,2,310516,310517,310519,1,3,0
88656,5,2,310521,310521,310523,0,2,2
88657,1,1,310522,310523,310524,1,2,0
88658,3,2,310525,310525,310527,0,2,1
88659,2,2,310527,310527,310529,0,2,0
88660,5,3,310532,310532,310535,0,3,3
88661,1,3,310533,310535,310538,2,5,0
88662,6,2,310539,310539,310541,0,2,1
88663,2,2,310541,310541,310543,0,2,0
88664,1,2,310542,310543,310545,1,3,0
88665,2,1,310544,310545,310546,1,2,0
88666,4,2,310548,310548,310550,0,2,2
88667,5,2,310553,310553,310555,0,2,3
88668,2,1,310555,310555,310556,0,1,0
88669,6,2,310561,310561,310563,0,2,5
88670,6,2,310567,310567,310569,0,2,4
88671,3,1,310570,310570,310571,0,1,1
88672,3,1,310573,310573,310574,0,1,2
88673,3,1,310576,310576,310577,0,1,2
88674,2,2,310578,310578,310580,0,2,1
88675,2,2,310580,310580,310582,0,2,0
88676,2,3,310582,310582,310585,0,3,0
88677,1,2,310583,310585,310587,2,4,0
88678,2,3,310585,310587,310590,2,5,0
88679,1,2,310586,310590,310592,4,6,0
88680,6,2,310592,310592,310594,0,2,0
88681,4,1,310596,310596,310597,0,1,2
88682,6,3,310602,310602,310605,0,3,5
88683,4,2,310606,310606,310608,0,2,1
88684,4,1,310610,310610,310611,0,1,2
88685,2,2,310612,310612,310614,0,2,1
88686,3,2,310615,310615,310617,0,2,1
88687,2,3,310617,310617,310620,0,3,0
88688,3,3,310620,310620,310623,0,3,0
88689,6,3,310626,310626,310629,0,3,3
88690,6,1,310632,310632,310633,0,1,3
88691,2,1,310634,310634,310635,0,1,1
88692,3,3,310637,310637,310640,0,3,2
88693,6,3,310643,310643,310646,0,3,3
88694,1,2,310644,310646,310648,2,4,0
88695,4,2,310648,310648,310650,0,2,0
88696,5,1,310653,310653,310654,0,1,3
88697,1,1,310654,310654,310655,0,1,0
88698,3,2,310657,310657,310659,0,2,2
88699,3,1,310660,310660,310661,0,1,1
88700,4,1,310664,310664,310665,0,1,3
88701,5,3,310669,310669,310672,0,3,4
88702,2,3,310671,310672,310675,1,4,0
88703,2,1,310673,310675,310676,2,3,0
88704,3,3,310676,310676,310679,0,3,0
88705,5,2,310681,310681,310683,0,2,2
88706,6,2,310687,310687,310689,0,2,4
88707,2,1,310689,310689,310690,0,1,0
88708,6,3,310695,310695,310698,0,3,5
88709,2,1,310697,310698,310699,1,2,0
88710,1,1,310698,310699,310700,1,2,0
88711,3,1,310701,310701,310702,0,1,1
88712,2,2,310703,310703,310705,0,2,1
88713,3,1,310706,310706,310707,0,1,1
88714,4,2,310710,310710,310712,0,2,3
88715,4,3,310714,310714,310717,0,3,2
88716,3,2,310717,310717,310719,0,2,0
88717,3,3,310720,310720,310723,0,3,1
88718,1,1,310721,310723,310724,2,3,0
88719,3,1,310724,310724,310725,0,1,0
88720,2,2,310726,310726,310728,0,2,1
88721,2,3,310728,310728,310731,0,3,0
88722,2,2,310730,310731,310733,1,3,0
88723,1,1,310731,310733,310734,2,3,0
88724,3,2,310734,310734,310736,0,2,0
88725,4,1,310738,310738,310739,0,1,2
88726,6,2,310744,310744,310746,0,2,5
88727,2,2,310746,310746,310748,0,2,0
88728,2,3,310748,310748,310751,0,3,0
88729,3,1,310751,310751,310752,0,1,0
88730,2,1,310753,310753,310754,0,1,1
88731,5,2,310758,310758,310760,0,2,4
88732,3,1,310761,310761,310762,0,1,1
88733,2,3,310763,310763,310766,0,3,1
88734,6,1,310769,310769,310770,0,1,3
88735,5,2,310774,310774,310776,0,2,4
88736,1,1,310775,310776,310777,1,2,0
88737,4,1,310779,310779,310780,0,1,2
88738,1,2,310780,310780,310782,0,2,0
88739,4,1,310784,310784,310785,0,1,2
88740,4,1,310788,310788,310789,0,1,3
88741,3,3,310791,310791,310794,0,3,2
88742,6,1,310797,310797,310798,0,1,3
88743,5,1,310802,310802,310803,0,1,4
88744,4,3,310806,310806,310809,0,3,3
88745,5,3,310811,310811,310814,0,3,2
88746,4,2,310815,310815,310817,0,2,1
88747,3,2,310818,310818,310820,0,2,1
88748,6,2,310824,310824,310826,0,2,4
88749,1,3,310825,310826,310829,1,4,0
88750,3,3,310828,310829,310832,1,4,0
88751,4,2,310832,310832,310834,0,2,0
88752,1,2,310833,310834,310836,1,3,0
88753,2,3,310835,310836,310839,1,4,0
88754,4,3,310839,310839,310842,0,3,0
88755,5,3,310844,310844,310847,0,3,2
88756,4,1,310848,310848,310849,0,1,1
88757,2,1,310850,310850,310851,0,1,1
88758,5,1,310855,310855,310856,0,1,4
88759,4,2,310859,310859,310861,0,2,3
88760,3,2,310862,310862,310864,0,2,1
88761,3,3,310865,310865,310868,0,3,1
88762,1,3,310866,310868,310871,2,5,0
88763,6,3,310872,310872,310875,0,3,1
88764,5,3,310877,310877,310880,0,3,2
88765,5,3,310882,310882,310885,0,3,2
88766,2,3,310884,310885,310888,1,4,0
88767,1,1,310885,310888,310889,3,4,0
88768,3,3,310888,310889,310892,1,4,0
88769,5,2,310893,310893,310895,0,2,1
88770,5,2,310898,310898,310900,0,2,3
88771,4,1,310902,310902,310903,0,1,2
88772,2,2,310904,310904,310906,0,2,1
88773,5,3,310909,310909,310912,0,3,3
88774,5,3,310914,310914,310917,0,3,2
88775,5,3,310919,310919,310922,0,3,2
88776,4,3,310923,310923,310926,0,3,1
88777,3,2,310926,310926,310928,0,2,0
88778,5,1,310931,310931,310932,0,1,3
88779,3,1,310934,310934,310935,0,1,2
88780,3,3,310937,310937,310940,0,3,2
88781,2,1,310939,310940,310941,1,2,0
88782,6,2,310945,310945,310947,0,2,4
88783,6,2,310951,310951,310953,0,2,4
88784,6,2,310957,310957,310959,0,2,4
88785,5,1,310962,310962,310963,0,1,3
88786,5,2,310967,310967,310969,0,2,4
88787,3,1,310970,310970,310971,0,1,1
88788,5,3,310975,310975,310978,0,3,4
88789,4,1,310979,310979,310980,0,1,1
88790,4,2,310983,310983,310985,0,2,3
88791,1,2,310984,310985,310987,1,3,0
88792,1,3,310985,310987,310990,2,5,0
88793,2,1,310987,310990,310991,3,4,0
88794,4,1,310991,310991,310992,0,1,0
88795,2,3,310993,310993,310996,0,3,1
88796,1,2,310994,310996,310998,2,4,0
88797,2,2,310996,310998,311000,2,4,0
88798,3,3,310999,311000,311003,1,4,0
88799,2,3,311001,311003,311006,2,5,0
88800,1,3,311002,311006,311009,4,7,0
88801,5,2,311007,311009,311011,2,4,0
88802,1,1,311008,311011,311012,3,4,0
88803,5,2,311013,311013,311015,0,2,1
88804,6,2,311019,311019,311021,0,2,4
88805,3,2,311022,311022,311024,0,2,1
88806,5,1,311027,311027,311028,0,1,3
88807,3,3,311030,311030,311033,0,3,2
88808,5,3,311035,311035,311038,0,3,2
88809,5,1,311040,311040,311041,0,1,2
88810,5,2,311045,311045,311047,0,2,4
88811,3,1,311048,311048,311049,0,1,1
88812,2,3,311050,311050,311053,0,3,1
88813,3,1,311053,311053,311054,0,1,0
88814,1,1,311054,311054,311055,0,1,0
88815,5,3,311059,311059,311062,0,3,4
88816,5,3,311064,311064,311067,0,3,2
88817,5,1,311069,311069,311070,0,1,2
88818,4,2,311073,311073,311075,0,2,3
88819,3,3,311076,311076,311079,0,3,1
88820,2,1,311078,311079,311080,1,2,0
88821,4,3,311082,311082,311085,0,3,2
88822,4,2,311086,311086,311088,0,2,1
88823,6,3,311092,311092,311095,0,3,4
88824,3,2,311095,311095,311097,0,2,0
88825,4,3,311099,311099,311102,0,3,2
88826,5,3,311104,311104,311107,0,3,2
88827,1,2,311105,311107,311109,2,4,0
88828,4,2,311109,311109,311111,0,2,0
88829,6,2,311115,311115,311117,0,2,4
88830,4,2,311119,311119,311121,0,2,2
88831,1,1,311120,311121,311122,1,2,0
88832,5,1,311125,311125,311126,0,1,3
88833,1,2,311126,311126,311128,0,2,0
88834,4,1,311130,311130,311131,0,1,2
88835,6,3,311136,311136,311139,0,3,5
88836,5,1,311141,311141,311142,0,1,2
88837,4,3,311145,311145,311148,0,3,3
88838,5,3,311150,311150,311153,0,3,2
88839,6,1,311156,311156,311157,0,1,3
88840,6,1,311162,311162,311163,0,1,5
88841,1,1,311163,311163,311164,0,1,0
88842,4,3,311167,311167,311170,0,3,3
88843,4,1,311171,311171,311172,0,1,1
88844,1,3,311172,311172,311175,0,3,0
88845,4,2,311176,311176,311178,0,2,1
88846,5,2,311181,311181,311183,0,2,3
88847,6,1,311187,311187,311188,0,1,4
88848,2,3,311189,311189,311192,0,3,1
88849,5,3,311194,311194,311197,0,3,2
88850,1,1,311195,311197,311198,2,3,0
88851,2,2,311197,311198,311200,1,3,0
88852,6,1,311203,311203,311204,0,1,3
88853,5,1,311208,311208,311209,0,1,4
88854,5,2,311213,311213,311215,0,2,4
88855,4,1,311217,311217,311218,0,1,2
88856,2,3,311219,311219,311222,0,3,1
88857,1,2,311220,311222,311224,2,4,0
88858,2,3,311222,311224,311227,2,5,0
88859,2,2,311224,311227,311229,3,5,0
88860,4,2,311228,311229,311231,1,3,0
88861,3,3,311231,311231,311234,0,3,0
88862,1,3,311232,311234,311237,2,5,0
88863,1,2,311233,311237,311239,4,6,0
88864,1,3,311234,311239,311242,5,8,0
88865,5,3,311239,311242,311245,3,6,0
88866,3,2,311242,311245,311247,3,5,0
88867,1,3,311243,311247,311250,4,7,0
88868,1,1,311244,311250,311251,6,7,0
88869,1,3,311245,311251,311254,6,9,0
88870,3,2,311248,311254,311256,6,8,0
88871,3,3,311251,311256,311259,5,8,0
88872,3,3,311254,311259,311262,5,8,0
88873,3,1,311257,311262,311263,5,6,0
88874,3,3,311260,311263,311266,3,6,0
88875,4,1,311264,311266,311267,2,3,0
88876,4,1,311268,311268,311269,0,1,1
88877,4,2,311272,311272,311274,0,2,3
88878,1,3,311273,311274,311277,1,4,0
88879,4,2,311277,311277,311279,0,2,0
88880,3,3,311280,311280,311283,0,3,1
88881,6,2,311286,311286,311288,0,2,3
88882,6,3,311292,311292,311295,0,3,4
88883,1,2,311293,311295,311297,2,4,0
88884,3,1,311296,311297,311298,1,2,0
88885,3,2,311299,311299,311301,0,2,1
88886,1,1,311300,311301,311302,1,2,0
88887,3,2,311303,311303,311305,0,2,1
88888,3,1,311306,311306,311307,0,1,1
88889,6,3,311312,311312,311315,0,3,5
88890,6,1,311318,311318,311319,0,1,3
88891,1,1,311319,311319,311320,0,1,0
88892,4,2,311323,311323,311325,0,2,3
88893,3,2,311326,311326,311328,0,2,1
88894,2,3,311328,311328,311331,0,3,0
88895,5,3,311333,311333,311336,0,3,2
88896,4,3,311337,311337,311340,0,3,1
88897,6,3,311343,311343,311346,0,3,3
88898,1,2,311344,311346,311348,2,4,0
88899,1,3,311345,311348,311351,3,6,0
88900,4,3,311349,311351,311354,2,5,0
88901,1,1,311350,311354,311355,4,5,0
88902,6,1,311356,311356,311357,0,1,1
88903,2,2,311358,311358,311360,0,2,1
88904,2,2,311360,311360,311362,0,2,0
88905,5,1,311365,311365,311366,0,1,3
88906,2,2,311367,311367,311369,0,2,1
88907,5,1,311372,311372,311373,0,1,3
88908,5,1,311377,311377,311378,0,1,4
88909,4,2,311381,311381,311383,0,2,3
88910,5,3,311386,311386,311389,0,3,3
88911,1,1,311387,311389,311390,2,3,0
88912,4,2,311391,311391,311393,0,2,1
88913,6,2,311397,311397,311399,0,2,4
88914,2,1,311399,311399,311400,0,1,0
88915,6,2,311405,311405,311407,0,2,5
88916,6,3,311411,311411,311414,0,3,4
88917,4,1,311415,311415,311416,0,1,1
88918,5,1,311420,311420,311421,0,1,4
88919,1,1,311421,311421,311422,0,1,0
88920,6,1,311427,311427,311428,0,1,5
88921,3,2,311430,311430,311432,0,2,2
88922,3,3,311433,311433,311436,0,3,1
88923,4,1,311437,311437,311438,0,1,1
88924,3,3,311440,311440,311443,0,3,2
88925,3,3,311443,311443,311446,0,3,0
88926,2,1,311445,311446,311447,1,2,0
88927,6,3,311451,311451,311454,0,3,4
88928,4,2,311455,311455,311457,0,2,1
88929,3,2,311458,311458,311460,0,2,1
88930,4,3,311462,311462,311465,0,3,2
88931,5,1,311467,311467,311468,0,1,2
88932,1,2,311468,311468,311470,0,2,0
88933,5,3,311473,311473,311476,0,3,3
88934,4,3,311477,311477,311480,0,3,1
88935,3,2,311480,311480,311482,0,2,0
88936,5,2,311485,311485,311487,0,2,3
88937,4,3,311489,311489,311492,0,3,2
88938,3,3,311492,311492,311495,0,3,0
88939,1,1,311493,311495,311496,2,3,0
88940,5,3,311498,311498,311501,0,3,2
88941,5,2,311503,311503,311505,0,2,2
88942,5,2,311508,311508,311510,0,2,3
88943,3,2,311511,311511,311513,0,2,1
88944,6,2,311517,311517,311519,0,2,4
88945,5,2,311522,311522,311524,0,2,3
88946,2,1,311524,311524,311525,0,1,0
88947,5,2,311529,311529,311531,0,2,4
88948,6,2,311535,311535,311537,0,2,4
88949,3,1,311538,311538,311539,0,1,1
88950,2,1,311540,311540,311541,0,1,1
88951,1,2,311541,311541,311543,0,2,0
88952,6,1,311547,311547,311548,0,1,4
88953,3,1,311550,311550,311551,0,1,2
88954,5,3,311555,311555,311558,0,3,4
88955,3,3,311558,311558,311561,0,3,0
88956,2,2,311560,311561,311563,1,3,0
88957,4,1,311564,311564,311565,0,1,1
88958,5,1,311569,311569,311570,0,1,4
88959,6,3,311575,311575,311578,0,3,5
88960,1,3,311576,311578,311581,2,5,0
88961,3,3,311579,311581,311584,2,5,0
88962,2,3,311581,311584,311587,3,6,0
88963,5,1,311586,311587,311588,1,2,0
88964,6,1,311592,311592,311593,0,1,4
88965,6,3,311598,311598,311601,0,3,5
88966,5,1,311603,311603,311604,0,1,2
88967,6,2,311609,311609,311611,0,2,5
88968,2,1,311611,311611,311612,0,1,0
88969,2,2,311613,311613,311615,0,2,1
88970,6,2,311619,311619,311621,0,2,4
88971,5,2,311624,311624,311626,0,2,3
88972,3,1,311627,311627,311628,0,1,1
88973,5,1,311632,311632,311633,0,1,4
88974,2,3,311634,311634,311637,0,3,1
88975,2,2,311636,311637,311639,1,3,0
88976,3,3,311639,311639,311642,0,3,0
88977,3,3,311642,311642,311645,0,3,0
88978,2,3,311644,311645,311648,1,4,0
88979,3,1,311647,311648,311649,1,2,0
88980,3,2,311650,311650,311652,0,2,1
88981,1,2,311651,311652,311654,1,3,0
88982,6,1,311657,311657,311658,0,1,3
88983,2,1,311659,311659,311660,0,1,1
88984,6,2,311665,311665,311667,0,2,5
88985,2,3,311667,311667,311670,0,3,0
88986,3,2,311670,311670,311672,0,2,0
88987,6,3,311676,311676,311679,0,3,4
88988,1,3,311677,311679,311682,2,5,0
88989,1,1,311678,311682,311683,4,5,0
88990,3,1,311681,311683,311684,2,3,0
88991,6,1,311687,311687,311688,0,1,3
88992,5,2,311692,311692,311694,0,2,4
88993,5,2,311697,311697,311699,0,2,3
88994,5,3,311702,311702,311705,0,3,3
88995,1,3,311703,311705,311708,2,5,0
88996,2,1,311705,311708,311709,3,4,0
88997,1,2,311706,311709,311711,3,5,0
88998,5,1,311711,311711,311712,0,1,0
88999,6,3,311717,311717,311720,0,3,5
89000,2,3,311719,311720,311723,1,4,0
89001,6,3,311725,311725,311728,0,3,2
89002,2,3,311727,311728,311731,1,4,0
89003,5,3,311732,311732,311735,0,3,1
89004,5,1,311737,311737,311738,0,1,2
89005,6,1,311743,311743,311744,0,1,5
89006,1,2,311744,311744,311746,0,2,0
89007,2,2,311746,311746,311748,0,2,0
89008,4,3,311750,311750,311753,0,3,2
89009,5,2,311755,311755,311757,0,2,2
89010,3,1,311758,311758,311759,0,1,1
89011,3,1,311761,311761,311762,0,1,2
89012,1,2,311762,311762,311764,0,2,0
89013,1,1,311763,311764,311765,1,2,0
89014,1,3,311764,311765,311768,1,4,0
89015,4,1,311768,311768,311769,0,1,0
89016,5,2,311773,311773,311775,0,2,4
89017,3,2,311776,311776,311778,0,2,1
89018,3,3,311779,311779,311782,0,3,1
89019,5,3,311784,311784,311787,0,3,2
89020,6,2,311790,311790,311792,0,2,3
89021,5,3,311795,311795,311798,0,3,3
89022,5,2,311800,311800,311802,0,2,2
89023,1,2,311801,311802,311804,1,3,0
89024,5,1,311806,311806,311807,0,1,2
89025,1,3,311807,311807,311810,0,3,0
89026,1,1,311808,311810,311811,2,3,0
89027,1,1,311809,311811,311812,2,3,0
89028,2,2,311811,311812,311814,1,3,0
89029,2,3,311813,311814,311817,1,4,0
89030,4,3,311817,311817,311820,0,3,0
89031,5,3,311822,311822,311825,0,3,2
89032,1,2,311823,311825,311827,2,4,0
89033,2,3,311825,311827,311830,2,5,0
89034,5,2,311830,311830,311832,0,2,0
89035,2,3,311832,311832,311835,0,3,0
89036,4,2,311836,311836,311838,0,2,1
89037,3,2,311839,311839,311841,0,2,1
89038,1,1,311840,311841,311842,1,2,0
89039,3,2,311843,311843,311845,0,2,1
89040,1,2,311844,311845,311847,1,3,0
89041,6,3,311850,311850,311853,0,3,3
89042,3,1,311853,311853,311854,0,1,0
89043,4,1,311857,311857,311858,0,1,3
89044,5,2,311862,311862,311864,0,2,4
89045,5,1,311867,311867,311868,0,1,3
89046,6,2,311873,311873,311875,0,2,5
89047,5,1,311878,311878,311879,0,1,3
89048,4,2,311882,311882,311884,0,2,3
89049,4,3,311886,311886,311889,0,3,2
89050,5,3,311891,311891,311894,0,3,2
89051,1,3,311892,311894,311897,2,5,0
89052,5,1,311897,311897,311898,0,1,0
89053,3,1,311900,311900,311901,0,1,2
89054,6,1,311906,311906,311907,0,1,5
89055,1,3,311907,311907,311910,0,3,0
89056,1,2,311908,311910,311912,2,4,0
89057,6,1,311914,311914,311915,0,1,2
89058,6,2,311920,311920,311922,0,2,5
89059,3,1,311923,311923,311924,0,1,1
89060,4,1,311927,311927,311928,0,1,3
89061,3,3,311930,311930,311933,0,3,2
89062,5,3,311935,311935,311938,0,3,2
89063,1,1,311936,311938,311939,2,3,0
89064,3,1,311939,311939,311940,0,1,0
89065,5,1,311944,311944,311945,0,1,4
89066,4,2,311948,311948,311950,0,2,3
89067,1,1,311949,311950,311951,1,2,0
89068,5,1,311954,311954,311955,0,1,3
89069,6,3,311960,311960,311963,0,3,5
89070,1,1,311961,311963,311964,2,3,0
89071,4,2,311965,311965,311967,0,2,1
89072,6,1,311971,311971,311972,0,1,4
89073,5,2,311976,311976,311978,0,2,4
89074,1,1,311977,311978,311979,1,2,0
89075,2,2,311979,311979,311981,0,2,0
89076,5,2,311984,311984,311986,0,2,3
89077,3,2,311987,311987,311989,0,2,1
89078,3,2,311990,311990,311992,0,2,1
89079,1,2,311991,311992,311994,1,3,0
89080,3,3,311994,311994,311997,0,3,0
89081,6,1,312000,312000,312001,0,1,3
89082,4,3,312004,312004,312007,0,3,3
89083,1,2,312005,312007,312009,2,4,0
89084,2,3,312007,312009,312012,2,5,0
89085,1,3,312008,312012,312015,4,7,0
89086,6,3,312014,312015,312018,1,4,0
89087,4,3,312018,312018,312021,0,3,0
89088,3,2,312021,312021,312023,0,2,0
89089,5,2,312026,312026,312028,0,2,3
89090,5,1,312031,312031,312032,0,1,3
89091,6,1,312037,312037,312038,0,1,5
89092,1,3,312038,312038,312041,0,3,0
89093,2,2,312040,312041,312043,1,3,0
89094,6,2,312046,312046,312048,0,2,3
89095,4,2,312050,312050,312052,0,2,2
89096,1,2,312051,312052,312054,1,3,0
89097,6,1,312057,312057,312058,0,1,3
89098,4,3,312061,312061,312064,0,3,3
89099,6,3,312067,312067,312070,0,3,3
89100,5,3,312072,312072,312075,0,3,2
89101,4,3,312076,312076,312079,0,3,1
89102,1,3,312077,312079,312082,2,5,0
89103,4,1,312081,312082,312083,1,2,0
89104,2,2,312083,312083,312085,0,2,0
89105,5,1,312088,312088,312089,0,1,3
89106,4,1,312092,312092,312093,0,1,3
89107,4,2,312096,312096,312098,0,2,3
89108,5,3,312101,312101,312104,0,3,3
89109,2,3,312103,312104,312107,1,4,0
89110,5,1,312108,312108,312109,0,1,1
89111,2,1,312110,312110,312111,0,1,1
89112,2,3,312112,312112,312115,0,3,1
89113,3,2,312115,312115,312117,0,2,0
89114,1,2,312116,312117,312119,1,3,0
89115,3,2,312119,312119,312121,0,2,0
89116,2,1,312121,312121,312122,0,1,0
89117,6,3,312127,312127,312130,0,3,5
89118,5,2,312132,312132,312134,0,2,2
89119,5,3,312137,312137,312140,0,3,3
89120,4,1,312141,312141,312142,0,1,1
89121,2,3,312143,312143,312146,0,3,1
89122,6,2,312149,312149,312151,0,2,3
89123,1,1,312150,312151,312152,1,2,0
89124,5,3,312155,312155,312158,0,3,3
89125,2,1,312157,312158,312159,1,2,0
89126,5,1,312162,312162,312163,0,1,3
89127,2,3,312164,312164,312167,0,3,1
89128,4,2,312168,312168,312170,0,2,1
89129,5,1,312173,312173,312174,0,1,3
89130,3,1,312176,312176,312177,0,1,2
89131,1,1,312177,312177,312178,0,1,0
89132,6,3,312183,312183,312186,0,3,5
89133,5,1,312188,312188,312189,0,1,2
89134,2,3,312190,312190,312193,0,3,1
89135,1,2,312191,312193,312195,2,4,0
89136,1,2,312192,312195,312197,3,5,0
89137,2,2,312194,312197,312199,3,5,0
89138,3,3,312197,312199,312202,2,5,0
89139,3,3,312200,312202,312205,2,5,0
89140,3,3,312203,312205,312208,2,5,0
89141,6,3,312209,312209,312212,0,3,1
89142,4,3,312213,312213,312216,0,3,1
89143,1,2,312214,312216,312218,2,4,0
89144,5,3,312219,312219,312222,0,3,1
89145,2,1,312221,312222,312223,1,2,0
89146,2,1,312223,312223,312224,0,1,0
89147,6,1,312229,312229,312230,0,1,5
89148,1,1,312230,312230,312231,0,1,0
89149,3,2,312233,312233,312235,0,2,2
89150,4,3,312237,312237,312240,0,3,2
89151,4,2,312241,312241,312243,0,2,1
89152,2,1,312243,312243,312244,0,1,0
89153,5,2,312248,312248,312250,0,2,4
89154,5,2,312253,312253,312255,0,2,3
89155,6,2,312259,312259,312261,0,2,4
89156,3,2,312262,312262,312264,0,2,1
89157,5,2,312267,312267,312269,0,2,3
89158,3,3,312270,312270,312273,0,3,1
89159,1,1,312271,312273,312274,2,3,0
89160,2,2,312273,312274,312276,1,3,0
89161,1,1,312274,312276,312277,2,3,0
89162,6,1,312280,312280,312281,0,1,3
89163,4,3,312284,312284,312287,0,3,3
89164,5,1,312289,312289,312290,0,1,2
89165,5,3,312294,312294,312297,0,3,4
89166,5,3,312299,312299,312302,0,3,2
89167,5,3,312304,312304,312307,0,3,2
89168,6,2,312310,312310,312312,0,2,3
89169,4,1,312314,312314,312315,0,1,2
89170,4,1,312318,312318,312319,0,1,3
89171,3,3,312321,312321,312324,0,3,2
89172,2,2,312323,312324,312326,1,3,0
89173,6,1,312329,312329,312330,0,1,3
89174,2,3,312331,312331,312334,0,3,1
89175,3,3,312334,312334,312337,0,3,0
89176,2,1,312336,312337,312338,1,2,0
89177,3,3,312339,312339,312342,0,3,1
89178,6,1,312345,312345,312346,0,1,3
89179,4,1,312349,312349,312350,0,1,3
89180,6,2,312355,312355,312357,0,2,5
89181,4,1,312359,312359,312360,0,1,2
89182,4,2,312363,312363,312365,0,2,3
89183,5,3,312368,312368,312371,0,3,3
89184,4,3,312372,312372,312375,0,3,1
89185,5,1,312377,312377,312378,0,1,2
89186,5,1,312382,312382,312383,0,1,4
89187,5,3,312387,312387,312390,0,3,4
89188,5,1,312392,312392,312393,0,1,2
89189,5,1,312397,312397,312398,0,1,4
89190,1,1,312398,312398,312399,0,1,0
89191,1,2,312399,312399,312401,0,2,0
89192,5,1,312404,312404,312405,0,1,3
89193,2,1,312406,312406,312407,0,1,1
89194,3,1,312409,312409,312410,0,1,2
89195,4,2,312413,312413,312415,0,2,3
89196,5,2,312418,312418,312420,0,2,3
89197,2,1,312420,312420,312421,0,1,0
89198,3,2,312423,312423,312425,0,2,2
89199,1,3,312424,312425,312428,1,4,0
89200,5,1,312429,312429,312430,0,1,1
89201,2,3,312431,312431,312434,0,3,1
89202,3,2,312434,312434,312436,0,2,0
89203,5,3,312439,312439,312442,0,3,3
89204,5,1,312444,312444,312445,0,1,2
89205,1,1,312445,312445,312446,0,1,0
89206,1,3,312446,312446,312449,0,3,0
89207,4,2,312450,312450,312452,0,2,1
89208,4,1,312454,312454,312455,0,1,2
89209,4,3,312458,312458,312461,0,3,3
89210,3,1,312461,312461,312462,0,1,0
89211,2,3,312463,312463,312466,0,3,1
89212,2,2,312465,312466,312468,1,3,0
89213,5,1,312470,312470,312471,0,1,2
89214,5,3,312475,312475,312478,0,3,4
89215,1,2,312476,312478,312480,2,4,0
89216,6,1,312482,312482,312483,0,1,2
89217,1,3,312483,312483,312486,0,3,0
89218,6,3,312489,312489,312492,0,3,3
89219,6,3,312495,312495,312498,0,3,3
89220,1,1,312496,312498,312499,2,3,0
89221,2,1,312498,312499,312500,1,2,0
89222,5,3,312503,312503,312506,0,3,3
89223,3,2,312506,312506,312508,0,2,0
89224,5,2,312511,312511,312513,0,2,3
89225,2,1,312513,312513,312514,0,1,0
89226,3,1,312516,312516,312517,0,1,2
89227,1,1,312517,312517,312518,0,1,0
89228,5,1,312522,312522,312523,0,1,4
89229,6,2,312528,312528,312530,0,2,5
89230,1,1,312529,312530,312531,1,2,0
89231,2,3,312531,312531,312534,0,3,0
89232,4,1,312535,312535,312536,0,1,1
89233,3,2,312538,312538,312540,0,2,2
89234,3,2,312541,312541,312543,0,2,1
89235,3,3,312544,312544,312547,0,3,1
89236,6,3,312550,312550,312553,0,3,3
89237,6,3,312556,312556,312559,0,3,3
89238,4,2,312560,312560,312562,0,2,1
89239,1,2,312561,312562,312564,1,3,0
89240,5,2,312566,312566,312568,0,2,2
89241,5,1,312571,312571,312572,0,1,3
89242,5,1,312576,312576,312577,0,1,4
89243,3,1,312579,312579,312580,0,1,2
89244,2,1,312581,312581,312582,0,1,1
89245,1,3,312582,312582,312585,0,3,0
89246,2,2,312584,312585,312587,1,3,0
89247,4,1,312588,312588,312589,0,1,1
89248,5,1,312593,312593,312594,0,1,4
89249,2,3,312595,312595,312598,0,3,1
89250,5,2,312600,312600,312602,0,2,2
89251,4,2,312604,312604,312606,0,2,2
89252,2,2,312606,312606,312608,0,2,0
89253,6,2,312612,312612,312614,0,2,4
89254,4,1,312616,312616,312617,0,1,2
89255,1,2,312617,312617,312619,0,2,0
89256,3,1,312620,312620,312621,0,1,1
89257,1,3,312621,312621,312624,0,3,0
89258,2,2,312623,312624,312626,1,3,0
89259,1,2,312624,312626,312628,2,4,0
89260,5,2,312629,312629,312631,0,2,1
89261,2,2,312631,312631,312633,0,2,0
89262,3,2,312634,312634,312636,0,2,1
89263,6,3,312640,312640,312643,0,3,4
89264,1,2,312641,312643,312645,2,4,0
89265,5,3,312646,312646,312649,0,3,1
89266,2,2,312648,312649,312651,1,3,0
89267,1,3,312649,312651,312654,2,5,0
89268,3,1,312652,312654,312655,2,3,0
89269,1,3,312653,312655,312658,2,5,0
89270,4,1,312657,312658,312659,1,2,0
89271,3,3,312660,312660,312663,0,3,1
89272,1,2,312661,312663,312665,2,4,0
89273,3,3,312664,312665,312668,1,4,0
89274,6,3,312670,312670,312673,0,3,2
89275,3,3,312673,312673,312676,0,3,0
89276,6,2,312679,312679,312681,0,2,3
89277,1,3,312680,312681,312684,1,4,0
89278,6,3,312686,312686,312689,0,3,2
89279,6,1,312692,312692,312693,0,1,3
89280,3,1,312695,312695,312696,0,1,2
89281,2,2,312697,312697,312699,0,2,1
89282,4,2,312701,312701,312703,0,2,2
89283,6,3,312707,312707,312710,0,3,4
89284,3,2,312710,312710,312712,0,2,0
89285,2,1,312712,312712,312713,0,1,0
89286,6,3,312718,312718,312721,0,3,5
89287,2,2,312720,312721,312723,1,3,0
89288,5,2,312725,312725,312727,0,2,2
89289,2,3,312727,312727,312730,0,3,0
89290,3,3,312730,312730,312733,0,3,0
89291,3,1,312733,312733,312734,0,1,0
89292,6,3,312739,312739,312742,0,3,5
89293,2,2,312741,312742,312744,1,3,0
89294,1,3,312742,312744,312747,2,5,0
89295,3,1,312745,312747,312748,2,3,0
89296,1,1,312746,312748,312749,2,3,0
89297,6,1,312752,312752,312753,0,1,3
89298,1,1,312753,312753,312754,0,1,0
89299,3,3,312756,312756,312759,0,3,2
89300,3,1,312759,312759,312760,0,1,0
89301,5,3,312764,312764,312767,0,3,4
89302,2,2,312766,312767,312769,1,3,0
89303,4,2,312770,312770,312772,0,2,1
89304,1,2,312771,312772,312774,1,3,0
89305,5,3,312776,312776,312779,0,3,2
89306,4,1,312780,312780,312781,0,1,1
89307,2,3,312782,312782,312785,0,3,1
89308,3,3,312785,312785,312788,0,3,0
89309,6,2,312791,312791,312793,0,2,3
89310,6,1,312797,312797,312798,0,1,4
89311,2,2,312799,312799,312801,0,2,1
89312,2,2,312801,312801,312803,0,2,0
89313,1,3,312802,312803,312806,1,4,0
89314,4,2,312806,312806,312808,0,2,0
89315,6,3,312812,312812,312815,0,3,4
89316,5,3,312817,312817,312820,0,3,2
89317,5,3,312822,312822,312825,0,3,2
89318,2,2,312824,312825,312827,1,3,0
89319,3,2,312827,312827,312829,0,2,0
89320,3,1,312830,312830,312831,0,1,1
89321,3,3,312833,312833,312836,0,3,2
89322,1,3,312834,312836,312839,2,5,0
89323,5,2,312839,312839,312841,0,2,0
89324,6,3,312845,312845,312848,0,3,4
89325,6,3,312851,312851,312854,0,3,3
89326,5,2,312856,312856,312858,0,2,2
89327,1,3,312857,312858,312861,1,4,0
89328,3,3,312860,312861,312864,1,4,0
89329,5,2,312865,312865,312867,0,2,1
89330,2,2,312867,312867,312869,0,2,0
89331,5,2,312872,312872,312874,0,2,3
89332,6,3,312878,312878,312881,0,3,4
89333,6,2,312884,312884,312886,0,2,3
89334,5,2,312889,312889,312891,0,2,3
89335,2,2,312891,312891,312893,0,2,0
89336,6,3,312897,312897,312900,0,3,4
89337,2,2,312899,312900,312902,1,3,0
89338,6,3,312905,312905,312908,0,3,3
89339,1,3,312906,312908,312911,2,5,0
89340,3,2,312909,312911,312913,2,4,0
89341,6,1,312915,312915,312916,0,1,2
89342,2,2,312917,312917,312919,0,2,1
89343,5,2,312922,312922,312924,0,2,3
89344,5,2,312927,312927,312929,0,2,3
89345,3,2,312930,312930,312932,0,2,1
89346,4,3,312934,312934,312937,0,3,2
89347,2,1,312936,312937,312938,1,2,0
89348,5,1,312941,312941,312942,0,1,3
89349,1,1,312942,312942,312943,0,1,0
89350,6,2,312948,312948,312950,0,2,5
89351,3,3,312951,312951,312954,0,3,1
89352,1,1,312952,312954,312955,2,3,0
89353,4,1,312956,312956,312957,0,1,1
89354,6,3,312962,312962,312965,0,3,5
89355,6,3,312968,312968,312971,0,3,3
89356,4,1,312972,312972,312973,0,1,1
89357,1,2,312973,312973,312975,0,2,0
89358,4,2,312977,312977,312979,0,2,2
89359,3,2,312980,312980,312982,0,2,1
89360,4,3,312984,312984,312987,0,3,2
89361,5,3,312989,312989,312992,0,3,2
89362,1,1,312990,312992,312993,2,3,0
89363,6,2,312996,312996,312998,0,2,3
89364,4,1,313000,313000,313001,0,1,2
89365,2,2,313002,313002,313004,0,2,1
89366,2,2,313004,313004,313006,0,2,0
89367,4,3,313008,313008,313011,0,3,2
89368,4,3,313012,313012,313015,0,3,1
89369,6,2,313018,313018,313020,0,2,3
89370,6,3,313024,313024,313027,0,3,4
89371,6,1,313030,313030,313031,0,1,3
89372,3,2,313033,313033,313035,0,2,2
89373,1,3,313034,313035,313038,1,4,0
89374,4,3,313038,313038,313041,0,3,0
89375,1,1,313039,313041,313042,2,3,0
89376,1,1,313040,313042,313043,2,3,0
89377,2,2,313042,313043,313045,1,3,0
89378,2,2,313044,313045,313047,1,3,0
89379,4,1,313048,313048,313049,0,1,1
89380,2,2,313050,313050,313052,0,2,1
89381,1,1,313051,313052,313053,1,2,0
89382,2,1,313053,313053,313054,0,1,0
89383,6,2,313059,313059,313061,0,2,5
89384,3,3,313062,313062,313065,0,3,1
89385,3,2,313065,313065,313067,0,2,0
89386,6,2,313071,313071,313073,0,2,4
89387,6,3,313077,313077,313080,0,3,4
89388,1,3,313078,313080,313083,2,5,0
89389,2,3,313080,313083,313086,3,6,0
89390,1,1,313081,313086,313087,5,6,0
89391,3,2,313084,313087,313089,3,5,0
89392,3,1,313087,313089,313090,2,3,0
89393,6,2,313093,313093,313095,0,2,3
89394,4,2,313097,313097,313099,0,2,2
89395,5,3,313102,313102,313105,0,3,3
89396,4,2,313106,313106,313108,0,2,1
89397,5,3,313111,313111,313114,0,3,3
89398,3,1,313114,313114,313115,0,1,0
89399,6,3,313120,313120,313123,0,3,5
89400,5,1,313125,313125,313126,0,1,2
89401,3,2,313128,313128,313130,0,2,2
89402,5,1,313133,313133,313134,0,1,3
89403,4,3,313137,313137,313140,0,3,3
89404,2,1,313139,313140,313141,1,2,0
89405,2,3,313141,313141,313144,0,3,0
89406,3,1,313144,313144,313145,0,1,0
89407,6,3,313150,313150,313153,0,3,5
89408,5,2,313155,313155,313157,0,2,2
89409,1,2,313156,313157,313159,1,3,0
89410,2,3,313158,313159,313162,1,4,0
89411,2,1,313160,313162,313163,2,3,0
89412,1,3,313161,313163,313166,2,5,0
89413,5,2,313166,313166,313168,0,2,0
89414,3,3,313169,313169,313172,0,3,1
89415,5,1,313174,313174,313175,0,1,2
89416,6,2,313180,313180,313182,0,2,5
89417,4,3,313184,313184,313187,0,3,2
89418,6,1,313190,313190,313191,0,1,3
89419,6,2,313196,313196,313198,0,2,5
89420,1,1,313197,313198,313199,1,2,0
89421,2,1,313199,313199,313200,0,1,0
89422,6,2,313205,313205,313207,0,2,5
89423,4,1,313209,313209,313210,0,1,2
89424,5,3,313214,313214,313217,0,3,4
89425,2,1,313216,313217,313218,1,2,0
89426,1,2,313217,313218,313220,1,3,0
89427,4,1,313221,313221,313222,0,1,1
89428,6,3,313227,313227,313230,0,3,5
89429,3,3,313230,313230,313233,0,3,0
89430,3,1,313233,313233,313234,0,1,0
89431,1,3,313234,313234,313237,0,3,0
89432,2,3,313236,313237,313240,1,4,0
89433,2,2,313238,313240,313242,2,4,0
89434,4,1,313242,313242,313243,0,1,0
89435,2,3,313244,313244,313247,0,3,1
89436,3,2,313247,313247,313249,0,2,0
89437,4,2,313251,313251,313253,0,2,2
89438,3,3,313254,313254,313257,0,3,1
89439,4,1,313258,313258,313259,0,1,1
89440,3,1,313261,313261,313262,0,1,2
89441,4,1,313265,313265,313266,0,1,3
89442,5,3,313270,313270,313273,0,3,4
89443,5,2,313275,313275,313277,0,2,2
89444,1,1,313276,313277,313278,1,2,0
89445,1,1,313277,313278,313279,1,2,0
89446,2,2,313279,313279,313281,0,2,0
89447,5,1,313284,313284,313285,0,1,3
89448,4,1,313288,313288,313289,0,1,3
89449,1,3,313289,313289,313292,0,3,0
89450,2,2,313291,313292,313294,1,3,0
89451,2,2,313293,313294,313296,1,3,0
89452,6,2,313299,313299,313301,0,2,3
89453,6,3,313305,313305,313308,0,3,4
89454,5,2,313310,313310,313312,0,2,2
89455,1,1,313311,313312,313313,1,2,0
89456,3,2,313314,313314,313316,0,2,1
89457,2,3,313316,313316,313319,0,3,0
89458,2,2,313318,313319,313321,1,3,0
89459,1,3,313319,313321,313324,2,5,0
89460,2,1,313321,313324,313325,3,4,0
89461,3,2,313324,313325,313327,1,3,0
89462,1,3,313325,313327,313330,2,5,0
89463,3,1,313328,313330,313331,2,3,0
89464,2,1,313330,313331,313332,1,2,0
89465,3,1,313333,313333,313334,0,1,1
89466,5,2,313338,313338,313340,0,2,4
89467,2,1,313340,313340,313341,0,1,0
89468,6,3,313346,313346,313349,0,3,5
89469,1,2,313347,313349,313351,2,4,0
89470,4,3,313351,313351,313354,0,3,0
89471,5,2,313356,313356,313358,0,2,2
89472,2,3,313358,313358,313361,0,3,0
89473,1,3,313359,313361,313364,2,5,0
89474,6,3,313365,313365,313368,0,3,1
89475,3,1,313368,313368,313369,0,1,0
89476,3,3,313371,313371,313374,0,3,2
89477,2,1,313373,313374,313375,1,2,0
89478,5,2,313378,313378,313380,0,2,3
89479,5,2,313383,313383,313385,0,2,3
89480,5,1,313388,313388,313389,0,1,3
89481,1,3,313389,313389,313392,0,3,0
89482,5,1,313394,313394,313395,0,1,2
89483,4,3,313398,313398,313401,0,3,3
89484,6,2,313404,313404,313406,0,2,3
89485,2,2,313406,313406,313408,0,2,0
89486,3,1,313409,313409,313410,0,1,1
89487,2,1,313411,313411,313412,0,1,1
89488,2,1,313413,313413,313414,0,1,1
89489,3,1,313416,313416,313417,0,1,2
89490,6,1,313422,313422,313423,0,1,5
89491,4,2,313426,313426,313428,0,2,3
89492,5,2,313431,313431,313433,0,2,3
89493,6,1,313437,313437,313438,0,1,4
89494,1,1,313438,313438,313439,0,1,0
89495,6,1,313444,313444,313445,0,1,5
89496,1,2,313445,313445,313447,0,2,0
89497,1,2,313446,313447,313449,1,3,0
89498,4,3,313450,313450,313453,0,3,1
89499,5,1,313455,313455,313456,0,1,2
89500,1,2,313456,313456,313458,0,2,0
89501,4,1,313460,313460,313461,0,1,2
89502,1,3,313461,313461,313464,0,3,0
89503,1,3,313462,313464,313467,2,5,0
89504,1,2,313463,313467,313469,4,6,0
89505,5,1,313468,313469,313470,1,2,0
89506,2,2,313470,313470,313472,0,2,0
89507,2,3,313472,313472,313475,0,3,0
89508,5,3,313477,313477,313480,0,3,2
89509,1,1,313478,313480,313481,2,3,0
89510,3,2,313481,313481,313483,0,2,0
89511,4,1,313485,313485,313486,0,1,2
89512,3,1,313488,313488,313489,0,1,2
89513,3,3,313491,313491,313494,0,3,2
89514,1,1,313492,313494,313495,2,3,0
89515,3,1,313495,313495,313496,0,1,0
89516,3,3,313498,313498,313501,0,3,2
89517,5,2,313503,313503,313505,0,2,2
89518,1,1,313504,313505,313506,1,2,0
89519,6,2,313510,313510,313512,0,2,4
89520,2,3,313512,313512,313515,0,3,0
89521,4,1,313516,313516,313517,0,1,1
89522,5,1,313521,313521,313522,0,1,4
89523,3,1,313524,313524,313525,0,1,2
89524,6,2,313530,313530,313532,0,2,5
89525,2,3,313532,313532,313535,0,3,0
89526,1,2,313533,313535,313537,2,4,0
89527,1,1,313534,313537,313538,3,4,0
89528,3,3,313537,313538,313541,1,4,0
89529,1,1,313538,313541,313542,3,4,0
89530,2,1,313540,313542,313543,2,3,0
89531,5,1,313545,313545,313546,0,1,2
89532,2,3,313547,313547,313550,0,3,1
89533,3,2,313550,313550,313552,0,2,0
89534,1,2,313551,313552,313554,1,3,0
89535,2,2,313553,313554,313556,1,3,0
89536,6,1,313559,313559,313560,0,1,3
89537,3,3,313562,313562,313565,0,3,2
89538,6,3,313568,313568,313571,0,3,3
89539,4,1,313572,313572,313573,0,1,1
89540,3,1,313575,313575,313576,0,1,2
89541,4,3,313579,313579,313582,0,3,3
89542,5,1,313584,313584,313585,0,1,2
89543,6,2,313590,313590,313592,0,2,5
89544,6,2,313596,313596,313598,0,2,4
89545,3,2,313599,313599,313601,0,2,1
89546,6,1,313605,313605,313606,0,1,4
89547,4,1,313609,313609,313610,0,1,3
89548,4,3,313613,313613,313616,0,3,3
89549,3,2,313616,313616,313618,0,2,0
89550,3,1,313619,313619,313620,0,1,1
89551,5,2,313624,313624,313626,0,2,4
89552,2,1,313626,313626,313627,0,1,0
89553,1,2,313627,313627,313629,0,2,0
89554,5,1,313632,313632,313633,0,1,3
89555,6,3,313638,313638,313641,0,3,5
89556,1,3,313639,313641,313644,2,5,0
89557,5,1,313644,313644,313645,0,1,0
89558,4,2,313648,313648,313650,0,2,3
89559,6,3,313654,313654,313657,0,3,4
89560,6,2,313660,313660,313662,0,2,3
89561,5,1,313665,313665,313666,0,1,3
89562,1,1,313666,313666,313667,0,1,0
89563,5,3,313671,313671,313674,0,3,4
89564,6,2,313677,313677,313679,0,2,3
89565,6,2,313683,313683,313685,0,2,4
89566,3,1,313686,313686,313687,0,1,1
89567,2,1,313688,313688,313689,0,1,1
89568,6,2,313694,313694,313696,0,2,5
89569,4,3,313698,313698,313701,0,3,2
89570,5,3,313703,313703,313706,0,3,2
89571,3,2,313706,313706,313708,0,2,0
89572,3,3,313709,313709,313712,0,3,1
89573,5,1,313714,313714,313715,0,1,2
89574,1,2,313715,313715,313717,0,2,0
89575,1,3,313716,313717,313720,1,4,0
89576,1,1,313717,313720,313721,3,4,0
89577,1,1,313718,313721,313722,3,4,0
89578,1,2,313719,313722,313724,3,5,0
89579,5,3,313724,313724,313727,0,3,0
89580,4,3,313728,313728,313731,0,3,1
89581,4,3,313732,313732,313735,0,3,1
89582,4,2,313736,313736,313738,0,2,1
89583,2,1,313738,313738,313739,0,1,0
89584,6,3,313744,313744,313747,0,3,5
89585,2,1,313746,313747,313748,1,2,0
89586,1,1,313747,313748,313749,1,2,0
89587,5,2,313752,313752,313754,0,2,3
89588,6,2,313758,313758,313760,0,2,4
89589,6,1,313764,313764,313765,0,1,4
89590,3,3,313767,313767,313770,0,3,2
89591,1,1,313768,313770,313771,2,3,0
89592,4,3,313772,313772,313775,0,3,1
89593,2,2,313774,313775,313777,1,3,0
89594,6,2,313780,313780,313782,0,2,3
89595,3,1,313783,313783,313784,0,1,1
89596,3,1,313786,313786,313787,0,1,2
89597,2,2,313788,313788,313790,0,2,1
89598,5,2,313793,313793,313795,0,2,3
89599,1,3,313794,313795,313798,1,4,0
89600,3,2,313797,313798,313800,1,3,0
89601,6,2,313803,313803,313805,0,2,3
89602,1,1,313804,313805,313806,1,2,0
89603,1,2,313805,313806,313808,1,3,0
89604,4,2,313809,313809,313811,0,2,1
89605,5,3,313814,313814,313817,0,3,3
89606,6,1,313820,313820,313821,0,1,3
89607,6,3,313826,313826,313829,0,3,5
89608,1,3,313827,313829,313832,2,5,0
89609,2,2,313829,313832,313834,3,5,0
89610,2,1,313831,313834,313835,3,4,0
89611,3,2,313834,313835,313837,1,3,0
89612,4,2,313838,313838,313840,0,2,1
89613,5,1,313843,313843,313844,0,1,3
89614,6,1,313849,313849,313850,0,1,5
89615,2,2,313851,313851,313853,0,2,1
89616,3,2,313854,313854,313856,0,2,1
89617,1,2,313855,313856,313858,1,3,0
89618,2,3,313857,313858,313861,1,4,0
89619,2,2,313859,313861,313863,2,4,0
89620,1,1,313860,313863,313864,3,4,0
89621,4,2,313864,313864,313866,0,2,0
89622,2,1,313866,313866,313867,0,1,0
89623,5,2,313871,313871,313873,0,2,4
89624,2,2,313873,313873,313875,0,2,0
89625,5,1,313878,313878,313879,0,1,3
89626,4,2,313882,313882,313884,0,2,3
89627,5,1,313887,313887,313888,0,1,3
89628,6,3,313893,313893,313896,0,3,5
89629,3,2,313896,313896,313898,0,2,0
89630,3,3,313899,313899,313902,0,3,1
89631,5,2,313904,313904,313906,0,2,2
89632,1,2,313905,313906,313908,1,3,0
89633,4,2,313909,313909,313911,0,2,1
89634,4,3,313913,313913,313916,0,3,2
89635,4,1,313917,313917,313918,0,1,1
89636,5,1,313922,313922,313923,0,1,4
89637,2,1,313924,313924,313925,0,1,1
89638,3,2,313927,313927,313929,0,2,2
89639,4,3,313931,313931,313934,0,3,2
89640,2,2,313933,313934,313936,1,3,0
89641,5,3,313938,313938,313941,0,3,2
89642,6,1,313944,313944,313945,0,1,3
89643,2,3,313946,313946,313949,0,3,1
89644,1,3,313947,313949,313952,2,5,0
89645,4,3,313951,313952,313955,1,4,0
89646,4,2,313955,313955,313957,0,2,0
89647,2,2,313957,313957,313959,0,2,0
89648,5,1,313962,313962,313963,0,1,3
89649,4,3,313966,313966,313969,0,3,3
89650,3,3,313969,313969,313972,0,3,0
89651,2,1,313971,313972,313973,1,2,0
89652,2,3,313973,313973,313976,0,3,0
89653,3,1,313976,313976,313977,0,1,0
89654,4,1,313980,313980,313981,0,1,3
89655,6,2,313986,313986,313988,0,2,5
89656,3,2,313989,313989,313991,0,2,1
89657,1,2,313990,313991,313993,1,3,0
89658,1,2,313991,313993,313995,2,4,0
89659,5,2,313996,313996,313998,0,2,1
89660,4,1,314000,314000,314001,0,1,2
89661,4,1,314004,314004,314005,0,1,3
89662,3,3,314007,314007,314010,0,3,2
89663,2,1,314009,314010,314011,1,2,0
89664,1,2,314010,314011,314013,1,3,0
89665,3,1,314013,314013,314014,0,1,0
89666,4,3,314017,314017,314020,0,3,3
89667,3,2,314020,314020,314022,0,2,0
89668,3,2,314023,314023,314025,0,2,1
89669,1,2,314024,314025,314027,1,3,0
89670,3,2,314027,314027,314029,0,2,0
89671,6,2,314033,314033,314035,0,2,4
89672,2,2,314035,314035,314037,0,2,0
89673,4,1,314039,314039,314040,0,1,2
89674,1,3,314040,314040,314043,0,3,0
89675,1,3,314041,314043,314046,2,5,0
89676,6,2,314047,314047,314049,0,2,1
89677,3,1,314050,314050,314051,0,1,1
89678,6,2,314056,314056,314058,0,2,5
89679,1,3,314057,314058,314061,1,4,0
89680,2,3,314059,314061,314064,2,5,0
89681,6,3,314065,314065,314068,0,3,1
89682,4,1,314069,314069,314070,0,1,1
89683,5,3,314074,314074,314077,0,3,4
89684,2,1,314076,314077,314078,1,2,0
89685,6,1,314082,314082,314083,0,1,4
89686,3,3,314085,314085,314088,0,3,2
89687,6,3,314091,314091,314094,0,3,3
89688,4,2,314095,314095,314097,0,2,1
89689,3,2,314098,314098,314100,0,2,1
89690,3,3,314101,314101,314104,0,3,1
89691,3,3,314104,314104,314107,0,3,0
89692,6,1,314110,314110,314111,0,1,3
89693,3,2,314113,314113,314115,0,2,2
89694,6,2,314119,314119,314121,0,2,4
89695,5,3,314124,314124,314127,0,3,3
89696,3,3,314127,314127,314130,0,3,0
89697,5,2,314132,314132,314134,0,2,2
89698,5,2,314137,314137,314139,0,2,3
89699,3,1,314140,314140,314141,0,1,1
89700,2,3,314142,314142,314145,0,3,1
89701,5,1,314147,314147,314148,0,1,2
89702,5,1,314152,314152,314153,0,1,4
89703,2,3,314154,314154,314157,0,3,1
89704,5,2,314159,314159,314161,0,2,2
89705,4,2,314163,314163,314165,0,2,2
89706,2,1,314165,314165,314166,0,1,0
89707,5,1,314170,314170,314171,0,1,4
89708,2,2,314172,314172,314174,0,2,1
89709,4,3,314176,314176,314179,0,3,2
89710,6,2,314182,314182,314184,0,2,3
89711,5,2,314187,314187,314189,0,2,3
89712,6,3,314193,314193,314196,0,3,4
89713,1,1,314194,314196,314197,2,3,0
89714,6,2,314200,314200,314202,0,2,3
89715,2,1,314202,314202,314203,0,1,0
89716,4,1,314206,314206,314207,0,1,3
89717,3,3,314209,314209,314212,0,3,2
89718,6,2,314215,314215,314217,0,2,3
89719,3,3,314218,314218,314221,0,3,1
89720,4,2,314222,314222,314224,0,2,1
89721,4,1,314226,314226,314227,0,1,2
89722,3,2,314229,314229,314231,0,2,2
89723,3,1,314232,314232,314233,0,1,1
89724,2,1,314234,314234,314235,0,1,1
89725,6,2,314240,314240,314242,0,2,5
89726,3,3,314243,314243,314246,0,3,1
89727,3,3,314246,314246,314249,0,3,0
89728,2,2,314248,314249,314251,1,3,0
89729,4,1,314252,314252,314253,0,1,1
89730,4,2,314256,314256,314258,0,2,3
89731,3,2,314259,314259,314261,0,2,1
89732,4,1,314263,314263,314264,0,1,2
89733,5,3,314268,314268,314271,0,3,4
89734,2,3,314270,314271,314274,1,4,0
89735,4,2,314274,314274,314276,0,2,0
89736,6,2,314280,314280,314282,0,2,4
89737,2,1,314282,314282,314283,0,1,0
89738,1,1,314283,314283,314284,0,1,0
89739,6,3,314289,314289,314292,0,3,5
89740,2,3,314291,314292,314295,1,4,0
89741,1,3,314292,314295,314298,3,6,0
89742,4,2,314296,314298,314300,2,4,0
89743,6,2,314302,314302,314304,0,2,2
89744,3,3,314305,314305,314308,0,3,1
89745,2,3,314307,314308,314311,1,4,0
89746,6,2,314313,314313,314315,0,2,2
89747,1,1,314314,314315,314316,1,2,0
89748,5,1,314319,314319,314320,0,1,3
89749,3,2,314322,314322,314324,0,2,2
89750,6,1,314328,314328,314329,0,1,4
89751,5,2,314333,314333,314335,0,2,4
89752,2,2,314335,314335,314337,0,2,0
89753,2,3,314337,314337,314340,0,3,0
89754,3,1,314340,314340,314341,0,1,0
89755,4,3,314344,314344,314347,0,3,3
89756,4,2,314348,314348,314350,0,2,1
89757,5,3,314353,314353,314356,0,3,3
89758,5,2,314358,314358,314360,0,2,2
89759,1,2,314359,314360,314362,1,3,0
89760,6,1,314365,314365,314366,0,1,3
89761,6,2,314371,314371,314373,0,2,5
89762,6,2,314377,314377,314379,0,2,4
89763,6,3,314383,314383,314386,0,3,4
89764,6,1,314389,314389,314390,0,1,3
89765,3,3,314392,314392,314395,0,3,2
89766,1,1,314393,314395,314396,2,3,0
89767,6,3,314399,314399,314402,0,3,3
89768,6,3,314405,314405,314408,0,3,3
89769,2,1,314407,314408,314409,1,2,0
89770,4,3,314411,314411,314414,0,3,2
89771,1,3,314412,314414,314417,2,5,0
89772,4,1,314416,314417,314418,1,2,0
89773,3,3,314419,314419,314422,0,3,1
89774,2,2,314421,314422,314424,1,3,0
89775,3,1,314424,314424,314425,0,1,0
89776,1,3,314425,314425,314428,0,3,0
89777,6,3,314431,314431,314434,0,3,3
89778,5,1,314436,314436,314437,0,1,2
89779,1,3,314437,314437,314440,0,3,0
89780,2,3,314439,314440,314443,1,4,0
89781,4,3,314443,314443,314446,0,3,0
89782,6,3,314449,314449,314452,0,3,3
89783,1,3,314450,314452,314455,2,5,0
89784,6,3,314456,314456,314459,0,3,1
89785,2,1,314458,314459,314460,1,2,0
89786,6,3,314464,314464,314467,0,3,4
89787,1,2,314465,314467,314469,2,4,0
89788,6,2,314471,314471,314473,0,2,2
89789,5,3,314476,314476,314479,0,3,3
89790,5,1,314481,314481,314482,0,1,2
89791,5,1,314486,314486,314487,0,1,4
89792,4,3,314490,314490,314493,0,3,3
89793,1,2,314491,314493,314495,2,4,0
89794,1,3,314492,314495,314498,3,6,0
89795,6,1,314498,314498,314499,0,1,0
89796,1,3,314499,314499,314502,0,3,0
89797,1,3,314500,314502,314505,2,5,0
89798,6,3,314506,314506,314509,0,3,1
89799,4,2,314510,314510,314512,0,2,1
89800,1,3,314511,314512,314515,1,4,0
89801,1,1,314512,314515,314516,3,4,0
89802,5,2,314517,314517,314519,0,2,1
89803,6,1,314523,314523,314524,0,1,4
89804,3,3,314526,314526,314529,0,3,2
89805,2,1,314528,314529,314530,1,2,0
89806,5,1,314533,314533,314534,0,1,3
89807,4,2,314537,314537,314539,0,2,3
89808,3,3,314540,314540,314543,0,3,1
89809,1,3,314541,314543,314546,2,5,0
89810,3,2,314544,314546,314548,2,4,0
89811,5,3,314549,314549,314552,0,3,1
89812,4,1,314553,314553,314554,0,1,1
89813,1,1,314554,314554,314555,0,1,0
89814,3,2,314557,314557,314559,0,2,2
89815,5,3,314562,314562,314565,0,3,3
89816,1,3,314563,314565,314568,2,5,0
89817,4,1,314567,314568,314569,1,2,0
89818,3,3,314570,314570,314573,0,3,1
89819,4,2,314574,314574,314576,0,2,1
89820,1,1,314575,314576,314577,1,2,0
89821,1,2,314576,314577,314579,1,3,0
89822,1,2,314577,314579,314581,2,4,0
89823,2,1,314579,314581,314582,2,3,0
89824,1,1,314580,314582,314583,2,3,0
89825,3,3,314583,314583,314586,0,3,0
89826,2,3,314585,314586,314589,1,4,0
89827,1,1,314586,314589,314590,3,4,0
89828,3,1,314589,314590,314591,1,2,0
89829,2,3,314591,314591,314594,0,3,0
89830,5,1,314596,314596,314597,0,1,2
89831,5,3,314601,314601,314604,0,3,4
89832,5,1,314606,314606,314607,0,1,2
89833,2,3,314608,314608,314611,0,3,1
89834,6,2,314614,314614,314616,0,2,3
89835,5,3,314619,314619,314622,0,3,3
89836,3,2,314622,314622,314624,0,2,0
89837,1,3,314623,314624,314627,1,4,0
89838,6,1,314629,314629,314630,0,1,2
89839,4,2,314633,314633,314635,0,2,3
89840,5,2,314638,314638,314640,0,2,3
89841,2,3,314640,314640,314643,0,3,0
89842,6,2,314646,314646,314648,0,2,3
89843,2,3,314648,314648,314651,0,3,0
89844,6,1,314654,314654,314655,0,1,3
89845,6,3,314660,314660,314663,0,3,5
89846,4,2,314664,314664,314666,0,2,1
89847,5,1,314669,314669,314670,0,1,3
89848,6,3,314675,314675,314678,0,3,5
89849,5,1,314680,314680,314681,0,1,2
89850,6,3,314686,314686,314689,0,3,5
89851,5,3,314691,314691,314694,0,3,2
89852,5,3,314696,314696,314699,0,3,2
89853,4,1,314700,314700,314701,0,1,1
89854,5,1,314705,314705,314706,0,1,4
89855,5,1,314710,314710,314711,0,1,4
89856,4,1,314714,314714,314715,0,1,3
89857,3,2,314717,314717,314719,0,2,2
89858,2,1,314719,314719,314720,0,1,0
89859,3,1,314722,314722,314723,0,1,2
89860,5,1,314727,314727,314728,0,1,4
89861,2,2,314729,314729,314731,0,2,1
89862,5,3,314734,314734,314737,0,3,3
89863,6,2,314740,314740,314742,0,2,3
89864,1,1,314741,314742,314743,1,2,0
89865,6,1,314747,314747,314748,0,1,4
89866,1,2,314748,314748,314750,0,2,0
89867,2,2,314750,314750,314752,0,2,0
89868,3,2,314753,314753,314755,0,2,1
89869,6,3,314759,314759,314762,0,3,4
89870,3,3,314762,314762,314765,0,3,0
89871,4,3,314766,314766,314769,0,3,1
89872,1,2,314767,314769,314771,2,4,0
89873,3,2,314770,314771,314773,1,3,0
89874,5,3,314775,314775,314778,0,3,2
89875,4,2,314779,314779,314781,0,2,1
89876,1,1,314780,314781,314782,1,2,0
89877,2,2,314782,314782,314784,0,2,0
89878,3,3,314785,314785,314788,0,3,1
89879,1,3,314786,314788,314791,2,5,0
89880,4,1,314790,314791,314792,1,2,0
89881,4,3,314794,314794,314797,0,3,2
89882,5,2,314799,314799,314801,0,2,2
89883,5,2,314804,314804,314806,0,2,3
89884,2,3,314806,314806,314809,0,3,0
89885,4,1,314810,314810,314811,0,1,1
89886,2,2,314812,314812,314814,0,2,1
89887,1,3,314813,314814,314817,1,4,0
89888,6,1,314819,314819,314820,0,1,2
89889,5,1,314824,314824,314825,0,1,4
89890,4,3,314828,314828,314831,0,3,3
89891,5,1,314833,314833,314834,0,1,2
89892,5,2,314838,314838,314840,0,2,4
89893,3,1,314841,314841,314842,0,1,1
89894,4,1,314845,314845,314846,0,1,3
89895,5,2,314850,314850,314852,0,2,4
89896,4,1,314854,314854,314855,0,1,2
89897,3,1,314857,314857,314858,0,1,2
89898,6,1,314863,314863,314864,0,1,5
89899,4,3,314867,314867,314870,0,3,3
89900,2,3,314869,314870,314873,1,4,0
89901,3,2,314872,314873,314875,1,3,0
89902,5,3,314877,314877,314880,0,3,2
89903,4,3,314881,314881,314884,0,3,1
89904,5,1,314886,314886,314887,0,1,2
89905,5,3,314891,314891,314894,0,3,4
89906,1,3,314892,314894,314897,2,5,0
89907,2,1,314894,314897,314898,3,4,0
89908,6,3,314900,314900,314903,0,3,2
89909,6,2,314906,314906,314908,0,2,3
89910,4,1,314910,314910,314911,0,1,2
89911,1,3,314911,314911,314914,0,3,0
89912,4,3,314915,314915,314918,0,3,1
89913,2,3,314917,314918,314921,1,4,0
89914,6,3,314923,314923,314926,0,3,2
89915,4,3,314927,314927,314930,0,3,1
89916,4,3,314931,314931,314934,0,3,1
89917,4,3,314935,314935,314938,0,3,1
89918,6,2,314941,314941,314943,0,2,3
89919,3,2,314944,314944,314946,0,2,1
89920,1,3,314945,314946,314949,1,4,0
89921,1,1,314946,314949,314950,3,4,0
89922,2,1,314948,314950,314951,2,3,0
89923,4,1,314952,314952,314953,0,1,1
89924,3,2,314955,314955,314957,0,2,2
89925,2,3,314957,314957,314960,0,3,0
89926,4,2,314961,314961,314963,0,2,1
89927,2,1,314963,314963,314964,0,1,0
89928,3,3,314966,314966,314969,0,3,2
89929,4,2,314970,314970,314972,0,2,1
89930,2,3,314972,314972,314975,0,3,0
89931,3,3,314975,314975,314978,0,3,0
89932,4,1,314979,314979,314980,0,1,1
89933,3,1,314982,314982,314983,0,1,2
89934,1,2,314983,314983,314985,0,2,0
89935,4,3,314987,314987,314990,0,3,2
89936,1,1,314988,314990,314991,2,3,0
89937,4,3,314992,314992,314995,0,3,1
89938,5,3,314997,314997,315000,0,3,2
89939,6,2,315003,315003,315005,0,2,3
89940,5,2,315008,315008,315010,0,2,3
89941,4,2,315012,315012,315014,0,2,2
89942,2,2,315014,315014,315016,0,2,0
89943,6,3,315020,315020,315023,0,3,4
89944,5,3,315025,315025,315028,0,3,2
89945,2,2,315027,315028,315030,1,3,0
89946,2,2,315029,315030,315032,1,3,0
89947,6,3,315035,315035,315038,0,3,3
89948,3,1,315038,315038,315039,0,1,0
89949,1,2,315039,315039,315041,0,2,0
89950,3,2,315042,315042,315044,0,2,1
89951,4,3,315046,315046,315049,0,3,2
89952,5,2,315051,315051,315053,0,2,2
89953,3,3,315054,315054,315057,0,3,1
89954,1,2,315055,315057,315059,2,4,0
89955,6,1,315061,315061,315062,0,1,2
89956,2,2,315063,315063,315065,0,2,1
89957,1,2,315064,315065,315067,1,3,0
89958,2,1,315066,315067,315068,1,2,0
89959,5,2,315071,315071,315073,0,2,3
89960,6,2,315077,315077,315079,0,2,4
89961,3,2,315080,315080,315082,0,2,1
89962,5,1,315085,315085,315086,0,1,3
89963,2,3,315087,315087,315090,0,3,1
89964,2,1,315089,315090,315091,1,2,0
89965,6,2,315095,315095,315097,0,2,4
89966,2,1,315097,315097,315098,0,1,0
89967,3,2,315100,315100,315102,0,2,2
89968,5,2,315105,315105,315107,0,2,3
89969,3,1,315108,315108,315109,0,1,1
89970,6,2,315114,315114,315116,0,2,5
89971,3,1,315117,315117,315118,0,1,1
89972,2,1,315119,315119,315120,0,1,1
89973,1,3,315120,315120,315123,0,3,0
89974,2,2,315122,315123,315125,1,3,0
89975,2,1,315124,315125,315126,1,2,0
89976,4,1,315128,315128,315129,0,1,2
89977,4,1,315132,315132,315133,0,1,3
89978,1,1,315133,315133,315134,0,1,0
89979,4,2,315137,315137,315139,0,2,3
89980,6,1,315143,315143,315144,0,1,4
89981,6,1,315149,315149,315150,0,1,5
89982,4,3,315153,315153,315156,0,3,3
89983,4,2,315157,315157,315159,0,2,1
89984,1,2,315158,315159,315161,1,3,0
89985,5,3,315163,315163,315166,0,3,2
89986,5,1,315168,315168,315169,0,1,2
89987,2,1,315170,315170,315171,0,1,1
89988,5,3,315175,315175,315178,0,3,4
89989,5,3,315180,315180,315183,0,3,2
89990,1,2,315181,315183,315185,2,4,0
89991,2,2,315183,315185,315187,2,4,0
89992,5,1,315188,315188,315189,0,1,1
89993,6,3,315194,315194,315197,0,3,5
89994,6,2,315200,315200,315202,0,2,3
89995,1,3,315201,315202,315205,1,4,0
89996,2,3,315203,315205,315208,2,5,0
89997,2,2,315205,315208,315210,3,5,0
89998,3,3,315208,315210,315213,2,5,0
89999,4,1,315212,315213,315214,1,2,0
90000,2,2,315214,315214,315216,0,2,0
90001,2,2,315216,315216,315218,0,2,0
90002,1,2,315217,315218,315220,1,3,0
90003,6,2,315223,315223,315225,0,2,3
90004,3,1,315226,315226,315227,0,1,1
90005,3,1,315229,315229,315230,0,1,2
90006,5,2,315234,315234,315236,0,2,4
90007,4,1,315238,315238,315239,0,1,2
90008,6,3,315244,315244,315247,0,3,5
90009,6,3,315250,315250,315253,0,3,3
90010,1,2,315251,315253,315255,2,4,0
90011,4,3,315255,315255,315258,0,3,0
90012,6,2,315261,315261,315263,0,2,3
90013,3,1,315264,315264,315265,0,1,1
90014,1,1,315265,315265,315266,0,1,0
90015,3,3,315268,315268,315271,0,3,2
90016,5,2,315273,315273,315275,0,2,2
90017,5,2,315278,315278,315280,0,2,3
90018,4,3,315282,315282,315285,0,3,2
90019,1,1,315283,315285,315286,2,3,0
90020,3,2,315286,315286,315288,0,2,0
90021,3,1,315289,315289,315290,0,1,1
90022,4,3,315293,315293,315296,0,3,3
90023,1,2,315294,315296,315298,2,4,0
90024,1,3,315295,315298,315301,3,6,0
90025,4,3,315299,315301,315304,2,5,0
90026,4,1,315303,315304,315305,1,2,0
90027,4,3,315307,315307,315310,0,3,2
90028,1,2,315308,315310,315312,2,4,0
90029,2,1,315310,315312,315313,2,3,0
90030,1,3,315311,315313,315316,2,5,0
90031,2,2,315313,315316,315318,3,5,0
90032,3,3,315316,315318,315321,2,5,0
90033,1,3,315317,315321,315324,4,7,0
90034,3,1,315320,315324,315325,4,5,0
90035,4,3,315324,315325,315328,1,4,0
90036,6,2,315330,315330,315332,0,2,2
90037,2,3,315332,315332,315335,0,3,0
90038,5,3,315337,315337,315340,0,3,2
90039,4,3,315341,315341,315344,0,3,1
90040,2,2,315343,315344,315346,1,3,0
90041,5,1,315348,315348,315349,0,1,2
90042,4,1,315352,315352,315353,0,1,3
90043,1,2,315353,315353,315355,0,2,0
90044,6,3,315359,315359,315362,0,3,4
90045,2,1,315361,315362,315363,1,2,0
90046,3,1,315364,315364,315365,0,1,1
90047,1,3,315365,315365,315368,0,3,0
90048,6,2,315371,315371,315373,0,2,3
90049,2,2,315373,315373,315375,0,2,0
90050,5,1,315378,315378,315379,0,1,3
90051,6,3,315384,315384,315387,0,3,5
90052,4,2,315388,315388,315390,0,2,1
90053,2,2,315390,315390,315392,0,2,0
90054,5,1,315395,315395,315396,0,1,3
90055,4,3,315399,315399,315402,0,3,3
90056,2,2,315401,315402,315404,1,3,0
90057,1,3,315402,315404,315407,2,5,0
90058,2,2,315404,315407,315409,3,5,0
90059,6,3,315410,315410,315413,0,3,1
90060,4,1,315414,315414,315415,0,1,1
90061,2,3,315416,315416,315419,0,3,1
90062,3,3,315419,315419,315422,0,3,0
90063,2,2,315421,315422,315424,1,3,0
90064,3,2,315424,315424,315426,0,2,0
90065,1,1,315425,315426,315427,1,2,0
90066,1,2,315426,315427,315429,1,3,0
90067,3,3,315429,315429,315432,0,3,0
90068,5,2,315434,315434,315436,0,2,2
90069,2,3,315436,315436,315439,0,3,0
90070,1,1,315437,315439,315440,2,3,0
90071,5,1,315442,315442,315443,0,1,2
90072,5,1,315447,315447,315448,0,1,4
90073,5,3,315452,315452,315455,0,3,4
90074,4,2,315456,315456,315458,0,2,1
90075,2,2,315458,315458,315460,0,2,0
90076,3,2,315461,315461,315463,0,2,1
90077,3,3,315464,315464,315467,0,3,1
90078,6,2,315470,315470,315472,0,2,3
90079,3,3,315473,315473,315476,0,3,1
90080,1,1,315474,315476,315477,2,3,0
90081,3,3,315477,315477,315480,0,3,0
90082,3,1,315480,315480,315481,0,1,0
90083,1,1,315481,315481,315482,0,1,0
90084,4,1,315485,315485,315486,0,1,3
90085,2,2,315487,315487,315489,0,2,1
90086,4,1,315491,315491,315492,0,1,2
90087,6,3,315497,315497,315500,0,3,5
90088,3,2,315500,315500,315502,0,2,0
90089,4,2,315504,315504,315506,0,2,2
90090,3,3,315507,315507,315510,0,3,1
90091,6,1,315513,315513,315514,0,1,3
90092,2,3,315515,315515,315518,0,3,1
90093,6,2,315521,315521,315523,0,2,3
90094,4,2,315525,315525,315527,0,2,2
90095,2,1,315527,315527,315528,0,1,0
90096,3,3,315530,315530,315533,0,3,2
90097,1,3,315531,315533,315536,2,5,0
90098,6,2,315537,315537,315539,0,2,1
90099,6,3,315543,315543,315546,0,3,4
90100,3,2,315546,315546,315548,0,2,0
90101,6,2,315552,315552,315554,0,2,4
90102,3,2,315555,315555,315557,0,2,1
90103,5,1,315560,315560,315561,0,1,3
90104,3,1,315563,315563,315564,0,1,2
90105,1,3,315564,315564,315567,0,3,0
90106,1,3,315565,315567,315570,2,5,0
90107,4,3,315569,315570,315573,1,4,0
90108,1,1,315570,315573,315574,3,4,0
90109,2,2,315572,315574,315576,2,4,0
90110,1,2,315573,315576,315578,3,5,0
90111,6,2,315579,315579,315581,0,2,1
90112,4,3,315583,315583,315586,0,3,2
90113,5,1,315588,315588,315589,0,1,2
90114,1,1,315589,315589,315590,0,1,0
90115,2,1,315591,315591,315592,0,1,1
90116,5,2,315596,315596,315598,0,2,4
90117,5,3,315601,315601,315604,0,3,3
90118,2,1,315603,315604,315605,1,2,0
90119,6,1,315609,315609,315610,0,1,4
90120,1,1,315610,315610,315611,0,1,0
90121,1,3,315611,315611,315614,0,3,0
90122,5,1,315616,315616,315617,0,1,2
90123,5,2,315621,315621,315623,0,2,4
90124,4,2,315625,315625,315627,0,2,2
90125,1,2,315626,315627,315629,1,3,0
90126,5,3,315631,315631,315634,0,3,2
90127,3,3,315634,315634,315637,0,3,0
90128,1,2,315635,315637,315639,2,4,0
90129,5,3,315640,315640,315643,0,3,1
90130,5,2,315645,315645,315647,0,2,2
90131,3,1,315648,315648,315649,0,1,1
90132,3,1,315651,315651,315652,0,1,2
90133,3,2,315654,315654,315656,0,2,2
90134,4,2,315658,315658,315660,0,2,2
90135,3,3,315661,315661,315664,0,3,1
90136,3,2,315664,315664,315666,0,2,0
90137,2,2,315666,315666,315668,0,2,0
90138,4,3,315670,315670,315673,0,3,2
90139,4,3,315674,315674,315677,0,3,1
90140,4,1,315678,315678,315679,0,1,1
90141,6,2,315684,315684,315686,0,2,5
90142,3,1,315687,315687,315688,0,1,1
90143,5,1,315692,315692,315693,0,1,4
90144,3,2,315695,315695,315697,0,2,2
90145,1,2,315696,315697,315699,1,3,0
90146,2,3,315698,315699,315702,1,4,0
90147,2,1,315700,315702,315703,2,3,0
90148,3,1,315703,315703,315704,0,1,0
90149,5,2,315708,315708,315710,0,2,4
90150,3,1,315711,315711,315712,0,1,1
90151,4,1,315715,315715,315716,0,1,3
90152,6,2,315721,315721,315723,0,2,5
90153,6,1,315727,315727,315728,0,1,4
90154,3,3,315730,315730,315733,0,3,2
90155,4,2,315734,315734,315736,0,2,1
90156,4,3,315738,315738,315741,0,3,2
90157,4,1,315742,315742,315743,0,1,1
90158,4,2,315746,315746,315748,0,2,3
90159,4,2,315750,315750,315752,0,2,2
90160,4,1,315754,315754,315755,0,1,2
90161,5,2,315759,315759,315761,0,2,4
90162,5,2,315764,315764,315766,0,2,3
90163,6,3,315770,315770,315773,0,3,4
90164,3,2,315773,315773,315775,0,2,0
90165,3,2,315776,315776,315778,0,2,1
90166,2,2,315778,315778,315780,0,2,0
90167,4,2,315782,315782,315784,0,2,2
90168,6,3,315788,315788,315791,0,3,4
90169,2,2,315790,315791,315793,1,3,0
90170,5,2,315795,315795,315797,0,2,2
90171,1,2,315796,315797,315799,1,3,0
90172,3,3,315799,315799,315802,0,3,0
90173,5,3,315804,315804,315807,0,3,2
90174,5,2,315809,315809,315811,0,2,2
90175,5,3,315814,315814,315817,0,3,3
90176,2,1,315816,315817,315818,1,2,0
90177,1,2,315817,315818,315820,1,3,0
90178,1,2,315818,315820,315822,2,4,0
90179,3,3,315821,315822,315825,1,4,0
90180,3,2,315824,315825,315827,1,3,0
90181,4,2,315828,315828,315830,0,2,1
90182,2,1,315830,315830,315831,0,1,0
90183,6,2,315836,315836,315838,0,2,5
90184,5,1,315841,315841,315842,0,1,3
90185,6,1,315847,315847,315848,0,1,5
90186,1,2,315848,315848,315850,0,2,0
90187,6,2,315854,315854,315856,0,2,4
90188,1,2,315855,315856,315858,1,3,0
90189,5,2,315860,315860,315862,0,2,2
90190,1,1,315861,315862,315863,1,2,0
90191,3,3,315864,315864,315867,0,3,1
90192,6,1,315870,315870,315871,0,1,3
90193,6,3,315876,315876,315879,0,3,5
90194,3,3,315879,315879,315882,0,3,0
90195,5,3,315884,315884,315887,0,3,2
90196,3,3,315887,315887,315890,0,3,0
90197,2,2,315889,315890,315892,1,3,0
90198,6,1,315895,315895,315896,0,1,3
90199,3,2,315898,315898,315900,0,2,2
90200,2,2,315900,315900,315902,0,2,0
90201,2,3,315902,315902,315905,0,3,0
90202,3,2,315905,315905,315907,0,2,0
90203,3,2,315908,315908,315910,0,2,1
90204,3,1,315911,315911,315912,0,1,1
90205,5,1,315916,315916,315917,0,1,4
90206,4,2,315920,315920,315922,0,2,3
90207,3,1,315923,315923,315924,0,1,1
90208,6,2,315929,315929,315931,0,2,5
90209,6,3,315935,315935,315938,0,3,4
90210,4,2,315939,315939,315941,0,2,1
90211,6,3,315945,315945,315948,0,3,4
90212,4,2,315949,315949,315951,0,2,1
90213,3,1,315952,315952,315953,0,1,1
90214,4,1,315956,315956,315957,0,1,3
90215,4,1,315960,315960,315961,0,1,3
90216,4,3,315964,315964,315967,0,3,3
90217,6,3,315970,315970,315973,0,3,3
90218,4,2,315974,315974,315976,0,2,1
90219,1,2,315975,315976,315978,1,3,0
90220,1,2,315976,315978,315980,2,4,0
90221,1,3,315977,315980,315983,3,6,0
90222,5,3,315982,315983,315986,1,4,0
90223,6,1,315988,315988,315989,0,1,2
90224,1,2,315989,315989,315991,0,2,0
90225,2,3,315991,315991,315994,0,3,0
90226,5,2,315996,315996,315998,0,2,2
90227,4,1,316000,316000,316001,0,1,2
90228,1,3,316001,316001,316004,0,3,0
90229,5,3,316006,316006,316009,0,3,2
90230,4,3,316010,316010,316013,0,3,1
90231,6,2,316016,316016,316018,0,2,3
90232,2,3,316018,316018,316021,0,3,0
90233,3,3,316021,316021,316024,0,3,0
90234,3,3,316024,316024,316027,0,3,0
90235,2,2,316026,316027,316029,1,3,0
90236,1,2,316027,316029,316031,2,4,0
90237,4,2,316031,316031,316033,0,2,0
90238,4,3,316035,316035,316038,0,3,2
90239,3,1,316038,316038,316039,0,1,0
90240,5,2,316043,316043,316045,0,2,4
90241,5,2,316048,316048,316050,0,2,3
90242,2,3,316050,316050,316053,0,3,0
90243,2,3,316052,316053,316056,1,4,0
90244,5,1,316057,316057,316058,0,1,1
90245,5,1,316062,316062,316063,0,1,4
90246,3,3,316065,316065,316068,0,3,2
90247,2,1,316067,316068,316069,1,2,0
90248,2,3,316069,316069,316072,0,3,0
90249,1,3,316070,316072,316075,2,5,0
90250,2,3,316072,316075,316078,3,6,0
90251,4,3,316076,316078,316081,2,5,0
90252,5,1,316081,316081,316082,0,1,0
90253,3,2,316084,316084,316086,0,2,2
90254,4,2,316088,316088,316090,0,2,2
90255,4,3,316092,316092,316095,0,3,2
90256,6,2,316098,316098,316100,0,2,3
90257,6,2,316104,316104,316106,0,2,4
90258,2,3,316106,316106,316109,0,3,0
90259,1,3,316107,316109,316112,2,5,0
90260,4,3,316111,316112,316115,1,4,0
90261,4,1,316115,316115,316116,0,1,0
90262,6,2,316121,316121,316123,0,2,5
90263,3,1,316124,316124,316125,0,1,1
90264,5,3,316129,316129,316132,0,3,4
90265,4,3,316133,316133,316136,0,3,1
90266,5,1,316138,316138,316139,0,1,2
90267,3,2,316141,316141,316143,0,2,2
90268,2,1,316143,316143,316144,0,1,0
90269,1,3,316144,316144,316147,0,3,0
90270,6,3,316150,316150,316153,0,3,3
90271,3,2,316153,316153,316155,0,2,0
90272,1,2,316154,316155,316157,1,3,0
90273,1,3,316155,316157,316160,2,5,0
90274,6,3,316161,316161,316164,0,3,1
90275,2,3,316163,316164,316167,1,4,0
90276,4,2,316167,316167,316169,0,2,0
90277,6,3,316173,316173,316176,0,3,4
90278,1,2,316174,316176,316178,2,4,0
90279,4,3,316178,316178,316181,0,3,0
90280,5,1,316183,316183,316184,0,1,2
90281,6,1,316189,316189,316190,0,1,5
90282,1,2,316190,316190,316192,0,2,0
90283,3,3,316193,316193,316196,0,3,1
90284,4,2,316197,316197,316199,0,2,1
90285,2,1,316199,316199,316200,0,1,0
90286,3,1,316202,316202,316203,0,1,2
90287,5,1,316207,316207,316208,0,1,4
90288,3,3,316210,316210,316213,0,3,2
90289,6,3,316216,316216,316219,0,3,3
90290,1,1,316217,316219,316220,2,3,0
90291,3,2,316220,316220,316222,0,2,0
90292,3,3,316223,316223,316226,0,3,1
90293,4,2,316227,316227,316229,0,2,1
90294,3,1,316230,316230,316231,0,1,1
90295,5,2,316235,316235,316237,0,2,4
90296,6,3,316241,316241,316244,0,3,4
90297,1,1,316242,316244,316245,2,3,0
90298,4,3,316246,316246,316249,0,3,1
90299,6,1,316252,316252,316253,0,1,3
90300,4,3,316256,316256,316259,0,3,3
90301,1,2,316257,316259,316261,2,4,0
90302,6,3,316263,316263,316266,0,3,2
90303,2,2,316265,316266,316268,1,3,0
90304,3,1,316268,316268,316269,0,1,0
90305,3,1,316271,316271,316272,0,1,2
90306,2,1,316273,316273,316274,0,1,1
90307,3,2,316276,316276,316278,0,2,2
90308,5,1,316281,316281,316282,0,1,3
90309,5,1,316286,316286,316287,0,1,4
90310,2,1,316288,316288,316289,0,1,1
90311,2,3,316290,316290,316293,0,3,1
90312,6,1,316296,316296,316297,0,1,3
90313,2,2,316298,316298,316300,0,2,1
90314,4,1,316302,316302,316303,0,1,2
90315,2,1,316304,316304,316305,0,1,1
90316,4,3,316308,316308,316311,0,3,3
90317,6,3,316314,316314,316317,0,3,3
90318,4,3,316318,316318,316321,0,3,1
90319,1,1,316319,316321,316322,2,3,0
90320,1,3,316320,316322,316325,2,5,0
90321,4,3,316324,316325,316328,1,4,0
90322,5,2,316329,316329,316331,0,2,1
90323,2,1,316331,316331,316332,0,1,0
90324,5,3,316336,316336,316339,0,3,4
90325,6,1,316342,316342,316343,0,1,3
90326,6,1,316348,316348,316349,0,1,5
90327,4,2,316352,316352,316354,0,2,3
90328,2,2,316354,316354,316356,0,2,0
90329,5,1,316359,316359,316360,0,1,3
90330,1,1,316360,316360,316361,0,1,0
90331,6,3,316366,316366,316369,0,3,5
90332,5,2,316371,316371,316373,0,2,2
90333,3,2,316374,316374,316376,0,2,1
90334,2,1,316376,316376,316377,0,1,0
90335,1,2,316377,316377,316379,0,2,0
90336,2,3,316379,316379,316382,0,3,0
90337,1,2,316380,316382,316384,2,4,0
90338,6,2,316386,316386,316388,0,2,2
90339,6,3,316392,316392,316395,0,3,4
90340,2,3,316394,316395,316398,1,4,0
90341,3,3,316397,316398,316401,1,4,0
90342,6,3,316403,316403,316406,0,3,2
90343,5,2,316408,316408,316410,0,2,2
90344,5,2,316413,316413,316415,0,2,3
90345,1,3,316414,316415,316418,1,4,0
90346,5,3,316419,316419,316422,0,3,1
90347,6,3,316425,316425,316428,0,3,3
90348,3,3,316428,316428,316431,0,3,0
90349,4,3,316432,316432,316435,0,3,1
90350,2,1,316434,316435,316436,1,2,0
90351,6,2,316440,316440,316442,0,2,4
90352,3,2,316443,316443,316445,0,2,1
90353,3,2,316446,316446,316448,0,2,1
90354,1,3,316447,316448,316451,1,4,0
90355,4,3,316451,316451,316454,0,3,0
90356,1,2,316452,316454,316456,2,4,0
90357,3,3,316455,316456,316459,1,4,0
90358,6,2,316461,316461,316463,0,2,2
90359,3,3,316464,316464,316467,0,3,1
90360,3,2,316467,316467,316469,0,2,0
90361,1,1,316468,316469,316470,1,2,0
90362,6,3,316474,316474,316477,0,3,4
90363,5,2,316479,316479,316481,0,2,2
90364,5,1,316484,316484,316485,0,1,3
90365,5,2,316489,316489,316491,0,2,4
90366,5,1,316494,316494,316495,0,1,3
90367,6,3,316500,316500,316503,0,3,5
90368,3,2,316503,316503,316505,0,2,0
90369,3,3,316506,316506,316509,0,3,1
90370,2,1,316508,316509,316510,1,2,0
90371,5,1,316513,316513,316514,0,1,3
90372,2,1,316515,316515,316516,0,1,1
90373,1,1,316516,316516,316517,0,1,0
90374,4,3,316520,316520,316523,0,3,3
90375,2,3,316522,316523,316526,1,4,0
90376,3,1,316525,316526,316527,1,2,0
90377,2,1,316527,316527,316528,0,1,0
90378,1,2,316528,316528,316530,0,2,0
90379,2,3,316530,316530,316533,0,3,0
90380,5,3,316535,316535,316538,0,3,2
90381,6,2,316541,316541,316543,0,2,3
90382,2,1,316543,316543,316544,0,1,0
90383,3,2,316546,316546,316548,0,2,2
90384,3,2,316549,316549,316551,0,2,1
90385,2,2,316551,316551,316553,0,2,0
90386,1,1,316552,316553,316554,1,2,0
90387,4,1,316556,316556,316557,0,1,2
90388,4,1,316560,316560,316561,0,1,3
90389,2,1,316562,316562,316563,0,1,1
90390,6,2,316568,316568,316570,0,2,5
90391,5,3,316573,316573,316576,0,3,3
90392,1,3,316574,316576,316579,2,5,0
90393,6,1,316580,316580,316581,0,1,1
90394,6,2,316586,316586,316588,0,2,5
90395,4,3,316590,316590,316593,0,3,2
90396,2,1,316592,316593,316594,1,2,0
90397,3,1,316595,316595,316596,0,1,1
90398,5,2,316600,316600,316602,0,2,4
90399,1,3,316601,316602,316605,1,4,0
90400,2,1,316603,316605,316606,2,3,0
90401,6,2,316609,316609,316611,0,2,3
90402,6,1,316615,316615,316616,0,1,4
90403,1,3,316616,316616,316619,0,3,0
90404,1,3,316617,316619,316622,2,5,0
90405,4,1,316621,316622,316623,1,2,0
90406,4,3,316625,316625,316628,0,3,2
90407,1,1,316626,316628,316629,2,3,0
90408,1,1,316627,316629,316630,2,3,0
90409,6,3,316633,316633,316636,0,3,3
90410,6,1,316639,316639,316640,0,1,3
90411,6,1,316645,316645,316646,0,1,5
90412,4,1,316649,316649,316650,0,1,3
90413,4,2,316653,316653,316655,0,2,3
90414,5,1,316658,316658,316659,0,1,3
90415,6,3,316664,316664,316667,0,3,5
90416,5,2,316669,316669,316671,0,2,2
90417,2,2,316671,316671,316673,0,2,0
90418,3,2,316674,316674,316676,0,2,1
90419,5,2,316679,316679,316681,0,2,3
90420,1,3,316680,316681,316684,1,4,0
90421,5,2,316685,316685,316687,0,2,1
90422,4,1,316689,316689,316690,0,1,2
90423,4,2,316693,316693,316695,0,2,3
90424,1,2,316694,316695,316697,1,3,0
90425,4,2,316698,316698,316700,0,2,1
90426,2,1,316700,316700,316701,0,1,0
90427,3,1,316703,316703,316704,0,1,2
90428,1,1,316704,316704,316705,0,1,0
90429,5,3,316709,316709,316712,0,3,4
90430,5,1,316714,316714,316715,0,1,2
90431,5,1,316719,316719,316720,0,1,4
90432,5,2,316724,316724,316726,0,2,4
90433,2,3,316726,316726,316729,0,3,0
90434,6,3,316732,316732,316735,0,3,3
90435,3,3,316735,316735,316738,0,3,0
90436,3,1,316738,316738,316739,0,1,0
90437,1,3,316739,316739,316742,0,3,0
90438,5,2,316744,316744,316746,0,2,2
90439,2,2,316746,316746,316748,0,2,0
90440,6,3,316752,316752,316755,0,3,4
90441,6,2,316758,316758,316760,0,2,3
90442,5,2,316763,316763,316765,0,2,3
90443,3,3,316766,316766,316769,0,3,1
90444,6,2,316772,316772,316774,0,2,3
90445,2,3,316774,316774,316777,0,3,0
90446,5,3,316779,316779,316782,0,3,2
90447,4,2,316783,316783,316785,0,2,1
90448,5,3,316788,316788,316791,0,3,3
90449,2,2,316790,316791,316793,1,3,0
90450,3,3,316793,316793,316796,0,3,0
90451,4,3,316797,316797,316800,0,3,1
90452,6,1,316803,316803,316804,0,1,3
90453,3,2,316806,316806,316808,0,2,2
90454,3,3,316809,316809,316812,0,3,1
90455,6,3,316815,316815,316818,0,3,3
90456,4,2,316819,316819,316821,0,2,1
90457,5,1,316824,316824,316825,0,1,3
90458,3,1,316827,316827,316828,0,1,2
90459,2,2,316829,316829,316831,0,2,1
90460,2,3,316831,316831,316834,0,3,0
90461,6,1,316837,316837,316838,0,1,3
90462,3,2,316840,316840,316842,0,2,2
90463,6,2,316846,316846,316848,0,2,4
90464,3,2,316849,316849,316851,0,2,1
90465,5,3,316854,316854,316857,0,3,3
90466,6,2,316860,316860,316862,0,2,3
90467,4,3,316864,316864,316867,0,3,2
90468,2,3,316866,316867,316870,1,4,0
90469,5,3,316871,316871,316874,0,3,1
90470,5,1,316876,316876,316877,0,1,2
90471,2,1,316878,316878,316879,0,1,1
90472,1,1,316879,316879,316880,0,1,0
90473,3,3,316882,316882,316885,0,3,2
90474,5,2,316887,316887,316889,0,2,2
90475,4,1,316891,316891,316892,0,1,2
90476,4,3,316895,316895,316898,0,3,3
90477,6,2,316901,316901,316903,0,2,3
90478,3,3,316904,316904,316907,0,3,1
90479,2,2,316906,316907,316909,1,3,0
90480,4,1,316910,316910,316911,0,1,1
90481,6,1,316916,316916,316917,0,1,5
90482,5,2,316921,316921,316923,0,2,4
90483,1,3,316922,316923,316926,1,4,0
90484,2,3,316924,316926,316929,2,5,0
90485,1,2,316925,316929,316931,4,6,0
90486,3,1,316928,316931,316932,3,4,0
90487,2,1,316930,316932,316933,2,3,0
90488,2,1,316932,316933,316934,1,2,0
90489,5,1,316937,316937,316938,0,1,3
90490,5,3,316942,316942,316945,0,3,4
90491,2,3,316944,316945,316948,1,4,0
90492,6,1,316950,316950,316951,0,1,2
90493,4,3,316954,316954,316957,0,3,3
90494,5,1,316959,316959,316960,0,1,2
90495,6,3,316965,316965,316968,0,3,5
90496,4,1,316969,316969,316970,0,1,1
90497,4,2,316973,316973,316975,0,2,3
90498,1,2,316974,316975,316977,1,3,0
90499,2,3,316976,316977,316980,1,4,0
90500,5,3,316981,316981,316984,0,3,1
90501,5,3,316986,316986,316989,0,3,2
90502,6,2,316992,316992,316994,0,2,3
90503,2,3,316994,316994,316997,0,3,0
90504,2,2,316996,316997,316999,1,3,0
90505,4,2,317000,317000,317002,0,2,1
90506,4,1,317004,317004,317005,0,1,2
90507,6,3,317010,317010,317013,0,3,5
90508,2,3,317012,317013,317016,1,4,0
90509,2,1,317014,317016,317017,2,3,0
90510,1,2,317015,317017,317019,2,4,0
90511,5,2,317020,317020,317022,0,2,1
90512,3,3,317023,317023,317026,0,3,1
90513,3,3,317026,317026,317029,0,3,0
90514,4,2,317030,317030,317032,0,2,1
90515,6,3,317036,317036,317039,0,3,4
90516,3,1,317039,317039,317040,0,1,0
90517,2,2,317041,317041,317043,0,2,1
90518,3,3,317044,317044,317047,0,3,1
90519,6,1,317050,317050,317051,0,1,3
90520,5,1,317055,317055,317056,0,1,4
90521,5,1,317060,317060,317061,0,1,4
90522,3,1,317063,317063,317064,0,1,2
90523,3,3,317066,317066,317069,0,3,2
90524,1,3,317067,317069,317072,2,5,0
90525,2,1,317069,317072,317073,3,4,0
90526,2,1,317071,317073,317074,2,3,0
90527,5,3,317076,317076,317079,0,3,2
90528,6,3,317082,317082,317085,0,3,3
90529,2,1,317084,317085,317086,1,2,0
90530,1,3,317085,317086,317089,1,4,0
90531,1,1,317086,317089,317090,3,4,0
90532,2,1,317088,317090,317091,2,3,0
90533,6,1,317094,317094,317095,0,1,3
90534,2,2,317096,317096,317098,0,2,1
90535,5,3,317101,317101,317104,0,3,3
90536,3,3,317104,317104,317107,0,3,0
90537,3,1,317107,317107,317108,0,1,0
90538,3,3,317110,317110,317113,0,3,2
90539,4,2,317114,317114,317116,0,2,1
90540,3,3,317117,317117,317120,0,3,1
90541,2,3,317119,317120,317123,1,4,0
90542,1,3,317120,317123,317126,3,6,0
90543,3,2,317123,317126,317128,3,5,0
90544,4,1,317127,317128,317129,1,2,0
90545,2,2,317129,317129,317131,0,2,0
90546,5,2,317134,317134,317136,0,2,3
90547,1,1,317135,317136,317137,1,2,0
90548,3,3,317138,317138,317141,0,3,1
90549,5,1,317143,317143,317144,0,1,2
90550,3,1,317146,317146,317147,0,1,2
90551,1,3,317147,317147,317150,0,3,0
90552,6,1,317153,317153,317154,0,1,3
90553,6,1,317159,317159,317160,0,1,5
90554,1,3,317160,317160,317163,0,3,0
90555,3,1,317163,317163,317164,0,1,0
90556,1,3,317164,317164,317167,0,3,0
90557,6,3,317170,317170,317173,0,3,3
90558,4,3,317174,317174,317177,0,3,1
90559,3,2,317177,317177,317179,0,2,0
90560,3,3,317180,317180,317183,0,3,1
90561,5,1,317185,317185,317186,0,1,2
90562,2,2,317187,317187,317189,0,2,1
90563,3,2,317190,317190,317192,0,2,1
90564,3,2,317193,317193,317195,0,2,1
90565,1,1,317194,317195,317196,1,2,0
90566,2,3,317196,317196,317199,0,3,0
90567,6,2,317202,317202,317204,0,2,3
90568,2,2,317204,317204,317206,0,2,0
90569,3,1,317207,317207,317208,0,1,1
90570,1,3,317208,317208,317211,0,3,0
90571,1,1,317209,317211,317212,2,3,0
90572,5,3,317214,317214,317217,0,3,2
90573,2,1,317216,317217,317218,1,2,0
90574,6,1,317222,317222,317223,0,1,4
90575,2,3,317224,317224,317227,0,3,1
90576,3,1,317227,317227,317228,0,1,0
90577,3,2,317230,317230,317232,0,2,2
90578,5,3,317235,317235,317238,0,3,3
90579,3,1,317238,317238,317239,0,1,0
90580,3,1,317241,317241,317242,0,1,2
90581,3,1,317244,317244,317245,0,1,2
90582,3,2,317247,317247,317249,0,2,2
90583,3,3,317250,317250,317253,0,3,1
90584,3,1,317253,317253,317254,0,1,0
90585,3,3,317256,317256,317259,0,3,2
90586,5,2,317261,317261,317263,0,2,2
90587,5,1,317266,317266,317267,0,1,3
90588,6,2,317272,317272,317274,0,2,5
90589,3,3,317275,317275,317278,0,3,1
90590,2,1,317277,317278,317279,1,2,0
90591,2,3,317279,317279,317282,0,3,0
90592,5,1,317284,317284,317285,0,1,2
90593,2,1,317286,317286,317287,0,1,1
90594,4,2,317290,317290,317292,0,2,3
90595,5,3,317295,317295,317298,0,3,3
90596,2,2,317297,317298,317300,1,3,0
90597,6,1,317303,317303,317304,0,1,3
90598,4,2,317307,317307,317309,0,2,3
90599,3,1,317310,317310,317311,0,1,1
90600,6,1,317316,317316,317317,0,1,5
90601,2,1,317318,317318,317319,0,1,1
90602,1,2,317319,317319,317321,0,2,0
90603,4,2,317323,317323,317325,0,2,2
90604,4,1,317327,317327,317328,0,1,2
90605,1,1,317328,317328,317329,0,1,0
90606,3,1,317331,317331,317332,0,1,2
90607,1,3,317332,317332,317335,0,3,0
90608,1,1,317333,317335,317336,2,3,0
90609,6,1,317339,317339,317340,0,1,3
90610,6,1,317345,317345,317346,0,1,5
90611,5,1,317350,317350,317351,0,1,4
90612,1,2,317351,317351,317353,0,2,0
90613,3,2,317354,317354,317356,0,2,1
90614,1,3,317355,317356,317359,1,4,0
90615,1,3,317356,317359,317362,3,6,0
90616,4,3,317360,317362,317365,2,5,0
90617,1,2,317361,317365,317367,4,6,0
90618,6,3,317367,317367,317370,0,3,0
90619,1,1,317368,317370,317371,2,3,0
90620,4,2,317372,317372,317374,0,2,1
90621,3,3,317375,317375,317378,0,3,1
90622,5,1,317380,317380,317381,0,1,2
90623,4,1,317384,317384,317385,0,1,3
90624,4,3,317388,317388,317391,0,3,3
90625,3,1,317391,317391,317392,0,1,0
90626,3,2,317394,317394,317396,0,2,2
90627,4,3,317398,317398,317401,0,3,2
90628,1,3,317399,317401,317404,2,5,0
90629,2,1,317401,317404,317405,3,4,0
90630,3,1,317404,317405,317406,1,2,0
90631,3,1,317407,317407,317408,0,1,1
90632,3,2,317410,317410,317412,0,2,2
90633,3,2,317413,317413,317415,0,2,1
90634,5,3,317418,317418,317421,0,3,3
90635,3,1,317421,317421,317422,0,1,0
90636,2,2,317423,317423,317425,0,2,1
90637,5,3,317428,317428,317431,0,3,3
90638,2,2,317430,317431,317433,1,3,0
90639,4,3,317434,317434,317437,0,3,1
90640,3,2,317437,317437,317439,0,2,0
90641,4,1,317441,317441,317442,0,1,2
90642,2,3,317443,317443,317446,0,3,1
90643,5,2,317448,317448,317450,0,2,2
90644,3,1,317451,317451,317452,0,1,1
90645,5,1,317456,317456,317457,0,1,4
90646,6,1,317462,317462,317463,0,1,5
90647,4,3,317466,317466,317469,0,3,3
90648,1,2,317467,317469,317471,2,4,0
90649,3,1,317470,317471,317472,1,2,0
90650,2,3,317472,317472,317475,0,3,0
90651,3,3,317475,317475,317478,0,3,0
90652,3,3,317478,317478,317481,0,3,0
90653,6,3,317484,317484,317487,0,3,3
90654,4,2,317488,317488,317490,0,2,1
90655,4,1,317492,317492,317493,0,1,2
90656,3,3,317495,317495,317498,0,3,2
90657,4,1,317499,317499,317500,0,1,1
90658,2,2,317501,317501,317503,0,2,1
90659,2,2,317503,317503,317505,0,2,0
90660,3,3,317506,317506,317509,0,3,1
90661,3,1,317509,317509,317510,0,1,0
90662,3,3,317512,317512,317515,0,3,2
90663,5,1,317517,317517,317518,0,1,2
90664,4,1,317521,317521,317522,0,1,3
90665,2,3,317523,317523,317526,0,3,1
90666,4,3,317527,317527,317530,0,3,1
90667,1,3,317528,317530,317533,2,5,0
90668,3,1,317531,317533,317534,2,3,0
90669,1,1,317532,317534,317535,2,3,0
90670,5,2,317537,317537,317539,0,2,2
90671,5,3,317542,317542,317545,0,3,3
90672,3,1,317545,317545,317546,0,1,0
90673,1,1,317546,317546,317547,0,1,0
90674,2,1,317548,317548,317549,0,1,1
90675,1,2,317549,317549,317551,0,2,0
90676,6,1,317555,317555,317556,0,1,4
90677,2,1,317557,317557,317558,0,1,1
90678,4,3,317561,317561,317564,0,3,3
90679,5,2,317566,317566,317568,0,2,2
90680,5,1,317571,317571,317572,0,1,3
90681,1,1,317572,317572,317573,0,1,0
90682,1,3,317573,317573,317576,0,3,0
90683,6,1,317579,317579,317580,0,1,3
90684,4,2,317583,317583,317585,0,2,3
90685,6,3,317589,317589,317592,0,3,4
90686,6,3,317595,317595,317598,0,3,3
90687,4,3,317599,317599,317602,0,3,1
90688,4,3,317603,317603,317606,0,3,1
90689,1,1,317604,317606,317607,2,3,0
90690,1,1,317605,317607,317608,2,3,0
90691,4,1,317609,317609,317610,0,1,1
90692,5,1,317614,317614,317615,0,1,4
90693,5,3,317619,317619,317622,0,3,4
90694,3,3,317622,317622,317625,0,3,0
90695,6,1,317628,317628,317629,0,1,3
90696,4,3,317632,317632,317635,0,3,3
90697,3,3,317635,317635,317638,0,3,0
90698,5,3,317640,317640,317643,0,3,2
90699,1,2,317641,317643,317645,2,4,0
90700,1,3,317642,317645,317648,3,6,0
90701,3,3,317645,317648,317651,3,6,0
90702,4,2,317649,317651,317653,2,4,0
90703,1,3,317650,317653,317656,3,6,0
90704,2,1,317652,317656,317657,4,5,0
90705,4,3,317656,317657,317660,1,4,0
90706,3,2,317659,317660,317662,1,3,0
90707,1,2,317660,317662,317664,2,4,0
90708,2,3,317662,317664,317667,2,5,0
90709,5,3,317667,317667,317670,0,3,0
90710,6,2,317673,317673,317675,0,2,3
90711,1,3,317674,317675,317678,1,4,0
90712,6,2,317680,317680,317682,0,2,2
90713,4,1,317684,317684,317685,0,1,2
90714,4,1,317688,317688,317689,0,1,3
90715,1,3,317689,317689,317692,0,3,0
90716,2,3,317691,317692,317695,1,4,0
90717,6,2,317697,317697,317699,0,2,2
90718,3,1,317700,317700,317701,0,1,1
90719,6,2,317706,317706,317708,0,2,5
90720,6,1,317712,317712,317713,0,1,4
90721,2,2,317714,317714,317716,0,2,1
90722,3,2,317717,317717,317719,0,2,1
90723,2,2,317719,317719,317721,0,2,0
90724,6,1,317725,317725,317726,0,1,4
90725,5,2,317730,317730,317732,0,2,4
90726,2,3,317732,317732,317735,0,3,0
90727,3,1,317735,317735,317736,0,1,0
90728,6,3,317741,317741,317744,0,3,5
90729,6,3,317747,317747,317750,0,3,3
90730,6,1,317753,317753,317754,0,1,3
90731,5,1,317758,317758,317759,0,1,4
90732,5,2,317763,317763,317765,0,2,4
90733,3,2,317766,317766,317768,0,2,1
90734,4,1,317770,317770,317771,0,1,2
90735,2,2,317772,317772,317774,0,2,1
90736,1,1,317773,317774,317775,1,2,0
90737,1,1,317774,317775,317776,1,2,0
90738,6,3,317780,317780,317783,0,3,4
90739,6,3,317786,317786,317789,0,3,3
90740,5,3,317791,317791,317794,0,3,2
90741,5,2,317796,317796,317798,0,2,2
90742,5,3,317801,317801,317804,0,3,3
90743,3,1,317804,317804,317805,0,1,0
90744,1,2,317805,317805,317807,0,2,0
90745,4,2,317809,317809,317811,0,2,2
90746,3,3,317812,317812,317815,0,3,1
90747,3,1,317815,317815,317816,0,1,0
90748,4,1,317819,317819,317820,0,1,3
90749,1,2,317820,317820,317822,0,2,0
90750,4,2,317824,317824,317826,0,2,2
90751,1,2,317825,317826,317828,1,3,0
90752,6,2,317831,317831,317833,0,2,3
90753,1,2,317832,317833,317835,1,3,0
90754,3,2,317835,317835,317837,0,2,0
90755,4,3,317839,317839,317842,0,3,2
90756,1,3,317840,317842,317845,2,5,0
90757,2,3,317842,317845,317848,3,6,0
90758,3,3,317845,317848,317851,3,6,0
90759,4,2,317849,317851,317853,2,4,0
90760,1,1,317850,317853,317854,3,4,0
90761,4,2,317854,317854,317856,0,2,0
90762,4,1,317858,317858,317859,0,1,2
90763,2,1,317860,317860,317861,0,1,1
90764,4,3,317864,317864,317867,0,3,3
90765,5,3,317869,317869,317872,0,3,2
90766,4,3,317873,317873,317876,0,3,1
90767,6,1,317879,317879,317880,0,1,3
90768,4,1,317883,317883,317884,0,1,3
90769,3,1,317886,317886,317887,0,1,2
90770,6,2,317892,317892,317894,0,2,5
90771,4,1,317896,317896,317897,0,1,2
90772,2,2,317898,317898,317900,0,2,1
90773,4,2,317902,317902,317904,0,2,2
90774,4,2,317906,317906,317908,0,2,2
90775,2,1,317908,317908,317909,0,1,0
90776,5,1,317913,317913,317914,0,1,4
90777,1,2,317914,317914,317916,0,2,0
90778,2,3,317916,317916,317919,0,3,0
90779,1,3,317917,317919,317922,2,5,0
90780,1,2,317918,317922,317924,4,6,0
90781,4,1,317922,317924,317925,2,3,0
90782,1,2,317923,317925,317927,2,4,0
90783,3,2,317926,317927,317929,1,3,0
90784,4,3,317930,317930,317933,0,3,1
90785,2,3,317932,317933,317936,1,4,0
90786,1,3,317933,317936,317939,3,6,0
90787,3,2,317936,317939,317941,3,5,0
90788,3,2,317939,317941,317943,2,4,0
90789,5,2,317944,317944,317946,0,2,1
90790,2,3,317946,317946,317949,0,3,0
90791,2,1,317948,317949,317950,1,2,0
90792,5,2,317953,317953,317955,0,2,3
90793,6,2,317959,317959,317961,0,2,4
90794,2,3,317961,317961,317964,0,3,0
90795,2,2,317963,317964,317966,1,3,0
90796,4,3,317967,317967,317970,0,3,1
90797,5,1,317972,317972,317973,0,1,2
90798,6,1,317978,317978,317979,0,1,5
90799,5,2,317983,317983,317985,0,2,4
90800,3,2,317986,317986,317988,0,2,1
90801,3,2,317989,317989,317991,0,2,1
90802,2,1,317991,317991,317992,0,1,0
90803,2,3,317993,317993,317996,0,3,1
90804,3,2,317996,317996,317998,0,2,0
90805,6,1,318002,318002,318003,0,1,4
90806,6,2,318008,318008,318010,0,2,5
90807,6,2,318014,318014,318016,0,2,4
90808,4,1,318018,318018,318019,0,1,2
90809,5,3,318023,318023,318026,0,3,4
90810,2,1,318025,318026,318027,1,2,0
90811,3,3,318028,318028,318031,0,3,1
90812,1,1,318029,318031,318032,2,3,0
90813,2,2,318031,318032,318034,1,3,0
90814,2,2,318033,318034,318036,1,3,0
90815,5,1,318038,318038,318039,0,1,2
90816,1,3,318039,318039,318042,0,3,0
90817,4,2,318043,318043,318045,0,2,1
90818,3,3,318046,318046,318049,0,3,1
90819,5,1,318051,318051,318052,0,1,2
90820,3,2,318054,318054,318056,0,2,2
90821,1,1,318055,318056,318057,1,2,0
90822,3,2,318058,318058,318060,0,2,1
90823,3,2,318061,318061,318063,0,2,1
90824,5,3,318066,318066,318069,0,3,3
90825,6,2,318072,318072,318074,0,2,3
90826,4,2,318076,318076,318078,0,2,2
90827,1,2,318077,318078,318080,1,3,0
90828,1,1,318078,318080,318081,2,3,0
90829,3,1,318081,318081,318082,0,1,0
90830,2,1,318083,318083,318084,0,1,1
90831,5,2,318088,318088,318090,0,2,4
90832,1,2,318089,318090,318092,1,3,0
90833,6,1,318095,318095,318096,0,1,3
90834,6,1,318101,318101,318102,0,1,5
90835,1,2,318102,318102,318104,0,2,0
90836,1,2,318103,318104,318106,1,3,0
90837,2,2,318105,318106,318108,1,3,0
90838,1,1,318106,318108,318109,2,3,0
90839,6,1,318112,318112,318113,0,1,3
90840,4,3,318116,318116,318119,0,3,3
90841,4,3,318120,318120,318123,0,3,1
90842,1,1,318121,318123,318124,2,3,0
90843,6,3,318127,318127,318130,0,3,3
90844,1,1,318128,318130,318131,2,3,0
90845,2,1,318130,318131,318132,1,2,0
90846,3,1,318133,318133,318134,0,1,1
90847,3,3,318136,318136,318139,0,3,2
90848,5,2,318141,318141,318143,0,2,2
90849,5,1,318146,318146,318147,0,1,3
90850,5,1,318151,318151,318152,0,1,4
90851,4,2,318155,318155,318157,0,2,3
90852,4,1,318159,318159,318160,0,1,2
90853,2,1,318161,318161,318162,0,1,1
90854,1,3,318162,318162,318165,0,3,0
90855,6,3,318168,318168,318171,0,3,3
90856,2,1,318170,318171,318172,1,2,0
90857,1,2,318171,318172,318174,1,3,0
90858,6,2,318177,318177,318179,0,2,3
90859,3,1,318180,318180,318181,0,1,1
90860,2,2,318182,318182,318184,0,2,1
90861,6,2,318188,318188,318190,0,2,4
90862,4,3,318192,318192,318195,0,3,2
90863,1,3,318193,318195,318198,2,5,0
90864,4,1,318197,318198,318199,1,2,0
90865,3,1,318200,318200,318201,0,1,1
90866,2,3,318202,318202,318205,0,3,1
90867,6,1,318208,318208,318209,0,1,3
90868,5,1,318213,318213,318214,0,1,4
90869,1,1,318214,318214,318215,0,1,0
90870,4,2,318218,318218,318220,0,2,3
90871,5,2,318223,318223,318225,0,2,3
90872,4,3,318227,318227,318230,0,3,2
90873,2,2,318229,318230,318232,1,3,0
90874,1,1,318230,318232,318233,2,3,0
90875,5,3,318235,318235,318238,0,3,2
90876,4,1,318239,318239,318240,0,1,1
90877,4,3,318243,318243,318246,0,3,3
90878,1,2,318244,318246,318248,2,4,0
90879,4,3,318248,318248,318251,0,3,0
90880,6,3,318254,318254,318257,0,3,3
90881,5,2,318259,318259,318261,0,2,2
90882,6,1,318265,318265,318266,0,1,4
90883,4,3,318269,318269,318272,0,3,3
90884,2,1,318271,318272,318273,1,2,0
90885,6,1,318277,318277,318278,0,1,4
90886,1,1,318278,318278,318279,0,1,0
90887,5,1,318283,318283,318284,0,1,4
90888,3,1,318286,318286,318287,0,1,2
90889,4,2,318290,318290,318292,0,2,3
90890,4,1,318294,318294,318295,0,1,2
90891,2,1,318296,318296,318297,0,1,1
90892,4,3,318300,318300,318303,0,3,3
90893,2,2,318302,318303,318305,1,3,0
90894,3,3,318305,318305,318308,0,3,0
90895,2,2,318307,318308,318310,1,3,0
90896,1,2,318308,318310,318312,2,4,0
90897,5,3,318313,318313,318316,0,3,1
90898,1,2,318314,318316,318318,2,4,0
90899,1,1,318315,318318,318319,3,4,0
90900,3,3,318318,318319,318322,1,4,0
90901,6,2,318324,318324,318326,0,2,2
90902,4,2,318328,318328,318330,0,2,2
90903,4,3,318332,318332,318335,0,3,2
90904,4,3,318336,318336,318339,0,3,1
90905,1,3,318337,318339,318342,2,5,0
90906,6,2,318343,318343,318345,0,2,1
90907,1,2,318344,318345,318347,1,3,0
90908,6,2,318350,318350,318352,0,2,3
90909,4,3,318354,318354,318357,0,3,2
90910,2,1,318356,318357,318358,1,2,0
90911,1,2,318357,318358,318360,1,3,0
90912,5,2,318362,318362,318364,0,2,2
90913,3,2,318365,318365,318367,0,2,1
90914,3,2,318368,318368,318370,0,2,1
90915,4,3,318372,318372,318375,0,3,2
90916,1,1,318373,318375,318376,2,3,0
90917,5,3,318378,318378,318381,0,3,2
90918,2,3,318380,318381,318384,1,4,0
90919,2,1,318382,318384,318385,2,3,0
90920,3,2,318385,318385,318387,0,2,0
90921,4,1,318389,318389,318390,0,1,2
90922,2,2,318391,318391,318393,0,2,1
90923,4,2,318395,318395,318397,0,2,2
90924,3,3,318398,318398,318401,0,3,1
90925,4,3,318402,318402,318405,0,3,1
90926,3,3,318405,318405,318408,0,3,0
90927,3,1,318408,318408,318409,0,1,0
90928,4,2,318412,318412,318414,0,2,3
90929,1,3,318413,318414,318417,1,4,0
90930,2,3,318415,318417,318420,2,5,0
90931,1,1,318416,318420,318421,4,5,0
90932,5,1,318421,318421,318422,0,1,0
90933,5,3,318426,318426,318429,0,3,4
90934,1,2,318427,318429,318431,2,4,0
90935,4,3,318431,318431,318434,0,3,0
90936,6,3,318437,318437,318440,0,3,3
90937,5,2,318442,318442,318444,0,2,2
90938,4,3,318446,318446,318449,0,3,2
90939,6,2,318452,318452,318454,0,2,3
90940,1,1,318453,318454,318455,1,2,0
90941,5,2,318458,318458,318460,0,2,3
90942,3,3,318461,318461,318464,0,3,1
90943,3,2,318464,318464,318466,0,2,0
90944,6,1,318470,318470,318471,0,1,4
90945,1,2,318471,318471,318473,0,2,0
90946,4,3,318475,318475,318478,0,3,2
90947,1,1,318476,318478,318479,2,3,0
90948,2,2,318478,318479,318481,1,3,0
90949,6,1,318484,318484,318485,0,1,3
90950,2,1,318486,318486,318487,0,1,1
90951,2,1,318488,318488,318489,0,1,1
90952,4,3,318492,318492,318495,0,3,3
90953,2,1,318494,318495,318496,1,2,0
90954,5,2,318499,318499,318501,0,2,3
90955,1,3,318500,318501,318504,1,4,0
90956,4,2,318504,318504,318506,0,2,0
90957,3,1,318507,318507,318508,0,1,1
90958,3,3,318510,318510,318513,0,3,2
90959,1,2,318511,318513,318515,2,4,0
90960,1,1,318512,318515,318516,3,4,0
90961,6,2,318518,318518,318520,0,2,2
90962,6,3,318524,318524,318527,0,3,4
90963,2,1,318526,318527,318528,1,2,0
90964,2,3,318528,318528,318531,0,3,0
90965,4,1,318532,318532,318533,0,1,1
90966,4,1,318536,318536,318537,0,1,3
90967,4,3,318540,318540,318543,0,3,3
90968,1,2,318541,318543,318545,2,4,0
90969,3,1,318544,318545,318546,1,2,0
90970,3,3,318547,318547,318550,0,3,1
90971,6,2,318553,318553,318555,0,2,3
90972,6,2,318559,318559,318561,0,2,4
90973,5,3,318564,318564,318567,0,3,3
90974,1,2,318565,318567,318569,2,4,0
90975,4,3,318569,318569,318572,0,3,0
90976,2,2,318571,318572,318574,1,3,0
90977,1,1,318572,318574,318575,2,3,0
90978,2,1,318574,318575,318576,1,2,0
90979,4,3,318578,318578,318581,0,3,2
90980,4,1,318582,318582,318583,0,1,1
90981,1,1,318583,318583,318584,0,1,0
90982,6,2,318589,318589,318591,0,2,5
90983,4,3,318593,318593,318596,0,3,2
90984,6,3,318599,318599,318602,0,3,3
90985,4,3,318603,318603,318606,0,3,1
90986,5,1,318608,318608,318609,0,1,2
90987,5,2,318613,318613,318615,0,2,4
90988,2,1,318615,318615,318616,0,1,0
90989,6,2,318621,318621,318623,0,2,5
90990,4,1,318625,318625,318626,0,1,2
90991,5,1,318630,318630,318631,0,1,4
90992,4,1,318634,318634,318635,0,1,3
90993,3,2,318637,318637,318639,0,2,2
90994,1,1,318638,318639,318640,1,2,0
90995,3,2,318641,318641,318643,0,2,1
90996,6,2,318647,318647,318649,0,2,4
90997,2,1,318649,318649,318650,0,1,0
90998,1,3,318650,318650,318653,0,3,0
90999,6,1,318656,318656,318657,0,1,3
91000,1,3,318657,318657,318660,0,3,0
91001,3,1,318660,318660,318661,0,1,0
91002,3,2,318663,318663,318665,0,2,2
91003,3,2,318666,318666,318668,0,2,1
91004,6,3,318672,318672,318675,0,3,4
91005,3,1,318675,318675,318676,0,1,0
91006,6,2,318681,318681,318683,0,2,5
91007,1,2,318682,318683,318685,1,3,0
91008,2,3,318684,318685,318688,1,4,0
91009,2,3,318686,318688,318691,2,5,0
91010,1,3,318687,318691,318694,4,7,0
91011,2,2,318689,318694,318696,5,7,0
91012,1,2,318690,318696,318698,6,8,0
91013,3,1,318693,318698,318699,5,6,0
91014,2,3,318695,318699,318702,4,7,0
91015,1,2,318696,318702,318704,6,8,0
91016,3,1,318699,318704,318705,5,6,0
91017,1,3,318700,318705,318708,5,8,0
91018,5,2,318705,318708,318710,3,5,0
91019,6,2,318711,318711,318713,0,2,1
91020,5,2,318716,318716,318718,0,2,3
91021,6,3,318722,318722,318725,0,3,4
91022,5,2,318727,318727,318729,0,2,2
91023,3,2,318730,318730,318732,0,2,1
91024,4,3,318734,318734,318737,0,3,2
91025,6,1,318740,318740,318741,0,1,3
91026,4,3,318744,318744,318747,0,3,3
91027,2,3,318746,318747,318750,1,4,0
91028,4,1,318750,318750,318751,0,1,0
91029,2,1,318752,318752,318753,0,1,1
91030,2,3,318754,318754,318757,0,3,1
91031,3,3,318757,318757,318760,0,3,0
91032,4,1,318761,318761,318762,0,1,1
91033,4,1,318765,318765,318766,0,1,3
91034,5,2,318770,318770,318772,0,2,4
91035,2,2,318772,318772,318774,0,2,0
91036,2,1,318774,318774,318775,0,1,0
91037,4,3,318778,318778,318781,0,3,3
91038,2,3,318780,318781,318784,1,4,0
91039,3,2,318783,318784,318786,1,3,0
91040,3,1,318786,318786,318787,0,1,0
91041,4,2,318790,318790,318792,0,2,3
91042,4,2,318794,318794,318796,0,2,2
91043,4,3,318798,318798,318801,0,3,2
91044,2,2,318800,318801,318803,1,3,0
91045,5,2,318805,318805,318807,0,2,2
91046,3,1,318808,318808,318809,0,1,1
91047,1,1,318809,318809,318810,0,1,0
91048,2,3,318811,318811,318814,0,3,1
91049,2,2,318813,318814,318816,1,3,0
91050,5,3,318818,318818,318821,0,3,2
91051,3,2,318821,318821,318823,0,2,0
91052,5,3,318826,318826,318829,0,3,3
91053,1,3,318827,318829,318832,2,5,0
91054,4,1,318831,318832,318833,1,2,0
91055,2,2,318833,318833,318835,0,2,0
91056,1,2,318834,318835,318837,1,3,0
91057,5,2,318839,318839,318841,0,2,2
91058,2,2,318841,318841,318843,0,2,0
91059,1,1,318842,318843,318844,1,2,0
91060,6,1,318848,318848,318849,0,1,4
91061,4,1,318852,318852,318853,0,1,3
91062,4,3,318856,318856,318859,0,3,3
91063,2,3,318858,318859,318862,1,4,0
91064,2,3,318860,318862,318865,2,5,0
91065,4,3,318864,318865,318868,1,4,0
91066,3,2,318867,318868,318870,1,3,0
91067,4,3,318871,318871,318874,0,3,1
91068,1,3,318872,318874,318877,2,5,0
91069,1,1,318873,318877,318878,4,5,0
91070,6,2,318879,318879,318881,0,2,1
91071,2,2,318881,318881,318883,0,2,0
91072,5,3,318886,318886,318889,0,3,3
91073,6,1,318892,318892,318893,0,1,3
91074,1,1,318893,318893,318894,0,1,0
91075,2,1,318895,318895,318896,0,1,1
91076,6,1,318901,318901,318902,0,1,5
91077,1,3,318902,318902,318905,0,3,0
91078,4,1,318906,318906,318907,0,1,1
91079,6,3,318912,318912,318915,0,3,5
91080,5,2,318917,318917,318919,0,2,2
91081,1,3,318918,318919,318922,1,4,0
91082,5,1,318923,318923,318924,0,1,1
91083,2,1,318925,318925,318926,0,1,1
91084,5,3,318930,318930,318933,0,3,4
91085,6,2,318936,318936,318938,0,2,3
91086,1,2,318937,318938,318940,1,3,0
91087,5,1,318942,318942,318943,0,1,2
91088,3,2,318945,318945,318947,0,2,2
91089,1,3,318946,318947,318950,1,4,0
91090,3,3,318949,318950,318953,1,4,0
91091,4,1,318953,318953,318954,0,1,0
91092,6,1,318959,318959,318960,0,1,5
91093,1,2,318960,318960,318962,0,2,0
91094,1,2,318961,318962,318964,1,3,0
91095,4,2,318965,318965,318967,0,2,1
91096,1,1,318966,318967,318968,1,2,0
91097,2,1,318968,318968,318969,0,1,0
91098,2,2,318970,318970,318972,0,2,1
91099,1,2,318971,318972,318974,1,3,0
91100,6,3,318977,318977,318980,0,3,3
91101,3,2,318980,318980,318982,0,2,0
91102,4,1,318984,318984,318985,0,1,2
91103,2,1,318986,318986,318987,0,1,1
91104,5,1,318991,318991,318992,0,1,4
91105,2,2,318993,318993,318995,0,2,1
91106,2,1,318995,318995,318996,0,1,0
91107,4,2,318999,318999,319001,0,2,3
91108,2,3,319001,319001,319004,0,3,0
91109,5,3,319006,319006,319009,0,3,2
91110,5,3,319011,319011,319014,0,3,2
91111,4,2,319015,319015,319017,0,2,1
91112,3,2,319018,319018,319020,0,2,1
91113,3,3,319021,319021,319024,0,3,1
91114,5,3,319026,319026,319029,0,3,2
91115,3,2,319029,319029,319031,0,2,0
91116,2,2,319031,319031,319033,0,2,0
91117,5,2,319036,319036,319038,0,2,3
91118,3,2,319039,319039,319041,0,2,1
91119,3,3,319042,319042,319045,0,3,1
91120,4,2,319046,319046,319048,0,2,1
91121,4,2,319050,319050,319052,0,2,2
91122,3,3,319053,319053,319056,0,3,1
91123,4,3,319057,319057,319060,0,3,1
91124,6,3,319063,319063,319066,0,3,3
91125,5,1,319068,319068,319069,0,1,2
91126,3,3,319071,319071,319074,0,3,2
91127,5,2,319076,319076,319078,0,2,2
91128,4,1,319080,319080,319081,0,1,2
91129,6,3,319086,319086,319089,0,3,5
91130,2,3,319088,319089,319092,1,4,0
91131,5,1,319093,319093,319094,0,1,1
91132,1,1,319094,319094,319095,0,1,0
91133,3,3,319097,319097,319100,0,3,2
91134,1,3,319098,319100,319103,2,5,0
91135,6,3,319104,319104,319107,0,3,1
91136,3,1,319107,319107,319108,0,1,0
91137,5,1,319112,319112,319113,0,1,4
91138,1,1,319113,319113,319114,0,1,0
91139,6,2,319119,319119,319121,0,2,5
91140,2,1,319121,319121,319122,0,1,0
91141,5,1,319126,319126,319127,0,1,4
91142,2,3,319128,319128,319131,0,3,1
91143,4,1,319132,319132,319133,0,1,1
91144,1,2,319133,319133,319135,0,2,0
91145,5,3,319138,319138,319141,0,3,3
91146,6,2,319144,319144,319146,0,2,3
91147,5,2,319149,319149,319151,0,2,3
91148,4,3,319153,319153,319156,0,3,2
91149,6,2,319159,319159,319161,0,2,3
91150,1,2,319160,319161,319163,1,3,0
91151,4,1,319164,319164,319165,0,1,1
91152,4,2,319168,319168,319170,0,2,3
91153,3,1,319171,319171,319172,0,1,1
91154,1,3,319172,319172,319175,0,3,0
91155,6,3,319178,319178,319181,0,3,3
91156,6,3,319184,319184,319187,0,3,3
91157,2,3,319186,319187,319190,1,4,0
91158,2,2,319188,319190,319192,2,4,0
91159,4,2,319192,319192,319194,0,2,0
91160,1,3,319193,319194,319197,1,4,0
91161,2,2,319195,319197,319199,2,4,0
91162,4,3,319199,319199,319202,0,3,0
91163,6,3,319205,319205,319208,0,3,3
91164,2,3,319207,319208,319211,1,4,0
91165,5,3,319212,319212,319215,0,3,1
91166,5,1,319217,319217,319218,0,1,2
91167,3,3,319220,319220,319223,0,3,2
91168,6,2,319226,319226,319228,0,2,3
91169,1,1,319227,319228,319229,1,2,0
91170,4,1,319231,319231,319232,0,1,2
91171,2,3,319233,319233,319236,0,3,1
91172,3,3,319236,319236,319239,0,3,0
91173,4,3,319240,319240,319243,0,3,1
91174,4,2,319244,319244,319246,0,2,1
91175,6,3,319250,319250,319253,0,3,4
91176,6,2,319256,319256,319258,0,2,3
91177,6,3,319262,319262,319265,0,3,4
91178,1,1,319263,319265,319266,2,3,0
91179,5,3,319268,319268,319271,0,3,2
91180,4,2,319272,319272,319274,0,2,1
91181,2,2,319274,319274,319276,0,2,0
91182,1,1,319275,319276,319277,1,2,0
91183,2,1,319277,319277,319278,0,1,0
91184,2,3,319279,319279,319282,0,3,1
91185,1,3,319280,319282,319285,2,5,0
91186,3,2,319283,319285,319287,2,4,0
91187,4,3,319287,319287,319290,0,3,0
91188,1,3,319288,319290,319293,2,5,0
91189,6,3,319294,319294,319297,0,3,1
91190,3,3,319297,319297,319300,0,3,0
91191,5,1,319302,319302,319303,0,1,2
91192,5,1,319307,319307,319308,0,1,4
91193,6,1,319313,319313,319314,0,1,5
91194,3,2,319316,319316,319318,0,2,2
91195,3,2,319319,319319,319321,0,2,1
91196,1,3,319320,319321,319324,1,4,0
91197,6,2,319326,319326,319328,0,2,2
91198,4,1,319330,319330,319331,0,1,2
91199,5,2,319335,319335,319337,0,2,4
91200,1,3,319336,319337,319340,1,4,0
91201,5,3,319341,319341,319344,0,3,1
91202,4,3,319345,319345,319348,0,3,1
91203,3,1,319348,319348,319349,0,1,0
91204,6,2,319354,319354,319356,0,2,5
91205,3,1,319357,319357,319358,0,1,1
91206,4,3,319361,319361,319364,0,3,3
91207,6,1,319367,319367,319368,0,1,3
91208,2,1,319369,319369,319370,0,1,1
91209,2,2,319371,319371,319373,0,2,1
91210,2,3,319373,319373,319376,0,3,0
91211,2,1,319375,319376,319377,1,2,0
91212,6,3,319381,319381,319384,0,3,4
91213,5,2,319386,319386,319388,0,2,2
91214,6,3,319392,319392,319395,0,3,4
91215,3,3,319395,319395,319398,0,3,0
91216,1,3,319396,319398,319401,2,5,0
91217,2,3,319398,319401,319404,3,6,0
91218,5,1,319403,319404,319405,1,2,0
91219,1,3,319404,319405,319408,1,4,0
91220,1,3,319405,319408,319411,3,6,0
91221,3,3,319408,319411,319414,3,6,0
91222,1,2,319409,319414,319416,5,7,0
91223,3,2,319412,319416,319418,4,6,0
91224,3,2,319415,319418,319420,3,5,0
91225,5,2,319420,319420,319422,0,2,0
91226,1,3,319421,319422,319425,1,4,0
91227,5,2,319426,319426,319428,0,2,1
91228,3,2,319429,319429,319431,0,2,1
91229,1,2,319430,319431,319433,1,3,0
91230,6,2,319436,319436,319438,0,2,3
91231,2,2,319438,319438,319440,0,2,0
91232,2,3,319440,319440,319443,0,3,0
91233,5,1,319445,319445,319446,0,1,2
91234,4,3,319449,319449,319452,0,3,3
91235,4,1,319453,319453,319454,0,1,1
91236,3,2,319456,319456,319458,0,2,2
91237,2,2,319458,319458,319460,0,2,0
91238,6,2,319464,319464,319466,0,2,4
91239,4,2,319468,319468,319470,0,2,2
91240,2,2,319470,319470,319472,0,2,0
91241,4,3,319474,319474,319477,0,3,2
91242,4,1,319478,319478,319479,0,1,1
91243,1,1,319479,319479,319480,0,1,0
91244,6,1,319485,319485,319486,0,1,5
91245,1,2,319486,319486,319488,0,2,0
91246,2,3,319488,319488,319491,0,3,0
91247,2,1,319490,319491,319492,1,2,0
91248,3,2,319493,319493,319495,0,2,1
91249,2,3,319495,319495,319498,0,3,0
91250,5,2,319500,319500,319502,0,2,2
91251,5,1,319505,319505,319506,0,1,3
91252,2,1,319507,319507,319508,0,1,1
91253,4,2,319511,319511,319513,0,2,3
91254,2,3,319513,319513,319516,0,3,0
91255,3,2,319516,319516,319518,0,2,0
91256,1,1,319517,319518,319519,1,2,0
91257,4,3,319521,319521,319524,0,3,2
91258,2,3,319523,319524,319527,1,4,0
91259,3,1,319526,319527,319528,1,2,0
91260,4,2,319530,319530,319532,0,2,2
91261,1,3,319531,319532,319535,1,4,0
91262,6,3,319537,319537,319540,0,3,2
91263,5,1,319542,319542,319543,0,1,2
91264,6,3,319548,319548,319551,0,3,5
91265,4,3,319552,319552,319555,0,3,1
91266,3,1,319555,319555,319556,0,1,0
91267,1,2,319556,319556,319558,0,2,0
91268,6,3,319562,319562,319565,0,3,4
91269,4,3,319566,319566,319569,0,3,1
91270,6,3,319572,319572,319575,0,3,3
91271,5,1,319577,319577,319578,0,1,2
91272,1,3,319578,319578,319581,0,3,0
91273,5,2,319583,319583,319585,0,2,2
91274,3,1,319586,319586,319587,0,1,1
91275,4,1,319590,319590,319591,0,1,3
91276,4,3,319594,319594,319597,0,3,3
91277,5,3,319599,319599,319602,0,3,2
91278,5,1,319604,319604,319605,0,1,2
91279,3,1,319607,319607,319608,0,1,2
91280,6,3,319613,319613,319616,0,3,5
91281,5,1,319618,319618,319619,0,1,2
91282,5,2,319623,319623,319625,0,2,4
91283,5,1,319628,319628,319629,0,1,3
91284,2,2,319630,319630,319632,0,2,1
91285,6,3,319636,319636,319639,0,3,4
91286,3,1,319639,319639,319640,0,1,0
91287,4,2,319643,319643,319645,0,2,3
91288,2,1,319645,319645,319646,0,1,0
91289,4,2,319649,319649,319651,0,2,3
91290,5,2,319654,319654,319656,0,2,3
91291,5,1,319659,319659,319660,0,1,3
91292,1,2,319660,319660,319662,0,2,0
91293,4,1,319664,319664,319665,0,1,2
91294,1,1,319665,319665,319666,0,1,0
91295,3,2,319668,319668,319670,0,2,2
91296,3,1,319671,319671,319672,0,1,1
91297,3,1,319674,319674,319675,0,1,2
91298,1,1,319675,319675,319676,0,1,0
91299,3,2,319678,319678,319680,0,2,2
91300,5,1,319683,319683,319684,0,1,3
91301,1,2,319684,319684,319686,0,2,0
91302,5,3,319689,319689,319692,0,3,3
91303,2,1,319691,319692,319693,1,2,0
91304,4,3,319695,319695,319698,0,3,2
91305,1,1,319696,319698,319699,2,3,0
91306,1,3,319697,319699,319702,2,5,0
91307,3,1,319700,319702,319703,2,3,0
91308,6,3,319706,319706,319709,0,3,3
91309,2,1,319708,319709,319710,1,2,0
91310,4,1,319712,319712,319713,0,1,2
91311,6,3,319718,319718,319721,0,3,5
91312,1,3,319719,319721,319724,2,5,0
91313,3,1,319722,319724,319725,2,3,0
91314,4,2,319726,319726,319728,0,2,1
91315,3,2,319729,319729,319731,0,2,1
91316,2,3,319731,319731,319734,0,3,0
91317,3,2,319734,319734,319736,0,2,0
91318,5,1,319739,319739,319740,0,1,3
91319,2,1,319741,319741,319742,0,1,1
91320,4,1,319745,319745,319746,0,1,3
91321,3,1,319748,319748,319749,0,1,2
91322,2,2,319750,319750,319752,0,2,1
91323,1,2,319751,319752,319754,1,3,0
91324,6,3,319757,319757,319760,0,3,3
91325,6,2,319763,319763,319765,0,2,3
91326,4,3,319767,319767,319770,0,3,2
91327,3,2,319770,319770,319772,0,2,0
91328,3,2,319773,319773,319775,0,2,1
91329,6,3,319779,319779,319782,0,3,4
91330,4,2,319783,319783,319785,0,2,1
91331,2,2,319785,319785,319787,0,2,0
91332,1,3,319786,319787,319790,1,4,0
91333,1,2,319787,319790,319792,3,5,0
91334,1,2,319788,319792,319794,4,6,0
91335,4,3,319792,319794,319797,2,5,0
91336,5,2,319797,319797,319799,0,2,0
91337,5,1,319802,319802,319803,0,1,3
91338,1,1,319803,319803,319804,0,1,0
91339,3,2,319806,319806,319808,0,2,2
91340,2,1,319808,319808,319809,0,1,0
91341,6,3,319814,319814,319817,0,3,5
91342,2,3,319816,319817,319820,1,4,0
91343,5,2,319821,319821,319823,0,2,1
91344,1,2,319822,319823,319825,1,3,0
91345,6,1,319828,319828,319829,0,1,3
91346,1,1,319829,319829,319830,0,1,0
91347,4,2,319833,319833,319835,0,2,3
91348,4,1,319837,319837,319838,0,1,2
91349,5,2,319842,319842,319844,0,2,4
91350,1,2,319843,319844,319846,1,3,0
91351,6,1,319849,319849,319850,0,1,3
91352,3,3,319852,319852,319855,0,3,2
91353,1,3,319853,319855,319858,2,5,0
91354,3,3,319856,319858,319861,2,5,0
91355,3,3,319859,319861,319864,2,5,0
91356,6,1,319865,319865,319866,0,1,1
91357,6,3,319871,319871,319874,0,3,5
91358,5,1,319876,319876,319877,0,1,2
91359,1,2,319877,319877,319879,0,2,0
91360,1,1,319878,319879,319880,1,2,0
91361,4,3,319882,319882,319885,0,3,2
91362,2,2,319884,319885,319887,1,3,0
91363,6,3,319890,319890,319893,0,3,3
91364,2,2,319892,319893,319895,1,3,0
91365,5,2,319897,319897,319899,0,2,2
91366,3,1,319900,319900,319901,0,1,1
91367,6,1,319906,319906,319907,0,1,5
91368,4,1,319910,319910,319911,0,1,3
91369,6,1,319916,319916,319917,0,1,5
91370,4,3,319920,319920,319923,0,3,3
91371,5,3,319925,319925,319928,0,3,2
91372,5,3,319930,319930,319933,0,3,2
91373,2,3,319932,319933,319936,1,4,0
91374,4,2,319936,319936,319938,0,2,0
91375,3,3,319939,319939,319942,0,3,1
91376,5,1,319944,319944,319945,0,1,2
91377,5,3,319949,319949,319952,0,3,4
91378,5,3,319954,319954,319957,0,3,2
91379,3,3,319957,319957,319960,0,3,0
91380,3,3,319960,319960,319963,0,3,0
91381,4,1,319964,319964,319965,0,1,1
91382,1,2,319965,319965,319967,0,2,0
91383,5,2,319970,319970,319972,0,2,3
91384,2,1,319972,319972,319973,0,1,0
91385,3,2,319975,319975,319977,0,2,2
91386,2,1,319977,319977,319978,0,1,0
91387,5,1,319982,319982,319983,0,1,4
91388,3,2,319985,319985,319987,0,2,2
91389,2,3,319987,319987,319990,0,3,0
91390,6,1,319993,319993,319994,0,1,3
91391,4,2,319997,319997,319999,0,2,3
91392,1,2,319998,319999,320001,1,3,0
91393,6,3,320004,320004,320007,0,3,3
91394,4,2,320008,320008,320010,0,2,1
91395,1,2,320009,320010,320012,1,3,0
91396,2,3,320011,320012,320015,1,4,0
91397,6,3,320017,320017,320020,0,3,2
91398,3,2,320020,320020,320022,0,2,0
91399,1,1,320021,320022,320023,1,2,0
91400,6,2,320027,320027,320029,0,2,4
91401,4,1,320031,320031,320032,0,1,2
91402,5,3,320036,320036,320039,0,3,4
91403,2,3,320038,320039,320042,1,4,0
91404,2,2,320040,320042,320044,2,4,0
91405,1,2,320041,320044,320046,3,5,0
91406,3,3,320044,320046,320049,2,5,0
91407,5,1,320049,320049,320050,0,1,0
91408,3,2,320052,320052,320054,0,2,2
91409,5,3,320057,320057,320060,0,3,3
91410,6,1,320063,320063,320064,0,1,3
91411,6,2,320069,320069,320071,0,2,5
91412,1,2,320070,320071,320073,1,3,0
91413,2,1,320072,320073,320074,1,2,0
91414,3,1,320075,320075,320076,0,1,1
91415,3,2,320078,320078,320080,0,2,2
91416,3,2,320081,320081,320083,0,2,1
91417,5,1,320086,320086,320087,0,1,3
91418,3,1,320089,320089,320090,0,1,2
91419,4,3,320093,320093,320096,0,3,3
91420,6,1,320099,320099,320100,0,1,3
91421,3,3,320102,320102,320105,0,3,2
91422,2,1,320104,320105,320106,1,2,0
91423,4,2,320108,320108,320110,0,2,2
91424,5,1,320113,320113,320114,0,1,3
91425,5,2,320118,320118,320120,0,2,4
91426,3,3,320121,320121,320124,0,3,1
91427,6,3,320127,320127,320130,0,3,3
91428,5,1,320132,320132,320133,0,1,2
91429,1,1,320133,320133,320134,0,1,0
91430,4,2,320137,320137,320139,0,2,3
91431,5,2,320142,320142,320144,0,2,3
91432,4,2,320146,320146,320148,0,2,2
91433,6,2,320152,320152,320154,0,2,4
91434,4,1,320156,320156,320157,0,1,2
91435,1,3,320157,320157,320160,0,3,0
91436,4,1,320161,320161,320162,0,1,1
91437,1,3,320162,320162,320165,0,3,0
91438,2,1,320164,320165,320166,1,2,0
91439,1,2,320165,320166,320168,1,3,0
91440,1,2,320166,320168,320170,2,4,0
91441,3,3,320169,320170,320173,1,4,0
91442,2,1,320171,320173,320174,2,3,0
91443,2,1,320173,320174,320175,1,2,0
91444,3,3,320176,320176,320179,0,3,1
91445,5,2,320181,320181,320183,0,2,2
91446,1,2,320182,320183,320185,1,3,0
91447,4,2,320186,320186,320188,0,2,1
91448,6,2,320192,320192,320194,0,2,4
91449,3,2,320195,320195,320197,0,2,1
91450,2,2,320197,320197,320199,0,2,0
91451,5,1,320202,320202,320203,0,1,3
91452,3,2,320205,320205,320207,0,2,2
91453,4,3,320209,320209,320212,0,3,2
91454,4,2,320213,320213,320215,0,2,1
91455,5,2,320218,320218,320220,0,2,3
91456,1,1,320219,320220,320221,1,2,0
91457,3,2,320222,320222,320224,0,2,1
91458,5,3,320227,320227,320230,0,3,3
91459,4,3,320231,320231,320234,0,3,1
91460,5,1,320236,320236,320237,0,1,2
91461,6,3,320242,320242,320245,0,3,5
91462,5,2,320247,320247,320249,0,2,2
91463,3,2,320250,320250,320252,0,2,1
91464,6,1,320256,320256,320257,0,1,4
91465,1,3,320257,320257,320260,0,3,0
91466,4,2,320261,320261,320263,0,2,1
91467,3,1,320264,320264,320265,0,1,1
91468,6,2,320270,320270,320272,0,2,5
91469,4,3,320274,320274,320277,0,3,2
91470,6,1,320280,320280,320281,0,1,3
91471,2,3,320282,320282,320285,0,3,1
91472,4,2,320286,320286,320288,0,2,1
91473,1,2,320287,320288,320290,1,3,0
91474,4,1,320291,320291,320292,0,1,1
91475,5,1,320296,320296,320297,0,1,4
91476,5,1,320301,320301,320302,0,1,4
91477,6,2,320307,320307,320309,0,2,5
91478,6,3,320313,320313,320316,0,3,4
91479,3,2,320316,320316,320318,0,2,0
91480,1,3,320317,320318,320321,1,4,0
91481,2,2,320319,320321,320323,2,4,0
91482,1,3,320320,320323,320326,3,6,0
91483,6,1,320326,320326,320327,0,1,0
91484,5,1,320331,320331,320332,0,1,4
91485,1,2,320332,320332,320334,0,2,0
91486,1,1,320333,320334,320335,1,2,0
91487,2,3,320335,320335,320338,0,3,0
91488,2,2,320337,320338,320340,1,3,0
91489,1,1,320338,320340,320341,2,3,0
91490,3,2,320341,320341,320343,0,2,0
91491,6,2,320347,320347,320349,0,2,4
91492,5,2,320352,320352,320354,0,2,3
91493,2,1,320354,320354,320355,0,1,0
91494,6,2,320360,320360,320362,0,2,5
91495,1,3,320361,320362,320365,1,4,0
91496,3,2,320364,320365,320367,1,3,0
91497,3,1,320367,320367,320368,0,1,0
91498,5,1,320372,320372,320373,0,1,4
91499,2,1,320374,320374,320375,0,1,1
91500,3,2,320377,320377,320379,0,2,2
91501,5,2,320382,320382,320384,0,2,3
91502,6,2,320388,320388,320390,0,2,4
91503,3,1,320391,320391,320392,0,1,1
91504,3,2,320394,320394,320396,0,2,2
91505,3,2,320397,320397,320399,0,2,1
91506,1,1,320398,320399,320400,1,2,0
91507,2,3,320400,320400,320403,0,3,0
91508,2,2,320402,320403,320405,1,3,0
91509,1,1,320403,320405,320406,2,3,0
91510,2,3,320405,320406,320409,1,4,0
91511,1,2,320406,320409,320411,3,5,0
91512,6,2,320412,320412,320414,0,2,1
91513,1,2,320413,320414,320416,1,3,0
91514,3,1,320416,320416,320417,0,1,0
91515,5,3,320421,320421,320424,0,3,4
91516,5,1,320426,320426,320427,0,1,2
91517,3,1,320429,320429,320430,0,1,2
91518,3,2,320432,320432,320434,0,2,2
91519,1,3,320433,320434,320437,1,4,0
91520,1,2,320434,320437,320439,3,5,0
91521,3,3,320437,320439,320442,2,5,0
91522,3,1,320440,320442,320443,2,3,0
91523,4,2,320444,320444,320446,0,2,1
91524,5,2,320449,320449,320451,0,2,3
91525,2,3,320451,320451,320454,0,3,0
91526,2,1,320453,320454,320455,1,2,0
91527,5,2,320458,320458,320460,0,2,3
91528,6,2,320464,320464,320466,0,2,4
91529,6,1,320470,320470,320471,0,1,4
91530,1,2,320471,320471,320473,0,2,0
91531,5,1,320476,320476,320477,0,1,3
91532,4,1,320480,320480,320481,0,1,3
91533,3,2,320483,320483,320485,0,2,2
91534,4,1,320487,320487,320488,0,1,2
91535,2,2,320489,320489,320491,0,2,1
91536,3,3,320492,320492,320495,0,3,1
91537,1,2,320493,320495,320497,2,4,0
91538,2,3,320495,320497,320500,2,5,0
91539,3,3,320498,320500,320503,2,5,0
91540,2,1,320500,320503,320504,3,4,0
91541,6,3,320506,320506,320509,0,3,2
91542,5,1,320511,320511,320512,0,1,2
91543,2,3,320513,320513,320516,0,3,1
91544,3,2,320516,320516,320518,0,2,0
91545,1,3,320517,320518,320521,1,4,0
91546,6,2,320523,320523,320525,0,2,2
91547,3,1,320526,320526,320527,0,1,1
91548,3,2,320529,320529,320531,0,2,2
91549,2,2,320531,320531,320533,0,2,0
91550,3,3,320534,320534,320537,0,3,1
91551,1,2,320535,320537,320539,2,4,0
91552,4,2,320539,320539,320541,0,2,0
91553,2,1,320541,320541,320542,0,1,0
91554,6,2,320547,320547,320549,0,2,5
91555,2,2,320549,320549,320551,0,2,0
91556,6,2,320555,320555,320557,0,2,4
91557,2,1,320557,320557,320558,0,1,0
91558,6,1,320563,320563,320564,0,1,5
91559,4,2,320567,320567,320569,0,2,3
91560,3,2,320570,320570,320572,0,2,1
91561,1,2,320571,320572,320574,1,3,0
91562,5,1,320576,320576,320577,0,1,2
91563,1,3,320577,320577,320580,0,3,0
91564,6,1,320583,320583,320584,0,1,3
91565,6,2,320589,320589,320591,0,2,5
91566,3,2,320592,320592,320594,0,2,1
91567,1,1,320593,320594,320595,1,2,0
91568,6,3,320599,320599,320602,0,3,4
91569,2,2,320601,320602,320604,1,3,0
91570,2,3,320603,320604,320607,1,4,0
91571,1,1,320604,320607,320608,3,4,0
91572,6,3,320610,320610,320613,0,3,2
91573,1,2,320611,320613,320615,2,4,0
91574,2,3,320613,320615,320618,2,5,0
91575,3,3,320616,320618,320621,2,5,0
91576,2,3,320618,320621,320624,3,6,0
91577,5,1,320623,320624,320625,1,2,0
91578,1,3,320624,320625,320628,1,4,0
91579,1,1,320625,320628,320629,3,4,0
91580,6,1,320631,320631,320632,0,1,2
91581,2,2,320633,320633,320635,0,2,1
91582,4,3,320637,320637,320640,0,3,2
91583,5,3,320642,320642,320645,0,3,2
91584,5,3,320647,320647,320650,0,3,2
91585,5,2,320652,320652,320654,0,2,2
91586,1,2,320653,320654,320656,1,3,0
91587,4,1,320657,320657,320658,0,1,1
91588,5,2,320662,320662,320664,0,2,4
91589,6,3,320668,320668,320671,0,3,4
91590,1,3,320669,320671,320674,2,5,0
91591,4,1,320673,320674,320675,1,2,0
91592,1,2,320674,320675,320677,1,3,0
91593,1,1,320675,320677,320678,2,3,0
91594,5,3,320680,320680,320683,0,3,2
91595,5,3,320685,320685,320688,0,3,2
91596,1,3,320686,320688,320691,2,5,0
91597,1,3,320687,320691,320694,4,7,0
91598,5,1,320692,320694,320695,2,3,0
91599,1,1,320693,320695,320696,2,3,0
91600,5,2,320698,320698,320700,0,2,2
91601,2,2,320700,320700,320702,0,2,0
91602,6,2,320706,320706,320708,0,2,4
91603,6,3,320712,320712,320715,0,3,4
91604,3,2,320715,320715,320717,0,2,0
91605,5,3,320720,320720,320723,0,3,3
91606,6,3,320726,320726,320729,0,3,3
91607,6,3,320732,320732,320735,0,3,3
91608,4,3,320736,320736,320739,0,3,1
91609,5,2,320741,320741,320743,0,2,2
91610,5,1,320746,320746,320747,0,1,3
91611,5,3,320751,320751,320754,0,3,4
91612,2,2,320753,320754,320756,1,3,0
91613,5,3,320758,320758,320761,0,3,2
91614,6,3,320764,320764,320767,0,3,3
91615,1,2,320765,320767,320769,2,4,0
91616,2,2,320767,320769,320771,2,4,0
91617,2,1,320769,320771,320772,2,3,0
91618,2,1,320771,320772,320773,1,2,0
91619,1,1,320772,320773,320774,1,2,0
91620,3,1,320775,320775,320776,0,1,1
91621,5,3,320780,320780,320783,0,3,4
91622,1,2,320781,320783,320785,2,4,0
91623,6,1,320787,320787,320788,0,1,2
91624,4,3,320791,320791,320794,0,3,3
91625,5,3,320796,320796,320799,0,3,2
91626,3,3,320799,320799,320802,0,3,0
91627,2,2,320801,320802,320804,1,3,0
91628,6,2,320807,320807,320809,0,2,3
91629,1,1,320808,320809,320810,1,2,0
91630,6,2,320814,320814,320816,0,2,4
91631,6,2,320820,320820,320822,0,2,4
91632,4,1,320824,320824,320825,0,1,2
91633,6,2,320830,320830,320832,0,2,5
91634,6,1,320836,320836,320837,0,1,4
91635,4,1,320840,320840,320841,0,1,3
91636,4,2,320844,320844,320846,0,2,3
91637,3,2,320847,320847,320849,0,2,1
91638,5,2,320852,320852,320854,0,2,3
91639,3,1,320855,320855,320856,0,1,1
91640,6,2,320861,320861,320863,0,2,5
91641,4,2,320865,320865,320867,0,2,2
91642,1,1,320866,320867,320868,1,2,0
91643,4,3,320870,320870,320873,0,3,2
91644,5,2,320875,320875,320877,0,2,2
91645,6,3,320881,320881,320884,0,3,4
91646,2,2,320883,320884,320886,1,3,0
91647,6,3,320889,320889,320892,0,3,3
91648,6,1,320895,320895,320896,0,1,3
91649,4,2,320899,320899,320901,0,2,3
91650,1,1,320900,320901,320902,1,2,0
91651,4,3,320904,320904,320907,0,3,2
91652,3,2,320907,320907,320909,0,2,0
91653,6,3,320913,320913,320916,0,3,4
91654,2,1,320915,320916,320917,1,2,0
91655,5,1,320920,320920,320921,0,1,3
91656,1,3,320921,320921,320924,0,3,0
91657,4,2,320925,320925,320927,0,2,1
91658,6,2,320931,320931,320933,0,2,4
91659,1,3,320932,320933,320936,1,4,0
91660,2,2,320934,320936,320938,2,4,0
91661,2,3,320936,320938,320941,2,5,0
91662,6,1,320942,320942,320943,0,1,1
91663,5,3,320947,320947,320950,0,3,4
91664,5,3,320952,320952,320955,0,3,2
91665,5,2,320957,320957,320959,0,2,2
91666,4,2,320961,320961,320963,0,2,2
91667,2,3,320963,320963,320966,0,3,0
91668,3,3,320966,320966,320969,0,3,0
91669,4,1,320970,320970,320971,0,1,1
91670,2,2,320972,320972,320974,0,2,1
91671,6,2,320978,320978,320980,0,2,4
91672,4,1,320982,320982,320983,0,1,2
91673,4,2,320986,320986,320988,0,2,3
91674,3,1,320989,320989,320990,0,1,1
91675,6,1,320995,320995,320996,0,1,5
91676,5,3,321000,321000,321003,0,3,4
91677,6,3,321006,321006,321009,0,3,3
91678,6,2,321012,321012,321014,0,2,3
91679,3,2,321015,321015,321017,0,2,1
91680,4,1,321019,321019,321020,0,1,2
91681,1,1,321020,321020,321021,0,1,0
91682,5,3,321025,321025,321028,0,3,4
91683,5,2,321030,321030,321032,0,2,2
91684,6,2,321036,321036,321038,0,2,4
91685,4,1,321040,321040,321041,0,1,2
91686,5,1,321045,321045,321046,0,1,4
91687,5,1,321050,321050,321051,0,1,4
91688,5,1,321055,321055,321056,0,1,4
91689,5,2,321060,321060,321062,0,2,4
91690,1,1,321061,321062,321063,1,2,0
91691,6,3,321067,321067,321070,0,3,4
91692,2,2,321069,321070,321072,1,3,0
91693,3,2,321072,321072,321074,0,2,0
91694,1,3,321073,321074,321077,1,4,0
91695,1,2,321074,321077,321079,3,5,0
91696,1,2,321075,321079,321081,4,6,0
91697,2,3,321077,321081,321084,4,7,0
91698,5,1,321082,321084,321085,2,3,0
91699,3,1,321085,321085,321086,0,1,0
91700,2,1,321087,321087,321088,0,1,1
91701,6,1,321093,321093,321094,0,1,5
91702,1,1,321094,321094,321095,0,1,0
91703,3,2,321097,321097,321099,0,2,2
91704,4,1,321101,321101,321102,0,1,2
91705,6,3,321107,321107,321110,0,3,5
91706,1,2,321108,321110,321112,2,4,0
91707,6,3,321114,321114,321117,0,3,2
91708,5,1,321119,321119,321120,0,1,2
91709,2,1,321121,321121,321122,0,1,1
91710,3,2,321124,321124,321126,0,2,2
91711,6,3,321130,321130,321133,0,3,4
91712,6,1,321136,321136,321137,0,1,3
91713,1,1,321137,321137,321138,0,1,0
91714,1,1,321138,321138,321139,0,1,0
91715,3,2,321141,321141,321143,0,2,2
91716,5,1,321146,321146,321147,0,1,3
91717,2,1,321148,321148,321149,0,1,1
91718,6,1,321154,321154,321155,0,1,5
91719,2,2,321156,321156,321158,0,2,1
91720,1,3,321157,321158,321161,1,4,0
91721,1,2,321158,321161,321163,3,5,0
91722,1,2,321159,321163,321165,4,6,0
91723,5,3,321164,321165,321168,1,4,0
91724,1,1,321165,321168,321169,3,4,0
91725,1,3,321166,321169,321172,3,6,0
91726,6,1,321172,321172,321173,0,1,0
91727,5,2,321177,321177,321179,0,2,4
91728,3,2,321180,321180,321182,0,2,1
91729,2,3,321182,321182,321185,0,3,0
91730,6,1,321188,321188,321189,0,1,3
91731,5,1,321193,321193,321194,0,1,4
91732,2,2,321195,321195,321197,0,2,1
91733,3,3,321198,321198,321201,0,3,1
91734,4,1,321202,321202,321203,0,1,1
91735,1,2,321203,321203,321205,0,2,0
91736,3,1,321206,321206,321207,0,1,1
91737,5,3,321211,321211,321214,0,3,4
91738,2,1,321213,321214,321215,1,2,0
91739,2,1,321215,321215,321216,0,1,0
91740,3,3,321218,321218,321221,0,3,2
91741,3,3,321221,321221,321224,0,3,0
91742,5,1,321226,321226,321227,0,1,2
91743,3,3,321229,321229,321232,0,3,2
91744,4,3,321233,321233,321236,0,3,1
91745,2,1,321235,321236,321237,1,2,0
91746,1,2,321236,321237,321239,1,3,0
91747,3,3,321239,321239,321242,0,3,0
91748,6,1,321245,321245,321246,0,1,3
91749,5,1,321250,321250,321251,0,1,4
91750,1,1,321251,321251,321252,0,1,0
91751,2,3,321253,321253,321256,0,3,1
91752,6,2,321259,321259,321261,0,2,3
91753,6,1,321265,321265,321266,0,1,4
91754,2,1,321267,321267,321268,0,1,1
91755,1,1,321268,321268,321269,0,1,0
91756,2,3,321270,321270,321273,0,3,1
91757,2,1,321272,321273,321274,1,2,0
91758,2,3,321274,321274,321277,0,3,0
91759,1,2,321275,321277,321279,2,4,0
91760,1,3,321276,321279,321282,3,6,0
91761,2,1,321278,321282,321283,4,5,0
91762,4,3,321282,321283,321286,1,4,0
91763,3,3,321285,321286,321289,1,4,0
91764,5,3,321290,321290,321293,0,3,1
91765,2,1,321292,321293,321294,1,2,0
91766,3,2,321295,321295,321297,0,2,1
91767,3,2,321298,321298,321300,0,2,1
91768,2,2,321300,321300,321302,0,2,0
91769,4,3,321304,321304,321307,0,3,2
91770,3,2,321307,321307,321309,0,2,0
91771,2,1,321309,321309,321310,0,1,0
91772,2,1,321311,321311,321312,0,1,1
91773,2,1,321313,321313,321314,0,1,1
91774,1,2,321314,321314,321316,0,2,0
91775,5,2,321319,321319,321321,0,2,3
91776,5,2,321324,321324,321326,0,2,3
91777,5,2,321329,321329,321331,0,2,3
91778,5,2,321334,321334,321336,0,2,3
91779,3,2,321337,321337,321339,0,2,1
91780,6,3,321343,321343,321346,0,3,4
91781,2,1,321345,321346,321347,1,2,0
91782,6,3,321351,321351,321354,0,3,4
91783,1,3,321352,321354,321357,2,5,0
91784,3,2,321355,321357,321359,2,4,0
91785,6,1,321361,321361,321362,0,1,2
91786,3,2,321364,321364,321366,0,2,2
91787,3,2,321367,321367,321369,0,2,1
91788,1,2,321368,321369,321371,1,3,0
91789,6,3,321374,321374,321377,0,3,3
91790,5,3,321379,321379,321382,0,3,2
91791,4,3,321383,321383,321386,0,3,1
91792,2,2,321385,321386,321388,1,3,0
91793,2,3,321387,321388,321391,1,4,0
91794,1,2,321388,321391,321393,3,5,0
91795,2,1,321390,321393,321394,3,4,0
91796,6,3,321396,321396,321399,0,3,2
91797,2,1,321398,321399,321400,1,2,0
91798,5,3,321403,321403,321406,0,3,3
91799,2,1,321405,321406,321407,1,2,0
91800,4,3,321409,321409,321412,0,3,2
91801,1,2,321410,321412,321414,2,4,0
91802,6,3,321416,321416,321419,0,3,2
91803,5,1,321421,321421,321422,0,1,2
91804,4,1,321425,321425,321426,0,1,3
91805,1,1,321426,321426,321427,0,1,0
91806,2,1,321428,321428,321429,0,1,1
91807,5,1,321433,321433,321434,0,1,4
91808,5,3,321438,321438,321441,0,3,4
91809,5,1,321443,321443,321444,0,1,2
91810,6,1,321449,321449,321450,0,1,5
91811,1,3,321450,321450,321453,0,3,0
91812,1,2,321451,321453,321455,2,4,0
91813,1,3,321452,321455,321458,3,6,0
91814,3,2,321455,321458,321460,3,5,0
91815,1,3,321456,321460,321463,4,7,0
91816,3,1,321459,321463,321464,4,5,0
91817,4,3,321463,321464,321467,1,4,0
91818,4,1,321467,321467,321468,0,1,0
91819,5,1,321472,321472,321473,0,1,4
91820,2,2,321474,321474,321476,0,2,1
91821,4,1,321478,321478,321479,0,1,2
91822,6,3,321484,321484,321487,0,3,5
91823,2,2,321486,321487,321489,1,3,0
91824,6,3,321492,321492,321495,0,3,3
91825,1,1,321493,321495,321496,2,3,0
91826,3,1,321496,321496,321497,0,1,0
91827,3,2,321499,321499,321501,0,2,2
91828,1,3,321500,321501,321504,1,4,0
91829,6,2,321506,321506,321508,0,2,2
91830,4,2,321510,321510,321512,0,2,2
91831,3,1,321513,321513,321514,0,1,1
91832,2,2,321515,321515,321517,0,2,1
91833,4,3,321519,321519,321522,0,3,2
91834,2,3,321521,321522,321525,1,4,0
91835,5,1,321526,321526,321527,0,1,1
91836,5,2,321531,321531,321533,0,2,4
91837,5,1,321536,321536,321537,0,1,3
91838,6,3,321542,321542,321545,0,3,5
91839,6,1,321548,321548,321549,0,1,3
91840,5,3,321553,321553,321556,0,3,4
91841,2,2,321555,321556,321558,1,3,0
91842,5,1,321560,321560,321561,0,1,2
91843,6,2,321566,321566,321568,0,2,5
91844,3,1,321569,321569,321570,0,1,1
91845,3,1,321572,321572,321573,0,1,2
91846,4,1,321576,321576,321577,0,1,3
91847,5,1,321581,321581,321582,0,1,4
91848,1,2,321582,321582,321584,0,2,0
91849,2,2,321584,321584,321586,0,2,0
91850,2,2,321586,321586,321588,0,2,0
91851,3,3,321589,321589,321592,0,3,1
91852,3,1,321592,321592,321593,0,1,0
91853,3,2,321595,321595,321597,0,2,2
91854,5,3,321600,321600,321603,0,3,3
91855,5,1,321605,321605,321606,0,1,2
91856,3,1,321608,321608,321609,0,1,2
91857,4,3,321612,321612,321615,0,3,3
91858,3,2,321615,321615,321617,0,2,0
91859,1,2,321616,321617,321619,1,3,0
91860,4,2,321620,321620,321622,0,2,1
91861,1,1,321621,321622,321623,1,2,0
91862,6,2,321627,321627,321629,0,2,4
91863,3,2,321630,321630,321632,0,2,1
91864,1,1,321631,321632,321633,1,2,0
91865,4,3,321635,321635,321638,0,3,2
91866,6,3,321641,321641,321644,0,3,3
91867,6,1,321647,321647,321648,0,1,3
91868,5,1,321652,321652,321653,0,1,4
91869,4,3,321656,321656,321659,0,3,3
91870,6,2,321662,321662,321664,0,2,3
91871,5,2,321667,321667,321669,0,2,3
91872,4,2,321671,321671,321673,0,2,2
91873,5,2,321676,321676,321678,0,2,3
91874,4,1,321680,321680,321681,0,1,2
91875,3,2,321683,321683,321685,0,2,2
91876,5,2,321688,321688,321690,0,2,3
91877,1,1,321689,321690,321691,1,2,0
91878,4,1,321693,321693,321694,0,1,2
91879,2,1,321695,321695,321696,0,1,1
91880,6,2,321701,321701,321703,0,2,5
91881,1,3,321702,321703,321706,1,4,0
91882,5,2,321707,321707,321709,0,2,1
91883,3,2,321710,321710,321712,0,2,1
91884,1,2,321711,321712,321714,1,3,0
91885,4,1,321715,321715,321716,0,1,1
91886,4,1,321719,321719,321720,0,1,3
91887,1,3,321720,321720,321723,0,3,0
91888,6,2,321726,321726,321728,0,2,3
91889,2,1,321728,321728,321729,0,1,0
91890,5,1,321733,321733,321734,0,1,4
91891,3,3,321736,321736,321739,0,3,2
91892,3,2,321739,321739,321741,0,2,0
91893,3,3,321742,321742,321745,0,3,1
91894,1,2,321743,321745,321747,2,4,0
91895,5,1,321748,321748,321749,0,1,1
91896,1,3,321749,321749,321752,0,3,0
91897,6,1,321755,321755,321756,0,1,3
91898,6,3,321761,321761,321764,0,3,5
91899,5,3,321766,321766,321769,0,3,2
91900,4,3,321770,321770,321773,0,3,1
91901,1,3,321771,321773,321776,2,5,0
91902,6,2,321777,321777,321779,0,2,1
91903,4,1,321781,321781,321782,0,1,2
91904,5,1,321786,321786,321787,0,1,4
91905,3,1,321789,321789,321790,0,1,2
91906,1,1,321790,321790,321791,0,1,0
91907,1,2,321791,321791,321793,0,2,0
91908,1,3,321792,321793,321796,1,4,0
91909,6,3,321798,321798,321801,0,3,2
91910,5,2,321803,321803,321805,0,2,2
91911,2,3,321805,321805,321808,0,3,0
91912,1,3,321806,321808,321811,2,5,0
91913,6,1,321812,321812,321813,0,1,1
91914,1,1,321813,321813,321814,0,1,0
91915,4,2,321817,321817,321819,0,2,3
91916,3,2,321820,321820,321822,0,2,1
91917,5,1,321825,321825,321826,0,1,3
91918,6,1,321831,321831,321832,0,1,5
91919,6,1,321837,321837,321838,0,1,5
91920,3,2,321840,321840,321842,0,2,2
91921,3,3,321843,321843,321846,0,3,1
91922,5,1,321848,321848,321849,0,1,2
91923,1,1,321849,321849,321850,0,1,0
91924,3,3,321852,321852,321855,0,3,2
91925,6,1,321858,321858,321859,0,1,3
91926,6,2,321864,321864,321866,0,2,5
91927,4,1,321868,321868,321869,0,1,2
91928,3,3,321871,321871,321874,0,3,2
91929,5,2,321876,321876,321878,0,2,2
91930,1,2,321877,321878,321880,1,3,0
91931,6,3,321883,321883,321886,0,3,3
91932,4,2,321887,321887,321889,0,2,1
91933,2,1,321889,321889,321890,0,1,0
91934,6,1,321895,321895,321896,0,1,5
91935,3,3,321898,321898,321901,0,3,2
91936,3,2,321901,321901,321903,0,2,0
91937,5,2,321906,321906,321908,0,2,3
91938,3,3,321909,321909,321912,0,3,1
91939,1,2,321910,321912,321914,2,4,0
91940,4,3,321914,321914,321917,0,3,0
91941,1,3,321915,321917,321920,2,5,0
91942,1,3,321916,321920,321923,4,7,0
91943,2,3,321918,321923,321926,5,8,0
91944,1,1,321919,321926,321927,7,8,0
91945,4,3,321923,321927,321930,4,7,0
91946,6,1,321929,321930,321931,1,2,0
91947,2,2,321931,321931,321933,0,2,0
91948,3,3,321934,321934,321937,0,3,1
91949,5,3,321939,321939,321942,0,3,2
91950,5,1,321944,321944,321945,0,1,2
91951,6,2,321950,321950,321952,0,2,5
91952,5,3,321955,321955,321958,0,3,3
91953,4,3,321959,321959,321962,0,3,1
91954,4,2,321963,321963,321965,0,2,1
91955,5,2,321968,321968,321970,0,2,3
91956,6,3,321974,321974,321977,0,3,4
91957,5,2,321979,321979,321981,0,2,2
91958,3,2,321982,321982,321984,0,2,1
91959,2,1,321984,321984,321985,0,1,0
91960,6,2,321990,321990,321992,0,2,5
91961,6,2,321996,321996,321998,0,2,4
91962,5,1,322001,322001,322002,0,1,3
91963,2,3,322003,322003,322006,0,3,1
91964,6,2,322009,322009,322011,0,2,3
91965,2,3,322011,322011,322014,0,3,0
91966,2,2,322013,322014,322016,1,3,0
91967,3,2,322016,322016,322018,0,2,0
91968,2,3,322018,322018,322021,0,3,0
91969,4,3,322022,322022,322025,0,3,1
91970,5,3,322027,322027,322030,0,3,2
91971,5,2,322032,322032,322034,0,2,2
91972,4,1,322036,322036,322037,0,1,2
91973,1,1,322037,322037,322038,0,1,0
91974,4,2,322041,322041,322043,0,2,3
91975,2,2,322043,322043,322045,0,2,0
91976,5,2,322048,322048,322050,0,2,3
91977,5,1,322053,322053,322054,0,1,3
91978,3,2,322056,322056,322058,0,2,2
91979,1,3,322057,322058,322061,1,4,0
91980,5,1,322062,322062,322063,0,1,1
91981,2,1,322064,322064,322065,0,1,1
91982,1,1,322065,322065,322066,0,1,0
91983,4,1,322069,322069,322070,0,1,3
91984,1,3,322070,322070,322073,0,3,0
91985,2,2,322072,322073,322075,1,3,0
91986,6,3,322078,322078,322081,0,3,3
91987,2,1,322080,322081,322082,1,2,0
91988,3,1,322083,322083,322084,0,1,1
91989,2,1,322085,322085,322086,0,1,1
91990,5,3,322090,322090,322093,0,3,4
91991,5,3,322095,322095,322098,0,3,2
91992,5,3,322100,322100,322103,0,3,2
91993,3,3,322103,322103,322106,0,3,0
91994,4,3,322107,322107,322110,0,3,1
91995,6,1,322113,322113,322114,0,1,3
91996,6,1,322119,322119,322120,0,1,5
91997,3,3,322122,322122,322125,0,3,2
91998,6,2,322128,322128,322130,0,2,3
91999,6,3,322134,322134,322137,0,3,4
92000,4,1,322138,322138,322139,0,1,1
92001,3,2,322141,322141,322143,0,2,2
92002,6,2,322147,322147,322149,0,2,4
92003,5,2,322152,322152,322154,0,2,3
92004,4,3,322156,322156,322159,0,3,2
92005,6,3,322162,322162,322165,0,3,3
92006,6,2,322168,322168,322170,0,2,3
92007,1,3,322169,322170,322173,1,4,0
92008,2,2,322171,322173,322175,2,4,0
92009,2,3,322173,322175,322178,2,5,0
92010,5,3,322178,322178,322181,0,3,0
92011,6,3,322184,322184,322187,0,3,3
92012,1,1,322185,322187,322188,2,3,0
92013,2,2,322187,322188,322190,1,3,0
92014,1,2,322188,322190,322192,2,4,0
92015,2,1,322190,322192,322193,2,3,0
92016,3,2,322193,322193,322195,0,2,0
92017,6,3,322199,322199,322202,0,3,4
92018,3,3,322202,322202,322205,0,3,0
92019,2,2,322204,322205,322207,1,3,0
92020,3,3,322207,322207,322210,0,3,0
92021,6,3,322213,322213,322216,0,3,3
92022,6,2,322219,322219,322221,0,2,3
92023,4,2,322223,322223,322225,0,2,2
92024,1,3,322224,322225,322228,1,4,0
92025,2,1,322226,322228,322229,2,3,0
92026,5,3,322231,322231,322234,0,3,2
92027,5,3,322236,322236,322239,0,3,2
92028,1,3,322237,322239,322242,2,5,0
92029,5,2,322242,322242,322244,0,2,0
92030,5,1,322247,322247,322248,0,1,3
92031,3,3,322250,322250,322253,0,3,2
92032,2,2,322252,322253,322255,1,3,0
92033,3,1,322255,322255,322256,0,1,0
92034,2,2,322257,322257,322259,0,2,1
92035,4,2,322261,322261,322263,0,2,2
92036,4,1,322265,322265,322266,0,1,2
92037,1,1,322266,322266,322267,0,1,0
92038,4,2,322270,322270,322272,0,2,3
92039,2,3,322272,322272,322275,0,3,0
92040,4,1,322276,322276,322277,0,1,1
92041,4,1,322280,322280,322281,0,1,3
92042,5,3,322285,322285,322288,0,3,4
92043,4,1,322289,322289,322290,0,1,1
92044,2,3,322291,322291,322294,0,3,1
92045,4,3,322295,322295,322298,0,3,1
92046,2,3,322297,322298,322301,1,4,0
92047,2,1,322299,322301,322302,2,3,0
92048,2,2,322301,322302,322304,1,3,0
92049,6,2,322307,322307,322309,0,2,3
92050,2,3,322309,322309,322312,0,3,0
92051,5,3,322314,322314,322317,0,3,2
92052,4,1,322318,322318,322319,0,1,1
92053,1,1,322319,322319,322320,0,1,0
92054,6,1,322325,322325,322326,0,1,5
92055,2,2,322327,322327,322329,0,2,1
92056,5,2,322332,322332,322334,0,2,3
92057,1,2,322333,322334,322336,1,3,0
92058,3,2,322336,322336,322338,0,2,0
92059,1,2,322337,322338,322340,1,3,0
92060,4,3,322341,322341,322344,0,3,1
92061,4,3,322345,322345,322348,0,3,1
92062,3,2,322348,322348,322350,0,2,0
92063,2,3,322350,322350,322353,0,3,0
92064,1,3,322351,322353,322356,2,5,0
92065,2,3,322353,322356,322359,3,6,0
92066,4,3,322357,322359,322362,2,5,0
92067,2,3,322359,322362,322365,3,6,0
92068,4,3,322363,322365,322368,2,5,0
92069,3,3,322366,322368,322371,2,5,0
92070,6,3,322372,322372,322375,0,3,1
92071,4,3,322376,322376,322379,0,3,1
92072,1,3,322377,322379,322382,2,5,0
92073,2,3,322379,322382,322385,3,6,0
92074,1,2,322380,322385,322387,5,7,0
92075,3,1,322383,322387,322388,4,5,0
92076,4,2,322387,322388,322390,1,3,0
92077,3,3,322390,322390,322393,0,3,0
92078,6,3,322396,322396,322399,0,3,3
92079,1,3,322397,322399,322402,2,5,0
92080,6,3,322403,322403,322406,0,3,1
92081,4,3,322407,322407,322410,0,3,1
92082,1,1,322408,322410,322411,2,3,0
92083,3,2,322411,322411,322413,0,2,0
92084,5,3,322416,322416,322419,0,3,3
92085,1,3,322417,322419,322422,2,5,0
92086,2,2,322419,322422,322424,3,5,0
92087,2,3,322421,322424,322427,3,6,0
92088,1,1,322422,322427,322428,5,6,0
92089,5,2,322427,322428,322430,1,3,0
92090,4,3,322431,322431,322434,0,3,1
92091,6,1,322437,322437,322438,0,1,3
92092,1,1,322438,322438,322439,0,1,0
92093,1,2,322439,322439,322441,0,2,0
92094,2,2,322441,322441,322443,0,2,0
92095,4,1,322445,322445,322446,0,1,2
92096,1,2,322446,322446,322448,0,2,0
92097,3,3,322449,322449,322452,0,3,1
92098,3,1,322452,322452,322453,0,1,0
92099,2,3,322454,322454,322457,0,3,1
92100,3,1,322457,322457,322458,0,1,0
92101,1,2,322458,322458,322460,0,2,0
92102,6,3,322464,322464,322467,0,3,4
92103,2,1,322466,322467,322468,1,2,0
92104,4,2,322470,322470,322472,0,2,2
92105,5,1,322475,322475,322476,0,1,3
92106,1,1,322476,322476,322477,0,1,0
92107,6,3,322482,322482,322485,0,3,5
92108,3,3,322485,322485,322488,0,3,0
92109,5,2,322490,322490,322492,0,2,2
92110,4,2,322494,322494,322496,0,2,2
92111,3,2,322497,322497,322499,0,2,1
92112,4,3,322501,322501,322504,0,3,2
92113,2,2,322503,322504,322506,1,3,0
92114,5,3,322508,322508,322511,0,3,2
92115,5,2,322513,322513,322515,0,2,2
92116,5,2,322518,322518,322520,0,2,3
92117,2,2,322520,322520,322522,0,2,0
92118,3,1,322523,322523,322524,0,1,1
92119,6,2,322529,322529,322531,0,2,5
92120,3,1,322532,322532,322533,0,1,1
92121,4,1,322536,322536,322537,0,1,3
92122,3,2,322539,322539,322541,0,2,2
92123,5,1,322544,322544,322545,0,1,3
92124,2,3,322546,322546,322549,0,3,1
92125,2,1,322548,322549,322550,1,2,0
92126,2,1,322550,322550,322551,0,1,0
92127,1,3,322551,322551,322554,0,3,0
92128,5,3,322556,322556,322559,0,3,2
92129,4,1,322560,322560,322561,0,1,1
92130,5,1,322565,322565,322566,0,1,4
92131,3,1,322568,322568,322569,0,1,2
92132,4,2,322572,322572,322574,0,2,3
92133,1,1,322573,322574,322575,1,2,0
92134,1,1,322574,322575,322576,1,2,0
92135,2,1,322576,322576,322577,0,1,0
92136,4,2,322580,322580,322582,0,2,3
92137,4,3,322584,322584,322587,0,3,2
92138,3,3,322587,322587,322590,0,3,0
92139,3,3,322590,322590,322593,0,3,0
92140,6,1,322596,322596,322597,0,1,3
92141,5,1,322601,322601,322602,0,1,4
92142,6,2,322607,322607,322609,0,2,5
92143,2,1,322609,322609,322610,0,1,0
92144,4,2,322613,322613,322615,0,2,3
92145,3,2,322616,322616,322618,0,2,1
92146,4,2,322620,322620,322622,0,2,2
92147,3,1,322623,322623,322624,0,1,1
92148,6,2,322629,322629,322631,0,2,5
92149,3,3,322632,322632,322635,0,3,1
92150,2,1,322634,322635,322636,1,2,0
92151,2,1,322636,322636,322637,0,1,0
92152,1,2,322637,322637,322639,0,2,0
92153,2,3,322639,322639,322642,0,3,0
92154,4,2,322643,322643,322645,0,2,1
92155,3,2,322646,322646,322648,0,2,1
92156,3,1,322649,322649,322650,0,1,1
92157,2,3,322651,322651,322654,0,3,1
92158,2,1,322653,322654,322655,1,2,0
92159,2,1,322655,322655,322656,0,1,0
92160,6,1,322661,322661,322662,0,1,5
92161,5,1,322666,322666,322667,0,1,4
92162,5,2,322671,322671,322673,0,2,4
92163,2,3,322673,322673,322676,0,3,0
92164,3,1,322676,322676,322677,0,1,0
92165,2,2,322678,322678,322680,0,2,1
92166,4,3,322682,322682,322685,0,3,2
92167,2,3,322684,322685,322688,1,4,0
92168,6,1,322690,322690,322691,0,1,2
92169,2,1,322692,322692,322693,0,1,1
92170,3,3,322695,322695,322698,0,3,2
92171,4,1,322699,322699,322700,0,1,1
92172,2,1,322701,322701,322702,0,1,1
92173,4,1,322705,322705,322706,0,1,3
92174,4,1,322709,322709,322710,0,1,3
92175,3,1,322712,322712,322713,0,1,2
92176,5,1,322717,322717,322718,0,1,4
92177,5,2,322722,322722,322724,0,2,4
92178,4,2,322726,322726,322728,0,2,2
92179,2,3,322728,322728,322731,0,3,0
92180,2,3,322730,322731,322734,1,4,0
92181,5,2,322735,322735,322737,0,2,1
92182,1,3,322736,322737,322740,1,4,0
92183,6,3,322742,322742,322745,0,3,2
92184,2,3,322744,322745,322748,1,4,0
92185,3,3,322747,322748,322751,1,4,0
92186,6,3,322753,322753,322756,0,3,2
92187,3,3,322756,322756,322759,0,3,0
92188,4,3,322760,322760,322763,0,3,1
92189,3,3,322763,322763,322766,0,3,0
92190,6,1,322769,322769,322770,0,1,3
92191,1,2,322770,322770,322772,0,2,0
92192,6,2,322776,322776,322778,0,2,4
92193,4,1,322780,322780,322781,0,1,2
92194,3,2,322783,322783,322785,0,2,2
92195,4,3,322787,322787,322790,0,3,2
92196,1,2,322788,322790,322792,2,4,0
92197,5,2,322793,322793,322795,0,2,1
92198,4,1,322797,322797,322798,0,1,2
92199,1,3,322798,322798,322801,0,3,0
92200,1,2,322799,322801,322803,2,4,0
92201,2,3,322801,322803,322806,2,5,0
92202,5,2,322806,322806,322808,0,2,0
92203,4,2,322810,322810,322812,0,2,2
92204,6,3,322816,322816,322819,0,3,4
92205,6,1,322822,322822,322823,0,1,3
92206,5,2,322827,322827,322829,0,2,4
92207,6,1,322833,322833,322834,0,1,4
92208,2,2,322835,322835,322837,0,2,1
92209,1,3,322836,322837,322840,1,4,0
92210,4,3,322840,322840,322843,0,3,0
92211,2,3,322842,322843,322846,1,4,0
92212,5,3,322847,322847,322850,0,3,1
92213,2,3,322849,322850,322853,1,4,0
92214,1,3,322850,322853,322856,3,6,0
92215,2,2,322852,322856,322858,4,6,0
92216,6,1,322858,322858,322859,0,1,0
92217,6,2,322864,322864,322866,0,2,5
92218,4,2,322868,322868,322870,0,2,2
92219,3,2,322871,322871,322873,0,2,1
92220,2,1,322873,322873,322874,0,1,0
92221,2,3,322875,322875,322878,0,3,1
92222,5,2,322880,322880,322882,0,2,2
92223,4,3,322884,322884,322887,0,3,2
92224,4,3,322888,322888,322891,0,3,1
92225,3,3,322891,322891,322894,0,3,0
92226,3,2,322894,322894,322896,0,2,0
92227,2,1,322896,322896,322897,0,1,0
92228,3,1,322899,322899,322900,0,1,2
92229,3,2,322902,322902,322904,0,2,2
92230,2,3,322904,322904,322907,0,3,0
92231,5,2,322909,322909,322911,0,2,2
92232,6,1,322915,322915,322916,0,1,4
92233,6,2,322921,322921,322923,0,2,5
92234,3,1,322924,322924,322925,0,1,1
92235,4,1,322928,322928,322929,0,1,3
92236,6,2,322934,322934,322936,0,2,5
92237,3,3,322937,322937,322940,0,3,1
92238,2,1,322939,322940,322941,1,2,0
92239,5,3,322944,322944,322947,0,3,3
92240,6,3,322950,322950,322953,0,3,3
92241,5,3,322955,322955,322958,0,3,2
92242,4,1,322959,322959,322960,0,1,1
92243,5,3,322964,322964,322967,0,3,4
92244,4,3,322968,322968,322971,0,3,1
92245,6,1,322974,322974,322975,0,1,3
92246,1,2,322975,322975,322977,0,2,0
92247,5,2,322980,322980,322982,0,2,3
92248,5,2,322985,322985,322987,0,2,3
92249,6,3,322991,322991,322994,0,3,4
92250,2,2,322993,322994,322996,1,3,0
92251,2,3,322995,322996,322999,1,4,0
92252,1,3,322996,322999,323002,3,6,0
92253,3,2,322999,323002,323004,3,5,0
92254,5,2,323004,323004,323006,0,2,0
92255,6,1,323010,323010,323011,0,1,4
92256,2,3,323012,323012,323015,0,3,1
92257,1,2,323013,323015,323017,2,4,0
92258,1,3,323014,323017,323020,3,6,0
92259,6,2,323020,323020,323022,0,2,0
92260,2,2,323022,323022,323024,0,2,0
92261,3,2,323025,323025,323027,0,2,1
92262,6,2,323031,323031,323033,0,2,4
92263,4,2,323035,323035,323037,0,2,2
92264,2,3,323037,323037,323040,0,3,0
92265,1,1,323038,323040,323041,2,3,0
92266,2,3,323040,323041,323044,1,4,0
92267,5,3,323045,323045,323048,0,3,1
92268,5,3,323050,323050,323053,0,3,2
92269,5,3,323055,323055,323058,0,3,2
92270,5,2,323060,323060,323062,0,2,2
92271,2,1,323062,323062,323063,0,1,0
92272,2,2,323064,323064,323066,0,2,1
92273,1,2,323065,323066,323068,1,3,0
92274,4,3,323069,323069,323072,0,3,1
92275,3,3,323072,323072,323075,0,3,0
92276,2,1,323074,323075,323076,1,2,0
92277,1,1,323075,323076,323077,1,2,0
92278,5,3,323080,323080,323083,0,3,3
92279,1,3,323081,323083,323086,2,5,0
92280,6,2,323087,323087,323089,0,2,1
92281,3,3,323090,323090,323093,0,3,1
92282,1,2,323091,323093,323095,2,4,0
92283,5,2,323096,323096,323098,0,2,1
92284,3,3,323099,323099,323102,0,3,1
92285,4,2,323103,323103,323105,0,2,1
92286,2,3,323105,323105,323108,0,3,0
92287,3,2,323108,323108,323110,0,2,0
92288,5,2,323113,323113,323115,0,2,3
92289,2,3,323115,323115,323118,0,3,0
92290,4,2,323119,323119,323121,0,2,1
92291,4,3,323123,323123,323126,0,3,2
92292,2,2,323125,323126,323128,1,3,0
92293,2,2,323127,323128,323130,1,3,0
92294,2,3,323129,323130,323133,1,4,0
92295,6,1,323135,323135,323136,0,1,2
92296,1,1,323136,323136,323137,0,1,0
92297,4,3,323140,323140,323143,0,3,3
92298,5,3,323145,323145,323148,0,3,2
92299,2,1,323147,323148,323149,1,2,0
92300,2,1,323149,323149,323150,0,1,0
92301,3,2,323152,323152,323154,0,2,2
92302,2,1,323154,323154,323155,0,1,0
92303,3,3,323157,323157,323160,0,3,2
92304,4,2,323161,323161,323163,0,2,1
92305,5,1,323166,323166,323167,0,1,3
92306,4,2,323170,323170,323172,0,2,3
92307,6,2,323176,323176,323178,0,2,4
92308,3,2,323179,323179,323181,0,2,1
92309,5,2,323184,323184,323186,0,2,3
92310,6,3,323190,323190,323193,0,3,4
92311,5,2,323195,323195,323197,0,2,2
92312,6,3,323201,323201,323204,0,3,4
92313,4,1,323205,323205,323206,0,1,1
92314,2,3,323207,323207,323210,0,3,1
92315,2,1,323209,323210,323211,1,2,0
92316,3,1,323212,323212,323213,0,1,1
92317,4,3,323216,323216,323219,0,3,3
92318,2,3,323218,323219,323222,1,4,0
92319,2,2,323220,323222,323224,2,4,0
92320,3,3,323223,323224,323227,1,4,0
92321,4,2,323227,323227,323229,0,2,0
92322,1,3,323228,323229,323232,1,4,0
92323,4,2,323232,323232,323234,0,2,0
92324,6,3,323238,323238,323241,0,3,4
92325,5,1,323243,323243,323244,0,1,2
92326,3,2,323246,323246,323248,0,2,2
92327,4,1,323250,323250,323251,0,1,2
92328,6,2,323256,323256,323258,0,2,5
92329,1,2,323257,323258,323260,1,3,0
92330,6,1,323263,323263,323264,0,1,3
92331,5,3,323268,323268,323271,0,3,4
92332,2,2,323270,323271,323273,1,3,0
92333,3,1,323273,323273,323274,0,1,0
92334,4,1,323277,323277,323278,0,1,3
92335,2,1,323279,323279,323280,0,1,1
92336,3,1,323282,323282,323283,0,1,2
92337,6,2,323288,323288,323290,0,2,5
92338,1,2,323289,323290,323292,1,3,0
92339,6,1,323295,323295,323296,0,1,3
92340,5,1,323300,323300,323301,0,1,4
92341,6,1,323306,323306,323307,0,1,5
92342,4,2,323310,323310,323312,0,2,3
92343,1,3,323311,323312,323315,1,4,0
92344,2,1,323313,323315,323316,2,3,0
92345,3,2,323316,323316,323318,0,2,0
92346,1,2,323317,323318,323320,1,3,0
92347,3,1,323320,323320,323321,0,1,0
92348,4,2,323324,323324,323326,0,2,3
92349,5,1,323329,323329,323330,0,1,3
92350,5,1,323334,323334,323335,0,1,4
92351,6,2,323340,323340,323342,0,2,5
92352,5,2,323345,323345,323347,0,2,3
92353,3,1,323348,323348,323349,0,1,1
92354,3,2,323351,323351,323353,0,2,2
92355,1,1,323352,323353,323354,1,2,0
92356,6,3,323358,323358,323361,0,3,4
92357,2,2,323360,323361,323363,1,3,0
92358,6,3,323366,323366,323369,0,3,3
92359,3,3,323369,323369,323372,0,3,0
92360,3,3,323372,323372,323375,0,3,0
92361,3,1,323375,323375,323376,0,1,0
92362,3,3,323378,323378,323381,0,3,2
92363,2,3,323380,323381,323384,1,4,0
92364,2,1,323382,323384,323385,2,3,0
92365,2,2,323384,323385,323387,1,3,0
92366,4,2,323388,323388,323390,0,2,1
92367,4,2,323392,323392,323394,0,2,2
92368,3,3,323395,323395,323398,0,3,1
92369,5,1,323400,323400,323401,0,1,2
92370,6,2,323406,323406,323408,0,2,5
92371,2,2,323408,323408,323410,0,2,0
92372,6,3,323414,323414,323417,0,3,4
92373,4,1,323418,323418,323419,0,1,1
92374,3,1,323421,323421,323422,0,1,2
92375,2,1,323423,323423,323424,0,1,1
92376,2,2,323425,323425,323427,0,2,1
92377,3,2,323428,323428,323430,0,2,1
92378,6,3,323434,323434,323437,0,3,4
92379,2,2,323436,323437,323439,1,3,0
92380,4,3,323440,323440,323443,0,3,1
92381,3,3,323443,323443,323446,0,3,0
92382,5,1,323448,323448,323449,0,1,2
92383,5,3,323453,323453,323456,0,3,4
92384,3,3,323456,323456,323459,0,3,0
92385,4,3,323460,323460,323463,0,3,1
92386,2,2,323462,323463,323465,1,3,0
92387,6,1,323468,323468,323469,0,1,3
92388,6,2,323474,323474,323476,0,2,5
92389,4,2,323478,323478,323480,0,2,2
92390,6,2,323484,323484,323486,0,2,4
92391,2,2,323486,323486,323488,0,2,0
92392,6,1,323492,323492,323493,0,1,4
92393,4,1,323496,323496,323497,0,1,3
92394,6,1,323502,323502,323503,0,1,5
92395,1,2,323503,323503,323505,0,2,0
92396,2,3,323505,323505,323508,0,3,0
92397,2,2,323507,323508,323510,1,3,0
92398,6,2,323513,323513,323515,0,2,3
92399,4,3,323517,323517,323520,0,3,2
92400,5,1,323522,323522,323523,0,1,2
92401,5,2,323527,323527,323529,0,2,4
92402,1,2,323528,323529,323531,1,3,0
92403,5,2,323533,323533,323535,0,2,2
92404,4,3,323537,323537,323540,0,3,2
92405,4,1,323541,323541,323542,0,1,1
92406,6,3,323547,323547,323550,0,3,5
92407,2,2,323549,323550,323552,1,3,0
92408,1,2,323550,323552,323554,2,4,0
92409,5,1,323555,323555,323556,0,1,1
92410,6,1,323561,323561,323562,0,1,5
92411,3,2,323564,323564,323566,0,2,2
92412,3,1,323567,323567,323568,0,1,1
92413,1,2,323568,323568,323570,0,2,0
92414,1,3,323569,323570,323573,1,4,0
92415,2,2,323571,323573,323575,2,4,0
92416,4,2,323575,323575,323577,0,2,0
92417,2,2,323577,323577,323579,0,2,0
92418,2,3,323579,323579,323582,0,3,0
92419,6,2,323585,323585,323587,0,2,3
92420,6,3,323591,323591,323594,0,3,4
92421,6,2,323597,323597,323599,0,2,3
92422,6,3,323603,323603,323606,0,3,4
92423,1,2,323604,323606,323608,2,4,0
92424,5,1,323609,323609,323610,0,1,1
92425,3,3,323612,323612,323615,0,3,2
92426,2,1,323614,323615,323616,1,2,0
92427,4,3,323618,323618,323621,0,3,2
92428,3,1,323621,323621,323622,0,1,0
92429,5,1,323626,323626,323627,0,1,4
92430,4,2,323630,323630,323632,0,2,3
92431,5,3,323635,323635,323638,0,3,3
92432,1,3,323636,323638,323641,2,5,0
92433,6,1,323642,323642,323643,0,1,1
92434,3,2,323645,323645,323647,0,2,2
92435,6,3,323651,323651,323654,0,3,4
92436,6,2,323657,323657,323659,0,2,3
92437,1,2,323658,323659,323661,1,3,0
92438,1,1,323659,323661,323662,2,3,0
92439,6,2,323665,323665,323667,0,2,3
92440,5,3,323670,323670,323673,0,3,3
92441,6,2,323676,323676,323678,0,2,3
92442,5,3,323681,323681,323684,0,3,3
92443,4,3,323685,323685,323688,0,3,1
92444,6,1,323691,323691,323692,0,1,3
92445,5,2,323696,323696,323698,0,2,4
92446,1,1,323697,323698,323699,1,2,0
92447,2,1,323699,323699,323700,0,1,0
92448,6,3,323705,323705,323708,0,3,5
92449,5,2,323710,323710,323712,0,2,2
92450,5,2,323715,323715,323717,0,2,3
92451,3,1,323718,323718,323719,0,1,1
92452,2,3,323720,323720,323723,0,3,1
92453,3,1,323723,323723,323724,0,1,0
92454,5,1,323728,323728,323729,0,1,4
92455,6,3,323734,323734,323737,0,3,5
92456,5,2,323739,323739,323741,0,2,2
92457,3,1,323742,323742,323743,0,1,1
92458,3,1,323745,323745,323746,0,1,2
92459,1,1,323746,323746,323747,0,1,0
92460,5,3,323751,323751,323754,0,3,4
92461,5,2,323756,323756,323758,0,2,2
92462,5,1,323761,323761,323762,0,1,3
92463,2,1,323763,323763,323764,0,1,1
92464,1,3,323764,323764,323767,0,3,0
92465,1,1,323765,323767,323768,2,3,0
92466,3,3,323768,323768,323771,0,3,0
92467,4,1,323772,323772,323773,0,1,1
92468,2,2,323774,323774,323776,0,2,1
92469,3,1,323777,323777,323778,0,1,1
92470,1,1,323778,323778,323779,0,1,0
92471,1,1,323779,323779,323780,0,1,0
92472,2,1,323781,323781,323782,0,1,1
92473,3,2,323784,323784,323786,0,2,2
92474,6,2,323790,323790,323792,0,2,4
92475,5,1,323795,323795,323796,0,1,3
92476,2,2,323797,323797,323799,0,2,1
92477,1,1,323798,323799,323800,1,2,0
92478,3,1,323801,323801,323802,0,1,1
92479,1,3,323802,323802,323805,0,3,0
92480,5,3,323807,323807,323810,0,3,2
92481,2,3,323809,323810,323813,1,4,0
92482,1,1,323810,323813,323814,3,4,0
92483,1,2,323811,323814,323816,3,5,0
92484,6,2,323817,323817,323819,0,2,1
92485,1,2,323818,323819,323821,1,3,0
92486,1,3,323819,323821,323824,2,5,0
92487,5,1,323824,323824,323825,0,1,0
92488,3,1,323827,323827,323828,0,1,2
92489,4,2,323831,323831,323833,0,2,3
92490,6,1,323837,323837,323838,0,1,4
92491,1,3,323838,323838,323841,0,3,0
92492,1,3,323839,323841,323844,2,5,0
92493,1,1,323840,323844,323845,4,5,0
92494,4,2,323844,323845,323847,1,3,0
92495,5,2,323849,323849,323851,0,2,2
92496,1,3,323850,323851,323854,1,4,0
92497,1,3,323851,323854,323857,3,6,0
92498,3,2,323854,323857,323859,3,5,0
92499,4,3,323858,323859,323862,1,4,0
92500,3,1,323861,323862,323863,1,2,0
92501,4,3,323865,323865,323868,0,3,2
92502,5,2,323870,323870,323872,0,2,2
92503,2,2,323872,323872,323874,0,2,0
92504,1,1,323873,323874,323875,1,2,0
92505,2,3,323875,323875,323878,0,3,0
92506,3,1,323878,323878,323879,0,1,0
92507,6,1,323884,323884,323885,0,1,5
92508,5,1,323889,323889,323890,0,1,4
92509,6,1,323895,323895,323896,0,1,5
92510,6,1,323901,323901,323902,0,1,5
92511,6,1,323907,323907,323908,0,1,5
92512,1,3,323908,323908,323911,0,3,0
92513,1,2,323909,323911,323913,2,4,0
92514,6,3,323915,323915,323918,0,3,2
92515,6,2,323921,323921,323923,0,2,3
92516,5,3,323926,323926,323929,0,3,3
92517,5,2,323931,323931,323933,0,2,2
92518,4,3,323935,323935,323938,0,3,2
92519,4,3,323939,323939,323942,0,3,1
92520,5,3,323944,323944,323947,0,3,2
92521,6,1,323950,323950,323951,0,1,3
92522,3,2,323953,323953,323955,0,2,2
92523,5,2,323958,323958,323960,0,2,3
92524,3,3,323961,323961,323964,0,3,1
92525,3,2,323964,323964,323966,0,2,0
92526,5,3,323969,323969,323972,0,3,3
92527,2,3,323971,323972,323975,1,4,0
92528,1,2,323972,323975,323977,3,5,0
92529,6,1,323978,323978,323979,0,1,1
92530,2,3,323980,323980,323983,0,3,1
92531,1,1,323981,323983,323984,2,3,0
92532,3,3,323984,323984,323987,0,3,0
92533,4,1,323988,323988,323989,0,1,1
92534,1,3,323989,323989,323992,0,3,0
92535,6,1,323995,323995,323996,0,1,3
92536,4,3,323999,323999,324002,0,3,3
92537,6,1,324005,324005,324006,0,1,3
92538,2,1,324007,324007,324008,0,1,1
92539,6,3,324013,324013,324016,0,3,5
92540,6,1,324019,324019,324020,0,1,3
92541,3,3,324022,324022,324025,0,3,2
92542,2,1,324024,324025,324026,1,2,0
92543,6,2,324030,324030,324032,0,2,4
92544,6,1,324036,324036,324037,0,1,4
92545,4,3,324040,324040,324043,0,3,3
92546,2,3,324042,324043,324046,1,4,0
92547,1,2,324043,324046,324048,3,5,0
92548,3,1,324046,324048,324049,2,3,0
92549,5,1,324051,324051,324052,0,1,2
92550,5,1,324056,324056,324057,0,1,4
92551,3,2,324059,324059,324061,0,2,2
92552,4,3,324063,324063,324066,0,3,2
92553,3,3,324066,324066,324069,0,3,0
92554,6,3,324072,324072,324075,0,3,3
92555,2,1,324074,324075,324076,1,2,0
92556,5,2,324079,324079,324081,0,2,3
92557,5,3,324084,324084,324087,0,3,3
92558,2,3,324086,324087,324090,1,4,0
92559,2,1,324088,324090,324091,2,3,0
92560,5,3,324093,324093,324096,0,3,2
92561,5,3,324098,324098,324101,0,3,2
92562,2,2,324100,324101,324103,1,3,0
92563,6,2,324106,324106,324108,0,2,3
92564,4,1,324110,324110,324111,0,1,2
92565,2,2,324112,324112,324114,0,2,1
92566,1,2,324113,324114,324116,1,3,0
92567,4,2,324117,324117,324119,0,2,1
92568,3,2,324120,324120,324122,0,2,1
92569,1,2,324121,324122,324124,1,3,0
92570,6,1,324127,324127,324128,0,1,3
92571,6,3,324133,324133,324136,0,3,5
92572,2,1,324135,324136,324137,1,2,0
92573,4,1,324139,324139,324140,0,1,2
92574,6,3,324145,324145,324148,0,3,5
92575,6,3,324151,324151,324154,0,3,3
92576,2,3,324153,324154,324157,1,4,0
92577,2,2,324155,324157,324159,2,4,0
92578,1,3,324156,324159,324162,3,6,0
92579,2,3,324158,324162,324165,4,7,0
92580,1,3,324159,324165,324168,6,9,0
92581,3,1,324162,324168,324169,6,7,0
92582,6,2,324168,324169,324171,1,3,0
92583,4,3,324172,324172,324175,0,3,1
92584,2,1,324174,324175,324176,1,2,0
92585,4,3,324178,324178,324181,0,3,2
92586,4,2,324182,324182,324184,0,2,1
92587,2,2,324184,324184,324186,0,2,0
92588,6,1,324190,324190,324191,0,1,4
92589,6,3,324196,324196,324199,0,3,5
92590,2,3,324198,324199,324202,1,4,0
92591,3,1,324201,324202,324203,1,2,0
92592,5,3,324206,324206,324209,0,3,3
92593,1,3,324207,324209,324212,2,5,0
92594,6,3,324213,324213,324216,0,3,1
92595,3,2,324216,324216,324218,0,2,0
92596,4,1,324220,324220,324221,0,1,2
92597,1,2,324221,324221,324223,0,2,0
92598,3,2,324224,324224,324226,0,2,1
92599,3,1,324227,324227,324228,0,1,1
92600,3,2,324230,324230,324232,0,2,2
92601,3,1,324233,324233,324234,0,1,1
92602,5,1,324238,324238,324239,0,1,4
92603,4,2,324242,324242,324244,0,2,3
92604,6,3,324248,324248,324251,0,3,4
92605,5,2,324253,324253,324255,0,2,2
92606,4,3,324257,324257,324260,0,3,2
92607,1,1,324258,324260,324261,2,3,0
92608,6,2,324264,324264,324266,0,2,3
92609,5,3,324269,324269,324272,0,3,3
92610,5,2,324274,324274,324276,0,2,2
92611,3,1,324277,324277,324278,0,1,1
92612,3,3,324280,324280,324283,0,3,2
92613,4,1,324284,324284,324285,0,1,1
92614,1,3,324285,324285,324288,0,3,0
92615,1,1,324286,324288,324289,2,3,0
92616,5,3,324291,324291,324294,0,3,2
92617,4,2,324295,324295,324297,0,2,1
92618,5,2,324300,324300,324302,0,2,3
92619,6,1,324306,324306,324307,0,1,4
92620,4,3,324310,324310,324313,0,3,3
92621,3,3,324313,324313,324316,0,3,0
92622,5,2,324318,324318,324320,0,2,2
92623,1,3,324319,324320,324323,1,4,0
92624,1,1,324320,324323,324324,3,4,0
92625,3,1,324323,324324,324325,1,2,0
92626,2,2,324325,324325,324327,0,2,0
92627,1,1,324326,324327,324328,1,2,0
92628,3,1,324329,324329,324330,0,1,1
92629,4,1,324333,324333,324334,0,1,3
92630,3,3,324336,324336,324339,0,3,2
92631,3,2,324339,324339,324341,0,2,0
92632,3,2,324342,324342,324344,0,2,1
92633,2,3,324344,324344,324347,0,3,0
92634,5,3,324349,324349,324352,0,3,2
92635,2,3,324351,324352,324355,1,4,0
92636,2,2,324353,324355,324357,2,4,0
92637,2,3,324355,324357,324360,2,5,0
92638,3,3,324358,324360,324363,2,5,0
92639,4,1,324362,324363,324364,1,2,0
92640,4,2,324366,324366,324368,0,2,2
92641,2,2,324368,324368,324370,0,2,0
92642,3,3,324371,324371,324374,0,3,1
92643,1,1,324372,324374,324375,2,3,0
92644,6,3,324378,324378,324381,0,3,3
92645,5,1,324383,324383,324384,0,1,2
92646,4,3,324387,324387,324390,0,3,3
92647,6,2,324393,324393,324395,0,2,3
92648,1,2,324394,324395,324397,1,3,0
92649,3,2,324397,324397,324399,0,2,0
92650,3,1,324400,324400,324401,0,1,1
92651,4,2,324404,324404,324406,0,2,3
92652,6,2,324410,324410,324412,0,2,4
92653,3,2,324413,324413,324415,0,2,1
92654,3,1,324416,324416,324417,0,1,1
92655,5,3,324421,324421,324424,0,3,4
92656,5,1,324426,324426,324427,0,1,2
92657,2,3,324428,324428,324431,0,3,1
92658,2,3,324430,324431,324434,1,4,0
92659,1,2,324431,324434,324436,3,5,0
92660,4,3,324435,324436,324439,1,4,0
92661,3,2,324438,324439,324441,1,3,0
92662,1,1,324439,324441,324442,2,3,0
92663,1,3,324440,324442,324445,2,5,0
92664,5,2,324445,324445,324447,0,2,0
92665,2,3,324447,324447,324450,0,3,0
92666,3,3,324450,324450,324453,0,3,0
92667,4,3,324454,324454,324457,0,3,1
92668,2,1,324456,324457,324458,1,2,0
92669,4,1,324460,324460,324461,0,1,2
92670,2,3,324462,324462,324465,0,3,1
92671,6,2,324468,324468,324470,0,2,3
92672,2,3,324470,324470,324473,0,3,0
92673,6,2,324476,324476,324478,0,2,3
92674,2,3,324478,324478,324481,0,3,0
92675,5,3,324483,324483,324486,0,3,2
92676,1,2,324484,324486,324488,2,4,0
92677,3,1,324487,324488,324489,1,2,0
92678,1,3,324488,324489,324492,1,4,0
92679,4,3,324492,324492,324495,0,3,0
92680,6,3,324498,324498,324501,0,3,3
92681,1,2,324499,324501,324503,2,4,0
92682,6,3,324505,324505,324508,0,3,2
92683,2,2,324507,324508,324510,1,3,0
92684,5,3,324512,324512,324515,0,3,2
92685,1,1,324513,324515,324516,2,3,0
92686,5,3,324518,324518,324521,0,3,2
92687,3,3,324521,324521,324524,0,3,0
92688,1,3,324522,324524,324527,2,5,0
92689,2,2,324524,324527,324529,3,5,0
92690,2,2,324526,324529,324531,3,5,0
92691,4,2,324530,324531,324533,1,3,0
92692,3,1,324533,324533,324534,0,1,0
92693,4,2,324537,324537,324539,0,2,3
92694,1,1,324538,324539,324540,1,2,0
92695,6,1,324544,324544,324545,0,1,4
92696,1,2,324545,324545,324547,0,2,0
92697,1,1,324546,324547,324548,1,2,0
92698,6,2,324552,324552,324554,0,2,4
92699,5,3,324557,324557,324560,0,3,3
92700,1,2,324558,324560,324562,2,4,0
92701,6,2,324564,324564,324566,0,2,2
92702,3,3,324567,324567,324570,0,3,1
92703,1,2,324568,324570,324572,2,4,0
92704,1,2,324569,324572,324574,3,5,0
92705,3,3,324572,324574,324577,2,5,0
92706,1,2,324573,324577,324579,4,6,0
92707,6,3,324579,324579,324582,0,3,0
92708,5,3,324584,324584,324587,0,3,2
92709,1,2,324585,324587,324589,2,4,0
92710,5,3,324590,324590,324593,0,3,1
92711,1,3,324591,324593,324596,2,5,0
92712,4,1,324595,324596,324597,1,2,0
92713,6,1,324601,324601,324602,0,1,4
92714,2,1,324603,324603,324604,0,1,1
92715,5,2,324608,324608,324610,0,2,4
92716,3,2,324611,324611,324613,0,2,1
92717,5,3,324616,324616,324619,0,3,3
92718,4,2,324620,324620,324622,0,2,1
92719,4,2,324624,324624,324626,0,2,2
92720,6,3,324630,324630,324633,0,3,4
92721,3,2,324633,324633,324635,0,2,0
92722,4,3,324637,324637,324640,0,3,2
92723,4,2,324641,324641,324643,0,2,1
92724,3,3,324644,324644,324647,0,3,1
92725,2,2,324646,324647,324649,1,3,0
92726,5,1,324651,324651,324652,0,1,2
92727,1,2,324652,324652,324654,0,2,0
92728,1,1,324653,324654,324655,1,2,0
92729,4,3,324657,324657,324660,0,3,2
92730,3,3,324660,324660,324663,0,3,0
92731,5,3,324665,324665,324668,0,3,2
92732,3,3,324668,324668,324671,0,3,0
92733,3,1,324671,324671,324672,0,1,0
92734,2,2,324673,324673,324675,0,2,1
92735,3,3,324676,324676,324679,0,3,1
92736,2,3,324678,324679,324682,1,4,0
92737,3,2,324681,324682,324684,1,3,0
92738,1,2,324682,324684,324686,2,4,0
92739,6,1,324688,324688,324689,0,1,2
92740,4,2,324692,324692,324694,0,2,3
92741,5,1,324697,324697,324698,0,1,3
92742,2,2,324699,324699,324701,0,2,1
92743,2,1,324701,324701,324702,0,1,0
92744,6,3,324707,324707,324710,0,3,5
92745,1,3,324708,324710,324713,2,5,0
92746,2,2,324710,324713,324715,3,5,0
92747,5,2,324715,324715,324717,0,2,0
92748,3,2,324718,324718,324720,0,2,1
92749,4,2,324722,324722,324724,0,2,2
92750,2,3,324724,324724,324727,0,3,0
92751,6,2,324730,324730,324732,0,2,3
92752,4,1,324734,324734,324735,0,1,2
92753,4,3,324738,324738,324741,0,3,3
92754,3,2,324741,324741,324743,0,2,0
92755,2,2,324743,324743,324745,0,2,0
92756,1,3,324744,324745,324748,1,4,0
92757,5,2,324749,324749,324751,0,2,1
92758,5,3,324754,324754,324757,0,3,3
92759,3,2,324757,324757,324759,0,2,0
92760,3,2,324760,324760,324762,0,2,1
92761,5,1,324765,324765,324766,0,1,3
92762,1,2,324766,324766,324768,0,2,0
92763,2,3,324768,324768,324771,0,3,0
92764,3,1,324771,324771,324772,0,1,0
92765,3,2,324774,324774,324776,0,2,2
92766,1,2,324775,324776,324778,1,3,0
92767,3,3,324778,324778,324781,0,3,0
92768,6,3,324784,324784,324787,0,3,3
92769,4,1,324788,324788,324789,0,1,1
92770,6,3,324794,324794,324797,0,3,5
92771,6,1,324800,324800,324801,0,1,3
92772,6,3,324806,324806,324809,0,3,5
92773,6,2,324812,324812,324814,0,2,3
92774,5,1,324817,324817,324818,0,1,3
92775,1,2,324818,324818,324820,0,2,0
92776,4,1,324822,324822,324823,0,1,2
92777,6,3,324828,324828,324831,0,3,5
92778,2,1,324830,324831,324832,1,2,0
92779,4,1,324834,324834,324835,0,1,2
92780,2,3,324836,324836,324839,0,3,1
92781,1,3,324837,324839,324842,2,5,0
92782,3,1,324840,324842,324843,2,3,0
92783,2,3,324842,324843,324846,1,4,0
92784,1,2,324843,324846,324848,3,5,0
92785,1,2,324844,324848,324850,4,6,0
92786,6,2,324850,324850,324852,0,2,0
92787,4,2,324854,324854,324856,0,2,2
92788,5,1,324859,324859,324860,0,1,3
92789,3,3,324862,324862,324865,0,3,2
92790,5,3,324867,324867,324870,0,3,2
92791,6,1,324873,324873,324874,0,1,3
92792,5,2,324878,324878,324880,0,2,4
92793,5,1,324883,324883,324884,0,1,3
92794,4,2,324887,324887,324889,0,2,3
92795,1,3,324888,324889,324892,1,4,0
92796,5,3,324893,324893,324896,0,3,1
92797,5,2,324898,324898,324900,0,2,2
92798,2,1,324900,324900,324901,0,1,0
92799,2,3,324902,324902,324905,0,3,1
92800,5,3,324907,324907,324910,0,3,2
92801,4,2,324911,324911,324913,0,2,1
92802,2,2,324913,324913,324915,0,2,0
92803,3,3,324916,324916,324919,0,3,1
92804,4,1,324920,324920,324921,0,1,1
92805,4,3,324924,324924,324927,0,3,3
92806,6,1,324930,324930,324931,0,1,3
92807,3,3,324933,324933,324936,0,3,2
92808,4,1,324937,324937,324938,0,1,1
92809,3,1,324940,324940,324941,0,1,2
92810,5,1,324945,324945,324946,0,1,4
92811,4,3,324949,324949,324952,0,3,3
92812,1,1,324950,324952,324953,2,3,0
92813,5,3,324955,324955,324958,0,3,2
92814,5,1,324960,324960,324961,0,1,2
92815,5,3,324965,324965,324968,0,3,4
92816,6,2,324971,324971,324973,0,2,3
92817,6,2,324977,324977,324979,0,2,4
92818,2,1,324979,324979,324980,0,1,0
92819,3,3,324982,324982,324985,0,3,2
92820,4,2,324986,324986,324988,0,2,1
92821,5,1,324991,324991,324992,0,1,3
92822,6,3,324997,324997,325000,0,3,5
92823,1,2,324998,325000,325002,2,4,0
92824,4,1,325002,325002,325003,0,1,0
92825,6,2,325008,325008,325010,0,2,5
92826,3,3,325011,325011,325014,0,3,1
92827,6,1,325017,325017,325018,0,1,3
92828,5,2,325022,325022,325024,0,2,4
92829,6,2,325028,325028,325030,0,2,4
92830,5,1,325033,325033,325034,0,1,3
92831,3,3,325036,325036,325039,0,3,2
92832,2,2,325038,325039,325041,1,3,0
92833,2,2,325040,325041,325043,1,3,0
92834,3,3,325043,325043,325046,0,3,0
92835,3,1,325046,325046,325047,0,1,0
92836,3,3,325049,325049,325052,0,3,2
92837,3,3,325052,325052,325055,0,3,0
92838,4,1,325056,325056,325057,0,1,1
92839,4,1,325060,325060,325061,0,1,3
92840,2,2,325062,325062,325064,0,2,1
92841,1,3,325063,325064,325067,1,4,0
92842,6,3,325069,325069,325072,0,3,2
92843,2,3,325071,325072,325075,1,4,0
92844,3,3,325074,325075,325078,1,4,0
92845,6,3,325080,325080,325083,0,3,2
92846,4,1,325084,325084,325085,0,1,1
92847,2,1,325086,325086,325087,0,1,1
92848,1,2,325087,325087,325089,0,2,0
92849,6,3,325093,325093,325096,0,3,4
92850,6,3,325099,325099,325102,0,3,3
92851,6,1,325105,325105,325106,0,1,3
92852,4,1,325109,325109,325110,0,1,3
92853,1,2,325110,325110,325112,0,2,0
92854,3,1,325113,325113,325114,0,1,1
92855,2,1,325115,325115,325116,0,1,1
92856,3,2,325118,325118,325120,0,2,2
92857,6,3,325124,325124,325127,0,3,4
92858,4,1,325128,325128,325129,0,1,1
92859,5,2,325133,325133,325135,0,2,4
92860,1,1,325134,325135,325136,1,2,0
92861,3,3,325137,325137,325140,0,3,1
92862,2,3,325139,325140,325143,1,4,0
92863,3,1,325142,325143,325144,1,2,0
92864,4,1,325146,325146,325147,0,1,2
92865,5,2,325151,325151,325153,0,2,4
92866,2,1,325153,325153,325154,0,1,0
92867,3,1,325156,325156,325157,0,1,2
92868,6,2,325162,325162,325164,0,2,5
92869,1,3,325163,325164,325167,1,4,0
92870,5,1,325168,325168,325169,0,1,1
92871,4,2,325172,325172,325174,0,2,3
92872,5,1,325177,325177,325178,0,1,3
92873,1,2,325178,325178,325180,0,2,0
92874,3,1,325181,325181,325182,0,1,1
92875,1,3,325182,325182,325185,0,3,0
92876,1,2,325183,325185,325187,2,4,0
92877,5,1,325188,325188,325189,0,1,1
92878,6,1,325194,325194,325195,0,1,5
92879,2,3,325196,325196,325199,0,3,1
92880,3,3,325199,325199,325202,0,3,0
92881,4,2,325203,325203,325205,0,2,1
92882,6,2,325209,325209,325211,0,2,4
92883,3,1,325212,325212,325213,0,1,1
92884,5,1,325217,325217,325218,0,1,4
92885,1,2,325218,325218,325220,0,2,0
92886,6,3,325224,325224,325227,0,3,4
92887,1,2,325225,325227,325229,2,4,0
92888,6,2,325231,325231,325233,0,2,2
92889,1,1,325232,325233,325234,1,2,0
92890,4,2,325236,325236,325238,0,2,2
92891,3,1,325239,325239,325240,0,1,1
92892,4,1,325243,325243,325244,0,1,3
92893,6,3,325249,325249,325252,0,3,5
92894,3,2,325252,325252,325254,0,2,0
92895,3,1,325255,325255,325256,0,1,1
92896,6,1,325261,325261,325262,0,1,5
92897,1,1,325262,325262,325263,0,1,0
92898,5,1,325267,325267,325268,0,1,4
92899,5,2,325272,325272,325274,0,2,4
92900,3,1,325275,325275,325276,0,1,1
92901,5,3,325280,325280,325283,0,3,4
92902,5,2,325285,325285,325287,0,2,2
92903,3,1,325288,325288,325289,0,1,1
92904,4,2,325292,325292,325294,0,2,3
92905,6,1,325298,325298,325299,0,1,4
92906,3,3,325301,325301,325304,0,3,2
92907,2,3,325303,325304,325307,1,4,0
92908,1,2,325304,325307,325309,3,5,0
92909,1,1,325305,325309,325310,4,5,0
92910,6,1,325311,325311,325312,0,1,1
92911,5,1,325316,325316,325317,0,1,4
92912,1,2,325317,325317,325319,0,2,0
92913,3,1,325320,325320,325321,0,1,1
92914,3,2,325323,325323,325325,0,2,2
92915,1,3,325324,325325,325328,1,4,0
92916,1,2,325325,325328,325330,3,5,0
92917,3,1,325328,325330,325331,2,3,0
92918,4,2,325332,325332,325334,0,2,1
92919,3,2,325335,325335,325337,0,2,1
92920,6,3,325341,325341,325344,0,3,4
92921,6,3,325347,325347,325350,0,3,3
92922,4,3,325351,325351,325354,0,3,1
92923,4,1,325355,325355,325356,0,1,1
92924,2,3,325357,325357,325360,0,3,1
92925,4,1,325361,325361,325362,0,1,1
92926,5,2,325366,325366,325368,0,2,4
92927,3,2,325369,325369,325371,0,2,1
92928,6,2,325375,325375,325377,0,2,4
92929,3,2,325378,325378,325380,0,2,1
92930,6,2,325384,325384,325386,0,2,4
92931,4,2,325388,325388,325390,0,2,2
92932,4,3,325392,325392,325395,0,3,2
92933,3,1,325395,325395,325396,0,1,0
92934,2,1,325397,325397,325398,0,1,1
92935,6,2,325403,325403,325405,0,2,5
92936,2,2,325405,325405,325407,0,2,0
92937,1,2,325406,325407,325409,1,3,0
92938,3,2,325409,325409,325411,0,2,0
92939,2,3,325411,325411,325414,0,3,0
92940,1,3,325412,325414,325417,2,5,0
92941,2,3,325414,325417,325420,3,6,0
92942,2,1,325416,325420,325421,4,5,0
92943,5,2,325421,325421,325423,0,2,0
92944,5,3,325426,325426,325429,0,3,3
92945,3,1,325429,325429,325430,0,1,0
92946,4,3,325433,325433,325436,0,3,3
92947,3,3,325436,325436,325439,0,3,0
92948,6,1,325442,325442,325443,0,1,3
92949,6,3,325448,325448,325451,0,3,5
92950,1,3,325449,325451,325454,2,5,0
92951,5,1,325454,325454,325455,0,1,0
92952,2,2,325456,325456,325458,0,2,1
92953,5,3,325461,325461,325464,0,3,3
92954,2,2,325463,325464,325466,1,3,0
92955,2,1,325465,325466,325467,1,2,0
92956,3,2,325468,325468,325470,0,2,1
92957,3,1,325471,325471,325472,0,1,1
92958,6,1,325477,325477,325478,0,1,5
92959,6,2,325483,325483,325485,0,2,5
92960,6,1,325489,325489,325490,0,1,4
92961,2,3,325491,325491,325494,0,3,1
92962,1,2,325492,325494,325496,2,4,0
92963,1,1,325493,325496,325497,3,4,0
92964,3,3,325496,325497,325500,1,4,0
92965,4,2,325500,325500,325502,0,2,0
92966,5,2,325505,325505,325507,0,2,3
92967,2,2,325507,325507,325509,0,2,0
92968,5,1,325512,325512,325513,0,1,3
92969,2,3,325514,325514,325517,0,3,1
92970,4,2,325518,325518,325520,0,2,1
92971,2,1,325520,325520,325521,0,1,0
92972,3,3,325523,325523,325526,0,3,2
92973,2,3,325525,325526,325529,1,4,0
92974,4,2,325529,325529,325531,0,2,0
92975,5,2,325534,325534,325536,0,2,3
92976,4,2,325538,325538,325540,0,2,2
92977,5,3,325543,325543,325546,0,3,3
92978,5,2,325548,325548,325550,0,2,2
92979,5,2,325553,325553,325555,0,2,3
92980,5,2,325558,325558,325560,0,2,3
92981,4,2,325562,325562,325564,0,2,2
92982,6,3,325568,325568,325571,0,3,4
92983,2,1,325570,325571,325572,1,2,0
92984,3,1,325573,325573,325574,0,1,1
92985,1,3,325574,325574,325577,0,3,0
92986,4,3,325578,325578,325581,0,3,1
92987,6,2,325584,325584,325586,0,2,3
92988,4,1,325588,325588,325589,0,1,2
92989,1,2,325589,325589,325591,0,2,0
92990,3,1,325592,325592,325593,0,1,1
92991,2,1,325594,325594,325595,0,1,1
92992,4,3,325598,325598,325601,0,3,3
92993,5,3,325603,325603,325606,0,3,2
92994,2,1,325605,325606,325607,1,2,0
92995,1,1,325606,325607,325608,1,2,0
92996,4,2,325610,325610,325612,0,2,2
92997,2,1,325612,325612,325613,0,1,0
92998,3,1,325615,325615,325616,0,1,2
92999,2,1,325617,325617,325618,0,1,1
93000,5,2,325622,325622,325624,0,2,4
93001,4,3,325626,325626,325629,0,3,2
93002,3,1,325629,325629,325630,0,1,0
93003,4,3,325633,325633,325636,0,3,3
93004,4,2,325637,325637,325639,0,2,1
93005,1,3,325638,325639,325642,1,4,0
93006,3,3,325641,325642,325645,1,4,0
93007,2,2,325643,325645,325647,2,4,0
93008,3,3,325646,325647,325650,1,4,0
93009,3,2,325649,325650,325652,1,3,0
93010,3,3,325652,325652,325655,0,3,0
93011,4,1,325656,325656,325657,0,1,1
93012,1,3,325657,325657,325660,0,3,0
93013,4,3,325661,325661,325664,0,3,1
93014,5,3,325666,325666,325669,0,3,2
93015,5,3,325671,325671,325674,0,3,2
93016,2,2,325673,325674,325676,1,3,0
93017,6,1,325679,325679,325680,0,1,3
93018,1,3,325680,325680,325683,0,3,0
93019,4,1,325684,325684,325685,0,1,1
93020,4,3,325688,325688,325691,0,3,3
93021,6,3,325694,325694,325697,0,3,3
93022,4,2,325698,325698,325700,0,2,1
93023,3,1,325701,325701,325702,0,1,1
93024,6,1,325707,325707,325708,0,1,5
93025,4,3,325711,325711,325714,0,3,3
93026,5,3,325716,325716,325719,0,3,2
93027,6,3,325722,325722,325725,0,3,3
93028,6,3,325728,325728,325731,0,3,3
93029,5,1,325733,325733,325734,0,1,2
93030,4,2,325737,325737,325739,0,2,3
93031,4,1,325741,325741,325742,0,1,2
93032,6,1,325747,325747,325748,0,1,5
93033,1,1,325748,325748,325749,0,1,0
93034,3,1,325751,325751,325752,0,1,2
93035,5,3,325756,325756,325759,0,3,4
93036,3,2,325759,325759,325761,0,2,0
93037,5,1,325764,325764,325765,0,1,3
93038,5,3,325769,325769,325772,0,3,4
93039,4,1,325773,325773,325774,0,1,1
93040,6,2,325779,325779,325781,0,2,5
93041,6,3,325785,325785,325788,0,3,4
93042,2,2,325787,325788,325790,1,3,0
93043,2,1,325789,325790,325791,1,2,0
93044,6,3,325795,325795,325798,0,3,4
93045,5,3,325800,325800,325803,0,3,2
93046,1,3,325801,325803,325806,2,5,0
93047,2,1,325803,325806,325807,3,4,0
93048,5,2,325808,325808,325810,0,2,1
93049,5,1,325813,325813,325814,0,1,3
93050,1,1,325814,325814,325815,0,1,0
93051,3,3,325817,325817,325820,0,3,2
93052,4,3,325821,325821,325824,0,3,1
93053,2,2,325823,325824,325826,1,3,0
93054,5,2,325828,325828,325830,0,2,2
93055,5,1,325833,325833,325834,0,1,3
93056,5,2,325838,325838,325840,0,2,4
93057,5,1,325843,325843,325844,0,1,3
93058,3,3,325846,325846,325849,0,3,2
93059,3,3,325849,325849,325852,0,3,0
93060,5,2,325854,325854,325856,0,2,2
93061,4,2,325858,325858,325860,0,2,2
93062,4,3,325862,325862,325865,0,3,2
93063,2,2,325864,325865,325867,1,3,0
93064,2,2,325866,325867,325869,1,3,0
93065,4,2,325870,325870,325872,0,2,1
93066,1,2,325871,325872,325874,1,3,0
93067,5,1,325876,325876,325877,0,1,2
93068,4,3,325880,325880,325883,0,3,3
93069,6,1,325886,325886,325887,0,1,3
93070,1,2,325887,325887,325889,0,2,0
93071,2,2,325889,325889,325891,0,2,0
93072,4,2,325893,325893,325895,0,2,2
93073,3,2,325896,325896,325898,0,2,1
93074,3,2,325899,325899,325901,0,2,1
93075,4,2,325903,325903,325905,0,2,2
93076,6,1,325909,325909,325910,0,1,4
93077,4,2,325913,325913,325915,0,2,3
93078,6,3,325919,325919,325922,0,3,4
93079,2,1,325921,325922,325923,1,2,0
93080,4,2,325925,325925,325927,0,2,2
93081,6,3,325931,325931,325934,0,3,4
93082,2,1,325933,325934,325935,1,2,0
93083,5,1,325938,325938,325939,0,1,3
93084,4,1,325942,325942,325943,0,1,3
93085,2,3,325944,325944,325947,0,3,1
93086,3,2,325947,325947,325949,0,2,0
93087,1,2,325948,325949,325951,1,3,0
93088,1,1,325949,325951,325952,2,3,0
93089,4,3,325953,325953,325956,0,3,1
93090,3,2,325956,325956,325958,0,2,0
93091,3,2,325959,325959,325961,0,2,1
93092,5,1,325964,325964,325965,0,1,3
93093,6,3,325970,325970,325973,0,3,5
93094,6,3,325976,325976,325979,0,3,3
93095,1,1,325977,325979,325980,2,3,0
93096,4,1,325981,325981,325982,0,1,1
93097,2,1,325983,325983,325984,0,1,1
93098,1,3,325984,325984,325987,0,3,0
93099,1,1,325985,325987,325988,2,3,0
93100,4,1,325989,325989,325990,0,1,1
93101,4,3,325993,325993,325996,0,3,3
93102,3,3,325996,325996,325999,0,3,0
93103,2,3,325998,325999,326002,1,4,0
93104,1,3,325999,326002,326005,3,6,0
93105,5,1,326004,326005,326006,1,2,0
93106,6,2,326010,326010,326012,0,2,4
93107,2,1,326012,326012,326013,0,1,0
93108,3,1,326015,326015,326016,0,1,2
93109,5,3,326020,326020,326023,0,3,4
93110,1,2,326021,326023,326025,2,4,0
93111,3,3,326024,326025,326028,1,4,0
93112,3,3,326027,326028,326031,1,4,0
93113,4,3,326031,326031,326034,0,3,0
93114,3,1,326034,326034,326035,0,1,0
93115,5,1,326039,326039,326040,0,1,4
93116,5,1,326044,326044,326045,0,1,4
93117,4,2,326048,326048,326050,0,2,3
93118,6,1,326054,326054,326055,0,1,4
93119,2,1,326056,326056,326057,0,1,1
93120,1,3,326057,326057,326060,0,3,0
93121,1,1,326058,326060,326061,2,3,0
93122,4,2,326062,326062,326064,0,2,1
93123,3,2,326065,326065,326067,0,2,1
93124,5,2,326070,326070,326072,0,2,3
93125,2,2,326072,326072,326074,0,2,0
93126,4,3,326076,326076,326079,0,3,2
93127,3,2,326079,326079,326081,0,2,0
93128,4,1,326083,326083,326084,0,1,2
93129,3,2,326086,326086,326088,0,2,2
93130,4,3,326090,326090,326093,0,3,2
93131,4,2,326094,326094,326096,0,2,1
93132,1,1,326095,326096,326097,1,2,0
93133,6,2,326101,326101,326103,0,2,4
93134,1,3,326102,326103,326106,1,4,0
93135,1,1,326103,326106,326107,3,4,0
93136,1,2,326104,326107,326109,3,5,0
93137,2,2,326106,326109,326111,3,5,0
93138,5,1,326111,326111,326112,0,1,0
93139,3,2,326114,326114,326116,0,2,2
93140,3,1,326117,326117,326118,0,1,1
93141,6,3,326123,326123,326126,0,3,5
93142,5,1,326128,326128,326129,0,1,2
93143,2,2,326130,326130,326132,0,2,1
93144,6,3,326136,326136,326139,0,3,4
93145,5,3,326141,326141,326144,0,3,2
93146,6,1,326147,326147,326148,0,1,3
93147,5,3,326152,326152,326155,0,3,4
93148,1,1,326153,326155,326156,2,3,0
93149,6,1,326159,326159,326160,0,1,3
93150,4,2,326163,326163,326165,0,2,3
93151,5,2,326168,326168,326170,0,2,3
93152,3,2,326171,326171,326173,0,2,1
93153,5,1,326176,326176,326177,0,1,3
93154,2,3,326178,326178,326181,0,3,1
93155,5,3,326183,326183,326186,0,3,2
93156,4,2,326187,326187,326189,0,2,1
93157,2,2,326189,326189,326191,0,2,0
93158,4,1,326193,326193,326194,0,1,2
93159,1,1,326194,326194,326195,0,1,0
93160,4,2,326198,326198,326200,0,2,3
93161,5,1,326203,326203,326204,0,1,3
93162,2,1,326205,326205,326206,0,1,1
93163,1,1,326206,326206,326207,0,1,0
93164,2,1,326208,326208,326209,0,1,1
93165,5,1,326213,326213,326214,0,1,4
93166,3,2,326216,326216,326218,0,2,2
93167,5,1,326221,326221,326222,0,1,3
93168,4,1,326225,326225,326226,0,1,3
93169,5,3,326230,326230,326233,0,3,4
93170,5,2,326235,326235,326237,0,2,2
93171,6,2,326241,326241,326243,0,2,4
93172,6,2,326247,326247,326249,0,2,4
93173,5,3,326252,326252,326255,0,3,3
93174,6,3,326258,326258,326261,0,3,3
93175,1,1,326259,326261,326262,2,3,0
93176,3,2,326262,326262,326264,0,2,0
93177,3,1,326265,326265,326266,0,1,1
93178,1,1,326266,326266,326267,0,1,0
93179,4,3,326270,326270,326273,0,3,3
93180,2,3,326272,326273,326276,1,4,0
93181,6,1,326278,326278,326279,0,1,2
93182,6,1,326284,326284,326285,0,1,5
93183,1,3,326285,326285,326288,0,3,0
93184,3,3,326288,326288,326291,0,3,0
93185,1,1,326289,326291,326292,2,3,0
93186,3,2,326292,326292,326294,0,2,0
93187,1,3,326293,326294,326297,1,4,0
93188,4,3,326297,326297,326300,0,3,0
93189,5,2,326302,326302,326304,0,2,2
93190,5,1,326307,326307,326308,0,1,3
93191,1,2,326308,326308,326310,0,2,0
93192,6,2,326314,326314,326316,0,2,4
93193,5,2,326319,326319,326321,0,2,3
93194,2,2,326321,326321,326323,0,2,0
93195,4,1,326325,326325,326326,0,1,2
93196,3,1,326328,326328,326329,0,1,2
93197,6,2,326334,326334,326336,0,2,5
93198,5,2,326339,326339,326341,0,2,3
93199,5,2,326344,326344,326346,0,2,3
93200,4,3,326348,326348,326351,0,3,2
93201,4,1,326352,326352,326353,0,1,1
93202,5,2,326357,326357,326359,0,2,4
93203,1,3,326358,326359,326362,1,4,0
93204,4,3,326362,326362,326365,0,3,0
93205,6,3,326368,326368,326371,0,3,3
93206,5,3,326373,326373,326376,0,3,2
93207,2,2,326375,326376,326378,1,3,0
93208,5,1,326380,326380,326381,0,1,2
93209,6,1,326386,326386,326387,0,1,5
93210,4,1,326390,326390,326391,0,1,3
93211,1,1,326391,326391,326392,0,1,0
93212,2,2,326393,326393,326395,0,2,1
93213,6,1,326399,326399,326400,0,1,4
93214,1,1,326400,326400,326401,0,1,0
93215,5,1,326405,326405,326406,0,1,4
93216,6,1,326411,326411,326412,0,1,5
93217,6,3,326417,326417,326420,0,3,5
93218,5,3,326422,326422,326425,0,3,2
93219,2,1,326424,326425,326426,1,2,0
93220,1,2,326425,326426,326428,1,3,0
93221,6,1,326431,326431,326432,0,1,3
93222,4,3,326435,326435,326438,0,3,3
93223,6,2,326441,326441,326443,0,2,3
93224,5,1,326446,326446,326447,0,1,3
93225,2,3,326448,326448,326451,0,3,1
93226,4,2,326452,326452,326454,0,2,1
93227,2,3,326454,326454,326457,0,3,0
93228,3,1,326457,326457,326458,0,1,0
93229,4,3,326461,326461,326464,0,3,3
93230,3,1,326464,326464,326465,0,1,0
93231,3,3,326467,326467,326470,0,3,2
93232,2,1,326469,326470,326471,1,2,0
93233,6,3,326475,326475,326478,0,3,4
93234,6,1,326481,326481,326482,0,1,3
93235,1,3,326482,326482,326485,0,3,0
93236,5,1,326487,326487,326488,0,1,2
93237,1,1,326488,326488,326489,0,1,0
93238,4,2,326492,326492,326494,0,2,3
93239,2,1,326494,326494,326495,0,1,0
93240,5,1,326499,326499,326500,0,1,4
93241,1,3,326500,326500,326503,0,3,0
93242,3,2,326503,326503,326505,0,2,0
93243,1,2,326504,326505,326507,1,3,0
93244,2,3,326506,326507,326510,1,4,0
93245,3,3,326509,326510,326513,1,4,0
93246,3,2,326512,326513,326515,1,3,0
93247,6,1,326518,326518,326519,0,1,3
93248,4,3,326522,326522,326525,0,3,3
93249,5,2,326527,326527,326529,0,2,2
93250,5,3,326532,326532,326535,0,3,3
93251,2,2,326534,326535,326537,1,3,0
93252,1,3,326535,326537,326540,2,5,0
93253,4,1,326539,326540,326541,1,2,0
93254,2,1,326541,326541,326542,0,1,0
93255,4,2,326545,326545,326547,0,2,3
93256,4,1,326549,326549,326550,0,1,2
93257,3,1,326552,326552,326553,0,1,2
93258,6,2,326558,326558,326560,0,2,5
93259,1,2,326559,326560,326562,1,3,0
93260,6,3,326565,326565,326568,0,3,3
93261,5,1,326570,326570,326571,0,1,2
93262,3,2,326573,326573,326575,0,2,2
93263,4,3,326577,326577,326580,0,3,2
93264,3,1,326580,326580,326581,0,1,0
93265,4,1,326584,326584,326585,0,1,3
93266,6,2,326590,326590,326592,0,2,5
93267,6,2,326596,326596,326598,0,2,4
93268,4,3,326600,326600,326603,0,3,2
93269,5,1,326605,326605,326606,0,1,2
93270,3,2,326608,326608,326610,0,2,2
93271,6,3,326614,326614,326617,0,3,4
93272,1,1,326615,326617,326618,2,3,0
93273,4,1,326619,326619,326620,0,1,1
93274,1,2,326620,326620,326622,0,2,0
93275,3,1,326623,326623,326624,0,1,1
93276,6,2,326629,326629,326631,0,2,5
93277,3,2,326632,326632,326634,0,2,1
93278,4,2,326636,326636,326638,0,2,2
93279,1,2,326637,326638,326640,1,3,0
93280,3,1,326640,326640,326641,0,1,0
93281,4,3,326644,326644,326647,0,3,3
93282,3,3,326647,326647,326650,0,3,0
93283,1,1,326648,326650,326651,2,3,0
93284,5,1,326653,326653,326654,0,1,2
93285,2,1,326655,326655,326656,0,1,1
93286,2,3,326657,326657,326660,0,3,1
93287,4,2,326661,326661,326663,0,2,1
93288,5,2,326666,326666,326668,0,2,3
93289,3,2,326669,326669,326671,0,2,1
93290,6,3,326675,326675,326678,0,3,4
93291,3,1,326678,326678,326679,0,1,0
93292,1,1,326679,326679,326680,0,1,0
93293,4,1,326683,326683,326684,0,1,3
93294,3,2,326686,326686,326688,0,2,2
93295,3,1,326689,326689,326690,0,1,1
93296,6,2,326695,326695,326697,0,2,5
93297,4,1,326699,326699,326700,0,1,2
93298,1,3,326700,326700,326703,0,3,0
93299,6,1,326706,326706,326707,0,1,3
93300,2,1,326708,326708,326709,0,1,1
93301,5,1,326713,326713,326714,0,1,4
93302,3,2,326716,326716,326718,0,2,2
93303,6,1,326722,326722,326723,0,1,4
93304,3,2,326725,326725,326727,0,2,2
93305,5,2,326730,326730,326732,0,2,3
93306,1,3,326731,326732,326735,1,4,0
93307,4,2,326735,326735,326737,0,2,0
93308,1,2,326736,326737,326739,1,3,0
93309,1,1,326737,326739,326740,2,3,0
93310,6,1,326743,326743,326744,0,1,3
93311,6,3,326749,326749,326752,0,3,5
93312,5,3,326754,326754,326757,0,3,2
93313,4,2,326758,326758,326760,0,2,1
93314,4,3,326762,326762,326765,0,3,2
93315,5,2,326767,326767,326769,0,2,2
93316,6,3,326773,326773,326776,0,3,4
93317,1,2,326774,326776,326778,2,4,0
93318,6,1,326780,326780,326781,0,1,2
93319,6,2,326786,326786,326788,0,2,5
93320,3,3,326789,326789,326792,0,3,1
93321,1,2,326790,326792,326794,2,4,0
93322,3,2,326793,326794,326796,1,3,0
93323,5,1,326798,326798,326799,0,1,2
93324,4,2,326802,326802,326804,0,2,3
93325,3,2,326805,326805,326807,0,2,1
93326,6,1,326811,326811,326812,0,1,4
93327,2,2,326813,326813,326815,0,2,1
93328,1,1,326814,326815,326816,1,2,0
93329,1,2,326815,326816,326818,1,3,0
93330,5,3,326820,326820,326823,0,3,2
93331,2,1,326822,326823,326824,1,2,0
93332,5,1,326827,326827,326828,0,1,3
93333,5,1,326832,326832,326833,0,1,4
93334,6,1,326838,326838,326839,0,1,5
93335,6,1,326844,326844,326845,0,1,5
93336,1,3,326845,326845,326848,0,3,0
93337,1,3,326846,326848,326851,2,5,0
93338,1,3,326847,326851,326854,4,7,0
93339,6,1,326853,326854,326855,1,2,0
93340,6,2,326859,326859,326861,0,2,4
93341,5,3,326864,326864,326867,0,3,3
93342,3,3,326867,326867,326870,0,3,0
93343,2,3,326869,326870,326873,1,4,0
93344,3,3,326872,326873,326876,1,4,0
93345,6,2,326878,326878,326880,0,2,2
93346,3,2,326881,326881,326883,0,2,1
93347,5,1,326886,326886,326887,0,1,3
93348,1,2,326887,326887,326889,0,2,0
93349,4,1,326891,326891,326892,0,1,2
93350,4,1,326895,326895,326896,0,1,3
93351,4,3,326899,326899,326902,0,3,3
93352,2,1,326901,326902,326903,1,2,0
93353,5,2,326906,326906,326908,0,2,3
93354,2,1,326908,326908,326909,0,1,0
93355,3,3,326911,326911,326914,0,3,2
93356,2,1,326913,326914,326915,1,2,0
93357,3,3,326916,326916,326919,0,3,1
93358,5,1,326921,326921,326922,0,1,2
93359,1,2,326922,326922,326924,0,2,0
93360,1,2,326923,326924,326926,1,3,0
93361,2,2,326925,326926,326928,1,3,0
93362,5,3,326930,326930,326933,0,3,2
93363,1,1,326931,326933,326934,2,3,0
93364,4,2,326935,326935,326937,0,2,1
93365,2,2,326937,326937,326939,0,2,0
93366,6,1,326943,326943,326944,0,1,4
93367,2,3,326945,326945,326948,0,3,1
93368,6,2,326951,326951,326953,0,2,3
93369,6,3,326957,326957,326960,0,3,4
93370,6,1,326963,326963,326964,0,1,3
93371,4,2,326967,326967,326969,0,2,3
93372,5,2,326972,326972,326974,0,2,3
93373,5,3,326977,326977,326980,0,3,3
93374,3,3,326980,326980,326983,0,3,0
93375,1,3,326981,326983,326986,2,5,0
93376,2,1,326983,326986,326987,3,4,0
93377,4,2,326987,326987,326989,0,2,0
93378,2,3,326989,326989,326992,0,3,0
93379,3,1,326992,326992,326993,0,1,0
93380,2,1,326994,326994,326995,0,1,1
93381,1,2,326995,326995,326997,0,2,0
93382,1,2,326996,326997,326999,1,3,0
93383,5,1,327001,327001,327002,0,1,2
93384,3,1,327004,327004,327005,0,1,2
93385,4,2,327008,327008,327010,0,2,3
93386,2,3,327010,327010,327013,0,3,0
93387,1,2,327011,327013,327015,2,4,0
93388,6,3,327017,327017,327020,0,3,2
93389,2,1,327019,327020,327021,1,2,0
93390,3,3,327022,327022,327025,0,3,1
93391,6,3,327028,327028,327031,0,3,3
93392,6,2,327034,327034,327036,0,2,3
93393,4,3,327038,327038,327041,0,3,2
93394,3,2,327041,327041,327043,0,2,0
93395,2,3,327043,327043,327046,0,3,0
93396,6,1,327049,327049,327050,0,1,3
93397,2,1,327051,327051,327052,0,1,1
93398,1,1,327052,327052,327053,0,1,0
93399,1,2,327053,327053,327055,0,2,0
93400,5,2,327058,327058,327060,0,2,3
93401,1,1,327059,327060,327061,1,2,0
93402,4,1,327063,327063,327064,0,1,2
93403,2,1,327065,327065,327066,0,1,1
93404,5,1,327070,327070,327071,0,1,4
93405,1,3,327071,327071,327074,0,3,0
93406,2,1,327073,327074,327075,1,2,0
93407,6,1,327079,327079,327080,0,1,4
93408,6,3,327085,327085,327088,0,3,5
93409,4,3,327089,327089,327092,0,3,1
93410,3,2,327092,327092,327094,0,2,0
93411,3,2,327095,327095,327097,0,2,1
93412,5,2,327100,327100,327102,0,2,3
93413,2,1,327102,327102,327103,0,1,0
93414,4,3,327106,327106,327109,0,3,3
93415,3,3,327109,327109,327112,0,3,0
93416,6,1,327115,327115,327116,0,1,3
93417,5,3,327120,327120,327123,0,3,4
93418,3,1,327123,327123,327124,0,1,0
93419,6,1,327129,327129,327130,0,1,5
93420,3,2,327132,327132,327134,0,2,2
93421,6,3,327138,327138,327141,0,3,4
93422,3,2,327141,327141,327143,0,2,0
93423,2,2,327143,327143,327145,0,2,0
93424,4,2,327147,327147,327149,0,2,2
93425,3,2,327150,327150,327152,0,2,1
93426,1,3,327151,327152,327155,1,4,0
93427,2,3,327153,327155,327158,2,5,0
93428,4,3,327157,327158,327161,1,4,0
93429,2,1,327159,327161,327162,2,3,0
93430,4,3,327163,327163,327166,0,3,1
93431,5,2,327168,327168,327170,0,2,2
93432,6,1,327174,327174,327175,0,1,4
93433,4,1,327178,327178,327179,0,1,3
93434,2,2,327180,327180,327182,0,2,1
93435,5,3,327185,327185,327188,0,3,3
93436,2,2,327187,327188,327190,1,3,0
93437,2,2,327189,327190,327192,1,3,0
93438,4,3,327193,327193,327196,0,3,1
93439,6,3,327199,327199,327202,0,3,3
93440,2,1,327201,327202,327203,1,2,0
93441,4,1,327205,327205,327206,0,1,2
93442,6,2,327211,327211,327213,0,2,5
93443,4,1,327215,327215,327216,0,1,2
93444,1,2,327216,327216,327218,0,2,0
93445,2,2,327218,327218,327220,0,2,0
93446,5,2,327223,327223,327225,0,2,3
93447,4,1,327227,327227,327228,0,1,2
93448,5,3,327232,327232,327235,0,3,4
93449,4,1,327236,327236,327237,0,1,1
93450,3,2,327239,327239,327241,0,2,2
93451,1,3,327240,327241,327244,1,4,0
93452,2,1,327242,327244,327245,2,3,0
93453,3,2,327245,327245,327247,0,2,0
93454,4,3,327249,327249,327252,0,3,2
93455,5,3,327254,327254,327257,0,3,2
93456,5,3,327259,327259,327262,0,3,2
93457,2,1,327261,327262,327263,1,2,0
93458,3,3,327264,327264,327267,0,3,1
93459,3,3,327267,327267,327270,0,3,0
93460,5,3,327272,327272,327275,0,3,2
93461,2,3,327274,327275,327278,1,4,0
93462,2,3,327276,327278,327281,2,5,0
93463,4,1,327280,327281,327282,1,2,0
93464,2,2,327282,327282,327284,0,2,0
93465,5,3,327287,327287,327290,0,3,3
93466,5,1,327292,327292,327293,0,1,2
93467,5,2,327297,327297,327299,0,2,4
93468,5,1,327302,327302,327303,0,1,3
93469,6,3,327308,327308,327311,0,3,5
93470,2,2,327310,327311,327313,1,3,0
93471,1,3,327311,327313,327316,2,5,0
93472,2,3,327313,327316,327319,3,6,0
93473,6,1,327319,327319,327320,0,1,0
93474,3,2,327322,327322,327324,0,2,2
93475,2,3,327324,327324,327327,0,3,0
93476,1,1,327325,327327,327328,2,3,0
93477,3,2,327328,327328,327330,0,2,0
93478,1,3,327329,327330,327333,1,4,0
93479,3,2,327332,327333,327335,1,3,0
93480,4,2,327336,327336,327338,0,2,1
93481,3,3,327339,327339,327342,0,3,1
93482,3,2,327342,327342,327344,0,2,0
93483,1,1,327343,327344,327345,1,2,0
93484,6,2,327349,327349,327351,0,2,4
93485,4,2,327353,327353,327355,0,2,2
93486,2,3,327355,327355,327358,0,3,0
93487,3,1,327358,327358,327359,0,1,0
93488,3,3,327361,327361,327364,0,3,2
93489,5,1,327366,327366,327367,0,1,2
93490,1,2,327367,327367,327369,0,2,0
93491,3,1,327370,327370,327371,0,1,1
93492,4,1,327374,327374,327375,0,1,3
93493,4,3,327378,327378,327381,0,3,3
93494,4,3,327382,327382,327385,0,3,1
93495,1,2,327383,327385,327387,2,4,0
93496,4,1,327387,327387,327388,0,1,0
93497,1,3,327388,327388,327391,0,3,0
93498,6,1,327394,327394,327395,0,1,3
93499,2,1,327396,327396,327397,0,1,1
93500,5,1,327401,327401,327402,0,1,4
93501,3,3,327404,327404,327407,0,3,2
93502,4,3,327408,327408,327411,0,3,1
93503,3,1,327411,327411,327412,0,1,0
93504,6,2,327417,327417,327419,0,2,5
93505,6,3,327423,327423,327426,0,3,4
93506,5,3,327428,327428,327431,0,3,2
93507,2,2,327430,327431,327433,1,3,0
93508,6,3,327436,327436,327439,0,3,3
93509,3,2,327439,327439,327441,0,2,0
93510,3,3,327442,327442,327445,0,3,1
93511,6,1,327448,327448,327449,0,1,3
93512,5,2,327453,327453,327455,0,2,4
93513,5,1,327458,327458,327459,0,1,3
93514,1,1,327459,327459,327460,0,1,0
93515,2,1,327461,327461,327462,0,1,1
93516,5,1,327466,327466,327467,0,1,4
93517,2,3,327468,327468,327471,0,3,1
93518,5,2,327473,327473,327475,0,2,2
93519,5,1,327478,327478,327479,0,1,3
93520,1,2,327479,327479,327481,0,2,0
93521,4,1,327483,327483,327484,0,1,2
93522,6,1,327489,327489,327490,0,1,5
93523,1,2,327490,327490,327492,0,2,0
93524,1,3,327491,327492,327495,1,4,0
93525,4,1,327495,327495,327496,0,1,0
93526,5,1,327500,327500,327501,0,1,4
93527,5,2,327505,327505,327507,0,2,4
93528,1,3,327506,327507,327510,1,4,0
93529,5,2,327511,327511,327513,0,2,1
93530,4,3,327515,327515,327518,0,3,2
93531,5,3,327520,327520,327523,0,3,2
93532,3,3,327523,327523,327526,0,3,0
93533,6,1,327529,327529,327530,0,1,3
93534,6,1,327535,327535,327536,0,1,5
93535,3,3,327538,327538,327541,0,3,2
93536,2,2,327540,327541,327543,1,3,0
93537,5,3,327545,327545,327548,0,3,2
93538,4,3,327549,327549,327552,0,3,1
93539,4,2,327553,327553,327555,0,2,1
93540,3,1,327556,327556,327557,0,1,1
93541,4,1,327560,327560,327561,0,1,3
93542,3,1,327563,327563,327564,0,1,2
93543,5,3,327568,327568,327571,0,3,4
93544,1,1,327569,327571,327572,2,3,0
93545,1,1,327570,327572,327573,2,3,0
93546,4,1,327574,327574,327575,0,1,1
93547,5,1,327579,327579,327580,0,1,4
93548,5,2,327584,327584,327586,0,2,4
93549,6,1,327590,327590,327591,0,1,4
93550,2,1,327592,327592,327593,0,1,1
93551,1,1,327593,327593,327594,0,1,0
93552,4,1,327597,327597,327598,0,1,3
93553,5,1,327602,327602,327603,0,1,4
93554,6,3,327608,327608,327611,0,3,5
93555,6,2,327614,327614,327616,0,2,3
93556,4,1,327618,327618,327619,0,1,2
93557,3,3,327621,327621,327624,0,3,2
93558,6,2,327627,327627,327629,0,2,3
93559,5,2,327632,327632,327634,0,2,3
93560,3,3,327635,327635,327638,0,3,1
93561,5,3,327640,327640,327643,0,3,2
93562,3,2,327643,327643,327645,0,2,0
93563,5,3,327648,327648,327651,0,3,3
93564,3,3,327651,327651,327654,0,3,0
93565,1,1,327652,327654,327655,2,3,0
93566,1,3,327653,327655,327658,2,5,0
93567,4,2,327657,327658,327660,1,3,0
93568,5,2,327662,327662,327664,0,2,2
93569,5,3,327667,327667,327670,0,3,3
93570,4,3,327671,327671,327674,0,3,1
93571,3,2,327674,327674,327676,0,2,0
93572,5,1,327679,327679,327680,0,1,3
93573,6,3,327685,327685,327688,0,3,5
93574,4,2,327689,327689,327691,0,2,1
93575,5,2,327694,327694,327696,0,2,3
93576,2,1,327696,327696,327697,0,1,0
93577,2,3,327698,327698,327701,0,3,1
93578,1,3,327699,327701,327704,2,5,0
93579,1,1,327700,327704,327705,4,5,0
93580,3,2,327703,327705,327707,2,4,0
93581,5,1,327708,327708,327709,0,1,1
93582,1,2,327709,327709,327711,0,2,0
93583,1,3,327710,327711,327714,1,4,0
93584,4,2,327714,327714,327716,0,2,0
93585,2,1,327716,327716,327717,0,1,0
93586,5,1,327721,327721,327722,0,1,4
93587,4,3,327725,327725,327728,0,3,3
93588,3,3,327728,327728,327731,0,3,0
93589,4,3,327732,327732,327735,0,3,1
93590,1,1,327733,327735,327736,2,3,0
93591,1,2,327734,327736,327738,2,4,0
93592,1,1,327735,327738,327739,3,4,0
93593,6,2,327741,327741,327743,0,2,2
93594,2,3,327743,327743,327746,0,3,0
93595,5,3,327748,327748,327751,0,3,2
93596,3,2,327751,327751,327753,0,2,0
93597,2,1,327753,327753,327754,0,1,0
93598,4,3,327757,327757,327760,0,3,3
93599,5,2,327762,327762,327764,0,2,2
93600,5,3,327767,327767,327770,0,3,3
93601,4,3,327771,327771,327774,0,3,1
93602,4,1,327775,327775,327776,0,1,1
93603,3,1,327778,327778,327779,0,1,2
93604,6,1,327784,327784,327785,0,1,5
93605,1,3,327785,327785,327788,0,3,0
93606,6,3,327791,327791,327794,0,3,3
93607,3,3,327794,327794,327797,0,3,0
93608,5,2,327799,327799,327801,0,2,2
93609,3,1,327802,327802,327803,0,1,1
93610,1,3,327803,327803,327806,0,3,0
93611,6,1,327809,327809,327810,0,1,3
93612,6,3,327815,327815,327818,0,3,5
93613,4,1,327819,327819,327820,0,1,1
93614,6,3,327825,327825,327828,0,3,5
93615,6,1,327831,327831,327832,0,1,3
93616,2,2,327833,327833,327835,0,2,1
93617,4,2,327837,327837,327839,0,2,2
93618,4,1,327841,327841,327842,0,1,2
93619,5,1,327846,327846,327847,0,1,4
93620,4,3,327850,327850,327853,0,3,3
93621,4,3,327854,327854,327857,0,3,1
93622,3,2,327857,327857,327859,0,2,0
93623,5,2,327862,327862,327864,0,2,3
93624,4,1,327866,327866,327867,0,1,2
93625,6,3,327872,327872,327875,0,3,5
93626,5,3,327877,327877,327880,0,3,2
93627,3,1,327880,327880,327881,0,1,0
93628,6,1,327886,327886,327887,0,1,5
93629,3,3,327889,327889,327892,0,3,2
93630,2,3,327891,327892,327895,1,4,0
93631,6,1,327897,327897,327898,0,1,2
93632,5,1,327902,327902,327903,0,1,4
93633,4,2,327906,327906,327908,0,2,3
93634,5,2,327911,327911,327913,0,2,3
93635,1,3,327912,327913,327916,1,4,0
93636,1,2,327913,327916,327918,3,5,0
93637,2,1,327915,327918,327919,3,4,0
93638,2,2,327917,327919,327921,2,4,0
93639,4,2,327921,327921,327923,0,2,0
93640,6,1,327927,327927,327928,0,1,4
93641,4,3,327931,327931,327934,0,3,3
93642,2,1,327933,327934,327935,1,2,0
93643,2,1,327935,327935,327936,0,1,0
93644,2,2,327937,327937,327939,0,2,1
93645,3,2,327940,327940,327942,0,2,1
93646,5,1,327945,327945,327946,0,1,3
93647,1,1,327946,327946,327947,0,1,0
93648,2,3,327948,327948,327951,0,3,1
93649,6,1,327954,327954,327955,0,1,3
93650,5,1,327959,327959,327960,0,1,4
93651,1,3,327960,327960,327963,0,3,0
93652,5,2,327965,327965,327967,0,2,2
93653,4,2,327969,327969,327971,0,2,2
93654,4,1,327973,327973,327974,0,1,2
93655,1,2,327974,327974,327976,0,2,0
93656,3,2,327977,327977,327979,0,2,1
93657,3,2,327980,327980,327982,0,2,1
93658,6,2,327986,327986,327988,0,2,4
93659,2,1,327988,327988,327989,0,1,0
93660,6,1,327994,327994,327995,0,1,5
93661,6,3,328000,328000,328003,0,3,5
93662,3,3,328003,328003,328006,0,3,0
93663,2,2,328005,328006,328008,1,3,0
93664,4,2,328009,328009,328011,0,2,1
93665,2,3,328011,328011,328014,0,3,0
93666,6,1,328017,328017,328018,0,1,3
93667,1,2,328018,328018,328020,0,2,0
93668,2,2,328020,328020,328022,0,2,0
93669,5,2,328025,328025,328027,0,2,3
93670,2,1,328027,328027,328028,0,1,0
93671,6,1,328033,328033,328034,0,1,5
93672,5,2,328038,328038,328040,0,2,4
93673,2,3,328040,328040,328043,0,3,0
93674,5,3,328045,328045,328048,0,3,2
93675,4,2,328049,328049,328051,0,2,1
93676,6,2,328055,328055,328057,0,2,4
93677,5,2,328060,328060,328062,0,2,3
93678,1,1,328061,328062,328063,1,2,0
93679,4,2,328065,328065,328067,0,2,2
93680,2,1,328067,328067,328068,0,1,0
93681,4,2,328071,328071,328073,0,2,3
93682,4,2,328075,328075,328077,0,2,2
93683,2,2,328077,328077,328079,0,2,0
93684,4,3,328081,328081,328084,0,3,2
93685,3,3,328084,328084,328087,0,3,0
93686,6,1,328090,328090,328091,0,1,3
93687,5,1,328095,328095,328096,0,1,4
93688,3,3,328098,328098,328101,0,3,2
93689,2,2,328100,328101,328103,1,3,0
93690,1,1,328101,328103,328104,2,3,0
93691,4,1,328105,328105,328106,0,1,1
93692,3,1,328108,328108,328109,0,1,2
93693,6,1,328114,328114,328115,0,1,5
93694,5,3,328119,328119,328122,0,3,4
93695,3,3,328122,328122,328125,0,3,0
93696,6,2,328128,328128,328130,0,2,3
93697,2,1,328130,328130,328131,0,1,0
93698,4,3,328134,328134,328137,0,3,3
93699,5,3,328139,328139,328142,0,3,2
93700,6,2,328145,328145,328147,0,2,3
93701,6,1,328151,328151,328152,0,1,4
93702,6,1,328157,328157,328158,0,1,5
93703,2,1,328159,328159,328160,0,1,1
93704,2,2,328161,328161,328163,0,2,1
93705,1,2,328162,328163,328165,1,3,0
93706,6,2,328168,328168,328170,0,2,3
93707,1,2,328169,328170,328172,1,3,0
93708,2,3,328171,328172,328175,1,4,0
93709,1,1,328172,328175,328176,3,4,0
93710,6,2,328178,328178,328180,0,2,2
93711,3,2,328181,328181,328183,0,2,1
93712,6,2,328187,328187,328189,0,2,4
93713,1,1,328188,328189,328190,1,2,0
93714,4,3,328192,328192,328195,0,3,2
93715,3,1,328195,328195,328196,0,1,0
93716,3,3,328198,328198,328201,0,3,2
93717,5,3,328203,328203,328206,0,3,2
93718,6,3,328209,328209,328212,0,3,3
93719,6,2,328215,328215,328217,0,2,3
93720,1,1,328216,328217,328218,1,2,0
93721,6,3,328222,328222,328225,0,3,4
93722,2,2,328224,328225,328227,1,3,0
93723,3,3,328227,328227,328230,0,3,0
93724,6,1,328233,328233,328234,0,1,3
93725,4,1,328237,328237,328238,0,1,3
93726,3,2,328240,328240,328242,0,2,2
93727,3,1,328243,328243,328244,0,1,1
93728,4,2,328247,328247,328249,0,2,3
93729,2,3,328249,328249,328252,0,3,0
93730,4,2,328253,328253,328255,0,2,1
93731,1,2,328254,328255,328257,1,3,0
93732,2,1,328256,328257,328258,1,2,0
93733,2,1,328258,328258,328259,0,1,0
93734,5,3,328263,328263,328266,0,3,4
93735,3,1,328266,328266,328267,0,1,0
93736,6,1,328272,328272,328273,0,1,5
93737,2,3,328274,328274,328277,0,3,1
93738,2,1,328276,328277,328278,1,2,0
93739,1,3,328277,328278,328281,1,4,0
93740,5,1,328282,328282,328283,0,1,1
93741,5,2,328287,328287,328289,0,2,4
93742,1,1,328288,328289,328290,1,2,0
93743,1,1,328289,328290,328291,1,2,0
93744,6,2,328295,328295,328297,0,2,4
93745,3,2,328298,328298,328300,0,2,1
93746,3,1,328301,328301,328302,0,1,1
93747,6,2,328307,328307,328309,0,2,5
93748,1,3,328308,328309,328312,1,4,0
93749,5,2,328313,328313,328315,0,2,1
93750,5,1,328318,328318,328319,0,1,3
93751,2,3,328320,328320,328323,0,3,1
93752,6,3,328326,328326,328329,0,3,3
93753,1,3,328327,328329,328332,2,5,0
93754,3,3,328330,328332,328335,2,5,0
93755,5,2,328335,328335,328337,0,2,0
93756,1,2,328336,328337,328339,1,3,0
93757,5,1,328341,328341,328342,0,1,2
93758,2,1,328343,328343,328344,0,1,1
93759,6,3,328349,328349,328352,0,3,5
93760,2,2,328351,328352,328354,1,3,0
93761,5,3,328356,328356,328359,0,3,2
93762,4,2,328360,328360,328362,0,2,1
93763,6,2,328366,328366,328368,0,2,4
93764,2,3,328368,328368,328371,0,3,0
93765,4,2,328372,328372,328374,0,2,1
93766,2,2,328374,328374,328376,0,2,0
93767,2,3,328376,328376,328379,0,3,0
93768,5,2,328381,328381,328383,0,2,2
93769,3,3,328384,328384,328387,0,3,1
93770,3,1,328387,328387,328388,0,1,0
93771,1,1,328388,328388,328389,0,1,0
93772,6,3,328394,328394,328397,0,3,5
93773,1,3,328395,328397,328400,2,5,0
93774,3,2,328398,328400,328402,2,4,0
93775,3,1,328401,328402,328403,1,2,0
93776,3,3,328404,328404,328407,0,3,1
93777,1,1,328405,328407,328408,2,3,0
93778,1,1,328406,328408,328409,2,3,0
93779,5,1,328411,328411,328412,0,1,2
93780,3,1,328414,328414,328415,0,1,2
93781,4,3,328418,328418,328421,0,3,3
93782,4,2,328422,328422,328424,0,2,1
93783,2,3,328424,328424,328427,0,3,0
93784,6,2,328430,328430,328432,0,2,3
93785,1,2,328431,328432,328434,1,3,0
93786,2,1,328433,328434,328435,1,2,0
93787,5,2,328438,328438,328440,0,2,3
93788,1,2,328439,328440,328442,1,3,0
93789,1,2,328440,328442,328444,2,4,0
93790,3,1,328443,328444,328445,1,2,0
93791,5,2,328448,328448,328450,0,2,3
93792,5,3,328453,328453,328456,0,3,3
93793,3,2,328456,328456,328458,0,2,0
93794,5,1,328461,328461,328462,0,1,3
93795,4,1,328465,328465,328466,0,1,3
93796,6,3,328471,328471,328474,0,3,5
93797,3,2,328474,328474,328476,0,2,0
93798,4,1,328478,328478,328479,0,1,2
93799,6,2,328484,328484,328486,0,2,5
93800,1,2,328485,328486,328488,1,3,0
93801,2,2,328487,328488,328490,1,3,0
93802,1,2,328488,328490,328492,2,4,0
93803,3,1,328491,328492,328493,1,2,0
93804,1,1,328492,328493,328494,1,2,0
93805,3,3,328495,328495,328498,0,3,1
93806,2,1,328497,328498,328499,1,2,0
93807,4,2,328501,328501,328503,0,2,2
93808,4,3,328505,328505,328508,0,3,2
93809,6,3,328511,328511,328514,0,3,3
93810,5,1,328516,328516,328517,0,1,2
93811,5,1,328521,328521,328522,0,1,4
93812,5,2,328526,328526,328528,0,2,4
93813,2,3,328528,328528,328531,0,3,0
93814,4,3,328532,328532,328535,0,3,1
93815,3,3,328535,328535,328538,0,3,0
93816,2,3,328537,328538,328541,1,4,0
93817,2,2,328539,328541,328543,2,4,0
93818,4,1,328543,328543,328544,0,1,0
93819,5,1,328548,328548,328549,0,1,4
93820,6,3,328554,328554,328557,0,3,5
93821,6,3,328560,328560,328563,0,3,3
93822,5,2,328565,328565,328567,0,2,2
93823,5,1,328570,328570,328571,0,1,3
93824,6,1,328576,328576,328577,0,1,5
93825,5,2,328581,328581,328583,0,2,4
93826,6,2,328587,328587,328589,0,2,4
93827,2,2,328589,328589,328591,0,2,0
93828,1,3,328590,328591,328594,1,4,0
93829,3,2,328593,328594,328596,1,3,0
93830,2,3,328595,328596,328599,1,4,0
93831,6,3,328601,328601,328604,0,3,2
93832,2,1,328603,328604,328605,1,2,0
93833,1,1,328604,328605,328606,1,2,0
93834,6,1,328610,328610,328611,0,1,4
93835,6,2,328616,328616,328618,0,2,5
93836,1,3,328617,328618,328621,1,4,0
93837,4,3,328621,328621,328624,0,3,0
93838,5,2,328626,328626,328628,0,2,2
93839,5,3,328631,328631,328634,0,3,3
93840,6,3,328637,328637,328640,0,3,3
93841,2,3,328639,328640,328643,1,4,0
93842,3,2,328642,328643,328645,1,3,0
93843,3,3,328645,328645,328648,0,3,0
93844,1,1,328646,328648,328649,2,3,0
93845,2,2,328648,328649,328651,1,3,0
93846,6,2,328654,328654,328656,0,2,3
93847,2,3,328656,328656,328659,0,3,0
93848,6,3,328662,328662,328665,0,3,3
93849,5,3,328667,328667,328670,0,3,2
93850,2,3,328669,328670,328673,1,4,0
93851,5,2,328674,328674,328676,0,2,1
93852,2,2,328676,328676,328678,0,2,0
93853,6,2,328682,328682,328684,0,2,4
93854,3,2,328685,328685,328687,0,2,1
93855,4,3,328689,328689,328692,0,3,2
93856,5,1,328694,328694,328695,0,1,2
93857,6,2,328700,328700,328702,0,2,5
93858,5,2,328705,328705,328707,0,2,3
93859,4,2,328709,328709,328711,0,2,2
93860,3,1,328712,328712,328713,0,1,1
93861,6,3,328718,328718,328721,0,3,5
93862,2,3,328720,328721,328724,1,4,0
93863,2,3,328722,328724,328727,2,5,0
93864,1,1,328723,328727,328728,4,5,0
93865,2,2,328725,328728,328730,3,5,0
93866,3,1,328728,328730,328731,2,3,0
93867,2,1,328730,328731,328732,1,2,0
93868,5,2,328735,328735,328737,0,2,3
93869,3,2,328738,328738,328740,0,2,1
93870,2,1,328740,328740,328741,0,1,0
93871,6,2,328746,328746,328748,0,2,5
93872,4,3,328750,328750,328753,0,3,2
93873,2,1,328752,328753,328754,1,2,0
93874,6,1,328758,328758,328759,0,1,4
93875,4,1,328762,328762,328763,0,1,3
93876,4,3,328766,328766,328769,0,3,3
93877,2,3,328768,328769,328772,1,4,0
93878,1,3,328769,328772,328775,3,6,0
93879,5,2,328774,328775,328777,1,3,0
93880,3,1,328777,328777,328778,0,1,0
93881,6,3,328783,328783,328786,0,3,5
93882,6,3,328789,328789,328792,0,3,3
93883,2,3,328791,328792,328795,1,4,0
93884,5,2,328796,328796,328798,0,2,1
93885,3,3,328799,328799,328802,0,3,1
93886,5,1,328804,328804,328805,0,1,2
93887,2,2,328806,328806,328808,0,2,1
93888,1,3,328807,328808,328811,1,4,0
93889,3,1,328810,328811,328812,1,2,0
93890,3,1,328813,328813,328814,0,1,1
93891,6,3,328819,328819,328822,0,3,5
93892,5,2,328824,328824,328826,0,2,2
93893,2,2,328826,328826,328828,0,2,0
93894,6,3,328832,328832,328835,0,3,4
93895,4,1,328836,328836,328837,0,1,1
93896,6,1,328842,328842,328843,0,1,5
93897,6,1,328848,328848,328849,0,1,5
93898,2,3,328850,328850,328853,0,3,1
93899,4,2,328854,328854,328856,0,2,1
93900,3,3,328857,328857,328860,0,3,1
93901,6,3,328863,328863,328866,0,3,3
93902,2,2,328865,328866,328868,1,3,0
93903,2,3,328867,328868,328871,1,4,0
93904,4,2,328871,328871,328873,0,2,0
93905,3,2,328874,328874,328876,0,2,1
93906,3,1,328877,328877,328878,0,1,1
93907,6,2,328883,328883,328885,0,2,5
93908,2,3,328885,328885,328888,0,3,0
93909,6,1,328891,328891,328892,0,1,3
93910,4,3,328895,328895,328898,0,3,3
93911,6,2,328901,328901,328903,0,2,3
93912,4,1,328905,328905,328906,0,1,2
93913,2,3,328907,328907,328910,0,3,1
93914,3,2,328910,328910,328912,0,2,0
93915,5,1,328915,328915,328916,0,1,3
93916,5,3,328920,328920,328923,0,3,4
93917,2,3,328922,328923,328926,1,4,0
93918,4,2,328926,328926,328928,0,2,0
93919,5,2,328931,328931,328933,0,2,3
93920,6,2,328937,328937,328939,0,2,4
93921,6,3,328943,328943,328946,0,3,4
93922,4,3,328947,328947,328950,0,3,1
93923,4,3,328951,328951,328954,0,3,1
93924,6,1,328957,328957,328958,0,1,3
93925,5,3,328962,328962,328965,0,3,4
93926,4,1,328966,328966,328967,0,1,1
93927,2,2,328968,328968,328970,0,2,1
93928,2,3,328970,328970,328973,0,3,0
93929,1,1,328971,328973,328974,2,3,0
93930,5,3,328976,328976,328979,0,3,2
93931,3,2,328979,328979,328981,0,2,0
93932,4,1,328983,328983,328984,0,1,2
93933,2,2,328985,328985,328987,0,2,1
93934,1,1,328986,328987,328988,1,2,0
93935,6,3,328992,328992,328995,0,3,4
93936,1,3,328993,328995,328998,2,5,0
93937,3,3,328996,328998,329001,2,5,0
93938,6,2,329002,329002,329004,0,2,1
93939,4,1,329006,329006,329007,0,1,2
93940,4,2,329010,329010,329012,0,2,3
93941,3,1,329013,329013,329014,0,1,1
93942,1,3,329014,329014,329017,0,3,0
93943,5,3,329019,329019,329022,0,3,2
93944,4,1,329023,329023,329024,0,1,1
93945,4,2,329027,329027,329029,0,2,3
93946,1,2,329028,329029,329031,1,3,0
93947,4,2,329032,329032,329034,0,2,1
93948,3,2,329035,329035,329037,0,2,1
93949,1,3,329036,329037,329040,1,4,0
93950,4,1,329040,329040,329041,0,1,0
93951,2,3,329042,329042,329045,0,3,1
93952,2,1,329044,329045,329046,1,2,0
93953,3,2,329047,329047,329049,0,2,1
93954,2,3,329049,329049,329052,0,3,0
93955,5,2,329054,329054,329056,0,2,2
93956,3,2,329057,329057,329059,0,2,1
93957,1,2,329058,329059,329061,1,3,0
93958,5,2,329063,329063,329065,0,2,2
93959,1,3,329064,329065,329068,1,4,0
93960,1,3,329065,329068,329071,3,6,0
93961,4,1,329069,329071,329072,2,3,0
93962,5,1,329074,329074,329075,0,1,2
93963,2,2,329076,329076,329078,0,2,1
93964,1,3,329077,329078,329081,1,4,0
93965,5,3,329082,329082,329085,0,3,1
93966,2,1,329084,329085,329086,1,2,0
93967,2,2,329086,329086,329088,0,2,0
93968,2,2,329088,329088,329090,0,2,0
93969,4,2,329092,329092,329094,0,2,2
93970,2,2,329094,329094,329096,0,2,0
93971,4,2,329098,329098,329100,0,2,2
93972,5,1,329103,329103,329104,0,1,3
93973,3,2,329106,329106,329108,0,2,2
93974,4,2,329110,329110,329112,0,2,2
93975,6,1,329116,329116,329117,0,1,4
93976,3,3,329119,329119,329122,0,3,2
93977,4,3,329123,329123,329126,0,3,1
93978,1,1,329124,329126,329127,2,3,0
93979,6,1,329130,329130,329131,0,1,3
93980,3,2,329133,329133,329135,0,2,2
93981,6,3,329139,329139,329142,0,3,4
93982,6,2,329145,329145,329147,0,2,3
93983,6,3,329151,329151,329154,0,3,4
93984,5,1,329156,329156,329157,0,1,2
93985,3,1,329159,329159,329160,0,1,2
93986,4,1,329163,329163,329164,0,1,3
93987,6,2,329169,329169,329171,0,2,5
93988,2,3,329171,329171,329174,0,3,0
93989,5,1,329176,329176,329177,0,1,2
93990,6,2,329182,329182,329184,0,2,5
93991,5,1,329187,329187,329188,0,1,3
93992,3,3,329190,329190,329193,0,3,2
93993,2,2,329192,329193,329195,1,3,0
93994,1,1,329193,329195,329196,2,3,0
93995,1,1,329194,329196,329197,2,3,0
93996,5,3,329199,329199,329202,0,3,2
93997,1,2,329200,329202,329204,2,4,0
93998,5,3,329205,329205,329208,0,3,1
93999,1,1,329206,329208,329209,2,3,0
94000,2,3,329208,329209,329212,1,4,0
94001,6,2,329214,329214,329216,0,2,2
94002,3,1,329217,329217,329218,0,1,1
94003,1,3,329218,329218,329221,0,3,0
94004,4,2,329222,329222,329224,0,2,1
94005,2,3,329224,329224,329227,0,3,0
94006,1,1,329225,329227,329228,2,3,0
94007,2,2,329227,329228,329230,1,3,0
94008,5,1,329232,329232,329233,0,1,2
94009,1,2,329233,329233,329235,0,2,0
94010,5,2,329238,329238,329240,0,2,3
94011,2,1,329240,329240,329241,0,1,0
94012,3,1,329243,329243,329244,0,1,2
94013,5,1,329248,329248,329249,0,1,4
94014,3,1,329251,329251,329252,0,1,2
94015,3,1,329254,329254,329255,0,1,2
94016,5,3,329259,329259,329262,0,3,4
94017,5,1,329264,329264,329265,0,1,2
94018,4,2,329268,329268,329270,0,2,3
94019,6,2,329274,329274,329276,0,2,4
94020,2,3,329276,329276,329279,0,3,0
94021,6,3,329282,329282,329285,0,3,3
94022,6,3,329288,329288,329291,0,3,3
94023,2,1,329290,329291,329292,1,2,0
94024,3,2,329293,329293,329295,0,2,1
94025,2,3,329295,329295,329298,0,3,0
94026,4,3,329299,329299,329302,0,3,1
94027,2,2,329301,329302,329304,1,3,0
94028,5,1,329306,329306,329307,0,1,2
94029,6,2,329312,329312,329314,0,2,5
94030,5,3,329317,329317,329320,0,3,3
94031,5,1,329322,329322,329323,0,1,2
94032,3,1,329325,329325,329326,0,1,2
94033,2,1,329327,329327,329328,0,1,1
94034,6,3,329333,329333,329336,0,3,5
94035,4,3,329337,329337,329340,0,3,1
94036,6,2,329343,329343,329345,0,2,3
94037,3,2,329346,329346,329348,0,2,1
94038,2,2,329348,329348,329350,0,2,0
94039,4,1,329352,329352,329353,0,1,2
94040,3,3,329355,329355,329358,0,3,2
94041,3,1,329358,329358,329359,0,1,0
94042,2,1,329360,329360,329361,0,1,1
94043,1,2,329361,329361,329363,0,2,0
94044,1,2,329362,329363,329365,1,3,0
94045,1,1,329363,329365,329366,2,3,0
94046,4,3,329367,329367,329370,0,3,1
94047,6,1,329373,329373,329374,0,1,3
94048,3,2,329376,329376,329378,0,2,2
94049,1,3,329377,329378,329381,1,4,0
94050,2,2,329379,329381,329383,2,4,0
94051,2,2,329381,329383,329385,2,4,0
94052,6,2,329387,329387,329389,0,2,2
94053,5,3,329392,329392,329395,0,3,3
94054,2,3,329394,329395,329398,1,4,0
94055,3,3,329397,329398,329401,1,4,0
94056,2,3,329399,329401,329404,2,5,0
94057,2,2,329401,329404,329406,3,5,0
94058,2,1,329403,329406,329407,3,4,0
94059,2,1,329405,329407,329408,2,3,0
94060,5,3,329410,329410,329413,0,3,2
94061,1,2,329411,329413,329415,2,4,0
94062,3,1,329414,329415,329416,1,2,0
94063,1,1,329415,329416,329417,1,2,0
94064,3,3,329418,329418,329421,0,3,1
94065,1,2,329419,329421,329423,2,4,0
94066,2,3,329421,329423,329426,2,5,0
94067,6,3,329427,329427,329430,0,3,1
94068,2,2,329429,329430,329432,1,3,0
94069,5,3,329434,329434,329437,0,3,2
94070,6,2,329440,329440,329442,0,2,3
94071,6,3,329446,329446,329449,0,3,4
94072,3,3,329449,329449,329452,0,3,0
94073,5,1,329454,329454,329455,0,1,2
94074,5,2,329459,329459,329461,0,2,4
94075,6,1,329465,329465,329466,0,1,4
94076,3,1,329468,329468,329469,0,1,2
94077,4,1,329472,329472,329473,0,1,3
94078,4,3,329476,329476,329479,0,3,3
94079,6,3,329482,329482,329485,0,3,3
94080,3,3,329485,329485,329488,0,3,0
94081,1,3,329486,329488,329491,2,5,0
94082,1,2,329487,329491,329493,4,6,0
94083,3,1,329490,329493,329494,3,4,0
94084,6,2,329496,329496,329498,0,2,2
94085,4,2,329500,329500,329502,0,2,2
94086,6,3,329506,329506,329509,0,3,4
94087,4,2,329510,329510,329512,0,2,1
94088,6,2,329516,329516,329518,0,2,4
94089,1,2,329517,329518,329520,1,3,0
94090,6,2,329523,329523,329525,0,2,3
94091,4,1,329527,329527,329528,0,1,2
94092,1,2,329528,329528,329530,0,2,0
94093,3,1,329531,329531,329532,0,1,1
94094,1,2,329532,329532,329534,0,2,0
94095,6,2,329538,329538,329540,0,2,4
94096,6,2,329544,329544,329546,0,2,4
94097,5,3,329549,329549,329552,0,3,3
94098,4,2,329553,329553,329555,0,2,1
94099,4,3,329557,329557,329560,0,3,2
94100,1,2,329558,329560,329562,2,4,0
94101,1,3,329559,329562,329565,3,6,0
94102,2,1,329561,329565,329566,4,5,0
94103,2,2,329563,329566,329568,3,5,0
94104,3,2,329566,329568,329570,2,4,0
94105,5,2,329571,329571,329573,0,2,1
94106,4,3,329575,329575,329578,0,3,2
94107,6,2,329581,329581,329583,0,2,3
94108,3,3,329584,329584,329587,0,3,1
94109,1,1,329585,329587,329588,2,3,0
94110,4,3,329589,329589,329592,0,3,1
94111,2,2,329591,329592,329594,1,3,0
94112,5,3,329596,329596,329599,0,3,2
94113,4,3,329600,329600,329603,0,3,1
94114,1,3,329601,329603,329606,2,5,0
94115,6,2,329607,329607,329609,0,2,1
94116,2,1,329609,329609,329610,0,1,0
94117,3,3,329612,329612,329615,0,3,2
94118,2,2,329614,329615,329617,1,3,0
94119,1,2,329615,329617,329619,2,4,0
94120,6,2,329621,329621,329623,0,2,2
94121,4,3,329625,329625,329628,0,3,2
94122,6,2,329631,329631,329633,0,2,3
94123,1,1,329632,329633,329634,1,2,0
94124,1,1,329633,329634,329635,1,2,0
94125,5,1,329638,329638,329639,0,1,3
94126,2,3,329640,329640,329643,0,3,1
94127,1,3,329641,329643,329646,2,5,0
94128,3,1,329644,329646,329647,2,3,0
94129,6,2,329650,329650,329652,0,2,3
94130,1,2,329651,329652,329654,1,3,0
94131,3,3,329654,329654,329657,0,3,0
94132,1,3,329655,329657,329660,2,5,0
94133,4,3,329659,329660,329663,1,4,0
94134,6,3,329665,329665,329668,0,3,2
94135,4,2,329669,329669,329671,0,2,1
94136,4,1,329673,329673,329674,0,1,2
94137,3,3,329676,329676,329679,0,3,2
94138,2,2,329678,329679,329681,1,3,0
94139,6,3,329684,329684,329687,0,3,3
94140,4,3,329688,329688,329691,0,3,1
94141,4,2,329692,329692,329694,0,2,1
94142,5,3,329697,329697,329700,0,3,3
94143,1,3,329698,329700,329703,2,5,0
94144,4,1,329702,329703,329704,1,2,0
94145,4,2,329706,329706,329708,0,2,2
94146,6,1,329712,329712,329713,0,1,4
94147,6,2,329718,329718,329720,0,2,5
94148,5,1,329723,329723,329724,0,1,3
94149,1,1,329724,329724,329725,0,1,0
94150,6,3,329730,329730,329733,0,3,5
94151,1,1,329731,329733,329734,2,3,0
94152,6,3,329737,329737,329740,0,3,3
94153,2,3,329739,329740,329743,1,4,0
94154,6,2,329745,329745,329747,0,2,2
94155,4,3,329749,329749,329752,0,3,2
94156,5,1,329754,329754,329755,0,1,2
94157,4,3,329758,329758,329761,0,3,3
94158,3,1,329761,329761,329762,0,1,0
94159,3,3,329764,329764,329767,0,3,2
94160,2,3,329766,329767,329770,1,4,0
94161,4,2,329770,329770,329772,0,2,0
94162,3,2,329773,329773,329775,0,2,1
94163,1,2,329774,329775,329777,1,3,0
94164,2,3,329776,329777,329780,1,4,0
94165,2,2,329778,329780,329782,2,4,0
94166,4,1,329782,329782,329783,0,1,0
94167,6,3,329788,329788,329791,0,3,5
94168,5,1,329793,329793,329794,0,1,2
94169,3,2,329796,329796,329798,0,2,2
94170,5,1,329801,329801,329802,0,1,3
94171,6,1,329807,329807,329808,0,1,5
94172,1,3,329808,329808,329811,0,3,0
94173,5,1,329813,329813,329814,0,1,2
94174,4,1,329817,329817,329818,0,1,3
94175,2,2,329819,329819,329821,0,2,1
94176,3,2,329822,329822,329824,0,2,1
94177,5,2,329827,329827,329829,0,2,3
94178,2,1,329829,329829,329830,0,1,0
94179,6,3,329835,329835,329838,0,3,5
94180,2,2,329837,329838,329840,1,3,0
94181,6,2,329843,329843,329845,0,2,3
94182,5,2,329848,329848,329850,0,2,3
94183,2,3,329850,329850,329853,0,3,0
94184,1,1,329851,329853,329854,2,3,0
94185,2,3,329853,329854,329857,1,4,0
94186,2,3,329855,329857,329860,2,5,0
94187,4,3,329859,329860,329863,1,4,0
94188,3,2,329862,329863,329865,1,3,0
94189,6,1,329868,329868,329869,0,1,3
94190,2,1,329870,329870,329871,0,1,1
94191,6,1,329876,329876,329877,0,1,5
94192,3,2,329879,329879,329881,0,2,2
94193,4,1,329883,329883,329884,0,1,2
94194,3,3,329886,329886,329889,0,3,2
94195,3,3,329889,329889,329892,0,3,0
94196,4,1,329893,329893,329894,0,1,1
94197,2,2,329895,329895,329897,0,2,1
94198,6,1,329901,329901,329902,0,1,4
94199,1,1,329902,329902,329903,0,1,0
94200,4,3,329906,329906,329909,0,3,3
94201,5,1,329911,329911,329912,0,1,2
94202,3,1,329914,329914,329915,0,1,2
94203,2,2,329916,329916,329918,0,2,1
94204,5,3,329921,329921,329924,0,3,3
94205,5,2,329926,329926,329928,0,2,2
94206,1,3,329927,329928,329931,1,4,0
94207,3,1,329930,329931,329932,1,2,0
94208,3,2,329933,329933,329935,0,2,1
94209,3,3,329936,329936,329939,0,3,1
94210,4,2,329940,329940,329942,0,2,1
94211,3,3,329943,329943,329946,0,3,1
94212,3,3,329946,329946,329949,0,3,0
94213,2,2,329948,329949,329951,1,3,0
94214,5,1,329953,329953,329954,0,1,2
94215,4,1,329957,329957,329958,0,1,3
94216,2,1,329959,329959,329960,0,1,1
94217,6,2,329965,329965,329967,0,2,5
94218,6,2,329971,329971,329973,0,2,4
94219,3,2,329974,329974,329976,0,2,1
94220,2,1,329976,329976,329977,0,1,0
94221,2,2,329978,329978,329980,0,2,1
94222,1,3,329979,329980,329983,1,4,0
94223,5,3,329984,329984,329987,0,3,1
94224,5,2,329989,329989,329991,0,2,2
94225,5,3,329994,329994,329997,0,3,3
94226,3,1,329997,329997,329998,0,1,0
94227,5,2,330002,330002,330004,0,2,4
94228,1,3,330003,330004,330007,1,4,0
94229,1,2,330004,330007,330009,3,5,0
94230,3,2,330007,330009,330011,2,4,0
94231,6,3,330013,330013,330016,0,3,2
94232,4,1,330017,330017,330018,0,1,1
94233,5,3,330022,330022,330025,0,3,4
94234,4,1,330026,330026,330027,0,1,1
94235,6,2,330032,330032,330034,0,2,5
94236,4,1,330036,330036,330037,0,1,2
94237,4,3,330040,330040,330043,0,3,3
94238,6,2,330046,330046,330048,0,2,3
94239,1,2,330047,330048,330050,1,3,0
94240,2,3,330049,330050,330053,1,4,0
94241,6,1,330055,330055,330056,0,1,2
94242,6,3,330061,330061,330064,0,3,5
94243,4,2,330065,330065,330067,0,2,1
94244,3,2,330068,330068,330070,0,2,1
94245,1,3,330069,330070,330073,1,4,0
94246,6,3,330075,330075,330078,0,3,2
94247,6,3,330081,330081,330084,0,3,3
94248,2,3,330083,330084,330087,1,4,0
94249,2,3,330085,330087,330090,2,5,0
94250,5,2,330090,330090,330092,0,2,0
94251,3,1,330093,330093,330094,0,1,1
94252,1,1,330094,330094,330095,0,1,0
94253,5,2,330099,330099,330101,0,2,4
94254,1,1,330100,330101,330102,1,2,0
94255,6,1,330106,330106,330107,0,1,4
94256,1,2,330107,330107,330109,0,2,0
94257,1,3,330108,330109,330112,1,4,0
94258,5,2,330113,330113,330115,0,2,1
94259,2,2,330115,330115,330117,0,2,0
94260,6,3,330121,330121,330124,0,3,4
94261,3,1,330124,330124,330125,0,1,0
94262,4,1,330128,330128,330129,0,1,3
94263,2,1,330130,330130,330131,0,1,1
94264,6,1,330136,330136,330137,0,1,5
94265,4,2,330140,330140,330142,0,2,3
94266,1,1,330141,330142,330143,1,2,0
94267,3,1,330144,330144,330145,0,1,1
94268,2,2,330146,330146,330148,0,2,1
94269,4,1,330150,330150,330151,0,1,2
94270,5,1,330155,330155,330156,0,1,4
94271,2,3,330157,330157,330160,0,3,1
94272,4,2,330161,330161,330163,0,2,1
94273,4,2,330165,330165,330167,0,2,2
94274,4,3,330169,330169,330172,0,3,2
94275,5,3,330174,330174,330177,0,3,2
94276,4,2,330178,330178,330180,0,2,1
94277,5,3,330183,330183,330186,0,3,3
94278,6,3,330189,330189,330192,0,3,3
94279,6,2,330195,330195,330197,0,2,3
94280,6,2,330201,330201,330203,0,2,4
94281,1,1,330202,330203,330204,1,2,0
94282,2,3,330204,330204,330207,0,3,0
94283,6,3,330210,330210,330213,0,3,3
94284,4,2,330214,330214,330216,0,2,1
94285,5,3,330219,330219,330222,0,3,3
94286,5,3,330224,330224,330227,0,3,2
94287,2,2,330226,330227,330229,1,3,0
94288,1,2,330227,330229,330231,2,4,0
94289,3,3,330230,330231,330234,1,4,0
94290,5,2,330235,330235,330237,0,2,1
94291,1,2,330236,330237,330239,1,3,0
94292,5,1,330241,330241,330242,0,1,2
94293,6,1,330247,330247,330248,0,1,5
94294,4,1,330251,330251,330252,0,1,3
94295,4,1,330255,330255,330256,0,1,3
94296,2,1,330257,330257,330258,0,1,1
94297,3,2,330260,330260,330262,0,2,2
94298,3,1,330263,330263,330264,0,1,1
94299,1,1,330264,330264,330265,0,1,0
94300,2,1,330266,330266,330267,0,1,1
94301,5,2,330271,330271,330273,0,2,4
94302,3,1,330274,330274,330275,0,1,1
94303,3,1,330277,330277,330278,0,1,2
94304,2,3,330279,330279,330282,0,3,1
94305,4,1,330283,330283,330284,0,1,1
94306,2,1,330285,330285,330286,0,1,1
94307,3,1,330288,330288,330289,0,1,2
94308,2,1,330290,330290,330291,0,1,1
94309,2,1,330292,330292,330293,0,1,1
94310,4,1,330296,330296,330297,0,1,3
94311,1,2,330297,330297,330299,0,2,0
94312,3,3,330300,330300,330303,0,3,1
94313,4,1,330304,330304,330305,0,1,1
94314,1,2,330305,330305,330307,0,2,0
94315,3,1,330308,330308,330309,0,1,1
94316,2,1,330310,330310,330311,0,1,1
94317,5,1,330315,330315,330316,0,1,4
94318,4,3,330319,330319,330322,0,3,3
94319,5,2,330324,330324,330326,0,2,2
94320,4,2,330328,330328,330330,0,2,2
94321,6,3,330334,330334,330337,0,3,4
94322,5,3,330339,330339,330342,0,3,2
94323,1,1,330340,330342,330343,2,3,0
94324,4,3,330344,330344,330347,0,3,1
94325,2,2,330346,330347,330349,1,3,0
94326,3,2,330349,330349,330351,0,2,0
94327,5,3,330354,330354,330357,0,3,3
94328,6,1,330360,330360,330361,0,1,3
94329,1,1,330361,330361,330362,0,1,0
94330,6,3,330367,330367,330370,0,3,5
94331,5,1,330372,330372,330373,0,1,2
94332,4,3,330376,330376,330379,0,3,3
94333,5,1,330381,330381,330382,0,1,2
94334,2,3,330383,330383,330386,0,3,1
94335,1,2,330384,330386,330388,2,4,0
94336,2,2,330386,330388,330390,2,4,0
94337,5,2,330391,330391,330393,0,2,1
94338,6,3,330397,330397,330400,0,3,4
94339,4,3,330401,330401,330404,0,3,1
94340,5,1,330406,330406,330407,0,1,2
94341,5,2,330411,330411,330413,0,2,4
94342,4,3,330415,330415,330418,0,3,2
94343,6,3,330421,330421,330424,0,3,3
94344,6,2,330427,330427,330429,0,2,3
94345,6,3,330433,330433,330436,0,3,4
94346,6,2,330439,330439,330441,0,2,3
94347,3,1,330442,330442,330443,0,1,1
94348,3,1,330445,330445,330446,0,1,2
94349,2,2,330447,330447,330449,0,2,1
94350,2,1,330449,330449,330450,0,1,0
94351,3,3,330452,330452,330455,0,3,2
94352,2,3,330454,330455,330458,1,4,0
94353,5,2,330459,330459,330461,0,2,1
94354,4,1,330463,330463,330464,0,1,2
94355,4,1,330467,330467,330468,0,1,3
94356,1,2,330468,330468,330470,0,2,0
94357,4,3,330472,330472,330475,0,3,2
94358,6,2,330478,330478,330480,0,2,3
94359,1,2,330479,330480,330482,1,3,0
94360,5,2,330484,330484,330486,0,2,2
94361,6,1,330490,330490,330491,0,1,4
94362,4,2,330494,330494,330496,0,2,3
94363,5,3,330499,330499,330502,0,3,3
94364,6,1,330505,330505,330506,0,1,3
94365,6,2,330511,330511,330513,0,2,5
94366,4,1,330515,330515,330516,0,1,2
94367,1,3,330516,330516,330519,0,3,0
94368,3,3,330519,330519,330522,0,3,0
94369,1,3,330520,330522,330525,2,5,0
94370,3,3,330523,330525,330528,2,5,0
94371,3,1,330526,330528,330529,2,3,0
94372,1,1,330527,330529,330530,2,3,0
94373,3,1,330530,330530,330531,0,1,0
94374,2,1,330532,330532,330533,0,1,1
94375,2,3,330534,330534,330537,0,3,1
94376,1,1,330535,330537,330538,2,3,0
94377,4,2,330539,330539,330541,0,2,1
94378,2,3,330541,330541,330544,0,3,0
94379,3,3,330544,330544,330547,0,3,0
94380,2,2,330546,330547,330549,1,3,0
94381,4,3,330550,330550,330553,0,3,1
94382,6,1,330556,330556,330557,0,1,3
94383,2,3,330558,330558,330561,0,3,1
94384,5,1,330563,330563,330564,0,1,2
94385,4,2,330567,330567,330569,0,2,3
94386,4,3,330571,330571,330574,0,3,2
94387,3,2,330574,330574,330576,0,2,0
94388,3,3,330577,330577,330580,0,3,1
94389,3,1,330580,330580,330581,0,1,0
94390,6,3,330586,330586,330589,0,3,5
94391,3,2,330589,330589,330591,0,2,0
94392,1,2,330590,330591,330593,1,3,0
94393,4,2,330594,330594,330596,0,2,1
94394,4,1,330598,330598,330599,0,1,2
94395,4,3,330602,330602,330605,0,3,3
94396,6,2,330608,330608,330610,0,2,3
94397,4,2,330612,330612,330614,0,2,2
94398,6,1,330618,330618,330619,0,1,4
94399,6,2,330624,330624,330626,0,2,5
94400,3,2,330627,330627,330629,0,2,1
94401,6,2,330633,330633,330635,0,2,4
94402,5,1,330638,330638,330639,0,1,3
94403,4,3,330642,330642,330645,0,3,3
94404,2,1,330644,330645,330646,1,2,0
94405,1,2,330645,330646,330648,1,3,0
94406,1,2,330646,330648,330650,2,4,0
94407,2,2,330648,330650,330652,2,4,0
94408,2,3,330650,330652,330655,2,5,0
94409,1,3,330651,330655,330658,4,7,0
94410,3,1,330654,330658,330659,4,5,0
94411,2,1,330656,330659,330660,3,4,0
94412,2,1,330658,330660,330661,2,3,0
94413,2,2,330660,330661,330663,1,3,0
94414,6,1,330666,330666,330667,0,1,3
94415,4,2,330670,330670,330672,0,2,3
94416,4,2,330674,330674,330676,0,2,2
94417,6,3,330680,330680,330683,0,3,4
94418,1,3,330681,330683,330686,2,5,0
94419,1,2,330682,330686,330688,4,6,0
94420,2,3,330684,330688,330691,4,7,0
94421,2,3,330686,330691,330694,5,8,0
94422,5,2,330691,330694,330696,3,5,0
94423,3,2,330694,330696,330698,2,4,0
94424,6,1,330700,330700,330701,0,1,2
94425,6,2,330706,330706,330708,0,2,5
94426,1,2,330707,330708,330710,1,3,0
94427,1,1,330708,330710,330711,2,3,0
94428,2,1,330710,330711,330712,1,2,0
94429,2,3,330712,330712,330715,0,3,0
94430,5,2,330717,330717,330719,0,2,2
94431,2,2,330719,330719,330721,0,2,0
94432,2,3,330721,330721,330724,0,3,0
94433,2,3,330723,330724,330727,1,4,0
94434,3,2,330726,330727,330729,1,3,0
94435,3,1,330729,330729,330730,0,1,0
94436,6,3,330735,330735,330738,0,3,5
94437,6,2,330741,330741,330743,0,2,3
94438,3,3,330744,330744,330747,0,3,1
94439,6,1,330750,330750,330751,0,1,3
94440,6,2,330756,330756,330758,0,2,5
94441,2,2,330758,330758,330760,0,2,0
94442,1,1,330759,330760,330761,1,2,0
94443,5,3,330764,330764,330767,0,3,3
94444,2,1,330766,330767,330768,1,2,0
94445,1,3,330767,330768,330771,1,4,0
94446,3,1,330770,330771,330772,1,2,0
94447,5,2,330775,330775,330777,0,2,3
94448,3,1,330778,330778,330779,0,1,1
94449,3,1,330781,330781,330782,0,1,2
94450,4,2,330785,330785,330787,0,2,3
94451,5,1,330790,330790,330791,0,1,3
94452,2,1,330792,330792,330793,0,1,1
94453,6,1,330798,330798,330799,0,1,5
94454,5,1,330803,330803,330804,0,1,4
94455,6,2,330809,330809,330811,0,2,5
94456,1,2,330810,330811,330813,1,3,0
94457,3,1,330813,330813,330814,0,1,0
94458,5,1,330818,330818,330819,0,1,4
94459,3,3,330821,330821,330824,0,3,2
94460,4,3,330825,330825,330828,0,3,1
94461,5,2,330830,330830,330832,0,2,2
94462,5,3,330835,330835,330838,0,3,3
94463,6,1,330841,330841,330842,0,1,3
94464,5,1,330846,330846,330847,0,1,4
94465,1,1,330847,330847,330848,0,1,0
94466,3,2,330850,330850,330852,0,2,2
94467,5,2,330855,330855,330857,0,2,3
94468,6,1,330861,330861,330862,0,1,4
94469,4,2,330865,330865,330867,0,2,3
94470,4,2,330869,330869,330871,0,2,2
94471,5,2,330874,330874,330876,0,2,3
94472,1,3,330875,330876,330879,1,4,0
94473,5,2,330880,330880,330882,0,2,1
94474,2,1,330882,330882,330883,0,1,0
94475,3,1,330885,330885,330886,0,1,2
94476,3,2,330888,330888,330890,0,2,2
94477,1,1,330889,330890,330891,1,2,0
94478,6,3,330895,330895,330898,0,3,4
94479,4,3,330899,330899,330902,0,3,1
94480,4,1,330903,330903,330904,0,1,1
94481,5,1,330908,330908,330909,0,1,4
94482,5,3,330913,330913,330916,0,3,4
94483,1,1,330914,330916,330917,2,3,0
94484,5,2,330919,330919,330921,0,2,2
94485,5,3,330924,330924,330927,0,3,3
94486,5,1,330929,330929,330930,0,1,2
94487,1,1,330930,330930,330931,0,1,0
94488,4,2,330934,330934,330936,0,2,3
94489,3,3,330937,330937,330940,0,3,1
94490,1,3,330938,330940,330943,2,5,0
94491,3,2,330941,330943,330945,2,4,0
94492,3,2,330944,330945,330947,1,3,0
94493,2,1,330946,330947,330948,1,2,0
94494,4,3,330950,330950,330953,0,3,2
94495,2,1,330952,330953,330954,1,2,0
94496,3,1,330955,330955,330956,0,1,1
94497,2,2,330957,330957,330959,0,2,1
94498,4,1,330961,330961,330962,0,1,2
94499,1,2,330962,330962,330964,0,2,0
94500,2,1,330964,330964,330965,0,1,0
94501,2,1,330966,330966,330967,0,1,1
94502,3,1,330969,330969,330970,0,1,2
94503,4,3,330973,330973,330976,0,3,3
94504,3,3,330976,330976,330979,0,3,0
94505,1,3,330977,330979,330982,2,5,0
94506,5,2,330982,330982,330984,0,2,0
94507,1,1,330983,330984,330985,1,2,0
94508,2,1,330985,330985,330986,0,1,0
94509,6,3,330991,330991,330994,0,3,5
94510,5,2,330996,330996,330998,0,2,2
94511,1,3,330997,330998,331001,1,4,0
94512,3,3,331000,331001,331004,1,4,0
94513,3,3,331003,331004,331007,1,4,0
94514,3,2,331006,331007,331009,1,3,0
94515,3,1,331009,331009,331010,0,1,0
94516,2,3,331011,331011,331014,0,3,1
94517,6,1,331017,331017,331018,0,1,3
94518,1,1,331018,331018,331019,0,1,0
94519,4,3,331022,331022,331025,0,3,3
94520,5,1,331027,331027,331028,0,1,2
94521,6,3,331033,331033,331036,0,3,5
94522,5,1,331038,331038,331039,0,1,2
94523,6,1,331044,331044,331045,0,1,5
94524,4,1,331048,331048,331049,0,1,3
94525,1,1,331049,331049,331050,0,1,0
94526,2,3,331051,331051,331054,0,3,1
94527,1,1,331052,331054,331055,2,3,0
94528,5,3,331057,331057,331060,0,3,2
94529,5,3,331062,331062,331065,0,3,2
94530,6,2,331068,331068,331070,0,2,3
94531,6,3,331074,331074,331077,0,3,4
94532,2,3,331076,331077,331080,1,4,0
94533,3,1,331079,331080,331081,1,2,0
94534,1,1,331080,331081,331082,1,2,0
94535,4,2,331084,331084,331086,0,2,2
94536,5,1,331089,331089,331090,0,1,3
94537,4,1,331093,331093,331094,0,1,3
94538,4,3,331097,331097,331100,0,3,3
94539,5,2,331102,331102,331104,0,2,2
94540,6,1,331108,331108,331109,0,1,4
94541,1,2,331109,331109,331111,0,2,0
94542,4,3,331113,331113,331116,0,3,2
94543,5,2,331118,331118,331120,0,2,2
94544,2,3,331120,331120,331123,0,3,0
94545,2,2,331122,331123,331125,1,3,0
94546,6,1,331128,331128,331129,0,1,3
94547,4,3,331132,331132,331135,0,3,3
94548,3,1,331135,331135,331136,0,1,0
94549,5,3,331140,331140,331143,0,3,4
94550,6,2,331146,331146,331148,0,2,3
94551,5,2,331151,331151,331153,0,2,3
94552,2,1,331153,331153,331154,0,1,0
94553,5,1,331158,331158,331159,0,1,4
94554,1,1,331159,331159,331160,0,1,0
94555,5,3,331164,331164,331167,0,3,4
94556,3,2,331167,331167,331169,0,2,0
94557,1,2,331168,331169,331171,1,3,0
94558,6,1,331174,331174,331175,0,1,3
94559,2,1,331176,331176,331177,0,1,1
94560,4,1,331180,331180,331181,0,1,3
94561,5,3,331185,331185,331188,0,3,4
94562,6,3,331191,331191,331194,0,3,3
94563,2,1,331193,331194,331195,1,2,0
94564,3,3,331196,331196,331199,0,3,1
94565,4,1,331200,331200,331201,0,1,1
94566,3,1,331203,331203,331204,0,1,2
94567,1,2,331204,331204,331206,0,2,0
94568,2,1,331206,331206,331207,0,1,0
94569,4,3,331210,331210,331213,0,3,3
94570,6,3,331216,331216,331219,0,3,3
94571,5,2,331221,331221,331223,0,2,2
94572,3,3,331224,331224,331227,0,3,1
94573,4,1,331228,331228,331229,0,1,1
94574,4,2,331232,331232,331234,0,2,3
94575,6,1,331238,331238,331239,0,1,4
94576,1,1,331239,331239,331240,0,1,0
94577,1,3,331240,331240,331243,0,3,0
94578,1,2,331241,331243,331245,2,4,0
94579,1,1,331242,331245,331246,3,4,0
94580,3,3,331245,331246,331249,1,4,0
94581,2,3,331247,331249,331252,2,5,0
94582,6,1,331253,331253,331254,0,1,1
94583,5,1,331258,331258,331259,0,1,4
94584,5,2,331263,331263,331265,0,2,4
94585,4,2,331267,331267,331269,0,2,2
94586,4,1,331271,331271,331272,0,1,2
94587,6,1,331277,331277,331278,0,1,5
94588,1,3,331278,331278,331281,0,3,0
94589,3,2,331281,331281,331283,0,2,0
94590,6,1,331287,331287,331288,0,1,4
94591,1,3,331288,331288,331291,0,3,0
94592,3,2,331291,331291,331293,0,2,0
94593,3,2,331294,331294,331296,0,2,1
94594,4,2,331298,331298,331300,0,2,2
94595,3,2,331301,331301,331303,0,2,1
94596,6,1,331307,331307,331308,0,1,4
94597,5,2,331312,331312,331314,0,2,4
94598,2,2,331314,331314,331316,0,2,0
94599,6,2,331320,331320,331322,0,2,4
94600,1,2,331321,331322,331324,1,3,0
94601,4,1,331325,331325,331326,0,1,1
94602,6,1,331331,331331,331332,0,1,5
94603,6,3,331337,331337,331340,0,3,5
94604,6,2,331343,331343,331345,0,2,3
94605,1,1,331344,331345,331346,1,2,0
94606,4,3,331348,331348,331351,0,3,2
94607,2,3,331350,331351,331354,1,4,0
94608,6,2,331356,331356,331358,0,2,2
94609,3,2,331359,331359,331361,0,2,1
94610,3,2,331362,331362,331364,0,2,1
94611,1,1,331363,331364,331365,1,2,0
94612,2,2,331365,331365,331367,0,2,0
94613,1,2,331366,331367,331369,1,3,0
94614,5,3,331371,331371,331374,0,3,2
94615,6,2,331377,331377,331379,0,2,3
94616,5,3,331382,331382,331385,0,3,3
94617,2,2,331384,331385,331387,1,3,0
94618,4,1,331388,331388,331389,0,1,1
94619,6,3,331394,331394,331397,0,3,5
94620,3,2,331397,331397,331399,0,2,0
94621,1,3,331398,331399,331402,1,4,0
94622,6,3,331404,331404,331407,0,3,2
94623,1,3,331405,331407,331410,2,5,0
94624,6,3,331411,331411,331414,0,3,1
94625,6,1,331417,331417,331418,0,1,3
94626,6,1,331423,331423,331424,0,1,5
94627,2,3,331425,331425,331428,0,3,1
94628,3,1,331428,331428,331429,0,1,0
94629,2,3,331430,331430,331433,0,3,1
94630,6,3,331436,331436,331439,0,3,3
94631,1,1,331437,331439,331440,2,3,0
94632,6,1,331443,331443,331444,0,1,3
94633,5,3,331448,331448,331451,0,3,4
94634,6,2,331454,331454,331456,0,2,3
94635,3,3,331457,331457,331460,0,3,1
94636,5,3,331462,331462,331465,0,3,2
94637,5,3,331467,331467,331470,0,3,2
94638,6,3,331473,331473,331476,0,3,3
94639,1,2,331474,331476,331478,2,4,0
94640,5,1,331479,331479,331480,0,1,1
94641,3,1,331482,331482,331483,0,1,2
94642,2,2,331484,331484,331486,0,2,1
94643,4,2,331488,331488,331490,0,2,2
94644,4,1,331492,331492,331493,0,1,2
94645,5,3,331497,331497,331500,0,3,4
94646,1,2,331498,331500,331502,2,4,0
94647,6,2,331504,331504,331506,0,2,2
94648,1,2,331505,331506,331508,1,3,0
94649,4,2,331509,331509,331511,0,2,1
94650,4,3,331513,331513,331516,0,3,2
94651,4,2,331517,331517,331519,0,2,1
94652,3,3,331520,331520,331523,0,3,1
94653,1,1,331521,331523,331524,2,3,0
94654,3,2,331524,331524,331526,0,2,0
94655,1,1,331525,331526,331527,1,2,0
94656,2,1,331527,331527,331528,0,1,0
94657,2,2,331529,331529,331531,0,2,1
94658,3,3,331532,331532,331535,0,3,1
94659,2,1,331534,331535,331536,1,2,0
94660,4,3,331538,331538,331541,0,3,2
94661,4,2,331542,331542,331544,0,2,1
94662,3,3,331545,331545,331548,0,3,1
94663,3,3,331548,331548,331551,0,3,0
94664,3,1,331551,331551,331552,0,1,0
94665,1,1,331552,331552,331553,0,1,0
94666,5,1,331557,331557,331558,0,1,4
94667,6,2,331563,331563,331565,0,2,5
94668,6,3,331569,331569,331572,0,3,4
94669,3,2,331572,331572,331574,0,2,0
94670,6,3,331578,331578,331581,0,3,4
94671,5,2,331583,331583,331585,0,2,2
94672,5,3,331588,331588,331591,0,3,3
94673,5,2,331593,331593,331595,0,2,2
94674,3,1,331596,331596,331597,0,1,1
94675,6,2,331602,331602,331604,0,2,5
94676,6,2,331608,331608,331610,0,2,4
94677,6,2,331614,331614,331616,0,2,4
94678,6,2,331620,331620,331622,0,2,4
94679,5,2,331625,331625,331627,0,2,3
94680,5,1,331630,331630,331631,0,1,3
94681,1,3,331631,331631,331634,0,3,0
94682,6,2,331637,331637,331639,0,2,3
94683,3,2,331640,331640,331642,0,2,1
94684,2,1,331642,331642,331643,0,1,0
94685,2,3,331644,331644,331647,0,3,1
94686,2,3,331646,331647,331650,1,4,0
94687,6,3,331652,331652,331655,0,3,2
94688,2,3,331654,331655,331658,1,4,0
94689,4,2,331658,331658,331660,0,2,0
94690,1,3,331659,331660,331663,1,4,0
94691,2,2,331661,331663,331665,2,4,0
94692,4,2,331665,331665,331667,0,2,0
94693,3,2,331668,331668,331670,0,2,1
94694,6,3,331674,331674,331677,0,3,4
94695,3,3,331677,331677,331680,0,3,0
94696,2,3,331679,331680,331683,1,4,0
94697,3,3,331682,331683,331686,1,4,0
94698,4,2,331686,331686,331688,0,2,0
94699,5,3,331691,331691,331694,0,3,3
94700,6,2,331697,331697,331699,0,2,3
94701,1,1,331698,331699,331700,1,2,0
94702,3,1,331701,331701,331702,0,1,1
94703,4,1,331705,331705,331706,0,1,3
94704,3,2,331708,331708,331710,0,2,2
94705,5,2,331713,331713,331715,0,2,3
94706,2,3,331715,331715,331718,0,3,0
94707,4,3,331719,331719,331722,0,3,1
94708,6,3,331725,331725,331728,0,3,3
94709,4,2,331729,331729,331731,0,2,1
94710,1,2,331730,331731,331733,1,3,0
94711,1,3,331731,331733,331736,2,5,0
94712,3,3,331734,331736,331739,2,5,0
94713,6,2,331740,331740,331742,0,2,1
94714,4,2,331744,331744,331746,0,2,2
94715,5,1,331749,331749,331750,0,1,3
94716,2,1,331751,331751,331752,0,1,1
94717,2,2,331753,331753,331755,0,2,1
94718,3,1,331756,331756,331757,0,1,1
94719,1,2,331757,331757,331759,0,2,0
94720,2,3,331759,331759,331762,0,3,0
94721,6,3,331765,331765,331768,0,3,3
94722,2,3,331767,331768,331771,1,4,0
94723,5,2,331772,331772,331774,0,2,1
94724,5,3,331777,331777,331780,0,3,3
94725,5,1,331782,331782,331783,0,1,2
94726,3,1,331785,331785,331786,0,1,2
94727,1,2,331786,331786,331788,0,2,0
94728,6,1,331792,331792,331793,0,1,4
94729,3,3,331795,331795,331798,0,3,2
94730,3,1,331798,331798,331799,0,1,0
94731,2,2,331800,331800,331802,0,2,1
94732,6,2,331806,331806,331808,0,2,4
94733,1,3,331807,331808,331811,1,4,0
94734,4,2,331811,331811,331813,0,2,0
94735,3,1,331814,331814,331815,0,1,1
94736,5,2,331819,331819,331821,0,2,4
94737,6,3,331825,331825,331828,0,3,4
94738,3,2,331828,331828,331830,0,2,0
94739,6,3,331834,331834,331837,0,3,4
94740,2,3,331836,331837,331840,1,4,0
94741,4,3,331840,331840,331843,0,3,0
94742,3,2,331843,331843,331845,0,2,0
94743,1,1,331844,331845,331846,1,2,0
94744,1,3,331845,331846,331849,1,4,0
94745,3,3,331848,331849,331852,1,4,0
94746,5,3,331853,331853,331856,0,3,1
94747,4,2,331857,331857,331859,0,2,1
94748,5,2,331862,331862,331864,0,2,3
94749,1,2,331863,331864,331866,1,3,0
94750,6,3,331869,331869,331872,0,3,3
94751,3,2,331872,331872,331874,0,2,0
94752,1,2,331873,331874,331876,1,3,0
94753,4,1,331877,331877,331878,0,1,1
94754,4,3,331881,331881,331884,0,3,3
94755,1,3,331882,331884,331887,2,5,0
94756,4,3,331886,331887,331890,1,4,0
94757,2,2,331888,331890,331892,2,4,0
94758,1,2,331889,331892,331894,3,5,0
94759,6,1,331895,331895,331896,0,1,1
94760,4,3,331899,331899,331902,0,3,3
94761,5,3,331904,331904,331907,0,3,2
94762,6,2,331910,331910,331912,0,2,3
94763,6,1,331916,331916,331917,0,1,4
94764,4,1,331920,331920,331921,0,1,3
94765,2,2,331922,331922,331924,0,2,1
94766,6,2,331928,331928,331930,0,2,4
94767,6,1,331934,331934,331935,0,1,4
94768,1,2,331935,331935,331937,0,2,0
94769,3,3,331938,331938,331941,0,3,1
94770,6,2,331944,331944,331946,0,2,3
94771,4,3,331948,331948,331951,0,3,2
94772,3,1,331951,331951,331952,0,1,0
94773,6,2,331957,331957,331959,0,2,5
94774,4,3,331961,331961,331964,0,3,2
94775,4,2,331965,331965,331967,0,2,1
94776,1,3,331966,331967,331970,1,4,0
94777,1,1,331967,331970,331971,3,4,0
94778,3,1,331970,331971,331972,1,2,0
94779,5,2,331975,331975,331977,0,2,3
94780,2,3,331977,331977,331980,0,3,0
94781,4,3,331981,331981,331984,0,3,1
94782,2,3,331983,331984,331987,1,4,0
94783,1,1,331984,331987,331988,3,4,0
94784,5,1,331989,331989,331990,0,1,1
94785,3,1,331992,331992,331993,0,1,2
94786,6,1,331998,331998,331999,0,1,5
94787,1,2,331999,331999,332001,0,2,0
94788,6,3,332005,332005,332008,0,3,4
94789,1,1,332006,332008,332009,2,3,0
94790,4,3,332010,332010,332013,0,3,1
94791,5,1,332015,332015,332016,0,1,2
94792,2,2,332017,332017,332019,0,2,1
94793,2,3,332019,332019,332022,0,3,0
94794,2,2,332021,332022,332024,1,3,0
94795,6,2,332027,332027,332029,0,2,3
94796,2,2,332029,332029,332031,0,2,0
94797,1,3,332030,332031,332034,1,4,0
94798,6,1,332036,332036,332037,0,1,2
94799,4,1,332040,332040,332041,0,1,3
94800,1,3,332041,332041,332044,0,3,0
94801,3,3,332044,332044,332047,0,3,0
94802,1,2,332045,332047,332049,2,4,0
94803,4,1,332049,332049,332050,0,1,0
94804,3,3,332052,332052,332055,0,3,2
94805,6,2,332058,332058,332060,0,2,3
94806,4,2,332062,332062,332064,0,2,2
94807,2,1,332064,332064,332065,0,1,0
94808,4,1,332068,332068,332069,0,1,3
94809,1,2,332069,332069,332071,0,2,0
94810,5,2,332074,332074,332076,0,2,3
94811,1,1,332075,332076,332077,1,2,0
94812,5,3,332080,332080,332083,0,3,3
94813,2,1,332082,332083,332084,1,2,0
94814,6,2,332088,332088,332090,0,2,4
94815,6,1,332094,332094,332095,0,1,4
94816,6,1,332100,332100,332101,0,1,5
94817,2,1,332102,332102,332103,0,1,1
94818,1,3,332103,332103,332106,0,3,0
94819,3,1,332106,332106,332107,0,1,0
94820,6,2,332112,332112,332114,0,2,5
94821,4,2,332116,332116,332118,0,2,2
94822,3,1,332119,332119,332120,0,1,1
94823,5,3,332124,332124,332127,0,3,4
94824,6,3,332130,332130,332133,0,3,3
94825,3,1,332133,332133,332134,0,1,0
94826,4,3,332137,332137,332140,0,3,3
94827,2,2,332139,332140,332142,1,3,0
94828,6,2,332145,332145,332147,0,2,3
94829,6,1,332151,332151,332152,0,1,4
94830,6,2,332157,332157,332159,0,2,5
94831,2,2,332159,332159,332161,0,2,0
94832,4,3,332163,332163,332166,0,3,2
94833,2,2,332165,332166,332168,1,3,0
94834,2,3,332167,332168,332171,1,4,0
94835,5,3,332172,332172,332175,0,3,1
94836,5,2,332177,332177,332179,0,2,2
94837,6,2,332183,332183,332185,0,2,4
94838,2,3,332185,332185,332188,0,3,0
94839,3,1,332188,332188,332189,0,1,0
94840,5,2,332193,332193,332195,0,2,4
94841,5,2,332198,332198,332200,0,2,3
94842,6,1,332204,332204,332205,0,1,4
94843,1,2,332205,332205,332207,0,2,0
94844,2,2,332207,332207,332209,0,2,0
94845,2,3,332209,332209,332212,0,3,0
94846,2,2,332211,332212,332214,1,3,0
94847,1,1,332212,332214,332215,2,3,0
94848,3,2,332215,332215,332217,0,2,0
94849,2,2,332217,332217,332219,0,2,0
94850,6,1,332223,332223,332224,0,1,4
94851,6,3,332229,332229,332232,0,3,5
94852,4,2,332233,332233,332235,0,2,1
94853,2,2,332235,332235,332237,0,2,0
94854,5,2,332240,332240,332242,0,2,3
94855,2,1,332242,332242,332243,0,1,0
94856,1,2,332243,332243,332245,0,2,0
94857,2,2,332245,332245,332247,0,2,0
94858,3,1,332248,332248,332249,0,1,1
94859,3,3,332251,332251,332254,0,3,2
94860,2,1,332253,332254,332255,1,2,0
94861,2,3,332255,332255,332258,0,3,0
94862,1,3,332256,332258,332261,2,5,0
94863,4,2,332260,332261,332263,1,3,0
94864,2,2,332262,332263,332265,1,3,0
94865,3,3,332265,332265,332268,0,3,0
94866,5,2,332270,332270,332272,0,2,2
94867,3,2,332273,332273,332275,0,2,1
94868,4,3,332277,332277,332280,0,3,2
94869,2,3,332279,332280,332283,1,4,0
94870,6,1,332285,332285,332286,0,1,2
94871,6,2,332291,332291,332293,0,2,5
94872,2,2,332293,332293,332295,0,2,0
94873,5,1,332298,332298,332299,0,1,3
94874,2,1,332300,332300,332301,0,1,1
94875,5,3,332305,332305,332308,0,3,4
94876,2,1,332307,332308,332309,1,2,0
94877,1,1,332308,332309,332310,1,2,0
94878,4,1,332312,332312,332313,0,1,2
94879,5,3,332317,332317,332320,0,3,4
94880,1,1,332318,332320,332321,2,3,0
94881,3,1,332321,332321,332322,0,1,0
94882,2,3,332323,332323,332326,0,3,1
94883,1,2,332324,332326,332328,2,4,0
94884,2,2,332326,332328,332330,2,4,0
94885,6,1,332332,332332,332333,0,1,2
94886,3,1,332335,332335,332336,0,1,2
94887,3,3,332338,332338,332341,0,3,2
94888,5,3,332343,332343,332346,0,3,2
94889,4,1,332347,332347,332348,0,1,1
94890,6,3,332353,332353,332356,0,3,5
94891,1,1,332354,332356,332357,2,3,0
94892,6,1,332360,332360,332361,0,1,3
94893,4,2,332364,332364,332366,0,2,3
94894,4,3,332368,332368,332371,0,3,2
94895,4,1,332372,332372,332373,0,1,1
94896,6,3,332378,332378,332381,0,3,5
94897,5,3,332383,332383,332386,0,3,2
94898,2,1,332385,332386,332387,1,2,0
94899,1,3,332386,332387,332390,1,4,0
94900,2,3,332388,332390,332393,2,5,0
94901,2,3,332390,332393,332396,3,6,0
94902,4,2,332394,332396,332398,2,4,0
94903,5,3,332399,332399,332402,0,3,1
94904,4,1,332403,332403,332404,0,1,1
94905,1,1,332404,332404,332405,0,1,0
94906,1,2,332405,332405,332407,0,2,0
94907,2,2,332407,332407,332409,0,2,0
94908,6,1,332413,332413,332414,0,1,4
94909,2,3,332415,332415,332418,0,3,1
94910,3,3,332418,332418,332421,0,3,0
94911,1,1,332419,332421,332422,2,3,0
94912,6,2,332425,332425,332427,0,2,3
94913,6,3,332431,332431,332434,0,3,4
94914,1,1,332432,332434,332435,2,3,0
94915,6,1,332438,332438,332439,0,1,3
94916,6,3,332444,332444,332447,0,3,5
94917,5,1,332449,332449,332450,0,1,2
94918,5,3,332454,332454,332457,0,3,4
94919,4,3,332458,332458,332461,0,3,1
94920,5,2,332463,332463,332465,0,2,2
94921,1,1,332464,332465,332466,1,2,0
94922,2,2,332466,332466,332468,0,2,0
94923,3,1,332469,332469,332470,0,1,1
94924,2,3,332471,332471,332474,0,3,1
94925,5,3,332476,332476,332479,0,3,2
94926,4,3,332480,332480,332483,0,3,1
94927,5,2,332485,332485,332487,0,2,2
94928,4,1,332489,332489,332490,0,1,2
94929,1,1,332490,332490,332491,0,1,0
94930,3,1,332493,332493,332494,0,1,2
94931,5,1,332498,332498,332499,0,1,4
94932,5,3,332503,332503,332506,0,3,4
94933,6,3,332509,332509,332512,0,3,3
94934,5,2,332514,332514,332516,0,2,2
94935,5,2,332519,332519,332521,0,2,3
94936,5,1,332524,332524,332525,0,1,3
94937,5,3,332529,332529,332532,0,3,4
94938,1,2,332530,332532,332534,2,4,0
94939,3,1,332533,332534,332535,1,2,0
94940,5,3,332538,332538,332541,0,3,3
94941,5,1,332543,332543,332544,0,1,2
94942,2,1,332545,332545,332546,0,1,1
94943,5,1,332550,332550,332551,0,1,4
94944,3,3,332553,332553,332556,0,3,2
94945,5,2,332558,332558,332560,0,2,2
94946,6,2,332564,332564,332566,0,2,4
94947,6,1,332570,332570,332571,0,1,4
94948,2,1,332572,332572,332573,0,1,1
94949,6,1,332578,332578,332579,0,1,5
94950,3,2,332581,332581,332583,0,2,2
94951,2,1,332583,332583,332584,0,1,0
94952,5,1,332588,332588,332589,0,1,4
94953,1,2,332589,332589,332591,0,2,0
94954,3,3,332592,332592,332595,0,3,1
94955,5,2,332597,332597,332599,0,2,2
94956,5,1,332602,332602,332603,0,1,3
94957,3,2,332605,332605,332607,0,2,2
94958,2,2,332607,332607,332609,0,2,0
94959,5,1,332612,332612,332613,0,1,3
94960,6,1,332618,332618,332619,0,1,5
94961,1,2,332619,332619,332621,0,2,0
94962,4,1,332623,332623,332624,0,1,2
94963,5,2,332628,332628,332630,0,2,4
94964,5,3,332633,332633,332636,0,3,3
94965,5,2,332638,332638,332640,0,2,2
94966,4,2,332642,332642,332644,0,2,2
94967,1,2,332643,332644,332646,1,3,0
94968,5,1,332648,332648,332649,0,1,2
94969,1,3,332649,332649,332652,0,3,0
94970,6,1,332655,332655,332656,0,1,3
94971,4,1,332659,332659,332660,0,1,3
94972,4,2,332663,332663,332665,0,2,3
94973,3,1,332666,332666,332667,0,1,1
94974,4,1,332670,332670,332671,0,1,3
94975,5,2,332675,332675,332677,0,2,4
94976,5,2,332680,332680,332682,0,2,3
94977,3,2,332683,332683,332685,0,2,1
94978,1,2,332684,332685,332687,1,3,0
94979,5,2,332689,332689,332691,0,2,2
94980,3,2,332692,332692,332694,0,2,1
94981,3,2,332695,332695,332697,0,2,1
94982,6,1,332701,332701,332702,0,1,4
94983,5,1,332706,332706,332707,0,1,4
94984,3,1,332709,332709,332710,0,1,2
94985,2,2,332711,332711,332713,0,2,1
94986,2,2,332713,332713,332715,0,2,0
94987,2,1,332715,332715,332716,0,1,0
94988,5,3,332720,332720,332723,0,3,4
94989,3,1,332723,332723,332724,0,1,0
94990,6,1,332729,332729,332730,0,1,5
94991,6,3,332735,332735,332738,0,3,5
94992,6,3,332741,332741,332744,0,3,3
94993,2,3,332743,332744,332747,1,4,0
94994,4,3,332747,332747,332750,0,3,0
94995,1,1,332748,332750,332751,2,3,0
94996,1,2,332749,332751,332753,2,4,0
94997,3,2,332752,332753,332755,1,3,0
94998,3,3,332755,332755,332758,0,3,0
94999,3,2,332758,332758,332760,0,2,0
95000,2,1,332760,332760,332761,0,1,0
95001,2,1,332762,332762,332763,0,1,1
95002,5,2,332767,332767,332769,0,2,4
95003,4,1,332771,332771,332772,0,1,2
95004,2,1,332773,332773,332774,0,1,1
95005,3,1,332776,332776,332777,0,1,2
95006,1,1,332777,332777,332778,0,1,0
95007,1,3,332778,332778,332781,0,3,0
95008,1,1,332779,332781,332782,2,3,0
95009,6,3,332785,332785,332788,0,3,3
95010,5,2,332790,332790,332792,0,2,2
95011,5,3,332795,332795,332798,0,3,3
95012,3,3,332798,332798,332801,0,3,0
95013,1,2,332799,332801,332803,2,4,0
95014,1,2,332800,332803,332805,3,5,0
95015,3,1,332803,332805,332806,2,3,0
95016,4,1,332807,332807,332808,0,1,1
95017,6,1,332813,332813,332814,0,1,5
95018,4,2,332817,332817,332819,0,2,3
95019,2,2,332819,332819,332821,0,2,0
95020,2,1,332821,332821,332822,0,1,0
95021,6,2,332827,332827,332829,0,2,5
95022,2,3,332829,332829,332832,0,3,0
95023,6,2,332835,332835,332837,0,2,3
95024,3,1,332838,332838,332839,0,1,1
95025,4,3,332842,332842,332845,0,3,3
95026,4,2,332846,332846,332848,0,2,1
95027,5,3,332851,332851,332854,0,3,3
95028,3,1,332854,332854,332855,0,1,0
95029,1,2,332855,332855,332857,0,2,0
95030,6,1,332861,332861,332862,0,1,4
95031,5,3,332866,332866,332869,0,3,4
95032,5,3,332871,332871,332874,0,3,2
95033,6,2,332877,332877,332879,0,2,3
95034,5,3,332882,332882,332885,0,3,3
95035,3,1,332885,332885,332886,0,1,0
95036,2,2,332887,332887,332889,0,2,1
95037,3,1,332890,332890,332891,0,1,1
95038,1,3,332891,332891,332894,0,3,0
95039,4,1,332895,332895,332896,0,1,1
95040,2,2,332897,332897,332899,0,2,1
95041,1,1,332898,332899,332900,1,2,0
95042,4,1,332902,332902,332903,0,1,2
95043,4,2,332906,332906,332908,0,2,3
95044,4,2,332910,332910,332912,0,2,2
95045,3,1,332913,332913,332914,0,1,1
95046,3,1,332916,332916,332917,0,1,2
95047,5,1,332921,332921,332922,0,1,4
95048,6,2,332927,332927,332929,0,2,5
95049,5,2,332932,332932,332934,0,2,3
95050,1,2,332933,332934,332936,1,3,0
95051,5,3,332938,332938,332941,0,3,2
95052,2,2,332940,332941,332943,1,3,0
95053,4,3,332944,332944,332947,0,3,1
95054,4,1,332948,332948,332949,0,1,1
95055,4,2,332952,332952,332954,0,2,3
95056,4,3,332956,332956,332959,0,3,2
95057,4,3,332960,332960,332963,0,3,1
95058,2,1,332962,332963,332964,1,2,0
95059,5,1,332967,332967,332968,0,1,3
95060,4,2,332971,332971,332973,0,2,3
95061,4,2,332975,332975,332977,0,2,2
95062,6,3,332981,332981,332984,0,3,4
95063,2,2,332983,332984,332986,1,3,0
95064,6,1,332989,332989,332990,0,1,3
95065,3,3,332992,332992,332995,0,3,2
95066,3,1,332995,332995,332996,0,1,0
95067,6,3,333001,333001,333004,0,3,5
95068,3,2,333004,333004,333006,0,2,0
95069,1,2,333005,333006,333008,1,3,0
95070,3,1,333008,333008,333009,0,1,0
95071,6,3,333014,333014,333017,0,3,5
95072,5,1,333019,333019,333020,0,1,2
95073,4,2,333023,333023,333025,0,2,3
95074,3,1,333026,333026,333027,0,1,1
95075,1,2,333027,333027,333029,0,2,0
95076,5,3,333032,333032,333035,0,3,3
95077,2,3,333034,333035,333038,1,4,0
95078,6,2,333040,333040,333042,0,2,2
95079,4,1,333044,333044,333045,0,1,2
95080,5,3,333049,333049,333052,0,3,4
95081,5,1,333054,333054,333055,0,1,2
95082,1,2,333055,333055,333057,0,2,0
95083,5,3,333060,333060,333063,0,3,3
95084,6,1,333066,333066,333067,0,1,3
95085,1,1,333067,333067,333068,0,1,0
95086,4,2,333071,333071,333073,0,2,3
95087,6,3,333077,333077,333080,0,3,4
95088,5,2,333082,333082,333084,0,2,2
95089,3,1,333085,333085,333086,0,1,1
95090,3,3,333088,333088,333091,0,3,2
95091,6,2,333094,333094,333096,0,2,3
95092,4,2,333098,333098,333100,0,2,2
95093,6,1,333104,333104,333105,0,1,4
95094,2,1,333106,333106,333107,0,1,1
95095,4,2,333110,333110,333112,0,2,3
95096,2,1,333112,333112,333113,0,1,0
95097,6,2,333118,333118,333120,0,2,5
95098,5,2,333123,333123,333125,0,2,3
95099,6,2,333129,333129,333131,0,2,4
95100,1,3,333130,333131,333134,1,4,0
95101,5,2,333135,333135,333137,0,2,1
95102,1,2,333136,333137,333139,1,3,0
95103,3,3,333139,333139,333142,0,3,0
95104,5,1,333144,333144,333145,0,1,2
95105,6,2,333150,333150,333152,0,2,5
95106,2,1,333152,333152,333153,0,1,0
95107,4,3,333156,333156,333159,0,3,3
95108,4,2,333160,333160,333162,0,2,1
95109,6,2,333166,333166,333168,0,2,4
95110,3,3,333169,333169,333172,0,3,1
95111,5,2,333174,333174,333176,0,2,2
95112,6,1,333180,333180,333181,0,1,4
95113,5,2,333185,333185,333187,0,2,4
95114,4,1,333189,333189,333190,0,1,2
95115,6,1,333195,333195,333196,0,1,5
95116,1,3,333196,333196,333199,0,3,0
95117,1,2,333197,333199,333201,2,4,0
95118,3,2,333200,333201,333203,1,3,0
95119,2,3,333202,333203,333206,1,4,0
95120,3,1,333205,333206,333207,1,2,0
95121,5,2,333210,333210,333212,0,2,3
95122,6,1,333216,333216,333217,0,1,4
95123,1,1,333217,333217,333218,0,1,0
95124,4,1,333221,333221,333222,0,1,3
95125,4,2,333225,333225,333227,0,2,3
95126,6,3,333231,333231,333234,0,3,4
95127,5,1,333236,333236,333237,0,1,2
95128,2,1,333238,333238,333239,0,1,1
95129,2,2,333240,333240,333242,0,2,1
95130,3,2,333243,333243,333245,0,2,1
95131,6,2,333249,333249,333251,0,2,4
95132,3,3,333252,333252,333255,0,3,1
95133,2,3,333254,333255,333258,1,4,0
95134,1,2,333255,333258,333260,3,5,0
95135,1,3,333256,333260,333263,4,7,0
95136,4,3,333260,333263,333266,3,6,0
95137,6,2,333266,333266,333268,0,2,0
95138,5,2,333271,333271,333273,0,2,3
95139,4,3,333275,333275,333278,0,3,2
95140,2,3,333277,333278,333281,1,4,0
95141,4,2,333281,333281,333283,0,2,0
95142,5,3,333286,333286,333289,0,3,3
95143,6,2,333292,333292,333294,0,2,3
95144,3,2,333295,333295,333297,0,2,1
95145,5,3,333300,333300,333303,0,3,3
95146,3,2,333303,333303,333305,0,2,0
95147,2,1,333305,333305,333306,0,1,0
95148,2,3,333307,333307,333310,0,3,1
95149,1,1,333308,333310,333311,2,3,0
95150,1,3,333309,333311,333314,2,5,0
95151,1,1,333310,333314,333315,4,5,0
95152,5,1,333315,333315,333316,0,1,0
95153,5,1,333320,333320,333321,0,1,4
95154,1,3,333321,333321,333324,0,3,0
95155,1,3,333322,333324,333327,2,5,0
95156,2,2,333324,333327,333329,3,5,0
95157,3,3,333327,333329,333332,2,5,0
95158,4,2,333331,333332,333334,1,3,0
95159,2,3,333333,333334,333337,1,4,0
95160,3,1,333336,333337,333338,1,2,0
95161,2,1,333338,333338,333339,0,1,0
95162,1,3,333339,333339,333342,0,3,0
95163,5,2,333344,333344,333346,0,2,2
95164,6,2,333350,333350,333352,0,2,4
95165,5,2,333355,333355,333357,0,2,3
95166,2,1,333357,333357,333358,0,1,0
95167,2,2,333359,333359,333361,0,2,1
95168,3,1,333362,333362,333363,0,1,1
95169,1,2,333363,333363,333365,0,2,0
95170,5,2,333368,333368,333370,0,2,3
95171,2,2,333370,333370,333372,0,2,0
95172,6,2,333376,333376,333378,0,2,4
95173,2,3,333378,333378,333381,0,3,0
95174,5,3,333383,333383,333386,0,3,2
95175,4,1,333387,333387,333388,0,1,1
95176,6,2,333393,333393,333395,0,2,5
95177,2,3,333395,333395,333398,0,3,0
95178,4,1,333399,333399,333400,0,1,1
95179,2,2,333401,333401,333403,0,2,1
95180,6,3,333407,333407,333410,0,3,4
95181,3,1,333410,333410,333411,0,1,0
95182,1,2,333411,333411,333413,0,2,0
95183,4,1,333415,333415,333416,0,1,2
95184,5,3,333420,333420,333423,0,3,4
95185,5,1,333425,333425,333426,0,1,2
95186,5,1,333430,333430,333431,0,1,4
95187,6,1,333436,333436,333437,0,1,5
95188,6,3,333442,333442,333445,0,3,5
95189,4,1,333446,333446,333447,0,1,1
95190,2,2,333448,333448,333450,0,2,1
95191,1,2,333449,333450,333452,1,3,0
95192,1,3,333450,333452,333455,2,5,0
95193,2,2,333452,333455,333457,3,5,0
95194,3,3,333455,333457,333460,2,5,0
95195,2,2,333457,333460,333462,3,5,0
95196,2,2,333459,333462,333464,3,5,0
95197,4,3,333463,333464,333467,1,4,0
95198,2,1,333465,333467,333468,2,3,0
95199,5,2,333470,333470,333472,0,2,2
95200,6,1,333476,333476,333477,0,1,4
95201,3,1,333479,333479,333480,0,1,2
95202,1,3,333480,333480,333483,0,3,0
95203,2,3,333482,333483,333486,1,4,0
95204,2,3,333484,333486,333489,2,5,0
95205,2,2,333486,333489,333491,3,5,0
95206,2,3,333488,333491,333494,3,6,0
95207,3,3,333491,333494,333497,3,6,0
95208,3,3,333494,333497,333500,3,6,0
95209,6,1,333500,333500,333501,0,1,0
95210,6,2,333506,333506,333508,0,2,5
95211,5,1,333511,333511,333512,0,1,3
95212,6,2,333517,333517,333519,0,2,5
95213,1,3,333518,333519,333522,1,4,0
95214,5,1,333523,333523,333524,0,1,1
95215,2,2,333525,333525,333527,0,2,1
95216,4,2,333529,333529,333531,0,2,2
95217,3,2,333532,333532,333534,0,2,1
95218,1,3,333533,333534,333537,1,4,0
95219,3,2,333536,333537,333539,1,3,0
95220,6,2,333542,333542,333544,0,2,3
95221,3,1,333545,333545,333546,0,1,1
95222,3,3,333548,333548,333551,0,3,2
95223,3,3,333551,333551,333554,0,3,0
95224,1,1,333552,333554,333555,2,3,0
95225,2,3,333554,333555,333558,1,4,0
95226,6,2,333560,333560,333562,0,2,2
95227,2,1,333562,333562,333563,0,1,0
95228,1,2,333563,333563,333565,0,2,0
95229,1,3,333564,333565,333568,1,4,0
95230,1,2,333565,333568,333570,3,5,0
95231,2,2,333567,333570,333572,3,5,0
95232,5,2,333572,333572,333574,0,2,0
95233,5,2,333577,333577,333579,0,2,3
95234,5,2,333582,333582,333584,0,2,3
95235,6,3,333588,333588,333591,0,3,4
95236,4,3,333592,333592,333595,0,3,1
95237,4,2,333596,333596,333598,0,2,1
95238,6,1,333602,333602,333603,0,1,4
95239,2,2,333604,333604,333606,0,2,1
95240,6,1,333610,333610,333611,0,1,4
95241,3,3,333613,333613,333616,0,3,2
95242,6,1,333619,333619,333620,0,1,3
95243,6,1,333625,333625,333626,0,1,5
95244,5,2,333630,333630,333632,0,2,4
95245,4,2,333634,333634,333636,0,2,2
95246,5,2,333639,333639,333641,0,2,3
95247,2,3,333641,333641,333644,0,3,0
95248,6,1,333647,333647,333648,0,1,3
95249,6,1,333653,333653,333654,0,1,5
95250,1,1,333654,333654,333655,0,1,0
95251,5,1,333659,333659,333660,0,1,4
95252,4,1,333663,333663,333664,0,1,3
95253,2,2,333665,333665,333667,0,2,1
95254,3,2,333668,333668,333670,0,2,1
95255,1,3,333669,333670,333673,1,4,0
95256,4,3,333673,333673,333676,0,3,0
95257,4,2,333677,333677,333679,0,2,1
95258,5,3,333682,333682,333685,0,3,3
95259,5,2,333687,333687,333689,0,2,2
95260,5,2,333692,333692,333694,0,2,3
95261,1,2,333693,333694,333696,1,3,0
95262,2,1,333695,333696,333697,1,2,0
95263,6,1,333701,333701,333702,0,1,4
95264,4,1,333705,333705,333706,0,1,3
95265,6,2,333711,333711,333713,0,2,5
95266,6,1,333717,333717,333718,0,1,4
95267,4,3,333721,333721,333724,0,3,3
95268,4,2,333725,333725,333727,0,2,1
95269,2,1,333727,333727,333728,0,1,0
95270,4,3,333731,333731,333734,0,3,3
95271,2,3,333733,333734,333737,1,4,0
95272,5,3,333738,333738,333741,0,3,1
95273,3,2,333741,333741,333743,0,2,0
95274,5,1,333746,333746,333747,0,1,3
95275,1,1,333747,333747,333748,0,1,0
95276,4,3,333751,333751,333754,0,3,3
95277,6,1,333757,333757,333758,0,1,3
95278,1,1,333758,333758,333759,0,1,0
95279,4,3,333762,333762,333765,0,3,3
95280,2,3,333764,333765,333768,1,4,0
95281,3,3,333767,333768,333771,1,4,0
95282,2,2,333769,333771,333773,2,4,0
95283,3,1,333772,333773,333774,1,2,0
95284,6,2,333778,333778,333780,0,2,4
95285,3,1,333781,333781,333782,0,1,1
95286,4,3,333785,333785,333788,0,3,3
95287,4,1,333789,333789,333790,0,1,1
95288,3,3,333792,333792,333795,0,3,2
95289,5,3,333797,333797,333800,0,3,2
95290,3,3,333800,333800,333803,0,3,0
95291,1,2,333801,333803,333805,2,4,0
95292,2,2,333803,333805,333807,2,4,0
95293,6,3,333809,333809,333812,0,3,2
95294,3,2,333812,333812,333814,0,2,0
95295,3,2,333815,333815,333817,0,2,1
95296,5,1,333820,333820,333821,0,1,3
95297,6,3,333826,333826,333829,0,3,5
95298,4,3,333830,333830,333833,0,3,1
95299,6,2,333836,333836,333838,0,2,3
95300,5,3,333841,333841,333844,0,3,3
95301,4,3,333845,333845,333848,0,3,1
95302,6,2,333851,333851,333853,0,2,3
95303,4,2,333855,333855,333857,0,2,2
95304,1,1,333856,333857,333858,1,2,0
95305,4,2,333860,333860,333862,0,2,2
95306,2,1,333862,333862,333863,0,1,0
95307,5,2,333867,333867,333869,0,2,4
95308,5,1,333872,333872,333873,0,1,3
95309,2,3,333874,333874,333877,0,3,1
95310,2,1,333876,333877,333878,1,2,0
95311,1,1,333877,333878,333879,1,2,0
95312,6,1,333883,333883,333884,0,1,4
95313,2,3,333885,333885,333888,0,3,1
95314,6,2,333891,333891,333893,0,2,3
95315,4,1,333895,333895,333896,0,1,2
95316,6,2,333901,333901,333903,0,2,5
95317,3,2,333904,333904,333906,0,2,1
95318,6,3,333910,333910,333913,0,3,4
95319,2,1,333912,333913,333914,1,2,0
95320,4,3,333916,333916,333919,0,3,2
95321,4,1,333920,333920,333921,0,1,1
95322,2,1,333922,333922,333923,0,1,1
95323,3,1,333925,333925,333926,0,1,2
95324,2,1,333927,333927,333928,0,1,1
95325,5,1,333932,333932,333933,0,1,4
95326,4,1,333936,333936,333937,0,1,3
95327,1,1,333937,333937,333938,0,1,0
95328,4,2,333941,333941,333943,0,2,3
95329,2,3,333943,333943,333946,0,3,0
95330,5,1,333948,333948,333949,0,1,2
95331,1,1,333949,333949,333950,0,1,0
95332,2,3,333951,333951,333954,0,3,1
95333,6,1,333957,333957,333958,0,1,3
95334,1,1,333958,333958,333959,0,1,0
95335,6,3,333964,333964,333967,0,3,5
95336,4,2,333968,333968,333970,0,2,1
95337,6,3,333974,333974,333977,0,3,4
95338,4,3,333978,333978,333981,0,3,1
95339,6,3,333984,333984,333987,0,3,3
95340,4,2,333988,333988,333990,0,2,1
95341,3,2,333991,333991,333993,0,2,1
95342,2,1,333993,333993,333994,0,1,0
95343,2,1,333995,333995,333996,0,1,1
95344,1,1,333996,333996,333997,0,1,0
95345,4,2,334000,334000,334002,0,2,3
95346,2,1,334002,334002,334003,0,1,0
95347,4,2,334006,334006,334008,0,2,3
95348,6,3,334012,334012,334015,0,3,4
95349,2,2,334014,334015,334017,1,3,0
95350,4,1,334018,334018,334019,0,1,1
95351,2,1,334020,334020,334021,0,1,1
95352,3,3,334023,334023,334026,0,3,2
95353,6,2,334029,334029,334031,0,2,3
95354,3,2,334032,334032,334034,0,2,1
95355,6,2,334038,334038,334040,0,2,4
95356,5,2,334043,334043,334045,0,2,3
95357,1,1,334044,334045,334046,1,2,0
95358,5,3,334049,334049,334052,0,3,3
95359,3,2,334052,334052,334054,0,2,0
95360,1,1,334053,334054,334055,1,2,0
95361,3,3,334056,334056,334059,0,3,1
95362,5,1,334061,334061,334062,0,1,2
95363,5,3,334066,334066,334069,0,3,4
95364,1,2,334067,334069,334071,2,4,0
95365,2,2,334069,334071,334073,2,4,0
95366,3,1,334072,334073,334074,1,2,0
95367,1,2,334073,334074,334076,1,3,0
95368,6,1,334079,334079,334080,0,1,3
95369,4,1,334083,334083,334084,0,1,3
95370,2,3,334085,334085,334088,0,3,1
95371,3,2,334088,334088,334090,0,2,0
95372,1,1,334089,334090,334091,1,2,0
95373,3,1,334092,334092,334093,0,1,1
95374,4,2,334096,334096,334098,0,2,3
95375,2,3,334098,334098,334101,0,3,0
95376,1,1,334099,334101,334102,2,3,0
95377,5,3,334104,334104,334107,0,3,2
95378,5,3,334109,334109,334112,0,3,2
95379,4,3,334113,334113,334116,0,3,1
95380,3,1,334116,334116,334117,0,1,0
95381,1,2,334117,334117,334119,0,2,0
95382,3,2,334120,334120,334122,0,2,1
95383,2,3,334122,334122,334125,0,3,0
95384,1,2,334123,334125,334127,2,4,0
95385,4,3,334127,334127,334130,0,3,0
95386,5,3,334132,334132,334135,0,3,2
95387,2,3,334134,334135,334138,1,4,0
95388,3,3,334137,334138,334141,1,4,0
95389,2,1,334139,334141,334142,2,3,0
95390,6,1,334145,334145,334146,0,1,3
95391,3,1,334148,334148,334149,0,1,2
95392,3,1,334151,334151,334152,0,1,2
95393,5,2,334156,334156,334158,0,2,4
95394,5,3,334161,334161,334164,0,3,3
95395,2,2,334163,334164,334166,1,3,0
95396,4,1,334167,334167,334168,0,1,1
95397,6,2,334173,334173,334175,0,2,5
95398,3,3,334176,334176,334179,0,3,1
95399,5,1,334181,334181,334182,0,1,2
95400,6,3,334187,334187,334190,0,3,5
95401,1,3,334188,334190,334193,2,5,0
95402,1,1,334189,334193,334194,4,5,0
95403,6,1,334195,334195,334196,0,1,1
95404,1,3,334196,334196,334199,0,3,0
95405,2,3,334198,334199,334202,1,4,0
95406,2,3,334200,334202,334205,2,5,0
95407,2,2,334202,334205,334207,3,5,0
95408,1,2,334203,334207,334209,4,6,0
95409,4,2,334207,334209,334211,2,4,0
95410,2,3,334209,334211,334214,2,5,0
95411,1,1,334210,334214,334215,4,5,0
95412,6,1,334216,334216,334217,0,1,1
95413,1,3,334217,334217,334220,0,3,0
95414,3,3,334220,334220,334223,0,3,0
95415,4,3,334224,334224,334227,0,3,1
95416,6,1,334230,334230,334231,0,1,3
95417,4,1,334234,334234,334235,0,1,3
95418,1,3,334235,334235,334238,0,3,0
95419,1,1,334236,334238,334239,2,3,0
95420,6,1,334242,334242,334243,0,1,3
95421,2,1,334244,334244,334245,0,1,1
95422,5,3,334249,334249,334252,0,3,4
95423,6,3,334255,334255,334258,0,3,3
95424,1,3,334256,334258,334261,2,5,0
95425,4,1,334260,334261,334262,1,2,0
95426,5,1,334265,334265,334266,0,1,3
95427,3,1,334268,334268,334269,0,1,2
95428,2,1,334270,334270,334271,0,1,1
95429,5,2,334275,334275,334277,0,2,4
95430,5,2,334280,334280,334282,0,2,3
95431,1,1,334281,334282,334283,1,2,0
95432,2,2,334283,334283,334285,0,2,0
95433,6,3,334289,334289,334292,0,3,4
95434,4,2,334293,334293,334295,0,2,1
95435,4,3,334297,334297,334300,0,3,2
95436,4,2,334301,334301,334303,0,2,1
95437,4,2,334305,334305,334307,0,2,2
95438,2,1,334307,334307,334308,0,1,0
95439,4,3,334311,334311,334314,0,3,3
95440,6,1,334317,334317,334318,0,1,3
95441,5,1,334322,334322,334323,0,1,4
95442,4,2,334326,334326,334328,0,2,3
95443,3,2,334329,334329,334331,0,2,1
95444,5,3,334334,334334,334337,0,3,3
95445,3,3,334337,334337,334340,0,3,0
95446,3,1,334340,334340,334341,0,1,0
95447,6,1,334346,334346,334347,0,1,5
95448,1,3,334347,334347,334350,0,3,0
95449,2,1,334349,334350,334351,1,2,0
95450,2,2,334351,334351,334353,0,2,0
95451,2,1,334353,334353,334354,0,1,0
95452,6,2,334359,334359,334361,0,2,5
95453,1,3,334360,334361,334364,1,4,0
95454,1,1,334361,334364,334365,3,4,0
95455,5,1,334366,334366,334367,0,1,1
95456,6,3,334372,334372,334375,0,3,5
95457,4,1,334376,334376,334377,0,1,1
95458,1,1,334377,334377,334378,0,1,0
95459,4,2,334381,334381,334383,0,2,3
95460,2,2,334383,334383,334385,0,2,0
95461,3,1,334386,334386,334387,0,1,1
95462,1,2,334387,334387,334389,0,2,0
95463,1,3,334388,334389,334392,1,4,0
95464,4,1,334392,334392,334393,0,1,0
95465,3,1,334395,334395,334396,0,1,2
95466,4,1,334399,334399,334400,0,1,3
95467,4,3,334403,334403,334406,0,3,3
95468,2,1,334405,334406,334407,1,2,0
95469,4,2,334409,334409,334411,0,2,2
95470,4,2,334413,334413,334415,0,2,2
95471,4,3,334417,334417,334420,0,3,2
95472,4,3,334421,334421,334424,0,3,1
95473,3,2,334424,334424,334426,0,2,0
95474,3,3,334427,334427,334430,0,3,1
95475,2,2,334429,334430,334432,1,3,0
95476,1,2,334430,334432,334434,2,4,0
95477,1,1,334431,334434,334435,3,4,0
95478,3,3,334434,334435,334438,1,4,0
95479,3,1,334437,334438,334439,1,2,0
95480,6,3,334443,334443,334446,0,3,4
95481,3,3,334446,334446,334449,0,3,0
95482,4,3,334450,334450,334453,0,3,1
95483,2,1,334452,334453,334454,1,2,0
95484,2,1,334454,334454,334455,0,1,0
95485,2,1,334456,334456,334457,0,1,1
95486,5,2,334461,334461,334463,0,2,4
95487,6,2,334467,334467,334469,0,2,4
95488,4,1,334471,334471,334472,0,1,2
95489,1,1,334472,334472,334473,0,1,0
95490,5,1,334477,334477,334478,0,1,4
95491,2,2,334479,334479,334481,0,2,1
95492,6,2,334485,334485,334487,0,2,4
95493,2,3,334487,334487,334490,0,3,0
95494,5,1,334492,334492,334493,0,1,2
95495,3,3,334495,334495,334498,0,3,2
95496,4,1,334499,334499,334500,0,1,1
95497,5,3,334504,334504,334507,0,3,4
95498,3,2,334507,334507,334509,0,2,0
95499,3,2,334510,334510,334512,0,2,1
95500,3,3,334513,334513,334516,0,3,1
95501,6,3,334519,334519,334522,0,3,3
95502,6,3,334525,334525,334528,0,3,3
95503,6,1,334531,334531,334532,0,1,3
95504,4,1,334535,334535,334536,0,1,3
95505,4,1,334539,334539,334540,0,1,3
95506,3,3,334542,334542,334545,0,3,2
95507,5,1,334547,334547,334548,0,1,2
95508,5,2,334552,334552,334554,0,2,4
95509,2,2,334554,334554,334556,0,2,0
95510,2,1,334556,334556,334557,0,1,0
95511,5,2,334561,334561,334563,0,2,4
95512,2,2,334563,334563,334565,0,2,0
95513,3,2,334566,334566,334568,0,2,1
95514,4,1,334570,334570,334571,0,1,2
95515,3,1,334573,334573,334574,0,1,2
95516,4,1,334577,334577,334578,0,1,3
95517,5,2,334582,334582,334584,0,2,4
95518,3,2,334585,334585,334587,0,2,1
95519,3,1,334588,334588,334589,0,1,1
95520,2,2,334590,334590,334592,0,2,1
95521,2,1,334592,334592,334593,0,1,0
95522,1,1,334593,334593,334594,0,1,0
95523,4,3,334597,334597,334600,0,3,3
95524,2,2,334599,334600,334602,1,3,0
95525,5,1,334604,334604,334605,0,1,2
95526,1,3,334605,334605,334608,0,3,0
95527,1,3,334606,334608,334611,2,5,0
95528,5,2,334611,334611,334613,0,2,0
95529,6,2,334617,334617,334619,0,2,4
95530,5,3,334622,334622,334625,0,3,3
95531,2,2,334624,334625,334627,1,3,0
95532,3,2,334627,334627,334629,0,2,0
95533,1,3,334628,334629,334632,1,4,0
95534,2,1,334630,334632,334633,2,3,0
95535,6,2,334636,334636,334638,0,2,3
95536,6,1,334642,334642,334643,0,1,4
95537,3,2,334645,334645,334647,0,2,2
95538,1,2,334646,334647,334649,1,3,0
95539,3,2,334649,334649,334651,0,2,0
95540,2,1,334651,334651,334652,0,1,0
95541,1,1,334652,334652,334653,0,1,0
95542,4,3,334656,334656,334659,0,3,3
95543,5,1,334661,334661,334662,0,1,2
95544,3,2,334664,334664,334666,0,2,2
95545,2,1,334666,334666,334667,0,1,0
95546,4,1,334670,334670,334671,0,1,3
95547,4,2,334674,334674,334676,0,2,3
95548,2,3,334676,334676,334679,0,3,0
95549,2,3,334678,334679,334682,1,4,0
95550,5,2,334683,334683,334685,0,2,1
95551,6,3,334689,334689,334692,0,3,4
95552,3,1,334692,334692,334693,0,1,0
95553,1,3,334693,334693,334696,0,3,0
95554,4,2,334697,334697,334699,0,2,1
95555,6,3,334703,334703,334706,0,3,4
95556,2,2,334705,334706,334708,1,3,0
95557,2,3,334707,334708,334711,1,4,0
95558,6,2,334713,334713,334715,0,2,2
95559,3,3,334716,334716,334719,0,3,1
95560,2,1,334718,334719,334720,1,2,0
95561,4,2,334722,334722,334724,0,2,2
95562,6,1,334728,334728,334729,0,1,4
95563,5,1,334733,334733,334734,0,1,4
95564,3,3,334736,334736,334739,0,3,2
95565,5,3,334741,334741,334744,0,3,2
95566,6,2,334747,334747,334749,0,2,3
95567,6,3,334753,334753,334756,0,3,4
95568,6,1,334759,334759,334760,0,1,3
95569,3,3,334762,334762,334765,0,3,2
95570,3,2,334765,334765,334767,0,2,0
95571,3,3,334768,334768,334771,0,3,1
95572,1,1,334769,334771,334772,2,3,0
95573,4,3,334773,334773,334776,0,3,1
95574,1,2,334774,334776,334778,2,4,0
95575,2,3,334776,334778,334781,2,5,0
95576,2,3,334778,334781,334784,3,6,0
95577,6,3,334784,334784,334787,0,3,0
95578,2,1,334786,334787,334788,1,2,0
95579,4,1,334790,334790,334791,0,1,2
95580,1,2,334791,334791,334793,0,2,0
95581,3,2,334794,334794,334796,0,2,1
95582,1,1,334795,334796,334797,1,2,0
95583,4,3,334799,334799,334802,0,3,2
95584,3,1,334802,334802,334803,0,1,0
95585,5,3,334807,334807,334810,0,3,4
95586,5,1,334812,334812,334813,0,1,2
95587,4,2,334816,334816,334818,0,2,3
95588,3,3,334819,334819,334822,0,3,1
95589,6,2,334825,334825,334827,0,2,3
95590,2,3,334827,334827,334830,0,3,0
95591,6,3,334833,334833,334836,0,3,3
95592,6,2,334839,334839,334841,0,2,3
95593,3,2,334842,334842,334844,0,2,1
95594,4,3,334846,334846,334849,0,3,2
95595,5,1,334851,334851,334852,0,1,2
95596,3,2,334854,334854,334856,0,2,2
95597,3,1,334857,334857,334858,0,1,1
95598,6,3,334863,334863,334866,0,3,5
95599,2,1,334865,334866,334867,1,2,0
95600,6,1,334871,334871,334872,0,1,4
95601,2,3,334873,334873,334876,0,3,1
95602,4,3,334877,334877,334880,0,3,1
95603,6,2,334883,334883,334885,0,2,3
95604,5,2,334888,334888,334890,0,2,3
95605,2,2,334890,334890,334892,0,2,0
95606,3,3,334893,334893,334896,0,3,1
95607,4,3,334897,334897,334900,0,3,1
95608,6,1,334903,334903,334904,0,1,3
95609,3,2,334906,334906,334908,0,2,2
95610,1,1,334907,334908,334909,1,2,0
95611,5,1,334912,334912,334913,0,1,3
95612,1,1,334913,334913,334914,0,1,0
95613,5,3,334918,334918,334921,0,3,4
95614,6,3,334924,334924,334927,0,3,3
95615,4,1,334928,334928,334929,0,1,1
95616,2,3,334930,334930,334933,0,3,1
95617,2,1,334932,334933,334934,1,2,0
95618,5,3,334937,334937,334940,0,3,3
95619,6,2,334943,334943,334945,0,2,3
95620,1,1,334944,334945,334946,1,2,0
95621,4,3,334948,334948,334951,0,3,2
95622,6,3,334954,334954,334957,0,3,3
95623,5,3,334959,334959,334962,0,3,2
95624,4,1,334963,334963,334964,0,1,1
95625,1,1,334964,334964,334965,0,1,0
95626,6,3,334970,334970,334973,0,3,5
95627,2,2,334972,334973,334975,1,3,0
95628,4,3,334976,334976,334979,0,3,1
95629,4,1,334980,334980,334981,0,1,1
95630,2,2,334982,334982,334984,0,2,1
95631,3,1,334985,334985,334986,0,1,1
95632,5,3,334990,334990,334993,0,3,4
95633,4,1,334994,334994,334995,0,1,1
95634,6,1,335000,335000,335001,0,1,5
95635,6,3,335006,335006,335009,0,3,5
95636,5,2,335011,335011,335013,0,2,2
95637,5,2,335016,335016,335018,0,2,3
95638,6,2,335022,335022,335024,0,2,4
95639,3,3,335025,335025,335028,0,3,1
95640,5,1,335030,335030,335031,0,1,2
95641,2,1,335032,335032,335033,0,1,1
95642,6,3,335038,335038,335041,0,3,5
95643,3,3,335041,335041,335044,0,3,0
95644,6,2,335047,335047,335049,0,2,3
95645,3,2,335050,335050,335052,0,2,1
95646,4,1,335054,335054,335055,0,1,2
95647,6,1,335060,335060,335061,0,1,5
95648,5,3,335065,335065,335068,0,3,4
95649,3,3,335068,335068,335071,0,3,0
95650,1,2,335069,335071,335073,2,4,0
95651,4,2,335073,335073,335075,0,2,0
95652,2,2,335075,335075,335077,0,2,0
95653,4,2,335079,335079,335081,0,2,2
95654,1,2,335080,335081,335083,1,3,0
95655,6,3,335086,335086,335089,0,3,3
95656,1,3,335087,335089,335092,2,5,0
95657,3,2,335090,335092,335094,2,4,0
95658,2,2,335092,335094,335096,2,4,0
95659,1,1,335093,335096,335097,3,4,0
95660,1,2,335094,335097,335099,3,5,0
95661,2,2,335096,335099,335101,3,5,0
95662,6,1,335102,335102,335103,0,1,1
95663,2,1,335104,335104,335105,0,1,1
95664,5,3,335109,335109,335112,0,3,4
95665,5,3,335114,335114,335117,0,3,2
95666,6,1,335120,335120,335121,0,1,3
95667,2,2,335122,335122,335124,0,2,1
95668,4,2,335126,335126,335128,0,2,2
95669,4,1,335130,335130,335131,0,1,2
95670,1,3,335131,335131,335134,0,3,0
95671,3,2,335134,335134,335136,0,2,0
95672,4,3,335138,335138,335141,0,3,2
95673,3,1,335141,335141,335142,0,1,0
95674,2,3,335143,335143,335146,0,3,1
95675,4,2,335147,335147,335149,0,2,1
95676,3,3,335150,335150,335153,0,3,1
95677,4,1,335154,335154,335155,0,1,1
95678,2,3,335156,335156,335159,0,3,1
95679,2,1,335158,335159,335160,1,2,0
95680,6,3,335164,335164,335167,0,3,4
95681,1,2,335165,335167,335169,2,4,0
95682,5,3,335170,335170,335173,0,3,1
95683,3,3,335173,335173,335176,0,3,0
95684,6,3,335179,335179,335182,0,3,3
95685,2,1,335181,335182,335183,1,2,0
95686,4,3,335185,335185,335188,0,3,2
95687,1,3,335186,335188,335191,2,5,0
95688,2,2,335188,335191,335193,3,5,0
95689,5,2,335193,335193,335195,0,2,0
95690,6,1,335199,335199,335200,0,1,4
95691,2,2,335201,335201,335203,0,2,1
95692,2,2,335203,335203,335205,0,2,0
95693,6,2,335209,335209,335211,0,2,4
95694,2,2,335211,335211,335213,0,2,0
95695,6,3,335217,335217,335220,0,3,4
95696,3,3,335220,335220,335223,0,3,0
95697,3,3,335223,335223,335226,0,3,0
95698,6,3,335229,335229,335232,0,3,3
95699,5,3,335234,335234,335237,0,3,2
95700,6,1,335240,335240,335241,0,1,3
95701,4,3,335244,335244,335247,0,3,3
95702,1,2,335245,335247,335249,2,4,0
95703,5,2,335250,335250,335252,0,2,1
95704,3,3,335253,335253,335256,0,3,1
95705,1,3,335254,335256,335259,2,5,0
95706,1,1,335255,335259,335260,4,5,0
95707,2,2,335257,335260,335262,3,5,0
95708,2,3,335259,335262,335265,3,6,0
95709,6,3,335265,335265,335268,0,3,0
95710,3,2,335268,335268,335270,0,2,0
95711,5,3,335273,335273,335276,0,3,3
95712,5,3,335278,335278,335281,0,3,2
95713,2,1,335280,335281,335282,1,2,0
95714,5,3,335285,335285,335288,0,3,3
95715,5,3,335290,335290,335293,0,3,2
95716,3,2,335293,335293,335295,0,2,0
95717,1,1,335294,335295,335296,1,2,0
95718,1,2,335295,335296,335298,1,3,0
95719,5,3,335300,335300,335303,0,3,2
95720,6,3,335306,335306,335309,0,3,3
95721,3,3,335309,335309,335312,0,3,0
95722,3,3,335312,335312,335315,0,3,0
95723,6,1,335318,335318,335319,0,1,3
95724,3,1,335321,335321,335322,0,1,2
95725,3,2,335324,335324,335326,0,2,2
95726,5,2,335329,335329,335331,0,2,3
95727,5,2,335334,335334,335336,0,2,3
95728,4,1,335338,335338,335339,0,1,2
95729,3,2,335341,335341,335343,0,2,2
95730,1,3,335342,335343,335346,1,4,0
95731,6,1,335348,335348,335349,0,1,2
95732,5,3,335353,335353,335356,0,3,4
95733,1,1,335354,335356,335357,2,3,0
95734,6,1,335360,335360,335361,0,1,3
95735,5,2,335365,335365,335367,0,2,4
95736,5,3,335370,335370,335373,0,3,3
95737,3,3,335373,335373,335376,0,3,0
95738,5,2,335378,335378,335380,0,2,2
95739,4,3,335382,335382,335385,0,3,2
95740,4,2,335386,335386,335388,0,2,1
95741,4,1,335390,335390,335391,0,1,2
95742,3,2,335393,335393,335395,0,2,2
95743,6,3,335399,335399,335402,0,3,4
95744,3,3,335402,335402,335405,0,3,0
95745,2,1,335404,335405,335406,1,2,0
95746,1,1,335405,335406,335407,1,2,0
95747,3,1,335408,335408,335409,0,1,1
95748,4,1,335412,335412,335413,0,1,3
95749,2,3,335414,335414,335417,0,3,1
95750,5,1,335419,335419,335420,0,1,2
95751,4,3,335423,335423,335426,0,3,3
95752,3,1,335426,335426,335427,0,1,0
95753,5,2,335431,335431,335433,0,2,4
95754,1,2,335432,335433,335435,1,3,0
95755,3,2,335435,335435,335437,0,2,0
95756,5,1,335440,335440,335441,0,1,3
95757,6,3,335446,335446,335449,0,3,5
95758,6,2,335452,335452,335454,0,2,3
95759,1,1,335453,335454,335455,1,2,0
95760,1,2,335454,335455,335457,1,3,0
95761,2,1,335456,335457,335458,1,2,0
95762,5,1,335461,335461,335462,0,1,3
95763,6,1,335467,335467,335468,0,1,5
95764,6,3,335473,335473,335476,0,3,5
95765,2,2,335475,335476,335478,1,3,0
95766,1,3,335476,335478,335481,2,5,0
95767,6,1,335482,335482,335483,0,1,1
95768,5,1,335487,335487,335488,0,1,4
95769,3,2,335490,335490,335492,0,2,2
95770,6,1,335496,335496,335497,0,1,4
95771,5,2,335501,335501,335503,0,2,4
95772,3,3,335504,335504,335507,0,3,1
95773,5,3,335509,335509,335512,0,3,2
95774,4,2,335513,335513,335515,0,2,1
95775,1,1,335514,335515,335516,1,2,0
95776,3,3,335517,335517,335520,0,3,1
95777,1,1,335518,335520,335521,2,3,0
95778,3,2,335521,335521,335523,0,2,0
95779,1,1,335522,335523,335524,1,2,0
95780,4,2,335526,335526,335528,0,2,2
95781,4,2,335530,335530,335532,0,2,2
95782,5,1,335535,335535,335536,0,1,3
95783,3,3,335538,335538,335541,0,3,2
95784,2,3,335540,335541,335544,1,4,0
95785,4,1,335544,335544,335545,0,1,0
95786,3,2,335547,335547,335549,0,2,2
95787,4,2,335551,335551,335553,0,2,2
95788,5,2,335556,335556,335558,0,2,3
95789,3,3,335559,335559,335562,0,3,1
95790,2,3,335561,335562,335565,1,4,0
95791,2,1,335563,335565,335566,2,3,0
95792,3,1,335566,335566,335567,0,1,0
95793,2,1,335568,335568,335569,0,1,1
95794,5,2,335573,335573,335575,0,2,4
95795,4,1,335577,335577,335578,0,1,2
95796,3,2,335580,335580,335582,0,2,2
95797,6,3,335586,335586,335589,0,3,4
95798,2,1,335588,335589,335590,1,2,0
95799,6,1,335594,335594,335595,0,1,4
95800,1,2,335595,335595,335597,0,2,0
95801,4,2,335599,335599,335601,0,2,2
95802,4,1,335603,335603,335604,0,1,2
95803,5,3,335608,335608,335611,0,3,4
95804,4,2,335612,335612,335614,0,2,1
95805,2,3,335614,335614,335617,0,3,0
95806,6,3,335620,335620,335623,0,3,3
95807,5,2,335625,335625,335627,0,2,2
95808,4,3,335629,335629,335632,0,3,2
95809,2,1,335631,335632,335633,1,2,0
95810,5,3,335636,335636,335639,0,3,3
95811,5,2,335641,335641,335643,0,2,2
95812,1,3,335642,335643,335646,1,4,0
95813,2,3,335644,335646,335649,2,5,0
95814,1,3,335645,335649,335652,4,7,0
95815,4,2,335649,335652,335654,3,5,0
95816,3,1,335652,335654,335655,2,3,0
95817,2,3,335654,335655,335658,1,4,0
95818,4,2,335658,335658,335660,0,2,0
95819,1,2,335659,335660,335662,1,3,0
95820,1,1,335660,335662,335663,2,3,0
95821,4,3,335664,335664,335667,0,3,1
95822,2,1,335666,335667,335668,1,2,0
95823,2,3,335668,335668,335671,0,3,0
95824,2,1,335670,335671,335672,1,2,0
95825,1,3,335671,335672,335675,1,4,0
95826,2,3,335673,335675,335678,2,5,0
95827,1,2,335674,335678,335680,4,6,0
95828,6,3,335680,335680,335683,0,3,0
95829,4,3,335684,335684,335687,0,3,1
95830,6,1,335690,335690,335691,0,1,3
95831,5,3,335695,335695,335698,0,3,4
95832,3,1,335698,335698,335699,0,1,0
95833,1,2,335699,335699,335701,0,2,0
95834,3,1,335702,335702,335703,0,1,1
95835,3,2,335705,335705,335707,0,2,2
95836,6,3,335711,335711,335714,0,3,4
95837,5,2,335716,335716,335718,0,2,2
95838,5,2,335721,335721,335723,0,2,3
95839,3,3,335724,335724,335727,0,3,1
95840,4,1,335728,335728,335729,0,1,1
95841,4,1,335732,335732,335733,0,1,3
95842,2,3,335734,335734,335737,0,3,1
95843,3,2,335737,335737,335739,0,2,0
95844,2,3,335739,335739,335742,0,3,0
95845,1,2,335740,335742,335744,2,4,0
95846,1,3,335741,335744,335747,3,6,0
95847,2,3,335743,335747,335750,4,7,0
95848,1,3,335744,335750,335753,6,9,0
95849,5,1,335749,335753,335754,4,5,0
95850,3,1,335752,335754,335755,2,3,0
95851,5,1,335757,335757,335758,0,1,2
95852,5,3,335762,335762,335765,0,3,4
95853,2,1,335764,335765,335766,1,2,0
95854,5,3,335769,335769,335772,0,3,3
95855,6,3,335775,335775,335778,0,3,3
95856,1,1,335776,335778,335779,2,3,0
95857,5,3,335781,335781,335784,0,3,2
95858,3,3,335784,335784,335787,0,3,0
95859,4,2,335788,335788,335790,0,2,1
95860,6,2,335794,335794,335796,0,2,4
95861,6,3,335800,335800,335803,0,3,4
95862,2,2,335802,335803,335805,1,3,0
95863,4,3,335806,335806,335809,0,3,1
95864,3,3,335809,335809,335812,0,3,0
95865,6,3,335815,335815,335818,0,3,3
95866,4,1,335819,335819,335820,0,1,1
95867,4,1,335823,335823,335824,0,1,3
95868,3,1,335826,335826,335827,0,1,2
95869,5,2,335831,335831,335833,0,2,4
95870,3,2,335834,335834,335836,0,2,1
95871,2,2,335836,335836,335838,0,2,0
95872,1,1,335837,335838,335839,1,2,0
95873,1,3,335838,335839,335842,1,4,0
95874,3,1,335841,335842,335843,1,2,0
95875,5,3,335846,335846,335849,0,3,3
95876,4,2,335850,335850,335852,0,2,1
95877,4,3,335854,335854,335857,0,3,2
95878,5,2,335859,335859,335861,0,2,2
95879,6,1,335865,335865,335866,0,1,4
95880,3,3,335868,335868,335871,0,3,2
95881,2,1,335870,335871,335872,1,2,0
95882,4,3,335874,335874,335877,0,3,2
95883,3,3,335877,335877,335880,0,3,0
95884,1,1,335878,335880,335881,2,3,0
95885,2,1,335880,335881,335882,1,2,0
95886,2,3,335882,335882,335885,0,3,0
95887,2,2,335884,335885,335887,1,3,0
95888,1,2,335885,335887,335889,2,4,0
95889,2,3,335887,335889,335892,2,5,0
95890,4,1,335891,335892,335893,1,2,0
95891,6,2,335897,335897,335899,0,2,4
95892,1,2,335898,335899,335901,1,3,0
95893,3,3,335901,335901,335904,0,3,0
95894,5,2,335906,335906,335908,0,2,2
95895,2,3,335908,335908,335911,0,3,0
95896,5,2,335913,335913,335915,0,2,2
95897,3,1,335916,335916,335917,0,1,1
95898,5,2,335921,335921,335923,0,2,4
95899,5,2,335926,335926,335928,0,2,3
95900,6,1,335932,335932,335933,0,1,4
95901,3,2,335935,335935,335937,0,2,2
95902,4,2,335939,335939,335941,0,2,2
95903,5,2,335944,335944,335946,0,2,3
95904,1,3,335945,335946,335949,1,4,0
95905,3,1,335948,335949,335950,1,2,0
95906,5,1,335953,335953,335954,0,1,3
95907,2,1,335955,335955,335956,0,1,1
95908,6,3,335961,335961,335964,0,3,5
95909,6,1,335967,335967,335968,0,1,3
95910,4,2,335971,335971,335973,0,2,3
95911,6,2,335977,335977,335979,0,2,4
95912,5,3,335982,335982,335985,0,3,3
95913,2,1,335984,335985,335986,1,2,0
95914,2,1,335986,335986,335987,0,1,0
95915,4,3,335990,335990,335993,0,3,3
95916,5,3,335995,335995,335998,0,3,2
95917,3,2,335998,335998,336000,0,2,0
95918,4,2,336002,336002,336004,0,2,2
95919,3,3,336005,336005,336008,0,3,1
95920,2,2,336007,336008,336010,1,3,0
95921,5,2,336012,336012,336014,0,2,2
95922,2,1,336014,336014,336015,0,1,0
95923,2,2,336016,336016,336018,0,2,1
95924,1,1,336017,336018,336019,1,2,0
95925,6,2,336023,336023,336025,0,2,4
95926,1,2,336024,336025,336027,1,3,0
95927,4,1,336028,336028,336029,0,1,1
95928,5,3,336033,336033,336036,0,3,4
95929,1,2,336034,336036,336038,2,4,0
95930,1,1,336035,336038,336039,3,4,0
95931,5,1,336040,336040,336041,0,1,1
95932,1,2,336041,336041,336043,0,2,0
95933,3,2,336044,336044,336046,0,2,1
95934,5,1,336049,336049,336050,0,1,3
95935,2,2,336051,336051,336053,0,2,1
95936,4,1,336055,336055,336056,0,1,2
95937,3,1,336058,336058,336059,0,1,2
95938,1,2,336059,336059,336061,0,2,0
95939,4,3,336063,336063,336066,0,3,2
95940,5,2,336068,336068,336070,0,2,2
95941,1,2,336069,336070,336072,1,3,0
95942,4,3,336073,336073,336076,0,3,1
95943,2,3,336075,336076,336079,1,4,0
95944,6,2,336081,336081,336083,0,2,2
95945,1,2,336082,336083,336085,1,3,0
95946,6,1,336088,336088,336089,0,1,3
95947,1,2,336089,336089,336091,0,2,0
95948,4,1,336093,336093,336094,0,1,2
95949,2,1,336095,336095,336096,0,1,1
95950,2,3,336097,336097,336100,0,3,1
95951,6,3,336103,336103,336106,0,3,3
95952,3,2,336106,336106,336108,0,2,0
95953,6,3,336112,336112,336115,0,3,4
95954,5,2,336117,336117,336119,0,2,2
95955,6,2,336123,336123,336125,0,2,4
95956,4,2,336127,336127,336129,0,2,2
95957,2,1,336129,336129,336130,0,1,0
95958,5,3,336134,336134,336137,0,3,4
95959,1,2,336135,336137,336139,2,4,0
95960,4,3,336139,336139,336142,0,3,0
95961,2,1,336141,336142,336143,1,2,0
95962,2,3,336143,336143,336146,0,3,0
95963,2,3,336145,336146,336149,1,4,0
95964,3,1,336148,336149,336150,1,2,0
95965,4,3,336152,336152,336155,0,3,2
95966,4,3,336156,336156,336159,0,3,1
95967,5,2,336161,336161,336163,0,2,2
95968,2,3,336163,336163,336166,0,3,0
95969,2,2,336165,336166,336168,1,3,0
95970,5,3,336170,336170,336173,0,3,2
95971,3,1,336173,336173,336174,0,1,0
95972,1,3,336174,336174,336177,0,3,0
95973,6,1,336180,336180,336181,0,1,3
95974,2,1,336182,336182,336183,0,1,1
95975,3,3,336185,336185,336188,0,3,2
95976,2,3,336187,336188,336191,1,4,0
95977,5,3,336192,336192,336195,0,3,1
95978,1,2,336193,336195,336197,2,4,0
95979,1,1,336194,336197,336198,3,4,0
95980,4,2,336198,336198,336200,0,2,0
95981,3,3,336201,336201,336204,0,3,1
95982,2,1,336203,336204,336205,1,2,0
95983,2,3,336205,336205,336208,0,3,0
95984,3,2,336208,336208,336210,0,2,0
95985,2,3,336210,336210,336213,0,3,0
95986,6,3,336216,336216,336219,0,3,3
95987,4,3,336220,336220,336223,0,3,1
95988,4,3,336224,336224,336227,0,3,1
95989,3,3,336227,336227,336230,0,3,0
95990,1,3,336228,336230,336233,2,5,0
95991,5,1,336233,336233,336234,0,1,0
95992,6,2,336239,336239,336241,0,2,5
95993,6,1,336245,336245,336246,0,1,4
95994,6,3,336251,336251,336254,0,3,5
95995,2,2,336253,336254,336256,1,3,0
95996,3,3,336256,336256,336259,0,3,0
95997,1,1,336257,336259,336260,2,3,0
95998,5,1,336262,336262,336263,0,1,2
95999,3,3,336265,336265,336268,0,3,2
96000,4,3,336269,336269,336272,0,3,1
96001,6,3,336275,336275,336278,0,3,3
96002,4,2,336279,336279,336281,0,2,1
96003,2,1,336281,336281,336282,0,1,0
96004,1,1,336282,336282,336283,0,1,0
96005,3,2,336285,336285,336287,0,2,2
96006,5,3,336290,336290,336293,0,3,3
96007,4,3,336294,336294,336297,0,3,1
96008,2,3,336296,336297,336300,1,4,0
96009,5,3,336301,336301,336304,0,3,1
96010,4,2,336305,336305,336307,0,2,1
96011,1,1,336306,336307,336308,1,2,0
96012,1,2,336307,336308,336310,1,3,0
96013,3,3,336310,336310,336313,0,3,0
96014,4,3,336314,336314,336317,0,3,1
96015,1,3,336315,336317,336320,2,5,0
96016,6,3,336321,336321,336324,0,3,1
96017,3,3,336324,336324,336327,0,3,0
96018,1,2,336325,336327,336329,2,4,0
96019,3,1,336328,336329,336330,1,2,0
96020,3,2,336331,336331,336333,0,2,1
96021,6,3,336337,336337,336340,0,3,4
96022,3,3,336340,336340,336343,0,3,0
96023,2,1,336342,336343,336344,1,2,0
96024,3,1,336345,336345,336346,0,1,1
96025,4,2,336349,336349,336351,0,2,3
96026,6,1,336355,336355,336356,0,1,4
96027,3,2,336358,336358,336360,0,2,2
96028,3,3,336361,336361,336364,0,3,1
96029,3,1,336364,336364,336365,0,1,0
96030,5,1,336369,336369,336370,0,1,4
96031,4,3,336373,336373,336376,0,3,3
96032,2,2,336375,336376,336378,1,3,0
96033,4,1,336379,336379,336380,0,1,1
96034,3,1,336382,336382,336383,0,1,2
96035,2,2,336384,336384,336386,0,2,1
96036,1,3,336385,336386,336389,1,4,0
96037,6,1,336391,336391,336392,0,1,2
96038,3,2,336394,336394,336396,0,2,2
96039,6,1,336400,336400,336401,0,1,4
96040,3,3,336403,336403,336406,0,3,2
96041,6,3,336409,336409,336412,0,3,3
96042,5,3,336414,336414,336417,0,3,2
96043,2,2,336416,336417,336419,1,3,0
96044,2,1,336418,336419,336420,1,2,0
96045,1,2,336419,336420,336422,1,3,0
96046,2,3,336421,336422,336425,1,4,0
96047,4,2,336425,336425,336427,0,2,0
96048,6,3,336431,336431,336434,0,3,4
96049,4,2,336435,336435,336437,0,2,1
96050,4,3,336439,336439,336442,0,3,2
96051,5,3,336444,336444,336447,0,3,2
96052,6,2,336450,336450,336452,0,2,3
96053,1,2,336451,336452,336454,1,3,0
96054,4,1,336455,336455,336456,0,1,1
96055,6,2,336461,336461,336463,0,2,5
96056,6,3,336467,336467,336470,0,3,4
96057,2,2,336469,336470,336472,1,3,0
96058,3,1,336472,336472,336473,0,1,0
96059,4,3,336476,336476,336479,0,3,3
96060,4,2,336480,336480,336482,0,2,1
96061,4,2,336484,336484,336486,0,2,2
96062,2,2,336486,336486,336488,0,2,0
96063,2,1,336488,336488,336489,0,1,0
96064,5,2,336493,336493,336495,0,2,4
96065,3,3,336496,336496,336499,0,3,1
96066,1,1,336497,336499,336500,2,3,0
96067,1,1,336498,336500,336501,2,3,0
96068,5,3,336503,336503,336506,0,3,2
96069,1,3,336504,336506,336509,2,5,0
96070,5,2,336509,336509,336511,0,2,0
96071,4,1,336513,336513,336514,0,1,2
96072,5,1,336518,336518,336519,0,1,4
96073,3,3,336521,336521,336524,0,3,2
96074,4,2,336525,336525,336527,0,2,1
96075,6,2,336531,336531,336533,0,2,4
96076,5,1,336536,336536,336537,0,1,3
96077,1,2,336537,336537,336539,0,2,0
96078,2,3,336539,336539,336542,0,3,0
96079,5,1,336544,336544,336545,0,1,2
96080,1,3,336545,336545,336548,0,3,0
96081,4,3,336549,336549,336552,0,3,1
96082,2,2,336551,336552,336554,1,3,0
96083,6,1,336557,336557,336558,0,1,3
96084,5,1,336562,336562,336563,0,1,4
96085,2,1,336564,336564,336565,0,1,1
96086,5,3,336569,336569,336572,0,3,4
96087,1,1,336570,336572,336573,2,3,0
96088,4,2,336574,336574,336576,0,2,1
96089,4,3,336578,336578,336581,0,3,2
96090,2,2,336580,336581,336583,1,3,0
96091,6,3,336586,336586,336589,0,3,3
96092,6,1,336592,336592,336593,0,1,3
96093,2,1,336594,336594,336595,0,1,1
96094,5,2,336599,336599,336601,0,2,4
96095,2,1,336601,336601,336602,0,1,0
96096,5,2,336606,336606,336608,0,2,4
96097,3,1,336609,336609,336610,0,1,1
96098,2,3,336611,336611,336614,0,3,1
96099,6,2,336617,336617,336619,0,2,3
96100,3,2,336620,336620,336622,0,2,1
96101,2,2,336622,336622,336624,0,2,0
96102,3,1,336625,336625,336626,0,1,1
96103,1,3,336626,336626,336629,0,3,0
96104,5,2,336631,336631,336633,0,2,2
96105,1,1,336632,336633,336634,1,2,0
96106,5,2,336637,336637,336639,0,2,3
96107,1,3,336638,336639,336642,1,4,0
96108,4,1,336642,336642,336643,0,1,0
96109,1,2,336643,336643,336645,0,2,0
96110,4,2,336647,336647,336649,0,2,2
96111,5,3,336652,336652,336655,0,3,3
96112,4,1,336656,336656,336657,0,1,1
96113,3,3,336659,336659,336662,0,3,2
96114,4,2,336663,336663,336665,0,2,1
96115,5,3,336668,336668,336671,0,3,3
96116,2,1,336670,336671,336672,1,2,0
96117,2,2,336672,336672,336674,0,2,0
96118,6,2,336678,336678,336680,0,2,4
96119,3,3,336681,336681,336684,0,3,1
96120,6,1,336687,336687,336688,0,1,3
96121,5,1,336692,336692,336693,0,1,4
96122,4,3,336696,336696,336699,0,3,3
96123,5,1,336701,336701,336702,0,1,2
96124,3,2,336704,336704,336706,0,2,2
96125,5,1,336709,336709,336710,0,1,3
96126,1,1,336710,336710,336711,0,1,0
96127,2,3,336712,336712,336715,0,3,1
96128,3,1,336715,336715,336716,0,1,0
96129,4,1,336719,336719,336720,0,1,3
96130,1,3,336720,336720,336723,0,3,0
96131,4,1,336724,336724,336725,0,1,1
96132,4,2,336728,336728,336730,0,2,3
96133,6,1,336734,336734,336735,0,1,4
96134,6,1,336740,336740,336741,0,1,5
96135,3,3,336743,336743,336746,0,3,2
96136,4,3,336747,336747,336750,0,3,1
96137,4,3,336751,336751,336754,0,3,1
96138,5,1,336756,336756,336757,0,1,2
96139,3,1,336759,336759,336760,0,1,2
96140,1,3,336760,336760,336763,0,3,0
96141,4,1,336764,336764,336765,0,1,1
96142,2,2,336766,336766,336768,0,2,1
96143,5,2,336771,336771,336773,0,2,3
96144,4,3,336775,336775,336778,0,3,2
96145,4,2,336779,336779,336781,0,2,1
96146,5,3,336784,336784,336787,0,3,3
96147,1,3,336785,336787,336790,2,5,0
96148,6,2,336791,336791,336793,0,2,1
96149,4,2,336795,336795,336797,0,2,2
96150,4,2,336799,336799,336801,0,2,2
96151,6,1,336805,336805,336806,0,1,4
96152,1,3,336806,336806,336809,0,3,0
96153,4,3,336810,336810,336813,0,3,1
96154,6,2,336816,336816,336818,0,2,3
96155,1,2,336817,336818,336820,1,3,0
96156,4,2,336821,336821,336823,0,2,1
96157,4,1,336825,336825,336826,0,1,2
96158,1,2,336826,336826,336828,0,2,0
96159,5,1,336831,336831,336832,0,1,3
96160,2,1,336833,336833,336834,0,1,1
96161,4,1,336837,336837,336838,0,1,3
96162,4,1,336841,336841,336842,0,1,3
96163,4,1,336845,336845,336846,0,1,3
96164,1,1,336846,336846,336847,0,1,0
96165,6,2,336852,336852,336854,0,2,5
96166,4,3,336856,336856,336859,0,3,2
96167,4,3,336860,336860,336863,0,3,1
96168,2,1,336862,336863,336864,1,2,0
96169,4,1,336866,336866,336867,0,1,2
96170,1,1,336867,336867,336868,0,1,0
96171,6,2,336873,336873,336875,0,2,5
96172,5,2,336878,336878,336880,0,2,3
96173,1,1,336879,336880,336881,1,2,0
96174,6,2,336885,336885,336887,0,2,4
96175,6,1,336891,336891,336892,0,1,4
96176,1,3,336892,336892,336895,0,3,0
96177,5,3,336897,336897,336900,0,3,2
96178,6,1,336903,336903,336904,0,1,3
96179,2,1,336905,336905,336906,0,1,1
96180,6,2,336911,336911,336913,0,2,5
96181,2,2,336913,336913,336915,0,2,0
96182,5,3,336918,336918,336921,0,3,3
96183,3,3,336921,336921,336924,0,3,0
96184,6,1,336927,336927,336928,0,1,3
96185,2,1,336929,336929,336930,0,1,1
96186,2,2,336931,336931,336933,0,2,1
96187,5,1,336936,336936,336937,0,1,3
96188,6,1,336942,336942,336943,0,1,5
96189,6,1,336948,336948,336949,0,1,5
96190,6,1,336954,336954,336955,0,1,5
96191,3,1,336957,336957,336958,0,1,2
96192,2,1,336959,336959,336960,0,1,1
96193,2,1,336961,336961,336962,0,1,1
96194,6,1,336967,336967,336968,0,1,5
96195,6,1,336973,336973,336974,0,1,5
96196,4,1,336977,336977,336978,0,1,3
96197,1,1,336978,336978,336979,0,1,0
96198,5,2,336983,336983,336985,0,2,4
96199,4,1,336987,336987,336988,0,1,2
96200,2,1,336989,336989,336990,0,1,1
96201,2,2,336991,336991,336993,0,2,1
96202,1,2,336992,336993,336995,1,3,0
96203,2,1,336994,336995,336996,1,2,0
96204,4,2,336998,336998,337000,0,2,2
96205,5,3,337003,337003,337006,0,3,3
96206,1,2,337004,337006,337008,2,4,0
96207,1,2,337005,337008,337010,3,5,0
96208,6,3,337011,337011,337014,0,3,1
96209,5,2,337016,337016,337018,0,2,2
96210,5,2,337021,337021,337023,0,2,3
96211,5,1,337026,337026,337027,0,1,3
96212,2,1,337028,337028,337029,0,1,1
96213,6,3,337034,337034,337037,0,3,5
96214,4,2,337038,337038,337040,0,2,1
96215,4,2,337042,337042,337044,0,2,2
96216,6,1,337048,337048,337049,0,1,4
96217,6,1,337054,337054,337055,0,1,5
96218,5,2,337059,337059,337061,0,2,4
96219,4,2,337063,337063,337065,0,2,2
96220,6,3,337069,337069,337072,0,3,4
96221,3,1,337072,337072,337073,0,1,0
96222,4,2,337076,337076,337078,0,2,3
96223,5,3,337081,337081,337084,0,3,3
96224,4,3,337085,337085,337088,0,3,1
96225,3,2,337088,337088,337090,0,2,0
96226,1,3,337089,337090,337093,1,4,0
96227,6,2,337095,337095,337097,0,2,2
96228,1,3,337096,337097,337100,1,4,0
96229,3,2,337099,337100,337102,1,3,0
96230,2,3,337101,337102,337105,1,4,0
96231,4,1,337105,337105,337106,0,1,0
96232,2,1,337107,337107,337108,0,1,1
96233,2,1,337109,337109,337110,0,1,1
96234,2,2,337111,337111,337113,0,2,1
96235,3,2,337114,337114,337116,0,2,1
96236,1,3,337115,337116,337119,1,4,0
96237,1,3,337116,337119,337122,3,6,0
96238,5,2,337121,337122,337124,1,3,0
96239,3,2,337124,337124,337126,0,2,0
96240,5,3,337129,337129,337132,0,3,3
96241,3,2,337132,337132,337134,0,2,0
96242,1,1,337133,337134,337135,1,2,0
96243,4,3,337137,337137,337140,0,3,2
96244,3,3,337140,337140,337143,0,3,0
96245,3,1,337143,337143,337144,0,1,0
96246,5,2,337148,337148,337150,0,2,4
96247,5,1,337153,337153,337154,0,1,3
96248,3,2,337156,337156,337158,0,2,2
96249,6,2,337162,337162,337164,0,2,4
96250,2,2,337164,337164,337166,0,2,0
96251,5,1,337169,337169,337170,0,1,3
96252,1,1,337170,337170,337171,0,1,0
96253,2,1,337172,337172,337173,0,1,1
96254,4,3,337176,337176,337179,0,3,3
96255,5,3,337181,337181,337184,0,3,2
96256,1,2,337182,337184,337186,2,4,0
96257,3,3,337185,337186,337189,1,4,0
96258,1,3,337186,337189,337192,3,6,0
96259,1,1,337187,337192,337193,5,6,0
96260,6,3,337193,337193,337196,0,3,0
96261,3,1,337196,337196,337197,0,1,0
96262,1,1,337197,337197,337198,0,1,0
96263,6,3,337203,337203,337206,0,3,5
96264,4,2,337207,337207,337209,0,2,1
96265,5,1,337212,337212,337213,0,1,3
96266,6,3,337218,337218,337221,0,3,5
96267,6,1,337224,337224,337225,0,1,3
96268,4,3,337228,337228,337231,0,3,3
96269,5,1,337233,337233,337234,0,1,2
96270,3,2,337236,337236,337238,0,2,2
96271,3,1,337239,337239,337240,0,1,1
96272,2,1,337241,337241,337242,0,1,1
96273,5,3,337246,337246,337249,0,3,4
96274,6,3,337252,337252,337255,0,3,3
96275,1,2,337253,337255,337257,2,4,0
96276,5,3,337258,337258,337261,0,3,1
96277,4,2,337262,337262,337264,0,2,1
96278,1,1,337263,337264,337265,1,2,0
96279,6,3,337269,337269,337272,0,3,4
96280,2,3,337271,337272,337275,1,4,0
96281,3,3,337274,337275,337278,1,4,0
96282,6,1,337280,337280,337281,0,1,2
96283,2,2,337282,337282,337284,0,2,1
96284,2,2,337284,337284,337286,0,2,0
96285,4,1,337288,337288,337289,0,1,2
96286,6,1,337294,337294,337295,0,1,5
96287,3,1,337297,337297,337298,0,1,2
96288,5,1,337302,337302,337303,0,1,4
96289,1,3,337303,337303,337306,0,3,0
96290,5,1,337308,337308,337309,0,1,2
96291,5,1,337313,337313,337314,0,1,4
96292,3,3,337316,337316,337319,0,3,2
96293,4,1,337320,337320,337321,0,1,1
96294,3,1,337323,337323,337324,0,1,2
96295,6,1,337329,337329,337330,0,1,5
96296,2,2,337331,337331,337333,0,2,1
96297,4,3,337335,337335,337338,0,3,2
96298,6,3,337341,337341,337344,0,3,3
96299,1,2,337342,337344,337346,2,4,0
96300,6,1,337348,337348,337349,0,1,2
96301,4,3,337352,337352,337355,0,3,3
96302,3,3,337355,337355,337358,0,3,0
96303,6,3,337361,337361,337364,0,3,3
96304,1,1,337362,337364,337365,2,3,0
96305,2,2,337364,337365,337367,1,3,0
96306,5,2,337369,337369,337371,0,2,2
96307,5,3,337374,337374,337377,0,3,3
96308,6,2,337380,337380,337382,0,2,3
96309,5,2,337385,337385,337387,0,2,3
96310,3,1,337388,337388,337389,0,1,1
96311,1,3,337389,337389,337392,0,3,0
96312,3,1,337392,337392,337393,0,1,0
96313,5,3,337397,337397,337400,0,3,4
96314,1,2,337398,337400,337402,2,4,0
96315,1,1,337399,337402,337403,3,4,0
96316,1,2,337400,337403,337405,3,5,0
96317,6,2,337406,337406,337408,0,2,1
96318,2,3,337408,337408,337411,0,3,0
96319,3,1,337411,337411,337412,0,1,0
96320,4,1,337415,337415,337416,0,1,3
96321,2,1,337417,337417,337418,0,1,1
96322,1,1,337418,337418,337419,0,1,0
96323,4,3,337422,337422,337425,0,3,3
96324,2,1,337424,337425,337426,1,2,0
96325,5,3,337429,337429,337432,0,3,3
96326,5,3,337434,337434,337437,0,3,2
96327,4,1,337438,337438,337439,0,1,1
96328,1,2,337439,337439,337441,0,2,0
96329,2,2,337441,337441,337443,0,2,0
96330,3,1,337444,337444,337445,0,1,1
96331,4,1,337448,337448,337449,0,1,3
96332,4,2,337452,337452,337454,0,2,3
96333,1,1,337453,337454,337455,1,2,0
96334,6,3,337459,337459,337462,0,3,4
96335,1,3,337460,337462,337465,2,5,0
96336,5,3,337465,337465,337468,0,3,0
96337,2,1,337467,337468,337469,1,2,0
96338,1,2,337468,337469,337471,1,3,0
96339,5,3,337473,337473,337476,0,3,2
96340,5,3,337478,337478,337481,0,3,2
96341,4,2,337482,337482,337484,0,2,1
96342,3,2,337485,337485,337487,0,2,1
96343,5,3,337490,337490,337493,0,3,3
96344,4,1,337494,337494,337495,0,1,1
96345,3,2,337497,337497,337499,0,2,2
96346,5,1,337502,337502,337503,0,1,3
96347,5,2,337507,337507,337509,0,2,4
96348,3,3,337510,337510,337513,0,3,1
96349,4,3,337514,337514,337517,0,3,1
96350,6,1,337520,337520,337521,0,1,3
96351,1,3,337521,337521,337524,0,3,0
96352,1,2,337522,337524,337526,2,4,0
96353,3,1,337525,337526,337527,1,2,0
96354,2,3,337527,337527,337530,0,3,0
96355,4,2,337531,337531,337533,0,2,1
96356,2,3,337533,337533,337536,0,3,0
96357,5,2,337538,337538,337540,0,2,2
96358,6,3,337544,337544,337547,0,3,4
96359,5,1,337549,337549,337550,0,1,2
96360,3,3,337552,337552,337555,0,3,2
96361,6,2,337558,337558,337560,0,2,3
96362,3,1,337561,337561,337562,0,1,1
96363,2,3,337563,337563,337566,0,3,1
96364,3,1,337566,337566,337567,0,1,0
96365,4,2,337570,337570,337572,0,2,3
96366,2,3,337572,337572,337575,0,3,0
96367,1,1,337573,337575,337576,2,3,0
96368,4,1,337577,337577,337578,0,1,1
96369,1,2,337578,337578,337580,0,2,0
96370,6,3,337584,337584,337587,0,3,4
96371,4,1,337588,337588,337589,0,1,1
96372,1,3,337589,337589,337592,0,3,0
96373,1,3,337590,337592,337595,2,5,0
96374,6,1,337596,337596,337597,0,1,1
96375,2,1,337598,337598,337599,0,1,1
96376,1,3,337599,337599,337602,0,3,0
96377,3,1,337602,337602,337603,0,1,0
96378,2,2,337604,337604,337606,0,2,1
96379,6,3,337610,337610,337613,0,3,4
96380,5,3,337615,337615,337618,0,3,2
96381,5,3,337620,337620,337623,0,3,2
96382,5,2,337625,337625,337627,0,2,2
96383,3,1,337628,337628,337629,0,1,1
96384,6,3,337634,337634,337637,0,3,5
96385,6,2,337640,337640,337642,0,2,3
96386,4,2,337644,337644,337646,0,2,2
96387,1,1,337645,337646,337647,1,2,0
96388,1,2,337646,337647,337649,1,3,0
96389,2,2,337648,337649,337651,1,3,0
96390,2,1,337650,337651,337652,1,2,0
96391,5,3,337655,337655,337658,0,3,3
96392,1,3,337656,337658,337661,2,5,0
96393,4,1,337660,337661,337662,1,2,0
96394,1,1,337661,337662,337663,1,2,0
96395,4,1,337665,337665,337666,0,1,2
96396,5,3,337670,337670,337673,0,3,4
96397,6,1,337676,337676,337677,0,1,3
96398,5,1,337681,337681,337682,0,1,4
96399,2,1,337683,337683,337684,0,1,1
96400,3,2,337686,337686,337688,0,2,2
96401,4,1,337690,337690,337691,0,1,2
96402,3,3,337693,337693,337696,0,3,2
96403,5,2,337698,337698,337700,0,2,2
96404,3,3,337701,337701,337704,0,3,1
96405,5,1,337706,337706,337707,0,1,2
96406,2,3,337708,337708,337711,0,3,1
96407,5,1,337713,337713,337714,0,1,2
96408,2,3,337715,337715,337718,0,3,1
96409,5,2,337720,337720,337722,0,2,2
96410,2,1,337722,337722,337723,0,1,0
96411,5,2,337727,337727,337729,0,2,4
96412,3,3,337730,337730,337733,0,3,1
96413,4,1,337734,337734,337735,0,1,1
96414,5,2,337739,337739,337741,0,2,4
96415,6,3,337745,337745,337748,0,3,4
96416,6,3,337751,337751,337754,0,3,3
96417,5,1,337756,337756,337757,0,1,2
96418,6,2,337762,337762,337764,0,2,5
96419,1,2,337763,337764,337766,1,3,0
96420,1,3,337764,337766,337769,2,5,0
96421,2,2,337766,337769,337771,3,5,0
96422,3,1,337769,337771,337772,2,3,0
96423,3,3,337772,337772,337775,0,3,0
96424,1,1,337773,337775,337776,2,3,0
96425,2,1,337775,337776,337777,1,2,0
96426,3,2,337778,337778,337780,0,2,1
96427,4,3,337782,337782,337785,0,3,2
96428,2,2,337784,337785,337787,1,3,0
96429,4,2,337788,337788,337790,0,2,1
96430,2,2,337790,337790,337792,0,2,0
96431,6,2,337796,337796,337798,0,2,4
96432,4,2,337800,337800,337802,0,2,2
96433,2,1,337802,337802,337803,0,1,0
96434,3,1,337805,337805,337806,0,1,2
96435,1,3,337806,337806,337809,0,3,0
96436,2,1,337808,337809,337810,1,2,0
96437,6,1,337814,337814,337815,0,1,4
96438,4,3,337818,337818,337821,0,3,3
96439,4,2,337822,337822,337824,0,2,1
96440,4,2,337826,337826,337828,0,2,2
96441,1,2,337827,337828,337830,1,3,0
96442,6,1,337833,337833,337834,0,1,3
96443,6,2,337839,337839,337841,0,2,5
96444,5,3,337844,337844,337847,0,3,3
96445,5,3,337849,337849,337852,0,3,2
96446,6,2,337855,337855,337857,0,2,3
96447,4,1,337859,337859,337860,0,1,2
96448,4,1,337863,337863,337864,0,1,3
96449,4,3,337867,337867,337870,0,3,3
96450,2,3,337869,337870,337873,1,4,0
96451,1,2,337870,337873,337875,3,5,0
96452,5,3,337875,337875,337878,0,3,0
96453,4,3,337879,337879,337882,0,3,1
96454,4,2,337883,337883,337885,0,2,1
96455,3,1,337886,337886,337887,0,1,1
96456,5,2,337891,337891,337893,0,2,4
96457,4,3,337895,337895,337898,0,3,2
96458,2,2,337897,337898,337900,1,3,0
96459,1,2,337898,337900,337902,2,4,0
96460,4,2,337902,337902,337904,0,2,0
96461,2,3,337904,337904,337907,0,3,0
96462,4,3,337908,337908,337911,0,3,1
96463,4,1,337912,337912,337913,0,1,1
96464,5,1,337917,337917,337918,0,1,4
96465,5,1,337922,337922,337923,0,1,4
96466,3,1,337925,337925,337926,0,1,2
96467,6,1,337931,337931,337932,0,1,5
96468,6,2,337937,337937,337939,0,2,5
96469,3,1,337940,337940,337941,0,1,1
96470,2,2,337942,337942,337944,0,2,1
96471,1,2,337943,337944,337946,1,3,0
96472,3,1,337946,337946,337947,0,1,0
96473,3,3,337949,337949,337952,0,3,2
96474,2,2,337951,337952,337954,1,3,0
96475,5,2,337956,337956,337958,0,2,2
96476,6,2,337962,337962,337964,0,2,4
96477,6,3,337968,337968,337971,0,3,4
96478,4,2,337972,337972,337974,0,2,1
96479,1,3,337973,337974,337977,1,4,0
96480,5,3,337978,337978,337981,0,3,1
96481,5,2,337983,337983,337985,0,2,2
96482,4,2,337987,337987,337989,0,2,2
96483,5,2,337992,337992,337994,0,2,3
96484,3,3,337995,337995,337998,0,3,1
96485,4,2,337999,337999,338001,0,2,1
96486,4,2,338003,338003,338005,0,2,2
96487,2,3,338005,338005,338008,0,3,0
96488,6,3,338011,338011,338014,0,3,3
96489,3,2,338014,338014,338016,0,2,0
96490,5,3,338019,338019,338022,0,3,3
96491,1,3,338020,338022,338025,2,5,0
96492,1,3,338021,338025,338028,4,7,0
96493,2,2,338023,338028,338030,5,7,0
96494,4,3,338027,338030,338033,3,6,0
96495,6,1,338033,338033,338034,0,1,0
96496,4,2,338037,338037,338039,0,2,3
96497,4,2,338041,338041,338043,0,2,2
96498,3,2,338044,338044,338046,0,2,1
96499,1,3,338045,338046,338049,1,4,0
96500,2,2,338047,338049,338051,2,4,0
96501,6,3,338053,338053,338056,0,3,2
96502,6,1,338059,338059,338060,0,1,3
96503,4,3,338063,338063,338066,0,3,3
96504,3,3,338066,338066,338069,0,3,0
96505,6,3,338072,338072,338075,0,3,3
96506,1,1,338073,338075,338076,2,3,0
96507,2,3,338075,338076,338079,1,4,0
96508,2,1,338077,338079,338080,2,3,0
96509,5,1,338082,338082,338083,0,1,2
96510,5,3,338087,338087,338090,0,3,4
96511,5,2,338092,338092,338094,0,2,2
96512,2,2,338094,338094,338096,0,2,0
96513,3,2,338097,338097,338099,0,2,1
96514,5,3,338102,338102,338105,0,3,3
96515,6,2,338108,338108,338110,0,2,3
96516,4,1,338112,338112,338113,0,1,2
96517,2,3,338114,338114,338117,0,3,1
96518,4,2,338118,338118,338120,0,2,1
96519,1,2,338119,338120,338122,1,3,0
96520,3,3,338122,338122,338125,0,3,0
96521,6,2,338128,338128,338130,0,2,3
96522,3,2,338131,338131,338133,0,2,1
96523,2,1,338133,338133,338134,0,1,0
96524,4,1,338137,338137,338138,0,1,3
96525,5,1,338142,338142,338143,0,1,4
96526,5,2,338147,338147,338149,0,2,4
96527,4,1,338151,338151,338152,0,1,2
96528,3,3,338154,338154,338157,0,3,2
96529,1,2,338155,338157,338159,2,4,0
96530,4,1,338159,338159,338160,0,1,0
96531,4,1,338163,338163,338164,0,1,3
96532,4,1,338167,338167,338168,0,1,3
96533,2,3,338169,338169,338172,0,3,1
96534,3,1,338172,338172,338173,0,1,0
96535,3,3,338175,338175,338178,0,3,2
96536,5,2,338180,338180,338182,0,2,2
96537,5,1,338185,338185,338186,0,1,3
96538,6,2,338191,338191,338193,0,2,5
96539,4,1,338195,338195,338196,0,1,2
96540,1,1,338196,338196,338197,0,1,0
96541,2,3,338198,338198,338201,0,3,1
96542,2,3,338200,338201,338204,1,4,0
96543,6,2,338206,338206,338208,0,2,2
96544,6,1,338212,338212,338213,0,1,4
96545,6,3,338218,338218,338221,0,3,5
96546,3,2,338221,338221,338223,0,2,0
96547,5,1,338226,338226,338227,0,1,3
96548,5,2,338231,338231,338233,0,2,4
96549,4,2,338235,338235,338237,0,2,2
96550,1,2,338236,338237,338239,1,3,0
96551,5,2,338241,338241,338243,0,2,2
96552,2,1,338243,338243,338244,0,1,0
96553,3,1,338246,338246,338247,0,1,2
96554,1,2,338247,338247,338249,0,2,0
96555,2,2,338249,338249,338251,0,2,0
96556,4,3,338253,338253,338256,0,3,2
96557,2,2,338255,338256,338258,1,3,0
96558,3,2,338258,338258,338260,0,2,0
96559,1,3,338259,338260,338263,1,4,0
96560,5,2,338264,338264,338266,0,2,1
96561,1,1,338265,338266,338267,1,2,0
96562,4,1,338269,338269,338270,0,1,2
96563,3,1,338272,338272,338273,0,1,2
96564,6,2,338278,338278,338280,0,2,5
96565,1,3,338279,338280,338283,1,4,0
96566,2,2,338281,338283,338285,2,4,0
96567,3,3,338284,338285,338288,1,4,0
96568,3,2,338287,338288,338290,1,3,0
96569,2,3,338289,338290,338293,1,4,0
96570,1,1,338290,338293,338294,3,4,0
96571,5,3,338295,338295,338298,0,3,1
96572,2,2,338297,338298,338300,1,3,0
96573,5,2,338302,338302,338304,0,2,2
96574,1,3,338303,338304,338307,1,4,0
96575,4,1,338307,338307,338308,0,1,0
96576,1,1,338308,338308,338309,0,1,0
96577,6,2,338314,338314,338316,0,2,5
96578,3,1,338317,338317,338318,0,1,1
96579,1,1,338318,338318,338319,0,1,0
96580,5,2,338323,338323,338325,0,2,4
96581,5,3,338328,338328,338331,0,3,3
96582,2,3,338330,338331,338334,1,4,0
96583,6,1,338336,338336,338337,0,1,2
96584,5,2,338341,338341,338343,0,2,4
96585,6,2,338347,338347,338349,0,2,4
96586,5,3,338352,338352,338355,0,3,3
96587,4,3,338356,338356,338359,0,3,1
96588,6,3,338362,338362,338365,0,3,3
96589,6,2,338368,338368,338370,0,2,3
96590,4,2,338372,338372,338374,0,2,2
96591,1,2,338373,338374,338376,1,3,0
96592,6,2,338379,338379,338381,0,2,3
96593,6,2,338385,338385,338387,0,2,4
96594,5,3,338390,338390,338393,0,3,3
96595,3,1,338393,338393,338394,0,1,0
96596,5,1,338398,338398,338399,0,1,4
96597,1,1,338399,338399,338400,0,1,0
96598,6,3,338405,338405,338408,0,3,5
96599,2,3,338407,338408,338411,1,4,0
96600,4,3,338411,338411,338414,0,3,0
96601,5,2,338416,338416,338418,0,2,2
96602,4,2,338420,338420,338422,0,2,2
96603,5,1,338425,338425,338426,0,1,3
96604,1,3,338426,338426,338429,0,3,0
96605,2,2,338428,338429,338431,1,3,0
96606,3,3,338431,338431,338434,0,3,0
96607,3,1,338434,338434,338435,0,1,0
96608,5,3,338439,338439,338442,0,3,4
96609,3,2,338442,338442,338444,0,2,0
96610,5,3,338447,338447,338450,0,3,3
96611,4,2,338451,338451,338453,0,2,1
96612,3,3,338454,338454,338457,0,3,1
96613,1,3,338455,338457,338460,2,5,0
96614,3,1,338458,338460,338461,2,3,0
96615,3,2,338461,338461,338463,0,2,0
96616,4,3,338465,338465,338468,0,3,2
96617,3,3,338468,338468,338471,0,3,0
96618,2,3,338470,338471,338474,1,4,0
96619,5,2,338475,338475,338477,0,2,1
96620,4,3,338479,338479,338482,0,3,2
96621,6,1,338485,338485,338486,0,1,3
96622,3,2,338488,338488,338490,0,2,2
96623,3,3,338491,338491,338494,0,3,1
96624,6,3,338497,338497,338500,0,3,3
96625,3,1,338500,338500,338501,0,1,0
96626,5,1,338505,338505,338506,0,1,4
96627,3,3,338508,338508,338511,0,3,2
96628,3,1,338511,338511,338512,0,1,0
96629,3,3,338514,338514,338517,0,3,2
96630,3,2,338517,338517,338519,0,2,0
96631,4,1,338521,338521,338522,0,1,2
96632,1,3,338522,338522,338525,0,3,0
96633,4,3,338526,338526,338529,0,3,1
96634,5,2,338531,338531,338533,0,2,2
96635,4,3,338535,338535,338538,0,3,2
96636,6,3,338541,338541,338544,0,3,3
96637,2,1,338543,338544,338545,1,2,0
96638,1,3,338544,338545,338548,1,4,0
96639,3,2,338547,338548,338550,1,3,0
96640,5,2,338552,338552,338554,0,2,2
96641,1,3,338553,338554,338557,1,4,0
96642,5,2,338558,338558,338560,0,2,1
96643,2,1,338560,338560,338561,0,1,0
96644,3,2,338563,338563,338565,0,2,2
96645,5,3,338568,338568,338571,0,3,3
96646,5,1,338573,338573,338574,0,1,2
96647,2,3,338575,338575,338578,0,3,1
96648,4,3,338579,338579,338582,0,3,1
96649,2,3,338581,338582,338585,1,4,0
96650,5,3,338586,338586,338589,0,3,1
96651,3,3,338589,338589,338592,0,3,0
96652,2,3,338591,338592,338595,1,4,0
96653,2,3,338593,338595,338598,2,5,0
96654,2,1,338595,338598,338599,3,4,0
96655,1,2,338596,338599,338601,3,5,0
96656,4,3,338600,338601,338604,1,4,0
96657,1,2,338601,338604,338606,3,5,0
96658,2,2,338603,338606,338608,3,5,0
96659,6,2,338609,338609,338611,0,2,1
96660,4,3,338613,338613,338616,0,3,2
96661,2,2,338615,338616,338618,1,3,0
96662,5,2,338620,338620,338622,0,2,2
96663,4,2,338624,338624,338626,0,2,2
96664,5,2,338629,338629,338631,0,2,3
96665,5,2,338634,338634,338636,0,2,3
96666,4,2,338638,338638,338640,0,2,2
96667,2,1,338640,338640,338641,0,1,0
96668,4,1,338644,338644,338645,0,1,3
96669,2,2,338646,338646,338648,0,2,1
96670,4,2,338650,338650,338652,0,2,2
96671,5,1,338655,338655,338656,0,1,3
96672,2,3,338657,338657,338660,0,3,1
96673,6,1,338663,338663,338664,0,1,3
96674,5,2,338668,338668,338670,0,2,4
96675,1,1,338669,338670,338671,1,2,0
96676,2,3,338671,338671,338674,0,3,0
96677,4,1,338675,338675,338676,0,1,1
96678,6,1,338681,338681,338682,0,1,5
96679,2,2,338683,338683,338685,0,2,1
96680,1,1,338684,338685,338686,1,2,0
96681,3,2,338687,338687,338689,0,2,1
96682,2,1,338689,338689,338690,0,1,0
96683,5,3,338694,338694,338697,0,3,4
96684,2,3,338696,338697,338700,1,4,0
96685,4,1,338700,338700,338701,0,1,0
96686,2,2,338702,338702,338704,0,2,1
96687,4,1,338706,338706,338707,0,1,2
96688,3,2,338709,338709,338711,0,2,2
96689,1,1,338710,338711,338712,1,2,0
96690,3,3,338713,338713,338716,0,3,1
96691,3,3,338716,338716,338719,0,3,0
96692,3,3,338719,338719,338722,0,3,0
96693,5,3,338724,338724,338727,0,3,2
96694,1,2,338725,338727,338729,2,4,0
96695,4,3,338729,338729,338732,0,3,0
96696,4,2,338733,338733,338735,0,2,1
96697,2,3,338735,338735,338738,0,3,0
96698,2,1,338737,338738,338739,1,2,0
96699,1,3,338738,338739,338742,1,4,0
96700,6,1,338744,338744,338745,0,1,2
96701,4,2,338748,338748,338750,0,2,3
96702,6,1,338754,338754,338755,0,1,4
96703,4,2,338758,338758,338760,0,2,3
96704,2,1,338760,338760,338761,0,1,0
96705,4,1,338764,338764,338765,0,1,3
96706,5,2,338769,338769,338771,0,2,4
96707,3,2,338772,338772,338774,0,2,1
96708,3,1,338775,338775,338776,0,1,1
96709,6,2,338781,338781,338783,0,2,5
96710,1,2,338782,338783,338785,1,3,0
96711,5,3,338787,338787,338790,0,3,2
96712,4,3,338791,338791,338794,0,3,1
96713,2,1,338793,338794,338795,1,2,0
96714,5,3,338798,338798,338801,0,3,3
96715,4,3,338802,338802,338805,0,3,1
96716,6,2,338808,338808,338810,0,2,3
96717,5,2,338813,338813,338815,0,2,3
96718,3,1,338816,338816,338817,0,1,1
96719,4,2,338820,338820,338822,0,2,3
96720,2,2,338822,338822,338824,0,2,0
96721,5,3,338827,338827,338830,0,3,3
96722,2,1,338829,338830,338831,1,2,0
96723,3,3,338832,338832,338835,0,3,1
96724,3,2,338835,338835,338837,0,2,0
96725,4,2,338839,338839,338841,0,2,2
96726,4,3,338843,338843,338846,0,3,2
96727,5,2,338848,338848,338850,0,2,2
96728,3,2,338851,338851,338853,0,2,1
96729,4,2,338855,338855,338857,0,2,2
96730,2,3,338857,338857,338860,0,3,0
96731,3,1,338860,338860,338861,0,1,0
96732,4,3,338864,338864,338867,0,3,3
96733,5,1,338869,338869,338870,0,1,2
96734,6,2,338875,338875,338877,0,2,5
96735,5,3,338880,338880,338883,0,3,3
96736,4,2,338884,338884,338886,0,2,1
96737,1,2,338885,338886,338888,1,3,0
96738,4,2,338889,338889,338891,0,2,1
96739,6,1,338895,338895,338896,0,1,4
96740,6,3,338901,338901,338904,0,3,5
96741,3,3,338904,338904,338907,0,3,0
96742,4,2,338908,338908,338910,0,2,1
96743,2,2,338910,338910,338912,0,2,0
96744,4,3,338914,338914,338917,0,3,2
96745,1,3,338915,338917,338920,2,5,0
96746,5,2,338920,338920,338922,0,2,0
96747,5,1,338925,338925,338926,0,1,3
96748,5,2,338930,338930,338932,0,2,4
96749,6,3,338936,338936,338939,0,3,4
96750,3,1,338939,338939,338940,0,1,0
96751,4,1,338943,338943,338944,0,1,3
96752,4,2,338947,338947,338949,0,2,3
96753,6,1,338953,338953,338954,0,1,4
96754,6,1,338959,338959,338960,0,1,5
96755,4,2,338963,338963,338965,0,2,3
96756,6,1,338969,338969,338970,0,1,4
96757,6,1,338975,338975,338976,0,1,5
96758,5,1,338980,338980,338981,0,1,4
96759,2,2,338982,338982,338984,0,2,1
96760,4,3,338986,338986,338989,0,3,2
96761,3,2,338989,338989,338991,0,2,0
96762,2,2,338991,338991,338993,0,2,0
96763,4,2,338995,338995,338997,0,2,2
96764,6,1,339001,339001,339002,0,1,4
96765,1,1,339002,339002,339003,0,1,0
96766,6,2,339008,339008,339010,0,2,5
96767,2,3,339010,339010,339013,0,3,0
96768,5,2,339015,339015,339017,0,2,2
96769,5,2,339020,339020,339022,0,2,3
96770,2,2,339022,339022,339024,0,2,0
96771,1,3,339023,339024,339027,1,4,0
96772,5,3,339028,339028,339031,0,3,1
96773,3,1,339031,339031,339032,0,1,0
96774,6,1,339037,339037,339038,0,1,5
96775,4,2,339041,339041,339043,0,2,3
96776,2,2,339043,339043,339045,0,2,0
96777,6,3,339049,339049,339052,0,3,4
96778,5,1,339054,339054,339055,0,1,2
96779,5,1,339059,339059,339060,0,1,4
96780,1,1,339060,339060,339061,0,1,0
96781,1,2,339061,339061,339063,0,2,0
96782,1,1,339062,339063,339064,1,2,0
96783,2,3,339064,339064,339067,0,3,0
96784,1,3,339065,339067,339070,2,5,0
96785,4,1,339069,339070,339071,1,2,0
96786,5,1,339074,339074,339075,0,1,3
96787,5,1,339079,339079,339080,0,1,4
96788,1,1,339080,339080,339081,0,1,0
96789,4,3,339084,339084,339087,0,3,3
96790,3,2,339087,339087,339089,0,2,0
96791,2,1,339089,339089,339090,0,1,0
96792,6,3,339095,339095,339098,0,3,5
96793,2,1,339097,339098,339099,1,2,0
96794,4,2,339101,339101,339103,0,2,2
96795,5,3,339106,339106,339109,0,3,3
96796,4,2,339110,339110,339112,0,2,1
96797,5,2,339115,339115,339117,0,2,3
96798,2,2,339117,339117,339119,0,2,0
96799,2,3,339119,339119,339122,0,3,0
96800,5,2,339124,339124,339126,0,2,2
96801,5,1,339129,339129,339130,0,1,3
96802,1,1,339130,339130,339131,0,1,0
96803,4,1,339134,339134,339135,0,1,3
96804,1,3,339135,339135,339138,0,3,0
96805,6,3,339141,339141,339144,0,3,3
96806,2,1,339143,339144,339145,1,2,0
96807,1,3,339144,339145,339148,1,4,0
96808,5,2,339149,339149,339151,0,2,1
96809,5,1,339154,339154,339155,0,1,3
96810,4,1,339158,339158,339159,0,1,3
96811,2,1,339160,339160,339161,0,1,1
96812,5,2,339165,339165,339167,0,2,4
96813,2,1,339167,339167,339168,0,1,0
96814,4,3,339171,339171,339174,0,3,3
96815,2,1,339173,339174,339175,1,2,0
96816,6,2,339179,339179,339181,0,2,4
96817,4,3,339183,339183,339186,0,3,2
96818,6,1,339189,339189,339190,0,1,3
96819,3,1,339192,339192,339193,0,1,2
96820,2,3,339194,339194,339197,0,3,1
96821,6,1,339200,339200,339201,0,1,3
96822,5,1,339205,339205,339206,0,1,4
96823,5,2,339210,339210,339212,0,2,4
96824,4,1,339214,339214,339215,0,1,2
96825,1,2,339215,339215,339217,0,2,0
96826,1,1,339216,339217,339218,1,2,0
96827,1,3,339217,339218,339221,1,4,0
96828,5,1,339222,339222,339223,0,1,1
96829,3,1,339225,339225,339226,0,1,2
96830,2,2,339227,339227,339229,0,2,1
96831,1,1,339228,339229,339230,1,2,0
96832,5,1,339233,339233,339234,0,1,3
96833,4,3,339237,339237,339240,0,3,3
96834,4,3,339241,339241,339244,0,3,1
96835,4,2,339245,339245,339247,0,2,1
96836,5,1,339250,339250,339251,0,1,3
96837,2,3,339252,339252,339255,0,3,1
96838,6,1,339258,339258,339259,0,1,3
96839,2,3,339260,339260,339263,0,3,1
96840,3,1,339263,339263,339264,0,1,0
96841,5,3,339268,339268,339271,0,3,4
96842,1,3,339269,339271,339274,2,5,0
96843,2,2,339271,339274,339276,3,5,0
96844,4,1,339275,339276,339277,1,2,0
96845,1,1,339276,339277,339278,1,2,0
96846,5,2,339281,339281,339283,0,2,3
96847,6,2,339287,339287,339289,0,2,4
96848,2,1,339289,339289,339290,0,1,0
96849,4,2,339293,339293,339295,0,2,3
96850,4,1,339297,339297,339298,0,1,2
96851,4,1,339301,339301,339302,0,1,3
96852,6,2,339307,339307,339309,0,2,5
96853,3,3,339310,339310,339313,0,3,1
96854,1,1,339311,339313,339314,2,3,0
96855,6,1,339317,339317,339318,0,1,3
96856,4,3,339321,339321,339324,0,3,3
96857,1,2,339322,339324,339326,2,4,0
96858,3,3,339325,339326,339329,1,4,0
96859,5,2,339330,339330,339332,0,2,1
96860,3,2,339333,339333,339335,0,2,1
96861,3,2,339336,339336,339338,0,2,1
96862,1,1,339337,339338,339339,1,2,0
96863,6,2,339343,339343,339345,0,2,4
96864,5,2,339348,339348,339350,0,2,3
96865,4,2,339352,339352,339354,0,2,2
96866,3,2,339355,339355,339357,0,2,1
96867,5,3,339360,339360,339363,0,3,3
96868,1,1,339361,339363,339364,2,3,0
96869,2,1,339363,339364,339365,1,2,0
96870,4,3,339367,339367,339370,0,3,2
96871,6,2,339373,339373,339375,0,2,3
96872,5,3,339378,339378,339381,0,3,3
96873,4,3,339382,339382,339385,0,3,1
96874,2,1,339384,339385,339386,1,2,0
96875,6,2,339390,339390,339392,0,2,4
96876,3,2,339393,339393,339395,0,2,1
96877,6,3,339399,339399,339402,0,3,4
96878,5,1,339404,339404,339405,0,1,2
96879,5,3,339409,339409,339412,0,3,4
96880,5,2,339414,339414,339416,0,2,2
96881,1,2,339415,339416,339418,1,3,0
96882,6,2,339421,339421,339423,0,2,3
96883,2,1,339423,339423,339424,0,1,0
96884,4,2,339427,339427,339429,0,2,3
96885,1,1,339428,339429,339430,1,2,0
96886,2,3,339430,339430,339433,0,3,0
96887,6,1,339436,339436,339437,0,1,3
96888,1,2,339437,339437,339439,0,2,0
96889,4,3,339441,339441,339444,0,3,2
96890,6,1,339447,339447,339448,0,1,3
96891,1,1,339448,339448,339449,0,1,0
96892,1,2,339449,339449,339451,0,2,0
96893,4,1,339453,339453,339454,0,1,2
96894,2,3,339455,339455,339458,0,3,1
96895,6,1,339461,339461,339462,0,1,3
96896,1,1,339462,339462,339463,0,1,0
96897,3,1,339465,339465,339466,0,1,2
96898,5,2,339470,339470,339472,0,2,4
96899,1,2,339471,339472,339474,1,3,0
96900,6,2,339477,339477,339479,0,2,3
96901,1,3,339478,339479,339482,1,4,0
96902,6,3,339484,339484,339487,0,3,2
96903,5,2,339489,339489,339491,0,2,2
96904,2,2,339491,339491,339493,0,2,0
96905,3,2,339494,339494,339496,0,2,1
96906,2,1,339496,339496,339497,0,1,0
96907,2,3,339498,339498,339501,0,3,1
96908,2,3,339500,339501,339504,1,4,0
96909,5,3,339505,339505,339508,0,3,1
96910,3,1,339508,339508,339509,0,1,0
96911,3,3,339511,339511,339514,0,3,2
96912,3,3,339514,339514,339517,0,3,0
96913,4,2,339518,339518,339520,0,2,1
96914,1,2,339519,339520,339522,1,3,0
96915,2,3,339521,339522,339525,1,4,0
96916,4,3,339525,339525,339528,0,3,0
96917,2,3,339527,339528,339531,1,4,0
96918,4,2,339531,339531,339533,0,2,0
96919,6,3,339537,339537,339540,0,3,4
96920,3,2,339540,339540,339542,0,2,0
96921,2,3,339542,339542,339545,0,3,0
96922,5,2,339547,339547,339549,0,2,2
96923,5,2,339552,339552,339554,0,2,3
96924,4,3,339556,339556,339559,0,3,2
96925,1,2,339557,339559,339561,2,4,0
96926,2,3,339559,339561,339564,2,5,0
96927,3,1,339562,339564,339565,2,3,0
96928,4,3,339566,339566,339569,0,3,1
96929,1,3,339567,339569,339572,2,5,0
96930,5,3,339572,339572,339575,0,3,0
96931,6,1,339578,339578,339579,0,1,3
96932,5,3,339583,339583,339586,0,3,4
96933,6,1,339589,339589,339590,0,1,3
96934,1,3,339590,339590,339593,0,3,0
96935,4,1,339594,339594,339595,0,1,1
96936,4,1,339598,339598,339599,0,1,3
96937,5,2,339603,339603,339605,0,2,4
96938,4,1,339607,339607,339608,0,1,2
96939,4,3,339611,339611,339614,0,3,3
96940,2,1,339613,339614,339615,1,2,0
96941,4,3,339617,339617,339620,0,3,2
96942,2,2,339619,339620,339622,1,3,0
96943,1,3,339620,339622,339625,2,5,0
96944,1,3,339621,339625,339628,4,7,0
96945,6,3,339627,339628,339631,1,4,0
96946,3,3,339630,339631,339634,1,4,0
96947,5,3,339635,339635,339638,0,3,1
96948,3,1,339638,339638,339639,0,1,0
96949,4,2,339642,339642,339644,0,2,3
96950,6,3,339648,339648,339651,0,3,4
96951,2,2,339650,339651,339653,1,3,0
96952,5,2,339655,339655,339657,0,2,2
96953,4,1,339659,339659,339660,0,1,2
96954,4,1,339663,339663,339664,0,1,3
96955,5,3,339668,339668,339671,0,3,4
96956,6,3,339674,339674,339677,0,3,3
96957,1,1,339675,339677,339678,2,3,0
96958,1,1,339676,339678,339679,2,3,0
96959,6,2,339682,339682,339684,0,2,3
96960,1,2,339683,339684,339686,1,3,0
96961,5,3,339688,339688,339691,0,3,2
96962,3,3,339691,339691,339694,0,3,0
96963,5,1,339696,339696,339697,0,1,2
96964,1,2,339697,339697,339699,0,2,0
96965,6,1,339703,339703,339704,0,1,4
96966,1,2,339704,339704,339706,0,2,0
96967,5,1,339709,339709,339710,0,1,3
96968,2,3,339711,339711,339714,0,3,1
96969,2,1,339713,339714,339715,1,2,0
96970,5,1,339718,339718,339719,0,1,3
96971,5,2,339723,339723,339725,0,2,4
96972,2,1,339725,339725,339726,0,1,0
96973,1,1,339726,339726,339727,0,1,0
96974,4,3,339730,339730,339733,0,3,3
96975,3,3,339733,339733,339736,0,3,0
96976,6,1,339739,339739,339740,0,1,3
96977,4,2,339743,339743,339745,0,2,3
96978,4,1,339747,339747,339748,0,1,2
96979,3,2,339750,339750,339752,0,2,2
96980,3,3,339753,339753,339756,0,3,1
96981,6,1,339759,339759,339760,0,1,3
96982,4,1,339763,339763,339764,0,1,3
96983,5,3,339768,339768,339771,0,3,4
96984,3,2,339771,339771,339773,0,2,0
96985,4,2,339775,339775,339777,0,2,2
96986,6,1,339781,339781,339782,0,1,4
96987,1,2,339782,339782,339784,0,2,0
96988,3,1,339785,339785,339786,0,1,1
96989,5,3,339790,339790,339793,0,3,4
96990,2,1,339792,339793,339794,1,2,0
96991,6,3,339798,339798,339801,0,3,4
96992,3,3,339801,339801,339804,0,3,0
96993,6,3,339807,339807,339810,0,3,3
96994,2,1,339809,339810,339811,1,2,0
96995,2,1,339811,339811,339812,0,1,0
96996,2,3,339813,339813,339816,0,3,1
96997,2,1,339815,339816,339817,1,2,0
96998,1,2,339816,339817,339819,1,3,0
96999,2,2,339818,339819,339821,1,3,0
97000,6,2,339824,339824,339826,0,2,3
97001,2,3,339826,339826,339829,0,3,0
97002,3,1,339829,339829,339830,0,1,0
97003,3,1,339832,339832,339833,0,1,2
97004,5,2,339837,339837,339839,0,2,4
97005,1,2,339838,339839,339841,1,3,0
97006,5,3,339843,339843,339846,0,3,2
97007,1,2,339844,339846,339848,2,4,0
97008,5,1,339849,339849,339850,0,1,1
97009,5,1,339854,339854,339855,0,1,4
97010,6,1,339860,339860,339861,0,1,5
97011,3,1,339863,339863,339864,0,1,2
97012,3,1,339866,339866,339867,0,1,2
97013,5,2,339871,339871,339873,0,2,4
97014,6,3,339877,339877,339880,0,3,4
97015,4,3,339881,339881,339884,0,3,1
97016,3,1,339884,339884,339885,0,1,0
97017,2,3,339886,339886,339889,0,3,1
97018,6,2,339892,339892,339894,0,2,3
97019,2,3,339894,339894,339897,0,3,0
97020,4,2,339898,339898,339900,0,2,1
97021,4,2,339902,339902,339904,0,2,2
97022,5,1,339907,339907,339908,0,1,3
97023,2,1,339909,339909,339910,0,1,1
97024,6,1,339915,339915,339916,0,1,5
97025,1,2,339916,339916,339918,0,2,0
97026,2,3,339918,339918,339921,0,3,0
97027,6,3,339924,339924,339927,0,3,3
97028,2,1,339926,339927,339928,1,2,0
97029,3,3,339929,339929,339932,0,3,1
97030,6,2,339935,339935,339937,0,2,3
97031,4,1,339939,339939,339940,0,1,2
97032,4,3,339943,339943,339946,0,3,3
97033,3,1,339946,339946,339947,0,1,0
97034,5,3,339951,339951,339954,0,3,4
97035,3,3,339954,339954,339957,0,3,0
97036,1,3,339955,339957,339960,2,5,0
97037,3,3,339958,339960,339963,2,5,0
97038,6,1,339964,339964,339965,0,1,1
97039,6,1,339970,339970,339971,0,1,5
97040,5,1,339975,339975,339976,0,1,4
97041,4,2,339979,339979,339981,0,2,3
97042,5,2,339984,339984,339986,0,2,3
97043,1,2,339985,339986,339988,1,3,0
97044,3,3,339988,339988,339991,0,3,0
97045,2,2,339990,339991,339993,1,3,0
97046,6,3,339996,339996,339999,0,3,3
97047,1,1,339997,339999,340000,2,3,0
97048,2,2,339999,340000,340002,1,3,0
97049,6,2,340005,340005,340007,0,2,3
97050,5,3,340010,340010,340013,0,3,3
97051,5,3,340015,340015,340018,0,3,2
97052,3,1,340018,340018,340019,0,1,0
97053,6,2,340024,340024,340026,0,2,5
97054,4,3,340028,340028,340031,0,3,2
97055,5,1,340033,340033,340034,0,1,2
97056,5,3,340038,340038,340041,0,3,4
97057,3,1,340041,340041,340042,0,1,0
97058,4,2,340045,340045,340047,0,2,3
97059,1,2,340046,340047,340049,1,3,0
97060,2,3,340048,340049,340052,1,4,0
97061,5,1,340053,340053,340054,0,1,1
97062,4,3,340057,340057,340060,0,3,3
97063,5,1,340062,340062,340063,0,1,2
97064,6,3,340068,340068,340071,0,3,5
97065,4,1,340072,340072,340073,0,1,1
97066,6,1,340078,340078,340079,0,1,5
97067,3,3,340081,340081,340084,0,3,2
97068,2,2,340083,340084,340086,1,3,0
97069,6,1,340089,340089,340090,0,1,3
97070,2,1,340091,340091,340092,0,1,1
97071,1,2,340092,340092,340094,0,2,0
97072,4,3,340096,340096,340099,0,3,2
97073,2,1,340098,340099,340100,1,2,0
97074,6,1,340104,340104,340105,0,1,4
97075,4,1,340108,340108,340109,0,1,3
97076,3,2,340111,340111,340113,0,2,2
97077,2,2,340113,340113,340115,0,2,0
97078,1,1,340114,340115,340116,1,2,0
97079,5,2,340119,340119,340121,0,2,3
97080,4,3,340123,340123,340126,0,3,2
97081,3,3,340126,340126,340129,0,3,0
97082,6,3,340132,340132,340135,0,3,3
97083,1,3,340133,340135,340138,2,5,0
97084,3,3,340136,340138,340141,2,5,0
97085,4,3,340140,340141,340144,1,4,0
97086,4,3,340144,340144,340147,0,3,0
97087,3,3,340147,340147,340150,0,3,0
97088,5,2,340152,340152,340154,0,2,2
97089,2,2,340154,340154,340156,0,2,0
97090,6,3,340160,340160,340163,0,3,4
97091,2,2,340162,340163,340165,1,3,0
97092,6,1,340168,340168,340169,0,1,3
97093,1,2,340169,340169,340171,0,2,0
97094,3,1,340172,340172,340173,0,1,1
97095,3,2,340175,340175,340177,0,2,2
97096,1,2,340176,340177,340179,1,3,0
97097,3,2,340179,340179,340181,0,2,0
97098,1,3,340180,340181,340184,1,4,0
97099,6,1,340186,340186,340187,0,1,2
97100,3,2,340189,340189,340191,0,2,2
97101,1,2,340190,340191,340193,1,3,0
97102,4,1,340194,340194,340195,0,1,1
97103,6,2,340200,340200,340202,0,2,5
97104,2,2,340202,340202,340204,0,2,0
97105,2,1,340204,340204,340205,0,1,0
97106,6,2,340210,340210,340212,0,2,5
97107,4,2,340214,340214,340216,0,2,2
97108,2,2,340216,340216,340218,0,2,0
97109,5,3,340221,340221,340224,0,3,3
97110,5,1,340226,340226,340227,0,1,2
97111,3,2,340229,340229,340231,0,2,2
97112,4,3,340233,340233,340236,0,3,2
97113,6,2,340239,340239,340241,0,2,3
97114,6,1,340245,340245,340246,0,1,4
97115,5,2,340250,340250,340252,0,2,4
97116,1,2,340251,340252,340254,1,3,0
97117,5,2,340256,340256,340258,0,2,2
97118,4,1,340260,340260,340261,0,1,2
97119,6,2,340266,340266,340268,0,2,5
97120,6,2,340272,340272,340274,0,2,4
97121,3,1,340275,340275,340276,0,1,1
97122,1,2,340276,340276,340278,0,2,0
97123,1,2,340277,340278,340280,1,3,0
97124,1,3,340278,340280,340283,2,5,0
97125,1,1,340279,340283,340284,4,5,0
97126,1,1,340280,340284,340285,4,5,0
97127,3,1,340283,340285,340286,2,3,0
97128,5,1,340288,340288,340289,0,1,2
97129,4,3,340292,340292,340295,0,3,3
97130,4,3,340296,340296,340299,0,3,1
97131,2,1,340298,340299,340300,1,2,0
97132,5,1,340303,340303,340304,0,1,3
97133,3,2,340306,340306,340308,0,2,2
97134,3,2,340309,340309,340311,0,2,1
97135,4,3,340313,340313,340316,0,3,2
97136,6,1,340319,340319,340320,0,1,3
97137,5,2,340324,340324,340326,0,2,4
97138,4,3,340328,340328,340331,0,3,2
97139,2,1,340330,340331,340332,1,2,0
97140,3,2,340333,340333,340335,0,2,1
97141,5,2,340338,340338,340340,0,2,3
97142,5,3,340343,340343,340346,0,3,3
97143,4,3,340347,340347,340350,0,3,1
97144,1,2,340348,340350,340352,2,4,0
97145,3,1,340351,340352,340353,1,2,0
97146,4,2,340355,340355,340357,0,2,2
97147,6,1,340361,340361,340362,0,1,4
97148,6,3,340367,340367,340370,0,3,5
97149,5,3,340372,340372,340375,0,3,2
97150,5,3,340377,340377,340380,0,3,2
97151,5,1,340382,340382,340383,0,1,2
97152,2,1,340384,340384,340385,0,1,1
97153,5,1,340389,340389,340390,0,1,4
97154,2,2,340391,340391,340393,0,2,1
97155,1,3,340392,340393,340396,1,4,0
97156,4,2,340396,340396,340398,0,2,0
97157,3,3,340399,340399,340402,0,3,1
97158,1,3,340400,340402,340405,2,5,0
97159,3,3,340403,340405,340408,2,5,0
97160,5,3,340408,340408,340411,0,3,0
97161,5,3,340413,340413,340416,0,3,2
97162,4,2,340417,340417,340419,0,2,1
97163,6,1,340423,340423,340424,0,1,4
97164,6,2,340429,340429,340431,0,2,5
97165,5,1,340434,340434,340435,0,1,3
97166,2,2,340436,340436,340438,0,2,1
97167,6,2,340442,340442,340444,0,2,4
97168,5,2,340447,340447,340449,0,2,3
97169,2,2,340449,340449,340451,0,2,0
97170,5,3,340454,340454,340457,0,3,3
97171,4,2,340458,340458,340460,0,2,1
97172,3,2,340461,340461,340463,0,2,1
97173,3,1,340464,340464,340465,0,1,1
97174,4,2,340468,340468,340470,0,2,3
97175,6,1,340474,340474,340475,0,1,4
97176,1,3,340475,340475,340478,0,3,0
97177,3,3,340478,340478,340481,0,3,0
97178,3,3,340481,340481,340484,0,3,0
97179,4,3,340485,340485,340488,0,3,1
97180,1,3,340486,340488,340491,2,5,0
97181,5,1,340491,340491,340492,0,1,0
97182,1,1,340492,340492,340493,0,1,0
97183,2,2,340494,340494,340496,0,2,1
97184,5,2,340499,340499,340501,0,2,3
97185,6,2,340505,340505,340507,0,2,4
97186,5,1,340510,340510,340511,0,1,3
97187,6,1,340516,340516,340517,0,1,5
97188,1,2,340517,340517,340519,0,2,0
97189,6,2,340523,340523,340525,0,2,4
97190,2,3,340525,340525,340528,0,3,0
97191,6,2,340531,340531,340533,0,2,3
97192,6,1,340537,340537,340538,0,1,4
97193,4,1,340541,340541,340542,0,1,3
97194,2,1,340543,340543,340544,0,1,1
97195,6,3,340549,340549,340552,0,3,5
97196,6,1,340555,340555,340556,0,1,3
97197,4,3,340559,340559,340562,0,3,3
97198,5,1,340564,340564,340565,0,1,2
97199,1,2,340565,340565,340567,0,2,0
97200,3,3,340568,340568,340571,0,3,1
97201,4,3,340572,340572,340575,0,3,1
97202,1,3,340573,340575,340578,2,5,0
97203,4,3,340577,340578,340581,1,4,0
97204,3,1,340580,340581,340582,1,2,0
97205,6,1,340586,340586,340587,0,1,4
97206,5,2,340591,340591,340593,0,2,4
97207,6,1,340597,340597,340598,0,1,4
97208,2,3,340599,340599,340602,0,3,1
97209,6,3,340605,340605,340608,0,3,3
97210,4,1,340609,340609,340610,0,1,1
97211,5,2,340614,340614,340616,0,2,4
97212,5,2,340619,340619,340621,0,2,3
97213,4,1,340623,340623,340624,0,1,2
97214,2,1,340625,340625,340626,0,1,1
97215,4,2,340629,340629,340631,0,2,3
97216,2,1,340631,340631,340632,0,1,0
97217,3,3,340634,340634,340637,0,3,2
97218,5,2,340639,340639,340641,0,2,2
97219,6,3,340645,340645,340648,0,3,4
97220,5,2,340650,340650,340652,0,2,2
97221,4,3,340654,340654,340657,0,3,2
97222,4,2,340658,340658,340660,0,2,1
97223,6,2,340664,340664,340666,0,2,4
97224,5,2,340669,340669,340671,0,2,3
97225,4,3,340673,340673,340676,0,3,2
97226,1,1,340674,340676,340677,2,3,0
97227,4,2,340678,340678,340680,0,2,1
97228,3,1,340681,340681,340682,0,1,1
97229,5,1,340686,340686,340687,0,1,4
97230,3,2,340689,340689,340691,0,2,2
97231,3,1,340692,340692,340693,0,1,1
97232,6,1,340698,340698,340699,0,1,5
97233,1,3,340699,340699,340702,0,3,0
97234,1,3,340700,340702,340705,2,5,0
97235,1,1,340701,340705,340706,4,5,0
97236,4,2,340705,340706,340708,1,3,0
97237,6,1,340711,340711,340712,0,1,3
97238,6,1,340717,340717,340718,0,1,5
97239,1,1,340718,340718,340719,0,1,0
97240,2,1,340720,340720,340721,0,1,1
97241,1,1,340721,340721,340722,0,1,0
97242,6,1,340727,340727,340728,0,1,5
97243,2,1,340729,340729,340730,0,1,1
97244,3,1,340732,340732,340733,0,1,2
97245,1,1,340733,340733,340734,0,1,0
97246,1,2,340734,340734,340736,0,2,0
97247,6,2,340740,340740,340742,0,2,4
97248,5,1,340745,340745,340746,0,1,3
97249,3,2,340748,340748,340750,0,2,2
97250,5,2,340753,340753,340755,0,2,3
97251,6,2,340759,340759,340761,0,2,4
97252,1,2,340760,340761,340763,1,3,0
97253,4,1,340764,340764,340765,0,1,1
97254,3,2,340767,340767,340769,0,2,2
97255,5,3,340772,340772,340775,0,3,3
97256,4,3,340776,340776,340779,0,3,1
97257,5,1,340781,340781,340782,0,1,2
97258,2,2,340783,340783,340785,0,2,1
97259,3,1,340786,340786,340787,0,1,1
97260,2,2,340788,340788,340790,0,2,1
97261,2,1,340790,340790,340791,0,1,0
97262,5,2,340795,340795,340797,0,2,4
97263,1,1,340796,340797,340798,1,2,0
97264,3,2,340799,340799,340801,0,2,1
97265,6,2,340805,340805,340807,0,2,4
97266,3,2,340808,340808,340810,0,2,1
97267,1,3,340809,340810,340813,1,4,0
97268,6,2,340815,340815,340817,0,2,2
97269,4,1,340819,340819,340820,0,1,2
97270,5,2,340824,340824,340826,0,2,4
97271,6,3,340830,340830,340833,0,3,4
97272,6,3,340836,340836,340839,0,3,3
97273,5,2,340841,340841,340843,0,2,2
97274,2,2,340843,340843,340845,0,2,0
97275,1,3,340844,340845,340848,1,4,0
97276,2,3,340846,340848,340851,2,5,0
97277,6,1,340852,340852,340853,0,1,1
97278,3,2,340855,340855,340857,0,2,2
97279,1,1,340856,340857,340858,1,2,0
97280,2,3,340858,340858,340861,0,3,0
97281,2,3,340860,340861,340864,1,4,0
97282,3,3,340863,340864,340867,1,4,0
97283,2,1,340865,340867,340868,2,3,0
97284,6,2,340871,340871,340873,0,2,3
97285,1,2,340872,340873,340875,1,3,0
97286,4,3,340876,340876,340879,0,3,1
97287,5,1,340881,340881,340882,0,1,2
97288,3,3,340884,340884,340887,0,3,2
97289,1,1,340885,340887,340888,2,3,0
97290,6,2,340891,340891,340893,0,2,3
97291,3,3,340894,340894,340897,0,3,1
97292,3,2,340897,340897,340899,0,2,0
97293,2,1,340899,340899,340900,0,1,0
97294,4,2,340903,340903,340905,0,2,3
97295,1,1,340904,340905,340906,1,2,0
97296,1,3,340905,340906,340909,1,4,0
97297,1,3,340906,340909,340912,3,6,0
97298,3,2,340909,340912,340914,3,5,0
97299,4,3,340913,340914,340917,1,4,0
97300,4,2,340917,340917,340919,0,2,0
97301,6,2,340923,340923,340925,0,2,4
97302,6,1,340929,340929,340930,0,1,4
97303,1,2,340930,340930,340932,0,2,0
97304,4,3,340934,340934,340937,0,3,2
97305,3,2,340937,340937,340939,0,2,0
97306,2,1,340939,340939,340940,0,1,0
97307,3,1,340942,340942,340943,0,1,2
97308,1,3,340943,340943,340946,0,3,0
97309,6,1,340949,340949,340950,0,1,3
97310,5,3,340954,340954,340957,0,3,4
97311,1,1,340955,340957,340958,2,3,0
97312,1,2,340956,340958,340960,2,4,0
97313,4,3,340960,340960,340963,0,3,0
97314,6,3,340966,340966,340969,0,3,3
97315,1,2,340967,340969,340971,2,4,0
97316,4,1,340971,340971,340972,0,1,0
97317,3,3,340974,340974,340977,0,3,2
97318,4,1,340978,340978,340979,0,1,1
97319,5,3,340983,340983,340986,0,3,4
97320,3,1,340986,340986,340987,0,1,0
97321,3,1,340989,340989,340990,0,1,2
97322,5,3,340994,340994,340997,0,3,4
97323,3,1,340997,340997,340998,0,1,0
97324,2,1,340999,340999,341000,0,1,1
97325,3,1,341002,341002,341003,0,1,2
97326,2,3,341004,341004,341007,0,3,1
97327,6,3,341010,341010,341013,0,3,3
97328,4,3,341014,341014,341017,0,3,1
97329,4,2,341018,341018,341020,0,2,1
97330,5,1,341023,341023,341024,0,1,3
97331,1,2,341024,341024,341026,0,2,0
97332,5,2,341029,341029,341031,0,2,3
97333,4,3,341033,341033,341036,0,3,2
97334,3,2,341036,341036,341038,0,2,0
97335,2,1,341038,341038,341039,0,1,0
97336,6,3,341044,341044,341047,0,3,5
97337,2,1,341046,341047,341048,1,2,0
97338,3,2,341049,341049,341051,0,2,1
97339,3,1,341052,341052,341053,0,1,1
97340,1,3,341053,341053,341056,0,3,0
97341,5,1,341058,341058,341059,0,1,2
97342,6,2,341064,341064,341066,0,2,5
97343,1,2,341065,341066,341068,1,3,0
97344,3,2,341068,341068,341070,0,2,0
97345,6,2,341074,341074,341076,0,2,4
97346,1,2,341075,341076,341078,1,3,0
97347,5,3,341080,341080,341083,0,3,2
97348,3,1,341083,341083,341084,0,1,0
97349,6,3,341089,341089,341092,0,3,5
97350,6,1,341095,341095,341096,0,1,3
97351,1,1,341096,341096,341097,0,1,0
97352,1,3,341097,341097,341100,0,3,0
97353,4,2,341101,341101,341103,0,2,1
97354,2,2,341103,341103,341105,0,2,0
97355,3,1,341106,341106,341107,0,1,1
97356,1,3,341107,341107,341110,0,3,0
97357,4,1,341111,341111,341112,0,1,1
97358,5,2,341116,341116,341118,0,2,4
97359,4,3,341120,341120,341123,0,3,2
97360,1,3,341121,341123,341126,2,5,0
97361,5,2,341126,341126,341128,0,2,0
97362,5,3,341131,341131,341134,0,3,3
97363,1,3,341132,341134,341137,2,5,0
97364,6,2,341138,341138,341140,0,2,1
97365,6,1,341144,341144,341145,0,1,4
97366,5,1,341149,341149,341150,0,1,4
97367,3,1,341152,341152,341153,0,1,2
97368,2,1,341154,341154,341155,0,1,1
97369,3,2,341157,341157,341159,0,2,2
97370,1,1,341158,341159,341160,1,2,0
97371,4,2,341162,341162,341164,0,2,2
97372,4,3,341166,341166,341169,0,3,2
97373,6,2,341172,341172,341174,0,2,3
97374,4,2,341176,341176,341178,0,2,2
97375,2,1,341178,341178,341179,0,1,0
97376,3,3,341181,341181,341184,0,3,2
97377,6,3,341187,341187,341190,0,3,3
97378,2,3,341189,341190,341193,1,4,0
97379,2,2,341191,341193,341195,2,4,0
97380,6,1,341197,341197,341198,0,1,2
97381,4,1,341201,341201,341202,0,1,3
97382,4,1,341205,341205,341206,0,1,3
97383,2,3,341207,341207,341210,0,3,1
97384,5,3,341212,341212,341215,0,3,2
97385,2,2,341214,341215,341217,1,3,0
97386,6,1,341220,341220,341221,0,1,3
97387,1,1,341221,341221,341222,0,1,0
97388,6,3,341227,341227,341230,0,3,5
97389,3,1,341230,341230,341231,0,1,0
97390,3,1,341233,341233,341234,0,1,2
97391,3,1,341236,341236,341237,0,1,2
97392,1,3,341237,341237,341240,0,3,0
97393,5,1,341242,341242,341243,0,1,2
97394,5,1,341247,341247,341248,0,1,4
97395,2,2,341249,341249,341251,0,2,1
97396,2,2,341251,341251,341253,0,2,0
97397,5,2,341256,341256,341258,0,2,3
97398,1,2,341257,341258,341260,1,3,0
97399,4,3,341261,341261,341264,0,3,1
97400,1,1,341262,341264,341265,2,3,0
97401,4,3,341266,341266,341269,0,3,1
97402,1,3,341267,341269,341272,2,5,0
97403,2,1,341269,341272,341273,3,4,0
97404,3,1,341272,341273,341274,1,2,0
97405,5,1,341277,341277,341278,0,1,3
97406,2,3,341279,341279,341282,0,3,1
97407,2,2,341281,341282,341284,1,3,0
97408,3,3,341284,341284,341287,0,3,0
97409,4,3,341288,341288,341291,0,3,1
97410,3,2,341291,341291,341293,0,2,0
97411,6,1,341297,341297,341298,0,1,4
97412,2,1,341299,341299,341300,0,1,1
97413,6,3,341305,341305,341308,0,3,5
97414,5,2,341310,341310,341312,0,2,2
97415,1,1,341311,341312,341313,1,2,0
97416,1,1,341312,341313,341314,1,2,0
97417,2,1,341314,341314,341315,0,1,0
97418,6,3,341320,341320,341323,0,3,5
97419,1,3,341321,341323,341326,2,5,0
97420,5,2,341326,341326,341328,0,2,0
97421,3,1,341329,341329,341330,0,1,1
97422,2,2,341331,341331,341333,0,2,1
97423,5,1,341336,341336,341337,0,1,3
97424,1,3,341337,341337,341340,0,3,0
97425,3,1,341340,341340,341341,0,1,0
97426,4,2,341344,341344,341346,0,2,3
97427,2,2,341346,341346,341348,0,2,0
97428,1,2,341347,341348,341350,1,3,0
97429,2,2,341349,341350,341352,1,3,0
97430,2,1,341351,341352,341353,1,2,0
97431,5,2,341356,341356,341358,0,2,3
97432,6,1,341362,341362,341363,0,1,4
97433,1,2,341363,341363,341365,0,2,0
97434,3,2,341366,341366,341368,0,2,1
97435,2,3,341368,341368,341371,0,3,0
97436,1,1,341369,341371,341372,2,3,0
97437,6,3,341375,341375,341378,0,3,3
97438,4,2,341379,341379,341381,0,2,1
97439,6,3,341385,341385,341388,0,3,4
97440,3,1,341388,341388,341389,0,1,0
97441,6,2,341394,341394,341396,0,2,5
97442,3,2,341397,341397,341399,0,2,1
97443,3,3,341400,341400,341403,0,3,1
97444,6,3,341406,341406,341409,0,3,3
97445,4,3,341410,341410,341413,0,3,1
97446,4,2,341414,341414,341416,0,2,1
97447,4,1,341418,341418,341419,0,1,2
97448,3,1,341421,341421,341422,0,1,2
97449,1,1,341422,341422,341423,0,1,0
97450,1,1,341423,341423,341424,0,1,0
97451,3,2,341426,341426,341428,0,2,2
97452,3,2,341429,341429,341431,0,2,1
97453,3,2,341432,341432,341434,0,2,1
97454,1,2,341433,341434,341436,1,3,0
97455,5,3,341438,341438,341441,0,3,2
97456,3,1,341441,341441,341442,0,1,0
97457,6,1,341447,341447,341448,0,1,5
97458,6,1,341453,341453,341454,0,1,5
97459,4,3,341457,341457,341460,0,3,3
97460,2,1,341459,341460,341461,1,2,0
97461,3,2,341462,341462,341464,0,2,1
97462,4,2,341466,341466,341468,0,2,2
97463,5,1,341471,341471,341472,0,1,3
97464,5,1,341476,341476,341477,0,1,4
97465,3,3,341479,341479,341482,0,3,2
97466,2,2,341481,341482,341484,1,3,0
97467,6,3,341487,341487,341490,0,3,3
97468,1,3,341488,341490,341493,2,5,0
97469,3,1,341491,341493,341494,2,3,0
97470,2,2,341493,341494,341496,1,3,0
97471,5,3,341498,341498,341501,0,3,2
97472,6,2,341504,341504,341506,0,2,3
97473,1,3,341505,341506,341509,1,4,0
97474,1,1,341506,341509,341510,3,4,0
97475,1,3,341507,341510,341513,3,6,0
97476,2,3,341509,341513,341516,4,7,0
97477,5,1,341514,341516,341517,2,3,0
97478,2,2,341516,341517,341519,1,3,0
97479,6,3,341522,341522,341525,0,3,3
97480,2,3,341524,341525,341528,1,4,0
97481,2,1,341526,341528,341529,2,3,0
97482,1,1,341527,341529,341530,2,3,0
97483,6,2,341533,341533,341535,0,2,3
97484,6,1,341539,341539,341540,0,1,4
97485,2,3,341541,341541,341544,0,3,1
97486,4,3,341545,341545,341548,0,3,1
97487,6,2,341551,341551,341553,0,2,3
97488,1,1,341552,341553,341554,1,2,0
97489,1,3,341553,341554,341557,1,4,0
97490,4,1,341557,341557,341558,0,1,0
97491,2,1,341559,341559,341560,0,1,1
97492,2,2,341561,341561,341563,0,2,1
97493,6,2,341567,341567,341569,0,2,4
97494,6,1,341573,341573,341574,0,1,4
97495,3,3,341576,341576,341579,0,3,2
97496,4,2,341580,341580,341582,0,2,1
97497,2,1,341582,341582,341583,0,1,0
97498,6,2,341588,341588,341590,0,2,5
97499,3,2,341591,341591,341593,0,2,1
97500,4,2,341595,341595,341597,0,2,2
97501,5,3,341600,341600,341603,0,3,3
97502,5,1,341605,341605,341606,0,1,2
97503,4,3,341609,341609,341612,0,3,3
97504,1,3,341610,341612,341615,2,5,0
97505,2,1,341612,341615,341616,3,4,0
97506,6,2,341618,341618,341620,0,2,2
97507,3,3,341621,341621,341624,0,3,1
97508,6,3,341627,341627,341630,0,3,3
97509,5,1,341632,341632,341633,0,1,2
97510,2,3,341634,341634,341637,0,3,1
97511,1,1,341635,341637,341638,2,3,0
97512,2,3,341637,341638,341641,1,4,0
97513,2,1,341639,341641,341642,2,3,0
97514,2,3,341641,341642,341645,1,4,0
97515,1,2,341642,341645,341647,3,5,0
97516,1,3,341643,341647,341650,4,7,0
97517,5,1,341648,341650,341651,2,3,0
97518,5,1,341653,341653,341654,0,1,2
97519,4,3,341657,341657,341660,0,3,3
97520,4,2,341661,341661,341663,0,2,1
97521,5,2,341666,341666,341668,0,2,3
97522,6,3,341672,341672,341675,0,3,4
97523,2,1,341674,341675,341676,1,2,0
97524,3,1,341677,341677,341678,0,1,1
97525,5,1,341682,341682,341683,0,1,4
97526,3,1,341685,341685,341686,0,1,2
97527,2,2,341687,341687,341689,0,2,1
97528,6,1,341693,341693,341694,0,1,4
97529,5,3,341698,341698,341701,0,3,4
97530,6,2,341704,341704,341706,0,2,3
97531,4,3,341708,341708,341711,0,3,2
97532,6,1,341714,341714,341715,0,1,3
97533,4,1,341718,341718,341719,0,1,3
97534,3,3,341721,341721,341724,0,3,2
97535,2,2,341723,341724,341726,1,3,0
97536,3,1,341726,341726,341727,0,1,0
97537,4,1,341730,341730,341731,0,1,3
97538,5,2,341735,341735,341737,0,2,4
97539,1,2,341736,341737,341739,1,3,0
97540,5,1,341741,341741,341742,0,1,2
97541,6,1,341747,341747,341748,0,1,5
97542,2,2,341749,341749,341751,0,2,1
97543,6,2,341755,341755,341757,0,2,4
97544,6,1,341761,341761,341762,0,1,4
97545,5,1,341766,341766,341767,0,1,4
97546,4,3,341770,341770,341773,0,3,3
97547,6,1,341776,341776,341777,0,1,3
97548,3,3,341779,341779,341782,0,3,2
97549,2,1,341781,341782,341783,1,2,0
97550,2,3,341783,341783,341786,0,3,0
97551,2,3,341785,341786,341789,1,4,0
97552,5,3,341790,341790,341793,0,3,1
97553,6,3,341796,341796,341799,0,3,3
97554,5,3,341801,341801,341804,0,3,2
97555,2,3,341803,341804,341807,1,4,0
97556,2,1,341805,341807,341808,2,3,0
97557,3,2,341808,341808,341810,0,2,0
97558,3,2,341811,341811,341813,0,2,1
97559,1,3,341812,341813,341816,1,4,0
97560,5,2,341817,341817,341819,0,2,1
97561,4,1,341821,341821,341822,0,1,2
97562,5,2,341826,341826,341828,0,2,4
97563,6,2,341832,341832,341834,0,2,4
97564,2,1,341834,341834,341835,0,1,0
97565,5,2,341839,341839,341841,0,2,4
97566,2,1,341841,341841,341842,0,1,0
97567,2,1,341843,341843,341844,0,1,1
97568,1,2,341844,341844,341846,0,2,0
97569,4,1,341848,341848,341849,0,1,2
97570,4,2,341852,341852,341854,0,2,3
97571,4,3,341856,341856,341859,0,3,2
97572,5,1,341861,341861,341862,0,1,2
97573,2,3,341863,341863,341866,0,3,1
97574,2,2,341865,341866,341868,1,3,0
97575,1,2,341866,341868,341870,2,4,0
97576,4,1,341870,341870,341871,0,1,0
97577,1,1,341871,341871,341872,0,1,0
97578,3,2,341874,341874,341876,0,2,2
97579,4,2,341878,341878,341880,0,2,2
97580,2,3,341880,341880,341883,0,3,0
97581,2,1,341882,341883,341884,1,2,0
97582,5,2,341887,341887,341889,0,2,3
97583,6,2,341893,341893,341895,0,2,4
97584,3,2,341896,341896,341898,0,2,1
97585,3,3,341899,341899,341902,0,3,1
97586,3,3,341902,341902,341905,0,3,0
97587,4,3,341906,341906,341909,0,3,1
97588,3,1,341909,341909,341910,0,1,0
97589,6,2,341915,341915,341917,0,2,5
97590,6,3,341921,341921,341924,0,3,4
97591,2,3,341923,341924,341927,1,4,0
97592,6,1,341929,341929,341930,0,1,2
97593,4,2,341933,341933,341935,0,2,3
97594,5,2,341938,341938,341940,0,2,3
97595,2,1,341940,341940,341941,0,1,0
97596,1,3,341941,341941,341944,0,3,0
97597,2,2,341943,341944,341946,1,3,0
97598,1,2,341944,341946,341948,2,4,0
97599,6,3,341950,341950,341953,0,3,2
97600,2,1,341952,341953,341954,1,2,0
97601,2,2,341954,341954,341956,0,2,0
97602,3,3,341957,341957,341960,0,3,1
97603,1,3,341958,341960,341963,2,5,0
97604,1,3,341959,341963,341966,4,7,0
97605,4,2,341963,341966,341968,3,5,0
97606,5,3,341968,341968,341971,0,3,0
97607,3,2,341971,341971,341973,0,2,0
97608,4,2,341975,341975,341977,0,2,2
97609,6,2,341981,341981,341983,0,2,4
97610,1,3,341982,341983,341986,1,4,0
97611,1,1,341983,341986,341987,3,4,0
97612,3,2,341986,341987,341989,1,3,0
97613,1,1,341987,341989,341990,2,3,0
97614,6,2,341993,341993,341995,0,2,3
97615,5,3,341998,341998,342001,0,3,3
97616,3,1,342001,342001,342002,0,1,0
97617,4,2,342005,342005,342007,0,2,3
97618,4,2,342009,342009,342011,0,2,2
97619,2,2,342011,342011,342013,0,2,0
97620,5,2,342016,342016,342018,0,2,3
97621,6,3,342022,342022,342025,0,3,4
97622,1,3,342023,342025,342028,2,5,0
97623,2,1,342025,342028,342029,3,4,0
97624,3,3,342028,342029,342032,1,4,0
97625,6,3,342034,342034,342037,0,3,2
97626,6,1,342040,342040,342041,0,1,3
97627,1,3,342041,342041,342044,0,3,0
97628,4,3,342045,342045,342048,0,3,1
97629,6,2,342051,342051,342053,0,2,3
97630,2,1,342053,342053,342054,0,1,0
97631,3,2,342056,342056,342058,0,2,2
97632,3,1,342059,342059,342060,0,1,1
97633,3,3,342062,342062,342065,0,3,2
97634,5,3,342067,342067,342070,0,3,2
97635,5,2,342072,342072,342074,0,2,2
97636,1,3,342073,342074,342077,1,4,0
97637,3,1,342076,342077,342078,1,2,0
97638,6,1,342082,342082,342083,0,1,4
97639,3,2,342085,342085,342087,0,2,2
97640,5,3,342090,342090,342093,0,3,3
97641,5,2,342095,342095,342097,0,2,2
97642,1,2,342096,342097,342099,1,3,0
97643,5,2,342101,342101,342103,0,2,2
97644,5,1,342106,342106,342107,0,1,3
97645,1,3,342107,342107,342110,0,3,0
97646,1,2,342108,342110,342112,2,4,0
97647,3,3,342111,342112,342115,1,4,0
97648,6,2,342117,342117,342119,0,2,2
97649,4,1,342121,342121,342122,0,1,2
97650,3,1,342124,342124,342125,0,1,2
97651,1,2,342125,342125,342127,0,2,0
97652,2,2,342127,342127,342129,0,2,0
97653,4,3,342131,342131,342134,0,3,2
97654,1,2,342132,342134,342136,2,4,0
97655,2,2,342134,342136,342138,2,4,0
97656,5,3,342139,342139,342142,0,3,1
97657,6,3,342145,342145,342148,0,3,3
97658,3,3,342148,342148,342151,0,3,0
97659,2,1,342150,342151,342152,1,2,0
97660,2,3,342152,342152,342155,0,3,0
97661,5,3,342157,342157,342160,0,3,2
97662,2,2,342159,342160,342162,1,3,0
97663,1,1,342160,342162,342163,2,3,0
97664,5,2,342165,342165,342167,0,2,2
97665,5,1,342170,342170,342171,0,1,3
97666,5,1,342175,342175,342176,0,1,4
97667,3,3,342178,342178,342181,0,3,2
97668,3,2,342181,342181,342183,0,2,0
97669,5,3,342186,342186,342189,0,3,3
97670,2,1,342188,342189,342190,1,2,0
97671,4,3,342192,342192,342195,0,3,2
97672,4,3,342196,342196,342199,0,3,1
97673,2,1,342198,342199,342200,1,2,0
97674,3,1,342201,342201,342202,0,1,1
97675,6,3,342207,342207,342210,0,3,5
97676,4,1,342211,342211,342212,0,1,1
97677,2,2,342213,342213,342215,0,2,1
97678,2,1,342215,342215,342216,0,1,0
97679,2,3,342217,342217,342220,0,3,1
97680,3,3,342220,342220,342223,0,3,0
97681,4,2,342224,342224,342226,0,2,1
97682,6,3,342230,342230,342233,0,3,4
97683,2,2,342232,342233,342235,1,3,0
97684,3,1,342235,342235,342236,0,1,0
97685,6,3,342241,342241,342244,0,3,5
97686,4,2,342245,342245,342247,0,2,1
97687,6,1,342251,342251,342252,0,1,4
97688,6,1,342257,342257,342258,0,1,5
97689,2,1,342259,342259,342260,0,1,1
97690,3,2,342262,342262,342264,0,2,2
97691,3,1,342265,342265,342266,0,1,1
97692,2,3,342267,342267,342270,0,3,1
97693,5,2,342272,342272,342274,0,2,2
97694,3,1,342275,342275,342276,0,1,1
97695,4,1,342279,342279,342280,0,1,3
97696,4,1,342283,342283,342284,0,1,3
97697,4,2,342287,342287,342289,0,2,3
97698,4,3,342291,342291,342294,0,3,2
97699,1,1,342292,342294,342295,2,3,0
97700,5,3,342297,342297,342300,0,3,2
97701,6,2,342303,342303,342305,0,2,3
97702,5,2,342308,342308,342310,0,2,3
97703,2,3,342310,342310,342313,0,3,0
97704,4,1,342314,342314,342315,0,1,1
97705,1,1,342315,342315,342316,0,1,0
97706,5,3,342320,342320,342323,0,3,4
97707,4,2,342324,342324,342326,0,2,1
97708,5,1,342329,342329,342330,0,1,3
97709,5,3,342334,342334,342337,0,3,4
97710,5,3,342339,342339,342342,0,3,2
97711,6,3,342345,342345,342348,0,3,3
97712,2,3,342347,342348,342351,1,4,0
97713,1,1,342348,342351,342352,3,4,0
97714,4,2,342352,342352,342354,0,2,0
97715,2,1,342354,342354,342355,0,1,0
97716,4,2,342358,342358,342360,0,2,3
97717,4,1,342362,342362,342363,0,1,2
97718,2,3,342364,342364,342367,0,3,1
97719,4,2,342368,342368,342370,0,2,1
97720,3,2,342371,342371,342373,0,2,1
97721,2,1,342373,342373,342374,0,1,0
97722,1,1,342374,342374,342375,0,1,0
97723,5,1,342379,342379,342380,0,1,4
97724,1,3,342380,342380,342383,0,3,0
97725,3,1,342383,342383,342384,0,1,0
97726,4,1,342387,342387,342388,0,1,3
97727,3,2,342390,342390,342392,0,2,2
97728,6,2,342396,342396,342398,0,2,4
97729,5,2,342401,342401,342403,0,2,3
97730,3,3,342404,342404,342407,0,3,1
97731,1,1,342405,342407,342408,2,3,0
97732,3,3,342408,342408,342411,0,3,0
97733,5,1,342413,342413,342414,0,1,2
97734,5,2,342418,342418,342420,0,2,4
97735,2,3,342420,342420,342423,0,3,0
97736,6,1,342426,342426,342427,0,1,3
97737,4,1,342430,342430,342431,0,1,3
97738,6,3,342436,342436,342439,0,3,5
97739,1,3,342437,342439,342442,2,5,0
97740,3,3,342440,342442,342445,2,5,0
97741,5,1,342445,342445,342446,0,1,0
97742,2,1,342447,342447,342448,0,1,1
97743,2,2,342449,342449,342451,0,2,1
97744,4,3,342453,342453,342456,0,3,2
97745,6,1,342459,342459,342460,0,1,3
97746,5,3,342464,342464,342467,0,3,4
97747,4,1,342468,342468,342469,0,1,1
97748,2,2,342470,342470,342472,0,2,1
97749,2,1,342472,342472,342473,0,1,0
97750,2,1,342474,342474,342475,0,1,1
97751,6,2,342480,342480,342482,0,2,5
97752,1,3,342481,342482,342485,1,4,0
97753,4,3,342485,342485,342488,0,3,0
97754,2,3,342487,342488,342491,1,4,0
97755,3,2,342490,342491,342493,1,3,0
97756,1,2,342491,342493,342495,2,4,0
97757,3,1,342494,342495,342496,1,2,0
97758,2,2,342496,342496,342498,0,2,0
97759,6,1,342502,342502,342503,0,1,4
97760,6,1,342508,342508,342509,0,1,5
97761,2,2,342510,342510,342512,0,2,1
97762,6,1,342516,342516,342517,0,1,4
97763,2,3,342518,342518,342521,0,3,1
97764,6,3,342524,342524,342527,0,3,3
97765,6,2,342530,342530,342532,0,2,3
97766,1,2,342531,342532,342534,1,3,0
97767,2,2,342533,342534,342536,1,3,0
97768,2,1,342535,342536,342537,1,2,0
97769,2,3,342537,342537,342540,0,3,0
97770,5,2,342542,342542,342544,0,2,2
97771,4,1,342546,342546,342547,0,1,2
97772,1,3,342547,342547,342550,0,3,0
97773,2,3,342549,342550,342553,1,4,0
97774,1,1,342550,342553,342554,3,4,0
97775,2,2,342552,342554,342556,2,4,0
97776,5,1,342557,342557,342558,0,1,1
97777,6,3,342563,342563,342566,0,3,5
97778,1,2,342564,342566,342568,2,4,0
97779,4,1,342568,342568,342569,0,1,0
97780,1,1,342569,342569,342570,0,1,0
97781,3,2,342572,342572,342574,0,2,2
97782,3,2,342575,342575,342577,0,2,1
97783,4,1,342579,342579,342580,0,1,2
97784,6,1,342585,342585,342586,0,1,5
97785,3,2,342588,342588,342590,0,2,2
97786,4,2,342592,342592,342594,0,2,2
97787,4,1,342596,342596,342597,0,1,2
97788,6,2,342602,342602,342604,0,2,5
97789,1,1,342603,342604,342605,1,2,0
97790,4,3,342607,342607,342610,0,3,2
97791,3,1,342610,342610,342611,0,1,0
97792,3,1,342613,342613,342614,0,1,2
97793,3,1,342616,342616,342617,0,1,2
97794,4,1,342620,342620,342621,0,1,3
97795,6,3,342626,342626,342629,0,3,5
97796,2,3,342628,342629,342632,1,4,0
97797,6,1,342634,342634,342635,0,1,2
97798,2,1,342636,342636,342637,0,1,1
97799,2,3,342638,342638,342641,0,3,1
97800,3,3,342641,342641,342644,0,3,0
97801,2,1,342643,342644,342645,1,2,0
97802,3,3,342646,342646,342649,0,3,1
97803,1,2,342647,342649,342651,2,4,0
97804,1,3,342648,342651,342654,3,6,0
97805,6,1,342654,342654,342655,0,1,0
97806,4,3,342658,342658,342661,0,3,3
97807,3,2,342661,342661,342663,0,2,0
97808,1,2,342662,342663,342665,1,3,0
97809,2,3,342664,342665,342668,1,4,0
97810,5,2,342669,342669,342671,0,2,1
97811,3,2,342672,342672,342674,0,2,1
97812,1,1,342673,342674,342675,1,2,0
97813,2,2,342675,342675,342677,0,2,0
97814,3,1,342678,342678,342679,0,1,1
97815,2,1,342680,342680,342681,0,1,1
97816,3,1,342683,342683,342684,0,1,2
97817,6,1,342689,342689,342690,0,1,5
97818,4,2,342693,342693,342695,0,2,3
97819,5,2,342698,342698,342700,0,2,3
97820,4,1,342702,342702,342703,0,1,2
97821,4,1,342706,342706,342707,0,1,3
97822,4,3,342710,342710,342713,0,3,3
97823,4,3,342714,342714,342717,0,3,1
97824,3,1,342717,342717,342718,0,1,0
97825,3,2,342720,342720,342722,0,2,2
97826,3,2,342723,342723,342725,0,2,1
97827,3,1,342726,342726,342727,0,1,1
97828,1,2,342727,342727,342729,0,2,0
97829,5,3,342732,342732,342735,0,3,3
97830,4,3,342736,342736,342739,0,3,1
97831,3,2,342739,342739,342741,0,2,0
97832,1,3,342740,342741,342744,1,4,0
97833,5,3,342745,342745,342748,0,3,1
97834,1,2,342746,342748,342750,2,4,0
97835,6,2,342752,342752,342754,0,2,2
97836,3,3,342755,342755,342758,0,3,1
97837,1,1,342756,342758,342759,2,3,0
97838,3,2,342759,342759,342761,0,2,0
97839,5,2,342764,342764,342766,0,2,3
97840,4,3,342768,342768,342771,0,3,2
97841,4,2,342772,342772,342774,0,2,1
97842,3,1,342775,342775,342776,0,1,1
97843,2,1,342777,342777,342778,0,1,1
97844,5,1,342782,342782,342783,0,1,4
97845,5,3,342787,342787,342790,0,3,4
97846,5,2,342792,342792,342794,0,2,2
97847,2,2,342794,342794,342796,0,2,0
97848,3,1,342797,342797,342798,0,1,1
97849,6,3,342803,342803,342806,0,3,5
97850,6,3,342809,342809,342812,0,3,3
97851,5,2,342814,342814,342816,0,2,2
97852,2,3,342816,342816,342819,0,3,0
97853,4,3,342820,342820,342823,0,3,1
97854,4,1,342824,342824,342825,0,1,1
97855,3,3,342827,342827,342830,0,3,2
97856,2,3,342829,342830,342833,1,4,0
97857,4,1,342833,342833,342834,0,1,0
97858,4,3,342837,342837,342840,0,3,3
97859,1,2,342838,342840,342842,2,4,0
97860,4,3,342842,342842,342845,0,3,0
97861,2,2,342844,342845,342847,1,3,0
97862,2,2,342846,342847,342849,1,3,0
97863,2,3,342848,342849,342852,1,4,0
97864,2,1,342850,342852,342853,2,3,0
97865,6,1,342856,342856,342857,0,1,3
97866,2,1,342858,342858,342859,0,1,1
97867,4,2,342862,342862,342864,0,2,3
97868,1,1,342863,342864,342865,1,2,0
97869,4,2,342867,342867,342869,0,2,2
97870,1,3,342868,342869,342872,1,4,0
97871,5,1,342873,342873,342874,0,1,1
97872,1,3,342874,342874,342877,0,3,0
97873,5,2,342879,342879,342881,0,2,2
97874,1,3,342880,342881,342884,1,4,0
97875,6,2,342886,342886,342888,0,2,2
97876,5,1,342891,342891,342892,0,1,3
97877,1,3,342892,342892,342895,0,3,0
97878,1,1,342893,342895,342896,2,3,0
97879,2,2,342895,342896,342898,1,3,0
97880,1,3,342896,342898,342901,2,5,0
97881,3,1,342899,342901,342902,2,3,0
97882,5,3,342904,342904,342907,0,3,2
97883,1,3,342905,342907,342910,2,5,0
97884,5,1,342910,342910,342911,0,1,0
97885,2,2,342912,342912,342914,0,2,1
97886,2,1,342914,342914,342915,0,1,0
97887,3,1,342917,342917,342918,0,1,2
97888,3,3,342920,342920,342923,0,3,2
97889,2,2,342922,342923,342925,1,3,0
97890,5,3,342927,342927,342930,0,3,2
97891,1,1,342928,342930,342931,2,3,0
97892,6,3,342934,342934,342937,0,3,3
97893,6,3,342940,342940,342943,0,3,3
97894,6,3,342946,342946,342949,0,3,3
97895,1,2,342947,342949,342951,2,4,0
97896,4,1,342951,342951,342952,0,1,0
97897,6,3,342957,342957,342960,0,3,5
97898,3,1,342960,342960,342961,0,1,0
97899,2,1,342962,342962,342963,0,1,1
97900,4,3,342966,342966,342969,0,3,3
97901,6,3,342972,342972,342975,0,3,3
97902,2,3,342974,342975,342978,1,4,0
97903,5,2,342979,342979,342981,0,2,1
97904,2,1,342981,342981,342982,0,1,0
97905,4,2,342985,342985,342987,0,2,3
97906,1,3,342986,342987,342990,1,4,0
97907,5,1,342991,342991,342992,0,1,1
97908,4,1,342995,342995,342996,0,1,3
97909,3,3,342998,342998,343001,0,3,2
97910,1,2,342999,343001,343003,2,4,0
97911,3,3,343002,343003,343006,1,4,0
97912,2,2,343004,343006,343008,2,4,0
97913,2,2,343006,343008,343010,2,4,0
97914,1,3,343007,343010,343013,3,6,0
97915,4,2,343011,343013,343015,2,4,0
97916,1,1,343012,343015,343016,3,4,0
97917,5,3,343017,343017,343020,0,3,1
97918,1,1,343018,343020,343021,2,3,0
97919,2,2,343020,343021,343023,1,3,0
97920,6,1,343026,343026,343027,0,1,3
97921,6,3,343032,343032,343035,0,3,5
97922,4,1,343036,343036,343037,0,1,1
97923,2,2,343038,343038,343040,0,2,1
97924,3,3,343041,343041,343044,0,3,1
97925,1,2,343042,343044,343046,2,4,0
97926,5,2,343047,343047,343049,0,2,1
97927,2,1,343049,343049,343050,0,1,0
97928,1,2,343050,343050,343052,0,2,0
97929,3,3,343053,343053,343056,0,3,1
97930,3,3,343056,343056,343059,0,3,0
97931,1,1,343057,343059,343060,2,3,0
97932,6,2,343063,343063,343065,0,2,3
97933,1,1,343064,343065,343066,1,2,0
97934,3,1,343067,343067,343068,0,1,1
97935,6,1,343073,343073,343074,0,1,5
97936,6,3,343079,343079,343082,0,3,5
97937,2,3,343081,343082,343085,1,4,0
97938,5,2,343086,343086,343088,0,2,1
97939,3,2,343089,343089,343091,0,2,1
97940,3,2,343092,343092,343094,0,2,1
97941,6,2,343098,343098,343100,0,2,4
97942,1,1,343099,343100,343101,1,2,0
97943,5,1,343104,343104,343105,0,1,3
97944,6,1,343110,343110,343111,0,1,5
97945,1,1,343111,343111,343112,0,1,0
97946,5,2,343116,343116,343118,0,2,4
97947,3,3,343119,343119,343122,0,3,1
97948,5,2,343124,343124,343126,0,2,2
97949,5,3,343129,343129,343132,0,3,3
97950,6,3,343135,343135,343138,0,3,3
97951,2,3,343137,343138,343141,1,4,0
97952,5,3,343142,343142,343145,0,3,1
97953,2,3,343144,343145,343148,1,4,0
97954,1,2,343145,343148,343150,3,5,0
97955,2,2,343147,343150,343152,3,5,0
97956,1,3,343148,343152,343155,4,7,0
97957,5,1,343153,343155,343156,2,3,0
97958,5,1,343158,343158,343159,0,1,2
97959,6,3,343164,343164,343167,0,3,5
97960,1,3,343165,343167,343170,2,5,0
97961,2,2,343167,343170,343172,3,5,0
97962,2,1,343169,343172,343173,3,4,0
97963,6,3,343175,343175,343178,0,3,2
97964,1,3,343176,343178,343181,2,5,0
97965,5,3,343181,343181,343184,0,3,0
97966,4,1,343185,343185,343186,0,1,1
97967,6,1,343191,343191,343192,0,1,5
97968,6,1,343197,343197,343198,0,1,5
97969,1,1,343198,343198,343199,0,1,0
97970,2,1,343200,343200,343201,0,1,1
97971,3,1,343203,343203,343204,0,1,2
97972,1,1,343204,343204,343205,0,1,0
97973,1,1,343205,343205,343206,0,1,0
97974,2,2,343207,343207,343209,0,2,1
97975,5,2,343212,343212,343214,0,2,3
97976,6,1,343218,343218,343219,0,1,4
97977,1,2,343219,343219,343221,0,2,0
97978,1,1,343220,343221,343222,1,2,0
97979,2,1,343222,343222,343223,0,1,0
97980,5,1,343227,343227,343228,0,1,4
97981,3,2,343230,343230,343232,0,2,2
97982,5,3,343235,343235,343238,0,3,3
97983,6,3,343241,343241,343244,0,3,3
97984,6,3,343247,343247,343250,0,3,3
97985,2,2,343249,343250,343252,1,3,0
97986,6,2,343255,343255,343257,0,2,3
97987,5,1,343260,343260,343261,0,1,3
97988,2,3,343262,343262,343265,0,3,1
97989,1,2,343263,343265,343267,2,4,0
97990,3,1,343266,343267,343268,1,2,0
97991,4,1,343270,343270,343271,0,1,2
97992,1,2,343271,343271,343273,0,2,0
97993,2,3,343273,343273,343276,0,3,0
97994,2,2,343275,343276,343278,1,3,0
97995,1,1,343276,343278,343279,2,3,0
97996,4,3,343280,343280,343283,0,3,1
97997,6,2,343286,343286,343288,0,2,3
97998,4,1,343290,343290,343291,0,1,2
97999,2,3,343292,343292,343295,0,3,1
98000,3,1,343295,343295,343296,0,1,0
98001,1,1,343296,343296,343297,0,1,0
98002,2,3,343298,343298,343301,0,3,1
98003,5,2,343303,343303,343305,0,2,2
98004,6,1,343309,343309,343310,0,1,4
98005,6,2,343315,343315,343317,0,2,5
98006,4,2,343319,343319,343321,0,2,2
98007,6,3,343325,343325,343328,0,3,4
98008,4,1,343329,343329,343330,0,1,1
98009,4,2,343333,343333,343335,0,2,3
98010,2,3,343335,343335,343338,0,3,0
98011,1,3,343336,343338,343341,2,5,0
98012,1,1,343337,343341,343342,4,5,0
98013,4,2,343341,343342,343344,1,3,0
98014,3,1,343344,343344,343345,0,1,0
98015,5,3,343349,343349,343352,0,3,4
98016,5,1,343354,343354,343355,0,1,2
98017,3,1,343357,343357,343358,0,1,2
98018,3,1,343360,343360,343361,0,1,2
98019,4,2,343364,343364,343366,0,2,3
98020,4,3,343368,343368,343371,0,3,2
98021,3,1,343371,343371,343372,0,1,0
98022,5,3,343376,343376,343379,0,3,4
98023,1,3,343377,343379,343382,2,5,0
98024,6,3,343383,343383,343386,0,3,1
98025,1,3,343384,343386,343389,2,5,0
98026,6,2,343390,343390,343392,0,2,1
98027,4,2,343394,343394,343396,0,2,2
98028,2,3,343396,343396,343399,0,3,0
98029,5,3,343401,343401,343404,0,3,2
98030,3,2,343404,343404,343406,0,2,0
98031,3,1,343407,343407,343408,0,1,1
98032,3,1,343410,343410,343411,0,1,2
98033,3,1,343413,343413,343414,0,1,2
98034,5,1,343418,343418,343419,0,1,4
98035,4,1,343422,343422,343423,0,1,3
98036,3,2,343425,343425,343427,0,2,2
98037,1,3,343426,343427,343430,1,4,0
98038,5,1,343431,343431,343432,0,1,1
98039,4,2,343435,343435,343437,0,2,3
98040,6,2,343441,343441,343443,0,2,4
98041,4,3,343445,343445,343448,0,3,2
98042,3,3,343448,343448,343451,0,3,0
98043,2,2,343450,343451,343453,1,3,0
98044,3,3,343453,343453,343456,0,3,0
98045,4,1,343457,343457,343458,0,1,1
98046,3,2,343460,343460,343462,0,2,2
98047,1,3,343461,343462,343465,1,4,0
98048,2,1,343463,343465,343466,2,3,0
98049,5,3,343468,343468,343471,0,3,2
98050,5,1,343473,343473,343474,0,1,2
98051,5,2,343478,343478,343480,0,2,4
98052,4,1,343482,343482,343483,0,1,2
98053,5,3,343487,343487,343490,0,3,4
98054,5,3,343492,343492,343495,0,3,2
98055,2,3,343494,343495,343498,1,4,0
98056,6,2,343500,343500,343502,0,2,2
98057,3,2,343503,343503,343505,0,2,1
98058,1,3,343504,343505,343508,1,4,0
98059,6,2,343510,343510,343512,0,2,2
98060,4,3,343514,343514,343517,0,3,2
98061,1,3,343515,343517,343520,2,5,0
98062,1,3,343516,343520,343523,4,7,0
98063,1,2,343517,343523,343525,6,8,0
98064,6,3,343523,343525,343528,2,5,0
98065,6,1,343529,343529,343530,0,1,1
98066,4,1,343533,343533,343534,0,1,3
98067,4,2,343537,343537,343539,0,2,3
98068,4,3,343541,343541,343544,0,3,2
98069,5,1,343546,343546,343547,0,1,2
98070,5,2,343551,343551,343553,0,2,4
98071,5,1,343556,343556,343557,0,1,3
98072,1,1,343557,343557,343558,0,1,0
98073,5,1,343562,343562,343563,0,1,4
98074,1,2,343563,343563,343565,0,2,0
98075,6,2,343569,343569,343571,0,2,4
98076,1,2,343570,343571,343573,1,3,0
98077,5,2,343575,343575,343577,0,2,2
98078,1,2,343576,343577,343579,1,3,0
98079,4,1,343580,343580,343581,0,1,1
98080,3,2,343583,343583,343585,0,2,2
98081,2,1,343585,343585,343586,0,1,0
98082,2,1,343587,343587,343588,0,1,1
98083,6,3,343593,343593,343596,0,3,5
98084,2,2,343595,343596,343598,1,3,0
98085,2,3,343597,343598,343601,1,4,0
98086,6,3,343603,343603,343606,0,3,2
98087,5,1,343608,343608,343609,0,1,2
98088,2,1,343610,343610,343611,0,1,1
98089,2,2,343612,343612,343614,0,2,1
98090,6,2,343618,343618,343620,0,2,4
98091,6,2,343624,343624,343626,0,2,4
98092,6,3,343630,343630,343633,0,3,4
98093,5,1,343635,343635,343636,0,1,2
98094,5,3,343640,343640,343643,0,3,4
98095,6,1,343646,343646,343647,0,1,3
98096,5,1,343651,343651,343652,0,1,4
98097,1,3,343652,343652,343655,0,3,0
98098,1,1,343653,343655,343656,2,3,0
98099,4,2,343657,343657,343659,0,2,1
98100,5,3,343662,343662,343665,0,3,3
98101,2,2,343664,343665,343667,1,3,0
98102,3,2,343667,343667,343669,0,2,0
98103,2,1,343669,343669,343670,0,1,0
98104,4,1,343673,343673,343674,0,1,3
98105,2,2,343675,343675,343677,0,2,1
98106,1,1,343676,343677,343678,1,2,0
98107,2,2,343678,343678,343680,0,2,0
98108,2,3,343680,343680,343683,0,3,0
98109,3,3,343683,343683,343686,0,3,0
98110,6,1,343689,343689,343690,0,1,3
98111,6,2,343695,343695,343697,0,2,5
98112,3,2,343698,343698,343700,0,2,1
98113,3,1,343701,343701,343702,0,1,1
98114,3,3,343704,343704,343707,0,3,2
98115,3,2,343707,343707,343709,0,2,0
98116,6,2,343713,343713,343715,0,2,4
98117,2,2,343715,343715,343717,0,2,0
98118,2,3,343717,343717,343720,0,3,0
98119,3,3,343720,343720,343723,0,3,0
98120,1,1,343721,343723,343724,2,3,0
98121,5,1,343726,343726,343727,0,1,2
98122,6,1,343732,343732,343733,0,1,5
98123,2,2,343734,343734,343736,0,2,1
98124,4,1,343738,343738,343739,0,1,2
98125,6,2,343744,343744,343746,0,2,5
98126,2,3,343746,343746,343749,0,3,0
98127,1,3,343747,343749,343752,2,5,0
98128,6,2,343753,343753,343755,0,2,1
98129,6,3,343759,343759,343762,0,3,4
98130,2,2,343761,343762,343764,1,3,0
98131,3,1,343764,343764,343765,0,1,0
98132,6,1,343770,343770,343771,0,1,5
98133,3,3,343773,343773,343776,0,3,2
98134,3,1,343776,343776,343777,0,1,0
98135,2,3,343778,343778,343781,0,3,1
98136,6,1,343784,343784,343785,0,1,3
98137,6,3,343790,343790,343793,0,3,5
98138,6,3,343796,343796,343799,0,3,3
98139,3,1,343799,343799,343800,0,1,0
98140,5,3,343804,343804,343807,0,3,4
98141,3,2,343807,343807,343809,0,2,0
98142,1,2,343808,343809,343811,1,3,0
98143,1,1,343809,343811,343812,2,3,0
98144,4,3,343813,343813,343816,0,3,1
98145,4,3,343817,343817,343820,0,3,1
98146,6,3,343823,343823,343826,0,3,3
98147,4,3,343827,343827,343830,0,3,1
98148,5,2,343832,343832,343834,0,2,2
98149,5,1,343837,343837,343838,0,1,3
98150,3,2,343840,343840,343842,0,2,2
98151,3,1,343843,343843,343844,0,1,1
98152,5,3,343848,343848,343851,0,3,4
98153,2,2,343850,343851,343853,1,3,0
98154,6,2,343856,343856,343858,0,2,3
98155,3,3,343859,343859,343862,0,3,1
98156,2,1,343861,343862,343863,1,2,0
98157,3,3,343864,343864,343867,0,3,1
98158,4,3,343868,343868,343871,0,3,1
98159,3,2,343871,343871,343873,0,2,0
98160,1,3,343872,343873,343876,1,4,0
98161,1,2,343873,343876,343878,3,5,0
98162,6,2,343879,343879,343881,0,2,1
98163,6,3,343885,343885,343888,0,3,4
98164,3,2,343888,343888,343890,0,2,0
98165,5,1,343893,343893,343894,0,1,3
98166,3,3,343896,343896,343899,0,3,2
98167,1,2,343897,343899,343901,2,4,0
98168,2,3,343899,343901,343904,2,5,0
98169,4,1,343903,343904,343905,1,2,0
98170,2,3,343905,343905,343908,0,3,0
98171,5,3,343910,343910,343913,0,3,2
98172,5,2,343915,343915,343917,0,2,2
98173,4,2,343919,343919,343921,0,2,2
98174,6,2,343925,343925,343927,0,2,4
98175,2,1,343927,343927,343928,0,1,0
98176,5,2,343932,343932,343934,0,2,4
98177,4,1,343936,343936,343937,0,1,2
98178,4,3,343940,343940,343943,0,3,3
98179,5,2,343945,343945,343947,0,2,2
98180,3,1,343948,343948,343949,0,1,1
98181,4,3,343952,343952,343955,0,3,3
98182,3,1,343955,343955,343956,0,1,0
98183,2,1,343957,343957,343958,0,1,1
98184,4,3,343961,343961,343964,0,3,3
98185,6,3,343967,343967,343970,0,3,3
98186,3,2,343970,343970,343972,0,2,0
98187,1,3,343971,343972,343975,1,4,0
98188,3,2,343974,343975,343977,1,3,0
98189,5,1,343979,343979,343980,0,1,2
98190,6,1,343985,343985,343986,0,1,5
98191,6,2,343991,343991,343993,0,2,5
98192,6,2,343997,343997,343999,0,2,4
98193,1,3,343998,343999,344002,1,4,0
98194,6,3,344004,344004,344007,0,3,2
98195,5,3,344009,344009,344012,0,3,2
98196,1,1,344010,344012,344013,2,3,0
98197,1,1,344011,344013,344014,2,3,0
98198,5,1,344016,344016,344017,0,1,2
98199,4,2,344020,344020,344022,0,2,3
98200,6,3,344026,344026,344029,0,3,4
98201,4,1,344030,344030,344031,0,1,1
98202,4,2,344034,344034,344036,0,2,3
98203,5,3,344039,344039,344042,0,3,3
98204,5,1,344044,344044,344045,0,1,2
98205,2,3,344046,344046,344049,0,3,1
98206,4,3,344050,344050,344053,0,3,1
98207,5,1,344055,344055,344056,0,1,2
98208,3,1,344058,344058,344059,0,1,2
98209,4,3,344062,344062,344065,0,3,3
98210,4,2,344066,344066,344068,0,2,1
98211,4,1,344070,344070,344071,0,1,2
98212,4,2,344074,344074,344076,0,2,3
98213,1,2,344075,344076,344078,1,3,0
98214,1,1,344076,344078,344079,2,3,0
98215,2,2,344078,344079,344081,1,3,0
98216,2,1,344080,344081,344082,1,2,0
98217,1,1,344081,344082,344083,1,2,0
98218,4,1,344085,344085,344086,0,1,2
98219,6,1,344091,344091,344092,0,1,5
98220,1,2,344092,344092,344094,0,2,0
98221,1,1,344093,344094,344095,1,2,0
98222,4,1,344097,344097,344098,0,1,2
98223,3,1,344100,344100,344101,0,1,2
98224,3,2,344103,344103,344105,0,2,2
98225,5,3,344108,344108,344111,0,3,3
98226,2,3,344110,344111,344114,1,4,0
98227,3,1,344113,344114,344115,1,2,0
98228,2,3,344115,344115,344118,0,3,0
98229,5,1,344120,344120,344121,0,1,2
98230,2,1,344122,344122,344123,0,1,1
98231,6,1,344128,344128,344129,0,1,5
98232,6,2,344134,344134,344136,0,2,5
98233,6,2,344140,344140,344142,0,2,4
98234,3,1,344143,344143,344144,0,1,1
98235,3,2,344146,344146,344148,0,2,2
98236,2,1,344148,344148,344149,0,1,0
98237,6,1,344154,344154,344155,0,1,5
98238,1,2,344155,344155,344157,0,2,0
98239,2,2,344157,344157,344159,0,2,0
98240,2,2,344159,344159,344161,0,2,0
98241,2,1,344161,344161,344162,0,1,0
98242,6,2,344167,344167,344169,0,2,5
98243,2,1,344169,344169,344170,0,1,0
98244,6,1,344175,344175,344176,0,1,5
98245,6,3,344181,344181,344184,0,3,5
98246,4,1,344185,344185,344186,0,1,1
98247,5,2,344190,344190,344192,0,2,4
98248,2,3,344192,344192,344195,0,3,0
98249,2,3,344194,344195,344198,1,4,0
98250,1,2,344195,344198,344200,3,5,0
98251,5,2,344200,344200,344202,0,2,0
98252,3,2,344203,344203,344205,0,2,1
98253,3,3,344206,344206,344209,0,3,1
98254,4,3,344210,344210,344213,0,3,1
98255,1,3,344211,344213,344216,2,5,0
98256,1,2,344212,344216,344218,4,6,0
98257,2,3,344214,344218,344221,4,7,0
98258,1,3,344215,344221,344224,6,9,0
98259,5,3,344220,344224,344227,4,7,0
98260,4,3,344224,344227,344230,3,6,0
98261,6,3,344230,344230,344233,0,3,0
98262,6,1,344236,344236,344237,0,1,3
98263,6,1,344242,344242,344243,0,1,5
98264,3,1,344245,344245,344246,0,1,2
98265,5,3,344250,344250,344253,0,3,4
98266,4,2,344254,344254,344256,0,2,1
98267,5,2,344259,344259,344261,0,2,3
98268,3,2,344262,344262,344264,0,2,1
98269,4,2,344266,344266,344268,0,2,2
98270,2,1,344268,344268,344269,0,1,0
98271,2,3,344270,344270,344273,0,3,1
98272,2,3,344272,344273,344276,1,4,0
98273,2,2,344274,344276,344278,2,4,0
98274,4,1,344278,344278,344279,0,1,0
98275,5,2,344283,344283,344285,0,2,4
98276,5,3,344288,344288,344291,0,3,3
98277,3,3,344291,344291,344294,0,3,0
98278,3,3,344294,344294,344297,0,3,0
98279,5,3,344299,344299,344302,0,3,2
98280,1,1,344300,344302,344303,2,3,0
98281,1,3,344301,344303,344306,2,5,0
98282,4,1,344305,344306,344307,1,2,0
98283,1,3,344306,344307,344310,1,4,0
98284,6,1,344312,344312,344313,0,1,2
98285,1,2,344313,344313,344315,0,2,0
98286,5,2,344318,344318,344320,0,2,3
98287,2,3,344320,344320,344323,0,3,0
98288,4,1,344324,344324,344325,0,1,1
98289,6,2,344330,344330,344332,0,2,5
98290,5,1,344335,344335,344336,0,1,3
98291,1,3,344336,344336,344339,0,3,0
98292,6,1,344342,344342,344343,0,1,3
98293,4,3,344346,344346,344349,0,3,3
98294,6,1,344352,344352,344353,0,1,3
98295,2,2,344354,344354,344356,0,2,1
98296,2,3,344356,344356,344359,0,3,0
98297,4,2,344360,344360,344362,0,2,1
98298,2,3,344362,344362,344365,0,3,0
98299,5,1,344367,344367,344368,0,1,2
98300,4,1,344371,344371,344372,0,1,3
98301,4,1,344375,344375,344376,0,1,3
98302,2,1,344377,344377,344378,0,1,1
98303,5,1,344382,344382,344383,0,1,4
98304,4,1,344386,344386,344387,0,1,3
98305,2,2,344388,344388,344390,0,2,1
98306,3,2,344391,344391,344393,0,2,1
98307,2,1,344393,344393,344394,0,1,0
98308,6,3,344399,344399,344402,0,3,5
98309,6,3,344405,344405,344408,0,3,3
98310,5,1,344410,344410,344411,0,1,2
98311,6,2,344416,344416,344418,0,2,5
98312,6,3,344422,344422,344425,0,3,4
98313,1,3,344423,344425,344428,2,5,0
98314,4,1,344427,344428,344429,1,2,0
98315,6,1,344433,344433,344434,0,1,4
98316,2,1,344435,344435,344436,0,1,1
98317,5,1,344440,344440,344441,0,1,4
98318,6,1,344446,344446,344447,0,1,5
98319,4,2,344450,344450,344452,0,2,3
98320,4,1,344454,344454,344455,0,1,2
98321,2,2,344456,344456,344458,0,2,1
98322,2,3,344458,344458,344461,0,3,0
98323,2,2,344460,344461,344463,1,3,0
98324,1,2,344461,344463,344465,2,4,0
98325,5,1,344466,344466,344467,0,1,1
98326,4,2,344470,344470,344472,0,2,3
98327,1,3,344471,344472,344475,1,4,0
98328,5,1,344476,344476,344477,0,1,1
98329,3,3,344479,344479,344482,0,3,2
98330,5,1,344484,344484,344485,0,1,2
98331,1,1,344485,344485,344486,0,1,0
98332,3,3,344488,344488,344491,0,3,2
98333,1,1,344489,344491,344492,2,3,0
98334,3,1,344492,344492,344493,0,1,0
98335,1,2,344493,344493,344495,0,2,0
98336,1,2,344494,344495,344497,1,3,0
98337,6,1,344500,344500,344501,0,1,3
98338,4,2,344504,344504,344506,0,2,3
98339,3,3,344507,344507,344510,0,3,1
98340,2,2,344509,344510,344512,1,3,0
98341,3,3,344512,344512,344515,0,3,0
98342,4,2,344516,344516,344518,0,2,1
98343,3,3,344519,344519,344522,0,3,1
98344,1,2,344520,344522,344524,2,4,0
98345,3,1,344523,344524,344525,1,2,0
98346,5,1,344528,344528,344529,0,1,3
98347,5,1,344533,344533,344534,0,1,4
98348,6,2,344539,344539,344541,0,2,5
98349,2,3,344541,344541,344544,0,3,0
98350,3,2,344544,344544,344546,0,2,0
98351,4,3,344548,344548,344551,0,3,2
98352,6,2,344554,344554,344556,0,2,3
98353,2,2,344556,344556,344558,0,2,0
98354,4,1,344560,344560,344561,0,1,2
98355,1,3,344561,344561,344564,0,3,0
98356,6,2,344567,344567,344569,0,2,3
98357,5,3,344572,344572,344575,0,3,3
98358,1,3,344573,344575,344578,2,5,0
98359,5,2,344578,344578,344580,0,2,0
98360,2,3,344580,344580,344583,0,3,0
98361,4,2,344584,344584,344586,0,2,1
98362,3,3,344587,344587,344590,0,3,1
98363,2,3,344589,344590,344593,1,4,0
98364,4,1,344593,344593,344594,0,1,0
98365,5,1,344598,344598,344599,0,1,4
98366,6,3,344604,344604,344607,0,3,5
98367,6,1,344610,344610,344611,0,1,3
98368,3,2,344613,344613,344615,0,2,2
98369,2,3,344615,344615,344618,0,3,0
98370,6,1,344621,344621,344622,0,1,3
98371,4,3,344625,344625,344628,0,3,3
98372,1,2,344626,344628,344630,2,4,0
98373,4,1,344630,344630,344631,0,1,0
98374,3,1,344633,344633,344634,0,1,2
98375,2,1,344635,344635,344636,0,1,1
98376,3,2,344638,344638,344640,0,2,2
98377,6,3,344644,344644,344647,0,3,4
98378,2,1,344646,344647,344648,1,2,0
98379,6,2,344652,344652,344654,0,2,4
98380,2,2,344654,344654,344656,0,2,0
98381,4,2,344658,344658,344660,0,2,2
98382,4,2,344662,344662,344664,0,2,2
98383,4,2,344666,344666,344668,0,2,2
98384,2,2,344668,344668,344670,0,2,0
98385,6,1,344674,344674,344675,0,1,4
98386,3,1,344677,344677,344678,0,1,2
98387,1,1,344678,344678,344679,0,1,0
98388,1,1,344679,344679,344680,0,1,0
98389,4,3,344683,344683,344686,0,3,3
98390,1,2,344684,344686,344688,2,4,0
98391,4,3,344688,344688,344691,0,3,0
98392,2,2,344690,344691,344693,1,3,0
98393,6,3,344696,344696,344699,0,3,3
98394,2,3,344698,344699,344702,1,4,0
98395,4,1,344702,344702,344703,0,1,0
98396,6,1,344708,344708,344709,0,1,5
98397,3,2,344711,344711,344713,0,2,2
98398,5,3,344716,344716,344719,0,3,3
98399,5,2,344721,344721,344723,0,2,2
98400,5,1,344726,344726,344727,0,1,3
98401,1,3,344727,344727,344730,0,3,0
98402,3,1,344730,344730,344731,0,1,0
98403,3,3,344733,344733,344736,0,3,2
98404,6,2,344739,344739,344741,0,2,3
98405,4,1,344743,344743,344744,0,1,2
98406,5,3,344748,344748,344751,0,3,4
98407,5,2,344753,344753,344755,0,2,2
98408,5,3,344758,344758,344761,0,3,3
98409,3,2,344761,344761,344763,0,2,0
98410,5,3,344766,344766,344769,0,3,3
98411,5,1,344771,344771,344772,0,1,2
98412,2,1,344773,344773,344774,0,1,1
98413,1,1,344774,344774,344775,0,1,0
98414,6,3,344780,344780,344783,0,3,5
98415,3,2,344783,344783,344785,0,2,0
98416,6,2,344789,344789,344791,0,2,4
98417,6,3,344795,344795,344798,0,3,4
98418,3,3,344798,344798,344801,0,3,0
98419,3,2,344801,344801,344803,0,2,0
98420,4,3,344805,344805,344808,0,3,2
98421,6,3,344811,344811,344814,0,3,3
98422,4,1,344815,344815,344816,0,1,1
98423,6,2,344821,344821,344823,0,2,5
98424,2,1,344823,344823,344824,0,1,0
98425,3,3,344826,344826,344829,0,3,2
98426,6,1,344832,344832,344833,0,1,3
98427,4,3,344836,344836,344839,0,3,3
98428,2,1,344838,344839,344840,1,2,0
98429,1,2,344839,344840,344842,1,3,0
98430,4,2,344843,344843,344845,0,2,1
98431,2,3,344845,344845,344848,0,3,0
98432,6,2,344851,344851,344853,0,2,3
98433,6,1,344857,344857,344858,0,1,4
98434,3,2,344860,344860,344862,0,2,2
98435,4,2,344864,344864,344866,0,2,2
98436,3,3,344867,344867,344870,0,3,1
98437,4,3,344871,344871,344874,0,3,1
98438,1,2,344872,344874,344876,2,4,0
98439,2,1,344874,344876,344877,2,3,0
98440,1,1,344875,344877,344878,2,3,0
98441,1,3,344876,344878,344881,2,5,0
98442,4,3,344880,344881,344884,1,4,0
98443,1,2,344881,344884,344886,3,5,0
98444,5,2,344886,344886,344888,0,2,0
98445,5,3,344891,344891,344894,0,3,3
98446,5,2,344896,344896,344898,0,2,2
98447,5,2,344901,344901,344903,0,2,3
98448,4,3,344905,344905,344908,0,3,2
98449,1,2,344906,344908,344910,2,4,0
98450,5,2,344911,344911,344913,0,2,1
98451,3,3,344914,344914,344917,0,3,1
98452,1,1,344915,344917,344918,2,3,0
98453,1,2,344916,344918,344920,2,4,0
98454,4,2,344920,344920,344922,0,2,0
98455,1,1,344921,344922,344923,1,2,0
98456,3,2,344924,344924,344926,0,2,1
98457,1,3,344925,344926,344929,1,4,0
98458,3,3,344928,344929,344932,1,4,0
98459,3,2,344931,344932,344934,1,3,0
98460,3,2,344934,344934,344936,0,2,0
98461,2,2,344936,344936,344938,0,2,0
98462,6,2,344942,344942,344944,0,2,4
98463,2,2,344944,344944,344946,0,2,0
98464,1,3,344945,344946,344949,1,4,0
98465,6,1,344951,344951,344952,0,1,2
98466,1,3,344952,344952,344955,0,3,0
98467,5,1,344957,344957,344958,0,1,2
98468,6,2,344963,344963,344965,0,2,5
98469,3,1,344966,344966,344967,0,1,1
98470,4,3,344970,344970,344973,0,3,3
98471,4,1,344974,344974,344975,0,1,1
98472,2,1,344976,344976,344977,0,1,1
98473,4,3,344980,344980,344983,0,3,3
98474,2,1,344982,344983,344984,1,2,0
98475,3,2,344985,344985,344987,0,2,1
98476,6,3,344991,344991,344994,0,3,4
98477,4,2,344995,344995,344997,0,2,1
98478,3,3,344998,344998,345001,0,3,1
98479,3,1,345001,345001,345002,0,1,0
98480,6,3,345007,345007,345010,0,3,5
98481,3,1,345010,345010,345011,0,1,0
98482,1,1,345011,345011,345012,0,1,0
98483,1,3,345012,345012,345015,0,3,0
98484,3,2,345015,345015,345017,0,2,0
98485,6,2,345021,345021,345023,0,2,4
98486,2,1,345023,345023,345024,0,1,0
98487,4,1,345027,345027,345028,0,1,3
98488,6,1,345033,345033,345034,0,1,5
98489,1,2,345034,345034,345036,0,2,0
98490,6,2,345040,345040,345042,0,2,4
98491,3,3,345043,345043,345046,0,3,1
98492,5,3,345048,345048,345051,0,3,2
98493,6,3,345054,345054,345057,0,3,3
98494,3,1,345057,345057,345058,0,1,0
98495,4,1,345061,345061,345062,0,1,3
98496,4,1,345065,345065,345066,0,1,3
98497,6,1,345071,345071,345072,0,1,5
98498,1,2,345072,345072,345074,0,2,0
98499,2,1,345074,345074,345075,0,1,0
98500,3,1,345077,345077,345078,0,1,2
98501,5,2,345082,345082,345084,0,2,4
98502,6,3,345088,345088,345091,0,3,4
98503,6,1,345094,345094,345095,0,1,3
98504,4,3,345098,345098,345101,0,3,3
98505,6,1,345104,345104,345105,0,1,3
98506,3,2,345107,345107,345109,0,2,2
98507,1,1,345108,345109,345110,1,2,0
98508,2,2,345110,345110,345112,0,2,0
98509,2,2,345112,345112,345114,0,2,0
98510,3,3,345115,345115,345118,0,3,1
98511,2,3,345117,345118,345121,1,4,0
98512,1,2,345118,345121,345123,3,5,0
98513,6,2,345124,345124,345126,0,2,1
98514,1,1,345125,345126,345127,1,2,0
98515,2,3,345127,345127,345130,0,3,0
98516,3,1,345130,345130,345131,0,1,0
98517,2,2,345132,345132,345134,0,2,1
98518,2,1,345134,345134,345135,0,1,0
98519,4,3,345138,345138,345141,0,3,3
98520,6,3,345144,345144,345147,0,3,3
98521,1,2,345145,345147,345149,2,4,0
98522,1,2,345146,345149,345151,3,5,0
98523,4,1,345150,345151,345152,1,2,0
98524,1,2,345151,345152,345154,1,3,0
98525,2,3,345153,345154,345157,1,4,0
98526,2,3,345155,345157,345160,2,5,0
98527,3,1,345158,345160,345161,2,3,0
98528,3,3,345161,345161,345164,0,3,0
98529,5,1,345166,345166,345167,0,1,2
98530,6,2,345172,345172,345174,0,2,5
98531,1,1,345173,345174,345175,1,2,0
98532,5,3,345178,345178,345181,0,3,3
98533,2,2,345180,345181,345183,1,3,0
98534,6,2,345186,345186,345188,0,2,3
98535,2,3,345188,345188,345191,0,3,0
98536,1,1,345189,345191,345192,2,3,0
98537,2,3,345191,345192,345195,1,4,0
98538,3,1,345194,345195,345196,1,2,0
98539,2,3,345196,345196,345199,0,3,0
98540,5,1,345201,345201,345202,0,1,2
98541,5,1,345206,345206,345207,0,1,4
98542,1,2,345207,345207,345209,0,2,0
98543,5,2,345212,345212,345214,0,2,3
98544,6,3,345218,345218,345221,0,3,4
98545,3,1,345221,345221,345222,0,1,0
98546,1,2,345222,345222,345224,0,2,0
98547,1,1,345223,345224,345225,1,2,0
98548,3,1,345226,345226,345227,0,1,1
98549,4,1,345230,345230,345231,0,1,3
98550,1,3,345231,345231,345234,0,3,0
98551,1,1,345232,345234,345235,2,3,0
98552,5,3,345237,345237,345240,0,3,2
98553,4,2,345241,345241,345243,0,2,1
98554,5,1,345246,345246,345247,0,1,3
98555,6,1,345252,345252,345253,0,1,5
98556,5,2,345257,345257,345259,0,2,4
98557,4,1,345261,345261,345262,0,1,2
98558,5,1,345266,345266,345267,0,1,4
98559,1,2,345267,345267,345269,0,2,0
98560,4,3,345271,345271,345274,0,3,2
98561,5,2,345276,345276,345278,0,2,2
98562,1,3,345277,345278,345281,1,4,0
98563,6,1,345283,345283,345284,0,1,2
98564,3,3,345286,345286,345289,0,3,2
98565,3,2,345289,345289,345291,0,2,0
98566,2,2,345291,345291,345293,0,2,0
98567,1,3,345292,345293,345296,1,4,0
98568,4,1,345296,345296,345297,0,1,0
98569,1,3,345297,345297,345300,0,3,0
98570,2,1,345299,345300,345301,1,2,0
98571,3,2,345302,345302,345304,0,2,1
98572,4,1,345306,345306,345307,0,1,2
98573,4,2,345310,345310,345312,0,2,3
98574,6,1,345316,345316,345317,0,1,4
98575,5,1,345321,345321,345322,0,1,4
98576,2,1,345323,345323,345324,0,1,1
98577,1,2,345324,345324,345326,0,2,0
98578,1,1,345325,345326,345327,1,2,0
98579,6,3,345331,345331,345334,0,3,4
98580,3,2,345334,345334,345336,0,2,0
98581,6,2,345340,345340,345342,0,2,4
98582,1,1,345341,345342,345343,1,2,0
98583,4,1,345345,345345,345346,0,1,2
98584,5,3,345350,345350,345353,0,3,4
98585,3,1,345353,345353,345354,0,1,0
98586,2,2,345355,345355,345357,0,2,1
98587,6,2,345361,345361,345363,0,2,4
98588,4,2,345365,345365,345367,0,2,2
98589,4,1,345369,345369,345370,0,1,2
98590,2,1,345371,345371,345372,0,1,1
98591,4,3,345375,345375,345378,0,3,3
98592,6,3,345381,345381,345384,0,3,3
98593,2,2,345383,345384,345386,1,3,0
98594,4,2,345387,345387,345389,0,2,1
98595,6,3,345393,345393,345396,0,3,4
98596,5,3,345398,345398,345401,0,3,2
98597,3,1,345401,345401,345402,0,1,0
98598,2,1,345403,345403,345404,0,1,1
98599,6,3,345409,345409,345412,0,3,5
98600,5,3,345414,345414,345417,0,3,2
98601,5,1,345419,345419,345420,0,1,2
98602,3,1,345422,345422,345423,0,1,2
98603,4,3,345426,345426,345429,0,3,3
98604,6,1,345432,345432,345433,0,1,3
98605,5,3,345437,345437,345440,0,3,4
98606,6,3,345443,345443,345446,0,3,3
98607,5,3,345448,345448,345451,0,3,2
98608,3,2,345451,345451,345453,0,2,0
98609,1,2,345452,345453,345455,1,3,0
98610,2,2,345454,345455,345457,1,3,0
98611,3,1,345457,345457,345458,0,1,0
98612,5,1,345462,345462,345463,0,1,4
98613,1,1,345463,345463,345464,0,1,0
98614,5,3,345468,345468,345471,0,3,4
98615,1,2,345469,345471,345473,2,4,0
98616,2,1,345471,345473,345474,2,3,0
98617,6,1,345477,345477,345478,0,1,3
98618,6,2,345483,345483,345485,0,2,5
98619,3,1,345486,345486,345487,0,1,1
98620,2,1,345488,345488,345489,0,1,1
98621,3,2,345491,345491,345493,0,2,2
98622,5,1,345496,345496,345497,0,1,3
98623,6,3,345502,345502,345505,0,3,5
98624,4,1,345506,345506,345507,0,1,1
98625,6,2,345512,345512,345514,0,2,5
98626,2,3,345514,345514,345517,0,3,0
98627,6,1,345520,345520,345521,0,1,3
98628,3,2,345523,345523,345525,0,2,2
98629,2,2,345525,345525,345527,0,2,0
98630,1,3,345526,345527,345530,1,4,0
98631,4,2,345530,345530,345532,0,2,0
98632,4,2,345534,345534,345536,0,2,2
98633,2,2,345536,345536,345538,0,2,0
98634,6,3,345542,345542,345545,0,3,4
98635,1,1,345543,345545,345546,2,3,0
98636,2,1,345545,345546,345547,1,2,0
98637,1,3,345546,345547,345550,1,4,0
98638,6,3,345552,345552,345555,0,3,2
98639,3,3,345555,345555,345558,0,3,0
98640,6,1,345561,345561,345562,0,1,3
98641,2,1,345563,345563,345564,0,1,1
98642,3,2,345566,345566,345568,0,2,2
98643,4,2,345570,345570,345572,0,2,2
98644,4,3,345574,345574,345577,0,3,2
98645,5,2,345579,345579,345581,0,2,2
98646,5,2,345584,345584,345586,0,2,3
98647,2,1,345586,345586,345587,0,1,0
98648,2,2,345588,345588,345590,0,2,1
98649,2,2,345590,345590,345592,0,2,0
98650,1,3,345591,345592,345595,1,4,0
98651,1,1,345592,345595,345596,3,4,0
98652,2,2,345594,345596,345598,2,4,0
98653,6,1,345600,345600,345601,0,1,2
98654,2,2,345602,345602,345604,0,2,1
98655,2,1,345604,345604,345605,0,1,0
98656,5,3,345609,345609,345612,0,3,4
98657,1,2,345610,345612,345614,2,4,0
98658,4,1,345614,345614,345615,0,1,0
98659,2,3,345616,345616,345619,0,3,1
98660,3,1,345619,345619,345620,0,1,0
98661,5,1,345624,345624,345625,0,1,4
98662,1,2,345625,345625,345627,0,2,0
98663,5,2,345630,345630,345632,0,2,3
98664,2,3,345632,345632,345635,0,3,0
98665,3,1,345635,345635,345636,0,1,0
98666,3,2,345638,345638,345640,0,2,2
98667,2,1,345640,345640,345641,0,1,0
98668,4,1,345644,345644,345645,0,1,3
98669,6,2,345650,345650,345652,0,2,5
98670,1,1,345651,345652,345653,1,2,0
98671,3,1,345654,345654,345655,0,1,1
98672,1,2,345655,345655,345657,0,2,0
98673,3,3,345658,345658,345661,0,3,1
98674,4,2,345662,345662,345664,0,2,1
98675,2,2,345664,345664,345666,0,2,0
98676,2,3,345666,345666,345669,0,3,0
98677,2,3,345668,345669,345672,1,4,0
98678,4,2,345672,345672,345674,0,2,0
98679,2,1,345674,345674,345675,0,1,0
98680,4,3,345678,345678,345681,0,3,3
98681,2,3,345680,345681,345684,1,4,0
98682,4,3,345684,345684,345687,0,3,0
98683,4,3,345688,345688,345691,0,3,1
98684,2,3,345690,345691,345694,1,4,0
98685,5,3,345695,345695,345698,0,3,1
98686,3,3,345698,345698,345701,0,3,0
98687,5,1,345703,345703,345704,0,1,2
98688,3,2,345706,345706,345708,0,2,2
98689,6,2,345712,345712,345714,0,2,4
98690,3,2,345715,345715,345717,0,2,1
98691,5,2,345720,345720,345722,0,2,3
98692,3,1,345723,345723,345724,0,1,1
98693,1,3,345724,345724,345727,0,3,0
98694,1,2,345725,345727,345729,2,4,0
98695,6,1,345731,345731,345732,0,1,2
98696,5,3,345736,345736,345739,0,3,4
98697,4,3,345740,345740,345743,0,3,1
98698,4,3,345744,345744,345747,0,3,1
98699,1,1,345745,345747,345748,2,3,0
98700,6,3,345751,345751,345754,0,3,3
98701,4,2,345755,345755,345757,0,2,1
98702,1,1,345756,345757,345758,1,2,0
98703,4,3,345760,345760,345763,0,3,2
98704,3,3,345763,345763,345766,0,3,0
98705,1,1,345764,345766,345767,2,3,0
98706,2,2,345766,345767,345769,1,3,0
98707,5,1,345771,345771,345772,0,1,2
98708,4,1,345775,345775,345776,0,1,3
98709,5,2,345780,345780,345782,0,2,4
98710,2,3,345782,345782,345785,0,3,0
98711,3,3,345785,345785,345788,0,3,0
98712,2,3,345787,345788,345791,1,4,0
98713,5,1,345792,345792,345793,0,1,1
98714,4,2,345796,345796,345798,0,2,3
98715,3,2,345799,345799,345801,0,2,1
98716,1,3,345800,345801,345804,1,4,0
98717,5,2,345805,345805,345807,0,2,1
98718,1,3,345806,345807,345810,1,4,0
98719,4,3,345810,345810,345813,0,3,0
98720,5,3,345815,345815,345818,0,3,2
98721,4,2,345819,345819,345821,0,2,1
98722,4,3,345823,345823,345826,0,3,2
98723,1,1,345824,345826,345827,2,3,0
98724,6,3,345830,345830,345833,0,3,3
98725,3,3,345833,345833,345836,0,3,0
98726,5,3,345838,345838,345841,0,3,2
98727,3,1,345841,345841,345842,0,1,0
98728,3,1,345844,345844,345845,0,1,2
98729,5,1,345849,345849,345850,0,1,4
98730,6,2,345855,345855,345857,0,2,5
98731,2,1,345857,345857,345858,0,1,0
98732,2,3,345859,345859,345862,0,3,1
98733,3,3,345862,345862,345865,0,3,0
98734,2,3,345864,345865,345868,1,4,0
98735,4,2,345868,345868,345870,0,2,0
98736,2,2,345870,345870,345872,0,2,0
98737,6,1,345876,345876,345877,0,1,4
98738,1,2,345877,345877,345879,0,2,0
98739,1,1,345878,345879,345880,1,2,0
98740,1,2,345879,345880,345882,1,3,0
98741,1,1,345880,345882,345883,2,3,0
98742,2,2,345882,345883,345885,1,3,0
98743,4,3,345886,345886,345889,0,3,1
98744,2,2,345888,345889,345891,1,3,0
98745,5,3,345893,345893,345896,0,3,2
98746,4,2,345897,345897,345899,0,2,1
98747,4,3,345901,345901,345904,0,3,2
98748,4,3,345905,345905,345908,0,3,1
98749,1,2,345906,345908,345910,2,4,0
98750,6,1,345912,345912,345913,0,1,2
98751,5,1,345917,345917,345918,0,1,4
98752,6,1,345923,345923,345924,0,1,5
98753,1,1,345924,345924,345925,0,1,0
98754,2,2,345926,345926,345928,0,2,1
98755,3,2,345929,345929,345931,0,2,1
98756,4,3,345933,345933,345936,0,3,2
98757,4,2,345937,345937,345939,0,2,1
98758,6,1,345943,345943,345944,0,1,4
98759,3,3,345946,345946,345949,0,3,2
98760,3,3,345949,345949,345952,0,3,0
98761,6,1,345955,345955,345956,0,1,3
98762,2,3,345957,345957,345960,0,3,1
98763,2,3,345959,345960,345963,1,4,0
98764,4,1,345963,345963,345964,0,1,0
98765,1,3,345964,345964,345967,0,3,0
98766,3,2,345967,345967,345969,0,2,0
98767,6,1,345973,345973,345974,0,1,4
98768,5,1,345978,345978,345979,0,1,4
98769,1,3,345979,345979,345982,0,3,0
98770,6,3,345985,345985,345988,0,3,3
98771,2,3,345987,345988,345991,1,4,0
98772,4,3,345991,345991,345994,0,3,0
98773,6,1,345997,345997,345998,0,1,3
98774,4,3,346001,346001,346004,0,3,3
98775,2,1,346003,346004,346005,1,2,0
98776,2,1,346005,346005,346006,0,1,0
98777,4,3,346009,346009,346012,0,3,3
98778,3,2,346012,346012,346014,0,2,0
98779,5,3,346017,346017,346020,0,3,3
98780,2,3,346019,346020,346023,1,4,0
98781,6,1,346025,346025,346026,0,1,2
98782,6,3,346031,346031,346034,0,3,5
98783,3,3,346034,346034,346037,0,3,0
98784,6,1,346040,346040,346041,0,1,3
98785,3,3,346043,346043,346046,0,3,2
98786,2,3,346045,346046,346049,1,4,0
98787,6,1,346051,346051,346052,0,1,2
98788,3,2,346054,346054,346056,0,2,2
98789,1,2,346055,346056,346058,1,3,0
98790,2,2,346057,346058,346060,1,3,0
98791,4,2,346061,346061,346063,0,2,1
98792,6,2,346067,346067,346069,0,2,4
98793,6,3,346073,346073,346076,0,3,4
98794,6,1,346079,346079,346080,0,1,3
98795,4,1,346083,346083,346084,0,1,3
98796,1,3,346084,346084,346087,0,3,0
98797,4,3,346088,346088,346091,0,3,1
98798,4,3,346092,346092,346095,0,3,1
98799,1,1,346093,346095,346096,2,3,0
98800,2,3,346095,346096,346099,1,4,0
98801,1,2,346096,346099,346101,3,5,0
98802,6,3,346102,346102,346105,0,3,1
98803,3,1,346105,346105,346106,0,1,0
98804,4,2,346109,346109,346111,0,2,3
98805,3,3,346112,346112,346115,0,3,1
98806,6,3,346118,346118,346121,0,3,3
98807,5,3,346123,346123,346126,0,3,2
98808,3,3,346126,346126,346129,0,3,0
98809,1,3,346127,346129,346132,2,5,0
98810,2,3,346129,346132,346135,3,6,0
98811,4,1,346133,346135,346136,2,3,0
98812,2,2,346135,346136,346138,1,3,0
98813,4,3,346139,346139,346142,0,3,1
98814,1,3,346140,346142,346145,2,5,0
98815,3,3,346143,346145,346148,2,5,0
98816,1,2,346144,346148,346150,4,6,0
98817,5,3,346149,346150,346153,1,4,0
98818,5,2,346154,346154,346156,0,2,1
98819,2,1,346156,346156,346157,0,1,0
98820,2,2,346158,346158,346160,0,2,1
98821,5,3,346163,346163,346166,0,3,3
98822,5,3,346168,346168,346171,0,3,2
98823,3,2,346171,346171,346173,0,2,0
98824,5,3,346176,346176,346179,0,3,3
98825,3,1,346179,346179,346180,0,1,0
98826,6,2,346185,346185,346187,0,2,5
98827,6,1,346191,346191,346192,0,1,4
98828,3,2,346194,346194,346196,0,2,2
98829,5,2,346199,346199,346201,0,2,3
98830,5,3,346204,346204,346207,0,3,3
98831,3,3,346207,346207,346210,0,3,0
98832,6,3,346213,346213,346216,0,3,3
98833,4,2,346217,346217,346219,0,2,1
98834,2,3,346219,346219,346222,0,3,0
98835,5,2,346224,346224,346226,0,2,2
98836,1,1,346225,346226,346227,1,2,0
98837,4,2,346229,346229,346231,0,2,2
98838,3,1,346232,346232,346233,0,1,1
98839,3,1,346235,346235,346236,0,1,2
98840,2,3,346237,346237,346240,0,3,1
98841,5,2,346242,346242,346244,0,2,2
98842,5,1,346247,346247,346248,0,1,3
98843,4,2,346251,346251,346253,0,2,3
98844,3,3,346254,346254,346257,0,3,1
98845,3,1,346257,346257,346258,0,1,0
98846,2,2,346259,346259,346261,0,2,1
98847,6,2,346265,346265,346267,0,2,4
98848,4,3,346269,346269,346272,0,3,2
98849,6,2,346275,346275,346277,0,2,3
98850,5,3,346280,346280,346283,0,3,3
98851,1,3,346281,346283,346286,2,5,0
98852,3,3,346284,346286,346289,2,5,0
98853,5,3,346289,346289,346292,0,3,0
98854,6,1,346295,346295,346296,0,1,3
98855,3,3,346298,346298,346301,0,3,2
98856,2,1,346300,346301,346302,1,2,0
98857,4,3,346304,346304,346307,0,3,2
98858,2,1,346306,346307,346308,1,2,0
98859,3,2,346309,346309,346311,0,2,1
98860,2,2,346311,346311,346313,0,2,0
98861,2,1,346313,346313,346314,0,1,0
98862,6,3,346319,346319,346322,0,3,5
98863,5,3,346324,346324,346327,0,3,2
98864,5,2,346329,346329,346331,0,2,2
98865,1,3,346330,346331,346334,1,4,0
98866,1,2,346331,346334,346336,3,5,0
98867,1,1,346332,346336,346337,4,5,0
98868,3,3,346335,346337,346340,2,5,0
98869,6,3,346341,346341,346344,0,3,1
98870,1,3,346342,346344,346347,2,5,0
98871,3,3,346345,346347,346350,2,5,0
98872,1,2,346346,346350,346352,4,6,0
98873,3,3,346349,346352,346355,3,6,0
98874,3,3,346352,346355,346358,3,6,0
98875,3,3,346355,346358,346361,3,6,0
98876,1,2,346356,346361,346363,5,7,0
98877,3,3,346359,346363,346366,4,7,0
98878,5,1,346364,346366,346367,2,3,0
98879,6,1,346370,346370,346371,0,1,3
98880,4,2,346374,346374,346376,0,2,3
98881,5,1,346379,346379,346380,0,1,3
98882,4,1,346383,346383,346384,0,1,3
98883,2,1,346385,346385,346386,0,1,1
98884,5,1,346390,346390,346391,0,1,4
98885,3,1,346393,346393,346394,0,1,2
98886,1,2,346394,346394,346396,0,2,0
98887,6,2,346400,346400,346402,0,2,4
98888,6,3,346406,346406,346409,0,3,4
98889,1,1,346407,346409,346410,2,3,0
98890,2,3,346409,346410,346413,1,4,0
98891,1,1,346410,346413,346414,3,4,0
98892,2,2,346412,346414,346416,2,4,0
98893,4,1,346416,346416,346417,0,1,0
98894,6,3,346422,346422,346425,0,3,5
98895,1,3,346423,346425,346428,2,5,0
98896,3,3,346426,346428,346431,2,5,0
98897,3,3,346429,346431,346434,2,5,0
98898,1,1,346430,346434,346435,4,5,0
98899,1,3,346431,346435,346438,4,7,0
98900,4,3,346435,346438,346441,3,6,0
98901,3,2,346438,346441,346443,3,5,0
98902,4,1,346442,346443,346444,1,2,0
98903,3,2,346445,346445,346447,0,2,1
98904,2,3,346447,346447,346450,0,3,0
98905,1,2,346448,346450,346452,2,4,0
98906,4,3,346452,346452,346455,0,3,0
98907,5,2,346457,346457,346459,0,2,2
98908,6,3,346463,346463,346466,0,3,4
98909,6,2,346469,346469,346471,0,2,3
98910,4,2,346473,346473,346475,0,2,2
98911,2,2,346475,346475,346477,0,2,0
98912,3,1,346478,346478,346479,0,1,1
98913,2,1,346480,346480,346481,0,1,1
98914,2,2,346482,346482,346484,0,2,1
98915,1,2,346483,346484,346486,1,3,0
98916,4,3,346487,346487,346490,0,3,1
98917,2,1,346489,346490,346491,1,2,0
98918,5,3,346494,346494,346497,0,3,3
98919,4,3,346498,346498,346501,0,3,1
98920,3,3,346501,346501,346504,0,3,0
98921,2,2,346503,346504,346506,1,3,0
98922,3,3,346506,346506,346509,0,3,0
98923,2,3,346508,346509,346512,1,4,0
98924,1,2,346509,346512,346514,3,5,0
98925,3,1,346512,346514,346515,2,3,0
98926,6,2,346518,346518,346520,0,2,3
98927,6,3,346524,346524,346527,0,3,4
98928,4,3,346528,346528,346531,0,3,1
98929,1,3,346529,346531,346534,2,5,0
98930,6,3,346535,346535,346538,0,3,1
98931,3,3,346538,346538,346541,0,3,0
98932,5,2,346543,346543,346545,0,2,2
98933,4,2,346547,346547,346549,0,2,2
98934,6,2,346553,346553,346555,0,2,4
98935,1,3,346554,346555,346558,1,4,0
98936,4,1,346558,346558,346559,0,1,0
98937,1,2,346559,346559,346561,0,2,0
98938,6,1,346565,346565,346566,0,1,4
98939,3,1,346568,346568,346569,0,1,2
98940,1,1,346569,346569,346570,0,1,0
98941,2,3,346571,346571,346574,0,3,1
98942,3,1,346574,346574,346575,0,1,0
98943,4,1,346578,346578,346579,0,1,3
98944,5,2,346583,346583,346585,0,2,4
98945,5,2,346588,346588,346590,0,2,3
98946,5,3,346593,346593,346596,0,3,3
98947,3,3,346596,346596,346599,0,3,0
98948,4,2,346600,346600,346602,0,2,1
98949,5,3,346605,346605,346608,0,3,3
98950,3,3,346608,346608,346611,0,3,0
98951,3,2,346611,346611,346613,0,2,0
98952,3,1,346614,346614,346615,0,1,1
98953,2,2,346616,346616,346618,0,2,1
98954,6,3,346622,346622,346625,0,3,4
98955,1,2,346623,346625,346627,2,4,0
98956,3,1,346626,346627,346628,1,2,0
98957,3,3,346629,346629,346632,0,3,1
98958,4,3,346633,346633,346636,0,3,1
98959,2,1,346635,346636,346637,1,2,0
98960,5,2,346640,346640,346642,0,2,3
98961,2,2,346642,346642,346644,0,2,0
98962,3,3,346645,346645,346648,0,3,1
98963,4,3,346649,346649,346652,0,3,1
98964,5,2,346654,346654,346656,0,2,2
98965,3,1,346657,346657,346658,0,1,1
98966,4,1,346661,346661,346662,0,1,3
98967,2,1,346663,346663,346664,0,1,1
98968,1,1,346664,346664,346665,0,1,0
98969,4,2,346668,346668,346670,0,2,3
98970,1,1,346669,346670,346671,1,2,0
98971,1,2,346670,346671,346673,1,3,0
98972,2,3,346672,346673,346676,1,4,0
98973,2,2,346674,346676,346678,2,4,0
98974,3,3,346677,346678,346681,1,4,0
98975,4,1,346681,346681,346682,0,1,0
98976,3,1,346684,346684,346685,0,1,2
98977,4,3,346688,346688,346691,0,3,3
98978,6,1,346694,346694,346695,0,1,3
98979,1,1,346695,346695,346696,0,1,0
98980,1,3,346696,346696,346699,0,3,0
98981,5,2,346701,346701,346703,0,2,2
98982,5,3,346706,346706,346709,0,3,3
98983,5,2,346711,346711,346713,0,2,2
98984,5,3,346716,346716,346719,0,3,3
98985,6,1,346722,346722,346723,0,1,3
98986,4,3,346726,346726,346729,0,3,3
98987,2,2,346728,346729,346731,1,3,0
98988,6,1,346734,346734,346735,0,1,3
98989,1,2,346735,346735,346737,0,2,0
98990,1,1,346736,346737,346738,1,2,0
98991,1,3,346737,346738,346741,1,4,0
98992,1,2,346738,346741,346743,3,5,0
98993,1,1,346739,346743,346744,4,5,0
98994,5,1,346744,346744,346745,0,1,0
98995,3,1,346747,346747,346748,0,1,2
98996,2,1,346749,346749,346750,0,1,1
98997,5,2,346754,346754,346756,0,2,4
98998,6,3,346760,346760,346763,0,3,4
98999,2,3,346762,346763,346766,1,4,0
99000,3,3,346765,346766,346769,1,4,0
99001,1,1,346766,346769,346770,3,4,0
99002,6,1,346772,346772,346773,0,1,2
99003,2,3,346774,346774,346777,0,3,1
99004,2,1,346776,346777,346778,1,2,0
99005,4,2,346780,346780,346782,0,2,2
99006,6,1,346786,346786,346787,0,1,4
99007,4,2,346790,346790,346792,0,2,3
99008,3,2,346793,346793,346795,0,2,1
99009,6,1,346799,346799,346800,0,1,4
99010,1,3,346800,346800,346803,0,3,0
99011,1,3,346801,346803,346806,2,5,0
99012,1,2,346802,346806,346808,4,6,0
99013,5,3,346807,346808,346811,1,4,0
99014,5,3,346812,346812,346815,0,3,1
99015,4,1,346816,346816,346817,0,1,1
99016,5,1,346821,346821,346822,0,1,4
99017,3,1,346824,346824,346825,0,1,2
99018,3,1,346827,346827,346828,0,1,2
99019,6,1,346833,346833,346834,0,1,5
99020,6,2,346839,346839,346841,0,2,5
99021,4,2,346843,346843,346845,0,2,2
99022,3,3,346846,346846,346849,0,3,1
99023,3,1,346849,346849,346850,0,1,0
99024,5,3,346854,346854,346857,0,3,4
99025,1,1,346855,346857,346858,2,3,0
99026,3,1,346858,346858,346859,0,1,0
99027,5,2,346863,346863,346865,0,2,4
99028,5,1,346868,346868,346869,0,1,3
99029,1,1,346869,346869,346870,0,1,0
99030,3,2,346872,346872,346874,0,2,2
99031,5,3,346877,346877,346880,0,3,3
99032,5,1,346882,346882,346883,0,1,2
99033,4,1,346886,346886,346887,0,1,3
99034,1,1,346887,346887,346888,0,1,0
99035,6,1,346893,346893,346894,0,1,5
99036,6,2,346899,346899,346901,0,2,5
99037,1,1,346900,346901,346902,1,2,0
99038,5,1,346905,346905,346906,0,1,3
99039,5,2,346910,346910,346912,0,2,4
99040,6,3,346916,346916,346919,0,3,4
99041,5,1,346921,346921,346922,0,1,2
99042,6,2,346927,346927,346929,0,2,5
99043,1,1,346928,346929,346930,1,2,0
99044,3,2,346931,346931,346933,0,2,1
99045,4,2,346935,346935,346937,0,2,2
99046,2,3,346937,346937,346940,0,3,0
99047,3,2,346940,346940,346942,0,2,0
99048,5,2,346945,346945,346947,0,2,3
99049,6,1,346951,346951,346952,0,1,4
99050,2,3,346953,346953,346956,0,3,1
99051,1,3,346954,346956,346959,2,5,0
99052,3,1,346957,346959,346960,2,3,0
99053,3,3,346960,346960,346963,0,3,0
99054,1,3,346961,346963,346966,2,5,0
99055,3,2,346964,346966,346968,2,4,0
99056,5,1,346969,346969,346970,0,1,1
99057,4,1,346973,346973,346974,0,1,3
99058,4,3,346977,346977,346980,0,3,3
99059,5,2,346982,346982,346984,0,2,2
99060,4,2,346986,346986,346988,0,2,2
99061,4,3,346990,346990,346993,0,3,2
99062,5,1,346995,346995,346996,0,1,2
99063,2,1,346997,346997,346998,0,1,1
99064,3,2,347000,347000,347002,0,2,2
99065,2,3,347002,347002,347005,0,3,0
99066,1,1,347003,347005,347006,2,3,0
99067,4,3,347007,347007,347010,0,3,1
99068,5,3,347012,347012,347015,0,3,2
99069,3,3,347015,347015,347018,0,3,0
99070,2,1,347017,347018,347019,1,2,0
99071,6,2,347023,347023,347025,0,2,4
99072,3,1,347026,347026,347027,0,1,1
99073,5,1,347031,347031,347032,0,1,4
99074,5,3,347036,347036,347039,0,3,4
99075,3,2,347039,347039,347041,0,2,0
99076,2,3,347041,347041,347044,0,3,0
99077,4,1,347045,347045,347046,0,1,1
99078,1,3,347046,347046,347049,0,3,0
99079,6,3,347052,347052,347055,0,3,3
99080,3,1,347055,347055,347056,0,1,0
99081,2,1,347057,347057,347058,0,1,1
99082,3,2,347060,347060,347062,0,2,2
99083,4,3,347064,347064,347067,0,3,2
99084,3,1,347067,347067,347068,0,1,0
99085,4,2,347071,347071,347073,0,2,3
99086,3,1,347074,347074,347075,0,1,1
99087,3,1,347077,347077,347078,0,1,2
99088,6,1,347083,347083,347084,0,1,5
99089,4,3,347087,347087,347090,0,3,3
99090,3,1,347090,347090,347091,0,1,0
99091,5,1,347095,347095,347096,0,1,4
99092,5,2,347100,347100,347102,0,2,4
99093,1,2,347101,347102,347104,1,3,0
99094,6,1,347107,347107,347108,0,1,3
99095,4,2,347111,347111,347113,0,2,3
99096,3,1,347114,347114,347115,0,1,1
99097,6,1,347120,347120,347121,0,1,5
99098,6,3,347126,347126,347129,0,3,5
99099,6,2,347132,347132,347134,0,2,3
99100,4,3,347136,347136,347139,0,3,2
99101,1,2,347137,347139,347141,2,4,0
99102,2,2,347139,347141,347143,2,4,0
99103,4,3,347143,347143,347146,0,3,0
99104,3,1,347146,347146,347147,0,1,0
99105,1,3,347147,347147,347150,0,3,0
99106,5,1,347152,347152,347153,0,1,2
99107,4,1,347156,347156,347157,0,1,3
99108,6,1,347162,347162,347163,0,1,5
99109,3,3,347165,347165,347168,0,3,2
99110,1,2,347166,347168,347170,2,4,0
99111,6,2,347172,347172,347174,0,2,2
99112,5,2,347177,347177,347179,0,2,3
99113,6,2,347183,347183,347185,0,2,4
99114,3,1,347186,347186,347187,0,1,1
99115,4,1,347190,347190,347191,0,1,3
99116,3,1,347193,347193,347194,0,1,2
99117,3,1,347196,347196,347197,0,1,2
99118,3,1,347199,347199,347200,0,1,2
99119,1,3,347200,347200,347203,0,3,0
99120,1,2,347201,347203,347205,2,4,0
99121,3,1,347204,347205,347206,1,2,0
99122,1,2,347205,347206,347208,1,3,0
99123,4,3,347209,347209,347212,0,3,1
99124,5,3,347214,347214,347217,0,3,2
99125,6,3,347220,347220,347223,0,3,3
99126,1,3,347221,347223,347226,2,5,0
99127,2,3,347223,347226,347229,3,6,0
99128,3,3,347226,347229,347232,3,6,0
99129,2,1,347228,347232,347233,4,5,0
99130,3,1,347231,347233,347234,2,3,0
99131,5,1,347236,347236,347237,0,1,2
99132,4,1,347240,347240,347241,0,1,3
99133,4,1,347244,347244,347245,0,1,3
99134,5,3,347249,347249,347252,0,3,4
99135,2,1,347251,347252,347253,1,2,0
99136,6,3,347257,347257,347260,0,3,4
99137,1,1,347258,347260,347261,2,3,0
99138,5,3,347263,347263,347266,0,3,2
99139,2,1,347265,347266,347267,1,2,0
99140,4,3,347269,347269,347272,0,3,2
99141,6,1,347275,347275,347276,0,1,3
99142,2,3,347277,347277,347280,0,3,1
99143,6,1,347283,347283,347284,0,1,3
99144,6,1,347289,347289,347290,0,1,5
99145,2,3,347291,347291,347294,0,3,1
99146,2,3,347293,347294,347297,1,4,0
99147,2,1,347295,347297,347298,2,3,0
99148,6,3,347301,347301,347304,0,3,3
99149,3,1,347304,347304,347305,0,1,0
99150,3,2,347307,347307,347309,0,2,2
99151,4,1,347311,347311,347312,0,1,2
99152,1,1,347312,347312,347313,0,1,0
99153,2,3,347314,347314,347317,0,3,1
99154,3,2,347317,347317,347319,0,2,0
99155,6,3,347323,347323,347326,0,3,4
99156,2,3,347325,347326,347329,1,4,0
99157,1,3,347326,347329,347332,3,6,0
99158,2,1,347328,347332,347333,4,5,0
99159,3,3,347331,347333,347336,2,5,0
99160,3,1,347334,347336,347337,2,3,0
99161,5,3,347339,347339,347342,0,3,2
99162,4,3,347343,347343,347346,0,3,1
99163,5,2,347348,347348,347350,0,2,2
99164,4,2,347352,347352,347354,0,2,2
99165,2,3,347354,347354,347357,0,3,0
99166,5,2,347359,347359,347361,0,2,2
99167,4,1,347363,347363,347364,0,1,2
99168,6,3,347369,347369,347372,0,3,5
99169,5,1,347374,347374,347375,0,1,2
99170,4,1,347378,347378,347379,0,1,3
99171,6,2,347384,347384,347386,0,2,5
99172,4,3,347388,347388,347391,0,3,2
99173,6,2,347394,347394,347396,0,2,3
99174,6,2,347400,347400,347402,0,2,4
99175,1,2,347401,347402,347404,1,3,0
99176,5,3,347406,347406,347409,0,3,2
99177,2,2,347408,347409,347411,1,3,0
99178,1,1,347409,347411,347412,2,3,0
99179,2,3,347411,347412,347415,1,4,0
99180,4,1,347415,347415,347416,0,1,0
99181,2,3,347417,347417,347420,0,3,1
99182,1,2,347418,347420,347422,2,4,0
99183,3,3,347421,347422,347425,1,4,0
99184,2,2,347423,347425,347427,2,4,0
99185,5,1,347428,347428,347429,0,1,1
99186,4,3,347432,347432,347435,0,3,3
99187,4,3,347436,347436,347439,0,3,1
99188,6,3,347442,347442,347445,0,3,3
99189,2,3,347444,347445,347448,1,4,0
99190,2,2,347446,347448,347450,2,4,0
99191,2,1,347448,347450,347451,2,3,0
99192,5,2,347453,347453,347455,0,2,2
99193,1,3,347454,347455,347458,1,4,0
99194,2,2,347456,347458,347460,2,4,0
99195,2,3,347458,347460,347463,2,5,0
99196,2,1,347460,347463,347464,3,4,0
99197,6,2,347466,347466,347468,0,2,2
99198,1,3,347467,347468,347471,1,4,0
99199,2,2,347469,347471,347473,2,4,0
99200,4,2,347473,347473,347475,0,2,0
99201,2,2,347475,347475,347477,0,2,0
99202,6,1,347481,347481,347482,0,1,4
99203,2,1,347483,347483,347484,0,1,1
99204,2,1,347485,347485,347486,0,1,1
99205,3,3,347488,347488,347491,0,3,2
99206,4,2,347492,347492,347494,0,2,1
99207,6,1,347498,347498,347499,0,1,4
99208,2,2,347500,347500,347502,0,2,1
99209,3,1,347503,347503,347504,0,1,1
99210,2,2,347505,347505,347507,0,2,1
99211,1,3,347506,347507,347510,1,4,0
99212,5,2,347511,347511,347513,0,2,1
99213,2,2,347513,347513,347515,0,2,0
99214,3,2,347516,347516,347518,0,2,1
99215,1,3,347517,347518,347521,1,4,0
99216,6,2,347523,347523,347525,0,2,2
99217,5,2,347528,347528,347530,0,2,3
99218,4,3,347532,347532,347535,0,3,2
99219,2,1,347534,347535,347536,1,2,0
99220,3,1,347537,347537,347538,0,1,1
99221,4,3,347541,347541,347544,0,3,3
99222,6,2,347547,347547,347549,0,2,3
99223,4,3,347551,347551,347554,0,3,2
99224,5,3,347556,347556,347559,0,3,2
99225,1,2,347557,347559,347561,2,4,0
99226,2,1,347559,347561,347562,2,3,0
99227,3,2,347562,347562,347564,0,2,0
99228,1,2,347563,347564,347566,1,3,0
99229,2,2,347565,347566,347568,1,3,0
99230,5,3,347570,347570,347573,0,3,2
99231,3,1,347573,347573,347574,0,1,0
99232,6,3,347579,347579,347582,0,3,5
99233,6,2,347585,347585,347587,0,2,3
99234,4,2,347589,347589,347591,0,2,2
99235,3,3,347592,347592,347595,0,3,1
99236,5,3,347597,347597,347600,0,3,2
99237,6,3,347603,347603,347606,0,3,3
99238,1,1,347604,347606,347607,2,3,0
99239,2,3,347606,347607,347610,1,4,0
99240,1,3,347607,347610,347613,3,6,0
99241,5,3,347612,347613,347616,1,4,0
99242,2,2,347614,347616,347618,2,4,0
99243,2,2,347616,347618,347620,2,4,0
99244,3,3,347619,347620,347623,1,4,0
99245,6,1,347625,347625,347626,0,1,2
99246,5,3,347630,347630,347633,0,3,4
99247,1,2,347631,347633,347635,2,4,0
99248,3,2,347634,347635,347637,1,3,0
99249,4,1,347638,347638,347639,0,1,1
99250,1,2,347639,347639,347641,0,2,0
99251,3,1,347642,347642,347643,0,1,1
99252,3,3,347645,347645,347648,0,3,2
99253,1,1,347646,347648,347649,2,3,0
99254,3,1,347649,347649,347650,0,1,0
99255,2,3,347651,347651,347654,0,3,1
99256,4,2,347655,347655,347657,0,2,1
99257,5,1,347660,347660,347661,0,1,3
99258,1,2,347661,347661,347663,0,2,0
99259,5,1,347666,347666,347667,0,1,3
99260,4,3,347670,347670,347673,0,3,3
99261,5,2,347675,347675,347677,0,2,2
99262,5,1,347680,347680,347681,0,1,3
99263,1,3,347681,347681,347684,0,3,0
99264,1,3,347682,347684,347687,2,5,0
99265,5,1,347687,347687,347688,0,1,0
99266,6,3,347693,347693,347696,0,3,5
99267,5,3,347698,347698,347701,0,3,2
99268,2,1,347700,347701,347702,1,2,0
99269,2,2,347702,347702,347704,0,2,0
99270,3,2,347705,347705,347707,0,2,1
99271,1,2,347706,347707,347709,1,3,0
99272,3,1,347709,347709,347710,0,1,0
99273,2,2,347711,347711,347713,0,2,1
99274,5,1,347716,347716,347717,0,1,3
99275,5,3,347721,347721,347724,0,3,4
99276,5,2,347726,347726,347728,0,2,2
99277,3,1,347729,347729,347730,0,1,1
99278,3,1,347732,347732,347733,0,1,2
99279,3,3,347735,347735,347738,0,3,2
99280,4,2,347739,347739,347741,0,2,1
99281,2,3,347741,347741,347744,0,3,0
99282,4,2,347745,347745,347747,0,2,1
99283,6,2,347751,347751,347753,0,2,4
99284,2,1,347753,347753,347754,0,1,0
99285,5,1,347758,347758,347759,0,1,4
99286,4,2,347762,347762,347764,0,2,3
99287,4,3,347766,347766,347769,0,3,2
99288,2,2,347768,347769,347771,1,3,0
99289,2,3,347770,347771,347774,1,4,0
99290,4,1,347774,347774,347775,0,1,0
99291,2,2,347776,347776,347778,0,2,1
99292,4,2,347780,347780,347782,0,2,2
99293,4,1,347784,347784,347785,0,1,2
99294,5,2,347789,347789,347791,0,2,4
99295,6,3,347795,347795,347798,0,3,4
99296,2,1,347797,347798,347799,1,2,0
99297,3,2,347800,347800,347802,0,2,1
99298,6,2,347806,347806,347808,0,2,4
99299,1,3,347807,347808,347811,1,4,0
99300,2,3,347809,347811,347814,2,5,0
99301,6,3,347815,347815,347818,0,3,1
99302,5,3,347820,347820,347823,0,3,2
99303,3,1,347823,347823,347824,0,1,0
99304,6,3,347829,347829,347832,0,3,5
99305,4,1,347833,347833,347834,0,1,1
99306,2,1,347835,347835,347836,0,1,1
99307,4,3,347839,347839,347842,0,3,3
99308,5,2,347844,347844,347846,0,2,2
99309,6,1,347850,347850,347851,0,1,4
99310,4,3,347854,347854,347857,0,3,3
99311,4,1,347858,347858,347859,0,1,1
99312,5,3,347863,347863,347866,0,3,4
99313,6,3,347869,347869,347872,0,3,3
99314,1,1,347870,347872,347873,2,3,0
99315,3,3,347873,347873,347876,0,3,0
99316,6,1,347879,347879,347880,0,1,3
99317,4,3,347883,347883,347886,0,3,3
99318,4,3,347887,347887,347890,0,3,1
99319,3,3,347890,347890,347893,0,3,0
99320,4,3,347894,347894,347897,0,3,1
99321,5,2,347899,347899,347901,0,2,2
99322,2,1,347901,347901,347902,0,1,0
99323,2,2,347903,347903,347905,0,2,1
99324,4,1,347907,347907,347908,0,1,2
99325,5,1,347912,347912,347913,0,1,4
99326,3,3,347915,347915,347918,0,3,2
99327,3,1,347918,347918,347919,0,1,0
99328,4,2,347922,347922,347924,0,2,3
99329,2,1,347924,347924,347925,0,1,0
99330,3,2,347927,347927,347929,0,2,2
99331,2,3,347929,347929,347932,0,3,0
99332,4,2,347933,347933,347935,0,2,1
99333,5,1,347938,347938,347939,0,1,3
99334,5,3,347943,347943,347946,0,3,4
99335,1,2,347944,347946,347948,2,4,0
99336,6,2,347950,347950,347952,0,2,2
99337,6,2,347956,347956,347958,0,2,4
99338,6,3,347962,347962,347965,0,3,4
99339,5,1,347967,347967,347968,0,1,2
99340,5,2,347972,347972,347974,0,2,4
99341,6,3,347978,347978,347981,0,3,4
99342,4,3,347982,347982,347985,0,3,1
99343,2,2,347984,347985,347987,1,3,0
99344,1,2,347985,347987,347989,2,4,0
99345,1,2,347986,347989,347991,3,5,0
99346,6,2,347992,347992,347994,0,2,1
99347,3,1,347995,347995,347996,0,1,1
99348,2,1,347997,347997,347998,0,1,1
99349,6,1,348003,348003,348004,0,1,5
99350,3,3,348006,348006,348009,0,3,2
99351,5,1,348011,348011,348012,0,1,2
99352,5,2,348016,348016,348018,0,2,4
99353,2,2,348018,348018,348020,0,2,0
99354,4,2,348022,348022,348024,0,2,2
99355,2,3,348024,348024,348027,0,3,0
99356,6,2,348030,348030,348032,0,2,3
99357,1,3,348031,348032,348035,1,4,0
99358,1,1,348032,348035,348036,3,4,0
99359,3,3,348035,348036,348039,1,4,0
99360,6,3,348041,348041,348044,0,3,2
99361,4,2,348045,348045,348047,0,2,1
99362,2,2,348047,348047,348049,0,2,0
99363,6,1,348053,348053,348054,0,1,4
99364,3,3,348056,348056,348059,0,3,2
99365,1,2,348057,348059,348061,2,4,0
99366,1,2,348058,348061,348063,3,5,0
99367,4,2,348062,348063,348065,1,3,0
99368,5,2,348067,348067,348069,0,2,2
99369,2,2,348069,348069,348071,0,2,0
99370,2,1,348071,348071,348072,0,1,0
99371,2,1,348073,348073,348074,0,1,1
99372,2,1,348075,348075,348076,0,1,1
99373,3,1,348078,348078,348079,0,1,2
99374,1,1,348079,348079,348080,0,1,0
99375,6,2,348085,348085,348087,0,2,5
99376,1,1,348086,348087,348088,1,2,0
99377,3,3,348089,348089,348092,0,3,1
99378,5,1,348094,348094,348095,0,1,2
99379,1,1,348095,348095,348096,0,1,0
99380,5,1,348100,348100,348101,0,1,4
99381,5,1,348105,348105,348106,0,1,4
99382,2,1,348107,348107,348108,0,1,1
99383,3,2,348110,348110,348112,0,2,2
99384,2,1,348112,348112,348113,0,1,0
99385,3,3,348115,348115,348118,0,3,2
99386,5,2,348120,348120,348122,0,2,2
99387,6,2,348126,348126,348128,0,2,4
99388,4,1,348130,348130,348131,0,1,2
99389,5,2,348135,348135,348137,0,2,4
99390,2,2,348137,348137,348139,0,2,0
99391,1,1,348138,348139,348140,1,2,0
99392,4,2,348142,348142,348144,0,2,2
99393,4,3,348146,348146,348149,0,3,2
99394,4,1,348150,348150,348151,0,1,1
99395,1,1,348151,348151,348152,0,1,0
99396,4,1,348155,348155,348156,0,1,3
99397,6,2,348161,348161,348163,0,2,5
99398,6,1,348167,348167,348168,0,1,4
99399,3,1,348170,348170,348171,0,1,2
99400,4,3,348174,348174,348177,0,3,3
99401,4,2,348178,348178,348180,0,2,1
99402,6,3,348184,348184,348187,0,3,4
99403,3,2,348187,348187,348189,0,2,0
99404,4,3,348191,348191,348194,0,3,2
99405,4,2,348195,348195,348197,0,2,1
99406,4,3,348199,348199,348202,0,3,2
99407,3,3,348202,348202,348205,0,3,0
99408,3,3,348205,348205,348208,0,3,0
99409,5,1,348210,348210,348211,0,1,2
99410,4,3,348214,348214,348217,0,3,3
99411,3,3,348217,348217,348220,0,3,0
99412,2,3,348219,348220,348223,1,4,0
99413,4,3,348223,348223,348226,0,3,0
99414,3,1,348226,348226,348227,0,1,0
99415,3,1,348229,348229,348230,0,1,2
99416,4,2,348233,348233,348235,0,2,3
99417,3,3,348236,348236,348239,0,3,1
99418,1,3,348237,348239,348242,2,5,0
99419,3,3,348240,348242,348245,2,5,0
99420,6,3,348246,348246,348249,0,3,1
99421,2,3,348248,348249,348252,1,4,0
99422,2,2,348250,348252,348254,2,4,0
99423,5,2,348255,348255,348257,0,2,1
99424,3,1,348258,348258,348259,0,1,1
99425,3,2,348261,348261,348263,0,2,2
99426,4,1,348265,348265,348266,0,1,2
99427,5,1,348270,348270,348271,0,1,4
99428,3,2,348273,348273,348275,0,2,2
99429,4,3,348277,348277,348280,0,3,2
99430,4,2,348281,348281,348283,0,2,1
99431,3,3,348284,348284,348287,0,3,1
99432,6,2,348290,348290,348292,0,2,3
99433,3,2,348293,348293,348295,0,2,1
99434,3,2,348296,348296,348298,0,2,1
99435,4,2,348300,348300,348302,0,2,2
99436,1,3,348301,348302,348305,1,4,0
99437,1,3,348302,348305,348308,3,6,0
99438,2,3,348304,348308,348311,4,7,0
99439,6,2,348310,348311,348313,1,3,0
99440,6,1,348316,348316,348317,0,1,3
99441,2,1,348318,348318,348319,0,1,1
99442,2,2,348320,348320,348322,0,2,1
99443,1,3,348321,348322,348325,1,4,0
99444,5,2,348326,348326,348328,0,2,1
99445,4,1,348330,348330,348331,0,1,2
99446,1,1,348331,348331,348332,0,1,0
99447,1,2,348332,348332,348334,0,2,0
99448,6,2,348338,348338,348340,0,2,4
99449,1,1,348339,348340,348341,1,2,0
99450,4,2,348343,348343,348345,0,2,2
99451,4,2,348347,348347,348349,0,2,2
99452,2,1,348349,348349,348350,0,1,0
99453,2,2,348351,348351,348353,0,2,1
99454,5,1,348356,348356,348357,0,1,3
99455,5,2,348361,348361,348363,0,2,4
99456,6,3,348367,348367,348370,0,3,4
99457,6,2,348373,348373,348375,0,2,3
99458,2,2,348375,348375,348377,0,2,0
99459,3,2,348378,348378,348380,0,2,1
99460,1,2,348379,348380,348382,1,3,0
99461,4,3,348383,348383,348386,0,3,1
99462,3,1,348386,348386,348387,0,1,0
99463,2,1,348388,348388,348389,0,1,1
99464,3,1,348391,348391,348392,0,1,2
99465,2,3,348393,348393,348396,0,3,1
99466,2,1,348395,348396,348397,1,2,0
99467,1,2,348396,348397,348399,1,3,0
99468,5,3,348401,348401,348404,0,3,2
99469,5,2,348406,348406,348408,0,2,2
99470,3,2,348409,348409,348411,0,2,1
99471,5,1,348414,348414,348415,0,1,3
99472,2,2,348416,348416,348418,0,2,1
99473,3,2,348419,348419,348421,0,2,1
99474,4,1,348423,348423,348424,0,1,2
99475,2,2,348425,348425,348427,0,2,1
99476,6,3,348431,348431,348434,0,3,4
99477,2,2,348433,348434,348436,1,3,0
99478,5,3,348438,348438,348441,0,3,2
99479,4,3,348442,348442,348445,0,3,1
99480,4,1,348446,348446,348447,0,1,1
99481,5,3,348451,348451,348454,0,3,4
99482,3,3,348454,348454,348457,0,3,0
99483,5,3,348459,348459,348462,0,3,2
99484,1,2,348460,348462,348464,2,4,0
99485,2,1,348462,348464,348465,2,3,0
99486,6,1,348468,348468,348469,0,1,3
99487,6,3,348474,348474,348477,0,3,5
99488,4,1,348478,348478,348479,0,1,1
99489,3,2,348481,348481,348483,0,2,2
99490,3,3,348484,348484,348487,0,3,1
99491,2,1,348486,348487,348488,1,2,0
99492,3,3,348489,348489,348492,0,3,1
99493,3,1,348492,348492,348493,0,1,0
99494,5,1,348497,348497,348498,0,1,4
99495,4,3,348501,348501,348504,0,3,3
99496,4,2,348505,348505,348507,0,2,1
99497,3,1,348508,348508,348509,0,1,1
99498,3,1,348511,348511,348512,0,1,2
99499,6,2,348517,348517,348519,0,2,5
99500,3,1,348520,348520,348521,0,1,1
99501,6,1,348526,348526,348527,0,1,5
99502,6,2,348532,348532,348534,0,2,5
99503,6,3,348538,348538,348541,0,3,4
99504,1,3,348539,348541,348544,2,5,0
99505,1,2,348540,348544,348546,4,6,0
99506,2,3,348542,348546,348549,4,7,0
99507,3,2,348545,348549,348551,4,6,0
99508,5,2,348550,348551,348553,1,3,0
99509,1,1,348551,348553,348554,2,3,0
99510,1,2,348552,348554,348556,2,4,0
99511,5,1,348557,348557,348558,0,1,1
99512,5,1,348562,348562,348563,0,1,4
99513,1,2,348563,348563,348565,0,2,0
99514,1,3,348564,348565,348568,1,4,0
99515,5,3,348569,348569,348572,0,3,1
99516,3,3,348572,348572,348575,0,3,0
99517,5,1,348577,348577,348578,0,1,2
99518,5,3,348582,348582,348585,0,3,4
99519,3,2,348585,348585,348587,0,2,0
99520,4,2,348589,348589,348591,0,2,2
99521,6,1,348595,348595,348596,0,1,4
99522,2,3,348597,348597,348600,0,3,1
99523,3,1,348600,348600,348601,0,1,0
99524,6,3,348606,348606,348609,0,3,5
99525,1,1,348607,348609,348610,2,3,0
99526,2,2,348609,348610,348612,1,3,0
99527,1,2,348610,348612,348614,2,4,0
99528,4,1,348614,348614,348615,0,1,0
99529,6,2,348620,348620,348622,0,2,5
99530,4,2,348624,348624,348626,0,2,2
99531,5,2,348629,348629,348631,0,2,3
99532,4,1,348633,348633,348634,0,1,2
99533,1,1,348634,348634,348635,0,1,0
99534,5,1,348639,348639,348640,0,1,4
99535,4,2,348643,348643,348645,0,2,3
99536,4,3,348647,348647,348650,0,3,2
99537,6,2,348653,348653,348655,0,2,3
99538,2,3,348655,348655,348658,0,3,0
99539,3,2,348658,348658,348660,0,2,0
99540,3,2,348661,348661,348663,0,2,1
99541,2,2,348663,348663,348665,0,2,0
99542,1,2,348664,348665,348667,1,3,0
99543,3,1,348667,348667,348668,0,1,0
99544,1,3,348668,348668,348671,0,3,0
99545,3,1,348671,348671,348672,0,1,0
99546,6,2,348677,348677,348679,0,2,5
99547,3,3,348680,348680,348683,0,3,1
99548,4,2,348684,348684,348686,0,2,1
99549,3,2,348687,348687,348689,0,2,1
99550,1,2,348688,348689,348691,1,3,0
99551,4,2,348692,348692,348694,0,2,1
99552,5,1,348697,348697,348698,0,1,3
99553,1,3,348698,348698,348701,0,3,0
99554,6,2,348704,348704,348706,0,2,3
99555,6,3,348710,348710,348713,0,3,4
99556,1,2,348711,348713,348715,2,4,0
99557,4,3,348715,348715,348718,0,3,0
99558,3,3,348718,348718,348721,0,3,0
99559,3,1,348721,348721,348722,0,1,0
99560,2,2,348723,348723,348725,0,2,1
99561,6,2,348729,348729,348731,0,2,4
99562,2,2,348731,348731,348733,0,2,0
99563,5,1,348736,348736,348737,0,1,3
99564,4,3,348740,348740,348743,0,3,3
99565,1,1,348741,348743,348744,2,3,0
99566,3,3,348744,348744,348747,0,3,0
99567,3,3,348747,348747,348750,0,3,0
99568,2,2,348749,348750,348752,1,3,0
99569,6,1,348755,348755,348756,0,1,3
99570,2,1,348757,348757,348758,0,1,1
99571,5,1,348762,348762,348763,0,1,4
99572,5,3,348767,348767,348770,0,3,4
99573,1,1,348768,348770,348771,2,3,0
99574,2,2,348770,348771,348773,1,3,0
99575,5,3,348775,348775,348778,0,3,2
99576,2,2,348777,348778,348780,1,3,0
99577,5,2,348782,348782,348784,0,2,2
99578,3,3,348785,348785,348788,0,3,1
99579,6,1,348791,348791,348792,0,1,3
99580,2,1,348793,348793,348794,0,1,1
99581,3,2,348796,348796,348798,0,2,2
99582,4,2,348800,348800,348802,0,2,2
99583,1,3,348801,348802,348805,1,4,0
99584,6,2,348807,348807,348809,0,2,2
99585,5,1,348812,348812,348813,0,1,3
99586,4,2,348816,348816,348818,0,2,3
99587,2,1,348818,348818,348819,0,1,0
99588,6,1,348824,348824,348825,0,1,5
99589,6,2,348830,348830,348832,0,2,5
99590,6,2,348836,348836,348838,0,2,4
99591,5,2,348841,348841,348843,0,2,3
99592,3,3,348844,348844,348847,0,3,1
99593,1,3,348845,348847,348850,2,5,0
99594,1,3,348846,348850,348853,4,7,0
99595,6,1,348852,348853,348854,1,2,0
99596,3,2,348855,348855,348857,0,2,1
99597,3,2,348858,348858,348860,0,2,1
99598,1,3,348859,348860,348863,1,4,0
99599,5,2,348864,348864,348866,0,2,1
99600,6,2,348870,348870,348872,0,2,4
99601,5,3,348875,348875,348878,0,3,3
99602,4,1,348879,348879,348880,0,1,1
99603,2,1,348881,348881,348882,0,1,1
99604,2,3,348883,348883,348886,0,3,1
99605,3,2,348886,348886,348888,0,2,0
99606,3,3,348889,348889,348892,0,3,1
99607,5,2,348894,348894,348896,0,2,2
99608,6,3,348900,348900,348903,0,3,4
99609,1,2,348901,348903,348905,2,4,0
99610,4,3,348905,348905,348908,0,3,0
99611,4,2,348909,348909,348911,0,2,1
99612,2,2,348911,348911,348913,0,2,0
99613,2,2,348913,348913,348915,0,2,0
99614,3,1,348916,348916,348917,0,1,1
99615,3,2,348919,348919,348921,0,2,2
99616,6,2,348925,348925,348927,0,2,4
99617,1,1,348926,348927,348928,1,2,0
99618,3,3,348929,348929,348932,0,3,1
99619,6,1,348935,348935,348936,0,1,3
99620,3,2,348938,348938,348940,0,2,2
99621,3,1,348941,348941,348942,0,1,1
99622,1,3,348942,348942,348945,0,3,0
99623,5,2,348947,348947,348949,0,2,2
99624,2,3,348949,348949,348952,0,3,0
99625,4,3,348953,348953,348956,0,3,1
99626,1,3,348954,348956,348959,2,5,0
99627,6,1,348960,348960,348961,0,1,1
99628,6,1,348966,348966,348967,0,1,5
99629,1,3,348967,348967,348970,0,3,0
99630,2,1,348969,348970,348971,1,2,0
99631,4,2,348973,348973,348975,0,2,2
99632,3,3,348976,348976,348979,0,3,1
99633,1,2,348977,348979,348981,2,4,0
99634,2,3,348979,348981,348984,2,5,0
99635,5,2,348984,348984,348986,0,2,0
99636,2,1,348986,348986,348987,0,1,0
99637,5,1,348991,348991,348992,0,1,4
99638,3,3,348994,348994,348997,0,3,2
99639,4,1,348998,348998,348999,0,1,1
99640,4,2,349002,349002,349004,0,2,3
99641,6,2,349008,349008,349010,0,2,4
99642,3,2,349011,349011,349013,0,2,1
99643,6,3,349017,349017,349020,0,3,4
99644,1,1,349018,349020,349021,2,3,0
99645,5,1,349023,349023,349024,0,1,2
99646,5,1,349028,349028,349029,0,1,4
99647,3,1,349031,349031,349032,0,1,2
99648,6,1,349037,349037,349038,0,1,5
99649,6,2,349043,349043,349045,0,2,5
99650,1,3,349044,349045,349048,1,4,0
99651,1,1,349045,349048,349049,3,4,0
99652,2,1,349047,349049,349050,2,3,0
99653,1,3,349048,349050,349053,2,5,0
99654,2,3,349050,349053,349056,3,6,0
99655,2,3,349052,349056,349059,4,7,0
99656,6,3,349058,349059,349062,1,4,0
99657,4,1,349062,349062,349063,0,1,0
99658,5,2,349067,349067,349069,0,2,4
99659,5,3,349072,349072,349075,0,3,3
99660,2,3,349074,349075,349078,1,4,0
99661,5,1,349079,349079,349080,0,1,1
99662,5,1,349084,349084,349085,0,1,4
99663,6,2,349090,349090,349092,0,2,5
99664,4,2,349094,349094,349096,0,2,2
99665,1,3,349095,349096,349099,1,4,0
99666,2,3,349097,349099,349102,2,5,0
99667,4,3,349101,349102,349105,1,4,0
99668,4,1,349105,349105,349106,0,1,0
99669,2,3,349107,349107,349110,0,3,1
99670,3,2,349110,349110,349112,0,2,0
99671,3,1,349113,349113,349114,0,1,1
99672,6,1,349119,349119,349120,0,1,5
99673,4,2,349123,349123,349125,0,2,3
99674,1,2,349124,349125,349127,1,3,0
99675,6,3,349130,349130,349133,0,3,3
99676,1,3,349131,349133,349136,2,5,0
99677,4,2,349135,349136,349138,1,3,0
99678,4,3,349139,349139,349142,0,3,1
99679,2,2,349141,349142,349144,1,3,0
99680,5,3,349146,349146,349149,0,3,2
99681,5,3,349151,349151,349154,0,3,2
99682,5,1,349156,349156,349157,0,1,2
99683,3,3,349159,349159,349162,0,3,2
99684,4,1,349163,349163,349164,0,1,1
99685,5,1,349168,349168,349169,0,1,4
99686,4,2,349172,349172,349174,0,2,3
99687,2,1,349174,349174,349175,0,1,0
99688,5,1,349179,349179,349180,0,1,4
99689,5,3,349184,349184,349187,0,3,4
99690,2,2,349186,349187,349189,1,3,0
99691,6,1,349192,349192,349193,0,1,3
99692,2,2,349194,349194,349196,0,2,1
99693,1,3,349195,349196,349199,1,4,0
99694,5,3,349200,349200,349203,0,3,1
99695,5,1,349205,349205,349206,0,1,2
99696,3,2,349208,349208,349210,0,2,2
99697,6,3,349214,349214,349217,0,3,4
99698,4,3,349218,349218,349221,0,3,1
99699,1,3,349219,349221,349224,2,5,0
99700,4,2,349223,349224,349226,1,3,0
99701,6,2,349229,349229,349231,0,2,3
99702,5,2,349234,349234,349236,0,2,3
99703,3,2,349237,349237,349239,0,2,1
99704,5,3,349242,349242,349245,0,3,3
99705,1,2,349243,349245,349247,2,4,0
99706,5,1,349248,349248,349249,0,1,1
99707,1,2,349249,349249,349251,0,2,0
99708,1,3,349250,349251,349254,1,4,0
99709,3,3,349253,349254,349257,1,4,0
99710,1,2,349254,349257,349259,3,5,0
99711,1,2,349255,349259,349261,4,6,0
99712,4,2,349259,349261,349263,2,4,0
99713,6,2,349265,349265,349267,0,2,2
99714,5,3,349270,349270,349273,0,3,3
99715,4,3,349274,349274,349277,0,3,1
99716,1,3,349275,349277,349280,2,5,0
99717,1,1,349276,349280,349281,4,5,0
99718,6,2,349282,349282,349284,0,2,1
99719,2,1,349284,349284,349285,0,1,0
99720,2,1,349286,349286,349287,0,1,1
99721,1,1,349287,349287,349288,0,1,0
99722,1,2,349288,349288,349290,0,2,0
99723,5,2,349293,349293,349295,0,2,3
99724,1,2,349294,349295,349297,1,3,0
99725,6,3,349300,349300,349303,0,3,3
99726,1,1,349301,349303,349304,2,3,0
99727,2,3,349303,349304,349307,1,4,0
99728,4,3,349307,349307,349310,0,3,0
99729,2,3,349309,349310,349313,1,4,0
99730,6,2,349315,349315,349317,0,2,2
99731,5,3,349320,349320,349323,0,3,3
99732,2,2,349322,349323,349325,1,3,0
99733,4,2,349326,349326,349328,0,2,1
99734,2,3,349328,349328,349331,0,3,0
99735,6,2,349334,349334,349336,0,2,3
99736,2,2,349336,349336,349338,0,2,0
99737,5,3,349341,349341,349344,0,3,3
99738,4,2,349345,349345,349347,0,2,1
99739,4,2,349349,349349,349351,0,2,2
99740,1,3,349350,349351,349354,1,4,0
99741,3,3,349353,349354,349357,1,4,0
99742,4,2,349357,349357,349359,0,2,0
99743,1,2,349358,349359,349361,1,3,0
99744,5,1,349363,349363,349364,0,1,2
99745,2,3,349365,349365,349368,0,3,1
99746,5,3,349370,349370,349373,0,3,2
99747,4,1,349374,349374,349375,0,1,1
99748,6,1,349380,349380,349381,0,1,5
99749,6,3,349386,349386,349389,0,3,5
99750,5,2,349391,349391,349393,0,2,2
99751,3,1,349394,349394,349395,0,1,1
99752,6,3,349400,349400,349403,0,3,5
99753,3,2,349403,349403,349405,0,2,0
99754,5,2,349408,349408,349410,0,2,3
99755,6,1,349414,349414,349415,0,1,4
99756,1,1,349415,349415,349416,0,1,0
99757,4,2,349419,349419,349421,0,2,3
99758,1,2,349420,349421,349423,1,3,0
99759,6,2,349426,349426,349428,0,2,3
99760,5,3,349431,349431,349434,0,3,3
99761,4,3,349435,349435,349438,0,3,1
99762,2,3,349437,349438,349441,1,4,0
99763,5,2,349442,349442,349444,0,2,1
99764,5,3,349447,349447,349450,0,3,3
99765,5,1,349452,349452,349453,0,1,2
99766,2,3,349454,349454,349457,0,3,1
99767,5,3,349459,349459,349462,0,3,2
99768,4,2,349463,349463,349465,0,2,1
99769,4,3,349467,349467,349470,0,3,2
99770,2,2,349469,349470,349472,1,3,0
99771,6,3,349475,349475,349478,0,3,3
99772,6,1,349481,349481,349482,0,1,3
99773,1,1,349482,349482,349483,0,1,0
99774,6,1,349488,349488,349489,0,1,5
99775,3,3,349491,349491,349494,0,3,2
99776,3,3,349494,349494,349497,0,3,0
99777,5,2,349499,349499,349501,0,2,2
99778,2,1,349501,349501,349502,0,1,0
99779,1,3,349502,349502,349505,0,3,0
99780,6,2,349508,349508,349510,0,2,3
99781,4,2,349512,349512,349514,0,2,2
99782,6,1,349518,349518,349519,0,1,4
99783,3,3,349521,349521,349524,0,3,2
99784,1,3,349522,349524,349527,2,5,0
99785,4,1,349526,349527,349528,1,2,0
99786,6,3,349532,349532,349535,0,3,4
99787,5,2,349537,349537,349539,0,2,2
99788,2,2,349539,349539,349541,0,2,0
99789,4,2,349543,349543,349545,0,2,2
99790,4,3,349547,349547,349550,0,3,2
99791,1,3,349548,349550,349553,2,5,0
99792,4,1,349552,349553,349554,1,2,0
99793,2,3,349554,349554,349557,0,3,0
99794,3,1,349557,349557,349558,0,1,0
99795,5,2,349562,349562,349564,0,2,4
99796,5,3,349567,349567,349570,0,3,3
99797,2,2,349569,349570,349572,1,3,0
99798,2,3,349571,349572,349575,1,4,0
99799,3,2,349574,349575,349577,1,3,0
99800,4,1,349578,349578,349579,0,1,1
99801,5,2,349583,349583,349585,0,2,4
99802,6,3,349589,349589,349592,0,3,4
99803,5,2,349594,349594,349596,0,2,2
99804,3,3,349597,349597,349600,0,3,1
99805,1,1,349598,349600,349601,2,3,0
99806,4,1,349602,349602,349603,0,1,1
99807,1,2,349603,349603,349605,0,2,0
99808,1,2,349604,349605,349607,1,3,0
99809,2,1,349606,349607,349608,1,2,0
99810,1,1,349607,349608,349609,1,2,0
99811,5,2,349612,349612,349614,0,2,3
99812,6,3,349618,349618,349621,0,3,4
99813,5,2,349623,349623,349625,0,2,2
99814,2,2,349625,349625,349627,0,2,0
99815,1,1,349626,349627,349628,1,2,0
99816,4,2,349630,349630,349632,0,2,2
99817,1,3,349631,349632,349635,1,4,0
99818,4,3,349635,349635,349638,0,3,0
99819,6,1,349641,349641,349642,0,1,3
99820,5,3,349646,349646,349649,0,3,4
99821,4,1,349650,349650,349651,0,1,1
99822,4,1,349654,349654,349655,0,1,3
99823,3,1,349657,349657,349658,0,1,2
99824,1,3,349658,349658,349661,0,3,0
99825,6,3,349664,349664,349667,0,3,3
99826,1,2,349665,349667,349669,2,4,0
99827,1,3,349666,349669,349672,3,6,0
99828,6,3,349672,349672,349675,0,3,0
99829,2,1,349674,349675,349676,1,2,0
99830,5,2,349679,349679,349681,0,2,3
99831,2,2,349681,349681,349683,0,2,0
99832,3,2,349684,349684,349686,0,2,1
99833,1,2,349685,349686,349688,1,3,0
99834,5,1,349690,349690,349691,0,1,2
99835,2,2,349692,349692,349694,0,2,1
99836,5,2,349697,349697,349699,0,2,3
99837,6,2,349703,349703,349705,0,2,4
99838,5,3,349708,349708,349711,0,3,3
99839,2,2,349710,349711,349713,1,3,0
99840,2,2,349712,349713,349715,1,3,0
99841,3,3,349715,349715,349718,0,3,0
99842,5,1,349720,349720,349721,0,1,2
99843,3,1,349723,349723,349724,0,1,2
99844,2,2,349725,349725,349727,0,2,1
99845,5,2,349730,349730,349732,0,2,3
99846,5,1,349735,349735,349736,0,1,3
99847,6,3,349741,349741,349744,0,3,5
99848,4,3,349745,349745,349748,0,3,1
99849,6,1,349751,349751,349752,0,1,3
99850,6,2,349757,349757,349759,0,2,5
99851,2,3,349759,349759,349762,0,3,0
99852,3,1,349762,349762,349763,0,1,0
99853,6,2,349768,349768,349770,0,2,5
99854,2,3,349770,349770,349773,0,3,0
99855,2,3,349772,349773,349776,1,4,0
99856,6,2,349778,349778,349780,0,2,2
99857,6,2,349784,349784,349786,0,2,4
99858,5,1,349789,349789,349790,0,1,3
99859,5,1,349794,349794,349795,0,1,4
99860,2,2,349796,349796,349798,0,2,1
99861,1,1,349797,349798,349799,1,2,0
99862,3,3,349800,349800,349803,0,3,1
99863,3,3,349803,349803,349806,0,3,0
99864,2,3,349805,349806,349809,1,4,0
99865,3,3,349808,349809,349812,1,4,0
99866,1,2,349809,349812,349814,3,5,0
99867,5,1,349814,349814,349815,0,1,0
99868,6,2,349820,349820,349822,0,2,5
99869,2,2,349822,349822,349824,0,2,0
99870,2,2,349824,349824,349826,0,2,0
99871,4,3,349828,349828,349831,0,3,2
99872,2,3,349830,349831,349834,1,4,0
99873,5,1,349835,349835,349836,0,1,1
99874,3,2,349838,349838,349840,0,2,2
99875,2,1,349840,349840,349841,0,1,0
99876,5,2,349845,349845,349847,0,2,4
99877,6,2,349851,349851,349853,0,2,4
99878,3,3,349854,349854,349857,0,3,1
99879,2,2,349856,349857,349859,1,3,0
99880,5,1,349861,349861,349862,0,1,2
99881,3,3,349864,349864,349867,0,3,2
99882,5,1,349869,349869,349870,0,1,2
99883,2,1,349871,349871,349872,0,1,1
99884,6,2,349877,349877,349879,0,2,5
99885,6,3,349883,349883,349886,0,3,4
99886,2,2,349885,349886,349888,1,3,0
99887,4,2,349889,349889,349891,0,2,1
99888,3,2,349892,349892,349894,0,2,1
99889,5,2,349897,349897,349899,0,2,3
99890,1,3,349898,349899,349902,1,4,0
99891,3,3,349901,349902,349905,1,4,0
99892,5,3,349906,349906,349909,0,3,1
99893,1,3,349907,349909,349912,2,5,0
99894,2,1,349909,349912,349913,3,4,0
99895,6,1,349915,349915,349916,0,1,2
99896,3,2,349918,349918,349920,0,2,2
99897,3,2,349921,349921,349923,0,2,1
99898,5,2,349926,349926,349928,0,2,3
99899,3,1,349929,349929,349930,0,1,1
99900,3,3,349932,349932,349935,0,3,2
99901,4,1,349936,349936,349937,0,1,1
99902,1,1,349937,349937,349938,0,1,0
99903,5,3,349942,349942,349945,0,3,4
99904,6,1,349948,349948,349949,0,1,3
99905,3,1,349951,349951,349952,0,1,2
99906,6,2,349957,349957,349959,0,2,5
99907,2,2,349959,349959,349961,0,2,0
99908,3,2,349962,349962,349964,0,2,1
99909,2,2,349964,349964,349966,0,2,0
99910,2,3,349966,349966,349969,0,3,0
99911,2,3,349968,349969,349972,1,4,0
99912,1,2,349969,349972,349974,3,5,0
99913,1,2,349970,349974,349976,4,6,0
99914,2,2,349972,349976,349978,4,6,0
99915,5,1,349977,349978,349979,1,2,0
99916,4,1,349981,349981,349982,0,1,2
99917,5,1,349986,349986,349987,0,1,4
99918,1,3,349987,349987,349990,0,3,0
99919,3,1,349990,349990,349991,0,1,0
99920,3,1,349993,349993,349994,0,1,2
99921,6,3,349999,349999,350002,0,3,5
99922,4,3,350003,350003,350006,0,3,1
99923,1,2,350004,350006,350008,2,4,0
99924,2,1,350006,350008,350009,2,3,0
99925,4,3,350010,350010,350013,0,3,1
99926,3,3,350013,350013,350016,0,3,0
99927,5,3,350018,350018,350021,0,3,2
99928,4,3,350022,350022,350025,0,3,1
99929,6,1,350028,350028,350029,0,1,3
99930,1,1,350029,350029,350030,0,1,0
99931,2,1,350031,350031,350032,0,1,1
99932,1,2,350032,350032,350034,0,2,0
99933,4,2,350036,350036,350038,0,2,2
99934,6,1,350042,350042,350043,0,1,4
99935,3,1,350045,350045,350046,0,1,2
99936,1,2,350046,350046,350048,0,2,0
99937,4,2,350050,350050,350052,0,2,2
99938,6,1,350056,350056,350057,0,1,4
99939,2,2,350058,350058,350060,0,2,1
99940,2,2,350060,350060,350062,0,2,0
99941,1,1,350061,350062,350063,1,2,0
99942,1,1,350062,350063,350064,1,2,0
99943,3,1,350065,350065,350066,0,1,1
99944,3,2,350068,350068,350070,0,2,2
99945,2,2,350070,350070,350072,0,2,0
99946,2,2,350072,350072,350074,0,2,0
99947,1,1,350073,350074,350075,1,2,0
99948,3,1,350076,350076,350077,0,1,1
99949,4,3,350080,350080,350083,0,3,3
99950,1,3,350081,350083,350086,2,5,0
99951,4,3,350085,350086,350089,1,4,0
99952,6,1,350091,350091,350092,0,1,2
99953,6,2,350097,350097,350099,0,2,5
99954,5,1,350102,350102,350103,0,1,3
99955,1,2,350103,350103,350105,0,2,0
99956,1,2,350104,350105,350107,1,3,0
99957,6,1,350110,350110,350111,0,1,3
99958,1,3,350111,350111,350114,0,3,0
99959,1,3,350112,350114,350117,2,5,0
99960,1,3,350113,350117,350120,4,7,0
99961,5,1,350118,350120,350121,2,3,0
99962,1,3,350119,350121,350124,2,5,0
99963,5,1,350124,350124,350125,0,1,0
99964,5,3,350129,350129,350132,0,3,4
99965,3,2,350132,350132,350134,0,2,0
99966,3,2,350135,350135,350137,0,2,1
99967,6,2,350141,350141,350143,0,2,4
99968,5,2,350146,350146,350148,0,2,3
99969,6,3,350152,350152,350155,0,3,4
99970,4,2,350156,350156,350158,0,2,1
99971,1,2,350157,350158,350160,1,3,0
99972,5,1,350162,350162,350163,0,1,2
99973,4,1,350166,350166,350167,0,1,3
99974,3,2,350169,350169,350171,0,2,2
99975,4,3,350173,350173,350176,0,3,2
99976,1,2,350174,350176,350178,2,4,0
99977,5,1,350179,350179,350180,0,1,1
99978,4,1,350183,350183,350184,0,1,3
99979,2,2,350185,350185,350187,0,2,1
99980,2,1,350187,350187,350188,0,1,0
99981,3,2,350190,350190,350192,0,2,2
99982,6,2,350196,350196,350198,0,2,4
99983,6,2,350202,350202,350204,0,2,4
99984,1,3,350203,350204,350207,1,4,0
99985,1,1,350204,350207,350208,3,4,0
99986,2,1,350206,350208,350209,2,3,0
99987,1,1,350207,350209,350210,2,3,0
99988,6,3,350213,350213,350216,0,3,3
99989,6,2,350219,350219,350221,0,2,3
99990,3,3,350222,350222,350225,0,3,1
99991,1,1,350223,350225,350226,2,3,0
99992,6,2,350229,350229,350231,0,2,3
99993,3,3,350232,350232,350235,0,3,1
99994,2,1,350234,350235,350236,1,2,0
99995,3,1,350237,350237,350238,0,1,1
99996,4,2,350241,350241,350243,0,2,3
99997,3,3,350244,350244,350247,0,3,1
99998,5,1,350249,350249,350250,0,1,2
99999,1,1,350250,350250,350251,0,1,0
