,time_between,service_time,arrival_time,start_time,end_time,wait_time,system_time,idle_time
0,0,2,0,0,2,0,2,0
1,1,3,1,2,5,1,4,0
2,2,2,3,5,7,2,4,0
3,6,3,9,9,12,0,3,2
4,5,1,14,14,15,0,1,2
5,1,3,15,15,18,0,3,0
6,1,2,16,18,20,2,4,0
7,3,3,19,20,23,1,4,0
8,5,3,24,24,27,0,3,1
9,3,1,27,27,28,0,1,0
10,6,1,33,33,34,0,1,5
11,3,1,36,36,37,0,1,2
12,2,1,38,38,39,0,1,1
13,5,3,43,43,46,0,3,4
14,1,1,44,46,47,2,3,0
15,3,1,47,47,48,0,1,0
16,1,1,48,48,49,0,1,0
17,5,3,53,53,56,0,3,4
18,5,2,58,58,60,0,2,2
19,3,2,61,61,63,0,2,1
20,1,3,62,63,66,1,4,0
21,2,3,64,66,69,2,5,0
22,5,3,69,69,72,0,3,0
23,2,3,71,72,75,1,4,0
24,2,3,73,75,78,2,5,0
25,6,2,79,79,81,0,2,1
26,1,3,80,81,84,1,4,0
27,3,2,83,84,86,1,3,0
28,3,1,86,86,87,0,1,0
29,4,2,90,90,92,0,2,3
30,4,2,94,94,96,0,2,2
31,5,3,99,99,102,0,3,3
32,1,1,100,102,103,2,3,0
33,4,1,104,104,105,0,1,1
34,2,1,106,106,107,0,1,1
35,5,2,111,111,113,0,2,4
36,1,1,112,113,114,1,2,0
37,1,2,113,114,116,1,3,0
38,5,1,118,118,119,0,1,2
39,5,1,123,123,124,0,1,4
40,6,3,129,129,132,0,3,5
41,4,1,133,133,134,0,1,1
42,1,2,134,134,136,0,2,0
43,5,3,139,139,142,0,3,3
44,5,3,144,144,147,0,3,2
45,6,3,150,150,153,0,3,3
46,3,2,153,153,155,0,2,0
47,6,3,159,159,162,0,3,4
48,6,1,165,165,166,0,1,3
49,5,2,170,170,172,0,2,4
50,6,1,176,176,177,0,1,4
51,2,3,178,178,181,0,3,1
52,2,3,180,181,184,1,4,0
53,2,3,182,184,187,2,5,0
54,5,3,187,187,190,0,3,0
55,1,1,188,190,191,2,3,0
56,3,3,191,191,194,0,3,0
57,6,2,197,197,199,0,2,3
58,3,1,200,200,201,0,1,1
59,5,2,205,205,207,0,2,4
60,5,1,210,210,211,0,1,3
61,3,3,213,213,216,0,3,2
62,2,1,215,216,217,1,2,0
63,3,1,218,218,219,0,1,1
64,4,2,222,222,224,0,2,3
65,1,1,223,224,225,1,2,0
66,6,3,229,229,232,0,3,4
67,5,1,234,234,235,0,1,2
68,4,3,238,238,241,0,3,3
69,6,1,244,244,245,0,1,3
70,3,2,247,247,249,0,2,2
71,5,2,252,252,254,0,2,3
72,6,1,258,258,259,0,1,4
73,5,2,263,263,265,0,2,4
74,4,2,267,267,269,0,2,2
75,4,1,271,271,272,0,1,2
76,2,1,273,273,274,0,1,1
77,1,1,274,274,275,0,1,0
78,1,2,275,275,277,0,2,0
79,4,3,279,279,282,0,3,2
80,3,1,282,282,283,0,1,0
81,4,1,286,286,287,0,1,3
82,1,2,287,287,289,0,2,0
83,3,3,290,290,293,0,3,1
84,4,2,294,294,296,0,2,1
85,1,1,295,296,297,1,2,0
86,5,3,300,300,303,0,3,3
87,4,3,304,304,307,0,3,1
88,3,1,307,307,308,0,1,0
89,2,1,309,309,310,0,1,1
90,6,3,315,315,318,0,3,5
91,5,2,320,320,322,0,2,2
92,1,3,321,322,325,1,4,0
93,2,3,323,325,328,2,5,0
94,4,2,327,328,330,1,3,0
95,5,2,332,332,334,0,2,2
96,2,2,334,334,336,0,2,0
97,3,3,337,337,340,0,3,1
98,6,2,343,343,345,0,2,3
99,3,3,346,346,349,0,3,1
100,3,1,349,349,350,0,1,0
101,2,3,351,351,354,0,3,1
102,1,1,352,354,355,2,3,0
103,3,2,355,355,357,0,2,0
104,5,2,360,360,362,0,2,3
105,6,3,366,366,369,0,3,4
106,1,2,367,369,371,2,4,0
107,1,2,368,371,373,3,5,0
108,2,1,370,373,374,3,4,0
109,5,1,375,375,376,0,1,1
110,5,2,380,380,382,0,2,4
111,5,2,385,385,387,0,2,3
112,1,3,386,387,390,1,4,0
113,4,1,390,390,391,0,1,0
114,2,1,392,392,393,0,1,1
115,1,3,393,393,396,0,3,0
116,2,3,395,396,399,1,4,0
117,1,2,396,399,401,3,5,0
118,4,1,400,401,402,1,2,0
119,5,2,405,405,407,0,2,3
120,1,3,406,407,410,1,4,0
121,5,1,411,411,412,0,1,1
122,6,1,417,417,418,0,1,5
123,5,1,422,422,423,0,1,4
124,1,3,423,423,426,0,3,0
125,4,2,427,427,429,0,2,1
126,6,1,433,433,434,0,1,4
127,1,1,434,434,435,0,1,0
128,5,3,439,439,442,0,3,4
129,1,1,440,442,443,2,3,0
130,1,1,441,443,444,2,3,0
131,1,3,442,444,447,2,5,0
132,1,3,443,447,450,4,7,0
133,3,2,446,450,452,4,6,0
134,3,1,449,452,453,3,4,0
135,3,2,452,453,455,1,3,0
136,1,2,453,455,457,2,4,0
137,1,1,454,457,458,3,4,0
138,3,1,457,458,459,1,2,0
139,2,2,459,459,461,0,2,0
140,5,3,464,464,467,0,3,3
141,1,2,465,467,469,2,4,0
142,6,3,471,471,474,0,3,2
143,5,1,476,476,477,0,1,2
144,1,2,477,477,479,0,2,0
145,4,2,481,481,483,0,2,2
146,3,2,484,484,486,0,2,1
147,2,3,486,486,489,0,3,0
148,4,1,490,490,491,0,1,1
149,1,3,491,491,494,0,3,0
150,5,3,496,496,499,0,3,2
151,3,3,499,499,502,0,3,0
152,4,2,503,503,505,0,2,1
153,4,1,507,507,508,0,1,2
154,1,3,508,508,511,0,3,0
155,5,1,513,513,514,0,1,2
156,5,1,518,518,519,0,1,4
157,4,2,522,522,524,0,2,3
158,3,3,525,525,528,0,3,1
159,5,2,530,530,532,0,2,2
160,4,1,534,534,535,0,1,2
161,6,3,540,540,543,0,3,5
162,5,1,545,545,546,0,1,2
163,5,1,550,550,551,0,1,4
164,3,2,553,553,555,0,2,2
165,3,2,556,556,558,0,2,1
166,4,1,560,560,561,0,1,2
167,5,3,565,565,568,0,3,4
168,4,2,569,569,571,0,2,1
169,5,2,574,574,576,0,2,3
170,6,1,580,580,581,0,1,4
171,5,2,585,585,587,0,2,4
172,4,1,589,589,590,0,1,2
173,1,2,590,590,592,0,2,0
174,5,1,595,595,596,0,1,3
175,5,3,600,600,603,0,3,4
176,3,2,603,603,605,0,2,0
177,4,2,607,607,609,0,2,2
178,1,1,608,609,610,1,2,0
179,3,1,611,611,612,0,1,1
180,1,3,612,612,615,0,3,0
181,2,2,614,615,617,1,3,0
182,1,2,615,617,619,2,4,0
183,2,1,617,619,620,2,3,0
184,3,1,620,620,621,0,1,0
185,1,2,621,621,623,0,2,0
186,6,2,627,627,629,0,2,4
187,2,1,629,629,630,0,1,0
188,4,1,633,633,634,0,1,3
189,5,3,638,638,641,0,3,4
190,1,2,639,641,643,2,4,0
191,2,2,641,643,645,2,4,0
192,5,3,646,646,649,0,3,1
193,3,2,649,649,651,0,2,0
194,3,2,652,652,654,0,2,1
195,4,3,656,656,659,0,3,2
196,2,3,658,659,662,1,4,0
197,4,3,662,662,665,0,3,0
198,3,1,665,665,666,0,1,0
199,4,2,669,669,671,0,2,3
200,4,3,673,673,676,0,3,2
201,4,1,677,677,678,0,1,1
202,6,2,683,683,685,0,2,5
203,3,1,686,686,687,0,1,1
204,6,2,692,692,694,0,2,5
205,6,3,698,698,701,0,3,4
206,5,3,703,703,706,0,3,2
207,6,3,709,709,712,0,3,3
208,4,1,713,713,714,0,1,1
209,4,2,717,717,719,0,2,3
210,4,2,721,721,723,0,2,2
211,3,2,724,724,726,0,2,1
212,4,1,728,728,729,0,1,2
213,5,1,733,733,734,0,1,4
214,2,3,735,735,738,0,3,1
215,2,1,737,738,739,1,2,0
216,2,1,739,739,740,0,1,0
217,3,1,742,742,743,0,1,2
218,3,1,745,745,746,0,1,2
219,4,2,749,749,751,0,2,3
220,1,1,750,751,752,1,2,0
221,3,3,753,753,756,0,3,1
222,6,2,759,759,761,0,2,3
223,5,1,764,764,765,0,1,3
224,4,2,768,768,770,0,2,3
225,5,2,773,773,775,0,2,3
226,2,2,775,775,777,0,2,0
227,6,2,781,781,783,0,2,4
228,6,2,787,787,789,0,2,4
229,1,2,788,789,791,1,3,0
230,3,2,791,791,793,0,2,0
231,3,2,794,794,796,0,2,1
232,6,2,800,800,802,0,2,4
233,4,2,804,804,806,0,2,2
234,3,2,807,807,809,0,2,1
235,6,3,813,813,816,0,3,4
236,5,2,818,818,820,0,2,2
237,5,2,823,823,825,0,2,3
238,1,2,824,825,827,1,3,0
239,6,3,830,830,833,0,3,3
240,2,3,832,833,836,1,4,0
241,4,1,836,836,837,0,1,0
242,6,3,842,842,845,0,3,5
243,3,3,845,845,848,0,3,0
244,2,2,847,848,850,1,3,0
245,2,2,849,850,852,1,3,0
246,3,1,852,852,853,0,1,0
247,1,2,853,853,855,0,2,0
248,5,2,858,858,860,0,2,3
249,6,1,864,864,865,0,1,4
250,3,2,867,867,869,0,2,2
251,3,3,870,870,873,0,3,1
252,4,1,874,874,875,0,1,1
253,5,2,879,879,881,0,2,4
254,4,3,883,883,886,0,3,2
255,5,1,888,888,889,0,1,2
256,1,1,889,889,890,0,1,0
257,2,3,891,891,894,0,3,1
258,3,3,894,894,897,0,3,0
259,2,1,896,897,898,1,2,0
260,2,1,898,898,899,0,1,0
261,4,2,902,902,904,0,2,3
262,6,2,908,908,910,0,2,4
263,1,3,909,910,913,1,4,0
264,1,2,910,913,915,3,5,0
265,6,2,916,916,918,0,2,1
266,6,1,922,922,923,0,1,4
267,3,1,925,925,926,0,1,2
268,2,3,927,927,930,0,3,1
269,2,3,929,930,933,1,4,0
270,2,3,931,933,936,2,5,0
271,6,2,937,937,939,0,2,1
272,1,2,938,939,941,1,3,0
273,6,2,944,944,946,0,2,3
274,2,1,946,946,947,0,1,0
275,1,2,947,947,949,0,2,0
276,4,2,951,951,953,0,2,2
277,4,2,955,955,957,0,2,2
278,3,3,958,958,961,0,3,1
279,3,3,961,961,964,0,3,0
280,3,3,964,964,967,0,3,0
281,6,2,970,970,972,0,2,3
282,4,1,974,974,975,0,1,2
283,6,2,980,980,982,0,2,5
284,2,3,982,982,985,0,3,0
285,3,2,985,985,987,0,2,0
286,3,1,988,988,989,0,1,1
287,2,1,990,990,991,0,1,1
288,4,3,994,994,997,0,3,3
289,1,2,995,997,999,2,4,0
290,4,1,999,999,1000,0,1,0
291,2,3,1001,1001,1004,0,3,1
292,6,3,1007,1007,1010,0,3,3
293,6,1,1013,1013,1014,0,1,3
294,2,2,1015,1015,1017,0,2,1
295,3,3,1018,1018,1021,0,3,1
296,3,2,1021,1021,1023,0,2,0
297,1,3,1022,1023,1026,1,4,0
298,1,3,1023,1026,1029,3,6,0
299,3,3,1026,1029,1032,3,6,0
300,4,3,1030,1032,1035,2,5,0
301,1,3,1031,1035,1038,4,7,0
302,5,1,1036,1038,1039,2,3,0
303,4,1,1040,1040,1041,0,1,1
304,5,3,1045,1045,1048,0,3,4
305,6,3,1051,1051,1054,0,3,3
306,2,1,1053,1054,1055,1,2,0
307,5,3,1058,1058,1061,0,3,3
308,4,3,1062,1062,1065,0,3,1
309,5,2,1067,1067,1069,0,2,2
310,4,3,1071,1071,1074,0,3,2
311,5,1,1076,1076,1077,0,1,2
312,6,2,1082,1082,1084,0,2,5
313,3,3,1085,1085,1088,0,3,1
314,2,1,1087,1088,1089,1,2,0
315,6,2,1093,1093,1095,0,2,4
316,5,2,1098,1098,1100,0,2,3
317,6,1,1104,1104,1105,0,1,4
318,4,3,1108,1108,1111,0,3,3
319,5,2,1113,1113,1115,0,2,2
320,5,2,1118,1118,1120,0,2,3
321,2,3,1120,1120,1123,0,3,0
322,5,2,1125,1125,1127,0,2,2
323,3,1,1128,1128,1129,0,1,1
324,1,3,1129,1129,1132,0,3,0
325,6,2,1135,1135,1137,0,2,3
326,2,2,1137,1137,1139,0,2,0
327,2,1,1139,1139,1140,0,1,0
328,3,1,1142,1142,1143,0,1,2
329,2,1,1144,1144,1145,0,1,1
330,3,2,1147,1147,1149,0,2,2
331,4,1,1151,1151,1152,0,1,2
332,5,3,1156,1156,1159,0,3,4
333,3,2,1159,1159,1161,0,2,0
334,5,1,1164,1164,1165,0,1,3
335,5,1,1169,1169,1170,0,1,4
336,4,1,1173,1173,1174,0,1,3
337,3,1,1176,1176,1177,0,1,2
338,1,1,1177,1177,1178,0,1,0
339,5,2,1182,1182,1184,0,2,4
340,3,1,1185,1185,1186,0,1,1
341,1,3,1186,1186,1189,0,3,0
342,6,1,1192,1192,1193,0,1,3
343,1,3,1193,1193,1196,0,3,0
344,5,1,1198,1198,1199,0,1,2
345,4,2,1202,1202,1204,0,2,3
346,6,1,1208,1208,1209,0,1,4
347,6,1,1214,1214,1215,0,1,5
348,2,2,1216,1216,1218,0,2,1
349,4,1,1220,1220,1221,0,1,2
350,5,1,1225,1225,1226,0,1,4
351,5,3,1230,1230,1233,0,3,4
352,1,2,1231,1233,1235,2,4,0
353,6,3,1237,1237,1240,0,3,2
354,5,1,1242,1242,1243,0,1,2
355,4,3,1246,1246,1249,0,3,3
356,2,3,1248,1249,1252,1,4,0
357,3,2,1251,1252,1254,1,3,0
358,2,2,1253,1254,1256,1,3,0
359,6,3,1259,1259,1262,0,3,3
360,3,3,1262,1262,1265,0,3,0
361,6,2,1268,1268,1270,0,2,3
362,3,3,1271,1271,1274,0,3,1
363,6,3,1277,1277,1280,0,3,3
364,4,2,1281,1281,1283,0,2,1
365,4,3,1285,1285,1288,0,3,2
366,6,3,1291,1291,1294,0,3,3
367,3,2,1294,1294,1296,0,2,0
368,1,3,1295,1296,1299,1,4,0
369,4,1,1299,1299,1300,0,1,0
370,1,3,1300,1300,1303,0,3,0
371,3,2,1303,1303,1305,0,2,0
372,5,2,1308,1308,1310,0,2,3
373,4,3,1312,1312,1315,0,3,2
374,5,1,1317,1317,1318,0,1,2
375,3,2,1320,1320,1322,0,2,2
376,1,2,1321,1322,1324,1,3,0
377,3,3,1324,1324,1327,0,3,0
378,6,1,1330,1330,1331,0,1,3
379,6,3,1336,1336,1339,0,3,5
380,5,2,1341,1341,1343,0,2,2
381,3,1,1344,1344,1345,0,1,1
382,6,2,1350,1350,1352,0,2,5
383,4,2,1354,1354,1356,0,2,2
384,2,3,1356,1356,1359,0,3,0
385,1,2,1357,1359,1361,2,4,0
386,6,2,1363,1363,1365,0,2,2
387,6,3,1369,1369,1372,0,3,4
388,2,1,1371,1372,1373,1,2,0
389,1,3,1372,1373,1376,1,4,0
390,1,3,1373,1376,1379,3,6,0
391,2,1,1375,1379,1380,4,5,0
392,1,3,1376,1380,1383,4,7,0
393,3,1,1379,1383,1384,4,5,0
394,5,3,1384,1384,1387,0,3,0
395,3,3,1387,1387,1390,0,3,0
396,2,2,1389,1390,1392,1,3,0
397,4,2,1393,1393,1395,0,2,1
398,3,2,1396,1396,1398,0,2,1
399,5,3,1401,1401,1404,0,3,3
400,1,3,1402,1404,1407,2,5,0
401,5,2,1407,1407,1409,0,2,0
402,2,1,1409,1409,1410,0,1,0
403,3,3,1412,1412,1415,0,3,2
404,5,2,1417,1417,1419,0,2,2
405,6,2,1423,1423,1425,0,2,4
406,3,3,1426,1426,1429,0,3,1
407,2,3,1428,1429,1432,1,4,0
408,5,1,1433,1433,1434,0,1,1
409,5,3,1438,1438,1441,0,3,4
410,6,3,1444,1444,1447,0,3,3
411,6,1,1450,1450,1451,0,1,3
412,1,1,1451,1451,1452,0,1,0
413,1,2,1452,1452,1454,0,2,0
414,2,2,1454,1454,1456,0,2,0
415,3,1,1457,1457,1458,0,1,1
416,5,2,1462,1462,1464,0,2,4
417,6,2,1468,1468,1470,0,2,4
418,3,3,1471,1471,1474,0,3,1
419,6,2,1477,1477,1479,0,2,3
420,3,3,1480,1480,1483,0,3,1
421,5,2,1485,1485,1487,0,2,2
422,4,1,1489,1489,1490,0,1,2
423,1,1,1490,1490,1491,0,1,0
424,5,2,1495,1495,1497,0,2,4
425,5,2,1500,1500,1502,0,2,3
426,3,1,1503,1503,1504,0,1,1
427,4,3,1507,1507,1510,0,3,3
428,1,3,1508,1510,1513,2,5,0
429,4,3,1512,1513,1516,1,4,0
430,3,2,1515,1516,1518,1,3,0
431,4,2,1519,1519,1521,0,2,1
432,6,1,1525,1525,1526,0,1,4
433,3,2,1528,1528,1530,0,2,2
434,1,3,1529,1530,1533,1,4,0
435,5,1,1534,1534,1535,0,1,1
436,6,1,1540,1540,1541,0,1,5
437,3,2,1543,1543,1545,0,2,2
438,1,3,1544,1545,1548,1,4,0
439,1,3,1545,1548,1551,3,6,0
440,6,3,1551,1551,1554,0,3,0
441,4,1,1555,1555,1556,0,1,1
442,2,1,1557,1557,1558,0,1,1
443,3,2,1560,1560,1562,0,2,2
444,2,1,1562,1562,1563,0,1,0
445,5,2,1567,1567,1569,0,2,4
446,2,1,1569,1569,1570,0,1,0
447,6,1,1575,1575,1576,0,1,5
448,1,3,1576,1576,1579,0,3,0
449,4,3,1580,1580,1583,0,3,1
450,4,1,1584,1584,1585,0,1,1
451,1,2,1585,1585,1587,0,2,0
452,6,3,1591,1591,1594,0,3,4
453,2,2,1593,1594,1596,1,3,0
454,2,3,1595,1596,1599,1,4,0
455,5,3,1600,1600,1603,0,3,1
456,3,2,1603,1603,1605,0,2,0
457,3,1,1606,1606,1607,0,1,1
458,1,2,1607,1607,1609,0,2,0
459,3,3,1610,1610,1613,0,3,1
460,6,1,1616,1616,1617,0,1,3
461,2,2,1618,1618,1620,0,2,1
462,6,2,1624,1624,1626,0,2,4
463,1,3,1625,1626,1629,1,4,0
464,2,1,1627,1629,1630,2,3,0
465,6,3,1633,1633,1636,0,3,3
466,1,2,1634,1636,1638,2,4,0
467,5,2,1639,1639,1641,0,2,1
468,4,1,1643,1643,1644,0,1,2
469,1,3,1644,1644,1647,0,3,0
470,1,2,1645,1647,1649,2,4,0
471,2,3,1647,1649,1652,2,5,0
472,3,2,1650,1652,1654,2,4,0
473,6,1,1656,1656,1657,0,1,2
474,2,2,1658,1658,1660,0,2,1
475,2,1,1660,1660,1661,0,1,0
476,1,2,1661,1661,1663,0,2,0
477,2,1,1663,1663,1664,0,1,0
478,2,1,1665,1665,1666,0,1,1
479,5,2,1670,1670,1672,0,2,4
480,6,1,1676,1676,1677,0,1,4
481,3,2,1679,1679,1681,0,2,2
482,5,1,1684,1684,1685,0,1,3
483,4,1,1688,1688,1689,0,1,3
484,3,2,1691,1691,1693,0,2,2
485,6,1,1697,1697,1698,0,1,4
486,3,2,1700,1700,1702,0,2,2
487,1,3,1701,1702,1705,1,4,0
488,6,2,1707,1707,1709,0,2,2
489,5,2,1712,1712,1714,0,2,3
490,3,2,1715,1715,1717,0,2,1
491,6,1,1721,1721,1722,0,1,4
492,2,3,1723,1723,1726,0,3,1
493,2,3,1725,1726,1729,1,4,0
494,3,3,1728,1729,1732,1,4,0
495,6,3,1734,1734,1737,0,3,2
496,6,1,1740,1740,1741,0,1,3
497,4,2,1744,1744,1746,0,2,3
498,5,1,1749,1749,1750,0,1,3
499,2,1,1751,1751,1752,0,1,1
500,6,3,1757,1757,1760,0,3,5
501,6,1,1763,1763,1764,0,1,3
502,2,1,1765,1765,1766,0,1,1
503,5,3,1770,1770,1773,0,3,4
504,3,2,1773,1773,1775,0,2,0
505,6,1,1779,1779,1780,0,1,4
506,5,1,1784,1784,1785,0,1,4
507,2,3,1786,1786,1789,0,3,1
508,3,3,1789,1789,1792,0,3,0
509,4,2,1793,1793,1795,0,2,1
510,2,2,1795,1795,1797,0,2,0
511,2,3,1797,1797,1800,0,3,0
512,2,2,1799,1800,1802,1,3,0
513,3,3,1802,1802,1805,0,3,0
514,2,3,1804,1805,1808,1,4,0
515,6,2,1810,1810,1812,0,2,2
516,5,3,1815,1815,1818,0,3,3
517,2,1,1817,1818,1819,1,2,0
518,5,2,1822,1822,1824,0,2,3
519,4,1,1826,1826,1827,0,1,2
520,1,1,1827,1827,1828,0,1,0
521,3,1,1830,1830,1831,0,1,2
522,2,1,1832,1832,1833,0,1,1
523,3,1,1835,1835,1836,0,1,2
524,1,1,1836,1836,1837,0,1,0
525,4,2,1840,1840,1842,0,2,3
526,3,1,1843,1843,1844,0,1,1
527,4,2,1847,1847,1849,0,2,3
528,3,3,1850,1850,1853,0,3,1
529,5,3,1855,1855,1858,0,3,2
530,5,1,1860,1860,1861,0,1,2
531,1,1,1861,1861,1862,0,1,0
532,4,2,1865,1865,1867,0,2,3
533,3,1,1868,1868,1869,0,1,1
534,6,2,1874,1874,1876,0,2,5
535,1,3,1875,1876,1879,1,4,0
536,1,1,1876,1879,1880,3,4,0
537,5,2,1881,1881,1883,0,2,1
538,5,2,1886,1886,1888,0,2,3
539,2,1,1888,1888,1889,0,1,0
540,1,2,1889,1889,1891,0,2,0
541,6,3,1895,1895,1898,0,3,4
542,2,1,1897,1898,1899,1,2,0
543,5,2,1902,1902,1904,0,2,3
544,5,3,1907,1907,1910,0,3,3
545,3,3,1910,1910,1913,0,3,0
546,1,1,1911,1913,1914,2,3,0
547,3,1,1914,1914,1915,0,1,0
548,4,3,1918,1918,1921,0,3,3
549,4,1,1922,1922,1923,0,1,1
550,1,3,1923,1923,1926,0,3,0
551,2,1,1925,1926,1927,1,2,0
552,4,1,1929,1929,1930,0,1,2
553,4,1,1933,1933,1934,0,1,3
554,6,2,1939,1939,1941,0,2,5
555,6,1,1945,1945,1946,0,1,4
556,6,3,1951,1951,1954,0,3,5
557,2,3,1953,1954,1957,1,4,0
558,4,2,1957,1957,1959,0,2,0
559,6,3,1963,1963,1966,0,3,4
560,6,2,1969,1969,1971,0,2,3
561,3,3,1972,1972,1975,0,3,1
562,3,2,1975,1975,1977,0,2,0
563,6,2,1981,1981,1983,0,2,4
564,6,1,1987,1987,1988,0,1,4
565,2,2,1989,1989,1991,0,2,1
566,1,1,1990,1991,1992,1,2,0
567,2,1,1992,1992,1993,0,1,0
568,1,1,1993,1993,1994,0,1,0
569,3,1,1996,1996,1997,0,1,2
570,6,1,2002,2002,2003,0,1,5
571,1,2,2003,2003,2005,0,2,0
572,5,1,2008,2008,2009,0,1,3
573,1,1,2009,2009,2010,0,1,0
574,6,1,2015,2015,2016,0,1,5
575,6,1,2021,2021,2022,0,1,5
576,5,2,2026,2026,2028,0,2,4
577,3,3,2029,2029,2032,0,3,1
578,3,2,2032,2032,2034,0,2,0
579,1,1,2033,2034,2035,1,2,0
580,5,2,2038,2038,2040,0,2,3
581,4,3,2042,2042,2045,0,3,2
582,2,2,2044,2045,2047,1,3,0
583,4,3,2048,2048,2051,0,3,1
584,5,2,2053,2053,2055,0,2,2
585,6,3,2059,2059,2062,0,3,4
586,6,3,2065,2065,2068,0,3,3
587,1,2,2066,2068,2070,2,4,0
588,6,1,2072,2072,2073,0,1,2
589,6,1,2078,2078,2079,0,1,5
590,5,1,2083,2083,2084,0,1,4
591,6,3,2089,2089,2092,0,3,5
592,3,3,2092,2092,2095,0,3,0
593,5,1,2097,2097,2098,0,1,2
594,4,1,2101,2101,2102,0,1,3
595,5,2,2106,2106,2108,0,2,4
596,1,2,2107,2108,2110,1,3,0
597,4,2,2111,2111,2113,0,2,1
598,2,2,2113,2113,2115,0,2,0
599,1,3,2114,2115,2118,1,4,0
600,1,2,2115,2118,2120,3,5,0
601,5,2,2120,2120,2122,0,2,0
602,5,1,2125,2125,2126,0,1,3
603,4,2,2129,2129,2131,0,2,3
604,3,2,2132,2132,2134,0,2,1
605,5,3,2137,2137,2140,0,3,3
606,2,2,2139,2140,2142,1,3,0
607,3,3,2142,2142,2145,0,3,0
608,2,3,2144,2145,2148,1,4,0
609,3,2,2147,2148,2150,1,3,0
610,4,2,2151,2151,2153,0,2,1
611,6,3,2157,2157,2160,0,3,4
612,6,2,2163,2163,2165,0,2,3
613,1,2,2164,2165,2167,1,3,0
614,3,3,2167,2167,2170,0,3,0
615,4,1,2171,2171,2172,0,1,1
616,1,3,2172,2172,2175,0,3,0
617,2,2,2174,2175,2177,1,3,0
618,1,1,2175,2177,2178,2,3,0
619,3,2,2178,2178,2180,0,2,0
620,2,1,2180,2180,2181,0,1,0
621,6,3,2186,2186,2189,0,3,5
622,5,3,2191,2191,2194,0,3,2
623,4,1,2195,2195,2196,0,1,1
624,2,1,2197,2197,2198,0,1,1
625,1,3,2198,2198,2201,0,3,0
626,2,2,2200,2201,2203,1,3,0
627,4,3,2204,2204,2207,0,3,1
628,5,3,2209,2209,2212,0,3,2
629,3,2,2212,2212,2214,0,2,0
630,5,1,2217,2217,2218,0,1,3
631,4,1,2221,2221,2222,0,1,3
632,4,3,2225,2225,2228,0,3,3
633,5,1,2230,2230,2231,0,1,2
634,4,2,2234,2234,2236,0,2,3
635,6,1,2240,2240,2241,0,1,4
636,4,3,2244,2244,2247,0,3,3
637,5,3,2249,2249,2252,0,3,2
638,4,2,2253,2253,2255,0,2,1
639,5,2,2258,2258,2260,0,2,3
640,1,2,2259,2260,2262,1,3,0
641,1,2,2260,2262,2264,2,4,0
642,5,1,2265,2265,2266,0,1,1
643,1,2,2266,2266,2268,0,2,0
644,4,2,2270,2270,2272,0,2,2
645,2,1,2272,2272,2273,0,1,0
646,6,3,2278,2278,2281,0,3,5
647,1,1,2279,2281,2282,2,3,0
648,1,3,2280,2282,2285,2,5,0
649,5,1,2285,2285,2286,0,1,0
650,4,3,2289,2289,2292,0,3,3
651,5,2,2294,2294,2296,0,2,2
652,6,1,2300,2300,2301,0,1,4
653,4,1,2304,2304,2305,0,1,3
654,2,2,2306,2306,2308,0,2,1
655,6,1,2312,2312,2313,0,1,4
656,6,2,2318,2318,2320,0,2,5
657,1,3,2319,2320,2323,1,4,0
658,3,1,2322,2323,2324,1,2,0
659,1,1,2323,2324,2325,1,2,0
660,3,3,2326,2326,2329,0,3,1
661,3,3,2329,2329,2332,0,3,0
662,4,2,2333,2333,2335,0,2,1
663,6,2,2339,2339,2341,0,2,4
664,1,3,2340,2341,2344,1,4,0
665,4,2,2344,2344,2346,0,2,0
666,6,3,2350,2350,2353,0,3,4
667,5,3,2355,2355,2358,0,3,2
668,4,3,2359,2359,2362,0,3,1
669,5,3,2364,2364,2367,0,3,2
670,3,1,2367,2367,2368,0,1,0
671,4,3,2371,2371,2374,0,3,3
672,5,1,2376,2376,2377,0,1,2
673,3,3,2379,2379,2382,0,3,2
674,4,2,2383,2383,2385,0,2,1
675,1,3,2384,2385,2388,1,4,0
676,3,3,2387,2388,2391,1,4,0
677,2,1,2389,2391,2392,2,3,0
678,4,3,2393,2393,2396,0,3,1
679,3,1,2396,2396,2397,0,1,0
680,1,3,2397,2397,2400,0,3,0
681,3,3,2400,2400,2403,0,3,0
682,1,2,2401,2403,2405,2,4,0
683,3,3,2404,2405,2408,1,4,0
684,5,1,2409,2409,2410,0,1,1
685,3,3,2412,2412,2415,0,3,2
686,2,3,2414,2415,2418,1,4,0
687,3,3,2417,2418,2421,1,4,0
688,6,1,2423,2423,2424,0,1,2
689,3,3,2426,2426,2429,0,3,2
690,1,3,2427,2429,2432,2,5,0
691,2,2,2429,2432,2434,3,5,0
692,2,3,2431,2434,2437,3,6,0
693,2,2,2433,2437,2439,4,6,0
694,4,1,2437,2439,2440,2,3,0
695,6,1,2443,2443,2444,0,1,3
696,1,1,2444,2444,2445,0,1,0
697,2,1,2446,2446,2447,0,1,1
698,2,2,2448,2448,2450,0,2,1
699,3,1,2451,2451,2452,0,1,1
700,2,2,2453,2453,2455,0,2,1
701,1,3,2454,2455,2458,1,4,0
702,1,3,2455,2458,2461,3,6,0
703,4,1,2459,2461,2462,2,3,0
704,6,3,2465,2465,2468,0,3,3
705,5,2,2470,2470,2472,0,2,2
706,2,2,2472,2472,2474,0,2,0
707,3,2,2475,2475,2477,0,2,1
708,4,1,2479,2479,2480,0,1,2
709,5,3,2484,2484,2487,0,3,4
710,1,1,2485,2487,2488,2,3,0
711,6,2,2491,2491,2493,0,2,3
712,4,2,2495,2495,2497,0,2,2
713,2,2,2497,2497,2499,0,2,0
714,4,3,2501,2501,2504,0,3,2
715,2,2,2503,2504,2506,1,3,0
716,5,2,2508,2508,2510,0,2,2
717,3,3,2511,2511,2514,0,3,1
718,1,1,2512,2514,2515,2,3,0
719,3,2,2515,2515,2517,0,2,0
720,1,2,2516,2517,2519,1,3,0
721,3,3,2519,2519,2522,0,3,0
722,5,3,2524,2524,2527,0,3,2
723,1,3,2525,2527,2530,2,5,0
724,1,1,2526,2530,2531,4,5,0
725,4,2,2530,2531,2533,1,3,0
726,1,2,2531,2533,2535,2,4,0
727,5,3,2536,2536,2539,0,3,1
728,6,1,2542,2542,2543,0,1,3
729,5,2,2547,2547,2549,0,2,4
730,4,1,2551,2551,2552,0,1,2
731,3,3,2554,2554,2557,0,3,2
732,4,2,2558,2558,2560,0,2,1
733,4,2,2562,2562,2564,0,2,2
734,4,2,2566,2566,2568,0,2,2
735,4,1,2570,2570,2571,0,1,2
736,6,2,2576,2576,2578,0,2,5
737,5,2,2581,2581,2583,0,2,3
738,6,2,2587,2587,2589,0,2,4
739,3,2,2590,2590,2592,0,2,1
740,3,1,2593,2593,2594,0,1,1
741,6,2,2599,2599,2601,0,2,5
742,5,2,2604,2604,2606,0,2,3
743,2,1,2606,2606,2607,0,1,0
744,5,1,2611,2611,2612,0,1,4
745,1,2,2612,2612,2614,0,2,0
746,5,2,2617,2617,2619,0,2,3
747,4,1,2621,2621,2622,0,1,2
748,5,1,2626,2626,2627,0,1,4
749,1,3,2627,2627,2630,0,3,0
750,4,1,2631,2631,2632,0,1,1
751,2,1,2633,2633,2634,0,1,1
752,3,3,2636,2636,2639,0,3,2
753,1,3,2637,2639,2642,2,5,0
754,4,3,2641,2642,2645,1,4,0
755,1,2,2642,2645,2647,3,5,0
756,5,1,2647,2647,2648,0,1,0
757,1,3,2648,2648,2651,0,3,0
758,6,2,2654,2654,2656,0,2,3
759,1,3,2655,2656,2659,1,4,0
760,2,3,2657,2659,2662,2,5,0
761,3,3,2660,2662,2665,2,5,0
762,5,2,2665,2665,2667,0,2,0
763,1,2,2666,2667,2669,1,3,0
764,6,2,2672,2672,2674,0,2,3
765,1,2,2673,2674,2676,1,3,0
766,3,2,2676,2676,2678,0,2,0
767,5,1,2681,2681,2682,0,1,3
768,2,2,2683,2683,2685,0,2,1
769,5,2,2688,2688,2690,0,2,3
770,1,2,2689,2690,2692,1,3,0
771,1,2,2690,2692,2694,2,4,0
772,4,2,2694,2694,2696,0,2,0
773,2,2,2696,2696,2698,0,2,0
774,4,1,2700,2700,2701,0,1,2
775,3,3,2703,2703,2706,0,3,2
776,3,3,2706,2706,2709,0,3,0
777,4,2,2710,2710,2712,0,2,1
778,6,2,2716,2716,2718,0,2,4
779,5,3,2721,2721,2724,0,3,3
780,4,2,2725,2725,2727,0,2,1
781,1,1,2726,2727,2728,1,2,0
782,6,3,2732,2732,2735,0,3,4
783,3,3,2735,2735,2738,0,3,0
784,6,3,2741,2741,2744,0,3,3
785,1,1,2742,2744,2745,2,3,0
786,2,1,2744,2745,2746,1,2,0
787,6,2,2750,2750,2752,0,2,4
788,6,3,2756,2756,2759,0,3,4
789,3,2,2759,2759,2761,0,2,0
790,5,1,2764,2764,2765,0,1,3
791,4,3,2768,2768,2771,0,3,3
792,6,3,2774,2774,2777,0,3,3
793,3,3,2777,2777,2780,0,3,0
794,6,3,2783,2783,2786,0,3,3
795,2,2,2785,2786,2788,1,3,0
796,6,1,2791,2791,2792,0,1,3
797,4,1,2795,2795,2796,0,1,3
798,4,2,2799,2799,2801,0,2,3
799,3,1,2802,2802,2803,0,1,1
800,4,3,2806,2806,2809,0,3,3
801,3,3,2809,2809,2812,0,3,0
802,2,3,2811,2812,2815,1,4,0
803,2,1,2813,2815,2816,2,3,0
804,4,1,2817,2817,2818,0,1,1
805,4,2,2821,2821,2823,0,2,3
806,4,1,2825,2825,2826,0,1,2
807,1,2,2826,2826,2828,0,2,0
808,3,3,2829,2829,2832,0,3,1
809,3,1,2832,2832,2833,0,1,0
810,5,2,2837,2837,2839,0,2,4
811,3,1,2840,2840,2841,0,1,1
812,6,1,2846,2846,2847,0,1,5
813,2,1,2848,2848,2849,0,1,1
814,6,3,2854,2854,2857,0,3,5
815,6,2,2860,2860,2862,0,2,3
816,1,2,2861,2862,2864,1,3,0
817,5,3,2866,2866,2869,0,3,2
818,2,1,2868,2869,2870,1,2,0
819,1,1,2869,2870,2871,1,2,0
820,2,2,2871,2871,2873,0,2,0
821,1,1,2872,2873,2874,1,2,0
822,4,2,2876,2876,2878,0,2,2
823,2,1,2878,2878,2879,0,1,0
824,4,2,2882,2882,2884,0,2,3
825,5,3,2887,2887,2890,0,3,3
826,6,1,2893,2893,2894,0,1,3
827,5,2,2898,2898,2900,0,2,4
828,3,3,2901,2901,2904,0,3,1
829,6,3,2907,2907,2910,0,3,3
830,4,2,2911,2911,2913,0,2,1
831,3,1,2914,2914,2915,0,1,1
832,2,1,2916,2916,2917,0,1,1
833,4,2,2920,2920,2922,0,2,3
834,1,1,2921,2922,2923,1,2,0
835,3,2,2924,2924,2926,0,2,1
836,3,3,2927,2927,2930,0,3,1
837,2,2,2929,2930,2932,1,3,0
838,5,3,2934,2934,2937,0,3,2
839,3,1,2937,2937,2938,0,1,0
840,4,3,2941,2941,2944,0,3,3
841,1,2,2942,2944,2946,2,4,0
842,5,3,2947,2947,2950,0,3,1
843,1,1,2948,2950,2951,2,3,0
844,2,1,2950,2951,2952,1,2,0
845,4,3,2954,2954,2957,0,3,2
846,3,1,2957,2957,2958,0,1,0
847,1,3,2958,2958,2961,0,3,0
848,1,2,2959,2961,2963,2,4,0
849,4,3,2963,2963,2966,0,3,0
850,4,3,2967,2967,2970,0,3,1
851,5,1,2972,2972,2973,0,1,2
852,6,1,2978,2978,2979,0,1,5
853,6,3,2984,2984,2987,0,3,5
854,2,2,2986,2987,2989,1,3,0
855,1,2,2987,2989,2991,2,4,0
856,2,3,2989,2991,2994,2,5,0
857,1,3,2990,2994,2997,4,7,0
858,1,1,2991,2997,2998,6,7,0
859,6,1,2997,2998,2999,1,2,0
860,3,2,3000,3000,3002,0,2,1
861,2,2,3002,3002,3004,0,2,0
862,2,1,3004,3004,3005,0,1,0
863,5,3,3009,3009,3012,0,3,4
864,2,1,3011,3012,3013,1,2,0
865,6,1,3017,3017,3018,0,1,4
866,6,3,3023,3023,3026,0,3,5
867,2,1,3025,3026,3027,1,2,0
868,4,2,3029,3029,3031,0,2,2
869,3,3,3032,3032,3035,0,3,1
870,4,3,3036,3036,3039,0,3,1
871,1,2,3037,3039,3041,2,4,0
872,6,3,3043,3043,3046,0,3,2
873,3,2,3046,3046,3048,0,2,0
874,4,1,3050,3050,3051,0,1,2
875,1,2,3051,3051,3053,0,2,0
876,1,3,3052,3053,3056,1,4,0
877,1,2,3053,3056,3058,3,5,0
878,6,2,3059,3059,3061,0,2,1
879,3,3,3062,3062,3065,0,3,1
880,6,3,3068,3068,3071,0,3,3
881,2,3,3070,3071,3074,1,4,0
882,6,1,3076,3076,3077,0,1,2
883,5,2,3081,3081,3083,0,2,4
884,2,3,3083,3083,3086,0,3,0
885,4,3,3087,3087,3090,0,3,1
886,4,3,3091,3091,3094,0,3,1
887,6,3,3097,3097,3100,0,3,3
888,6,1,3103,3103,3104,0,1,3
889,3,3,3106,3106,3109,0,3,2
890,5,3,3111,3111,3114,0,3,2
891,3,1,3114,3114,3115,0,1,0
892,1,1,3115,3115,3116,0,1,0
893,3,3,3118,3118,3121,0,3,2
894,6,1,3124,3124,3125,0,1,3
895,1,2,3125,3125,3127,0,2,0
896,2,1,3127,3127,3128,0,1,0
897,1,2,3128,3128,3130,0,2,0
898,6,3,3134,3134,3137,0,3,4
899,2,1,3136,3137,3138,1,2,0
900,6,2,3142,3142,3144,0,2,4
901,1,1,3143,3144,3145,1,2,0
902,6,2,3149,3149,3151,0,2,4
903,3,1,3152,3152,3153,0,1,1
904,3,2,3155,3155,3157,0,2,2
905,6,3,3161,3161,3164,0,3,4
906,5,1,3166,3166,3167,0,1,2
907,6,1,3172,3172,3173,0,1,5
908,3,3,3175,3175,3178,0,3,2
909,3,2,3178,3178,3180,0,2,0
910,5,3,3183,3183,3186,0,3,3
911,2,2,3185,3186,3188,1,3,0
912,1,1,3186,3188,3189,2,3,0
913,6,2,3192,3192,3194,0,2,3
914,1,3,3193,3194,3197,1,4,0
915,2,1,3195,3197,3198,2,3,0
916,3,1,3198,3198,3199,0,1,0
917,1,1,3199,3199,3200,0,1,0
918,2,2,3201,3201,3203,0,2,1
919,6,2,3207,3207,3209,0,2,4
920,2,2,3209,3209,3211,0,2,0
921,4,2,3213,3213,3215,0,2,2
922,3,2,3216,3216,3218,0,2,1
923,1,2,3217,3218,3220,1,3,0
924,3,3,3220,3220,3223,0,3,0
925,1,2,3221,3223,3225,2,4,0
926,5,1,3226,3226,3227,0,1,1
927,1,1,3227,3227,3228,0,1,0
928,1,2,3228,3228,3230,0,2,0
929,5,3,3233,3233,3236,0,3,3
930,6,1,3239,3239,3240,0,1,3
931,6,3,3245,3245,3248,0,3,5
932,5,3,3250,3250,3253,0,3,2
933,3,2,3253,3253,3255,0,2,0
934,2,1,3255,3255,3256,0,1,0
935,1,2,3256,3256,3258,0,2,0
936,4,2,3260,3260,3262,0,2,2
937,2,1,3262,3262,3263,0,1,0
938,6,3,3268,3268,3271,0,3,5
939,6,1,3274,3274,3275,0,1,3
940,4,2,3278,3278,3280,0,2,3
941,1,1,3279,3280,3281,1,2,0
942,2,1,3281,3281,3282,0,1,0
943,6,2,3287,3287,3289,0,2,5
944,5,2,3292,3292,3294,0,2,3
945,2,1,3294,3294,3295,0,1,0
946,4,1,3298,3298,3299,0,1,3
947,1,3,3299,3299,3302,0,3,0
948,4,1,3303,3303,3304,0,1,1
949,6,1,3309,3309,3310,0,1,5
950,4,2,3313,3313,3315,0,2,3
951,6,3,3319,3319,3322,0,3,4
952,2,1,3321,3322,3323,1,2,0
953,6,2,3327,3327,3329,0,2,4
954,1,1,3328,3329,3330,1,2,0
955,5,3,3333,3333,3336,0,3,3
956,1,2,3334,3336,3338,2,4,0
957,5,3,3339,3339,3342,0,3,1
958,4,3,3343,3343,3346,0,3,1
959,1,2,3344,3346,3348,2,4,0
960,3,3,3347,3348,3351,1,4,0
961,1,1,3348,3351,3352,3,4,0
962,3,1,3351,3352,3353,1,2,0
963,4,2,3355,3355,3357,0,2,2
964,2,2,3357,3357,3359,0,2,0
965,6,1,3363,3363,3364,0,1,4
966,1,2,3364,3364,3366,0,2,0
967,5,3,3369,3369,3372,0,3,3
968,2,3,3371,3372,3375,1,4,0
969,2,3,3373,3375,3378,2,5,0
970,5,3,3378,3378,3381,0,3,0
971,4,1,3382,3382,3383,0,1,1
972,2,1,3384,3384,3385,0,1,1
973,1,2,3385,3385,3387,0,2,0
974,6,3,3391,3391,3394,0,3,4
975,2,1,3393,3394,3395,1,2,0
976,1,1,3394,3395,3396,1,2,0
977,1,2,3395,3396,3398,1,3,0
978,6,3,3401,3401,3404,0,3,3
979,4,1,3405,3405,3406,0,1,1
980,5,3,3410,3410,3413,0,3,4
981,2,2,3412,3413,3415,1,3,0
982,2,3,3414,3415,3418,1,4,0
983,5,2,3419,3419,3421,0,2,1
984,3,3,3422,3422,3425,0,3,1
985,1,2,3423,3425,3427,2,4,0
986,1,3,3424,3427,3430,3,6,0
987,5,1,3429,3430,3431,1,2,0
988,3,2,3432,3432,3434,0,2,1
989,2,2,3434,3434,3436,0,2,0
990,1,2,3435,3436,3438,1,3,0
991,4,1,3439,3439,3440,0,1,1
992,6,3,3445,3445,3448,0,3,5
993,1,2,3446,3448,3450,2,4,0
994,4,1,3450,3450,3451,0,1,0
995,3,2,3453,3453,3455,0,2,2
996,5,3,3458,3458,3461,0,3,3
997,3,2,3461,3461,3463,0,2,0
998,5,3,3466,3466,3469,0,3,3
999,2,2,3468,3469,3471,1,3,0
1000,2,1,3470,3471,3472,1,2,0
1001,4,1,3474,3474,3475,0,1,2
1002,2,2,3476,3476,3478,0,2,1
1003,4,1,3480,3480,3481,0,1,2
1004,3,1,3483,3483,3484,0,1,2
1005,1,2,3484,3484,3486,0,2,0
1006,6,1,3490,3490,3491,0,1,4
1007,2,1,3492,3492,3493,0,1,1
1008,5,1,3497,3497,3498,0,1,4
1009,3,1,3500,3500,3501,0,1,2
1010,3,2,3503,3503,3505,0,2,2
1011,6,1,3509,3509,3510,0,1,4
1012,3,2,3512,3512,3514,0,2,2
1013,1,2,3513,3514,3516,1,3,0
1014,2,3,3515,3516,3519,1,4,0
1015,6,3,3521,3521,3524,0,3,2
1016,3,3,3524,3524,3527,0,3,0
1017,6,2,3530,3530,3532,0,2,3
1018,4,1,3534,3534,3535,0,1,2
1019,3,1,3537,3537,3538,0,1,2
1020,5,3,3542,3542,3545,0,3,4
1021,5,2,3547,3547,3549,0,2,2
1022,4,3,3551,3551,3554,0,3,2
1023,4,2,3555,3555,3557,0,2,1
1024,3,2,3558,3558,3560,0,2,1
1025,6,2,3564,3564,3566,0,2,4
1026,4,3,3568,3568,3571,0,3,2
1027,5,1,3573,3573,3574,0,1,2
1028,3,3,3576,3576,3579,0,3,2
1029,5,2,3581,3581,3583,0,2,2
1030,2,3,3583,3583,3586,0,3,0
1031,2,3,3585,3586,3589,1,4,0
1032,2,2,3587,3589,3591,2,4,0
1033,4,3,3591,3591,3594,0,3,0
1034,5,1,3596,3596,3597,0,1,2
1035,4,2,3600,3600,3602,0,2,3
1036,3,2,3603,3603,3605,0,2,1
1037,6,3,3609,3609,3612,0,3,4
1038,1,1,3610,3612,3613,2,3,0
1039,5,1,3615,3615,3616,0,1,2
1040,5,2,3620,3620,3622,0,2,4
1041,1,2,3621,3622,3624,1,3,0
1042,2,3,3623,3624,3627,1,4,0
1043,4,3,3627,3627,3630,0,3,0
1044,6,2,3633,3633,3635,0,2,3
1045,2,1,3635,3635,3636,0,1,0
1046,1,2,3636,3636,3638,0,2,0
1047,1,1,3637,3638,3639,1,2,0
1048,1,1,3638,3639,3640,1,2,0
1049,1,3,3639,3640,3643,1,4,0
1050,3,2,3642,3643,3645,1,3,0
1051,2,1,3644,3645,3646,1,2,0
1052,2,2,3646,3646,3648,0,2,0
1053,2,2,3648,3648,3650,0,2,0
1054,6,3,3654,3654,3657,0,3,4
1055,2,1,3656,3657,3658,1,2,0
1056,3,2,3659,3659,3661,0,2,1
1057,5,3,3664,3664,3667,0,3,3
1058,1,2,3665,3667,3669,2,4,0
1059,2,2,3667,3669,3671,2,4,0
1060,6,1,3673,3673,3674,0,1,2
1061,1,1,3674,3674,3675,0,1,0
1062,4,2,3678,3678,3680,0,2,3
1063,1,1,3679,3680,3681,1,2,0
1064,3,2,3682,3682,3684,0,2,1
1065,1,3,3683,3684,3687,1,4,0
1066,1,2,3684,3687,3689,3,5,0
1067,4,1,3688,3689,3690,1,2,0
1068,4,1,3692,3692,3693,0,1,2
1069,3,3,3695,3695,3698,0,3,2
1070,4,1,3699,3699,3700,0,1,1
1071,6,1,3705,3705,3706,0,1,5
1072,3,2,3708,3708,3710,0,2,2
1073,4,2,3712,3712,3714,0,2,2
1074,2,2,3714,3714,3716,0,2,0
1075,4,3,3718,3718,3721,0,3,2
1076,6,2,3724,3724,3726,0,2,3
1077,3,3,3727,3727,3730,0,3,1
1078,6,2,3733,3733,3735,0,2,3
1079,6,3,3739,3739,3742,0,3,4
1080,3,1,3742,3742,3743,0,1,0
1081,2,1,3744,3744,3745,0,1,1
1082,5,3,3749,3749,3752,0,3,4
1083,6,1,3755,3755,3756,0,1,3
1084,4,3,3759,3759,3762,0,3,3
1085,1,1,3760,3762,3763,2,3,0
1086,6,1,3766,3766,3767,0,1,3
1087,6,2,3772,3772,3774,0,2,5
1088,2,2,3774,3774,3776,0,2,0
1089,6,3,3780,3780,3783,0,3,4
1090,5,1,3785,3785,3786,0,1,2
1091,4,1,3789,3789,3790,0,1,3
1092,1,3,3790,3790,3793,0,3,0
1093,3,2,3793,3793,3795,0,2,0
1094,6,2,3799,3799,3801,0,2,4
1095,4,2,3803,3803,3805,0,2,2
1096,2,3,3805,3805,3808,0,3,0
1097,4,2,3809,3809,3811,0,2,1
1098,4,2,3813,3813,3815,0,2,2
1099,1,1,3814,3815,3816,1,2,0
1100,1,3,3815,3816,3819,1,4,0
1101,2,2,3817,3819,3821,2,4,0
1102,3,2,3820,3821,3823,1,3,0
1103,5,3,3825,3825,3828,0,3,2
1104,6,2,3831,3831,3833,0,2,3
1105,1,3,3832,3833,3836,1,4,0
1106,4,3,3836,3836,3839,0,3,0
1107,5,1,3841,3841,3842,0,1,2
1108,1,1,3842,3842,3843,0,1,0
1109,4,2,3846,3846,3848,0,2,3
1110,3,3,3849,3849,3852,0,3,1
1111,1,3,3850,3852,3855,2,5,0
1112,1,1,3851,3855,3856,4,5,0
1113,6,2,3857,3857,3859,0,2,1
1114,1,2,3858,3859,3861,1,3,0
1115,3,3,3861,3861,3864,0,3,0
1116,5,2,3866,3866,3868,0,2,2
1117,6,1,3872,3872,3873,0,1,4
1118,2,1,3874,3874,3875,0,1,1
1119,1,3,3875,3875,3878,0,3,0
1120,6,2,3881,3881,3883,0,2,3
1121,4,2,3885,3885,3887,0,2,2
1122,1,3,3886,3887,3890,1,4,0
1123,4,3,3890,3890,3893,0,3,0
1124,5,2,3895,3895,3897,0,2,2
1125,5,2,3900,3900,3902,0,2,3
1126,2,1,3902,3902,3903,0,1,0
1127,6,3,3908,3908,3911,0,3,5
1128,2,1,3910,3911,3912,1,2,0
1129,1,1,3911,3912,3913,1,2,0
1130,4,2,3915,3915,3917,0,2,2
1131,2,2,3917,3917,3919,0,2,0
1132,4,3,3921,3921,3924,0,3,2
1133,1,3,3922,3924,3927,2,5,0
1134,1,3,3923,3927,3930,4,7,0
1135,6,1,3929,3930,3931,1,2,0
1136,6,1,3935,3935,3936,0,1,4
1137,1,3,3936,3936,3939,0,3,0
1138,6,3,3942,3942,3945,0,3,3
1139,3,2,3945,3945,3947,0,2,0
1140,4,1,3949,3949,3950,0,1,2
1141,3,1,3952,3952,3953,0,1,2
1142,5,3,3957,3957,3960,0,3,4
1143,4,3,3961,3961,3964,0,3,1
1144,4,3,3965,3965,3968,0,3,1
1145,4,2,3969,3969,3971,0,2,1
1146,5,2,3974,3974,3976,0,2,3
1147,2,2,3976,3976,3978,0,2,0
1148,4,2,3980,3980,3982,0,2,2
1149,2,1,3982,3982,3983,0,1,0
1150,3,3,3985,3985,3988,0,3,2
1151,3,1,3988,3988,3989,0,1,0
1152,4,2,3992,3992,3994,0,2,3
1153,3,2,3995,3995,3997,0,2,1
1154,6,3,4001,4001,4004,0,3,4
1155,5,1,4006,4006,4007,0,1,2
1156,2,3,4008,4008,4011,0,3,1
1157,6,3,4014,4014,4017,0,3,3
1158,6,3,4020,4020,4023,0,3,3
1159,1,3,4021,4023,4026,2,5,0
1160,3,1,4024,4026,4027,2,3,0
1161,3,3,4027,4027,4030,0,3,0
1162,2,1,4029,4030,4031,1,2,0
1163,1,3,4030,4031,4034,1,4,0
1164,6,2,4036,4036,4038,0,2,2
1165,4,1,4040,4040,4041,0,1,2
1166,4,3,4044,4044,4047,0,3,3
1167,5,3,4049,4049,4052,0,3,2
1168,1,3,4050,4052,4055,2,5,0
1169,4,3,4054,4055,4058,1,4,0
1170,4,2,4058,4058,4060,0,2,0
1171,5,1,4063,4063,4064,0,1,3
1172,6,2,4069,4069,4071,0,2,5
1173,1,2,4070,4071,4073,1,3,0
1174,1,1,4071,4073,4074,2,3,0
1175,4,1,4075,4075,4076,0,1,1
1176,5,1,4080,4080,4081,0,1,4
1177,2,1,4082,4082,4083,0,1,1
1178,1,3,4083,4083,4086,0,3,0
1179,5,3,4088,4088,4091,0,3,2
1180,5,1,4093,4093,4094,0,1,2
1181,3,2,4096,4096,4098,0,2,2
1182,4,1,4100,4100,4101,0,1,2
1183,6,3,4106,4106,4109,0,3,5
1184,2,2,4108,4109,4111,1,3,0
1185,1,2,4109,4111,4113,2,4,0
1186,4,2,4113,4113,4115,0,2,0
1187,4,1,4117,4117,4118,0,1,2
1188,5,2,4122,4122,4124,0,2,4
1189,5,1,4127,4127,4128,0,1,3
1190,1,3,4128,4128,4131,0,3,0
1191,3,2,4131,4131,4133,0,2,0
1192,2,3,4133,4133,4136,0,3,0
1193,3,2,4136,4136,4138,0,2,0
1194,1,1,4137,4138,4139,1,2,0
1195,6,1,4143,4143,4144,0,1,4
1196,3,3,4146,4146,4149,0,3,2
1197,6,1,4152,4152,4153,0,1,3
1198,6,1,4158,4158,4159,0,1,5
1199,3,2,4161,4161,4163,0,2,2
1200,2,3,4163,4163,4166,0,3,0
1201,3,1,4166,4166,4167,0,1,0
1202,2,3,4168,4168,4171,0,3,1
1203,5,3,4173,4173,4176,0,3,2
1204,4,2,4177,4177,4179,0,2,1
1205,5,3,4182,4182,4185,0,3,3
1206,4,3,4186,4186,4189,0,3,1
1207,5,2,4191,4191,4193,0,2,2
1208,5,1,4196,4196,4197,0,1,3
1209,5,2,4201,4201,4203,0,2,4
1210,1,2,4202,4203,4205,1,3,0
1211,5,1,4207,4207,4208,0,1,2
1212,6,3,4213,4213,4216,0,3,5
1213,2,2,4215,4216,4218,1,3,0
1214,6,1,4221,4221,4222,0,1,3
1215,3,3,4224,4224,4227,0,3,2
1216,2,1,4226,4227,4228,1,2,0
1217,5,3,4231,4231,4234,0,3,3
1218,6,2,4237,4237,4239,0,2,3
1219,1,1,4238,4239,4240,1,2,0
1220,5,3,4243,4243,4246,0,3,3
1221,6,3,4249,4249,4252,0,3,3
1222,6,1,4255,4255,4256,0,1,3
1223,3,3,4258,4258,4261,0,3,2
1224,3,3,4261,4261,4264,0,3,0
1225,6,1,4267,4267,4268,0,1,3
1226,1,1,4268,4268,4269,0,1,0
1227,5,1,4273,4273,4274,0,1,4
1228,2,2,4275,4275,4277,0,2,1
1229,1,1,4276,4277,4278,1,2,0
1230,3,1,4279,4279,4280,0,1,1
1231,3,1,4282,4282,4283,0,1,2
1232,6,1,4288,4288,4289,0,1,5
1233,1,1,4289,4289,4290,0,1,0
1234,2,1,4291,4291,4292,0,1,1
1235,4,2,4295,4295,4297,0,2,3
1236,2,1,4297,4297,4298,0,1,0
1237,4,3,4301,4301,4304,0,3,3
1238,1,1,4302,4304,4305,2,3,0
1239,2,1,4304,4305,4306,1,2,0
1240,4,3,4308,4308,4311,0,3,2
1241,3,3,4311,4311,4314,0,3,0
1242,5,3,4316,4316,4319,0,3,2
1243,5,2,4321,4321,4323,0,2,2
1244,4,2,4325,4325,4327,0,2,2
1245,5,3,4330,4330,4333,0,3,3
1246,3,1,4333,4333,4334,0,1,0
1247,3,1,4336,4336,4337,0,1,2
1248,5,2,4341,4341,4343,0,2,4
1249,3,2,4344,4344,4346,0,2,1
1250,1,3,4345,4346,4349,1,4,0
1251,3,1,4348,4349,4350,1,2,0
1252,6,2,4354,4354,4356,0,2,4
1253,3,1,4357,4357,4358,0,1,1
1254,3,1,4360,4360,4361,0,1,2
1255,1,3,4361,4361,4364,0,3,0
1256,6,3,4367,4367,4370,0,3,3
1257,5,1,4372,4372,4373,0,1,2
1258,5,3,4377,4377,4380,0,3,4
1259,1,3,4378,4380,4383,2,5,0
1260,2,1,4380,4383,4384,3,4,0
1261,3,3,4383,4384,4387,1,4,0
1262,5,2,4388,4388,4390,0,2,1
1263,1,1,4389,4390,4391,1,2,0
1264,1,2,4390,4391,4393,1,3,0
1265,1,1,4391,4393,4394,2,3,0
1266,3,3,4394,4394,4397,0,3,0
1267,5,2,4399,4399,4401,0,2,2
1268,4,3,4403,4403,4406,0,3,2
1269,5,1,4408,4408,4409,0,1,2
1270,4,2,4412,4412,4414,0,2,3
1271,1,3,4413,4414,4417,1,4,0
1272,5,2,4418,4418,4420,0,2,1
1273,4,2,4422,4422,4424,0,2,2
1274,3,3,4425,4425,4428,0,3,1
1275,1,3,4426,4428,4431,2,5,0
1276,2,2,4428,4431,4433,3,5,0
1277,6,1,4434,4434,4435,0,1,1
1278,6,1,4440,4440,4441,0,1,5
1279,4,3,4444,4444,4447,0,3,3
1280,6,1,4450,4450,4451,0,1,3
1281,3,3,4453,4453,4456,0,3,2
1282,4,3,4457,4457,4460,0,3,1
1283,4,3,4461,4461,4464,0,3,1
1284,4,2,4465,4465,4467,0,2,1
1285,5,2,4470,4470,4472,0,2,3
1286,1,1,4471,4472,4473,1,2,0
1287,2,2,4473,4473,4475,0,2,0
1288,1,1,4474,4475,4476,1,2,0
1289,6,3,4480,4480,4483,0,3,4
1290,6,2,4486,4486,4488,0,2,3
1291,1,3,4487,4488,4491,1,4,0
1292,1,3,4488,4491,4494,3,6,0
1293,1,2,4489,4494,4496,5,7,0
1294,1,2,4490,4496,4498,6,8,0
1295,6,3,4496,4498,4501,2,5,0
1296,2,3,4498,4501,4504,3,6,0
1297,1,3,4499,4504,4507,5,8,0
1298,4,2,4503,4507,4509,4,6,0
1299,2,2,4505,4509,4511,4,6,0
1300,2,3,4507,4511,4514,4,7,0
1301,1,2,4508,4514,4516,6,8,0
1302,1,3,4509,4516,4519,7,10,0
1303,6,2,4515,4519,4521,4,6,0
1304,1,1,4516,4521,4522,5,6,0
1305,1,1,4517,4522,4523,5,6,0
1306,4,1,4521,4523,4524,2,3,0
1307,3,1,4524,4524,4525,0,1,0
1308,5,2,4529,4529,4531,0,2,4
1309,6,2,4535,4535,4537,0,2,4
1310,6,3,4541,4541,4544,0,3,4
1311,5,1,4546,4546,4547,0,1,2
1312,5,1,4551,4551,4552,0,1,4
1313,6,2,4557,4557,4559,0,2,5
1314,5,3,4562,4562,4565,0,3,3
1315,3,2,4565,4565,4567,0,2,0
1316,1,1,4566,4567,4568,1,2,0
1317,5,1,4571,4571,4572,0,1,3
1318,1,3,4572,4572,4575,0,3,0
1319,4,2,4576,4576,4578,0,2,1
1320,1,3,4577,4578,4581,1,4,0
1321,5,3,4582,4582,4585,0,3,1
1322,5,1,4587,4587,4588,0,1,2
1323,5,3,4592,4592,4595,0,3,4
1324,6,3,4598,4598,4601,0,3,3
1325,6,2,4604,4604,4606,0,2,3
1326,4,3,4608,4608,4611,0,3,2
1327,4,1,4612,4612,4613,0,1,1
1328,3,3,4615,4615,4618,0,3,2
1329,6,1,4621,4621,4622,0,1,3
1330,3,1,4624,4624,4625,0,1,2
1331,3,2,4627,4627,4629,0,2,2
1332,6,2,4633,4633,4635,0,2,4
1333,1,1,4634,4635,4636,1,2,0
1334,1,3,4635,4636,4639,1,4,0
1335,2,3,4637,4639,4642,2,5,0
1336,3,1,4640,4642,4643,2,3,0
1337,3,1,4643,4643,4644,0,1,0
1338,6,2,4649,4649,4651,0,2,5
1339,4,3,4653,4653,4656,0,3,2
1340,3,1,4656,4656,4657,0,1,0
1341,2,2,4658,4658,4660,0,2,1
1342,2,2,4660,4660,4662,0,2,0
1343,1,2,4661,4662,4664,1,3,0
1344,2,2,4663,4664,4666,1,3,0
1345,2,2,4665,4666,4668,1,3,0
1346,5,3,4670,4670,4673,0,3,2
1347,5,2,4675,4675,4677,0,2,2
1348,6,1,4681,4681,4682,0,1,4
1349,5,1,4686,4686,4687,0,1,4
1350,4,2,4690,4690,4692,0,2,3
1351,3,2,4693,4693,4695,0,2,1
1352,6,3,4699,4699,4702,0,3,4
1353,1,3,4700,4702,4705,2,5,0
1354,3,2,4703,4705,4707,2,4,0
1355,6,2,4709,4709,4711,0,2,2
1356,4,3,4713,4713,4716,0,3,2
1357,5,1,4718,4718,4719,0,1,2
1358,2,2,4720,4720,4722,0,2,1
1359,1,2,4721,4722,4724,1,3,0
1360,6,3,4727,4727,4730,0,3,3
1361,1,3,4728,4730,4733,2,5,0
1362,1,1,4729,4733,4734,4,5,0
1363,5,3,4734,4734,4737,0,3,0
1364,2,1,4736,4737,4738,1,2,0
1365,6,2,4742,4742,4744,0,2,4
1366,4,3,4746,4746,4749,0,3,2
1367,3,1,4749,4749,4750,0,1,0
1368,2,2,4751,4751,4753,0,2,1
1369,6,3,4757,4757,4760,0,3,4
1370,3,3,4760,4760,4763,0,3,0
1371,5,2,4765,4765,4767,0,2,2
1372,5,1,4770,4770,4771,0,1,3
1373,6,1,4776,4776,4777,0,1,5
1374,6,2,4782,4782,4784,0,2,5
1375,2,3,4784,4784,4787,0,3,0
1376,3,2,4787,4787,4789,0,2,0
1377,1,2,4788,4789,4791,1,3,0
1378,3,1,4791,4791,4792,0,1,0
1379,5,2,4796,4796,4798,0,2,4
1380,6,3,4802,4802,4805,0,3,4
1381,5,2,4807,4807,4809,0,2,2
1382,2,3,4809,4809,4812,0,3,0
1383,3,3,4812,4812,4815,0,3,0
1384,5,3,4817,4817,4820,0,3,2
1385,3,1,4820,4820,4821,0,1,0
1386,5,2,4825,4825,4827,0,2,4
1387,3,1,4828,4828,4829,0,1,1
1388,3,2,4831,4831,4833,0,2,2
1389,2,3,4833,4833,4836,0,3,0
1390,2,1,4835,4836,4837,1,2,0
1391,2,2,4837,4837,4839,0,2,0
1392,4,2,4841,4841,4843,0,2,2
1393,2,2,4843,4843,4845,0,2,0
1394,6,3,4849,4849,4852,0,3,4
1395,6,1,4855,4855,4856,0,1,3
1396,4,3,4859,4859,4862,0,3,3
1397,3,1,4862,4862,4863,0,1,0
1398,4,2,4866,4866,4868,0,2,3
1399,6,1,4872,4872,4873,0,1,4
1400,5,1,4877,4877,4878,0,1,4
1401,1,3,4878,4878,4881,0,3,0
1402,6,3,4884,4884,4887,0,3,3
1403,1,3,4885,4887,4890,2,5,0
1404,5,1,4890,4890,4891,0,1,0
1405,2,1,4892,4892,4893,0,1,1
1406,6,2,4898,4898,4900,0,2,5
1407,2,2,4900,4900,4902,0,2,0
1408,6,1,4906,4906,4907,0,1,4
1409,4,3,4910,4910,4913,0,3,3
1410,4,3,4914,4914,4917,0,3,1
1411,5,3,4919,4919,4922,0,3,2
1412,1,3,4920,4922,4925,2,5,0
1413,1,2,4921,4925,4927,4,6,0
1414,4,2,4925,4927,4929,2,4,0
1415,5,3,4930,4930,4933,0,3,1
1416,1,1,4931,4933,4934,2,3,0
1417,1,1,4932,4934,4935,2,3,0
1418,3,1,4935,4935,4936,0,1,0
1419,6,2,4941,4941,4943,0,2,5
1420,6,2,4947,4947,4949,0,2,4
1421,2,1,4949,4949,4950,0,1,0
1422,3,1,4952,4952,4953,0,1,2
1423,3,3,4955,4955,4958,0,3,2
1424,5,3,4960,4960,4963,0,3,2
1425,5,3,4965,4965,4968,0,3,2
1426,2,3,4967,4968,4971,1,4,0
1427,1,2,4968,4971,4973,3,5,0
1428,6,3,4974,4974,4977,0,3,1
1429,5,3,4979,4979,4982,0,3,2
1430,5,1,4984,4984,4985,0,1,2
1431,4,1,4988,4988,4989,0,1,3
1432,1,3,4989,4989,4992,0,3,0
1433,1,2,4990,4992,4994,2,4,0
1434,5,1,4995,4995,4996,0,1,1
1435,3,2,4998,4998,5000,0,2,2
1436,6,1,5004,5004,5005,0,1,4
1437,3,1,5007,5007,5008,0,1,2
1438,6,1,5013,5013,5014,0,1,5
1439,6,2,5019,5019,5021,0,2,5
1440,6,2,5025,5025,5027,0,2,4
1441,4,1,5029,5029,5030,0,1,2
1442,3,3,5032,5032,5035,0,3,2
1443,6,1,5038,5038,5039,0,1,3
1444,3,1,5041,5041,5042,0,1,2
1445,6,1,5047,5047,5048,0,1,5
1446,1,1,5048,5048,5049,0,1,0
1447,4,3,5052,5052,5055,0,3,3
1448,4,1,5056,5056,5057,0,1,1
1449,5,1,5061,5061,5062,0,1,4
1450,6,1,5067,5067,5068,0,1,5
1451,2,2,5069,5069,5071,0,2,1
1452,6,2,5075,5075,5077,0,2,4
1453,1,1,5076,5077,5078,1,2,0
1454,1,1,5077,5078,5079,1,2,0
1455,3,3,5080,5080,5083,0,3,1
1456,2,3,5082,5083,5086,1,4,0
1457,4,1,5086,5086,5087,0,1,0
1458,6,3,5092,5092,5095,0,3,5
1459,2,2,5094,5095,5097,1,3,0
1460,2,2,5096,5097,5099,1,3,0
1461,3,3,5099,5099,5102,0,3,0
1462,1,2,5100,5102,5104,2,4,0
1463,3,3,5103,5104,5107,1,4,0
1464,1,2,5104,5107,5109,3,5,0
1465,2,1,5106,5109,5110,3,4,0
1466,5,1,5111,5111,5112,0,1,1
1467,4,3,5115,5115,5118,0,3,3
1468,2,2,5117,5118,5120,1,3,0
1469,5,1,5122,5122,5123,0,1,2
1470,4,1,5126,5126,5127,0,1,3
1471,6,1,5132,5132,5133,0,1,5
1472,4,1,5136,5136,5137,0,1,3
1473,6,2,5142,5142,5144,0,2,5
1474,5,3,5147,5147,5150,0,3,3
1475,2,3,5149,5150,5153,1,4,0
1476,4,1,5153,5153,5154,0,1,0
1477,5,2,5158,5158,5160,0,2,4
1478,5,1,5163,5163,5164,0,1,3
1479,6,3,5169,5169,5172,0,3,5
1480,2,3,5171,5172,5175,1,4,0
1481,4,3,5175,5175,5178,0,3,0
1482,1,1,5176,5178,5179,2,3,0
1483,4,1,5180,5180,5181,0,1,1
1484,6,2,5186,5186,5188,0,2,5
1485,3,2,5189,5189,5191,0,2,1
1486,3,2,5192,5192,5194,0,2,1
1487,3,3,5195,5195,5198,0,3,1
1488,6,3,5201,5201,5204,0,3,3
1489,6,2,5207,5207,5209,0,2,3
1490,3,3,5210,5210,5213,0,3,1
1491,3,1,5213,5213,5214,0,1,0
1492,4,2,5217,5217,5219,0,2,3
1493,6,3,5223,5223,5226,0,3,4
1494,3,2,5226,5226,5228,0,2,0
1495,4,2,5230,5230,5232,0,2,2
1496,3,2,5233,5233,5235,0,2,1
1497,4,2,5237,5237,5239,0,2,2
1498,2,2,5239,5239,5241,0,2,0
1499,5,3,5244,5244,5247,0,3,3
1500,2,3,5246,5247,5250,1,4,0
1501,2,2,5248,5250,5252,2,4,0
1502,3,3,5251,5252,5255,1,4,0
1503,3,2,5254,5255,5257,1,3,0
1504,2,1,5256,5257,5258,1,2,0
1505,3,2,5259,5259,5261,0,2,1
1506,1,3,5260,5261,5264,1,4,0
1507,6,1,5266,5266,5267,0,1,2
1508,2,2,5268,5268,5270,0,2,1
1509,4,2,5272,5272,5274,0,2,2
1510,5,3,5277,5277,5280,0,3,3
1511,4,3,5281,5281,5284,0,3,1
1512,6,1,5287,5287,5288,0,1,3
1513,2,1,5289,5289,5290,0,1,1
1514,1,1,5290,5290,5291,0,1,0
1515,3,3,5293,5293,5296,0,3,2
1516,5,3,5298,5298,5301,0,3,2
1517,6,3,5304,5304,5307,0,3,3
1518,5,1,5309,5309,5310,0,1,2
1519,2,2,5311,5311,5313,0,2,1
1520,4,1,5315,5315,5316,0,1,2
1521,2,3,5317,5317,5320,0,3,1
1522,4,3,5321,5321,5324,0,3,1
1523,2,2,5323,5324,5326,1,3,0
1524,5,2,5328,5328,5330,0,2,2
1525,2,3,5330,5330,5333,0,3,0
1526,4,2,5334,5334,5336,0,2,1
1527,5,2,5339,5339,5341,0,2,3
1528,4,1,5343,5343,5344,0,1,2
1529,3,1,5346,5346,5347,0,1,2
1530,5,2,5351,5351,5353,0,2,4
1531,4,3,5355,5355,5358,0,3,2
1532,3,2,5358,5358,5360,0,2,0
1533,6,3,5364,5364,5367,0,3,4
1534,2,1,5366,5367,5368,1,2,0
1535,5,1,5371,5371,5372,0,1,3
1536,3,2,5374,5374,5376,0,2,2
1537,1,1,5375,5376,5377,1,2,0
1538,6,2,5381,5381,5383,0,2,4
1539,3,1,5384,5384,5385,0,1,1
1540,4,1,5388,5388,5389,0,1,3
1541,6,2,5394,5394,5396,0,2,5
1542,4,3,5398,5398,5401,0,3,2
1543,5,1,5403,5403,5404,0,1,2
1544,1,3,5404,5404,5407,0,3,0
1545,3,1,5407,5407,5408,0,1,0
1546,4,2,5411,5411,5413,0,2,3
1547,6,2,5417,5417,5419,0,2,4
1548,5,1,5422,5422,5423,0,1,3
1549,2,2,5424,5424,5426,0,2,1
1550,1,3,5425,5426,5429,1,4,0
1551,1,2,5426,5429,5431,3,5,0
1552,6,3,5432,5432,5435,0,3,1
1553,2,1,5434,5435,5436,1,2,0
1554,3,3,5437,5437,5440,0,3,1
1555,6,3,5443,5443,5446,0,3,3
1556,4,1,5447,5447,5448,0,1,1
1557,2,1,5449,5449,5450,0,1,1
1558,3,2,5452,5452,5454,0,2,2
1559,3,1,5455,5455,5456,0,1,1
1560,1,2,5456,5456,5458,0,2,0
1561,3,2,5459,5459,5461,0,2,1
1562,2,1,5461,5461,5462,0,1,0
1563,5,2,5466,5466,5468,0,2,4
1564,5,3,5471,5471,5474,0,3,3
1565,2,3,5473,5474,5477,1,4,0
1566,3,1,5476,5477,5478,1,2,0
1567,1,3,5477,5478,5481,1,4,0
1568,1,3,5478,5481,5484,3,6,0
1569,6,3,5484,5484,5487,0,3,0
1570,2,1,5486,5487,5488,1,2,0
1571,6,1,5492,5492,5493,0,1,4
1572,1,3,5493,5493,5496,0,3,0
1573,5,2,5498,5498,5500,0,2,2
1574,2,3,5500,5500,5503,0,3,0
1575,3,2,5503,5503,5505,0,2,0
1576,6,2,5509,5509,5511,0,2,4
1577,3,2,5512,5512,5514,0,2,1
1578,6,3,5518,5518,5521,0,3,4
1579,1,1,5519,5521,5522,2,3,0
1580,2,1,5521,5522,5523,1,2,0
1581,5,3,5526,5526,5529,0,3,3
1582,1,2,5527,5529,5531,2,4,0
1583,2,1,5529,5531,5532,2,3,0
1584,1,2,5530,5532,5534,2,4,0
1585,6,1,5536,5536,5537,0,1,2
1586,4,1,5540,5540,5541,0,1,3
1587,3,3,5543,5543,5546,0,3,2
1588,6,3,5549,5549,5552,0,3,3
1589,6,1,5555,5555,5556,0,1,3
1590,3,2,5558,5558,5560,0,2,2
1591,1,3,5559,5560,5563,1,4,0
1592,2,2,5561,5563,5565,2,4,0
1593,3,1,5564,5565,5566,1,2,0
1594,3,3,5567,5567,5570,0,3,1
1595,2,2,5569,5570,5572,1,3,0
1596,2,3,5571,5572,5575,1,4,0
1597,1,2,5572,5575,5577,3,5,0
1598,5,2,5577,5577,5579,0,2,0
1599,4,1,5581,5581,5582,0,1,2
1600,4,2,5585,5585,5587,0,2,3
1601,4,2,5589,5589,5591,0,2,2
1602,1,2,5590,5591,5593,1,3,0
1603,2,3,5592,5593,5596,1,4,0
1604,4,1,5596,5596,5597,0,1,0
1605,6,2,5602,5602,5604,0,2,5
1606,5,3,5607,5607,5610,0,3,3
1607,1,2,5608,5610,5612,2,4,0
1608,3,1,5611,5612,5613,1,2,0
1609,4,3,5615,5615,5618,0,3,2
1610,2,1,5617,5618,5619,1,2,0
1611,6,3,5623,5623,5626,0,3,4
1612,3,3,5626,5626,5629,0,3,0
1613,6,1,5632,5632,5633,0,1,3
1614,1,3,5633,5633,5636,0,3,0
1615,5,1,5638,5638,5639,0,1,2
1616,4,1,5642,5642,5643,0,1,3
1617,4,2,5646,5646,5648,0,2,3
1618,3,3,5649,5649,5652,0,3,1
1619,3,2,5652,5652,5654,0,2,0
1620,3,3,5655,5655,5658,0,3,1
1621,2,1,5657,5658,5659,1,2,0
1622,2,3,5659,5659,5662,0,3,0
1623,4,3,5663,5663,5666,0,3,1
1624,6,1,5669,5669,5670,0,1,3
1625,6,3,5675,5675,5678,0,3,5
1626,4,2,5679,5679,5681,0,2,1
1627,6,2,5685,5685,5687,0,2,4
1628,3,1,5688,5688,5689,0,1,1
1629,3,1,5691,5691,5692,0,1,2
1630,3,2,5694,5694,5696,0,2,2
1631,2,1,5696,5696,5697,0,1,0
1632,4,2,5700,5700,5702,0,2,3
1633,2,1,5702,5702,5703,0,1,0
1634,3,1,5705,5705,5706,0,1,2
1635,2,2,5707,5707,5709,0,2,1
1636,4,3,5711,5711,5714,0,3,2
1637,4,2,5715,5715,5717,0,2,1
1638,2,3,5717,5717,5720,0,3,0
1639,4,3,5721,5721,5724,0,3,1
1640,4,1,5725,5725,5726,0,1,1
1641,1,3,5726,5726,5729,0,3,0
1642,1,3,5727,5729,5732,2,5,0
1643,3,1,5730,5732,5733,2,3,0
1644,6,3,5736,5736,5739,0,3,3
1645,3,1,5739,5739,5740,0,1,0
1646,3,2,5742,5742,5744,0,2,2
1647,1,1,5743,5744,5745,1,2,0
1648,1,2,5744,5745,5747,1,3,0
1649,2,3,5746,5747,5750,1,4,0
1650,2,2,5748,5750,5752,2,4,0
1651,4,2,5752,5752,5754,0,2,0
1652,5,2,5757,5757,5759,0,2,3
1653,1,1,5758,5759,5760,1,2,0
1654,1,3,5759,5760,5763,1,4,0
1655,5,1,5764,5764,5765,0,1,1
1656,5,3,5769,5769,5772,0,3,4
1657,6,3,5775,5775,5778,0,3,3
1658,4,2,5779,5779,5781,0,2,1
1659,6,1,5785,5785,5786,0,1,4
1660,3,2,5788,5788,5790,0,2,2
1661,3,2,5791,5791,5793,0,2,1
1662,3,1,5794,5794,5795,0,1,1
1663,6,2,5800,5800,5802,0,2,5
1664,4,1,5804,5804,5805,0,1,2
1665,5,3,5809,5809,5812,0,3,4
1666,3,3,5812,5812,5815,0,3,0
1667,6,1,5818,5818,5819,0,1,3
1668,2,1,5820,5820,5821,0,1,1
1669,4,2,5824,5824,5826,0,2,3
1670,3,3,5827,5827,5830,0,3,1
1671,4,3,5831,5831,5834,0,3,1
1672,4,2,5835,5835,5837,0,2,1
1673,1,3,5836,5837,5840,1,4,0
1674,6,1,5842,5842,5843,0,1,2
1675,1,1,5843,5843,5844,0,1,0
1676,5,3,5848,5848,5851,0,3,4
1677,1,2,5849,5851,5853,2,4,0
1678,2,1,5851,5853,5854,2,3,0
1679,4,3,5855,5855,5858,0,3,1
1680,3,1,5858,5858,5859,0,1,0
1681,2,2,5860,5860,5862,0,2,1
1682,1,2,5861,5862,5864,1,3,0
1683,3,3,5864,5864,5867,0,3,0
1684,3,2,5867,5867,5869,0,2,0
1685,6,3,5873,5873,5876,0,3,4
1686,6,3,5879,5879,5882,0,3,3
1687,5,2,5884,5884,5886,0,2,2
1688,3,2,5887,5887,5889,0,2,1
1689,5,3,5892,5892,5895,0,3,3
1690,5,3,5897,5897,5900,0,3,2
1691,3,3,5900,5900,5903,0,3,0
1692,1,2,5901,5903,5905,2,4,0
1693,6,3,5907,5907,5910,0,3,2
1694,2,1,5909,5910,5911,1,2,0
1695,2,3,5911,5911,5914,0,3,0
1696,4,3,5915,5915,5918,0,3,1
1697,3,2,5918,5918,5920,0,2,0
1698,3,3,5921,5921,5924,0,3,1
1699,3,3,5924,5924,5927,0,3,0
1700,6,3,5930,5930,5933,0,3,3
1701,2,2,5932,5933,5935,1,3,0
1702,4,2,5936,5936,5938,0,2,1
1703,2,1,5938,5938,5939,0,1,0
1704,5,1,5943,5943,5944,0,1,4
1705,5,1,5948,5948,5949,0,1,4
1706,3,2,5951,5951,5953,0,2,2
1707,1,3,5952,5953,5956,1,4,0
1708,4,3,5956,5956,5959,0,3,0
1709,2,2,5958,5959,5961,1,3,0
1710,3,3,5961,5961,5964,0,3,0
1711,4,1,5965,5965,5966,0,1,1
1712,5,1,5970,5970,5971,0,1,4
1713,1,1,5971,5971,5972,0,1,0
1714,2,2,5973,5973,5975,0,2,1
1715,4,2,5977,5977,5979,0,2,2
1716,5,3,5982,5982,5985,0,3,3
1717,4,2,5986,5986,5988,0,2,1
1718,3,3,5989,5989,5992,0,3,1
1719,5,3,5994,5994,5997,0,3,2
1720,6,1,6000,6000,6001,0,1,3
1721,5,3,6005,6005,6008,0,3,4
1722,4,2,6009,6009,6011,0,2,1
1723,3,1,6012,6012,6013,0,1,1
1724,5,3,6017,6017,6020,0,3,4
1725,6,1,6023,6023,6024,0,1,3
1726,5,3,6028,6028,6031,0,3,4
1727,3,2,6031,6031,6033,0,2,0
1728,6,1,6037,6037,6038,0,1,4
1729,2,3,6039,6039,6042,0,3,1
1730,4,1,6043,6043,6044,0,1,1
1731,5,2,6048,6048,6050,0,2,4
1732,2,2,6050,6050,6052,0,2,0
1733,4,3,6054,6054,6057,0,3,2
1734,1,2,6055,6057,6059,2,4,0
1735,4,1,6059,6059,6060,0,1,0
1736,6,1,6065,6065,6066,0,1,5
1737,1,1,6066,6066,6067,0,1,0
1738,6,2,6072,6072,6074,0,2,5
1739,1,3,6073,6074,6077,1,4,0
1740,1,3,6074,6077,6080,3,6,0
1741,4,3,6078,6080,6083,2,5,0
1742,6,3,6084,6084,6087,0,3,1
1743,6,3,6090,6090,6093,0,3,3
1744,1,1,6091,6093,6094,2,3,0
1745,4,1,6095,6095,6096,0,1,1
1746,3,3,6098,6098,6101,0,3,2
1747,4,2,6102,6102,6104,0,2,1
1748,2,1,6104,6104,6105,0,1,0
1749,2,1,6106,6106,6107,0,1,1
1750,2,1,6108,6108,6109,0,1,1
1751,1,1,6109,6109,6110,0,1,0
1752,4,1,6113,6113,6114,0,1,3
1753,4,3,6117,6117,6120,0,3,3
1754,6,2,6123,6123,6125,0,2,3
1755,6,3,6129,6129,6132,0,3,4
1756,1,3,6130,6132,6135,2,5,0
1757,3,2,6133,6135,6137,2,4,0
1758,2,2,6135,6137,6139,2,4,0
1759,5,3,6140,6140,6143,0,3,1
1760,1,1,6141,6143,6144,2,3,0
1761,5,2,6146,6146,6148,0,2,2
1762,3,1,6149,6149,6150,0,1,1
1763,5,2,6154,6154,6156,0,2,4
1764,1,3,6155,6156,6159,1,4,0
1765,2,3,6157,6159,6162,2,5,0
1766,4,1,6161,6162,6163,1,2,0
1767,2,1,6163,6163,6164,0,1,0
1768,5,3,6168,6168,6171,0,3,4
1769,3,2,6171,6171,6173,0,2,0
1770,4,3,6175,6175,6178,0,3,2
1771,5,3,6180,6180,6183,0,3,2
1772,2,3,6182,6183,6186,1,4,0
1773,6,2,6188,6188,6190,0,2,2
1774,2,1,6190,6190,6191,0,1,0
1775,6,1,6196,6196,6197,0,1,5
1776,3,3,6199,6199,6202,0,3,2
1777,3,2,6202,6202,6204,0,2,0
1778,3,2,6205,6205,6207,0,2,1
1779,6,3,6211,6211,6214,0,3,4
1780,1,3,6212,6214,6217,2,5,0
1781,6,2,6218,6218,6220,0,2,1
1782,3,2,6221,6221,6223,0,2,1
1783,5,1,6226,6226,6227,0,1,3
1784,6,2,6232,6232,6234,0,2,5
1785,1,3,6233,6234,6237,1,4,0
1786,3,2,6236,6237,6239,1,3,0
1787,3,2,6239,6239,6241,0,2,0
1788,4,3,6243,6243,6246,0,3,2
1789,2,1,6245,6246,6247,1,2,0
1790,5,2,6250,6250,6252,0,2,3
1791,5,1,6255,6255,6256,0,1,3
1792,4,1,6259,6259,6260,0,1,3
1793,6,2,6265,6265,6267,0,2,5
1794,5,2,6270,6270,6272,0,2,3
1795,1,2,6271,6272,6274,1,3,0
1796,5,1,6276,6276,6277,0,1,2
1797,4,2,6280,6280,6282,0,2,3
1798,5,2,6285,6285,6287,0,2,3
1799,5,2,6290,6290,6292,0,2,3
1800,3,3,6293,6293,6296,0,3,1
1801,5,2,6298,6298,6300,0,2,2
1802,3,2,6301,6301,6303,0,2,1
1803,5,2,6306,6306,6308,0,2,3
1804,6,2,6312,6312,6314,0,2,4
1805,4,1,6316,6316,6317,0,1,2
1806,2,1,6318,6318,6319,0,1,1
1807,4,1,6322,6322,6323,0,1,3
1808,2,3,6324,6324,6327,0,3,1
1809,6,2,6330,6330,6332,0,2,3
1810,1,3,6331,6332,6335,1,4,0
1811,4,2,6335,6335,6337,0,2,0
1812,4,3,6339,6339,6342,0,3,2
1813,5,3,6344,6344,6347,0,3,2
1814,3,2,6347,6347,6349,0,2,0
1815,3,1,6350,6350,6351,0,1,1
1816,6,2,6356,6356,6358,0,2,5
1817,5,2,6361,6361,6363,0,2,3
1818,6,3,6367,6367,6370,0,3,4
1819,1,2,6368,6370,6372,2,4,0
1820,4,3,6372,6372,6375,0,3,0
1821,2,1,6374,6375,6376,1,2,0
1822,6,2,6380,6380,6382,0,2,4
1823,2,1,6382,6382,6383,0,1,0
1824,3,3,6385,6385,6388,0,3,2
1825,3,2,6388,6388,6390,0,2,0
1826,1,1,6389,6390,6391,1,2,0
1827,6,1,6395,6395,6396,0,1,4
1828,5,2,6400,6400,6402,0,2,4
1829,5,1,6405,6405,6406,0,1,3
1830,2,2,6407,6407,6409,0,2,1
1831,2,3,6409,6409,6412,0,3,0
1832,5,3,6414,6414,6417,0,3,2
1833,6,2,6420,6420,6422,0,2,3
1834,3,1,6423,6423,6424,0,1,1
1835,1,3,6424,6424,6427,0,3,0
1836,1,3,6425,6427,6430,2,5,0
1837,6,2,6431,6431,6433,0,2,1
1838,2,3,6433,6433,6436,0,3,0
1839,5,1,6438,6438,6439,0,1,2
1840,6,3,6444,6444,6447,0,3,5
1841,6,1,6450,6450,6451,0,1,3
1842,6,3,6456,6456,6459,0,3,5
1843,6,2,6462,6462,6464,0,2,3
1844,6,3,6468,6468,6471,0,3,4
1845,5,1,6473,6473,6474,0,1,2
1846,5,1,6478,6478,6479,0,1,4
1847,1,1,6479,6479,6480,0,1,0
1848,1,3,6480,6480,6483,0,3,0
1849,5,2,6485,6485,6487,0,2,2
1850,3,3,6488,6488,6491,0,3,1
1851,1,3,6489,6491,6494,2,5,0
1852,3,3,6492,6494,6497,2,5,0
1853,5,2,6497,6497,6499,0,2,0
1854,1,2,6498,6499,6501,1,3,0
1855,4,3,6502,6502,6505,0,3,1
1856,1,2,6503,6505,6507,2,4,0
1857,6,3,6509,6509,6512,0,3,2
1858,5,1,6514,6514,6515,0,1,2
1859,4,3,6518,6518,6521,0,3,3
1860,1,1,6519,6521,6522,2,3,0
1861,6,2,6525,6525,6527,0,2,3
1862,1,2,6526,6527,6529,1,3,0
1863,6,3,6532,6532,6535,0,3,3
1864,2,3,6534,6535,6538,1,4,0
1865,5,1,6539,6539,6540,0,1,1
1866,2,3,6541,6541,6544,0,3,1
1867,4,3,6545,6545,6548,0,3,1
1868,3,1,6548,6548,6549,0,1,0
1869,4,3,6552,6552,6555,0,3,3
1870,3,3,6555,6555,6558,0,3,0
1871,2,2,6557,6558,6560,1,3,0
1872,6,1,6563,6563,6564,0,1,3
1873,2,1,6565,6565,6566,0,1,1
1874,2,1,6567,6567,6568,0,1,1
1875,5,2,6572,6572,6574,0,2,4
1876,1,1,6573,6574,6575,1,2,0
1877,4,2,6577,6577,6579,0,2,2
1878,2,2,6579,6579,6581,0,2,0
1879,2,3,6581,6581,6584,0,3,0
1880,4,3,6585,6585,6588,0,3,1
1881,3,3,6588,6588,6591,0,3,0
1882,2,3,6590,6591,6594,1,4,0
1883,6,1,6596,6596,6597,0,1,2
1884,5,3,6601,6601,6604,0,3,4
1885,6,3,6607,6607,6610,0,3,3
1886,5,3,6612,6612,6615,0,3,2
1887,3,1,6615,6615,6616,0,1,0
1888,5,3,6620,6620,6623,0,3,4
1889,5,1,6625,6625,6626,0,1,2
1890,3,3,6628,6628,6631,0,3,2
1891,2,2,6630,6631,6633,1,3,0
1892,4,1,6634,6634,6635,0,1,1
1893,5,3,6639,6639,6642,0,3,4
1894,3,1,6642,6642,6643,0,1,0
1895,5,2,6647,6647,6649,0,2,4
1896,2,1,6649,6649,6650,0,1,0
1897,5,1,6654,6654,6655,0,1,4
1898,6,2,6660,6660,6662,0,2,5
1899,3,2,6663,6663,6665,0,2,1
1900,4,2,6667,6667,6669,0,2,2
1901,5,2,6672,6672,6674,0,2,3
1902,2,2,6674,6674,6676,0,2,0
1903,2,3,6676,6676,6679,0,3,0
1904,2,3,6678,6679,6682,1,4,0
1905,1,3,6679,6682,6685,3,6,0
1906,5,1,6684,6685,6686,1,2,0
1907,4,2,6688,6688,6690,0,2,2
1908,2,1,6690,6690,6691,0,1,0
1909,1,1,6691,6691,6692,0,1,0
1910,4,1,6695,6695,6696,0,1,3
1911,4,1,6699,6699,6700,0,1,3
1912,1,3,6700,6700,6703,0,3,0
1913,4,2,6704,6704,6706,0,2,1
1914,3,3,6707,6707,6710,0,3,1
1915,2,1,6709,6710,6711,1,2,0
1916,5,1,6714,6714,6715,0,1,3
1917,6,3,6720,6720,6723,0,3,5
1918,5,3,6725,6725,6728,0,3,2
1919,2,1,6727,6728,6729,1,2,0
1920,3,1,6730,6730,6731,0,1,1
1921,1,2,6731,6731,6733,0,2,0
1922,2,2,6733,6733,6735,0,2,0
1923,4,2,6737,6737,6739,0,2,2
1924,5,3,6742,6742,6745,0,3,3
1925,2,2,6744,6745,6747,1,3,0
1926,2,1,6746,6747,6748,1,2,0
1927,1,2,6747,6748,6750,1,3,0
1928,1,1,6748,6750,6751,2,3,0
1929,1,3,6749,6751,6754,2,5,0
1930,1,1,6750,6754,6755,4,5,0
1931,6,3,6756,6756,6759,0,3,1
1932,6,1,6762,6762,6763,0,1,3
1933,4,1,6766,6766,6767,0,1,3
1934,5,2,6771,6771,6773,0,2,4
1935,6,1,6777,6777,6778,0,1,4
1936,1,1,6778,6778,6779,0,1,0
1937,2,1,6780,6780,6781,0,1,1
1938,1,3,6781,6781,6784,0,3,0
1939,3,3,6784,6784,6787,0,3,0
1940,6,1,6790,6790,6791,0,1,3
1941,1,3,6791,6791,6794,0,3,0
1942,6,3,6797,6797,6800,0,3,3
1943,6,3,6803,6803,6806,0,3,3
1944,1,1,6804,6806,6807,2,3,0
1945,6,2,6810,6810,6812,0,2,3
1946,3,1,6813,6813,6814,0,1,1
1947,6,1,6819,6819,6820,0,1,5
1948,1,1,6820,6820,6821,0,1,0
1949,1,3,6821,6821,6824,0,3,0
1950,2,3,6823,6824,6827,1,4,0
1951,4,2,6827,6827,6829,0,2,0
1952,6,1,6833,6833,6834,0,1,4
1953,3,1,6836,6836,6837,0,1,2
1954,3,1,6839,6839,6840,0,1,2
1955,1,1,6840,6840,6841,0,1,0
1956,6,1,6846,6846,6847,0,1,5
1957,2,2,6848,6848,6850,0,2,1
1958,2,1,6850,6850,6851,0,1,0
1959,1,1,6851,6851,6852,0,1,0
1960,2,3,6853,6853,6856,0,3,1
1961,4,1,6857,6857,6858,0,1,1
1962,3,2,6860,6860,6862,0,2,2
1963,6,3,6866,6866,6869,0,3,4
1964,1,3,6867,6869,6872,2,5,0
1965,2,2,6869,6872,6874,3,5,0
1966,4,2,6873,6874,6876,1,3,0
1967,1,1,6874,6876,6877,2,3,0
1968,3,2,6877,6877,6879,0,2,0
1969,6,1,6883,6883,6884,0,1,4
1970,5,3,6888,6888,6891,0,3,4
1971,6,1,6894,6894,6895,0,1,3
1972,3,2,6897,6897,6899,0,2,2
1973,3,1,6900,6900,6901,0,1,1
1974,6,3,6906,6906,6909,0,3,5
1975,3,1,6909,6909,6910,0,1,0
1976,3,2,6912,6912,6914,0,2,2
1977,6,3,6918,6918,6921,0,3,4
1978,5,1,6923,6923,6924,0,1,2
1979,2,2,6925,6925,6927,0,2,1
1980,3,2,6928,6928,6930,0,2,1
1981,5,2,6933,6933,6935,0,2,3
1982,3,1,6936,6936,6937,0,1,1
1983,1,3,6937,6937,6940,0,3,0
1984,6,1,6943,6943,6944,0,1,3
1985,5,1,6948,6948,6949,0,1,4
1986,4,1,6952,6952,6953,0,1,3
1987,2,2,6954,6954,6956,0,2,1
1988,3,3,6957,6957,6960,0,3,1
1989,2,3,6959,6960,6963,1,4,0
1990,6,3,6965,6965,6968,0,3,2
1991,5,2,6970,6970,6972,0,2,2
1992,1,3,6971,6972,6975,1,4,0
1993,2,2,6973,6975,6977,2,4,0
1994,6,1,6979,6979,6980,0,1,2
1995,5,3,6984,6984,6987,0,3,4
1996,1,1,6985,6987,6988,2,3,0
1997,3,3,6988,6988,6991,0,3,0
1998,2,3,6990,6991,6994,1,4,0
1999,3,1,6993,6994,6995,1,2,0
2000,4,1,6997,6997,6998,0,1,2
2001,3,1,7000,7000,7001,0,1,2
2002,6,3,7006,7006,7009,0,3,5
2003,2,3,7008,7009,7012,1,4,0
2004,2,2,7010,7012,7014,2,4,0
2005,6,2,7016,7016,7018,0,2,2
2006,6,3,7022,7022,7025,0,3,4
2007,1,2,7023,7025,7027,2,4,0
2008,5,3,7028,7028,7031,0,3,1
2009,2,1,7030,7031,7032,1,2,0
2010,6,2,7036,7036,7038,0,2,4
2011,2,3,7038,7038,7041,0,3,0
2012,6,3,7044,7044,7047,0,3,3
2013,2,3,7046,7047,7050,1,4,0
2014,3,3,7049,7050,7053,1,4,0
2015,2,3,7051,7053,7056,2,5,0
2016,4,3,7055,7056,7059,1,4,0
2017,1,3,7056,7059,7062,3,6,0
2018,3,2,7059,7062,7064,3,5,0
2019,2,1,7061,7064,7065,3,4,0
2020,4,3,7065,7065,7068,0,3,0
2021,4,1,7069,7069,7070,0,1,1
2022,6,2,7075,7075,7077,0,2,5
2023,3,2,7078,7078,7080,0,2,1
2024,2,1,7080,7080,7081,0,1,0
2025,5,3,7085,7085,7088,0,3,4
2026,5,2,7090,7090,7092,0,2,2
2027,6,3,7096,7096,7099,0,3,4
2028,4,1,7100,7100,7101,0,1,1
2029,2,1,7102,7102,7103,0,1,1
2030,3,1,7105,7105,7106,0,1,2
2031,6,3,7111,7111,7114,0,3,5
2032,4,1,7115,7115,7116,0,1,1
2033,4,1,7119,7119,7120,0,1,3
2034,1,2,7120,7120,7122,0,2,0
2035,1,3,7121,7122,7125,1,4,0
2036,4,2,7125,7125,7127,0,2,0
2037,1,2,7126,7127,7129,1,3,0
2038,2,2,7128,7129,7131,1,3,0
2039,6,2,7134,7134,7136,0,2,3
2040,5,1,7139,7139,7140,0,1,3
2041,3,3,7142,7142,7145,0,3,2
2042,3,3,7145,7145,7148,0,3,0
2043,6,3,7151,7151,7154,0,3,3
2044,5,3,7156,7156,7159,0,3,2
2045,2,1,7158,7159,7160,1,2,0
2046,5,2,7163,7163,7165,0,2,3
2047,6,3,7169,7169,7172,0,3,4
2048,1,1,7170,7172,7173,2,3,0
2049,5,2,7175,7175,7177,0,2,2
2050,1,2,7176,7177,7179,1,3,0
2051,5,3,7181,7181,7184,0,3,2
2052,2,3,7183,7184,7187,1,4,0
2053,6,2,7189,7189,7191,0,2,2
2054,4,1,7193,7193,7194,0,1,2
2055,5,3,7198,7198,7201,0,3,4
2056,6,3,7204,7204,7207,0,3,3
2057,3,2,7207,7207,7209,0,2,0
2058,1,1,7208,7209,7210,1,2,0
2059,6,3,7214,7214,7217,0,3,4
2060,1,3,7215,7217,7220,2,5,0
2061,6,1,7221,7221,7222,0,1,1
2062,4,3,7225,7225,7228,0,3,3
2063,6,2,7231,7231,7233,0,2,3
2064,6,1,7237,7237,7238,0,1,4
2065,4,1,7241,7241,7242,0,1,3
2066,1,3,7242,7242,7245,0,3,0
2067,4,1,7246,7246,7247,0,1,1
2068,6,1,7252,7252,7253,0,1,5
2069,6,3,7258,7258,7261,0,3,5
2070,6,1,7264,7264,7265,0,1,3
2071,2,1,7266,7266,7267,0,1,1
2072,1,3,7267,7267,7270,0,3,0
2073,1,3,7268,7270,7273,2,5,0
2074,4,1,7272,7273,7274,1,2,0
2075,4,1,7276,7276,7277,0,1,2
2076,5,2,7281,7281,7283,0,2,4
2077,2,2,7283,7283,7285,0,2,0
2078,2,3,7285,7285,7288,0,3,0
2079,5,3,7290,7290,7293,0,3,2
2080,1,3,7291,7293,7296,2,5,0
2081,4,2,7295,7296,7298,1,3,0
2082,1,2,7296,7298,7300,2,4,0
2083,3,2,7299,7300,7302,1,3,0
2084,2,3,7301,7302,7305,1,4,0
2085,4,1,7305,7305,7306,0,1,0
2086,6,2,7311,7311,7313,0,2,5
2087,6,1,7317,7317,7318,0,1,4
2088,4,1,7321,7321,7322,0,1,3
2089,1,1,7322,7322,7323,0,1,0
2090,1,3,7323,7323,7326,0,3,0
2091,4,2,7327,7327,7329,0,2,1
2092,6,1,7333,7333,7334,0,1,4
2093,4,3,7337,7337,7340,0,3,3
2094,2,2,7339,7340,7342,1,3,0
2095,5,1,7344,7344,7345,0,1,2
2096,1,3,7345,7345,7348,0,3,0
2097,4,2,7349,7349,7351,0,2,1
2098,1,2,7350,7351,7353,1,3,0
2099,1,1,7351,7353,7354,2,3,0
2100,5,2,7356,7356,7358,0,2,2
2101,5,3,7361,7361,7364,0,3,3
2102,3,1,7364,7364,7365,0,1,0
2103,6,1,7370,7370,7371,0,1,5
2104,6,2,7376,7376,7378,0,2,5
2105,5,2,7381,7381,7383,0,2,3
2106,6,3,7387,7387,7390,0,3,4
2107,3,3,7390,7390,7393,0,3,0
2108,1,1,7391,7393,7394,2,3,0
2109,3,1,7394,7394,7395,0,1,0
2110,1,3,7395,7395,7398,0,3,0
2111,6,3,7401,7401,7404,0,3,3
2112,3,3,7404,7404,7407,0,3,0
2113,2,3,7406,7407,7410,1,4,0
2114,1,3,7407,7410,7413,3,6,0
2115,2,2,7409,7413,7415,4,6,0
2116,3,2,7412,7415,7417,3,5,0
2117,1,1,7413,7417,7418,4,5,0
2118,1,2,7414,7418,7420,4,6,0
2119,3,3,7417,7420,7423,3,6,0
2120,3,1,7420,7423,7424,3,4,0
2121,5,2,7425,7425,7427,0,2,1
2122,6,2,7431,7431,7433,0,2,4
2123,4,3,7435,7435,7438,0,3,2
2124,2,3,7437,7438,7441,1,4,0
2125,4,1,7441,7441,7442,0,1,0
2126,4,2,7445,7445,7447,0,2,3
2127,5,1,7450,7450,7451,0,1,3
2128,4,1,7454,7454,7455,0,1,3
2129,6,2,7460,7460,7462,0,2,5
2130,1,3,7461,7462,7465,1,4,0
2131,3,2,7464,7465,7467,1,3,0
2132,6,3,7470,7470,7473,0,3,3
2133,4,1,7474,7474,7475,0,1,1
2134,6,2,7480,7480,7482,0,2,5
2135,4,3,7484,7484,7487,0,3,2
2136,3,2,7487,7487,7489,0,2,0
2137,2,2,7489,7489,7491,0,2,0
2138,1,2,7490,7491,7493,1,3,0
2139,6,1,7496,7496,7497,0,1,3
2140,5,3,7501,7501,7504,0,3,4
2141,1,1,7502,7504,7505,2,3,0
2142,2,1,7504,7505,7506,1,2,0
2143,4,2,7508,7508,7510,0,2,2
2144,6,2,7514,7514,7516,0,2,4
2145,3,3,7517,7517,7520,0,3,1
2146,1,3,7518,7520,7523,2,5,0
2147,6,1,7524,7524,7525,0,1,1
2148,2,2,7526,7526,7528,0,2,1
2149,1,2,7527,7528,7530,1,3,0
2150,4,1,7531,7531,7532,0,1,1
2151,2,1,7533,7533,7534,0,1,1
2152,3,3,7536,7536,7539,0,3,2
2153,3,3,7539,7539,7542,0,3,0
2154,4,3,7543,7543,7546,0,3,1
2155,3,1,7546,7546,7547,0,1,0
2156,6,1,7552,7552,7553,0,1,5
2157,6,2,7558,7558,7560,0,2,5
2158,4,1,7562,7562,7563,0,1,2
2159,5,3,7567,7567,7570,0,3,4
2160,6,1,7573,7573,7574,0,1,3
2161,1,3,7574,7574,7577,0,3,0
2162,4,3,7578,7578,7581,0,3,1
2163,1,3,7579,7581,7584,2,5,0
2164,3,3,7582,7584,7587,2,5,0
2165,6,2,7588,7588,7590,0,2,1
2166,2,2,7590,7590,7592,0,2,0
2167,6,2,7596,7596,7598,0,2,4
2168,5,3,7601,7601,7604,0,3,3
2169,1,3,7602,7604,7607,2,5,0
2170,2,1,7604,7607,7608,3,4,0
2171,4,1,7608,7608,7609,0,1,0
2172,1,2,7609,7609,7611,0,2,0
2173,6,3,7615,7615,7618,0,3,4
2174,3,2,7618,7618,7620,0,2,0
2175,5,3,7623,7623,7626,0,3,3
2176,5,3,7628,7628,7631,0,3,2
2177,2,3,7630,7631,7634,1,4,0
2178,5,2,7635,7635,7637,0,2,1
2179,1,3,7636,7637,7640,1,4,0
2180,1,3,7637,7640,7643,3,6,0
2181,3,2,7640,7643,7645,3,5,0
2182,4,1,7644,7645,7646,1,2,0
2183,1,3,7645,7646,7649,1,4,0
2184,4,2,7649,7649,7651,0,2,0
2185,3,3,7652,7652,7655,0,3,1
2186,3,3,7655,7655,7658,0,3,0
2187,2,3,7657,7658,7661,1,4,0
2188,2,2,7659,7661,7663,2,4,0
2189,6,2,7665,7665,7667,0,2,2
2190,2,3,7667,7667,7670,0,3,0
2191,6,1,7673,7673,7674,0,1,3
2192,5,2,7678,7678,7680,0,2,4
2193,5,2,7683,7683,7685,0,2,3
2194,4,1,7687,7687,7688,0,1,2
2195,1,3,7688,7688,7691,0,3,0
2196,6,3,7694,7694,7697,0,3,3
2197,4,2,7698,7698,7700,0,2,1
2198,2,2,7700,7700,7702,0,2,0
2199,1,1,7701,7702,7703,1,2,0
2200,5,3,7706,7706,7709,0,3,3
2201,2,2,7708,7709,7711,1,3,0
2202,5,3,7713,7713,7716,0,3,2
2203,1,2,7714,7716,7718,2,4,0
2204,5,3,7719,7719,7722,0,3,1
2205,3,3,7722,7722,7725,0,3,0
2206,4,1,7726,7726,7727,0,1,1
2207,3,1,7729,7729,7730,0,1,2
2208,3,3,7732,7732,7735,0,3,2
2209,6,2,7738,7738,7740,0,2,3
2210,5,2,7743,7743,7745,0,2,3
2211,5,2,7748,7748,7750,0,2,3
2212,4,1,7752,7752,7753,0,1,2
2213,1,3,7753,7753,7756,0,3,0
2214,4,3,7757,7757,7760,0,3,1
2215,1,1,7758,7760,7761,2,3,0
2216,2,3,7760,7761,7764,1,4,0
2217,4,2,7764,7764,7766,0,2,0
2218,5,2,7769,7769,7771,0,2,3
2219,1,2,7770,7771,7773,1,3,0
2220,5,2,7775,7775,7777,0,2,2
2221,6,1,7781,7781,7782,0,1,4
2222,1,2,7782,7782,7784,0,2,0
2223,2,2,7784,7784,7786,0,2,0
2224,4,1,7788,7788,7789,0,1,2
2225,4,2,7792,7792,7794,0,2,3
2226,4,1,7796,7796,7797,0,1,2
2227,1,2,7797,7797,7799,0,2,0
2228,3,2,7800,7800,7802,0,2,1
2229,3,1,7803,7803,7804,0,1,1
2230,2,3,7805,7805,7808,0,3,1
2231,6,2,7811,7811,7813,0,2,3
2232,1,1,7812,7813,7814,1,2,0
2233,1,3,7813,7814,7817,1,4,0
2234,4,1,7817,7817,7818,0,1,0
2235,5,3,7822,7822,7825,0,3,4
2236,3,2,7825,7825,7827,0,2,0
2237,5,3,7830,7830,7833,0,3,3
2238,4,1,7834,7834,7835,0,1,1
2239,3,3,7837,7837,7840,0,3,2
2240,5,3,7842,7842,7845,0,3,2
2241,5,2,7847,7847,7849,0,2,2
2242,3,1,7850,7850,7851,0,1,1
2243,4,2,7854,7854,7856,0,2,3
2244,1,3,7855,7856,7859,1,4,0
2245,4,1,7859,7859,7860,0,1,0
2246,6,1,7865,7865,7866,0,1,5
2247,3,2,7868,7868,7870,0,2,2
2248,3,1,7871,7871,7872,0,1,1
2249,1,2,7872,7872,7874,0,2,0
2250,6,1,7878,7878,7879,0,1,4
2251,2,3,7880,7880,7883,0,3,1
2252,3,3,7883,7883,7886,0,3,0
2253,3,2,7886,7886,7888,0,2,0
2254,3,2,7889,7889,7891,0,2,1
2255,3,2,7892,7892,7894,0,2,1
2256,4,2,7896,7896,7898,0,2,2
2257,2,3,7898,7898,7901,0,3,0
2258,4,2,7902,7902,7904,0,2,1
2259,5,1,7907,7907,7908,0,1,3
2260,1,2,7908,7908,7910,0,2,0
2261,5,2,7913,7913,7915,0,2,3
2262,3,1,7916,7916,7917,0,1,1
2263,6,3,7922,7922,7925,0,3,5
2264,2,3,7924,7925,7928,1,4,0
2265,6,1,7930,7930,7931,0,1,2
2266,6,1,7936,7936,7937,0,1,5
2267,2,2,7938,7938,7940,0,2,1
2268,2,2,7940,7940,7942,0,2,0
2269,2,3,7942,7942,7945,0,3,0
2270,1,3,7943,7945,7948,2,5,0
2271,2,3,7945,7948,7951,3,6,0
2272,4,3,7949,7951,7954,2,5,0
2273,5,2,7954,7954,7956,0,2,0
2274,3,1,7957,7957,7958,0,1,1
2275,2,1,7959,7959,7960,0,1,1
2276,5,2,7964,7964,7966,0,2,4
2277,6,3,7970,7970,7973,0,3,4
2278,1,2,7971,7973,7975,2,4,0
2279,6,1,7977,7977,7978,0,1,2
2280,3,3,7980,7980,7983,0,3,2
2281,3,1,7983,7983,7984,0,1,0
2282,4,1,7987,7987,7988,0,1,3
2283,6,1,7993,7993,7994,0,1,5
2284,6,2,7999,7999,8001,0,2,5
2285,3,2,8002,8002,8004,0,2,1
2286,4,3,8006,8006,8009,0,3,2
2287,6,3,8012,8012,8015,0,3,3
2288,2,1,8014,8015,8016,1,2,0
2289,5,3,8019,8019,8022,0,3,3
2290,1,1,8020,8022,8023,2,3,0
2291,4,3,8024,8024,8027,0,3,1
2292,2,2,8026,8027,8029,1,3,0
2293,4,1,8030,8030,8031,0,1,1
2294,4,3,8034,8034,8037,0,3,3
2295,6,3,8040,8040,8043,0,3,3
2296,5,2,8045,8045,8047,0,2,2
2297,3,2,8048,8048,8050,0,2,1
2298,4,2,8052,8052,8054,0,2,2
2299,6,1,8058,8058,8059,0,1,4
2300,2,1,8060,8060,8061,0,1,1
2301,2,1,8062,8062,8063,0,1,1
2302,6,2,8068,8068,8070,0,2,5
2303,3,1,8071,8071,8072,0,1,1
2304,5,1,8076,8076,8077,0,1,4
2305,1,2,8077,8077,8079,0,2,0
2306,4,2,8081,8081,8083,0,2,2
2307,1,3,8082,8083,8086,1,4,0
2308,4,2,8086,8086,8088,0,2,0
2309,3,3,8089,8089,8092,0,3,1
2310,1,1,8090,8092,8093,2,3,0
2311,3,3,8093,8093,8096,0,3,0
2312,1,2,8094,8096,8098,2,4,0
2313,5,3,8099,8099,8102,0,3,1
2314,6,2,8105,8105,8107,0,2,3
2315,6,1,8111,8111,8112,0,1,4
2316,2,1,8113,8113,8114,0,1,1
2317,2,2,8115,8115,8117,0,2,1
2318,5,1,8120,8120,8121,0,1,3
2319,3,2,8123,8123,8125,0,2,2
2320,3,2,8126,8126,8128,0,2,1
2321,6,1,8132,8132,8133,0,1,4
2322,3,1,8135,8135,8136,0,1,2
2323,5,3,8140,8140,8143,0,3,4
2324,3,3,8143,8143,8146,0,3,0
2325,2,2,8145,8146,8148,1,3,0
2326,6,1,8151,8151,8152,0,1,3
2327,2,2,8153,8153,8155,0,2,1
2328,2,2,8155,8155,8157,0,2,0
2329,6,2,8161,8161,8163,0,2,4
2330,5,2,8166,8166,8168,0,2,3
2331,4,3,8170,8170,8173,0,3,2
2332,1,2,8171,8173,8175,2,4,0
2333,5,2,8176,8176,8178,0,2,1
2334,4,1,8180,8180,8181,0,1,2
2335,1,3,8181,8181,8184,0,3,0
2336,1,2,8182,8184,8186,2,4,0
2337,3,3,8185,8186,8189,1,4,0
2338,1,2,8186,8189,8191,3,5,0
2339,3,2,8189,8191,8193,2,4,0
2340,5,3,8194,8194,8197,0,3,1
2341,2,2,8196,8197,8199,1,3,0
2342,5,2,8201,8201,8203,0,2,2
2343,1,1,8202,8203,8204,1,2,0
2344,3,1,8205,8205,8206,0,1,1
2345,4,3,8209,8209,8212,0,3,3
2346,6,1,8215,8215,8216,0,1,3
2347,2,3,8217,8217,8220,0,3,1
2348,1,1,8218,8220,8221,2,3,0
2349,4,2,8222,8222,8224,0,2,1
2350,3,2,8225,8225,8227,0,2,1
2351,5,1,8230,8230,8231,0,1,3
2352,1,1,8231,8231,8232,0,1,0
2353,3,1,8234,8234,8235,0,1,2
2354,5,1,8239,8239,8240,0,1,4
2355,2,1,8241,8241,8242,0,1,1
2356,5,2,8246,8246,8248,0,2,4
2357,3,2,8249,8249,8251,0,2,1
2358,2,1,8251,8251,8252,0,1,0
2359,1,1,8252,8252,8253,0,1,0
2360,1,1,8253,8253,8254,0,1,0
2361,2,2,8255,8255,8257,0,2,1
2362,4,3,8259,8259,8262,0,3,2
2363,5,3,8264,8264,8267,0,3,2
2364,5,2,8269,8269,8271,0,2,2
2365,4,3,8273,8273,8276,0,3,2
2366,1,1,8274,8276,8277,2,3,0
2367,3,1,8277,8277,8278,0,1,0
2368,1,2,8278,8278,8280,0,2,0
2369,6,1,8284,8284,8285,0,1,4
2370,6,3,8290,8290,8293,0,3,5
2371,5,3,8295,8295,8298,0,3,2
2372,6,3,8301,8301,8304,0,3,3
2373,1,2,8302,8304,8306,2,4,0
2374,1,1,8303,8306,8307,3,4,0
2375,4,3,8307,8307,8310,0,3,0
2376,2,3,8309,8310,8313,1,4,0
2377,3,2,8312,8313,8315,1,3,0
2378,2,2,8314,8315,8317,1,3,0
2379,5,2,8319,8319,8321,0,2,2
2380,1,3,8320,8321,8324,1,4,0
2381,6,1,8326,8326,8327,0,1,2
2382,1,1,8327,8327,8328,0,1,0
2383,2,1,8329,8329,8330,0,1,1
2384,5,1,8334,8334,8335,0,1,4
2385,3,1,8337,8337,8338,0,1,2
2386,5,1,8342,8342,8343,0,1,4
2387,3,1,8345,8345,8346,0,1,2
2388,3,1,8348,8348,8349,0,1,2
2389,6,1,8354,8354,8355,0,1,5
2390,1,3,8355,8355,8358,0,3,0
2391,6,3,8361,8361,8364,0,3,3
2392,1,1,8362,8364,8365,2,3,0
2393,6,1,8368,8368,8369,0,1,3
2394,3,3,8371,8371,8374,0,3,2
2395,2,2,8373,8374,8376,1,3,0
2396,1,2,8374,8376,8378,2,4,0
2397,1,1,8375,8378,8379,3,4,0
2398,4,3,8379,8379,8382,0,3,0
2399,2,1,8381,8382,8383,1,2,0
2400,3,3,8384,8384,8387,0,3,1
2401,6,2,8390,8390,8392,0,2,3
2402,3,2,8393,8393,8395,0,2,1
2403,5,3,8398,8398,8401,0,3,3
2404,2,3,8400,8401,8404,1,4,0
2405,6,2,8406,8406,8408,0,2,2
2406,2,2,8408,8408,8410,0,2,0
2407,4,2,8412,8412,8414,0,2,2
2408,5,3,8417,8417,8420,0,3,3
2409,6,3,8423,8423,8426,0,3,3
2410,4,1,8427,8427,8428,0,1,1
2411,4,2,8431,8431,8433,0,2,3
2412,6,1,8437,8437,8438,0,1,4
2413,4,3,8441,8441,8444,0,3,3
2414,3,2,8444,8444,8446,0,2,0
2415,3,3,8447,8447,8450,0,3,1
2416,1,1,8448,8450,8451,2,3,0
2417,1,3,8449,8451,8454,2,5,0
2418,6,3,8455,8455,8458,0,3,1
2419,6,2,8461,8461,8463,0,2,3
2420,6,1,8467,8467,8468,0,1,4
2421,6,2,8473,8473,8475,0,2,5
2422,6,2,8479,8479,8481,0,2,4
2423,6,1,8485,8485,8486,0,1,4
2424,4,1,8489,8489,8490,0,1,3
2425,1,3,8490,8490,8493,0,3,0
2426,1,2,8491,8493,8495,2,4,0
2427,3,1,8494,8495,8496,1,2,0
2428,3,1,8497,8497,8498,0,1,1
2429,4,2,8501,8501,8503,0,2,3
2430,1,1,8502,8503,8504,1,2,0
2431,6,1,8508,8508,8509,0,1,4
2432,5,3,8513,8513,8516,0,3,4
2433,1,3,8514,8516,8519,2,5,0
2434,3,1,8517,8519,8520,2,3,0
2435,1,1,8518,8520,8521,2,3,0
2436,4,2,8522,8522,8524,0,2,1
2437,1,1,8523,8524,8525,1,2,0
2438,3,3,8526,8526,8529,0,3,1
2439,6,2,8532,8532,8534,0,2,3
2440,4,1,8536,8536,8537,0,1,2
2441,1,2,8537,8537,8539,0,2,0
2442,6,2,8543,8543,8545,0,2,4
2443,6,1,8549,8549,8550,0,1,4
2444,2,2,8551,8551,8553,0,2,1
2445,3,2,8554,8554,8556,0,2,1
2446,4,2,8558,8558,8560,0,2,2
2447,4,2,8562,8562,8564,0,2,2
2448,4,2,8566,8566,8568,0,2,2
2449,1,1,8567,8568,8569,1,2,0
2450,2,2,8569,8569,8571,0,2,0
2451,4,1,8573,8573,8574,0,1,2
2452,6,2,8579,8579,8581,0,2,5
2453,5,1,8584,8584,8585,0,1,3
2454,5,2,8589,8589,8591,0,2,4
2455,6,1,8595,8595,8596,0,1,4
2456,6,1,8601,8601,8602,0,1,5
2457,3,3,8604,8604,8607,0,3,2
2458,3,3,8607,8607,8610,0,3,0
2459,4,1,8611,8611,8612,0,1,1
2460,3,1,8614,8614,8615,0,1,2
2461,3,2,8617,8617,8619,0,2,2
2462,5,3,8622,8622,8625,0,3,3
2463,4,1,8626,8626,8627,0,1,1
2464,3,1,8629,8629,8630,0,1,2
2465,5,1,8634,8634,8635,0,1,4
2466,3,2,8637,8637,8639,0,2,2
2467,1,1,8638,8639,8640,1,2,0
2468,5,3,8643,8643,8646,0,3,3
2469,6,3,8649,8649,8652,0,3,3
2470,4,3,8653,8653,8656,0,3,1
2471,1,1,8654,8656,8657,2,3,0
2472,5,3,8659,8659,8662,0,3,2
2473,2,1,8661,8662,8663,1,2,0
2474,6,2,8667,8667,8669,0,2,4
2475,3,1,8670,8670,8671,0,1,1
2476,3,2,8673,8673,8675,0,2,2
2477,6,1,8679,8679,8680,0,1,4
2478,4,3,8683,8683,8686,0,3,3
2479,4,3,8687,8687,8690,0,3,1
2480,1,2,8688,8690,8692,2,4,0
2481,6,3,8694,8694,8697,0,3,2
2482,4,2,8698,8698,8700,0,2,1
2483,4,3,8702,8702,8705,0,3,2
2484,4,1,8706,8706,8707,0,1,1
2485,5,3,8711,8711,8714,0,3,4
2486,5,1,8716,8716,8717,0,1,2
2487,2,2,8718,8718,8720,0,2,1
2488,3,3,8721,8721,8724,0,3,1
2489,5,2,8726,8726,8728,0,2,2
2490,1,2,8727,8728,8730,1,3,0
2491,3,1,8730,8730,8731,0,1,0
2492,5,1,8735,8735,8736,0,1,4
2493,1,2,8736,8736,8738,0,2,0
2494,6,1,8742,8742,8743,0,1,4
2495,5,3,8747,8747,8750,0,3,4
2496,3,2,8750,8750,8752,0,2,0
2497,6,3,8756,8756,8759,0,3,4
2498,1,3,8757,8759,8762,2,5,0
2499,6,3,8763,8763,8766,0,3,1
2500,6,1,8769,8769,8770,0,1,3
2501,1,2,8770,8770,8772,0,2,0
2502,3,3,8773,8773,8776,0,3,1
2503,4,2,8777,8777,8779,0,2,1
2504,5,3,8782,8782,8785,0,3,3
2505,6,3,8788,8788,8791,0,3,3
2506,5,2,8793,8793,8795,0,2,2
2507,4,3,8797,8797,8800,0,3,2
2508,6,2,8803,8803,8805,0,2,3
2509,5,2,8808,8808,8810,0,2,3
2510,1,1,8809,8810,8811,1,2,0
2511,1,2,8810,8811,8813,1,3,0
2512,3,2,8813,8813,8815,0,2,0
2513,4,3,8817,8817,8820,0,3,2
2514,5,2,8822,8822,8824,0,2,2
2515,2,1,8824,8824,8825,0,1,0
2516,6,1,8830,8830,8831,0,1,5
2517,3,3,8833,8833,8836,0,3,2
2518,2,2,8835,8836,8838,1,3,0
2519,1,2,8836,8838,8840,2,4,0
2520,4,1,8840,8840,8841,0,1,0
2521,3,2,8843,8843,8845,0,2,2
2522,2,2,8845,8845,8847,0,2,0
2523,1,2,8846,8847,8849,1,3,0
2524,2,2,8848,8849,8851,1,3,0
2525,4,3,8852,8852,8855,0,3,1
2526,4,1,8856,8856,8857,0,1,1
2527,6,3,8862,8862,8865,0,3,5
2528,4,3,8866,8866,8869,0,3,1
2529,1,2,8867,8869,8871,2,4,0
2530,3,1,8870,8871,8872,1,2,0
2531,6,3,8876,8876,8879,0,3,4
2532,5,1,8881,8881,8882,0,1,2
2533,6,3,8887,8887,8890,0,3,5
2534,1,2,8888,8890,8892,2,4,0
2535,4,2,8892,8892,8894,0,2,0
2536,4,3,8896,8896,8899,0,3,2
2537,4,3,8900,8900,8903,0,3,1
2538,2,3,8902,8903,8906,1,4,0
2539,4,3,8906,8906,8909,0,3,0
2540,5,3,8911,8911,8914,0,3,2
2541,6,1,8917,8917,8918,0,1,3
2542,5,3,8922,8922,8925,0,3,4
2543,6,3,8928,8928,8931,0,3,3
2544,2,2,8930,8931,8933,1,3,0
2545,1,2,8931,8933,8935,2,4,0
2546,2,2,8933,8935,8937,2,4,0
2547,6,3,8939,8939,8942,0,3,2
2548,4,1,8943,8943,8944,0,1,1
2549,4,2,8947,8947,8949,0,2,3
2550,3,2,8950,8950,8952,0,2,1
2551,6,2,8956,8956,8958,0,2,4
2552,5,3,8961,8961,8964,0,3,3
2553,5,2,8966,8966,8968,0,2,2
2554,6,3,8972,8972,8975,0,3,4
2555,3,1,8975,8975,8976,0,1,0
2556,4,2,8979,8979,8981,0,2,3
2557,1,1,8980,8981,8982,1,2,0
2558,6,1,8986,8986,8987,0,1,4
2559,3,3,8989,8989,8992,0,3,2
2560,3,2,8992,8992,8994,0,2,0
2561,3,1,8995,8995,8996,0,1,1
2562,3,2,8998,8998,9000,0,2,2
2563,4,3,9002,9002,9005,0,3,2
2564,2,1,9004,9005,9006,1,2,0
2565,3,1,9007,9007,9008,0,1,1
2566,5,1,9012,9012,9013,0,1,4
2567,4,2,9016,9016,9018,0,2,3
2568,1,1,9017,9018,9019,1,2,0
2569,3,2,9020,9020,9022,0,2,1
2570,5,1,9025,9025,9026,0,1,3
2571,6,3,9031,9031,9034,0,3,5
2572,5,2,9036,9036,9038,0,2,2
2573,5,1,9041,9041,9042,0,1,3
2574,3,3,9044,9044,9047,0,3,2
2575,4,3,9048,9048,9051,0,3,1
2576,5,3,9053,9053,9056,0,3,2
2577,1,1,9054,9056,9057,2,3,0
2578,3,1,9057,9057,9058,0,1,0
2579,2,3,9059,9059,9062,0,3,1
2580,2,2,9061,9062,9064,1,3,0
2581,4,3,9065,9065,9068,0,3,1
2582,1,2,9066,9068,9070,2,4,0
2583,3,2,9069,9070,9072,1,3,0
2584,3,3,9072,9072,9075,0,3,0
2585,4,1,9076,9076,9077,0,1,1
2586,1,1,9077,9077,9078,0,1,0
2587,5,1,9082,9082,9083,0,1,4
2588,4,1,9086,9086,9087,0,1,3
2589,1,2,9087,9087,9089,0,2,0
2590,6,1,9093,9093,9094,0,1,4
2591,2,2,9095,9095,9097,0,2,1
2592,6,1,9101,9101,9102,0,1,4
2593,5,2,9106,9106,9108,0,2,4
2594,4,2,9110,9110,9112,0,2,2
2595,2,1,9112,9112,9113,0,1,0
2596,4,2,9116,9116,9118,0,2,3
2597,1,3,9117,9118,9121,1,4,0
2598,1,1,9118,9121,9122,3,4,0
2599,4,1,9122,9122,9123,0,1,0
2600,1,3,9123,9123,9126,0,3,0
2601,4,2,9127,9127,9129,0,2,1
2602,4,1,9131,9131,9132,0,1,2
2603,1,2,9132,9132,9134,0,2,0
2604,6,2,9138,9138,9140,0,2,4
2605,2,2,9140,9140,9142,0,2,0
2606,2,2,9142,9142,9144,0,2,0
2607,2,1,9144,9144,9145,0,1,0
2608,5,2,9149,9149,9151,0,2,4
2609,2,3,9151,9151,9154,0,3,0
2610,6,2,9157,9157,9159,0,2,3
2611,1,2,9158,9159,9161,1,3,0
2612,6,3,9164,9164,9167,0,3,3
2613,1,2,9165,9167,9169,2,4,0
2614,3,3,9168,9169,9172,1,4,0
2615,5,2,9173,9173,9175,0,2,1
2616,4,3,9177,9177,9180,0,3,2
2617,3,2,9180,9180,9182,0,2,0
2618,4,1,9184,9184,9185,0,1,2
2619,4,2,9188,9188,9190,0,2,3
2620,1,3,9189,9190,9193,1,4,0
2621,2,3,9191,9193,9196,2,5,0
2622,6,2,9197,9197,9199,0,2,1
2623,5,1,9202,9202,9203,0,1,3
2624,5,2,9207,9207,9209,0,2,4
2625,6,1,9213,9213,9214,0,1,4
2626,1,1,9214,9214,9215,0,1,0
2627,6,2,9220,9220,9222,0,2,5
2628,2,1,9222,9222,9223,0,1,0
2629,6,2,9228,9228,9230,0,2,5
2630,4,2,9232,9232,9234,0,2,2
2631,6,3,9238,9238,9241,0,3,4
2632,4,2,9242,9242,9244,0,2,1
2633,6,2,9248,9248,9250,0,2,4
2634,6,2,9254,9254,9256,0,2,4
2635,1,3,9255,9256,9259,1,4,0
2636,2,1,9257,9259,9260,2,3,0
2637,6,1,9263,9263,9264,0,1,3
2638,4,1,9267,9267,9268,0,1,3
2639,3,3,9270,9270,9273,0,3,2
2640,4,2,9274,9274,9276,0,2,1
2641,3,2,9277,9277,9279,0,2,1
2642,6,1,9283,9283,9284,0,1,4
2643,1,2,9284,9284,9286,0,2,0
2644,4,3,9288,9288,9291,0,3,2
2645,1,3,9289,9291,9294,2,5,0
2646,6,2,9295,9295,9297,0,2,1
2647,1,1,9296,9297,9298,1,2,0
2648,1,3,9297,9298,9301,1,4,0
2649,6,2,9303,9303,9305,0,2,2
2650,4,2,9307,9307,9309,0,2,2
2651,4,2,9311,9311,9313,0,2,2
2652,3,2,9314,9314,9316,0,2,1
2653,1,1,9315,9316,9317,1,2,0
2654,1,2,9316,9317,9319,1,3,0
2655,5,2,9321,9321,9323,0,2,2
2656,1,1,9322,9323,9324,1,2,0
2657,5,1,9327,9327,9328,0,1,3
2658,4,1,9331,9331,9332,0,1,3
2659,5,3,9336,9336,9339,0,3,4
2660,3,1,9339,9339,9340,0,1,0
2661,3,3,9342,9342,9345,0,3,2
2662,1,3,9343,9345,9348,2,5,0
2663,2,1,9345,9348,9349,3,4,0
2664,1,2,9346,9349,9351,3,5,0
2665,5,3,9351,9351,9354,0,3,0
2666,5,3,9356,9356,9359,0,3,2
2667,6,3,9362,9362,9365,0,3,3
2668,5,2,9367,9367,9369,0,2,2
2669,4,2,9371,9371,9373,0,2,2
2670,1,3,9372,9373,9376,1,4,0
2671,3,3,9375,9376,9379,1,4,0
2672,5,1,9380,9380,9381,0,1,1
2673,5,3,9385,9385,9388,0,3,4
2674,3,1,9388,9388,9389,0,1,0
2675,6,3,9394,9394,9397,0,3,5
2676,1,2,9395,9397,9399,2,4,0
2677,5,1,9400,9400,9401,0,1,1
2678,1,2,9401,9401,9403,0,2,0
2679,3,2,9404,9404,9406,0,2,1
2680,5,2,9409,9409,9411,0,2,3
2681,5,2,9414,9414,9416,0,2,3
2682,1,3,9415,9416,9419,1,4,0
2683,2,1,9417,9419,9420,2,3,0
2684,5,3,9422,9422,9425,0,3,2
2685,1,3,9423,9425,9428,2,5,0
2686,3,1,9426,9428,9429,2,3,0
2687,3,3,9429,9429,9432,0,3,0
2688,3,2,9432,9432,9434,0,2,0
2689,4,1,9436,9436,9437,0,1,2
2690,1,3,9437,9437,9440,0,3,0
2691,4,1,9441,9441,9442,0,1,1
2692,1,2,9442,9442,9444,0,2,0
2693,6,2,9448,9448,9450,0,2,4
2694,4,3,9452,9452,9455,0,3,2
2695,2,3,9454,9455,9458,1,4,0
2696,2,2,9456,9458,9460,2,4,0
2697,4,3,9460,9460,9463,0,3,0
2698,6,1,9466,9466,9467,0,1,3
2699,5,2,9471,9471,9473,0,2,4
2700,4,1,9475,9475,9476,0,1,2
2701,2,2,9477,9477,9479,0,2,1
2702,4,3,9481,9481,9484,0,3,2
2703,6,3,9487,9487,9490,0,3,3
2704,6,3,9493,9493,9496,0,3,3
2705,2,1,9495,9496,9497,1,2,0
2706,3,2,9498,9498,9500,0,2,1
2707,3,1,9501,9501,9502,0,1,1
2708,5,2,9506,9506,9508,0,2,4
2709,4,3,9510,9510,9513,0,3,2
2710,2,1,9512,9513,9514,1,2,0
2711,3,1,9515,9515,9516,0,1,1
2712,3,1,9518,9518,9519,0,1,2
2713,4,3,9522,9522,9525,0,3,3
2714,1,2,9523,9525,9527,2,4,0
2715,1,1,9524,9527,9528,3,4,0
2716,2,1,9526,9528,9529,2,3,0
2717,1,2,9527,9529,9531,2,4,0
2718,4,1,9531,9531,9532,0,1,0
2719,1,3,9532,9532,9535,0,3,0
2720,6,3,9538,9538,9541,0,3,3
2721,3,1,9541,9541,9542,0,1,0
2722,4,1,9545,9545,9546,0,1,3
2723,5,1,9550,9550,9551,0,1,4
2724,6,3,9556,9556,9559,0,3,5
2725,4,2,9560,9560,9562,0,2,1
2726,5,2,9565,9565,9567,0,2,3
2727,1,2,9566,9567,9569,1,3,0
2728,5,3,9571,9571,9574,0,3,2
2729,2,2,9573,9574,9576,1,3,0
2730,3,1,9576,9576,9577,0,1,0
2731,1,1,9577,9577,9578,0,1,0
2732,6,2,9583,9583,9585,0,2,5
2733,2,2,9585,9585,9587,0,2,0
2734,3,1,9588,9588,9589,0,1,1
2735,2,2,9590,9590,9592,0,2,1
2736,6,3,9596,9596,9599,0,3,4
2737,6,3,9602,9602,9605,0,3,3
2738,2,3,9604,9605,9608,1,4,0
2739,1,3,9605,9608,9611,3,6,0
2740,2,1,9607,9611,9612,4,5,0
2741,4,2,9611,9612,9614,1,3,0
2742,4,2,9615,9615,9617,0,2,1
2743,4,2,9619,9619,9621,0,2,2
2744,5,2,9624,9624,9626,0,2,3
2745,2,2,9626,9626,9628,0,2,0
2746,3,3,9629,9629,9632,0,3,1
2747,1,2,9630,9632,9634,2,4,0
2748,2,3,9632,9634,9637,2,5,0
2749,6,1,9638,9638,9639,0,1,1
2750,1,3,9639,9639,9642,0,3,0
2751,1,2,9640,9642,9644,2,4,0
2752,3,2,9643,9644,9646,1,3,0
2753,5,3,9648,9648,9651,0,3,2
2754,1,1,9649,9651,9652,2,3,0
2755,5,2,9654,9654,9656,0,2,2
2756,2,3,9656,9656,9659,0,3,0
2757,5,3,9661,9661,9664,0,3,2
2758,4,1,9665,9665,9666,0,1,1
2759,6,3,9671,9671,9674,0,3,5
2760,1,2,9672,9674,9676,2,4,0
2761,1,3,9673,9676,9679,3,6,0
2762,5,1,9678,9679,9680,1,2,0
2763,3,2,9681,9681,9683,0,2,1
2764,3,3,9684,9684,9687,0,3,1
2765,6,3,9690,9690,9693,0,3,3
2766,5,3,9695,9695,9698,0,3,2
2767,2,1,9697,9698,9699,1,2,0
2768,1,1,9698,9699,9700,1,2,0
2769,1,3,9699,9700,9703,1,4,0
2770,5,1,9704,9704,9705,0,1,1
2771,3,2,9707,9707,9709,0,2,2
2772,6,2,9713,9713,9715,0,2,4
2773,3,3,9716,9716,9719,0,3,1
2774,3,3,9719,9719,9722,0,3,0
2775,5,2,9724,9724,9726,0,2,2
2776,2,1,9726,9726,9727,0,1,0
2777,3,2,9729,9729,9731,0,2,2
2778,2,2,9731,9731,9733,0,2,0
2779,3,2,9734,9734,9736,0,2,1
2780,2,3,9736,9736,9739,0,3,0
2781,3,2,9739,9739,9741,0,2,0
2782,6,3,9745,9745,9748,0,3,4
2783,2,3,9747,9748,9751,1,4,0
2784,4,1,9751,9751,9752,0,1,0
2785,4,1,9755,9755,9756,0,1,3
2786,6,1,9761,9761,9762,0,1,5
2787,5,2,9766,9766,9768,0,2,4
2788,2,2,9768,9768,9770,0,2,0
2789,5,2,9773,9773,9775,0,2,3
2790,1,2,9774,9775,9777,1,3,0
2791,3,3,9777,9777,9780,0,3,0
2792,2,2,9779,9780,9782,1,3,0
2793,6,3,9785,9785,9788,0,3,3
2794,2,1,9787,9788,9789,1,2,0
2795,1,3,9788,9789,9792,1,4,0
2796,6,1,9794,9794,9795,0,1,2
2797,6,3,9800,9800,9803,0,3,5
2798,1,3,9801,9803,9806,2,5,0
2799,4,3,9805,9806,9809,1,4,0
2800,4,2,9809,9809,9811,0,2,0
2801,4,3,9813,9813,9816,0,3,2
2802,5,3,9818,9818,9821,0,3,2
2803,4,2,9822,9822,9824,0,2,1
2804,2,2,9824,9824,9826,0,2,0
2805,5,1,9829,9829,9830,0,1,3
2806,4,2,9833,9833,9835,0,2,3
2807,3,1,9836,9836,9837,0,1,1
2808,6,2,9842,9842,9844,0,2,5
2809,6,3,9848,9848,9851,0,3,4
2810,4,3,9852,9852,9855,0,3,1
2811,5,3,9857,9857,9860,0,3,2
2812,1,2,9858,9860,9862,2,4,0
2813,4,2,9862,9862,9864,0,2,0
2814,5,2,9867,9867,9869,0,2,3
2815,1,3,9868,9869,9872,1,4,0
2816,5,1,9873,9873,9874,0,1,1
2817,6,3,9879,9879,9882,0,3,5
2818,4,1,9883,9883,9884,0,1,1
2819,2,2,9885,9885,9887,0,2,1
2820,6,1,9891,9891,9892,0,1,4
2821,5,2,9896,9896,9898,0,2,4
2822,6,1,9902,9902,9903,0,1,4
2823,4,2,9906,9906,9908,0,2,3
2824,6,3,9912,9912,9915,0,3,4
2825,2,2,9914,9915,9917,1,3,0
2826,5,1,9919,9919,9920,0,1,2
2827,4,3,9923,9923,9926,0,3,3
2828,1,3,9924,9926,9929,2,5,0
2829,6,1,9930,9930,9931,0,1,1
2830,2,3,9932,9932,9935,0,3,1
2831,1,2,9933,9935,9937,2,4,0
2832,1,2,9934,9937,9939,3,5,0
2833,2,2,9936,9939,9941,3,5,0
2834,2,1,9938,9941,9942,3,4,0
2835,1,3,9939,9942,9945,3,6,0
2836,1,1,9940,9945,9946,5,6,0
2837,6,2,9946,9946,9948,0,2,0
2838,3,3,9949,9949,9952,0,3,1
2839,5,1,9954,9954,9955,0,1,2
2840,1,1,9955,9955,9956,0,1,0
2841,1,1,9956,9956,9957,0,1,0
2842,5,1,9961,9961,9962,0,1,4
2843,2,2,9963,9963,9965,0,2,1
2844,2,1,9965,9965,9966,0,1,0
2845,5,3,9970,9970,9973,0,3,4
2846,4,1,9974,9974,9975,0,1,1
2847,1,1,9975,9975,9976,0,1,0
2848,3,3,9978,9978,9981,0,3,2
2849,6,2,9984,9984,9986,0,2,3
2850,4,3,9988,9988,9991,0,3,2
2851,2,1,9990,9991,9992,1,2,0
2852,5,1,9995,9995,9996,0,1,3
2853,4,3,9999,9999,10002,0,3,3
2854,6,1,10005,10005,10006,0,1,3
2855,2,1,10007,10007,10008,0,1,1
2856,4,3,10011,10011,10014,0,3,3
2857,3,3,10014,10014,10017,0,3,0
2858,4,3,10018,10018,10021,0,3,1
2859,4,3,10022,10022,10025,0,3,1
2860,4,1,10026,10026,10027,0,1,1
2861,1,2,10027,10027,10029,0,2,0
2862,2,1,10029,10029,10030,0,1,0
2863,4,2,10033,10033,10035,0,2,3
2864,1,2,10034,10035,10037,1,3,0
2865,5,3,10039,10039,10042,0,3,2
2866,1,1,10040,10042,10043,2,3,0
2867,2,3,10042,10043,10046,1,4,0
2868,3,3,10045,10046,10049,1,4,0
2869,2,3,10047,10049,10052,2,5,0
2870,4,1,10051,10052,10053,1,2,0
2871,5,1,10056,10056,10057,0,1,3
2872,5,1,10061,10061,10062,0,1,4
2873,4,2,10065,10065,10067,0,2,3
2874,3,3,10068,10068,10071,0,3,1
2875,2,1,10070,10071,10072,1,2,0
2876,6,3,10076,10076,10079,0,3,4
2877,2,3,10078,10079,10082,1,4,0
2878,6,1,10084,10084,10085,0,1,2
2879,3,1,10087,10087,10088,0,1,2
2880,5,2,10092,10092,10094,0,2,4
2881,4,2,10096,10096,10098,0,2,2
2882,4,3,10100,10100,10103,0,3,2
2883,5,2,10105,10105,10107,0,2,2
2884,1,1,10106,10107,10108,1,2,0
2885,5,2,10111,10111,10113,0,2,3
2886,6,2,10117,10117,10119,0,2,4
2887,1,3,10118,10119,10122,1,4,0
2888,3,2,10121,10122,10124,1,3,0
2889,4,3,10125,10125,10128,0,3,1
2890,2,3,10127,10128,10131,1,4,0
2891,4,2,10131,10131,10133,0,2,0
2892,6,1,10137,10137,10138,0,1,4
2893,1,3,10138,10138,10141,0,3,0
2894,6,2,10144,10144,10146,0,2,3
2895,2,2,10146,10146,10148,0,2,0
2896,3,1,10149,10149,10150,0,1,1
2897,1,1,10150,10150,10151,0,1,0
2898,5,3,10155,10155,10158,0,3,4
2899,5,1,10160,10160,10161,0,1,2
2900,1,1,10161,10161,10162,0,1,0
2901,2,2,10163,10163,10165,0,2,1
2902,5,1,10168,10168,10169,0,1,3
2903,6,1,10174,10174,10175,0,1,5
2904,3,3,10177,10177,10180,0,3,2
2905,1,3,10178,10180,10183,2,5,0
2906,2,1,10180,10183,10184,3,4,0
2907,6,2,10186,10186,10188,0,2,2
2908,3,2,10189,10189,10191,0,2,1
2909,3,3,10192,10192,10195,0,3,1
2910,3,1,10195,10195,10196,0,1,0
2911,4,1,10199,10199,10200,0,1,3
2912,6,3,10205,10205,10208,0,3,5
2913,3,2,10208,10208,10210,0,2,0
2914,3,2,10211,10211,10213,0,2,1
2915,3,2,10214,10214,10216,0,2,1
2916,2,2,10216,10216,10218,0,2,0
2917,3,2,10219,10219,10221,0,2,1
2918,6,2,10225,10225,10227,0,2,4
2919,1,1,10226,10227,10228,1,2,0
2920,4,2,10230,10230,10232,0,2,2
2921,4,1,10234,10234,10235,0,1,2
2922,3,1,10237,10237,10238,0,1,2
2923,2,2,10239,10239,10241,0,2,1
2924,1,1,10240,10241,10242,1,2,0
2925,1,1,10241,10242,10243,1,2,0
2926,2,1,10243,10243,10244,0,1,0
2927,1,3,10244,10244,10247,0,3,0
2928,3,2,10247,10247,10249,0,2,0
2929,3,3,10250,10250,10253,0,3,1
2930,4,3,10254,10254,10257,0,3,1
2931,4,1,10258,10258,10259,0,1,1
2932,5,3,10263,10263,10266,0,3,4
2933,6,3,10269,10269,10272,0,3,3
2934,4,2,10273,10273,10275,0,2,1
2935,3,2,10276,10276,10278,0,2,1
2936,2,3,10278,10278,10281,0,3,0
2937,3,2,10281,10281,10283,0,2,0
2938,1,2,10282,10283,10285,1,3,0
2939,2,1,10284,10285,10286,1,2,0
2940,5,1,10289,10289,10290,0,1,3
2941,3,1,10292,10292,10293,0,1,2
2942,1,3,10293,10293,10296,0,3,0
2943,4,1,10297,10297,10298,0,1,1
2944,2,1,10299,10299,10300,0,1,1
2945,1,3,10300,10300,10303,0,3,0
2946,1,2,10301,10303,10305,2,4,0
2947,4,3,10305,10305,10308,0,3,0
2948,3,1,10308,10308,10309,0,1,0
2949,2,1,10310,10310,10311,0,1,1
2950,3,2,10313,10313,10315,0,2,2
2951,3,2,10316,10316,10318,0,2,1
2952,2,2,10318,10318,10320,0,2,0
2953,5,1,10323,10323,10324,0,1,3
2954,6,2,10329,10329,10331,0,2,5
2955,3,1,10332,10332,10333,0,1,1
2956,4,3,10336,10336,10339,0,3,3
2957,5,2,10341,10341,10343,0,2,2
2958,4,3,10345,10345,10348,0,3,2
2959,1,2,10346,10348,10350,2,4,0
2960,6,1,10352,10352,10353,0,1,2
2961,6,1,10358,10358,10359,0,1,5
2962,3,3,10361,10361,10364,0,3,2
2963,3,3,10364,10364,10367,0,3,0
2964,1,2,10365,10367,10369,2,4,0
2965,1,1,10366,10369,10370,3,4,0
2966,6,3,10372,10372,10375,0,3,2
2967,5,1,10377,10377,10378,0,1,2
2968,4,3,10381,10381,10384,0,3,3
2969,2,3,10383,10384,10387,1,4,0
2970,3,3,10386,10387,10390,1,4,0
2971,4,3,10390,10390,10393,0,3,0
2972,6,2,10396,10396,10398,0,2,3
2973,3,3,10399,10399,10402,0,3,1
2974,4,3,10403,10403,10406,0,3,1
2975,5,3,10408,10408,10411,0,3,2
2976,6,3,10414,10414,10417,0,3,3
2977,2,1,10416,10417,10418,1,2,0
2978,1,1,10417,10418,10419,1,2,0
2979,6,3,10423,10423,10426,0,3,4
2980,4,3,10427,10427,10430,0,3,1
2981,4,2,10431,10431,10433,0,2,1
2982,5,3,10436,10436,10439,0,3,3
2983,2,1,10438,10439,10440,1,2,0
2984,6,2,10444,10444,10446,0,2,4
2985,6,3,10450,10450,10453,0,3,4
2986,2,3,10452,10453,10456,1,4,0
2987,2,2,10454,10456,10458,2,4,0
2988,1,3,10455,10458,10461,3,6,0
2989,1,3,10456,10461,10464,5,8,0
2990,2,1,10458,10464,10465,6,7,0
2991,5,1,10463,10465,10466,2,3,0
2992,2,1,10465,10466,10467,1,2,0
2993,5,3,10470,10470,10473,0,3,3
2994,6,2,10476,10476,10478,0,2,3
2995,6,2,10482,10482,10484,0,2,4
2996,3,3,10485,10485,10488,0,3,1
2997,5,1,10490,10490,10491,0,1,2
2998,4,2,10494,10494,10496,0,2,3
2999,5,3,10499,10499,10502,0,3,3
3000,1,1,10500,10502,10503,2,3,0
3001,5,3,10505,10505,10508,0,3,2
3002,6,1,10511,10511,10512,0,1,3
3003,1,3,10512,10512,10515,0,3,0
3004,6,1,10518,10518,10519,0,1,3
3005,2,2,10520,10520,10522,0,2,1
3006,2,2,10522,10522,10524,0,2,0
3007,4,1,10526,10526,10527,0,1,2
3008,2,1,10528,10528,10529,0,1,1
3009,2,1,10530,10530,10531,0,1,1
3010,3,1,10533,10533,10534,0,1,2
3011,6,2,10539,10539,10541,0,2,5
3012,3,1,10542,10542,10543,0,1,1
3013,6,2,10548,10548,10550,0,2,5
3014,2,1,10550,10550,10551,0,1,0
3015,4,1,10554,10554,10555,0,1,3
3016,6,2,10560,10560,10562,0,2,5
3017,4,1,10564,10564,10565,0,1,2
3018,6,2,10570,10570,10572,0,2,5
3019,5,1,10575,10575,10576,0,1,3
3020,4,2,10579,10579,10581,0,2,3
3021,2,2,10581,10581,10583,0,2,0
3022,3,2,10584,10584,10586,0,2,1
3023,5,1,10589,10589,10590,0,1,3
3024,2,3,10591,10591,10594,0,3,1
3025,5,2,10596,10596,10598,0,2,2
3026,2,2,10598,10598,10600,0,2,0
3027,1,1,10599,10600,10601,1,2,0
3028,2,3,10601,10601,10604,0,3,0
3029,2,1,10603,10604,10605,1,2,0
3030,6,1,10609,10609,10610,0,1,4
3031,3,2,10612,10612,10614,0,2,2
3032,2,3,10614,10614,10617,0,3,0
3033,4,1,10618,10618,10619,0,1,1
3034,1,2,10619,10619,10621,0,2,0
3035,2,2,10621,10621,10623,0,2,0
3036,6,3,10627,10627,10630,0,3,4
3037,3,2,10630,10630,10632,0,2,0
3038,2,3,10632,10632,10635,0,3,0
3039,2,1,10634,10635,10636,1,2,0
3040,4,3,10638,10638,10641,0,3,2
3041,4,1,10642,10642,10643,0,1,1
3042,2,1,10644,10644,10645,0,1,1
3043,5,3,10649,10649,10652,0,3,4
3044,2,1,10651,10652,10653,1,2,0
3045,3,2,10654,10654,10656,0,2,1
3046,1,1,10655,10656,10657,1,2,0
3047,4,3,10659,10659,10662,0,3,2
3048,5,2,10664,10664,10666,0,2,2
3049,1,2,10665,10666,10668,1,3,0
3050,2,3,10667,10668,10671,1,4,0
3051,5,3,10672,10672,10675,0,3,1
3052,1,1,10673,10675,10676,2,3,0
3053,4,2,10677,10677,10679,0,2,1
3054,4,2,10681,10681,10683,0,2,2
3055,2,3,10683,10683,10686,0,3,0
3056,5,2,10688,10688,10690,0,2,2
3057,3,1,10691,10691,10692,0,1,1
3058,2,2,10693,10693,10695,0,2,1
3059,1,2,10694,10695,10697,1,3,0
3060,2,1,10696,10697,10698,1,2,0
3061,1,1,10697,10698,10699,1,2,0
3062,4,3,10701,10701,10704,0,3,2
3063,2,2,10703,10704,10706,1,3,0
3064,4,1,10707,10707,10708,0,1,1
3065,1,1,10708,10708,10709,0,1,0
3066,6,2,10714,10714,10716,0,2,5
3067,6,3,10720,10720,10723,0,3,4
3068,4,2,10724,10724,10726,0,2,1
3069,2,3,10726,10726,10729,0,3,0
3070,1,1,10727,10729,10730,2,3,0
3071,4,3,10731,10731,10734,0,3,1
3072,1,2,10732,10734,10736,2,4,0
3073,4,2,10736,10736,10738,0,2,0
3074,6,3,10742,10742,10745,0,3,4
3075,1,2,10743,10745,10747,2,4,0
3076,1,3,10744,10747,10750,3,6,0
3077,3,3,10747,10750,10753,3,6,0
3078,4,2,10751,10753,10755,2,4,0
3079,2,3,10753,10755,10758,2,5,0
3080,6,3,10759,10759,10762,0,3,1
3081,4,2,10763,10763,10765,0,2,1
3082,6,2,10769,10769,10771,0,2,4
3083,3,1,10772,10772,10773,0,1,1
3084,2,3,10774,10774,10777,0,3,1
3085,4,1,10778,10778,10779,0,1,1
3086,5,1,10783,10783,10784,0,1,4
3087,2,1,10785,10785,10786,0,1,1
3088,3,1,10788,10788,10789,0,1,2
3089,6,1,10794,10794,10795,0,1,5
3090,6,1,10800,10800,10801,0,1,5
3091,2,3,10802,10802,10805,0,3,1
3092,5,1,10807,10807,10808,0,1,2
3093,1,3,10808,10808,10811,0,3,0
3094,4,2,10812,10812,10814,0,2,1
3095,5,3,10817,10817,10820,0,3,3
3096,6,2,10823,10823,10825,0,2,3
3097,2,2,10825,10825,10827,0,2,0
3098,2,1,10827,10827,10828,0,1,0
3099,5,3,10832,10832,10835,0,3,4
3100,2,1,10834,10835,10836,1,2,0
3101,2,1,10836,10836,10837,0,1,0
3102,3,1,10839,10839,10840,0,1,2
3103,6,1,10845,10845,10846,0,1,5
3104,6,1,10851,10851,10852,0,1,5
3105,6,1,10857,10857,10858,0,1,5
3106,4,2,10861,10861,10863,0,2,3
3107,4,3,10865,10865,10868,0,3,2
3108,3,2,10868,10868,10870,0,2,0
3109,2,3,10870,10870,10873,0,3,0
3110,1,2,10871,10873,10875,2,4,0
3111,6,3,10877,10877,10880,0,3,2
3112,4,3,10881,10881,10884,0,3,1
3113,5,2,10886,10886,10888,0,2,2
3114,2,2,10888,10888,10890,0,2,0
3115,6,2,10894,10894,10896,0,2,4
3116,4,1,10898,10898,10899,0,1,2
3117,2,1,10900,10900,10901,0,1,1
3118,6,2,10906,10906,10908,0,2,5
3119,5,2,10911,10911,10913,0,2,3
3120,2,3,10913,10913,10916,0,3,0
3121,3,2,10916,10916,10918,0,2,0
3122,6,2,10922,10922,10924,0,2,4
3123,4,2,10926,10926,10928,0,2,2
3124,4,3,10930,10930,10933,0,3,2
3125,1,1,10931,10933,10934,2,3,0
3126,4,3,10935,10935,10938,0,3,1
3127,3,3,10938,10938,10941,0,3,0
3128,3,3,10941,10941,10944,0,3,0
3129,1,1,10942,10944,10945,2,3,0
3130,1,2,10943,10945,10947,2,4,0
3131,4,3,10947,10947,10950,0,3,0
3132,1,3,10948,10950,10953,2,5,0
3133,5,2,10953,10953,10955,0,2,0
3134,2,2,10955,10955,10957,0,2,0
3135,2,2,10957,10957,10959,0,2,0
3136,4,3,10961,10961,10964,0,3,2
3137,2,1,10963,10964,10965,1,2,0
3138,2,1,10965,10965,10966,0,1,0
3139,2,3,10967,10967,10970,0,3,1
3140,2,2,10969,10970,10972,1,3,0
3141,1,1,10970,10972,10973,2,3,0
3142,2,2,10972,10973,10975,1,3,0
3143,6,2,10978,10978,10980,0,2,3
3144,5,2,10983,10983,10985,0,2,3
3145,6,2,10989,10989,10991,0,2,4
3146,5,1,10994,10994,10995,0,1,3
3147,4,3,10998,10998,11001,0,3,3
3148,1,3,10999,11001,11004,2,5,0
3149,1,2,11000,11004,11006,4,6,0
3150,2,2,11002,11006,11008,4,6,0
3151,2,2,11004,11008,11010,4,6,0
3152,3,3,11007,11010,11013,3,6,0
3153,1,1,11008,11013,11014,5,6,0
3154,2,3,11010,11014,11017,4,7,0
3155,6,2,11016,11017,11019,1,3,0
3156,3,2,11019,11019,11021,0,2,0
3157,6,3,11025,11025,11028,0,3,4
3158,3,3,11028,11028,11031,0,3,0
3159,3,3,11031,11031,11034,0,3,0
3160,1,1,11032,11034,11035,2,3,0
3161,1,3,11033,11035,11038,2,5,0
3162,5,2,11038,11038,11040,0,2,0
3163,3,1,11041,11041,11042,0,1,1
3164,3,2,11044,11044,11046,0,2,2
3165,1,2,11045,11046,11048,1,3,0
3166,4,3,11049,11049,11052,0,3,1
3167,6,3,11055,11055,11058,0,3,3
3168,3,3,11058,11058,11061,0,3,0
3169,5,3,11063,11063,11066,0,3,2
3170,5,3,11068,11068,11071,0,3,2
3171,3,3,11071,11071,11074,0,3,0
3172,1,2,11072,11074,11076,2,4,0
3173,6,1,11078,11078,11079,0,1,2
3174,5,2,11083,11083,11085,0,2,4
3175,6,1,11089,11089,11090,0,1,4
3176,3,2,11092,11092,11094,0,2,2
3177,1,3,11093,11094,11097,1,4,0
3178,4,1,11097,11097,11098,0,1,0
3179,4,1,11101,11101,11102,0,1,3
3180,1,1,11102,11102,11103,0,1,0
3181,6,2,11108,11108,11110,0,2,5
3182,3,3,11111,11111,11114,0,3,1
3183,2,1,11113,11114,11115,1,2,0
3184,1,1,11114,11115,11116,1,2,0
3185,2,3,11116,11116,11119,0,3,0
3186,5,1,11121,11121,11122,0,1,2
3187,5,1,11126,11126,11127,0,1,4
3188,2,3,11128,11128,11131,0,3,1
3189,3,1,11131,11131,11132,0,1,0
3190,1,1,11132,11132,11133,0,1,0
3191,2,3,11134,11134,11137,0,3,1
3192,1,3,11135,11137,11140,2,5,0
3193,1,2,11136,11140,11142,4,6,0
3194,1,3,11137,11142,11145,5,8,0
3195,4,2,11141,11145,11147,4,6,0
3196,2,3,11143,11147,11150,4,7,0
3197,4,2,11147,11150,11152,3,5,0
3198,5,1,11152,11152,11153,0,1,0
3199,5,1,11157,11157,11158,0,1,4
3200,4,2,11161,11161,11163,0,2,3
3201,4,3,11165,11165,11168,0,3,2
3202,5,1,11170,11170,11171,0,1,2
3203,5,3,11175,11175,11178,0,3,4
3204,6,1,11181,11181,11182,0,1,3
3205,2,3,11183,11183,11186,0,3,1
3206,2,1,11185,11186,11187,1,2,0
3207,2,3,11187,11187,11190,0,3,0
3208,5,1,11192,11192,11193,0,1,2
3209,4,2,11196,11196,11198,0,2,3
3210,6,1,11202,11202,11203,0,1,4
3211,2,2,11204,11204,11206,0,2,1
3212,5,3,11209,11209,11212,0,3,3
3213,2,2,11211,11212,11214,1,3,0
3214,1,2,11212,11214,11216,2,4,0
3215,6,2,11218,11218,11220,0,2,2
3216,2,1,11220,11220,11221,0,1,0
3217,3,1,11223,11223,11224,0,1,2
3218,1,1,11224,11224,11225,0,1,0
3219,3,2,11227,11227,11229,0,2,2
3220,1,2,11228,11229,11231,1,3,0
3221,3,1,11231,11231,11232,0,1,0
3222,3,2,11234,11234,11236,0,2,2
3223,3,2,11237,11237,11239,0,2,1
3224,3,2,11240,11240,11242,0,2,1
3225,1,3,11241,11242,11245,1,4,0
3226,4,2,11245,11245,11247,0,2,0
3227,4,1,11249,11249,11250,0,1,2
3228,5,3,11254,11254,11257,0,3,4
3229,1,3,11255,11257,11260,2,5,0
3230,2,2,11257,11260,11262,3,5,0
3231,6,1,11263,11263,11264,0,1,1
3232,5,2,11268,11268,11270,0,2,4
3233,3,3,11271,11271,11274,0,3,1
3234,5,2,11276,11276,11278,0,2,2
3235,6,3,11282,11282,11285,0,3,4
3236,5,2,11287,11287,11289,0,2,2
3237,5,1,11292,11292,11293,0,1,3
3238,1,2,11293,11293,11295,0,2,0
3239,1,3,11294,11295,11298,1,4,0
3240,6,1,11300,11300,11301,0,1,2
3241,6,1,11306,11306,11307,0,1,5
3242,6,3,11312,11312,11315,0,3,5
3243,4,1,11316,11316,11317,0,1,1
3244,3,1,11319,11319,11320,0,1,2
3245,5,1,11324,11324,11325,0,1,4
3246,2,3,11326,11326,11329,0,3,1
3247,2,1,11328,11329,11330,1,2,0
3248,5,3,11333,11333,11336,0,3,3
3249,6,2,11339,11339,11341,0,2,3
3250,1,2,11340,11341,11343,1,3,0
3251,5,2,11345,11345,11347,0,2,2
3252,4,1,11349,11349,11350,0,1,2
3253,3,1,11352,11352,11353,0,1,2
3254,1,2,11353,11353,11355,0,2,0
3255,6,3,11359,11359,11362,0,3,4
3256,1,2,11360,11362,11364,2,4,0
3257,2,1,11362,11364,11365,2,3,0
3258,6,2,11368,11368,11370,0,2,3
3259,5,2,11373,11373,11375,0,2,3
3260,6,3,11379,11379,11382,0,3,4
3261,6,2,11385,11385,11387,0,2,3
3262,3,2,11388,11388,11390,0,2,1
3263,2,3,11390,11390,11393,0,3,0
3264,4,1,11394,11394,11395,0,1,1
3265,1,1,11395,11395,11396,0,1,0
3266,2,2,11397,11397,11399,0,2,1
3267,3,3,11400,11400,11403,0,3,1
3268,4,2,11404,11404,11406,0,2,1
3269,1,3,11405,11406,11409,1,4,0
3270,5,2,11410,11410,11412,0,2,1
3271,6,3,11416,11416,11419,0,3,4
3272,1,1,11417,11419,11420,2,3,0
3273,5,3,11422,11422,11425,0,3,2
3274,1,1,11423,11425,11426,2,3,0
3275,2,3,11425,11426,11429,1,4,0
3276,3,2,11428,11429,11431,1,3,0
3277,4,2,11432,11432,11434,0,2,1
3278,3,1,11435,11435,11436,0,1,1
3279,1,1,11436,11436,11437,0,1,0
3280,4,3,11440,11440,11443,0,3,3
3281,5,2,11445,11445,11447,0,2,2
3282,6,1,11451,11451,11452,0,1,4
3283,4,3,11455,11455,11458,0,3,3
3284,2,2,11457,11458,11460,1,3,0
3285,6,3,11463,11463,11466,0,3,3
3286,4,1,11467,11467,11468,0,1,1
3287,5,1,11472,11472,11473,0,1,4
3288,3,2,11475,11475,11477,0,2,2
3289,6,3,11481,11481,11484,0,3,4
3290,2,3,11483,11484,11487,1,4,0
3291,2,2,11485,11487,11489,2,4,0
3292,6,2,11491,11491,11493,0,2,2
3293,3,2,11494,11494,11496,0,2,1
3294,2,3,11496,11496,11499,0,3,0
3295,1,2,11497,11499,11501,2,4,0
3296,2,1,11499,11501,11502,2,3,0
3297,5,3,11504,11504,11507,0,3,2
3298,5,1,11509,11509,11510,0,1,2
3299,4,2,11513,11513,11515,0,2,3
3300,3,3,11516,11516,11519,0,3,1
3301,2,3,11518,11519,11522,1,4,0
3302,2,3,11520,11522,11525,2,5,0
3303,4,2,11524,11525,11527,1,3,0
3304,4,1,11528,11528,11529,0,1,1
3305,6,2,11534,11534,11536,0,2,5
3306,1,3,11535,11536,11539,1,4,0
3307,2,2,11537,11539,11541,2,4,0
3308,5,1,11542,11542,11543,0,1,1
3309,5,3,11547,11547,11550,0,3,4
3310,3,2,11550,11550,11552,0,2,0
3311,2,3,11552,11552,11555,0,3,0
3312,6,3,11558,11558,11561,0,3,3
3313,1,1,11559,11561,11562,2,3,0
3314,6,2,11565,11565,11567,0,2,3
3315,4,3,11569,11569,11572,0,3,2
3316,2,2,11571,11572,11574,1,3,0
3317,4,1,11575,11575,11576,0,1,1
3318,5,2,11580,11580,11582,0,2,4
3319,6,3,11586,11586,11589,0,3,4
3320,1,3,11587,11589,11592,2,5,0
3321,5,1,11592,11592,11593,0,1,0
3322,1,3,11593,11593,11596,0,3,0
3323,5,2,11598,11598,11600,0,2,2
3324,4,3,11602,11602,11605,0,3,2
3325,1,2,11603,11605,11607,2,4,0
3326,2,1,11605,11607,11608,2,3,0
3327,1,2,11606,11608,11610,2,4,0
3328,1,1,11607,11610,11611,3,4,0
3329,4,1,11611,11611,11612,0,1,0
3330,6,3,11617,11617,11620,0,3,5
3331,6,3,11623,11623,11626,0,3,3
3332,5,2,11628,11628,11630,0,2,2
3333,6,2,11634,11634,11636,0,2,4
3334,1,3,11635,11636,11639,1,4,0
3335,1,2,11636,11639,11641,3,5,0
3336,3,3,11639,11641,11644,2,5,0
3337,5,1,11644,11644,11645,0,1,0
3338,5,2,11649,11649,11651,0,2,4
3339,4,3,11653,11653,11656,0,3,2
3340,6,2,11659,11659,11661,0,2,3
3341,5,1,11664,11664,11665,0,1,3
3342,2,2,11666,11666,11668,0,2,1
3343,3,3,11669,11669,11672,0,3,1
3344,4,1,11673,11673,11674,0,1,1
3345,6,2,11679,11679,11681,0,2,5
3346,6,3,11685,11685,11688,0,3,4
3347,6,1,11691,11691,11692,0,1,3
3348,6,3,11697,11697,11700,0,3,5
3349,4,2,11701,11701,11703,0,2,1
3350,1,3,11702,11703,11706,1,4,0
3351,2,1,11704,11706,11707,2,3,0
3352,4,3,11708,11708,11711,0,3,1
3353,3,1,11711,11711,11712,0,1,0
3354,1,1,11712,11712,11713,0,1,0
3355,5,2,11717,11717,11719,0,2,4
3356,1,2,11718,11719,11721,1,3,0
3357,2,2,11720,11721,11723,1,3,0
3358,1,2,11721,11723,11725,2,4,0
3359,6,1,11727,11727,11728,0,1,2
3360,3,2,11730,11730,11732,0,2,2
3361,3,3,11733,11733,11736,0,3,1
3362,2,2,11735,11736,11738,1,3,0
3363,5,2,11740,11740,11742,0,2,2
3364,6,1,11746,11746,11747,0,1,4
3365,5,2,11751,11751,11753,0,2,4
3366,1,3,11752,11753,11756,1,4,0
3367,6,1,11758,11758,11759,0,1,2
3368,3,1,11761,11761,11762,0,1,2
3369,6,3,11767,11767,11770,0,3,5
3370,3,1,11770,11770,11771,0,1,0
3371,3,2,11773,11773,11775,0,2,2
3372,5,3,11778,11778,11781,0,3,3
3373,1,1,11779,11781,11782,2,3,0
3374,3,3,11782,11782,11785,0,3,0
3375,4,2,11786,11786,11788,0,2,1
3376,6,3,11792,11792,11795,0,3,4
3377,4,1,11796,11796,11797,0,1,1
3378,4,2,11800,11800,11802,0,2,3
3379,3,1,11803,11803,11804,0,1,1
3380,5,3,11808,11808,11811,0,3,4
3381,2,2,11810,11811,11813,1,3,0
3382,3,1,11813,11813,11814,0,1,0
3383,5,3,11818,11818,11821,0,3,4
3384,3,3,11821,11821,11824,0,3,0
3385,1,2,11822,11824,11826,2,4,0
3386,4,2,11826,11826,11828,0,2,0
3387,6,1,11832,11832,11833,0,1,4
3388,6,3,11838,11838,11841,0,3,5
3389,5,2,11843,11843,11845,0,2,2
3390,3,3,11846,11846,11849,0,3,1
3391,3,1,11849,11849,11850,0,1,0
3392,2,2,11851,11851,11853,0,2,1
3393,1,2,11852,11853,11855,1,3,0
3394,2,1,11854,11855,11856,1,2,0
3395,6,3,11860,11860,11863,0,3,4
3396,1,1,11861,11863,11864,2,3,0
3397,3,1,11864,11864,11865,0,1,0
3398,5,1,11869,11869,11870,0,1,4
3399,1,3,11870,11870,11873,0,3,0
3400,3,1,11873,11873,11874,0,1,0
3401,5,1,11878,11878,11879,0,1,4
3402,6,3,11884,11884,11887,0,3,5
3403,2,1,11886,11887,11888,1,2,0
3404,2,3,11888,11888,11891,0,3,0
3405,4,2,11892,11892,11894,0,2,1
3406,5,2,11897,11897,11899,0,2,3
3407,1,2,11898,11899,11901,1,3,0
3408,3,1,11901,11901,11902,0,1,0
3409,4,1,11905,11905,11906,0,1,3
3410,6,2,11911,11911,11913,0,2,5
3411,1,1,11912,11913,11914,1,2,0
3412,4,3,11916,11916,11919,0,3,2
3413,4,2,11920,11920,11922,0,2,1
3414,6,2,11926,11926,11928,0,2,4
3415,2,1,11928,11928,11929,0,1,0
3416,1,3,11929,11929,11932,0,3,0
3417,6,3,11935,11935,11938,0,3,3
3418,4,2,11939,11939,11941,0,2,1
3419,5,2,11944,11944,11946,0,2,3
3420,3,2,11947,11947,11949,0,2,1
3421,2,3,11949,11949,11952,0,3,0
3422,1,2,11950,11952,11954,2,4,0
3423,1,3,11951,11954,11957,3,6,0
3424,6,2,11957,11957,11959,0,2,0
3425,3,1,11960,11960,11961,0,1,1
3426,6,1,11966,11966,11967,0,1,5
3427,6,1,11972,11972,11973,0,1,5
3428,1,3,11973,11973,11976,0,3,0
3429,3,1,11976,11976,11977,0,1,0
3430,1,1,11977,11977,11978,0,1,0
3431,1,3,11978,11978,11981,0,3,0
3432,6,2,11984,11984,11986,0,2,3
3433,6,1,11990,11990,11991,0,1,4
3434,3,3,11993,11993,11996,0,3,2
3435,3,3,11996,11996,11999,0,3,0
3436,5,3,12001,12001,12004,0,3,2
3437,6,1,12007,12007,12008,0,1,3
3438,1,2,12008,12008,12010,0,2,0
3439,4,2,12012,12012,12014,0,2,2
3440,1,2,12013,12014,12016,1,3,0
3441,4,2,12017,12017,12019,0,2,1
3442,1,2,12018,12019,12021,1,3,0
3443,2,1,12020,12021,12022,1,2,0
3444,1,2,12021,12022,12024,1,3,0
3445,2,2,12023,12024,12026,1,3,0
3446,4,1,12027,12027,12028,0,1,1
3447,5,2,12032,12032,12034,0,2,4
3448,2,2,12034,12034,12036,0,2,0
3449,4,1,12038,12038,12039,0,1,2
3450,6,2,12044,12044,12046,0,2,5
3451,6,1,12050,12050,12051,0,1,4
3452,1,3,12051,12051,12054,0,3,0
3453,5,3,12056,12056,12059,0,3,2
3454,5,3,12061,12061,12064,0,3,2
3455,1,1,12062,12064,12065,2,3,0
3456,3,1,12065,12065,12066,0,1,0
3457,5,1,12070,12070,12071,0,1,4
3458,2,1,12072,12072,12073,0,1,1
3459,3,2,12075,12075,12077,0,2,2
3460,5,2,12080,12080,12082,0,2,3
3461,2,3,12082,12082,12085,0,3,0
3462,1,3,12083,12085,12088,2,5,0
3463,2,2,12085,12088,12090,3,5,0
3464,5,2,12090,12090,12092,0,2,0
3465,3,3,12093,12093,12096,0,3,1
3466,5,1,12098,12098,12099,0,1,2
3467,3,3,12101,12101,12104,0,3,2
3468,6,2,12107,12107,12109,0,2,3
3469,1,1,12108,12109,12110,1,2,0
3470,2,2,12110,12110,12112,0,2,0
3471,2,2,12112,12112,12114,0,2,0
3472,1,1,12113,12114,12115,1,2,0
3473,2,2,12115,12115,12117,0,2,0
3474,6,3,12121,12121,12124,0,3,4
3475,6,2,12127,12127,12129,0,2,3
3476,3,1,12130,12130,12131,0,1,1
3477,3,1,12133,12133,12134,0,1,2
3478,2,1,12135,12135,12136,0,1,1
3479,4,3,12139,12139,12142,0,3,3
3480,5,1,12144,12144,12145,0,1,2
3481,1,2,12145,12145,12147,0,2,0
3482,5,3,12150,12150,12153,0,3,3
3483,5,2,12155,12155,12157,0,2,2
3484,4,1,12159,12159,12160,0,1,2
3485,2,3,12161,12161,12164,0,3,1
3486,2,1,12163,12164,12165,1,2,0
3487,1,2,12164,12165,12167,1,3,0
3488,6,3,12170,12170,12173,0,3,3
3489,2,1,12172,12173,12174,1,2,0
3490,1,2,12173,12174,12176,1,3,0
3491,4,2,12177,12177,12179,0,2,1
3492,5,3,12182,12182,12185,0,3,3
3493,5,3,12187,12187,12190,0,3,2
3494,1,1,12188,12190,12191,2,3,0
3495,5,3,12193,12193,12196,0,3,2
3496,3,3,12196,12196,12199,0,3,0
3497,4,3,12200,12200,12203,0,3,1
3498,1,2,12201,12203,12205,2,4,0
3499,5,3,12206,12206,12209,0,3,1
3500,2,2,12208,12209,12211,1,3,0
3501,6,1,12214,12214,12215,0,1,3
3502,4,2,12218,12218,12220,0,2,3
3503,4,3,12222,12222,12225,0,3,2
3504,1,3,12223,12225,12228,2,5,0
3505,2,3,12225,12228,12231,3,6,0
3506,5,2,12230,12231,12233,1,3,0
3507,6,3,12236,12236,12239,0,3,3
3508,4,1,12240,12240,12241,0,1,1
3509,6,1,12246,12246,12247,0,1,5
3510,5,3,12251,12251,12254,0,3,4
3511,5,3,12256,12256,12259,0,3,2
3512,6,1,12262,12262,12263,0,1,3
3513,1,1,12263,12263,12264,0,1,0
3514,4,3,12267,12267,12270,0,3,3
3515,4,3,12271,12271,12274,0,3,1
3516,5,3,12276,12276,12279,0,3,2
3517,5,3,12281,12281,12284,0,3,2
3518,4,2,12285,12285,12287,0,2,1
3519,5,1,12290,12290,12291,0,1,3
3520,1,2,12291,12291,12293,0,2,0
3521,5,1,12296,12296,12297,0,1,3
3522,3,3,12299,12299,12302,0,3,2
3523,2,3,12301,12302,12305,1,4,0
3524,4,3,12305,12305,12308,0,3,0
3525,1,1,12306,12308,12309,2,3,0
3526,6,2,12312,12312,12314,0,2,3
3527,1,3,12313,12314,12317,1,4,0
3528,4,3,12317,12317,12320,0,3,0
3529,6,1,12323,12323,12324,0,1,3
3530,5,2,12328,12328,12330,0,2,4
3531,5,2,12333,12333,12335,0,2,3
3532,4,2,12337,12337,12339,0,2,2
3533,6,2,12343,12343,12345,0,2,4
3534,2,2,12345,12345,12347,0,2,0
3535,2,1,12347,12347,12348,0,1,0
3536,6,1,12353,12353,12354,0,1,5
3537,2,3,12355,12355,12358,0,3,1
3538,5,1,12360,12360,12361,0,1,2
3539,5,2,12365,12365,12367,0,2,4
3540,6,1,12371,12371,12372,0,1,4
3541,2,3,12373,12373,12376,0,3,1
3542,4,1,12377,12377,12378,0,1,1
3543,1,2,12378,12378,12380,0,2,0
3544,2,3,12380,12380,12383,0,3,0
3545,1,1,12381,12383,12384,2,3,0
3546,1,1,12382,12384,12385,2,3,0
3547,1,1,12383,12385,12386,2,3,0
3548,5,2,12388,12388,12390,0,2,2
3549,5,1,12393,12393,12394,0,1,3
3550,4,3,12397,12397,12400,0,3,3
3551,2,3,12399,12400,12403,1,4,0
3552,1,3,12400,12403,12406,3,6,0
3553,5,3,12405,12406,12409,1,4,0
3554,3,1,12408,12409,12410,1,2,0
3555,4,1,12412,12412,12413,0,1,2
3556,2,1,12414,12414,12415,0,1,1
3557,6,3,12420,12420,12423,0,3,5
3558,3,3,12423,12423,12426,0,3,0
3559,2,2,12425,12426,12428,1,3,0
3560,1,1,12426,12428,12429,2,3,0
3561,5,2,12431,12431,12433,0,2,2
3562,1,2,12432,12433,12435,1,3,0
3563,2,2,12434,12435,12437,1,3,0
3564,4,1,12438,12438,12439,0,1,1
3565,4,2,12442,12442,12444,0,2,3
3566,4,1,12446,12446,12447,0,1,2
3567,2,3,12448,12448,12451,0,3,1
3568,1,3,12449,12451,12454,2,5,0
3569,1,1,12450,12454,12455,4,5,0
3570,2,1,12452,12455,12456,3,4,0
3571,6,3,12458,12458,12461,0,3,2
3572,2,2,12460,12461,12463,1,3,0
3573,4,1,12464,12464,12465,0,1,1
3574,6,3,12470,12470,12473,0,3,5
3575,1,1,12471,12473,12474,2,3,0
3576,1,3,12472,12474,12477,2,5,0
3577,4,1,12476,12477,12478,1,2,0
3578,6,1,12482,12482,12483,0,1,4
3579,4,2,12486,12486,12488,0,2,3
3580,6,2,12492,12492,12494,0,2,4
3581,4,1,12496,12496,12497,0,1,2
3582,6,1,12502,12502,12503,0,1,5
3583,1,3,12503,12503,12506,0,3,0
3584,3,3,12506,12506,12509,0,3,0
3585,2,2,12508,12509,12511,1,3,0
3586,3,1,12511,12511,12512,0,1,0
3587,3,3,12514,12514,12517,0,3,2
3588,3,1,12517,12517,12518,0,1,0
3589,2,2,12519,12519,12521,0,2,1
3590,2,2,12521,12521,12523,0,2,0
3591,3,3,12524,12524,12527,0,3,1
3592,4,3,12528,12528,12531,0,3,1
3593,6,2,12534,12534,12536,0,2,3
3594,4,2,12538,12538,12540,0,2,2
3595,6,2,12544,12544,12546,0,2,4
3596,4,3,12548,12548,12551,0,3,2
3597,6,3,12554,12554,12557,0,3,3
3598,3,1,12557,12557,12558,0,1,0
3599,3,3,12560,12560,12563,0,3,2
3600,6,3,12566,12566,12569,0,3,3
3601,5,2,12571,12571,12573,0,2,2
3602,5,2,12576,12576,12578,0,2,3
3603,4,1,12580,12580,12581,0,1,2
3604,1,1,12581,12581,12582,0,1,0
3605,4,3,12585,12585,12588,0,3,3
3606,5,1,12590,12590,12591,0,1,2
3607,3,1,12593,12593,12594,0,1,2
3608,3,3,12596,12596,12599,0,3,2
3609,2,3,12598,12599,12602,1,4,0
3610,6,2,12604,12604,12606,0,2,2
3611,4,2,12608,12608,12610,0,2,2
3612,6,3,12614,12614,12617,0,3,4
3613,6,2,12620,12620,12622,0,2,3
3614,6,3,12626,12626,12629,0,3,4
3615,4,2,12630,12630,12632,0,2,1
3616,2,1,12632,12632,12633,0,1,0
3617,5,2,12637,12637,12639,0,2,4
3618,1,1,12638,12639,12640,1,2,0
3619,3,1,12641,12641,12642,0,1,1
3620,4,2,12645,12645,12647,0,2,3
3621,4,2,12649,12649,12651,0,2,2
3622,2,1,12651,12651,12652,0,1,0
3623,1,1,12652,12652,12653,0,1,0
3624,1,2,12653,12653,12655,0,2,0
3625,3,2,12656,12656,12658,0,2,1
3626,2,2,12658,12658,12660,0,2,0
3627,4,3,12662,12662,12665,0,3,2
3628,4,3,12666,12666,12669,0,3,1
3629,6,1,12672,12672,12673,0,1,3
3630,4,1,12676,12676,12677,0,1,3
3631,5,3,12681,12681,12684,0,3,4
3632,1,2,12682,12684,12686,2,4,0
3633,6,2,12688,12688,12690,0,2,2
3634,4,2,12692,12692,12694,0,2,2
3635,1,2,12693,12694,12696,1,3,0
3636,5,2,12698,12698,12700,0,2,2
3637,1,3,12699,12700,12703,1,4,0
3638,4,3,12703,12703,12706,0,3,0
3639,6,1,12709,12709,12710,0,1,3
3640,2,3,12711,12711,12714,0,3,1
3641,3,1,12714,12714,12715,0,1,0
3642,6,2,12720,12720,12722,0,2,5
3643,4,2,12724,12724,12726,0,2,2
3644,4,1,12728,12728,12729,0,1,2
3645,5,3,12733,12733,12736,0,3,4
3646,3,2,12736,12736,12738,0,2,0
3647,4,2,12740,12740,12742,0,2,2
3648,5,1,12745,12745,12746,0,1,3
3649,4,1,12749,12749,12750,0,1,3
3650,3,1,12752,12752,12753,0,1,2
3651,3,3,12755,12755,12758,0,3,2
3652,5,1,12760,12760,12761,0,1,2
3653,2,3,12762,12762,12765,0,3,1
3654,2,3,12764,12765,12768,1,4,0
3655,6,1,12770,12770,12771,0,1,2
3656,4,2,12774,12774,12776,0,2,3
3657,2,3,12776,12776,12779,0,3,0
3658,3,1,12779,12779,12780,0,1,0
3659,1,2,12780,12780,12782,0,2,0
3660,6,1,12786,12786,12787,0,1,4
3661,2,2,12788,12788,12790,0,2,1
3662,5,3,12793,12793,12796,0,3,3
3663,1,2,12794,12796,12798,2,4,0
3664,2,3,12796,12798,12801,2,5,0
3665,3,1,12799,12801,12802,2,3,0
3666,5,1,12804,12804,12805,0,1,2
3667,2,3,12806,12806,12809,0,3,1
3668,5,2,12811,12811,12813,0,2,2
3669,3,1,12814,12814,12815,0,1,1
3670,6,1,12820,12820,12821,0,1,5
3671,4,3,12824,12824,12827,0,3,3
3672,4,3,12828,12828,12831,0,3,1
3673,4,2,12832,12832,12834,0,2,1
3674,6,2,12838,12838,12840,0,2,4
3675,1,2,12839,12840,12842,1,3,0
3676,4,3,12843,12843,12846,0,3,1
3677,3,1,12846,12846,12847,0,1,0
3678,1,1,12847,12847,12848,0,1,0
3679,2,2,12849,12849,12851,0,2,1
3680,5,3,12854,12854,12857,0,3,3
3681,1,3,12855,12857,12860,2,5,0
3682,5,3,12860,12860,12863,0,3,0
3683,3,1,12863,12863,12864,0,1,0
3684,1,1,12864,12864,12865,0,1,0
3685,5,1,12869,12869,12870,0,1,4
3686,1,3,12870,12870,12873,0,3,0
3687,4,3,12874,12874,12877,0,3,1
3688,5,3,12879,12879,12882,0,3,2
3689,2,3,12881,12882,12885,1,4,0
3690,4,3,12885,12885,12888,0,3,0
3691,1,2,12886,12888,12890,2,4,0
3692,2,2,12888,12890,12892,2,4,0
3693,1,1,12889,12892,12893,3,4,0
3694,1,1,12890,12893,12894,3,4,0
3695,3,1,12893,12894,12895,1,2,0
3696,4,2,12897,12897,12899,0,2,2
3697,2,2,12899,12899,12901,0,2,0
3698,6,3,12905,12905,12908,0,3,4
3699,4,2,12909,12909,12911,0,2,1
3700,4,1,12913,12913,12914,0,1,2
3701,6,1,12919,12919,12920,0,1,5
3702,2,1,12921,12921,12922,0,1,1
3703,2,1,12923,12923,12924,0,1,1
3704,3,2,12926,12926,12928,0,2,2
3705,3,2,12929,12929,12931,0,2,1
3706,3,2,12932,12932,12934,0,2,1
3707,1,1,12933,12934,12935,1,2,0
3708,1,1,12934,12935,12936,1,2,0
3709,3,2,12937,12937,12939,0,2,1
3710,6,1,12943,12943,12944,0,1,4
3711,2,1,12945,12945,12946,0,1,1
3712,5,1,12950,12950,12951,0,1,4
3713,2,2,12952,12952,12954,0,2,1
3714,1,1,12953,12954,12955,1,2,0
3715,6,3,12959,12959,12962,0,3,4
3716,1,2,12960,12962,12964,2,4,0
3717,4,2,12964,12964,12966,0,2,0
3718,5,3,12969,12969,12972,0,3,3
3719,2,2,12971,12972,12974,1,3,0
3720,4,1,12975,12975,12976,0,1,1
3721,4,2,12979,12979,12981,0,2,3
3722,2,1,12981,12981,12982,0,1,0
3723,6,2,12987,12987,12989,0,2,5
3724,2,2,12989,12989,12991,0,2,0
3725,4,1,12993,12993,12994,0,1,2
3726,6,2,12999,12999,13001,0,2,5
3727,6,1,13005,13005,13006,0,1,4
3728,3,3,13008,13008,13011,0,3,2
3729,6,3,13014,13014,13017,0,3,3
3730,2,2,13016,13017,13019,1,3,0
3731,2,1,13018,13019,13020,1,2,0
3732,5,2,13023,13023,13025,0,2,3
3733,1,1,13024,13025,13026,1,2,0
3734,6,2,13030,13030,13032,0,2,4
3735,4,3,13034,13034,13037,0,3,2
3736,2,2,13036,13037,13039,1,3,0
3737,6,3,13042,13042,13045,0,3,3
3738,2,1,13044,13045,13046,1,2,0
3739,3,1,13047,13047,13048,0,1,1
3740,1,3,13048,13048,13051,0,3,0
3741,2,3,13050,13051,13054,1,4,0
3742,4,1,13054,13054,13055,0,1,0
3743,6,3,13060,13060,13063,0,3,5
3744,2,1,13062,13063,13064,1,2,0
3745,3,2,13065,13065,13067,0,2,1
3746,4,3,13069,13069,13072,0,3,2
3747,1,3,13070,13072,13075,2,5,0
3748,6,1,13076,13076,13077,0,1,1
3749,3,3,13079,13079,13082,0,3,2
3750,6,2,13085,13085,13087,0,2,3
3751,5,3,13090,13090,13093,0,3,3
3752,2,2,13092,13093,13095,1,3,0
3753,4,2,13096,13096,13098,0,2,1
3754,5,1,13101,13101,13102,0,1,3
3755,4,3,13105,13105,13108,0,3,3
3756,2,2,13107,13108,13110,1,3,0
3757,4,1,13111,13111,13112,0,1,1
3758,5,2,13116,13116,13118,0,2,4
3759,1,1,13117,13118,13119,1,2,0
3760,5,1,13122,13122,13123,0,1,3
3761,3,3,13125,13125,13128,0,3,2
3762,2,2,13127,13128,13130,1,3,0
3763,2,3,13129,13130,13133,1,4,0
3764,6,2,13135,13135,13137,0,2,2
3765,5,3,13140,13140,13143,0,3,3
3766,3,2,13143,13143,13145,0,2,0
3767,1,2,13144,13145,13147,1,3,0
3768,3,3,13147,13147,13150,0,3,0
3769,1,3,13148,13150,13153,2,5,0
3770,6,2,13154,13154,13156,0,2,1
3771,2,3,13156,13156,13159,0,3,0
3772,2,3,13158,13159,13162,1,4,0
3773,1,2,13159,13162,13164,3,5,0
3774,3,2,13162,13164,13166,2,4,0
3775,3,2,13165,13166,13168,1,3,0
3776,1,2,13166,13168,13170,2,4,0
3777,1,3,13167,13170,13173,3,6,0
3778,4,2,13171,13173,13175,2,4,0
3779,4,1,13175,13175,13176,0,1,0
3780,4,1,13179,13179,13180,0,1,3
3781,4,3,13183,13183,13186,0,3,3
3782,2,3,13185,13186,13189,1,4,0
3783,3,1,13188,13189,13190,1,2,0
3784,2,2,13190,13190,13192,0,2,0
3785,1,3,13191,13192,13195,1,4,0
3786,2,3,13193,13195,13198,2,5,0
3787,6,3,13199,13199,13202,0,3,1
3788,6,3,13205,13205,13208,0,3,3
3789,1,3,13206,13208,13211,2,5,0
3790,3,2,13209,13211,13213,2,4,0
3791,1,2,13210,13213,13215,3,5,0
3792,6,2,13216,13216,13218,0,2,1
3793,6,3,13222,13222,13225,0,3,4
3794,6,1,13228,13228,13229,0,1,3
3795,6,1,13234,13234,13235,0,1,5
3796,2,1,13236,13236,13237,0,1,1
3797,3,3,13239,13239,13242,0,3,2
3798,3,3,13242,13242,13245,0,3,0
3799,4,2,13246,13246,13248,0,2,1
3800,2,1,13248,13248,13249,0,1,0
3801,3,2,13251,13251,13253,0,2,2
3802,5,1,13256,13256,13257,0,1,3
3803,4,3,13260,13260,13263,0,3,3
3804,4,2,13264,13264,13266,0,2,1
3805,4,1,13268,13268,13269,0,1,2
3806,1,3,13269,13269,13272,0,3,0
3807,3,2,13272,13272,13274,0,2,0
3808,1,3,13273,13274,13277,1,4,0
3809,2,2,13275,13277,13279,2,4,0
3810,3,2,13278,13279,13281,1,3,0
3811,1,1,13279,13281,13282,2,3,0
3812,3,2,13282,13282,13284,0,2,0
3813,3,2,13285,13285,13287,0,2,1
3814,6,3,13291,13291,13294,0,3,4
3815,4,3,13295,13295,13298,0,3,1
3816,6,2,13301,13301,13303,0,2,3
3817,4,3,13305,13305,13308,0,3,2
3818,5,3,13310,13310,13313,0,3,2
3819,4,3,13314,13314,13317,0,3,1
3820,4,1,13318,13318,13319,0,1,1
3821,4,3,13322,13322,13325,0,3,3
3822,4,2,13326,13326,13328,0,2,1
3823,1,2,13327,13328,13330,1,3,0
3824,1,2,13328,13330,13332,2,4,0
3825,5,2,13333,13333,13335,0,2,1
3826,5,3,13338,13338,13341,0,3,3
3827,6,1,13344,13344,13345,0,1,3
3828,2,2,13346,13346,13348,0,2,1
3829,5,3,13351,13351,13354,0,3,3
3830,2,2,13353,13354,13356,1,3,0
3831,6,3,13359,13359,13362,0,3,3
3832,4,2,13363,13363,13365,0,2,1
3833,2,1,13365,13365,13366,0,1,0
3834,5,1,13370,13370,13371,0,1,4
3835,5,1,13375,13375,13376,0,1,4
3836,2,2,13377,13377,13379,0,2,1
3837,4,1,13381,13381,13382,0,1,2
3838,6,3,13387,13387,13390,0,3,5
3839,3,1,13390,13390,13391,0,1,0
3840,3,2,13393,13393,13395,0,2,2
3841,6,1,13399,13399,13400,0,1,4
3842,6,3,13405,13405,13408,0,3,5
3843,1,1,13406,13408,13409,2,3,0
3844,4,3,13410,13410,13413,0,3,1
3845,2,2,13412,13413,13415,1,3,0
3846,4,2,13416,13416,13418,0,2,1
3847,1,1,13417,13418,13419,1,2,0
3848,6,2,13423,13423,13425,0,2,4
3849,1,1,13424,13425,13426,1,2,0
3850,3,3,13427,13427,13430,0,3,1
3851,6,2,13433,13433,13435,0,2,3
3852,6,3,13439,13439,13442,0,3,4
3853,6,3,13445,13445,13448,0,3,3
3854,2,2,13447,13448,13450,1,3,0
3855,3,1,13450,13450,13451,0,1,0
3856,4,3,13454,13454,13457,0,3,3
3857,5,3,13459,13459,13462,0,3,2
3858,4,2,13463,13463,13465,0,2,1
3859,2,3,13465,13465,13468,0,3,0
3860,1,2,13466,13468,13470,2,4,0
3861,4,3,13470,13470,13473,0,3,0
3862,1,3,13471,13473,13476,2,5,0
3863,1,2,13472,13476,13478,4,6,0
3864,1,1,13473,13478,13479,5,6,0
3865,6,3,13479,13479,13482,0,3,0
3866,3,2,13482,13482,13484,0,2,0
3867,5,3,13487,13487,13490,0,3,3
3868,2,2,13489,13490,13492,1,3,0
3869,5,3,13494,13494,13497,0,3,2
3870,3,3,13497,13497,13500,0,3,0
3871,5,2,13502,13502,13504,0,2,2
3872,1,3,13503,13504,13507,1,4,0
3873,5,1,13508,13508,13509,0,1,1
3874,6,2,13514,13514,13516,0,2,5
3875,2,2,13516,13516,13518,0,2,0
3876,6,1,13522,13522,13523,0,1,4
3877,2,3,13524,13524,13527,0,3,1
3878,2,3,13526,13527,13530,1,4,0
3879,5,2,13531,13531,13533,0,2,1
3880,5,3,13536,13536,13539,0,3,3
3881,6,2,13542,13542,13544,0,2,3
3882,5,3,13547,13547,13550,0,3,3
3883,2,3,13549,13550,13553,1,4,0
3884,4,1,13553,13553,13554,0,1,0
3885,3,2,13556,13556,13558,0,2,2
3886,5,3,13561,13561,13564,0,3,3
3887,4,1,13565,13565,13566,0,1,1
3888,5,1,13570,13570,13571,0,1,4
3889,5,1,13575,13575,13576,0,1,4
3890,4,1,13579,13579,13580,0,1,3
3891,4,3,13583,13583,13586,0,3,3
3892,2,2,13585,13586,13588,1,3,0
3893,2,1,13587,13588,13589,1,2,0
3894,4,3,13591,13591,13594,0,3,2
3895,2,2,13593,13594,13596,1,3,0
3896,5,3,13598,13598,13601,0,3,2
3897,4,2,13602,13602,13604,0,2,1
3898,1,2,13603,13604,13606,1,3,0
3899,2,3,13605,13606,13609,1,4,0
3900,6,2,13611,13611,13613,0,2,2
3901,1,1,13612,13613,13614,1,2,0
3902,2,3,13614,13614,13617,0,3,0
3903,4,1,13618,13618,13619,0,1,1
3904,4,2,13622,13622,13624,0,2,3
3905,1,1,13623,13624,13625,1,2,0
3906,6,3,13629,13629,13632,0,3,4
3907,3,2,13632,13632,13634,0,2,0
3908,5,1,13637,13637,13638,0,1,3
3909,2,3,13639,13639,13642,0,3,1
3910,6,2,13645,13645,13647,0,2,3
3911,3,3,13648,13648,13651,0,3,1
3912,3,1,13651,13651,13652,0,1,0
3913,1,3,13652,13652,13655,0,3,0
3914,4,3,13656,13656,13659,0,3,1
3915,1,3,13657,13659,13662,2,5,0
3916,6,2,13663,13663,13665,0,2,1
3917,6,2,13669,13669,13671,0,2,4
3918,6,2,13675,13675,13677,0,2,4
3919,1,3,13676,13677,13680,1,4,0
3920,1,3,13677,13680,13683,3,6,0
3921,5,2,13682,13683,13685,1,3,0
3922,1,2,13683,13685,13687,2,4,0
3923,1,3,13684,13687,13690,3,6,0
3924,5,3,13689,13690,13693,1,4,0
3925,4,1,13693,13693,13694,0,1,0
3926,3,2,13696,13696,13698,0,2,2
3927,6,1,13702,13702,13703,0,1,4
3928,5,3,13707,13707,13710,0,3,4
3929,2,3,13709,13710,13713,1,4,0
3930,2,3,13711,13713,13716,2,5,0
3931,3,3,13714,13716,13719,2,5,0
3932,5,3,13719,13719,13722,0,3,0
3933,4,1,13723,13723,13724,0,1,1
3934,1,1,13724,13724,13725,0,1,0
3935,5,1,13729,13729,13730,0,1,4
3936,5,1,13734,13734,13735,0,1,4
3937,2,2,13736,13736,13738,0,2,1
3938,3,2,13739,13739,13741,0,2,1
3939,3,1,13742,13742,13743,0,1,1
3940,5,1,13747,13747,13748,0,1,4
3941,4,2,13751,13751,13753,0,2,3
3942,4,3,13755,13755,13758,0,3,2
3943,5,2,13760,13760,13762,0,2,2
3944,6,2,13766,13766,13768,0,2,4
3945,5,1,13771,13771,13772,0,1,3
3946,5,3,13776,13776,13779,0,3,4
3947,6,1,13782,13782,13783,0,1,3
3948,6,2,13788,13788,13790,0,2,5
3949,5,3,13793,13793,13796,0,3,3
3950,1,1,13794,13796,13797,2,3,0
3951,1,2,13795,13797,13799,2,4,0
3952,3,2,13798,13799,13801,1,3,0
3953,5,3,13803,13803,13806,0,3,2
3954,4,2,13807,13807,13809,0,2,1
3955,2,1,13809,13809,13810,0,1,0
3956,3,2,13812,13812,13814,0,2,2
3957,6,2,13818,13818,13820,0,2,4
3958,4,2,13822,13822,13824,0,2,2
3959,1,1,13823,13824,13825,1,2,0
3960,5,1,13828,13828,13829,0,1,3
3961,2,2,13830,13830,13832,0,2,1
3962,5,1,13835,13835,13836,0,1,3
3963,4,2,13839,13839,13841,0,2,3
3964,5,1,13844,13844,13845,0,1,3
3965,1,3,13845,13845,13848,0,3,0
3966,6,1,13851,13851,13852,0,1,3
3967,5,3,13856,13856,13859,0,3,4
3968,4,3,13860,13860,13863,0,3,1
3969,2,3,13862,13863,13866,1,4,0
3970,1,1,13863,13866,13867,3,4,0
3971,3,2,13866,13867,13869,1,3,0
3972,3,1,13869,13869,13870,0,1,0
3973,1,2,13870,13870,13872,0,2,0
3974,5,3,13875,13875,13878,0,3,3
3975,5,2,13880,13880,13882,0,2,2
3976,6,1,13886,13886,13887,0,1,4
3977,2,3,13888,13888,13891,0,3,1
3978,4,3,13892,13892,13895,0,3,1
3979,4,3,13896,13896,13899,0,3,1
3980,3,1,13899,13899,13900,0,1,0
3981,2,1,13901,13901,13902,0,1,1
3982,2,1,13903,13903,13904,0,1,1
3983,2,1,13905,13905,13906,0,1,1
3984,1,1,13906,13906,13907,0,1,0
3985,4,2,13910,13910,13912,0,2,3
3986,1,2,13911,13912,13914,1,3,0
3987,3,1,13914,13914,13915,0,1,0
3988,2,3,13916,13916,13919,0,3,1
3989,5,3,13921,13921,13924,0,3,2
3990,3,1,13924,13924,13925,0,1,0
3991,1,2,13925,13925,13927,0,2,0
3992,3,2,13928,13928,13930,0,2,1
3993,3,2,13931,13931,13933,0,2,1
3994,4,1,13935,13935,13936,0,1,2
3995,4,3,13939,13939,13942,0,3,3
3996,3,2,13942,13942,13944,0,2,0
3997,3,1,13945,13945,13946,0,1,1
3998,3,2,13948,13948,13950,0,2,2
3999,3,2,13951,13951,13953,0,2,1
4000,2,2,13953,13953,13955,0,2,0
4001,3,1,13956,13956,13957,0,1,1
4002,5,3,13961,13961,13964,0,3,4
4003,1,1,13962,13964,13965,2,3,0
4004,1,3,13963,13965,13968,2,5,0
4005,5,2,13968,13968,13970,0,2,0
4006,6,2,13974,13974,13976,0,2,4
4007,4,3,13978,13978,13981,0,3,2
4008,2,2,13980,13981,13983,1,3,0
4009,2,2,13982,13983,13985,1,3,0
4010,6,3,13988,13988,13991,0,3,3
4011,3,2,13991,13991,13993,0,2,0
4012,6,2,13997,13997,13999,0,2,4
4013,1,3,13998,13999,14002,1,4,0
4014,2,3,14000,14002,14005,2,5,0
4015,1,3,14001,14005,14008,4,7,0
4016,1,2,14002,14008,14010,6,8,0
4017,5,2,14007,14010,14012,3,5,0
4018,1,2,14008,14012,14014,4,6,0
4019,3,1,14011,14014,14015,3,4,0
4020,5,1,14016,14016,14017,0,1,1
4021,3,2,14019,14019,14021,0,2,2
4022,3,1,14022,14022,14023,0,1,1
4023,3,2,14025,14025,14027,0,2,2
4024,3,3,14028,14028,14031,0,3,1
4025,1,3,14029,14031,14034,2,5,0
4026,3,1,14032,14034,14035,2,3,0
4027,4,3,14036,14036,14039,0,3,1
4028,1,2,14037,14039,14041,2,4,0
4029,3,1,14040,14041,14042,1,2,0
4030,3,1,14043,14043,14044,0,1,1
4031,4,3,14047,14047,14050,0,3,3
4032,1,3,14048,14050,14053,2,5,0
4033,1,1,14049,14053,14054,4,5,0
4034,3,3,14052,14054,14057,2,5,0
4035,1,3,14053,14057,14060,4,7,0
4036,5,3,14058,14060,14063,2,5,0
4037,6,2,14064,14064,14066,0,2,1
4038,4,3,14068,14068,14071,0,3,2
4039,6,2,14074,14074,14076,0,2,3
4040,6,1,14080,14080,14081,0,1,4
4041,2,2,14082,14082,14084,0,2,1
4042,1,3,14083,14084,14087,1,4,0
4043,1,2,14084,14087,14089,3,5,0
4044,4,2,14088,14089,14091,1,3,0
4045,2,1,14090,14091,14092,1,2,0
4046,3,1,14093,14093,14094,0,1,1
4047,5,3,14098,14098,14101,0,3,4
4048,5,3,14103,14103,14106,0,3,2
4049,3,1,14106,14106,14107,0,1,0
4050,2,3,14108,14108,14111,0,3,1
4051,1,2,14109,14111,14113,2,4,0
4052,3,3,14112,14113,14116,1,4,0
4053,1,2,14113,14116,14118,3,5,0
4054,5,2,14118,14118,14120,0,2,0
4055,3,3,14121,14121,14124,0,3,1
4056,4,1,14125,14125,14126,0,1,1
4057,4,2,14129,14129,14131,0,2,3
4058,1,2,14130,14131,14133,1,3,0
4059,1,2,14131,14133,14135,2,4,0
4060,5,2,14136,14136,14138,0,2,1
4061,3,1,14139,14139,14140,0,1,1
4062,3,2,14142,14142,14144,0,2,2
4063,6,2,14148,14148,14150,0,2,4
4064,1,1,14149,14150,14151,1,2,0
4065,6,3,14155,14155,14158,0,3,4
4066,4,3,14159,14159,14162,0,3,1
4067,5,2,14164,14164,14166,0,2,2
4068,1,1,14165,14166,14167,1,2,0
4069,1,3,14166,14167,14170,1,4,0
4070,3,2,14169,14170,14172,1,3,0
4071,6,1,14175,14175,14176,0,1,3
4072,4,2,14179,14179,14181,0,2,3
4073,4,3,14183,14183,14186,0,3,2
4074,1,1,14184,14186,14187,2,3,0
4075,2,1,14186,14187,14188,1,2,0
4076,3,1,14189,14189,14190,0,1,1
4077,1,1,14190,14190,14191,0,1,0
4078,5,1,14195,14195,14196,0,1,4
4079,4,2,14199,14199,14201,0,2,3
4080,6,1,14205,14205,14206,0,1,4
4081,2,1,14207,14207,14208,0,1,1
4082,5,2,14212,14212,14214,0,2,4
4083,3,1,14215,14215,14216,0,1,1
4084,5,1,14220,14220,14221,0,1,4
4085,3,3,14223,14223,14226,0,3,2
4086,1,2,14224,14226,14228,2,4,0
4087,3,3,14227,14228,14231,1,4,0
4088,6,3,14233,14233,14236,0,3,2
4089,6,3,14239,14239,14242,0,3,3
4090,3,1,14242,14242,14243,0,1,0
4091,3,1,14245,14245,14246,0,1,2
4092,6,3,14251,14251,14254,0,3,5
4093,5,2,14256,14256,14258,0,2,2
4094,6,2,14262,14262,14264,0,2,4
4095,4,1,14266,14266,14267,0,1,2
4096,6,2,14272,14272,14274,0,2,5
4097,2,3,14274,14274,14277,0,3,0
4098,5,2,14279,14279,14281,0,2,2
4099,2,2,14281,14281,14283,0,2,0
4100,6,1,14287,14287,14288,0,1,4
4101,4,1,14291,14291,14292,0,1,3
4102,2,1,14293,14293,14294,0,1,1
4103,3,1,14296,14296,14297,0,1,2
4104,5,3,14301,14301,14304,0,3,4
4105,5,1,14306,14306,14307,0,1,2
4106,3,2,14309,14309,14311,0,2,2
4107,1,3,14310,14311,14314,1,4,0
4108,3,3,14313,14314,14317,1,4,0
4109,6,2,14319,14319,14321,0,2,2
4110,4,2,14323,14323,14325,0,2,2
4111,2,1,14325,14325,14326,0,1,0
4112,1,2,14326,14326,14328,0,2,0
4113,1,3,14327,14328,14331,1,4,0
4114,4,2,14331,14331,14333,0,2,0
4115,5,2,14336,14336,14338,0,2,3
4116,2,2,14338,14338,14340,0,2,0
4117,3,3,14341,14341,14344,0,3,1
4118,4,3,14345,14345,14348,0,3,1
4119,5,3,14350,14350,14353,0,3,2
4120,4,1,14354,14354,14355,0,1,1
4121,2,1,14356,14356,14357,0,1,1
4122,5,2,14361,14361,14363,0,2,4
4123,1,2,14362,14363,14365,1,3,0
4124,3,1,14365,14365,14366,0,1,0
4125,3,2,14368,14368,14370,0,2,2
4126,5,2,14373,14373,14375,0,2,3
4127,1,1,14374,14375,14376,1,2,0
4128,2,2,14376,14376,14378,0,2,0
4129,2,2,14378,14378,14380,0,2,0
4130,4,3,14382,14382,14385,0,3,2
4131,2,3,14384,14385,14388,1,4,0
4132,2,3,14386,14388,14391,2,5,0
4133,5,3,14391,14391,14394,0,3,0
4134,6,2,14397,14397,14399,0,2,3
4135,4,1,14401,14401,14402,0,1,2
4136,3,2,14404,14404,14406,0,2,2
4137,1,1,14405,14406,14407,1,2,0
4138,3,3,14408,14408,14411,0,3,1
4139,3,1,14411,14411,14412,0,1,0
4140,2,1,14413,14413,14414,0,1,1
4141,4,2,14417,14417,14419,0,2,3
4142,3,1,14420,14420,14421,0,1,1
4143,4,1,14424,14424,14425,0,1,3
4144,4,2,14428,14428,14430,0,2,3
4145,2,1,14430,14430,14431,0,1,0
4146,3,1,14433,14433,14434,0,1,2
4147,1,2,14434,14434,14436,0,2,0
4148,2,1,14436,14436,14437,0,1,0
4149,3,2,14439,14439,14441,0,2,2
4150,4,3,14443,14443,14446,0,3,2
4151,6,1,14449,14449,14450,0,1,3
4152,5,2,14454,14454,14456,0,2,4
4153,2,1,14456,14456,14457,0,1,0
4154,5,2,14461,14461,14463,0,2,4
4155,5,2,14466,14466,14468,0,2,3
4156,4,1,14470,14470,14471,0,1,2
4157,3,3,14473,14473,14476,0,3,2
4158,1,2,14474,14476,14478,2,4,0
4159,3,3,14477,14478,14481,1,4,0
4160,1,1,14478,14481,14482,3,4,0
4161,5,3,14483,14483,14486,0,3,1
4162,6,2,14489,14489,14491,0,2,3
4163,6,1,14495,14495,14496,0,1,4
4164,4,3,14499,14499,14502,0,3,3
4165,2,3,14501,14502,14505,1,4,0
4166,1,3,14502,14505,14508,3,6,0
4167,5,2,14507,14508,14510,1,3,0
4168,4,2,14511,14511,14513,0,2,1
4169,6,2,14517,14517,14519,0,2,4
4170,5,1,14522,14522,14523,0,1,3
4171,3,1,14525,14525,14526,0,1,2
4172,3,3,14528,14528,14531,0,3,2
4173,4,2,14532,14532,14534,0,2,1
4174,6,1,14538,14538,14539,0,1,4
4175,5,3,14543,14543,14546,0,3,4
4176,5,2,14548,14548,14550,0,2,2
4177,3,2,14551,14551,14553,0,2,1
4178,6,3,14557,14557,14560,0,3,4
4179,4,2,14561,14561,14563,0,2,1
4180,4,3,14565,14565,14568,0,3,2
4181,5,3,14570,14570,14573,0,3,2
4182,3,3,14573,14573,14576,0,3,0
4183,6,3,14579,14579,14582,0,3,3
4184,2,1,14581,14582,14583,1,2,0
4185,1,1,14582,14583,14584,1,2,0
4186,2,2,14584,14584,14586,0,2,0
4187,6,1,14590,14590,14591,0,1,4
4188,4,1,14594,14594,14595,0,1,3
4189,2,3,14596,14596,14599,0,3,1
4190,3,1,14599,14599,14600,0,1,0
4191,1,3,14600,14600,14603,0,3,0
4192,2,2,14602,14603,14605,1,3,0
4193,3,2,14605,14605,14607,0,2,0
4194,6,3,14611,14611,14614,0,3,4
4195,2,2,14613,14614,14616,1,3,0
4196,6,1,14619,14619,14620,0,1,3
4197,3,1,14622,14622,14623,0,1,2
4198,4,3,14626,14626,14629,0,3,3
4199,2,1,14628,14629,14630,1,2,0
4200,4,1,14632,14632,14633,0,1,2
4201,6,1,14638,14638,14639,0,1,5
4202,2,2,14640,14640,14642,0,2,1
4203,4,3,14644,14644,14647,0,3,2
4204,1,1,14645,14647,14648,2,3,0
4205,3,3,14648,14648,14651,0,3,0
4206,6,3,14654,14654,14657,0,3,3
4207,5,3,14659,14659,14662,0,3,2
4208,4,1,14663,14663,14664,0,1,1
4209,4,1,14667,14667,14668,0,1,3
4210,2,3,14669,14669,14672,0,3,1
4211,6,3,14675,14675,14678,0,3,3
4212,3,2,14678,14678,14680,0,2,0
4213,5,2,14683,14683,14685,0,2,3
4214,1,3,14684,14685,14688,1,4,0
4215,6,1,14690,14690,14691,0,1,2
4216,3,2,14693,14693,14695,0,2,2
4217,3,1,14696,14696,14697,0,1,1
4218,3,2,14699,14699,14701,0,2,2
4219,6,2,14705,14705,14707,0,2,4
4220,2,1,14707,14707,14708,0,1,0
4221,5,1,14712,14712,14713,0,1,4
4222,6,2,14718,14718,14720,0,2,5
4223,2,2,14720,14720,14722,0,2,0
4224,2,2,14722,14722,14724,0,2,0
4225,3,3,14725,14725,14728,0,3,1
4226,2,1,14727,14728,14729,1,2,0
4227,1,2,14728,14729,14731,1,3,0
4228,2,2,14730,14731,14733,1,3,0
4229,2,1,14732,14733,14734,1,2,0
4230,4,3,14736,14736,14739,0,3,2
4231,5,1,14741,14741,14742,0,1,2
4232,4,2,14745,14745,14747,0,2,3
4233,2,2,14747,14747,14749,0,2,0
4234,3,2,14750,14750,14752,0,2,1
4235,2,2,14752,14752,14754,0,2,0
4236,1,2,14753,14754,14756,1,3,0
4237,2,1,14755,14756,14757,1,2,0
4238,6,2,14761,14761,14763,0,2,4
4239,2,1,14763,14763,14764,0,1,0
4240,4,1,14767,14767,14768,0,1,3
4241,3,2,14770,14770,14772,0,2,2
4242,1,3,14771,14772,14775,1,4,0
4243,3,3,14774,14775,14778,1,4,0
4244,5,2,14779,14779,14781,0,2,1
4245,3,3,14782,14782,14785,0,3,1
4246,2,2,14784,14785,14787,1,3,0
4247,6,3,14790,14790,14793,0,3,3
4248,6,1,14796,14796,14797,0,1,3
4249,6,3,14802,14802,14805,0,3,5
4250,5,2,14807,14807,14809,0,2,2
4251,2,2,14809,14809,14811,0,2,0
4252,5,3,14814,14814,14817,0,3,3
4253,1,1,14815,14817,14818,2,3,0
4254,4,1,14819,14819,14820,0,1,1
4255,5,2,14824,14824,14826,0,2,4
4256,6,3,14830,14830,14833,0,3,4
4257,2,2,14832,14833,14835,1,3,0
4258,6,3,14838,14838,14841,0,3,3
4259,5,1,14843,14843,14844,0,1,2
4260,4,3,14847,14847,14850,0,3,3
4261,3,3,14850,14850,14853,0,3,0
4262,6,3,14856,14856,14859,0,3,3
4263,3,1,14859,14859,14860,0,1,0
4264,4,2,14863,14863,14865,0,2,3
4265,6,2,14869,14869,14871,0,2,4
4266,6,2,14875,14875,14877,0,2,4
4267,4,3,14879,14879,14882,0,3,2
4268,5,1,14884,14884,14885,0,1,2
4269,4,3,14888,14888,14891,0,3,3
4270,5,2,14893,14893,14895,0,2,2
4271,4,1,14897,14897,14898,0,1,2
4272,6,2,14903,14903,14905,0,2,5
4273,3,1,14906,14906,14907,0,1,1
4274,2,1,14908,14908,14909,0,1,1
4275,3,1,14911,14911,14912,0,1,2
4276,5,3,14916,14916,14919,0,3,4
4277,2,3,14918,14919,14922,1,4,0
4278,2,3,14920,14922,14925,2,5,0
4279,2,1,14922,14925,14926,3,4,0
4280,5,2,14927,14927,14929,0,2,1
4281,5,3,14932,14932,14935,0,3,3
4282,3,2,14935,14935,14937,0,2,0
4283,6,3,14941,14941,14944,0,3,4
4284,6,1,14947,14947,14948,0,1,3
4285,2,2,14949,14949,14951,0,2,1
4286,3,2,14952,14952,14954,0,2,1
4287,6,2,14958,14958,14960,0,2,4
4288,6,2,14964,14964,14966,0,2,4
4289,3,1,14967,14967,14968,0,1,1
4290,4,2,14971,14971,14973,0,2,3
4291,3,2,14974,14974,14976,0,2,1
4292,2,3,14976,14976,14979,0,3,0
4293,3,2,14979,14979,14981,0,2,0
4294,5,3,14984,14984,14987,0,3,3
4295,4,2,14988,14988,14990,0,2,1
4296,2,1,14990,14990,14991,0,1,0
4297,1,3,14991,14991,14994,0,3,0
4298,6,2,14997,14997,14999,0,2,3
4299,5,3,15002,15002,15005,0,3,3
4300,3,2,15005,15005,15007,0,2,0
4301,1,3,15006,15007,15010,1,4,0
4302,4,3,15010,15010,15013,0,3,0
4303,3,2,15013,15013,15015,0,2,0
4304,1,2,15014,15015,15017,1,3,0
4305,4,3,15018,15018,15021,0,3,1
4306,2,2,15020,15021,15023,1,3,0
4307,1,1,15021,15023,15024,2,3,0
4308,4,2,15025,15025,15027,0,2,1
4309,1,3,15026,15027,15030,1,4,0
4310,3,1,15029,15030,15031,1,2,0
4311,2,1,15031,15031,15032,0,1,0
4312,2,1,15033,15033,15034,0,1,1
4313,3,3,15036,15036,15039,0,3,2
4314,6,1,15042,15042,15043,0,1,3
4315,6,1,15048,15048,15049,0,1,5
4316,3,2,15051,15051,15053,0,2,2
4317,1,1,15052,15053,15054,1,2,0
4318,4,1,15056,15056,15057,0,1,2
4319,6,3,15062,15062,15065,0,3,5
4320,5,3,15067,15067,15070,0,3,2
4321,2,3,15069,15070,15073,1,4,0
4322,5,3,15074,15074,15077,0,3,1
4323,6,3,15080,15080,15083,0,3,3
4324,6,1,15086,15086,15087,0,1,3
4325,4,2,15090,15090,15092,0,2,3
4326,6,2,15096,15096,15098,0,2,4
4327,1,1,15097,15098,15099,1,2,0
4328,6,2,15103,15103,15105,0,2,4
4329,3,3,15106,15106,15109,0,3,1
4330,1,1,15107,15109,15110,2,3,0
4331,1,3,15108,15110,15113,2,5,0
4332,5,2,15113,15113,15115,0,2,0
4333,6,3,15119,15119,15122,0,3,4
4334,6,1,15125,15125,15126,0,1,3
4335,3,1,15128,15128,15129,0,1,2
4336,3,3,15131,15131,15134,0,3,2
4337,4,3,15135,15135,15138,0,3,1
4338,6,1,15141,15141,15142,0,1,3
4339,5,2,15146,15146,15148,0,2,4
4340,3,2,15149,15149,15151,0,2,1
4341,1,2,15150,15151,15153,1,3,0
4342,5,1,15155,15155,15156,0,1,2
4343,1,1,15156,15156,15157,0,1,0
4344,1,1,15157,15157,15158,0,1,0
4345,2,2,15159,15159,15161,0,2,1
4346,3,3,15162,15162,15165,0,3,1
4347,6,2,15168,15168,15170,0,2,3
4348,2,2,15170,15170,15172,0,2,0
4349,3,3,15173,15173,15176,0,3,1
4350,1,3,15174,15176,15179,2,5,0
4351,2,1,15176,15179,15180,3,4,0
4352,5,2,15181,15181,15183,0,2,1
4353,5,1,15186,15186,15187,0,1,3
4354,6,3,15192,15192,15195,0,3,5
4355,1,3,15193,15195,15198,2,5,0
4356,4,1,15197,15198,15199,1,2,0
4357,2,1,15199,15199,15200,0,1,0
4358,1,2,15200,15200,15202,0,2,0
4359,4,1,15204,15204,15205,0,1,2
4360,6,3,15210,15210,15213,0,3,5
4361,3,3,15213,15213,15216,0,3,0
4362,3,3,15216,15216,15219,0,3,0
4363,5,2,15221,15221,15223,0,2,2
4364,2,2,15223,15223,15225,0,2,0
4365,5,1,15228,15228,15229,0,1,3
4366,1,1,15229,15229,15230,0,1,0
4367,5,2,15234,15234,15236,0,2,4
4368,3,2,15237,15237,15239,0,2,1
4369,2,2,15239,15239,15241,0,2,0
4370,2,1,15241,15241,15242,0,1,0
4371,5,1,15246,15246,15247,0,1,4
4372,1,2,15247,15247,15249,0,2,0
4373,4,3,15251,15251,15254,0,3,2
4374,6,3,15257,15257,15260,0,3,3
4375,5,2,15262,15262,15264,0,2,2
4376,4,2,15266,15266,15268,0,2,2
4377,4,3,15270,15270,15273,0,3,2
4378,3,3,15273,15273,15276,0,3,0
4379,3,3,15276,15276,15279,0,3,0
4380,4,2,15280,15280,15282,0,2,1
4381,4,1,15284,15284,15285,0,1,2
4382,2,3,15286,15286,15289,0,3,1
4383,3,1,15289,15289,15290,0,1,0
4384,6,3,15295,15295,15298,0,3,5
4385,5,3,15300,15300,15303,0,3,2
4386,6,3,15306,15306,15309,0,3,3
4387,5,1,15311,15311,15312,0,1,2
4388,2,1,15313,15313,15314,0,1,1
4389,6,3,15319,15319,15322,0,3,5
4390,4,1,15323,15323,15324,0,1,1
4391,6,1,15329,15329,15330,0,1,5
4392,4,3,15333,15333,15336,0,3,3
4393,5,2,15338,15338,15340,0,2,2
4394,2,2,15340,15340,15342,0,2,0
4395,5,3,15345,15345,15348,0,3,3
4396,4,3,15349,15349,15352,0,3,1
4397,5,1,15354,15354,15355,0,1,2
4398,4,2,15358,15358,15360,0,2,3
4399,2,1,15360,15360,15361,0,1,0
4400,5,3,15365,15365,15368,0,3,4
4401,2,3,15367,15368,15371,1,4,0
4402,6,2,15373,15373,15375,0,2,2
4403,4,1,15377,15377,15378,0,1,2
4404,3,3,15380,15380,15383,0,3,2
4405,2,1,15382,15383,15384,1,2,0
4406,3,3,15385,15385,15388,0,3,1
4407,2,2,15387,15388,15390,1,3,0
4408,4,1,15391,15391,15392,0,1,1
4409,6,3,15397,15397,15400,0,3,5
4410,5,1,15402,15402,15403,0,1,2
4411,3,3,15405,15405,15408,0,3,2
4412,2,2,15407,15408,15410,1,3,0
4413,1,3,15408,15410,15413,2,5,0
4414,6,3,15414,15414,15417,0,3,1
4415,4,2,15418,15418,15420,0,2,1
4416,3,1,15421,15421,15422,0,1,1
4417,6,3,15427,15427,15430,0,3,5
4418,1,1,15428,15430,15431,2,3,0
4419,2,3,15430,15431,15434,1,4,0
4420,1,2,15431,15434,15436,3,5,0
4421,4,2,15435,15436,15438,1,3,0
4422,6,2,15441,15441,15443,0,2,3
4423,4,3,15445,15445,15448,0,3,2
4424,2,3,15447,15448,15451,1,4,0
4425,5,1,15452,15452,15453,0,1,1
4426,5,1,15457,15457,15458,0,1,4
4427,6,1,15463,15463,15464,0,1,5
4428,5,2,15468,15468,15470,0,2,4
4429,6,1,15474,15474,15475,0,1,4
4430,1,3,15475,15475,15478,0,3,0
4431,1,2,15476,15478,15480,2,4,0
4432,5,1,15481,15481,15482,0,1,1
4433,6,3,15487,15487,15490,0,3,5
4434,3,1,15490,15490,15491,0,1,0
4435,6,3,15496,15496,15499,0,3,5
4436,3,2,15499,15499,15501,0,2,0
4437,2,3,15501,15501,15504,0,3,0
4438,3,1,15504,15504,15505,0,1,0
4439,6,2,15510,15510,15512,0,2,5
4440,5,1,15515,15515,15516,0,1,3
4441,3,1,15518,15518,15519,0,1,2
4442,5,1,15523,15523,15524,0,1,4
4443,5,1,15528,15528,15529,0,1,4
4444,1,2,15529,15529,15531,0,2,0
4445,5,3,15534,15534,15537,0,3,3
4446,6,1,15540,15540,15541,0,1,3
4447,4,3,15544,15544,15547,0,3,3
4448,3,2,15547,15547,15549,0,2,0
4449,3,3,15550,15550,15553,0,3,1
4450,3,2,15553,15553,15555,0,2,0
4451,5,1,15558,15558,15559,0,1,3
4452,4,3,15562,15562,15565,0,3,3
4453,4,1,15566,15566,15567,0,1,1
4454,2,2,15568,15568,15570,0,2,1
4455,1,1,15569,15570,15571,1,2,0
4456,5,2,15574,15574,15576,0,2,3
4457,5,1,15579,15579,15580,0,1,3
4458,4,2,15583,15583,15585,0,2,3
4459,6,3,15589,15589,15592,0,3,4
4460,1,1,15590,15592,15593,2,3,0
4461,5,1,15595,15595,15596,0,1,2
4462,4,3,15599,15599,15602,0,3,3
4463,3,1,15602,15602,15603,0,1,0
4464,6,3,15608,15608,15611,0,3,5
4465,4,3,15612,15612,15615,0,3,1
4466,3,3,15615,15615,15618,0,3,0
4467,2,1,15617,15618,15619,1,2,0
4468,2,3,15619,15619,15622,0,3,0
4469,2,3,15621,15622,15625,1,4,0
4470,2,1,15623,15625,15626,2,3,0
4471,5,2,15628,15628,15630,0,2,2
4472,2,1,15630,15630,15631,0,1,0
4473,1,2,15631,15631,15633,0,2,0
4474,3,1,15634,15634,15635,0,1,1
4475,1,2,15635,15635,15637,0,2,0
4476,6,3,15641,15641,15644,0,3,4
4477,2,2,15643,15644,15646,1,3,0
4478,5,2,15648,15648,15650,0,2,2
4479,4,2,15652,15652,15654,0,2,2
4480,5,3,15657,15657,15660,0,3,3
4481,5,3,15662,15662,15665,0,3,2
4482,1,1,15663,15665,15666,2,3,0
4483,1,1,15664,15666,15667,2,3,0
4484,4,1,15668,15668,15669,0,1,1
4485,3,1,15671,15671,15672,0,1,2
4486,2,2,15673,15673,15675,0,2,1
4487,6,2,15679,15679,15681,0,2,4
4488,6,2,15685,15685,15687,0,2,4
4489,5,3,15690,15690,15693,0,3,3
4490,1,3,15691,15693,15696,2,5,0
4491,1,3,15692,15696,15699,4,7,0
4492,4,2,15696,15699,15701,3,5,0
4493,4,2,15700,15701,15703,1,3,0
4494,5,1,15705,15705,15706,0,1,2
4495,5,1,15710,15710,15711,0,1,4
4496,6,1,15716,15716,15717,0,1,5
4497,2,1,15718,15718,15719,0,1,1
4498,6,2,15724,15724,15726,0,2,5
4499,2,2,15726,15726,15728,0,2,0
4500,2,2,15728,15728,15730,0,2,0
4501,1,1,15729,15730,15731,1,2,0
4502,5,1,15734,15734,15735,0,1,3
4503,6,2,15740,15740,15742,0,2,5
4504,1,3,15741,15742,15745,1,4,0
4505,4,2,15745,15745,15747,0,2,0
4506,3,2,15748,15748,15750,0,2,1
4507,5,3,15753,15753,15756,0,3,3
4508,3,1,15756,15756,15757,0,1,0
4509,6,1,15762,15762,15763,0,1,5
4510,4,3,15766,15766,15769,0,3,3
4511,5,1,15771,15771,15772,0,1,2
4512,3,1,15774,15774,15775,0,1,2
4513,3,3,15777,15777,15780,0,3,2
4514,2,3,15779,15780,15783,1,4,0
4515,4,1,15783,15783,15784,0,1,0
4516,4,3,15787,15787,15790,0,3,3
4517,6,3,15793,15793,15796,0,3,3
4518,1,3,15794,15796,15799,2,5,0
4519,1,2,15795,15799,15801,4,6,0
4520,1,1,15796,15801,15802,5,6,0
4521,2,1,15798,15802,15803,4,5,0
4522,4,2,15802,15803,15805,1,3,0
4523,2,2,15804,15805,15807,1,3,0
4524,6,3,15810,15810,15813,0,3,3
4525,5,1,15815,15815,15816,0,1,2
4526,4,3,15819,15819,15822,0,3,3
4527,4,3,15823,15823,15826,0,3,1
4528,6,2,15829,15829,15831,0,2,3
4529,6,1,15835,15835,15836,0,1,4
4530,1,1,15836,15836,15837,0,1,0
4531,3,1,15839,15839,15840,0,1,2
4532,4,3,15843,15843,15846,0,3,3
4533,1,2,15844,15846,15848,2,4,0
4534,5,1,15849,15849,15850,0,1,1
4535,5,2,15854,15854,15856,0,2,4
4536,1,3,15855,15856,15859,1,4,0
4537,4,2,15859,15859,15861,0,2,0
4538,1,1,15860,15861,15862,1,2,0
4539,1,1,15861,15862,15863,1,2,0
4540,3,2,15864,15864,15866,0,2,1
4541,5,1,15869,15869,15870,0,1,3
4542,5,3,15874,15874,15877,0,3,4
4543,1,1,15875,15877,15878,2,3,0
4544,5,2,15880,15880,15882,0,2,2
4545,6,2,15886,15886,15888,0,2,4
4546,4,2,15890,15890,15892,0,2,2
4547,1,3,15891,15892,15895,1,4,0
4548,3,1,15894,15895,15896,1,2,0
4549,6,1,15900,15900,15901,0,1,4
4550,3,1,15903,15903,15904,0,1,2
4551,6,3,15909,15909,15912,0,3,5
4552,4,3,15913,15913,15916,0,3,1
4553,4,3,15917,15917,15920,0,3,1
4554,1,3,15918,15920,15923,2,5,0
4555,6,1,15924,15924,15925,0,1,1
4556,5,2,15929,15929,15931,0,2,4
4557,1,3,15930,15931,15934,1,4,0
4558,6,3,15936,15936,15939,0,3,2
4559,5,1,15941,15941,15942,0,1,2
4560,1,3,15942,15942,15945,0,3,0
4561,4,2,15946,15946,15948,0,2,1
4562,4,2,15950,15950,15952,0,2,2
4563,1,1,15951,15952,15953,1,2,0
4564,6,3,15957,15957,15960,0,3,4
4565,4,1,15961,15961,15962,0,1,1
4566,2,2,15963,15963,15965,0,2,1
4567,4,2,15967,15967,15969,0,2,2
4568,6,3,15973,15973,15976,0,3,4
4569,2,3,15975,15976,15979,1,4,0
4570,3,1,15978,15979,15980,1,2,0
4571,5,2,15983,15983,15985,0,2,3
4572,3,1,15986,15986,15987,0,1,1
4573,3,3,15989,15989,15992,0,3,2
4574,4,1,15993,15993,15994,0,1,1
4575,4,1,15997,15997,15998,0,1,3
4576,1,1,15998,15998,15999,0,1,0
4577,6,3,16004,16004,16007,0,3,5
4578,4,1,16008,16008,16009,0,1,1
4579,1,2,16009,16009,16011,0,2,0
4580,4,3,16013,16013,16016,0,3,2
4581,1,2,16014,16016,16018,2,4,0
4582,1,3,16015,16018,16021,3,6,0
4583,5,1,16020,16021,16022,1,2,0
4584,6,1,16026,16026,16027,0,1,4
4585,5,1,16031,16031,16032,0,1,4
4586,5,1,16036,16036,16037,0,1,4
4587,4,3,16040,16040,16043,0,3,3
4588,1,3,16041,16043,16046,2,5,0
4589,2,1,16043,16046,16047,3,4,0
4590,5,3,16048,16048,16051,0,3,1
4591,4,2,16052,16052,16054,0,2,1
4592,6,1,16058,16058,16059,0,1,4
4593,4,1,16062,16062,16063,0,1,3
4594,5,2,16067,16067,16069,0,2,4
4595,3,3,16070,16070,16073,0,3,1
4596,5,1,16075,16075,16076,0,1,2
4597,4,1,16079,16079,16080,0,1,3
4598,2,2,16081,16081,16083,0,2,1
4599,3,1,16084,16084,16085,0,1,1
4600,5,3,16089,16089,16092,0,3,4
4601,6,1,16095,16095,16096,0,1,3
4602,4,1,16099,16099,16100,0,1,3
4603,4,3,16103,16103,16106,0,3,3
4604,4,3,16107,16107,16110,0,3,1
4605,3,3,16110,16110,16113,0,3,0
4606,1,3,16111,16113,16116,2,5,0
4607,6,2,16117,16117,16119,0,2,1
4608,2,1,16119,16119,16120,0,1,0
4609,2,2,16121,16121,16123,0,2,1
4610,5,1,16126,16126,16127,0,1,3
4611,5,2,16131,16131,16133,0,2,4
4612,2,1,16133,16133,16134,0,1,0
4613,2,2,16135,16135,16137,0,2,1
4614,1,2,16136,16137,16139,1,3,0
4615,1,3,16137,16139,16142,2,5,0
4616,4,2,16141,16142,16144,1,3,0
4617,3,1,16144,16144,16145,0,1,0
4618,2,2,16146,16146,16148,0,2,1
4619,6,2,16152,16152,16154,0,2,4
4620,6,3,16158,16158,16161,0,3,4
4621,1,3,16159,16161,16164,2,5,0
4622,5,1,16164,16164,16165,0,1,0
4623,3,3,16167,16167,16170,0,3,2
4624,6,3,16173,16173,16176,0,3,3
4625,1,1,16174,16176,16177,2,3,0
4626,3,1,16177,16177,16178,0,1,0
4627,4,3,16181,16181,16184,0,3,3
4628,2,3,16183,16184,16187,1,4,0
4629,6,3,16189,16189,16192,0,3,2
4630,6,1,16195,16195,16196,0,1,3
4631,1,2,16196,16196,16198,0,2,0
4632,4,1,16200,16200,16201,0,1,2
4633,2,1,16202,16202,16203,0,1,1
4634,2,3,16204,16204,16207,0,3,1
4635,2,1,16206,16207,16208,1,2,0
4636,4,1,16210,16210,16211,0,1,2
4637,2,1,16212,16212,16213,0,1,1
4638,3,2,16215,16215,16217,0,2,2
4639,2,2,16217,16217,16219,0,2,0
4640,6,2,16223,16223,16225,0,2,4
4641,3,2,16226,16226,16228,0,2,1
4642,4,3,16230,16230,16233,0,3,2
4643,2,1,16232,16233,16234,1,2,0
4644,1,1,16233,16234,16235,1,2,0
4645,6,1,16239,16239,16240,0,1,4
4646,2,2,16241,16241,16243,0,2,1
4647,1,3,16242,16243,16246,1,4,0
4648,6,3,16248,16248,16251,0,3,2
4649,2,2,16250,16251,16253,1,3,0
4650,2,1,16252,16253,16254,1,2,0
4651,5,1,16257,16257,16258,0,1,3
4652,6,1,16263,16263,16264,0,1,5
4653,1,2,16264,16264,16266,0,2,0
4654,3,3,16267,16267,16270,0,3,1
4655,2,1,16269,16270,16271,1,2,0
4656,4,3,16273,16273,16276,0,3,2
4657,5,2,16278,16278,16280,0,2,2
4658,2,1,16280,16280,16281,0,1,0
4659,3,2,16283,16283,16285,0,2,2
4660,1,2,16284,16285,16287,1,3,0
4661,3,1,16287,16287,16288,0,1,0
4662,2,2,16289,16289,16291,0,2,1
4663,6,3,16295,16295,16298,0,3,4
4664,1,2,16296,16298,16300,2,4,0
4665,5,2,16301,16301,16303,0,2,1
4666,4,2,16305,16305,16307,0,2,2
4667,1,2,16306,16307,16309,1,3,0
4668,3,3,16309,16309,16312,0,3,0
4669,4,2,16313,16313,16315,0,2,1
4670,1,3,16314,16315,16318,1,4,0
4671,2,3,16316,16318,16321,2,5,0
4672,5,3,16321,16321,16324,0,3,0
4673,2,2,16323,16324,16326,1,3,0
4674,3,3,16326,16326,16329,0,3,0
4675,1,2,16327,16329,16331,2,4,0
4676,5,1,16332,16332,16333,0,1,1
4677,2,2,16334,16334,16336,0,2,1
4678,4,3,16338,16338,16341,0,3,2
4679,6,1,16344,16344,16345,0,1,3
4680,5,1,16349,16349,16350,0,1,4
4681,6,1,16355,16355,16356,0,1,5
4682,5,1,16360,16360,16361,0,1,4
4683,3,1,16363,16363,16364,0,1,2
4684,5,3,16368,16368,16371,0,3,4
4685,3,1,16371,16371,16372,0,1,0
4686,3,1,16374,16374,16375,0,1,2
4687,3,2,16377,16377,16379,0,2,2
4688,3,1,16380,16380,16381,0,1,1
4689,5,2,16385,16385,16387,0,2,4
4690,6,2,16391,16391,16393,0,2,4
4691,1,2,16392,16393,16395,1,3,0
4692,4,2,16396,16396,16398,0,2,1
4693,4,3,16400,16400,16403,0,3,2
4694,3,1,16403,16403,16404,0,1,0
4695,2,2,16405,16405,16407,0,2,1
4696,4,3,16409,16409,16412,0,3,2
4697,6,3,16415,16415,16418,0,3,3
4698,1,2,16416,16418,16420,2,4,0
4699,1,3,16417,16420,16423,3,6,0
4700,6,2,16423,16423,16425,0,2,0
4701,1,1,16424,16425,16426,1,2,0
4702,6,2,16430,16430,16432,0,2,4
4703,5,2,16435,16435,16437,0,2,3
4704,5,2,16440,16440,16442,0,2,3
4705,5,1,16445,16445,16446,0,1,3
4706,5,1,16450,16450,16451,0,1,4
4707,4,1,16454,16454,16455,0,1,3
4708,3,3,16457,16457,16460,0,3,2
4709,1,1,16458,16460,16461,2,3,0
4710,4,2,16462,16462,16464,0,2,1
4711,4,2,16466,16466,16468,0,2,2
4712,2,1,16468,16468,16469,0,1,0
4713,3,1,16471,16471,16472,0,1,2
4714,4,3,16475,16475,16478,0,3,3
4715,5,1,16480,16480,16481,0,1,2
4716,3,3,16483,16483,16486,0,3,2
4717,2,1,16485,16486,16487,1,2,0
4718,3,1,16488,16488,16489,0,1,1
4719,1,1,16489,16489,16490,0,1,0
4720,5,2,16494,16494,16496,0,2,4
4721,5,1,16499,16499,16500,0,1,3
4722,5,2,16504,16504,16506,0,2,4
4723,2,2,16506,16506,16508,0,2,0
4724,2,3,16508,16508,16511,0,3,0
4725,2,3,16510,16511,16514,1,4,0
4726,6,2,16516,16516,16518,0,2,2
4727,1,2,16517,16518,16520,1,3,0
4728,3,1,16520,16520,16521,0,1,0
4729,2,2,16522,16522,16524,0,2,1
4730,2,3,16524,16524,16527,0,3,0
4731,4,1,16528,16528,16529,0,1,1
4732,6,2,16534,16534,16536,0,2,5
4733,2,1,16536,16536,16537,0,1,0
4734,3,1,16539,16539,16540,0,1,2
4735,5,3,16544,16544,16547,0,3,4
4736,2,1,16546,16547,16548,1,2,0
4737,5,1,16551,16551,16552,0,1,3
4738,3,1,16554,16554,16555,0,1,2
4739,1,1,16555,16555,16556,0,1,0
4740,1,3,16556,16556,16559,0,3,0
4741,2,3,16558,16559,16562,1,4,0
4742,1,3,16559,16562,16565,3,6,0
4743,6,2,16565,16565,16567,0,2,0
4744,6,1,16571,16571,16572,0,1,4
4745,5,2,16576,16576,16578,0,2,4
4746,5,2,16581,16581,16583,0,2,3
4747,2,2,16583,16583,16585,0,2,0
4748,3,1,16586,16586,16587,0,1,1
4749,3,3,16589,16589,16592,0,3,2
4750,5,1,16594,16594,16595,0,1,2
4751,2,1,16596,16596,16597,0,1,1
4752,6,2,16602,16602,16604,0,2,5
4753,4,1,16606,16606,16607,0,1,2
4754,4,3,16610,16610,16613,0,3,3
4755,2,2,16612,16613,16615,1,3,0
4756,6,3,16618,16618,16621,0,3,3
4757,3,3,16621,16621,16624,0,3,0
4758,4,2,16625,16625,16627,0,2,1
4759,6,2,16631,16631,16633,0,2,4
4760,1,2,16632,16633,16635,1,3,0
4761,1,2,16633,16635,16637,2,4,0
4762,1,1,16634,16637,16638,3,4,0
4763,6,2,16640,16640,16642,0,2,2
4764,3,3,16643,16643,16646,0,3,1
4765,1,3,16644,16646,16649,2,5,0
4766,1,2,16645,16649,16651,4,6,0
4767,2,2,16647,16651,16653,4,6,0
4768,1,3,16648,16653,16656,5,8,0
4769,4,3,16652,16656,16659,4,7,0
4770,1,1,16653,16659,16660,6,7,0
4771,4,3,16657,16660,16663,3,6,0
4772,2,3,16659,16663,16666,4,7,0
4773,4,3,16663,16666,16669,3,6,0
4774,1,1,16664,16669,16670,5,6,0
4775,3,3,16667,16670,16673,3,6,0
4776,5,3,16672,16673,16676,1,4,0
4777,4,2,16676,16676,16678,0,2,0
4778,2,2,16678,16678,16680,0,2,0
4779,4,3,16682,16682,16685,0,3,2
4780,2,2,16684,16685,16687,1,3,0
4781,5,2,16689,16689,16691,0,2,2
4782,6,1,16695,16695,16696,0,1,4
4783,5,2,16700,16700,16702,0,2,4
4784,2,3,16702,16702,16705,0,3,0
4785,2,2,16704,16705,16707,1,3,0
4786,6,2,16710,16710,16712,0,2,3
4787,4,1,16714,16714,16715,0,1,2
4788,3,2,16717,16717,16719,0,2,2
4789,4,2,16721,16721,16723,0,2,2
4790,2,3,16723,16723,16726,0,3,0
4791,5,1,16728,16728,16729,0,1,2
4792,4,2,16732,16732,16734,0,2,3
4793,1,1,16733,16734,16735,1,2,0
4794,4,1,16737,16737,16738,0,1,2
4795,6,2,16743,16743,16745,0,2,5
4796,4,1,16747,16747,16748,0,1,2
4797,1,1,16748,16748,16749,0,1,0
4798,5,2,16753,16753,16755,0,2,4
4799,4,3,16757,16757,16760,0,3,2
4800,3,2,16760,16760,16762,0,2,0
4801,1,3,16761,16762,16765,1,4,0
4802,1,3,16762,16765,16768,3,6,0
4803,1,1,16763,16768,16769,5,6,0
4804,5,2,16768,16769,16771,1,3,0
4805,6,2,16774,16774,16776,0,2,3
4806,5,1,16779,16779,16780,0,1,3
4807,4,3,16783,16783,16786,0,3,3
4808,3,2,16786,16786,16788,0,2,0
4809,2,3,16788,16788,16791,0,3,0
4810,3,3,16791,16791,16794,0,3,0
4811,3,3,16794,16794,16797,0,3,0
4812,1,1,16795,16797,16798,2,3,0
4813,2,1,16797,16798,16799,1,2,0
4814,5,2,16802,16802,16804,0,2,3
4815,2,1,16804,16804,16805,0,1,0
4816,5,2,16809,16809,16811,0,2,4
4817,5,2,16814,16814,16816,0,2,3
4818,4,1,16818,16818,16819,0,1,2
4819,3,1,16821,16821,16822,0,1,2
4820,1,2,16822,16822,16824,0,2,0
4821,2,3,16824,16824,16827,0,3,0
4822,5,2,16829,16829,16831,0,2,2
4823,1,1,16830,16831,16832,1,2,0
4824,3,2,16833,16833,16835,0,2,1
4825,5,1,16838,16838,16839,0,1,3
4826,3,1,16841,16841,16842,0,1,2
4827,5,1,16846,16846,16847,0,1,4
4828,4,2,16850,16850,16852,0,2,3
4829,2,2,16852,16852,16854,0,2,0
4830,2,2,16854,16854,16856,0,2,0
4831,5,1,16859,16859,16860,0,1,3
4832,6,3,16865,16865,16868,0,3,5
4833,3,3,16868,16868,16871,0,3,0
4834,2,2,16870,16871,16873,1,3,0
4835,6,1,16876,16876,16877,0,1,3
4836,5,3,16881,16881,16884,0,3,4
4837,1,1,16882,16884,16885,2,3,0
4838,1,3,16883,16885,16888,2,5,0
4839,6,2,16889,16889,16891,0,2,1
4840,2,1,16891,16891,16892,0,1,0
4841,2,3,16893,16893,16896,0,3,1
4842,4,1,16897,16897,16898,0,1,1
4843,3,3,16900,16900,16903,0,3,2
4844,4,1,16904,16904,16905,0,1,1
4845,4,3,16908,16908,16911,0,3,3
4846,6,2,16914,16914,16916,0,2,3
4847,6,1,16920,16920,16921,0,1,4
4848,5,1,16925,16925,16926,0,1,4
4849,4,2,16929,16929,16931,0,2,3
4850,5,2,16934,16934,16936,0,2,3
4851,6,2,16940,16940,16942,0,2,4
4852,2,1,16942,16942,16943,0,1,0
4853,1,1,16943,16943,16944,0,1,0
4854,1,3,16944,16944,16947,0,3,0
4855,3,2,16947,16947,16949,0,2,0
4856,2,2,16949,16949,16951,0,2,0
4857,2,3,16951,16951,16954,0,3,0
4858,3,1,16954,16954,16955,0,1,0
4859,5,2,16959,16959,16961,0,2,4
4860,1,3,16960,16961,16964,1,4,0
4861,2,1,16962,16964,16965,2,3,0
4862,1,2,16963,16965,16967,2,4,0
4863,2,1,16965,16967,16968,2,3,0
4864,2,1,16967,16968,16969,1,2,0
4865,2,3,16969,16969,16972,0,3,0
4866,5,3,16974,16974,16977,0,3,2
4867,5,3,16979,16979,16982,0,3,2
4868,2,3,16981,16982,16985,1,4,0
4869,2,1,16983,16985,16986,2,3,0
4870,2,2,16985,16986,16988,1,3,0
4871,4,1,16989,16989,16990,0,1,1
4872,3,1,16992,16992,16993,0,1,2
4873,4,1,16996,16996,16997,0,1,3
4874,5,3,17001,17001,17004,0,3,4
4875,6,3,17007,17007,17010,0,3,3
4876,2,3,17009,17010,17013,1,4,0
4877,1,3,17010,17013,17016,3,6,0
4878,4,3,17014,17016,17019,2,5,0
4879,5,3,17019,17019,17022,0,3,0
4880,3,3,17022,17022,17025,0,3,0
4881,2,2,17024,17025,17027,1,3,0
4882,2,3,17026,17027,17030,1,4,0
4883,5,2,17031,17031,17033,0,2,1
4884,5,2,17036,17036,17038,0,2,3
4885,6,1,17042,17042,17043,0,1,4
4886,1,2,17043,17043,17045,0,2,0
4887,5,2,17048,17048,17050,0,2,3
4888,3,2,17051,17051,17053,0,2,1
4889,6,3,17057,17057,17060,0,3,4
4890,1,2,17058,17060,17062,2,4,0
4891,1,3,17059,17062,17065,3,6,0
4892,5,3,17064,17065,17068,1,4,0
4893,2,3,17066,17068,17071,2,5,0
4894,5,1,17071,17071,17072,0,1,0
4895,5,2,17076,17076,17078,0,2,4
4896,2,3,17078,17078,17081,0,3,0
4897,5,2,17083,17083,17085,0,2,2
4898,3,1,17086,17086,17087,0,1,1
4899,2,2,17088,17088,17090,0,2,1
4900,1,1,17089,17090,17091,1,2,0
4901,2,3,17091,17091,17094,0,3,0
4902,5,3,17096,17096,17099,0,3,2
4903,5,1,17101,17101,17102,0,1,2
4904,2,2,17103,17103,17105,0,2,1
4905,5,2,17108,17108,17110,0,2,3
4906,6,3,17114,17114,17117,0,3,4
4907,4,2,17118,17118,17120,0,2,1
4908,1,2,17119,17120,17122,1,3,0
4909,6,2,17125,17125,17127,0,2,3
4910,4,3,17129,17129,17132,0,3,2
4911,4,2,17133,17133,17135,0,2,1
4912,6,2,17139,17139,17141,0,2,4
4913,1,2,17140,17141,17143,1,3,0
4914,4,3,17144,17144,17147,0,3,1
4915,6,2,17150,17150,17152,0,2,3
4916,4,3,17154,17154,17157,0,3,2
4917,5,1,17159,17159,17160,0,1,2
4918,2,3,17161,17161,17164,0,3,1
4919,6,3,17167,17167,17170,0,3,3
4920,5,2,17172,17172,17174,0,2,2
4921,6,2,17178,17178,17180,0,2,4
4922,3,1,17181,17181,17182,0,1,1
4923,5,1,17186,17186,17187,0,1,4
4924,6,3,17192,17192,17195,0,3,5
4925,3,3,17195,17195,17198,0,3,0
4926,1,1,17196,17198,17199,2,3,0
4927,1,1,17197,17199,17200,2,3,0
4928,4,1,17201,17201,17202,0,1,1
4929,1,2,17202,17202,17204,0,2,0
4930,4,3,17206,17206,17209,0,3,2
4931,1,2,17207,17209,17211,2,4,0
4932,3,1,17210,17211,17212,1,2,0
4933,5,1,17215,17215,17216,0,1,3
4934,5,2,17220,17220,17222,0,2,4
4935,1,3,17221,17222,17225,1,4,0
4936,3,3,17224,17225,17228,1,4,0
4937,4,1,17228,17228,17229,0,1,0
4938,6,2,17234,17234,17236,0,2,5
4939,6,3,17240,17240,17243,0,3,4
4940,4,2,17244,17244,17246,0,2,1
4941,4,3,17248,17248,17251,0,3,2
4942,5,1,17253,17253,17254,0,1,2
4943,6,3,17259,17259,17262,0,3,5
4944,4,3,17263,17263,17266,0,3,1
4945,1,2,17264,17266,17268,2,4,0
4946,3,2,17267,17268,17270,1,3,0
4947,1,3,17268,17270,17273,2,5,0
4948,3,2,17271,17273,17275,2,4,0
4949,3,2,17274,17275,17277,1,3,0
4950,4,2,17278,17278,17280,0,2,1
4951,1,1,17279,17280,17281,1,2,0
4952,3,3,17282,17282,17285,0,3,1
4953,3,2,17285,17285,17287,0,2,0
4954,4,2,17289,17289,17291,0,2,2
4955,3,1,17292,17292,17293,0,1,1
4956,2,3,17294,17294,17297,0,3,1
4957,3,2,17297,17297,17299,0,2,0
4958,3,1,17300,17300,17301,0,1,1
4959,2,3,17302,17302,17305,0,3,1
4960,2,2,17304,17305,17307,1,3,0
4961,5,2,17309,17309,17311,0,2,2
4962,3,1,17312,17312,17313,0,1,1
4963,5,1,17317,17317,17318,0,1,4
4964,3,3,17320,17320,17323,0,3,2
4965,6,1,17326,17326,17327,0,1,3
4966,2,3,17328,17328,17331,0,3,1
4967,3,3,17331,17331,17334,0,3,0
4968,4,1,17335,17335,17336,0,1,1
4969,6,1,17341,17341,17342,0,1,5
4970,3,1,17344,17344,17345,0,1,2
4971,6,3,17350,17350,17353,0,3,5
4972,3,2,17353,17353,17355,0,2,0
4973,6,3,17359,17359,17362,0,3,4
4974,3,1,17362,17362,17363,0,1,0
4975,6,2,17368,17368,17370,0,2,5
4976,3,1,17371,17371,17372,0,1,1
4977,1,2,17372,17372,17374,0,2,0
4978,1,2,17373,17374,17376,1,3,0
4979,1,3,17374,17376,17379,2,5,0
4980,5,3,17379,17379,17382,0,3,0
4981,4,3,17383,17383,17386,0,3,1
4982,6,1,17389,17389,17390,0,1,3
4983,1,3,17390,17390,17393,0,3,0
4984,6,2,17396,17396,17398,0,2,3
4985,2,2,17398,17398,17400,0,2,0
4986,1,3,17399,17400,17403,1,4,0
4987,5,1,17404,17404,17405,0,1,1
4988,5,3,17409,17409,17412,0,3,4
4989,3,3,17412,17412,17415,0,3,0
4990,3,1,17415,17415,17416,0,1,0
4991,5,1,17420,17420,17421,0,1,4
4992,1,1,17421,17421,17422,0,1,0
4993,3,2,17424,17424,17426,0,2,2
4994,6,2,17430,17430,17432,0,2,4
4995,6,3,17436,17436,17439,0,3,4
4996,4,1,17440,17440,17441,0,1,1
4997,6,2,17446,17446,17448,0,2,5
4998,1,1,17447,17448,17449,1,2,0
4999,4,2,17451,17451,17453,0,2,2
5000,6,2,17457,17457,17459,0,2,4
5001,1,2,17458,17459,17461,1,3,0
5002,5,3,17463,17463,17466,0,3,2
5003,4,2,17467,17467,17469,0,2,1
5004,4,1,17471,17471,17472,0,1,2
5005,6,2,17477,17477,17479,0,2,5
5006,4,1,17481,17481,17482,0,1,2
5007,1,2,17482,17482,17484,0,2,0
5008,1,3,17483,17484,17487,1,4,0
5009,2,3,17485,17487,17490,2,5,0
5010,3,1,17488,17490,17491,2,3,0
5011,1,3,17489,17491,17494,2,5,0
5012,1,3,17490,17494,17497,4,7,0
5013,6,3,17496,17497,17500,1,4,0
5014,3,3,17499,17500,17503,1,4,0
5015,2,3,17501,17503,17506,2,5,0
5016,5,1,17506,17506,17507,0,1,0
5017,3,1,17509,17509,17510,0,1,2
5018,5,3,17514,17514,17517,0,3,4
5019,5,3,17519,17519,17522,0,3,2
5020,1,3,17520,17522,17525,2,5,0
5021,3,1,17523,17525,17526,2,3,0
5022,6,2,17529,17529,17531,0,2,3
5023,3,2,17532,17532,17534,0,2,1
5024,3,1,17535,17535,17536,0,1,1
5025,1,3,17536,17536,17539,0,3,0
5026,5,1,17541,17541,17542,0,1,2
5027,3,1,17544,17544,17545,0,1,2
5028,5,1,17549,17549,17550,0,1,4
5029,6,2,17555,17555,17557,0,2,5
5030,3,1,17558,17558,17559,0,1,1
5031,4,3,17562,17562,17565,0,3,3
5032,3,3,17565,17565,17568,0,3,0
5033,4,2,17569,17569,17571,0,2,1
5034,6,3,17575,17575,17578,0,3,4
5035,4,3,17579,17579,17582,0,3,1
5036,4,1,17583,17583,17584,0,1,1
5037,2,1,17585,17585,17586,0,1,1
5038,2,3,17587,17587,17590,0,3,1
5039,2,3,17589,17590,17593,1,4,0
5040,3,2,17592,17593,17595,1,3,0
5041,4,1,17596,17596,17597,0,1,1
5042,3,2,17599,17599,17601,0,2,2
5043,6,1,17605,17605,17606,0,1,4
5044,3,3,17608,17608,17611,0,3,2
5045,1,3,17609,17611,17614,2,5,0
5046,1,3,17610,17614,17617,4,7,0
5047,4,1,17614,17617,17618,3,4,0
5048,4,1,17618,17618,17619,0,1,0
5049,3,3,17621,17621,17624,0,3,2
5050,5,3,17626,17626,17629,0,3,2
5051,1,2,17627,17629,17631,2,4,0
5052,4,1,17631,17631,17632,0,1,0
5053,5,2,17636,17636,17638,0,2,4
5054,3,3,17639,17639,17642,0,3,1
5055,3,1,17642,17642,17643,0,1,0
5056,2,3,17644,17644,17647,0,3,1
5057,1,2,17645,17647,17649,2,4,0
5058,1,3,17646,17649,17652,3,6,0
5059,3,2,17649,17652,17654,3,5,0
5060,4,1,17653,17654,17655,1,2,0
5061,2,1,17655,17655,17656,0,1,0
5062,3,1,17658,17658,17659,0,1,2
5063,4,3,17662,17662,17665,0,3,3
5064,1,2,17663,17665,17667,2,4,0
5065,6,1,17669,17669,17670,0,1,2
5066,1,2,17670,17670,17672,0,2,0
5067,2,2,17672,17672,17674,0,2,0
5068,4,3,17676,17676,17679,0,3,2
5069,6,2,17682,17682,17684,0,2,3
5070,1,2,17683,17684,17686,1,3,0
5071,1,3,17684,17686,17689,2,5,0
5072,5,1,17689,17689,17690,0,1,0
5073,1,1,17690,17690,17691,0,1,0
5074,6,2,17696,17696,17698,0,2,5
5075,4,1,17700,17700,17701,0,1,2
5076,3,2,17703,17703,17705,0,2,2
5077,1,1,17704,17705,17706,1,2,0
5078,6,3,17710,17710,17713,0,3,4
5079,1,2,17711,17713,17715,2,4,0
5080,5,2,17716,17716,17718,0,2,1
5081,1,3,17717,17718,17721,1,4,0
5082,6,1,17723,17723,17724,0,1,2
5083,3,2,17726,17726,17728,0,2,2
5084,2,1,17728,17728,17729,0,1,0
5085,2,2,17730,17730,17732,0,2,1
5086,5,2,17735,17735,17737,0,2,3
5087,2,1,17737,17737,17738,0,1,0
5088,4,3,17741,17741,17744,0,3,3
5089,5,1,17746,17746,17747,0,1,2
5090,1,1,17747,17747,17748,0,1,0
5091,4,2,17751,17751,17753,0,2,3
5092,1,1,17752,17753,17754,1,2,0
5093,4,3,17756,17756,17759,0,3,2
5094,3,2,17759,17759,17761,0,2,0
5095,5,2,17764,17764,17766,0,2,3
5096,4,2,17768,17768,17770,0,2,2
5097,6,1,17774,17774,17775,0,1,4
5098,3,1,17777,17777,17778,0,1,2
5099,6,2,17783,17783,17785,0,2,5
5100,3,1,17786,17786,17787,0,1,1
5101,5,2,17791,17791,17793,0,2,4
5102,3,3,17794,17794,17797,0,3,1
5103,3,3,17797,17797,17800,0,3,0
5104,4,2,17801,17801,17803,0,2,1
5105,5,2,17806,17806,17808,0,2,3
5106,4,2,17810,17810,17812,0,2,2
5107,2,2,17812,17812,17814,0,2,0
5108,4,2,17816,17816,17818,0,2,2
5109,3,1,17819,17819,17820,0,1,1
5110,6,2,17825,17825,17827,0,2,5
5111,2,2,17827,17827,17829,0,2,0
5112,4,1,17831,17831,17832,0,1,2
5113,3,3,17834,17834,17837,0,3,2
5114,1,3,17835,17837,17840,2,5,0
5115,6,3,17841,17841,17844,0,3,1
5116,3,1,17844,17844,17845,0,1,0
5117,2,1,17846,17846,17847,0,1,1
5118,3,2,17849,17849,17851,0,2,2
5119,2,1,17851,17851,17852,0,1,0
5120,3,3,17854,17854,17857,0,3,2
5121,2,3,17856,17857,17860,1,4,0
5122,2,2,17858,17860,17862,2,4,0
5123,2,2,17860,17862,17864,2,4,0
5124,2,3,17862,17864,17867,2,5,0
5125,6,3,17868,17868,17871,0,3,1
5126,3,1,17871,17871,17872,0,1,0
5127,6,1,17877,17877,17878,0,1,5
5128,4,2,17881,17881,17883,0,2,3
5129,3,3,17884,17884,17887,0,3,1
5130,3,2,17887,17887,17889,0,2,0
5131,4,1,17891,17891,17892,0,1,2
5132,2,2,17893,17893,17895,0,2,1
5133,4,1,17897,17897,17898,0,1,2
5134,2,3,17899,17899,17902,0,3,1
5135,4,3,17903,17903,17906,0,3,1
5136,3,1,17906,17906,17907,0,1,0
5137,3,1,17909,17909,17910,0,1,2
5138,5,3,17914,17914,17917,0,3,4
5139,5,2,17919,17919,17921,0,2,2
5140,6,2,17925,17925,17927,0,2,4
5141,1,3,17926,17927,17930,1,4,0
5142,3,2,17929,17930,17932,1,3,0
5143,6,3,17935,17935,17938,0,3,3
5144,1,3,17936,17938,17941,2,5,0
5145,5,3,17941,17941,17944,0,3,0
5146,5,1,17946,17946,17947,0,1,2
5147,4,3,17950,17950,17953,0,3,3
5148,1,3,17951,17953,17956,2,5,0
5149,5,2,17956,17956,17958,0,2,0
5150,5,1,17961,17961,17962,0,1,3
5151,2,3,17963,17963,17966,0,3,1
5152,4,2,17967,17967,17969,0,2,1
5153,1,3,17968,17969,17972,1,4,0
5154,6,2,17974,17974,17976,0,2,2
5155,1,2,17975,17976,17978,1,3,0
5156,1,1,17976,17978,17979,2,3,0
5157,1,2,17977,17979,17981,2,4,0
5158,1,1,17978,17981,17982,3,4,0
5159,4,1,17982,17982,17983,0,1,0
5160,5,3,17987,17987,17990,0,3,4
5161,3,1,17990,17990,17991,0,1,0
5162,4,2,17994,17994,17996,0,2,3
5163,4,1,17998,17998,17999,0,1,2
5164,5,1,18003,18003,18004,0,1,4
5165,5,3,18008,18008,18011,0,3,4
5166,2,3,18010,18011,18014,1,4,0
5167,6,2,18016,18016,18018,0,2,2
5168,1,1,18017,18018,18019,1,2,0
5169,4,3,18021,18021,18024,0,3,2
5170,1,2,18022,18024,18026,2,4,0
5171,3,2,18025,18026,18028,1,3,0
5172,6,3,18031,18031,18034,0,3,3
5173,4,3,18035,18035,18038,0,3,1
5174,6,3,18041,18041,18044,0,3,3
5175,5,2,18046,18046,18048,0,2,2
5176,2,2,18048,18048,18050,0,2,0
5177,2,1,18050,18050,18051,0,1,0
5178,2,2,18052,18052,18054,0,2,1
5179,1,1,18053,18054,18055,1,2,0
5180,3,1,18056,18056,18057,0,1,1
5181,2,2,18058,18058,18060,0,2,1
5182,1,2,18059,18060,18062,1,3,0
5183,5,2,18064,18064,18066,0,2,2
5184,2,1,18066,18066,18067,0,1,0
5185,2,1,18068,18068,18069,0,1,1
5186,6,1,18074,18074,18075,0,1,5
5187,6,2,18080,18080,18082,0,2,5
5188,2,1,18082,18082,18083,0,1,0
5189,6,3,18088,18088,18091,0,3,5
5190,1,2,18089,18091,18093,2,4,0
5191,4,2,18093,18093,18095,0,2,0
5192,2,1,18095,18095,18096,0,1,0
5193,3,1,18098,18098,18099,0,1,2
5194,4,3,18102,18102,18105,0,3,3
5195,6,3,18108,18108,18111,0,3,3
5196,5,3,18113,18113,18116,0,3,2
5197,1,2,18114,18116,18118,2,4,0
5198,3,1,18117,18118,18119,1,2,0
5199,4,1,18121,18121,18122,0,1,2
5200,5,2,18126,18126,18128,0,2,4
5201,6,2,18132,18132,18134,0,2,4
5202,3,1,18135,18135,18136,0,1,1
5203,2,3,18137,18137,18140,0,3,1
5204,2,3,18139,18140,18143,1,4,0
5205,4,2,18143,18143,18145,0,2,0
5206,6,1,18149,18149,18150,0,1,4
5207,4,3,18153,18153,18156,0,3,3
5208,1,2,18154,18156,18158,2,4,0
5209,2,2,18156,18158,18160,2,4,0
5210,1,2,18157,18160,18162,3,5,0
5211,5,2,18162,18162,18164,0,2,0
5212,1,3,18163,18164,18167,1,4,0
5213,4,3,18167,18167,18170,0,3,0
5214,2,2,18169,18170,18172,1,3,0
5215,2,2,18171,18172,18174,1,3,0
5216,1,2,18172,18174,18176,2,4,0
5217,6,2,18178,18178,18180,0,2,2
5218,5,2,18183,18183,18185,0,2,3
5219,6,2,18189,18189,18191,0,2,4
5220,1,2,18190,18191,18193,1,3,0
5221,4,2,18194,18194,18196,0,2,1
5222,1,3,18195,18196,18199,1,4,0
5223,1,2,18196,18199,18201,3,5,0
5224,1,2,18197,18201,18203,4,6,0
5225,6,2,18203,18203,18205,0,2,0
5226,5,3,18208,18208,18211,0,3,3
5227,2,1,18210,18211,18212,1,2,0
5228,1,2,18211,18212,18214,1,3,0
5229,6,2,18217,18217,18219,0,2,3
5230,5,2,18222,18222,18224,0,2,3
5231,6,1,18228,18228,18229,0,1,4
5232,4,2,18232,18232,18234,0,2,3
5233,6,2,18238,18238,18240,0,2,4
5234,3,1,18241,18241,18242,0,1,1
5235,4,2,18245,18245,18247,0,2,3
5236,1,2,18246,18247,18249,1,3,0
5237,6,3,18252,18252,18255,0,3,3
5238,2,3,18254,18255,18258,1,4,0
5239,3,2,18257,18258,18260,1,3,0
5240,6,1,18263,18263,18264,0,1,3
5241,4,2,18267,18267,18269,0,2,3
5242,3,3,18270,18270,18273,0,3,1
5243,4,2,18274,18274,18276,0,2,1
5244,5,3,18279,18279,18282,0,3,3
5245,6,3,18285,18285,18288,0,3,3
5246,2,2,18287,18288,18290,1,3,0
5247,1,2,18288,18290,18292,2,4,0
5248,3,2,18291,18292,18294,1,3,0
5249,6,1,18297,18297,18298,0,1,3
5250,4,3,18301,18301,18304,0,3,3
5251,2,2,18303,18304,18306,1,3,0
5252,1,2,18304,18306,18308,2,4,0
5253,1,3,18305,18308,18311,3,6,0
5254,5,2,18310,18311,18313,1,3,0
5255,4,3,18314,18314,18317,0,3,1
5256,1,3,18315,18317,18320,2,5,0
5257,3,2,18318,18320,18322,2,4,0
5258,6,2,18324,18324,18326,0,2,2
5259,6,1,18330,18330,18331,0,1,4
5260,5,2,18335,18335,18337,0,2,4
5261,4,2,18339,18339,18341,0,2,2
5262,6,2,18345,18345,18347,0,2,4
5263,3,2,18348,18348,18350,0,2,1
5264,3,3,18351,18351,18354,0,3,1
5265,6,2,18357,18357,18359,0,2,3
5266,3,1,18360,18360,18361,0,1,1
5267,3,2,18363,18363,18365,0,2,2
5268,2,2,18365,18365,18367,0,2,0
5269,5,3,18370,18370,18373,0,3,3
5270,4,1,18374,18374,18375,0,1,1
5271,2,2,18376,18376,18378,0,2,1
5272,4,3,18380,18380,18383,0,3,2
5273,5,3,18385,18385,18388,0,3,2
5274,1,2,18386,18388,18390,2,4,0
5275,5,1,18391,18391,18392,0,1,1
5276,3,3,18394,18394,18397,0,3,2
5277,3,3,18397,18397,18400,0,3,0
5278,5,3,18402,18402,18405,0,3,2
5279,1,1,18403,18405,18406,2,3,0
5280,6,1,18409,18409,18410,0,1,3
5281,4,2,18413,18413,18415,0,2,3
5282,4,3,18417,18417,18420,0,3,2
5283,3,2,18420,18420,18422,0,2,0
5284,1,3,18421,18422,18425,1,4,0
5285,2,3,18423,18425,18428,2,5,0
5286,5,3,18428,18428,18431,0,3,0
5287,3,2,18431,18431,18433,0,2,0
5288,3,2,18434,18434,18436,0,2,1
5289,3,3,18437,18437,18440,0,3,1
5290,3,2,18440,18440,18442,0,2,0
5291,3,2,18443,18443,18445,0,2,1
5292,6,1,18449,18449,18450,0,1,4
5293,2,3,18451,18451,18454,0,3,1
5294,6,1,18457,18457,18458,0,1,3
5295,5,2,18462,18462,18464,0,2,4
5296,4,2,18466,18466,18468,0,2,2
5297,6,3,18472,18472,18475,0,3,4
5298,6,2,18478,18478,18480,0,2,3
5299,3,1,18481,18481,18482,0,1,1
5300,3,2,18484,18484,18486,0,2,2
5301,4,2,18488,18488,18490,0,2,2
5302,2,3,18490,18490,18493,0,3,0
5303,4,3,18494,18494,18497,0,3,1
5304,2,1,18496,18497,18498,1,2,0
5305,6,1,18502,18502,18503,0,1,4
5306,2,3,18504,18504,18507,0,3,1
5307,5,1,18509,18509,18510,0,1,2
5308,6,3,18515,18515,18518,0,3,5
5309,1,1,18516,18518,18519,2,3,0
5310,3,2,18519,18519,18521,0,2,0
5311,2,2,18521,18521,18523,0,2,0
5312,1,3,18522,18523,18526,1,4,0
5313,5,1,18527,18527,18528,0,1,1
5314,2,3,18529,18529,18532,0,3,1
5315,6,3,18535,18535,18538,0,3,3
5316,1,3,18536,18538,18541,2,5,0
5317,5,3,18541,18541,18544,0,3,0
5318,2,3,18543,18544,18547,1,4,0
5319,6,3,18549,18549,18552,0,3,2
5320,2,2,18551,18552,18554,1,3,0
5321,3,2,18554,18554,18556,0,2,0
5322,2,1,18556,18556,18557,0,1,0
5323,1,2,18557,18557,18559,0,2,0
5324,3,1,18560,18560,18561,0,1,1
5325,1,1,18561,18561,18562,0,1,0
5326,2,3,18563,18563,18566,0,3,1
5327,6,1,18569,18569,18570,0,1,3
5328,5,1,18574,18574,18575,0,1,4
5329,1,2,18575,18575,18577,0,2,0
5330,2,1,18577,18577,18578,0,1,0
5331,6,1,18583,18583,18584,0,1,5
5332,6,1,18589,18589,18590,0,1,5
5333,2,1,18591,18591,18592,0,1,1
5334,2,3,18593,18593,18596,0,3,1
5335,3,2,18596,18596,18598,0,2,0
5336,2,2,18598,18598,18600,0,2,0
5337,5,2,18603,18603,18605,0,2,3
5338,2,1,18605,18605,18606,0,1,0
5339,1,1,18606,18606,18607,0,1,0
5340,5,1,18611,18611,18612,0,1,4
5341,2,2,18613,18613,18615,0,2,1
5342,2,1,18615,18615,18616,0,1,0
5343,3,1,18618,18618,18619,0,1,2
5344,1,2,18619,18619,18621,0,2,0
5345,3,3,18622,18622,18625,0,3,1
5346,6,3,18628,18628,18631,0,3,3
5347,4,1,18632,18632,18633,0,1,1
5348,6,2,18638,18638,18640,0,2,5
5349,2,2,18640,18640,18642,0,2,0
5350,6,3,18646,18646,18649,0,3,4
5351,1,2,18647,18649,18651,2,4,0
5352,6,2,18653,18653,18655,0,2,2
5353,4,1,18657,18657,18658,0,1,2
5354,1,3,18658,18658,18661,0,3,0
5355,4,1,18662,18662,18663,0,1,1
5356,5,3,18667,18667,18670,0,3,4
5357,6,3,18673,18673,18676,0,3,3
5358,5,3,18678,18678,18681,0,3,2
5359,3,2,18681,18681,18683,0,2,0
5360,1,3,18682,18683,18686,1,4,0
5361,6,3,18688,18688,18691,0,3,2
5362,2,2,18690,18691,18693,1,3,0
5363,3,1,18693,18693,18694,0,1,0
5364,1,2,18694,18694,18696,0,2,0
5365,2,1,18696,18696,18697,0,1,0
5366,1,1,18697,18697,18698,0,1,0
5367,5,2,18702,18702,18704,0,2,4
5368,4,2,18706,18706,18708,0,2,2
5369,6,1,18712,18712,18713,0,1,4
5370,1,2,18713,18713,18715,0,2,0
5371,4,1,18717,18717,18718,0,1,2
5372,5,3,18722,18722,18725,0,3,4
5373,3,3,18725,18725,18728,0,3,0
5374,2,3,18727,18728,18731,1,4,0
5375,3,3,18730,18731,18734,1,4,0
5376,1,2,18731,18734,18736,3,5,0
5377,5,1,18736,18736,18737,0,1,0
5378,6,1,18742,18742,18743,0,1,5
5379,2,3,18744,18744,18747,0,3,1
5380,1,2,18745,18747,18749,2,4,0
5381,1,1,18746,18749,18750,3,4,0
5382,4,3,18750,18750,18753,0,3,0
5383,6,3,18756,18756,18759,0,3,3
5384,6,2,18762,18762,18764,0,2,3
5385,4,3,18766,18766,18769,0,3,2
5386,6,1,18772,18772,18773,0,1,3
5387,2,3,18774,18774,18777,0,3,1
5388,3,3,18777,18777,18780,0,3,0
5389,6,1,18783,18783,18784,0,1,3
5390,4,3,18787,18787,18790,0,3,3
5391,2,1,18789,18790,18791,1,2,0
5392,2,2,18791,18791,18793,0,2,0
5393,5,3,18796,18796,18799,0,3,3
5394,2,1,18798,18799,18800,1,2,0
5395,5,3,18803,18803,18806,0,3,3
5396,2,3,18805,18806,18809,1,4,0
5397,3,2,18808,18809,18811,1,3,0
5398,4,1,18812,18812,18813,0,1,1
5399,5,1,18817,18817,18818,0,1,4
5400,5,2,18822,18822,18824,0,2,4
5401,5,2,18827,18827,18829,0,2,3
5402,3,3,18830,18830,18833,0,3,1
5403,3,1,18833,18833,18834,0,1,0
5404,1,2,18834,18834,18836,0,2,0
5405,3,1,18837,18837,18838,0,1,1
5406,2,1,18839,18839,18840,0,1,1
5407,1,3,18840,18840,18843,0,3,0
5408,2,2,18842,18843,18845,1,3,0
5409,3,1,18845,18845,18846,0,1,0
5410,5,3,18850,18850,18853,0,3,4
5411,5,3,18855,18855,18858,0,3,2
5412,4,2,18859,18859,18861,0,2,1
5413,2,1,18861,18861,18862,0,1,0
5414,4,1,18865,18865,18866,0,1,3
5415,4,1,18869,18869,18870,0,1,3
5416,3,1,18872,18872,18873,0,1,2
5417,4,1,18876,18876,18877,0,1,3
5418,1,1,18877,18877,18878,0,1,0
5419,1,3,18878,18878,18881,0,3,0
5420,5,2,18883,18883,18885,0,2,2
5421,2,3,18885,18885,18888,0,3,0
5422,3,1,18888,18888,18889,0,1,0
5423,3,1,18891,18891,18892,0,1,2
5424,1,2,18892,18892,18894,0,2,0
5425,5,2,18897,18897,18899,0,2,3
5426,5,1,18902,18902,18903,0,1,3
5427,1,2,18903,18903,18905,0,2,0
5428,1,1,18904,18905,18906,1,2,0
5429,3,2,18907,18907,18909,0,2,1
5430,2,2,18909,18909,18911,0,2,0
5431,3,1,18912,18912,18913,0,1,1
5432,1,3,18913,18913,18916,0,3,0
5433,1,3,18914,18916,18919,2,5,0
5434,4,2,18918,18919,18921,1,3,0
5435,2,2,18920,18921,18923,1,3,0
5436,1,3,18921,18923,18926,2,5,0
5437,5,1,18926,18926,18927,0,1,0
5438,2,2,18928,18928,18930,0,2,1
5439,2,3,18930,18930,18933,0,3,0
5440,6,1,18936,18936,18937,0,1,3
5441,6,1,18942,18942,18943,0,1,5
5442,4,3,18946,18946,18949,0,3,3
5443,5,1,18951,18951,18952,0,1,2
5444,5,2,18956,18956,18958,0,2,4
5445,1,2,18957,18958,18960,1,3,0
5446,2,3,18959,18960,18963,1,4,0
5447,2,1,18961,18963,18964,2,3,0
5448,2,1,18963,18964,18965,1,2,0
5449,6,1,18969,18969,18970,0,1,4
5450,6,2,18975,18975,18977,0,2,5
5451,6,3,18981,18981,18984,0,3,4
5452,5,3,18986,18986,18989,0,3,2
5453,3,1,18989,18989,18990,0,1,0
5454,3,2,18992,18992,18994,0,2,2
5455,1,3,18993,18994,18997,1,4,0
5456,1,1,18994,18997,18998,3,4,0
5457,4,3,18998,18998,19001,0,3,0
5458,4,3,19002,19002,19005,0,3,1
5459,1,2,19003,19005,19007,2,4,0
5460,2,2,19005,19007,19009,2,4,0
5461,2,3,19007,19009,19012,2,5,0
5462,1,2,19008,19012,19014,4,6,0
5463,3,2,19011,19014,19016,3,5,0
5464,1,2,19012,19016,19018,4,6,0
5465,4,3,19016,19018,19021,2,5,0
5466,3,2,19019,19021,19023,2,4,0
5467,6,3,19025,19025,19028,0,3,2
5468,3,1,19028,19028,19029,0,1,0
5469,5,1,19033,19033,19034,0,1,4
5470,4,2,19037,19037,19039,0,2,3
5471,3,2,19040,19040,19042,0,2,1
5472,5,1,19045,19045,19046,0,1,3
5473,2,1,19047,19047,19048,0,1,1
5474,6,2,19053,19053,19055,0,2,5
5475,3,1,19056,19056,19057,0,1,1
5476,4,1,19060,19060,19061,0,1,3
5477,4,3,19064,19064,19067,0,3,3
5478,5,1,19069,19069,19070,0,1,2
5479,6,1,19075,19075,19076,0,1,5
5480,6,2,19081,19081,19083,0,2,5
5481,2,3,19083,19083,19086,0,3,0
5482,5,3,19088,19088,19091,0,3,2
5483,6,1,19094,19094,19095,0,1,3
5484,4,2,19098,19098,19100,0,2,3
5485,4,1,19102,19102,19103,0,1,2
5486,2,1,19104,19104,19105,0,1,1
5487,3,3,19107,19107,19110,0,3,2
5488,5,2,19112,19112,19114,0,2,2
5489,5,2,19117,19117,19119,0,2,3
5490,6,2,19123,19123,19125,0,2,4
5491,5,3,19128,19128,19131,0,3,3
5492,5,2,19133,19133,19135,0,2,2
5493,6,2,19139,19139,19141,0,2,4
5494,6,2,19145,19145,19147,0,2,4
5495,6,3,19151,19151,19154,0,3,4
5496,5,2,19156,19156,19158,0,2,2
5497,1,3,19157,19158,19161,1,4,0
5498,4,1,19161,19161,19162,0,1,0
5499,5,3,19166,19166,19169,0,3,4
5500,6,2,19172,19172,19174,0,2,3
5501,4,3,19176,19176,19179,0,3,2
5502,3,1,19179,19179,19180,0,1,0
5503,4,3,19183,19183,19186,0,3,3
5504,2,3,19185,19186,19189,1,4,0
5505,4,3,19189,19189,19192,0,3,0
5506,5,2,19194,19194,19196,0,2,2
5507,5,2,19199,19199,19201,0,2,3
5508,2,1,19201,19201,19202,0,1,0
5509,3,3,19204,19204,19207,0,3,2
5510,4,3,19208,19208,19211,0,3,1
5511,5,2,19213,19213,19215,0,2,2
5512,2,2,19215,19215,19217,0,2,0
5513,6,2,19221,19221,19223,0,2,4
5514,4,3,19225,19225,19228,0,3,2
5515,5,3,19230,19230,19233,0,3,2
5516,2,2,19232,19233,19235,1,3,0
5517,4,2,19236,19236,19238,0,2,1
5518,1,2,19237,19238,19240,1,3,0
5519,5,1,19242,19242,19243,0,1,2
5520,2,3,19244,19244,19247,0,3,1
5521,6,3,19250,19250,19253,0,3,3
5522,1,3,19251,19253,19256,2,5,0
5523,6,2,19257,19257,19259,0,2,1
5524,5,3,19262,19262,19265,0,3,3
5525,1,1,19263,19265,19266,2,3,0
5526,3,2,19266,19266,19268,0,2,0
5527,5,3,19271,19271,19274,0,3,3
5528,1,1,19272,19274,19275,2,3,0
5529,4,3,19276,19276,19279,0,3,1
5530,2,2,19278,19279,19281,1,3,0
5531,2,1,19280,19281,19282,1,2,0
5532,2,2,19282,19282,19284,0,2,0
5533,5,3,19287,19287,19290,0,3,3
5534,1,3,19288,19290,19293,2,5,0
5535,2,1,19290,19293,19294,3,4,0
5536,1,1,19291,19294,19295,3,4,0
5537,6,3,19297,19297,19300,0,3,2
5538,3,3,19300,19300,19303,0,3,0
5539,2,2,19302,19303,19305,1,3,0
5540,3,2,19305,19305,19307,0,2,0
5541,2,3,19307,19307,19310,0,3,0
5542,5,1,19312,19312,19313,0,1,2
5543,5,2,19317,19317,19319,0,2,4
5544,2,3,19319,19319,19322,0,3,0
5545,5,3,19324,19324,19327,0,3,2
5546,3,1,19327,19327,19328,0,1,0
5547,4,3,19331,19331,19334,0,3,3
5548,5,3,19336,19336,19339,0,3,2
5549,6,3,19342,19342,19345,0,3,3
5550,5,1,19347,19347,19348,0,1,2
5551,6,2,19353,19353,19355,0,2,5
5552,1,3,19354,19355,19358,1,4,0
5553,1,3,19355,19358,19361,3,6,0
5554,3,3,19358,19361,19364,3,6,0
5555,1,3,19359,19364,19367,5,8,0
5556,4,1,19363,19367,19368,4,5,0
5557,2,1,19365,19368,19369,3,4,0
5558,5,2,19370,19370,19372,0,2,1
5559,2,2,19372,19372,19374,0,2,0
5560,4,2,19376,19376,19378,0,2,2
5561,5,1,19381,19381,19382,0,1,3
5562,3,3,19384,19384,19387,0,3,2
5563,3,3,19387,19387,19390,0,3,0
5564,2,1,19389,19390,19391,1,2,0
5565,4,2,19393,19393,19395,0,2,2
5566,3,3,19396,19396,19399,0,3,1
5567,4,3,19400,19400,19403,0,3,1
5568,6,3,19406,19406,19409,0,3,3
5569,1,1,19407,19409,19410,2,3,0
5570,6,2,19413,19413,19415,0,2,3
5571,3,2,19416,19416,19418,0,2,1
5572,5,1,19421,19421,19422,0,1,3
5573,6,3,19427,19427,19430,0,3,5
5574,1,2,19428,19430,19432,2,4,0
5575,4,3,19432,19432,19435,0,3,0
5576,2,2,19434,19435,19437,1,3,0
5577,6,1,19440,19440,19441,0,1,3
5578,1,2,19441,19441,19443,0,2,0
5579,2,2,19443,19443,19445,0,2,0
5580,3,3,19446,19446,19449,0,3,1
5581,2,1,19448,19449,19450,1,2,0
5582,6,3,19454,19454,19457,0,3,4
5583,1,3,19455,19457,19460,2,5,0
5584,3,1,19458,19460,19461,2,3,0
5585,1,3,19459,19461,19464,2,5,0
5586,6,3,19465,19465,19468,0,3,1
5587,1,3,19466,19468,19471,2,5,0
5588,5,3,19471,19471,19474,0,3,0
5589,1,3,19472,19474,19477,2,5,0
5590,3,3,19475,19477,19480,2,5,0
5591,5,1,19480,19480,19481,0,1,0
5592,2,3,19482,19482,19485,0,3,1
5593,3,3,19485,19485,19488,0,3,0
5594,4,2,19489,19489,19491,0,2,1
5595,1,3,19490,19491,19494,1,4,0
5596,2,1,19492,19494,19495,2,3,0
5597,1,2,19493,19495,19497,2,4,0
5598,6,3,19499,19499,19502,0,3,2
5599,6,3,19505,19505,19508,0,3,3
5600,5,1,19510,19510,19511,0,1,2
5601,4,3,19514,19514,19517,0,3,3
5602,6,3,19520,19520,19523,0,3,3
5603,2,2,19522,19523,19525,1,3,0
5604,1,3,19523,19525,19528,2,5,0
5605,1,1,19524,19528,19529,4,5,0
5606,1,3,19525,19529,19532,4,7,0
5607,1,2,19526,19532,19534,6,8,0
5608,5,2,19531,19534,19536,3,5,0
5609,2,1,19533,19536,19537,3,4,0
5610,3,2,19536,19537,19539,1,3,0
5611,2,1,19538,19539,19540,1,2,0
5612,3,2,19541,19541,19543,0,2,1
5613,4,2,19545,19545,19547,0,2,2
5614,3,2,19548,19548,19550,0,2,1
5615,1,2,19549,19550,19552,1,3,0
5616,4,2,19553,19553,19555,0,2,1
5617,5,3,19558,19558,19561,0,3,3
5618,5,2,19563,19563,19565,0,2,2
5619,1,1,19564,19565,19566,1,2,0
5620,2,2,19566,19566,19568,0,2,0
5621,3,2,19569,19569,19571,0,2,1
5622,6,1,19575,19575,19576,0,1,4
5623,4,1,19579,19579,19580,0,1,3
5624,5,3,19584,19584,19587,0,3,4
5625,6,2,19590,19590,19592,0,2,3
5626,4,2,19594,19594,19596,0,2,2
5627,4,1,19598,19598,19599,0,1,2
5628,2,2,19600,19600,19602,0,2,1
5629,6,3,19606,19606,19609,0,3,4
5630,4,2,19610,19610,19612,0,2,1
5631,1,3,19611,19612,19615,1,4,0
5632,4,2,19615,19615,19617,0,2,0
5633,4,1,19619,19619,19620,0,1,2
5634,5,3,19624,19624,19627,0,3,4
5635,5,2,19629,19629,19631,0,2,2
5636,3,2,19632,19632,19634,0,2,1
5637,1,2,19633,19634,19636,1,3,0
5638,4,1,19637,19637,19638,0,1,1
5639,6,1,19643,19643,19644,0,1,5
5640,3,1,19646,19646,19647,0,1,2
5641,5,2,19651,19651,19653,0,2,4
5642,1,3,19652,19653,19656,1,4,0
5643,2,1,19654,19656,19657,2,3,0
5644,6,3,19660,19660,19663,0,3,3
5645,3,3,19663,19663,19666,0,3,0
5646,3,1,19666,19666,19667,0,1,0
5647,1,1,19667,19667,19668,0,1,0
5648,2,2,19669,19669,19671,0,2,1
5649,1,3,19670,19671,19674,1,4,0
5650,3,3,19673,19674,19677,1,4,0
5651,5,3,19678,19678,19681,0,3,1
5652,5,2,19683,19683,19685,0,2,2
5653,3,1,19686,19686,19687,0,1,1
5654,2,1,19688,19688,19689,0,1,1
5655,1,1,19689,19689,19690,0,1,0
5656,4,1,19693,19693,19694,0,1,3
5657,3,1,19696,19696,19697,0,1,2
5658,5,1,19701,19701,19702,0,1,4
5659,2,3,19703,19703,19706,0,3,1
5660,1,3,19704,19706,19709,2,5,0
5661,6,3,19710,19710,19713,0,3,1
5662,3,2,19713,19713,19715,0,2,0
5663,3,2,19716,19716,19718,0,2,1
5664,3,2,19719,19719,19721,0,2,1
5665,5,3,19724,19724,19727,0,3,3
5666,1,1,19725,19727,19728,2,3,0
5667,4,2,19729,19729,19731,0,2,1
5668,2,2,19731,19731,19733,0,2,0
5669,2,1,19733,19733,19734,0,1,0
5670,5,3,19738,19738,19741,0,3,4
5671,5,2,19743,19743,19745,0,2,2
5672,1,2,19744,19745,19747,1,3,0
5673,6,1,19750,19750,19751,0,1,3
5674,5,1,19755,19755,19756,0,1,4
5675,6,2,19761,19761,19763,0,2,5
5676,5,2,19766,19766,19768,0,2,3
5677,5,2,19771,19771,19773,0,2,3
5678,6,2,19777,19777,19779,0,2,4
5679,1,2,19778,19779,19781,1,3,0
5680,5,1,19783,19783,19784,0,1,2
5681,3,2,19786,19786,19788,0,2,2
5682,3,3,19789,19789,19792,0,3,1
5683,6,3,19795,19795,19798,0,3,3
5684,5,1,19800,19800,19801,0,1,2
5685,2,3,19802,19802,19805,0,3,1
5686,1,2,19803,19805,19807,2,4,0
5687,5,2,19808,19808,19810,0,2,1
5688,4,3,19812,19812,19815,0,3,2
5689,1,3,19813,19815,19818,2,5,0
5690,6,3,19819,19819,19822,0,3,1
5691,6,1,19825,19825,19826,0,1,3
5692,2,1,19827,19827,19828,0,1,1
5693,6,1,19833,19833,19834,0,1,5
5694,5,3,19838,19838,19841,0,3,4
5695,6,1,19844,19844,19845,0,1,3
5696,5,3,19849,19849,19852,0,3,4
5697,2,3,19851,19852,19855,1,4,0
5698,3,3,19854,19855,19858,1,4,0
5699,5,1,19859,19859,19860,0,1,1
5700,4,2,19863,19863,19865,0,2,3
5701,3,2,19866,19866,19868,0,2,1
5702,6,3,19872,19872,19875,0,3,4
5703,1,2,19873,19875,19877,2,4,0
5704,2,3,19875,19877,19880,2,5,0
5705,3,2,19878,19880,19882,2,4,0
5706,3,1,19881,19882,19883,1,2,0
5707,1,2,19882,19883,19885,1,3,0
5708,3,1,19885,19885,19886,0,1,0
5709,5,1,19890,19890,19891,0,1,4
5710,4,1,19894,19894,19895,0,1,3
5711,3,2,19897,19897,19899,0,2,2
5712,4,3,19901,19901,19904,0,3,2
5713,1,1,19902,19904,19905,2,3,0
5714,4,3,19906,19906,19909,0,3,1
5715,1,3,19907,19909,19912,2,5,0
5716,6,2,19913,19913,19915,0,2,1
5717,2,1,19915,19915,19916,0,1,0
5718,1,3,19916,19916,19919,0,3,0
5719,6,3,19922,19922,19925,0,3,3
5720,6,2,19928,19928,19930,0,2,3
5721,4,2,19932,19932,19934,0,2,2
5722,5,2,19937,19937,19939,0,2,3
5723,3,3,19940,19940,19943,0,3,1
5724,1,1,19941,19943,19944,2,3,0
5725,5,2,19946,19946,19948,0,2,2
5726,1,1,19947,19948,19949,1,2,0
5727,5,2,19952,19952,19954,0,2,3
5728,6,2,19958,19958,19960,0,2,4
5729,5,2,19963,19963,19965,0,2,3
5730,5,3,19968,19968,19971,0,3,3
5731,5,1,19973,19973,19974,0,1,2
5732,6,3,19979,19979,19982,0,3,5
5733,4,1,19983,19983,19984,0,1,1
5734,2,3,19985,19985,19988,0,3,1
5735,3,2,19988,19988,19990,0,2,0
5736,6,3,19994,19994,19997,0,3,4
5737,3,2,19997,19997,19999,0,2,0
5738,1,3,19998,19999,20002,1,4,0
5739,4,2,20002,20002,20004,0,2,0
5740,4,3,20006,20006,20009,0,3,2
5741,5,3,20011,20011,20014,0,3,2
5742,1,2,20012,20014,20016,2,4,0
5743,5,2,20017,20017,20019,0,2,1
5744,3,2,20020,20020,20022,0,2,1
5745,4,1,20024,20024,20025,0,1,2
5746,2,1,20026,20026,20027,0,1,1
5747,5,2,20031,20031,20033,0,2,4
5748,1,3,20032,20033,20036,1,4,0
5749,2,1,20034,20036,20037,2,3,0
5750,3,1,20037,20037,20038,0,1,0
5751,6,2,20043,20043,20045,0,2,5
5752,3,2,20046,20046,20048,0,2,1
5753,2,3,20048,20048,20051,0,3,0
5754,4,3,20052,20052,20055,0,3,1
5755,5,3,20057,20057,20060,0,3,2
5756,5,2,20062,20062,20064,0,2,2
5757,2,3,20064,20064,20067,0,3,0
5758,2,1,20066,20067,20068,1,2,0
5759,6,1,20072,20072,20073,0,1,4
5760,2,2,20074,20074,20076,0,2,1
5761,1,3,20075,20076,20079,1,4,0
5762,1,1,20076,20079,20080,3,4,0
5763,1,2,20077,20080,20082,3,5,0
5764,2,2,20079,20082,20084,3,5,0
5765,1,2,20080,20084,20086,4,6,0
5766,5,3,20085,20086,20089,1,4,0
5767,2,3,20087,20089,20092,2,5,0
5768,3,3,20090,20092,20095,2,5,0
5769,2,3,20092,20095,20098,3,6,0
5770,1,3,20093,20098,20101,5,8,0
5771,6,1,20099,20101,20102,2,3,0
5772,1,1,20100,20102,20103,2,3,0
5773,1,2,20101,20103,20105,2,4,0
5774,1,1,20102,20105,20106,3,4,0
5775,3,3,20105,20106,20109,1,4,0
5776,5,3,20110,20110,20113,0,3,1
5777,2,1,20112,20113,20114,1,2,0
5778,5,2,20117,20117,20119,0,2,3
5779,2,3,20119,20119,20122,0,3,0
5780,3,1,20122,20122,20123,0,1,0
5781,1,1,20123,20123,20124,0,1,0
5782,6,1,20129,20129,20130,0,1,5
5783,3,1,20132,20132,20133,0,1,2
5784,5,3,20137,20137,20140,0,3,4
5785,4,1,20141,20141,20142,0,1,1
5786,3,3,20144,20144,20147,0,3,2
5787,4,1,20148,20148,20149,0,1,1
5788,4,2,20152,20152,20154,0,2,3
5789,5,1,20157,20157,20158,0,1,3
5790,3,1,20160,20160,20161,0,1,2
5791,5,3,20165,20165,20168,0,3,4
5792,6,1,20171,20171,20172,0,1,3
5793,2,3,20173,20173,20176,0,3,1
5794,1,2,20174,20176,20178,2,4,0
5795,6,2,20180,20180,20182,0,2,2
5796,3,3,20183,20183,20186,0,3,1
5797,2,2,20185,20186,20188,1,3,0
5798,1,2,20186,20188,20190,2,4,0
5799,5,3,20191,20191,20194,0,3,1
5800,6,1,20197,20197,20198,0,1,3
5801,1,1,20198,20198,20199,0,1,0
5802,4,3,20202,20202,20205,0,3,3
5803,1,2,20203,20205,20207,2,4,0
5804,6,1,20209,20209,20210,0,1,2
5805,2,3,20211,20211,20214,0,3,1
5806,4,2,20215,20215,20217,0,2,1
5807,6,2,20221,20221,20223,0,2,4
5808,4,3,20225,20225,20228,0,3,2
5809,4,3,20229,20229,20232,0,3,1
5810,2,2,20231,20232,20234,1,3,0
5811,6,3,20237,20237,20240,0,3,3
5812,1,2,20238,20240,20242,2,4,0
5813,3,3,20241,20242,20245,1,4,0
5814,2,1,20243,20245,20246,2,3,0
5815,6,3,20249,20249,20252,0,3,3
5816,2,2,20251,20252,20254,1,3,0
5817,6,3,20257,20257,20260,0,3,3
5818,2,2,20259,20260,20262,1,3,0
5819,1,1,20260,20262,20263,2,3,0
5820,6,2,20266,20266,20268,0,2,3
5821,2,3,20268,20268,20271,0,3,0
5822,6,1,20274,20274,20275,0,1,3
5823,3,1,20277,20277,20278,0,1,2
5824,6,1,20283,20283,20284,0,1,5
5825,4,2,20287,20287,20289,0,2,3
5826,1,1,20288,20289,20290,1,2,0
5827,3,3,20291,20291,20294,0,3,1
5828,5,3,20296,20296,20299,0,3,2
5829,4,3,20300,20300,20303,0,3,1
5830,2,3,20302,20303,20306,1,4,0
5831,5,3,20307,20307,20310,0,3,1
5832,2,2,20309,20310,20312,1,3,0
5833,5,2,20314,20314,20316,0,2,2
5834,5,1,20319,20319,20320,0,1,3
5835,3,1,20322,20322,20323,0,1,2
5836,5,3,20327,20327,20330,0,3,4
5837,2,1,20329,20330,20331,1,2,0
5838,4,3,20333,20333,20336,0,3,2
5839,3,2,20336,20336,20338,0,2,0
5840,6,3,20342,20342,20345,0,3,4
5841,6,2,20348,20348,20350,0,2,3
5842,2,2,20350,20350,20352,0,2,0
5843,5,1,20355,20355,20356,0,1,3
5844,6,1,20361,20361,20362,0,1,5
5845,6,2,20367,20367,20369,0,2,5
5846,3,1,20370,20370,20371,0,1,1
5847,6,2,20376,20376,20378,0,2,5
5848,4,1,20380,20380,20381,0,1,2
5849,2,3,20382,20382,20385,0,3,1
5850,4,2,20386,20386,20388,0,2,1
5851,3,3,20389,20389,20392,0,3,1
5852,5,3,20394,20394,20397,0,3,2
5853,6,2,20400,20400,20402,0,2,3
5854,6,3,20406,20406,20409,0,3,4
5855,1,3,20407,20409,20412,2,5,0
5856,5,2,20412,20412,20414,0,2,0
5857,5,3,20417,20417,20420,0,3,3
5858,3,2,20420,20420,20422,0,2,0
5859,3,1,20423,20423,20424,0,1,1
5860,1,1,20424,20424,20425,0,1,0
5861,6,1,20430,20430,20431,0,1,5
5862,5,2,20435,20435,20437,0,2,4
5863,5,1,20440,20440,20441,0,1,3
5864,6,2,20446,20446,20448,0,2,5
5865,4,1,20450,20450,20451,0,1,2
5866,6,2,20456,20456,20458,0,2,5
5867,2,1,20458,20458,20459,0,1,0
5868,2,1,20460,20460,20461,0,1,1
5869,1,1,20461,20461,20462,0,1,0
5870,1,1,20462,20462,20463,0,1,0
5871,5,2,20467,20467,20469,0,2,4
5872,1,2,20468,20469,20471,1,3,0
5873,3,2,20471,20471,20473,0,2,0
5874,4,3,20475,20475,20478,0,3,2
5875,3,3,20478,20478,20481,0,3,0
5876,2,1,20480,20481,20482,1,2,0
5877,1,2,20481,20482,20484,1,3,0
5878,5,3,20486,20486,20489,0,3,2
5879,2,2,20488,20489,20491,1,3,0
5880,1,3,20489,20491,20494,2,5,0
5881,4,2,20493,20494,20496,1,3,0
5882,2,3,20495,20496,20499,1,4,0
5883,6,1,20501,20501,20502,0,1,2
5884,1,3,20502,20502,20505,0,3,0
5885,4,2,20506,20506,20508,0,2,1
5886,3,1,20509,20509,20510,0,1,1
5887,6,3,20515,20515,20518,0,3,5
5888,1,1,20516,20518,20519,2,3,0
5889,2,2,20518,20519,20521,1,3,0
5890,4,3,20522,20522,20525,0,3,1
5891,4,2,20526,20526,20528,0,2,1
5892,6,3,20532,20532,20535,0,3,4
5893,3,1,20535,20535,20536,0,1,0
5894,4,1,20539,20539,20540,0,1,3
5895,2,2,20541,20541,20543,0,2,1
5896,1,3,20542,20543,20546,1,4,0
5897,5,1,20547,20547,20548,0,1,1
5898,5,1,20552,20552,20553,0,1,4
5899,4,1,20556,20556,20557,0,1,3
5900,5,3,20561,20561,20564,0,3,4
5901,6,3,20567,20567,20570,0,3,3
5902,3,2,20570,20570,20572,0,2,0
5903,6,3,20576,20576,20579,0,3,4
5904,3,2,20579,20579,20581,0,2,0
5905,5,1,20584,20584,20585,0,1,3
5906,5,2,20589,20589,20591,0,2,4
5907,2,1,20591,20591,20592,0,1,0
5908,6,2,20597,20597,20599,0,2,5
5909,2,2,20599,20599,20601,0,2,0
5910,5,2,20604,20604,20606,0,2,3
5911,6,1,20610,20610,20611,0,1,4
5912,5,1,20615,20615,20616,0,1,4
5913,4,2,20619,20619,20621,0,2,3
5914,1,1,20620,20621,20622,1,2,0
5915,3,1,20623,20623,20624,0,1,1
5916,4,1,20627,20627,20628,0,1,3
5917,3,1,20630,20630,20631,0,1,2
5918,5,1,20635,20635,20636,0,1,4
5919,2,2,20637,20637,20639,0,2,1
5920,1,1,20638,20639,20640,1,2,0
5921,1,1,20639,20640,20641,1,2,0
5922,1,2,20640,20641,20643,1,3,0
5923,3,3,20643,20643,20646,0,3,0
5924,2,3,20645,20646,20649,1,4,0
5925,4,3,20649,20649,20652,0,3,0
5926,3,3,20652,20652,20655,0,3,0
5927,4,1,20656,20656,20657,0,1,1
5928,5,1,20661,20661,20662,0,1,4
5929,2,2,20663,20663,20665,0,2,1
5930,5,2,20668,20668,20670,0,2,3
5931,4,3,20672,20672,20675,0,3,2
5932,3,3,20675,20675,20678,0,3,0
5933,3,1,20678,20678,20679,0,1,0
5934,2,1,20680,20680,20681,0,1,1
5935,4,3,20684,20684,20687,0,3,3
5936,6,2,20690,20690,20692,0,2,3
5937,5,1,20695,20695,20696,0,1,3
5938,4,3,20699,20699,20702,0,3,3
5939,6,2,20705,20705,20707,0,2,3
5940,1,1,20706,20707,20708,1,2,0
5941,6,2,20712,20712,20714,0,2,4
5942,2,1,20714,20714,20715,0,1,0
5943,5,1,20719,20719,20720,0,1,4
5944,6,1,20725,20725,20726,0,1,5
5945,3,1,20728,20728,20729,0,1,2
5946,2,1,20730,20730,20731,0,1,1
5947,4,3,20734,20734,20737,0,3,3
5948,5,1,20739,20739,20740,0,1,2
5949,6,3,20745,20745,20748,0,3,5
5950,1,1,20746,20748,20749,2,3,0
5951,2,2,20748,20749,20751,1,3,0
5952,1,3,20749,20751,20754,2,5,0
5953,6,3,20755,20755,20758,0,3,1
5954,2,1,20757,20758,20759,1,2,0
5955,3,3,20760,20760,20763,0,3,1
5956,2,2,20762,20763,20765,1,3,0
5957,1,3,20763,20765,20768,2,5,0
5958,4,3,20767,20768,20771,1,4,0
5959,4,1,20771,20771,20772,0,1,0
5960,6,2,20777,20777,20779,0,2,5
5961,6,3,20783,20783,20786,0,3,4
5962,4,2,20787,20787,20789,0,2,1
5963,3,1,20790,20790,20791,0,1,1
5964,2,2,20792,20792,20794,0,2,1
5965,6,2,20798,20798,20800,0,2,4
5966,5,1,20803,20803,20804,0,1,3
5967,2,2,20805,20805,20807,0,2,1
5968,4,2,20809,20809,20811,0,2,2
5969,3,3,20812,20812,20815,0,3,1
5970,6,1,20818,20818,20819,0,1,3
5971,1,2,20819,20819,20821,0,2,0
5972,6,2,20825,20825,20827,0,2,4
5973,1,1,20826,20827,20828,1,2,0
5974,3,1,20829,20829,20830,0,1,1
5975,2,3,20831,20831,20834,0,3,1
5976,3,1,20834,20834,20835,0,1,0
5977,2,3,20836,20836,20839,0,3,1
5978,2,3,20838,20839,20842,1,4,0
5979,3,3,20841,20842,20845,1,4,0
5980,1,1,20842,20845,20846,3,4,0
5981,5,1,20847,20847,20848,0,1,1
5982,2,1,20849,20849,20850,0,1,1
5983,5,2,20854,20854,20856,0,2,4
5984,4,3,20858,20858,20861,0,3,2
5985,3,1,20861,20861,20862,0,1,0
5986,5,2,20866,20866,20868,0,2,4
5987,3,2,20869,20869,20871,0,2,1
5988,2,3,20871,20871,20874,0,3,0
5989,1,2,20872,20874,20876,2,4,0
5990,1,2,20873,20876,20878,3,5,0
5991,2,1,20875,20878,20879,3,4,0
5992,6,1,20881,20881,20882,0,1,2
5993,3,2,20884,20884,20886,0,2,2
5994,3,2,20887,20887,20889,0,2,1
5995,1,1,20888,20889,20890,1,2,0
5996,1,3,20889,20890,20893,1,4,0
5997,5,3,20894,20894,20897,0,3,1
5998,5,2,20899,20899,20901,0,2,2
5999,4,3,20903,20903,20906,0,3,2
6000,1,2,20904,20906,20908,2,4,0
6001,1,1,20905,20908,20909,3,4,0
6002,4,1,20909,20909,20910,0,1,0
6003,5,2,20914,20914,20916,0,2,4
6004,5,2,20919,20919,20921,0,2,3
6005,2,3,20921,20921,20924,0,3,0
6006,3,1,20924,20924,20925,0,1,0
6007,6,2,20930,20930,20932,0,2,5
6008,4,2,20934,20934,20936,0,2,2
6009,5,2,20939,20939,20941,0,2,3
6010,2,3,20941,20941,20944,0,3,0
6011,5,1,20946,20946,20947,0,1,2
6012,5,3,20951,20951,20954,0,3,4
6013,1,3,20952,20954,20957,2,5,0
6014,5,3,20957,20957,20960,0,3,0
6015,3,3,20960,20960,20963,0,3,0
6016,5,1,20965,20965,20966,0,1,2
6017,1,2,20966,20966,20968,0,2,0
6018,6,3,20972,20972,20975,0,3,4
6019,5,1,20977,20977,20978,0,1,2
6020,6,2,20983,20983,20985,0,2,5
6021,6,3,20989,20989,20992,0,3,4
6022,6,2,20995,20995,20997,0,2,3
6023,4,1,20999,20999,21000,0,1,2
6024,3,3,21002,21002,21005,0,3,2
6025,1,1,21003,21005,21006,2,3,0
6026,1,1,21004,21006,21007,2,3,0
6027,4,1,21008,21008,21009,0,1,1
6028,1,3,21009,21009,21012,0,3,0
6029,6,3,21015,21015,21018,0,3,3
6030,4,1,21019,21019,21020,0,1,1
6031,5,1,21024,21024,21025,0,1,4
6032,4,1,21028,21028,21029,0,1,3
6033,2,3,21030,21030,21033,0,3,1
6034,2,1,21032,21033,21034,1,2,0
6035,2,2,21034,21034,21036,0,2,0
6036,4,3,21038,21038,21041,0,3,2
6037,1,2,21039,21041,21043,2,4,0
6038,5,1,21044,21044,21045,0,1,1
6039,6,3,21050,21050,21053,0,3,5
6040,1,3,21051,21053,21056,2,5,0
6041,4,2,21055,21056,21058,1,3,0
6042,4,3,21059,21059,21062,0,3,1
6043,1,3,21060,21062,21065,2,5,0
6044,1,2,21061,21065,21067,4,6,0
6045,5,3,21066,21067,21070,1,4,0
6046,2,2,21068,21070,21072,2,4,0
6047,6,2,21074,21074,21076,0,2,2
6048,1,3,21075,21076,21079,1,4,0
6049,6,3,21081,21081,21084,0,3,2
6050,4,1,21085,21085,21086,0,1,1
6051,2,3,21087,21087,21090,0,3,1
6052,4,3,21091,21091,21094,0,3,1
6053,2,3,21093,21094,21097,1,4,0
6054,4,2,21097,21097,21099,0,2,0
6055,1,2,21098,21099,21101,1,3,0
6056,2,3,21100,21101,21104,1,4,0
6057,1,1,21101,21104,21105,3,4,0
6058,4,2,21105,21105,21107,0,2,0
6059,4,2,21109,21109,21111,0,2,2
6060,4,1,21113,21113,21114,0,1,2
6061,1,1,21114,21114,21115,0,1,0
6062,1,2,21115,21115,21117,0,2,0
6063,6,1,21121,21121,21122,0,1,4
6064,1,1,21122,21122,21123,0,1,0
6065,6,1,21128,21128,21129,0,1,5
6066,2,3,21130,21130,21133,0,3,1
6067,4,2,21134,21134,21136,0,2,1
6068,1,2,21135,21136,21138,1,3,0
6069,3,1,21138,21138,21139,0,1,0
6070,6,2,21144,21144,21146,0,2,5
6071,1,1,21145,21146,21147,1,2,0
6072,2,2,21147,21147,21149,0,2,0
6073,3,3,21150,21150,21153,0,3,1
6074,6,2,21156,21156,21158,0,2,3
6075,2,3,21158,21158,21161,0,3,0
6076,5,2,21163,21163,21165,0,2,2
6077,6,3,21169,21169,21172,0,3,4
6078,1,3,21170,21172,21175,2,5,0
6079,3,1,21173,21175,21176,2,3,0
6080,6,3,21179,21179,21182,0,3,3
6081,1,3,21180,21182,21185,2,5,0
6082,4,3,21184,21185,21188,1,4,0
6083,3,2,21187,21188,21190,1,3,0
6084,1,1,21188,21190,21191,2,3,0
6085,1,3,21189,21191,21194,2,5,0
6086,4,3,21193,21194,21197,1,4,0
6087,4,3,21197,21197,21200,0,3,0
6088,2,1,21199,21200,21201,1,2,0
6089,4,1,21203,21203,21204,0,1,2
6090,6,2,21209,21209,21211,0,2,5
6091,6,3,21215,21215,21218,0,3,4
6092,1,1,21216,21218,21219,2,3,0
6093,2,2,21218,21219,21221,1,3,0
6094,6,3,21224,21224,21227,0,3,3
6095,2,3,21226,21227,21230,1,4,0
6096,6,3,21232,21232,21235,0,3,2
6097,5,2,21237,21237,21239,0,2,2
6098,3,2,21240,21240,21242,0,2,1
6099,6,3,21246,21246,21249,0,3,4
6100,2,1,21248,21249,21250,1,2,0
6101,6,1,21254,21254,21255,0,1,4
6102,2,3,21256,21256,21259,0,3,1
6103,3,2,21259,21259,21261,0,2,0
6104,6,2,21265,21265,21267,0,2,4
6105,5,3,21270,21270,21273,0,3,3
6106,5,2,21275,21275,21277,0,2,2
6107,1,2,21276,21277,21279,1,3,0
6108,3,1,21279,21279,21280,0,1,0
6109,3,3,21282,21282,21285,0,3,2
6110,2,3,21284,21285,21288,1,4,0
6111,4,3,21288,21288,21291,0,3,0
6112,2,3,21290,21291,21294,1,4,0
6113,5,2,21295,21295,21297,0,2,1
6114,2,2,21297,21297,21299,0,2,0
6115,4,1,21301,21301,21302,0,1,2
6116,4,3,21305,21305,21308,0,3,3
6117,3,3,21308,21308,21311,0,3,0
6118,1,2,21309,21311,21313,2,4,0
6119,4,2,21313,21313,21315,0,2,0
6120,1,3,21314,21315,21318,1,4,0
6121,2,3,21316,21318,21321,2,5,0
6122,4,2,21320,21321,21323,1,3,0
6123,1,2,21321,21323,21325,2,4,0
6124,4,3,21325,21325,21328,0,3,0
6125,3,3,21328,21328,21331,0,3,0
6126,5,3,21333,21333,21336,0,3,2
6127,1,3,21334,21336,21339,2,5,0
6128,5,2,21339,21339,21341,0,2,0
6129,4,1,21343,21343,21344,0,1,2
6130,5,2,21348,21348,21350,0,2,4
6131,1,1,21349,21350,21351,1,2,0
6132,5,3,21354,21354,21357,0,3,3
6133,2,3,21356,21357,21360,1,4,0
6134,6,3,21362,21362,21365,0,3,2
6135,2,1,21364,21365,21366,1,2,0
6136,6,2,21370,21370,21372,0,2,4
6137,2,3,21372,21372,21375,0,3,0
6138,6,1,21378,21378,21379,0,1,3
6139,3,2,21381,21381,21383,0,2,2
6140,2,3,21383,21383,21386,0,3,0
6141,6,1,21389,21389,21390,0,1,3
6142,5,1,21394,21394,21395,0,1,4
6143,5,3,21399,21399,21402,0,3,4
6144,6,3,21405,21405,21408,0,3,3
6145,2,3,21407,21408,21411,1,4,0
6146,6,3,21413,21413,21416,0,3,2
6147,2,2,21415,21416,21418,1,3,0
6148,4,1,21419,21419,21420,0,1,1
6149,1,2,21420,21420,21422,0,2,0
6150,3,1,21423,21423,21424,0,1,1
6151,6,3,21429,21429,21432,0,3,5
6152,2,1,21431,21432,21433,1,2,0
6153,1,1,21432,21433,21434,1,2,0
6154,1,1,21433,21434,21435,1,2,0
6155,4,3,21437,21437,21440,0,3,2
6156,6,2,21443,21443,21445,0,2,3
6157,4,2,21447,21447,21449,0,2,2
6158,5,3,21452,21452,21455,0,3,3
6159,4,3,21456,21456,21459,0,3,1
6160,2,1,21458,21459,21460,1,2,0
6161,6,1,21464,21464,21465,0,1,4
6162,5,3,21469,21469,21472,0,3,4
6163,4,2,21473,21473,21475,0,2,1
6164,1,1,21474,21475,21476,1,2,0
6165,2,1,21476,21476,21477,0,1,0
6166,1,3,21477,21477,21480,0,3,0
6167,6,3,21483,21483,21486,0,3,3
6168,1,2,21484,21486,21488,2,4,0
6169,5,3,21489,21489,21492,0,3,1
6170,3,2,21492,21492,21494,0,2,0
6171,5,1,21497,21497,21498,0,1,3
6172,1,3,21498,21498,21501,0,3,0
6173,4,1,21502,21502,21503,0,1,1
6174,6,3,21508,21508,21511,0,3,5
6175,3,1,21511,21511,21512,0,1,0
6176,3,1,21514,21514,21515,0,1,2
6177,6,2,21520,21520,21522,0,2,5
6178,5,2,21525,21525,21527,0,2,3
6179,3,3,21528,21528,21531,0,3,1
6180,5,1,21533,21533,21534,0,1,2
6181,4,1,21537,21537,21538,0,1,3
6182,6,2,21543,21543,21545,0,2,5
6183,6,3,21549,21549,21552,0,3,4
6184,4,3,21553,21553,21556,0,3,1
6185,3,3,21556,21556,21559,0,3,0
6186,1,3,21557,21559,21562,2,5,0
6187,2,3,21559,21562,21565,3,6,0
6188,6,3,21565,21565,21568,0,3,0
6189,4,2,21569,21569,21571,0,2,1
6190,5,3,21574,21574,21577,0,3,3
6191,4,3,21578,21578,21581,0,3,1
6192,3,1,21581,21581,21582,0,1,0
6193,4,1,21585,21585,21586,0,1,3
6194,3,2,21588,21588,21590,0,2,2
6195,4,2,21592,21592,21594,0,2,2
6196,2,2,21594,21594,21596,0,2,0
6197,2,2,21596,21596,21598,0,2,0
6198,3,2,21599,21599,21601,0,2,1
6199,6,3,21605,21605,21608,0,3,4
6200,6,3,21611,21611,21614,0,3,3
6201,4,2,21615,21615,21617,0,2,1
6202,4,1,21619,21619,21620,0,1,2
6203,2,3,21621,21621,21624,0,3,1
6204,2,2,21623,21624,21626,1,3,0
6205,5,1,21628,21628,21629,0,1,2
6206,5,1,21633,21633,21634,0,1,4
6207,3,3,21636,21636,21639,0,3,2
6208,3,1,21639,21639,21640,0,1,0
6209,5,1,21644,21644,21645,0,1,4
6210,6,3,21650,21650,21653,0,3,5
6211,3,3,21653,21653,21656,0,3,0
6212,1,1,21654,21656,21657,2,3,0
6213,6,2,21660,21660,21662,0,2,3
6214,3,1,21663,21663,21664,0,1,1
6215,2,1,21665,21665,21666,0,1,1
6216,1,3,21666,21666,21669,0,3,0
6217,6,2,21672,21672,21674,0,2,3
6218,2,3,21674,21674,21677,0,3,0
6219,5,3,21679,21679,21682,0,3,2
6220,3,2,21682,21682,21684,0,2,0
6221,3,3,21685,21685,21688,0,3,1
6222,3,3,21688,21688,21691,0,3,0
6223,3,1,21691,21691,21692,0,1,0
6224,2,1,21693,21693,21694,0,1,1
6225,5,2,21698,21698,21700,0,2,4
6226,2,1,21700,21700,21701,0,1,0
6227,4,1,21704,21704,21705,0,1,3
6228,4,1,21708,21708,21709,0,1,3
6229,6,2,21714,21714,21716,0,2,5
6230,3,2,21717,21717,21719,0,2,1
6231,5,2,21722,21722,21724,0,2,3
6232,5,3,21727,21727,21730,0,3,3
6233,6,3,21733,21733,21736,0,3,3
6234,2,2,21735,21736,21738,1,3,0
6235,2,1,21737,21738,21739,1,2,0
6236,5,1,21742,21742,21743,0,1,3
6237,3,2,21745,21745,21747,0,2,2
6238,5,1,21750,21750,21751,0,1,3
6239,3,2,21753,21753,21755,0,2,2
6240,2,3,21755,21755,21758,0,3,0
6241,4,3,21759,21759,21762,0,3,1
6242,1,2,21760,21762,21764,2,4,0
6243,5,1,21765,21765,21766,0,1,1
6244,1,2,21766,21766,21768,0,2,0
6245,1,2,21767,21768,21770,1,3,0
6246,4,2,21771,21771,21773,0,2,1
6247,3,1,21774,21774,21775,0,1,1
6248,1,1,21775,21775,21776,0,1,0
6249,2,1,21777,21777,21778,0,1,1
6250,2,1,21779,21779,21780,0,1,1
6251,1,1,21780,21780,21781,0,1,0
6252,3,1,21783,21783,21784,0,1,2
6253,1,3,21784,21784,21787,0,3,0
6254,1,3,21785,21787,21790,2,5,0
6255,3,1,21788,21790,21791,2,3,0
6256,1,3,21789,21791,21794,2,5,0
6257,3,1,21792,21794,21795,2,3,0
6258,6,1,21798,21798,21799,0,1,3
6259,4,3,21802,21802,21805,0,3,3
6260,1,3,21803,21805,21808,2,5,0
6261,2,2,21805,21808,21810,3,5,0
6262,6,2,21811,21811,21813,0,2,1
6263,3,3,21814,21814,21817,0,3,1
6264,6,3,21820,21820,21823,0,3,3
6265,3,3,21823,21823,21826,0,3,0
6266,3,2,21826,21826,21828,0,2,0
6267,3,2,21829,21829,21831,0,2,1
6268,1,1,21830,21831,21832,1,2,0
6269,2,1,21832,21832,21833,0,1,0
6270,4,3,21836,21836,21839,0,3,3
6271,5,2,21841,21841,21843,0,2,2
6272,4,1,21845,21845,21846,0,1,2
6273,5,1,21850,21850,21851,0,1,4
6274,6,1,21856,21856,21857,0,1,5
6275,4,1,21860,21860,21861,0,1,3
6276,5,1,21865,21865,21866,0,1,4
6277,3,2,21868,21868,21870,0,2,2
6278,2,1,21870,21870,21871,0,1,0
6279,2,2,21872,21872,21874,0,2,1
6280,5,3,21877,21877,21880,0,3,3
6281,5,3,21882,21882,21885,0,3,2
6282,4,2,21886,21886,21888,0,2,1
6283,1,3,21887,21888,21891,1,4,0
6284,2,2,21889,21891,21893,2,4,0
6285,5,3,21894,21894,21897,0,3,1
6286,4,1,21898,21898,21899,0,1,1
6287,5,1,21903,21903,21904,0,1,4
6288,3,1,21906,21906,21907,0,1,2
6289,1,2,21907,21907,21909,0,2,0
6290,3,2,21910,21910,21912,0,2,1
6291,3,1,21913,21913,21914,0,1,1
6292,4,3,21917,21917,21920,0,3,3
6293,6,1,21923,21923,21924,0,1,3
6294,6,3,21929,21929,21932,0,3,5
6295,4,2,21933,21933,21935,0,2,1
6296,2,2,21935,21935,21937,0,2,0
6297,1,2,21936,21937,21939,1,3,0
6298,6,1,21942,21942,21943,0,1,3
6299,6,3,21948,21948,21951,0,3,5
6300,5,3,21953,21953,21956,0,3,2
6301,6,1,21959,21959,21960,0,1,3
6302,1,1,21960,21960,21961,0,1,0
6303,6,2,21966,21966,21968,0,2,5
6304,2,1,21968,21968,21969,0,1,0
6305,4,3,21972,21972,21975,0,3,3
6306,3,1,21975,21975,21976,0,1,0
6307,4,3,21979,21979,21982,0,3,3
6308,3,1,21982,21982,21983,0,1,0
6309,3,1,21985,21985,21986,0,1,2
6310,4,2,21989,21989,21991,0,2,3
6311,3,3,21992,21992,21995,0,3,1
6312,5,2,21997,21997,21999,0,2,2
6313,5,3,22002,22002,22005,0,3,3
6314,3,3,22005,22005,22008,0,3,0
6315,5,1,22010,22010,22011,0,1,2
6316,2,3,22012,22012,22015,0,3,1
6317,6,3,22018,22018,22021,0,3,3
6318,2,3,22020,22021,22024,1,4,0
6319,6,3,22026,22026,22029,0,3,2
6320,1,3,22027,22029,22032,2,5,0
6321,5,2,22032,22032,22034,0,2,0
6322,5,2,22037,22037,22039,0,2,3
6323,3,3,22040,22040,22043,0,3,1
6324,4,3,22044,22044,22047,0,3,1
6325,2,3,22046,22047,22050,1,4,0
6326,5,2,22051,22051,22053,0,2,1
6327,1,3,22052,22053,22056,1,4,0
6328,5,2,22057,22057,22059,0,2,1
6329,3,2,22060,22060,22062,0,2,1
6330,3,1,22063,22063,22064,0,1,1
6331,4,1,22067,22067,22068,0,1,3
6332,3,1,22070,22070,22071,0,1,2
6333,4,1,22074,22074,22075,0,1,3
6334,6,3,22080,22080,22083,0,3,5
6335,2,2,22082,22083,22085,1,3,0
6336,1,3,22083,22085,22088,2,5,0
6337,1,1,22084,22088,22089,4,5,0
6338,1,1,22085,22089,22090,4,5,0
6339,5,3,22090,22090,22093,0,3,0
6340,5,1,22095,22095,22096,0,1,2
6341,4,1,22099,22099,22100,0,1,3
6342,6,2,22105,22105,22107,0,2,5
6343,5,1,22110,22110,22111,0,1,3
6344,5,1,22115,22115,22116,0,1,4
6345,5,3,22120,22120,22123,0,3,4
6346,2,2,22122,22123,22125,1,3,0
6347,3,1,22125,22125,22126,0,1,0
6348,1,3,22126,22126,22129,0,3,0
6349,1,1,22127,22129,22130,2,3,0
6350,6,1,22133,22133,22134,0,1,3
6351,4,1,22137,22137,22138,0,1,3
6352,6,1,22143,22143,22144,0,1,5
6353,5,1,22148,22148,22149,0,1,4
6354,1,1,22149,22149,22150,0,1,0
6355,6,1,22155,22155,22156,0,1,5
6356,4,2,22159,22159,22161,0,2,3
6357,2,1,22161,22161,22162,0,1,0
6358,6,2,22167,22167,22169,0,2,5
6359,6,1,22173,22173,22174,0,1,4
6360,5,1,22178,22178,22179,0,1,4
6361,1,1,22179,22179,22180,0,1,0
6362,5,1,22184,22184,22185,0,1,4
6363,1,3,22185,22185,22188,0,3,0
6364,6,1,22191,22191,22192,0,1,3
6365,3,1,22194,22194,22195,0,1,2
6366,3,2,22197,22197,22199,0,2,2
6367,3,1,22200,22200,22201,0,1,1
6368,5,3,22205,22205,22208,0,3,4
6369,4,2,22209,22209,22211,0,2,1
6370,1,1,22210,22211,22212,1,2,0
6371,2,1,22212,22212,22213,0,1,0
6372,4,2,22216,22216,22218,0,2,3
6373,2,3,22218,22218,22221,0,3,0
6374,1,2,22219,22221,22223,2,4,0
6375,1,2,22220,22223,22225,3,5,0
6376,6,2,22226,22226,22228,0,2,1
6377,4,2,22230,22230,22232,0,2,2
6378,2,2,22232,22232,22234,0,2,0
6379,1,2,22233,22234,22236,1,3,0
6380,1,1,22234,22236,22237,2,3,0
6381,1,1,22235,22237,22238,2,3,0
6382,4,1,22239,22239,22240,0,1,1
6383,5,2,22244,22244,22246,0,2,4
6384,4,1,22248,22248,22249,0,1,2
6385,1,1,22249,22249,22250,0,1,0
6386,6,2,22255,22255,22257,0,2,5
6387,4,2,22259,22259,22261,0,2,2
6388,6,3,22265,22265,22268,0,3,4
6389,2,2,22267,22268,22270,1,3,0
6390,6,3,22273,22273,22276,0,3,3
6391,2,1,22275,22276,22277,1,2,0
6392,4,1,22279,22279,22280,0,1,2
6393,5,1,22284,22284,22285,0,1,4
6394,5,3,22289,22289,22292,0,3,4
6395,4,1,22293,22293,22294,0,1,1
6396,1,2,22294,22294,22296,0,2,0
6397,1,1,22295,22296,22297,1,2,0
6398,6,3,22301,22301,22304,0,3,4
6399,1,2,22302,22304,22306,2,4,0
6400,3,1,22305,22306,22307,1,2,0
6401,3,2,22308,22308,22310,0,2,1
6402,5,2,22313,22313,22315,0,2,3
6403,2,2,22315,22315,22317,0,2,0
6404,2,1,22317,22317,22318,0,1,0
6405,1,3,22318,22318,22321,0,3,0
6406,4,1,22322,22322,22323,0,1,1
6407,4,1,22326,22326,22327,0,1,3
6408,4,1,22330,22330,22331,0,1,3
6409,5,3,22335,22335,22338,0,3,4
6410,2,3,22337,22338,22341,1,4,0
6411,1,1,22338,22341,22342,3,4,0
6412,2,2,22340,22342,22344,2,4,0
6413,2,1,22342,22344,22345,2,3,0
6414,4,1,22346,22346,22347,0,1,1
6415,2,3,22348,22348,22351,0,3,1
6416,5,1,22353,22353,22354,0,1,2
6417,4,3,22357,22357,22360,0,3,3
6418,6,2,22363,22363,22365,0,2,3
6419,2,1,22365,22365,22366,0,1,0
6420,5,2,22370,22370,22372,0,2,4
6421,1,2,22371,22372,22374,1,3,0
6422,5,1,22376,22376,22377,0,1,2
6423,3,2,22379,22379,22381,0,2,2
6424,2,3,22381,22381,22384,0,3,0
6425,5,1,22386,22386,22387,0,1,2
6426,4,3,22390,22390,22393,0,3,3
6427,2,1,22392,22393,22394,1,2,0
6428,2,3,22394,22394,22397,0,3,0
6429,4,3,22398,22398,22401,0,3,1
6430,6,2,22404,22404,22406,0,2,3
6431,4,3,22408,22408,22411,0,3,2
6432,3,1,22411,22411,22412,0,1,0
6433,5,2,22416,22416,22418,0,2,4
6434,5,3,22421,22421,22424,0,3,3
6435,2,2,22423,22424,22426,1,3,0
6436,5,1,22428,22428,22429,0,1,2
6437,3,3,22431,22431,22434,0,3,2
6438,5,3,22436,22436,22439,0,3,2
6439,4,3,22440,22440,22443,0,3,1
6440,2,2,22442,22443,22445,1,3,0
6441,4,1,22446,22446,22447,0,1,1
6442,2,3,22448,22448,22451,0,3,1
6443,2,3,22450,22451,22454,1,4,0
6444,4,3,22454,22454,22457,0,3,0
6445,3,1,22457,22457,22458,0,1,0
6446,4,1,22461,22461,22462,0,1,3
6447,5,3,22466,22466,22469,0,3,4
6448,1,1,22467,22469,22470,2,3,0
6449,6,3,22473,22473,22476,0,3,3
6450,5,3,22478,22478,22481,0,3,2
6451,1,3,22479,22481,22484,2,5,0
6452,5,3,22484,22484,22487,0,3,0
6453,6,3,22490,22490,22493,0,3,3
6454,5,1,22495,22495,22496,0,1,2
6455,2,3,22497,22497,22500,0,3,1
6456,6,3,22503,22503,22506,0,3,3
6457,4,2,22507,22507,22509,0,2,1
6458,5,3,22512,22512,22515,0,3,3
6459,1,3,22513,22515,22518,2,5,0
6460,1,1,22514,22518,22519,4,5,0
6461,5,1,22519,22519,22520,0,1,0
6462,4,1,22523,22523,22524,0,1,3
6463,5,3,22528,22528,22531,0,3,4
6464,3,3,22531,22531,22534,0,3,0
6465,3,3,22534,22534,22537,0,3,0
6466,6,2,22540,22540,22542,0,2,3
6467,2,2,22542,22542,22544,0,2,0
6468,3,1,22545,22545,22546,0,1,1
6469,4,3,22549,22549,22552,0,3,3
6470,1,1,22550,22552,22553,2,3,0
6471,1,1,22551,22553,22554,2,3,0
6472,2,2,22553,22554,22556,1,3,0
6473,3,1,22556,22556,22557,0,1,0
6474,2,1,22558,22558,22559,0,1,1
6475,5,2,22563,22563,22565,0,2,4
6476,3,1,22566,22566,22567,0,1,1
6477,6,3,22572,22572,22575,0,3,5
6478,6,3,22578,22578,22581,0,3,3
6479,5,2,22583,22583,22585,0,2,2
6480,4,2,22587,22587,22589,0,2,2
6481,6,3,22593,22593,22596,0,3,4
6482,2,1,22595,22596,22597,1,2,0
6483,5,3,22600,22600,22603,0,3,3
6484,3,2,22603,22603,22605,0,2,0
6485,6,2,22609,22609,22611,0,2,4
6486,3,1,22612,22612,22613,0,1,1
6487,4,2,22616,22616,22618,0,2,3
6488,5,3,22621,22621,22624,0,3,3
6489,6,2,22627,22627,22629,0,2,3
6490,3,2,22630,22630,22632,0,2,1
6491,5,1,22635,22635,22636,0,1,3
6492,5,3,22640,22640,22643,0,3,4
6493,6,1,22646,22646,22647,0,1,3
6494,4,1,22650,22650,22651,0,1,3
6495,2,3,22652,22652,22655,0,3,1
6496,3,2,22655,22655,22657,0,2,0
6497,2,2,22657,22657,22659,0,2,0
6498,6,3,22663,22663,22666,0,3,4
6499,4,1,22667,22667,22668,0,1,1
6500,6,1,22673,22673,22674,0,1,5
6501,2,1,22675,22675,22676,0,1,1
6502,3,1,22678,22678,22679,0,1,2
6503,3,2,22681,22681,22683,0,2,2
6504,6,3,22687,22687,22690,0,3,4
6505,3,1,22690,22690,22691,0,1,0
6506,1,3,22691,22691,22694,0,3,0
6507,6,2,22697,22697,22699,0,2,3
6508,4,1,22701,22701,22702,0,1,2
6509,4,1,22705,22705,22706,0,1,3
6510,1,2,22706,22706,22708,0,2,0
6511,5,1,22711,22711,22712,0,1,3
6512,2,1,22713,22713,22714,0,1,1
6513,6,3,22719,22719,22722,0,3,5
6514,1,2,22720,22722,22724,2,4,0
6515,4,1,22724,22724,22725,0,1,0
6516,4,1,22728,22728,22729,0,1,3
6517,6,1,22734,22734,22735,0,1,5
6518,3,1,22737,22737,22738,0,1,2
6519,5,1,22742,22742,22743,0,1,4
6520,3,3,22745,22745,22748,0,3,2
6521,6,1,22751,22751,22752,0,1,3
6522,1,2,22752,22752,22754,0,2,0
6523,6,1,22758,22758,22759,0,1,4
6524,1,3,22759,22759,22762,0,3,0
6525,1,2,22760,22762,22764,2,4,0
6526,6,3,22766,22766,22769,0,3,2
6527,2,3,22768,22769,22772,1,4,0
6528,5,1,22773,22773,22774,0,1,1
6529,2,1,22775,22775,22776,0,1,1
6530,1,3,22776,22776,22779,0,3,0
6531,3,3,22779,22779,22782,0,3,0
6532,4,2,22783,22783,22785,0,2,1
6533,3,1,22786,22786,22787,0,1,1
6534,6,3,22792,22792,22795,0,3,5
6535,1,2,22793,22795,22797,2,4,0
6536,1,3,22794,22797,22800,3,6,0
6537,1,1,22795,22800,22801,5,6,0
6538,6,1,22801,22801,22802,0,1,0
6539,5,2,22806,22806,22808,0,2,4
6540,1,2,22807,22808,22810,1,3,0
6541,2,1,22809,22810,22811,1,2,0
6542,5,3,22814,22814,22817,0,3,3
6543,4,3,22818,22818,22821,0,3,1
6544,6,2,22824,22824,22826,0,2,3
6545,4,2,22828,22828,22830,0,2,2
6546,2,2,22830,22830,22832,0,2,0
6547,1,3,22831,22832,22835,1,4,0
6548,5,3,22836,22836,22839,0,3,1
6549,2,1,22838,22839,22840,1,2,0
6550,5,2,22843,22843,22845,0,2,3
6551,4,1,22847,22847,22848,0,1,2
6552,2,2,22849,22849,22851,0,2,1
6553,4,3,22853,22853,22856,0,3,2
6554,1,3,22854,22856,22859,2,5,0
6555,6,1,22860,22860,22861,0,1,1
6556,3,3,22863,22863,22866,0,3,2
6557,3,1,22866,22866,22867,0,1,0
6558,3,1,22869,22869,22870,0,1,2
6559,4,1,22873,22873,22874,0,1,3
6560,5,3,22878,22878,22881,0,3,4
6561,4,3,22882,22882,22885,0,3,1
6562,1,1,22883,22885,22886,2,3,0
6563,2,1,22885,22886,22887,1,2,0
6564,4,1,22889,22889,22890,0,1,2
6565,1,1,22890,22890,22891,0,1,0
6566,5,2,22895,22895,22897,0,2,4
6567,1,2,22896,22897,22899,1,3,0
6568,3,3,22899,22899,22902,0,3,0
6569,6,2,22905,22905,22907,0,2,3
6570,1,1,22906,22907,22908,1,2,0
6571,6,3,22912,22912,22915,0,3,4
6572,4,1,22916,22916,22917,0,1,1
6573,2,3,22918,22918,22921,0,3,1
6574,1,2,22919,22921,22923,2,4,0
6575,6,3,22925,22925,22928,0,3,2
6576,4,2,22929,22929,22931,0,2,1
6577,3,1,22932,22932,22933,0,1,1
6578,3,1,22935,22935,22936,0,1,2
6579,2,1,22937,22937,22938,0,1,1
6580,3,3,22940,22940,22943,0,3,2
6581,1,3,22941,22943,22946,2,5,0
6582,6,3,22947,22947,22950,0,3,1
6583,1,1,22948,22950,22951,2,3,0
6584,5,1,22953,22953,22954,0,1,2
6585,6,2,22959,22959,22961,0,2,5
6586,2,3,22961,22961,22964,0,3,0
6587,3,3,22964,22964,22967,0,3,0
6588,1,3,22965,22967,22970,2,5,0
6589,4,1,22969,22970,22971,1,2,0
6590,1,1,22970,22971,22972,1,2,0
6591,5,1,22975,22975,22976,0,1,3
6592,6,3,22981,22981,22984,0,3,5
6593,3,2,22984,22984,22986,0,2,0
6594,6,1,22990,22990,22991,0,1,4
6595,4,2,22994,22994,22996,0,2,3
6596,3,3,22997,22997,23000,0,3,1
6597,2,1,22999,23000,23001,1,2,0
6598,5,3,23004,23004,23007,0,3,3
6599,4,1,23008,23008,23009,0,1,1
6600,2,1,23010,23010,23011,0,1,1
6601,2,3,23012,23012,23015,0,3,1
6602,5,1,23017,23017,23018,0,1,2
6603,4,3,23021,23021,23024,0,3,3
6604,1,3,23022,23024,23027,2,5,0
6605,2,3,23024,23027,23030,3,6,0
6606,2,3,23026,23030,23033,4,7,0
6607,6,2,23032,23033,23035,1,3,0
6608,1,3,23033,23035,23038,2,5,0
6609,6,2,23039,23039,23041,0,2,1
6610,2,3,23041,23041,23044,0,3,0
6611,5,2,23046,23046,23048,0,2,2
6612,5,2,23051,23051,23053,0,2,3
6613,5,3,23056,23056,23059,0,3,3
6614,4,2,23060,23060,23062,0,2,1
6615,6,1,23066,23066,23067,0,1,4
6616,4,2,23070,23070,23072,0,2,3
6617,1,3,23071,23072,23075,1,4,0
6618,3,2,23074,23075,23077,1,3,0
6619,4,1,23078,23078,23079,0,1,1
6620,3,2,23081,23081,23083,0,2,2
6621,6,3,23087,23087,23090,0,3,4
6622,6,3,23093,23093,23096,0,3,3
6623,3,3,23096,23096,23099,0,3,0
6624,6,3,23102,23102,23105,0,3,3
6625,3,3,23105,23105,23108,0,3,0
6626,6,1,23111,23111,23112,0,1,3
6627,6,3,23117,23117,23120,0,3,5
6628,4,2,23121,23121,23123,0,2,1
6629,3,3,23124,23124,23127,0,3,1
6630,1,2,23125,23127,23129,2,4,0
6631,5,2,23130,23130,23132,0,2,1
6632,5,3,23135,23135,23138,0,3,3
6633,4,1,23139,23139,23140,0,1,1
6634,6,3,23145,23145,23148,0,3,5
6635,3,1,23148,23148,23149,0,1,0
6636,3,1,23151,23151,23152,0,1,2
6637,5,1,23156,23156,23157,0,1,4
6638,5,2,23161,23161,23163,0,2,4
6639,3,3,23164,23164,23167,0,3,1
6640,1,3,23165,23167,23170,2,5,0
6641,6,3,23171,23171,23174,0,3,1
6642,1,1,23172,23174,23175,2,3,0
6643,3,3,23175,23175,23178,0,3,0
6644,6,1,23181,23181,23182,0,1,3
6645,6,1,23187,23187,23188,0,1,5
6646,5,3,23192,23192,23195,0,3,4
6647,1,3,23193,23195,23198,2,5,0
6648,5,2,23198,23198,23200,0,2,0
6649,2,2,23200,23200,23202,0,2,0
6650,6,1,23206,23206,23207,0,1,4
6651,2,3,23208,23208,23211,0,3,1
6652,4,1,23212,23212,23213,0,1,1
6653,4,2,23216,23216,23218,0,2,3
6654,3,2,23219,23219,23221,0,2,1
6655,3,3,23222,23222,23225,0,3,1
6656,6,1,23228,23228,23229,0,1,3
6657,4,2,23232,23232,23234,0,2,3
6658,4,3,23236,23236,23239,0,3,2
6659,5,3,23241,23241,23244,0,3,2
6660,1,2,23242,23244,23246,2,4,0
6661,5,1,23247,23247,23248,0,1,1
6662,1,1,23248,23248,23249,0,1,0
6663,5,3,23253,23253,23256,0,3,4
6664,2,1,23255,23256,23257,1,2,0
6665,5,2,23260,23260,23262,0,2,3
6666,1,3,23261,23262,23265,1,4,0
6667,2,3,23263,23265,23268,2,5,0
6668,4,3,23267,23268,23271,1,4,0
6669,4,1,23271,23271,23272,0,1,0
6670,1,1,23272,23272,23273,0,1,0
6671,3,2,23275,23275,23277,0,2,2
6672,2,2,23277,23277,23279,0,2,0
6673,5,3,23282,23282,23285,0,3,3
6674,4,2,23286,23286,23288,0,2,1
6675,2,1,23288,23288,23289,0,1,0
6676,3,1,23291,23291,23292,0,1,2
6677,6,1,23297,23297,23298,0,1,5
6678,5,3,23302,23302,23305,0,3,4
6679,4,2,23306,23306,23308,0,2,1
6680,4,2,23310,23310,23312,0,2,2
6681,6,1,23316,23316,23317,0,1,4
6682,4,1,23320,23320,23321,0,1,3
6683,2,1,23322,23322,23323,0,1,1
6684,4,3,23326,23326,23329,0,3,3
6685,2,1,23328,23329,23330,1,2,0
6686,1,3,23329,23330,23333,1,4,0
6687,6,3,23335,23335,23338,0,3,2
6688,1,1,23336,23338,23339,2,3,0
6689,3,2,23339,23339,23341,0,2,0
6690,5,1,23344,23344,23345,0,1,3
6691,2,2,23346,23346,23348,0,2,1
6692,1,2,23347,23348,23350,1,3,0
6693,6,2,23353,23353,23355,0,2,3
6694,3,2,23356,23356,23358,0,2,1
6695,1,1,23357,23358,23359,1,2,0
6696,3,3,23360,23360,23363,0,3,1
6697,6,1,23366,23366,23367,0,1,3
6698,6,2,23372,23372,23374,0,2,5
6699,6,2,23378,23378,23380,0,2,4
6700,6,1,23384,23384,23385,0,1,4
6701,3,3,23387,23387,23390,0,3,2
6702,4,1,23391,23391,23392,0,1,1
6703,6,1,23397,23397,23398,0,1,5
6704,6,2,23403,23403,23405,0,2,5
6705,5,3,23408,23408,23411,0,3,3
6706,4,1,23412,23412,23413,0,1,1
6707,4,1,23416,23416,23417,0,1,3
6708,4,3,23420,23420,23423,0,3,3
6709,6,3,23426,23426,23429,0,3,3
6710,5,2,23431,23431,23433,0,2,2
6711,1,3,23432,23433,23436,1,4,0
6712,3,3,23435,23436,23439,1,4,0
6713,4,3,23439,23439,23442,0,3,0
6714,3,2,23442,23442,23444,0,2,0
6715,4,1,23446,23446,23447,0,1,2
6716,2,3,23448,23448,23451,0,3,1
6717,6,2,23454,23454,23456,0,2,3
6718,1,1,23455,23456,23457,1,2,0
6719,5,2,23460,23460,23462,0,2,3
6720,4,3,23464,23464,23467,0,3,2
6721,5,1,23469,23469,23470,0,1,2
6722,5,3,23474,23474,23477,0,3,4
6723,6,3,23480,23480,23483,0,3,3
6724,1,1,23481,23483,23484,2,3,0
6725,5,1,23486,23486,23487,0,1,2
6726,1,3,23487,23487,23490,0,3,0
6727,5,2,23492,23492,23494,0,2,2
6728,4,1,23496,23496,23497,0,1,2
6729,4,3,23500,23500,23503,0,3,3
6730,5,2,23505,23505,23507,0,2,2
6731,1,3,23506,23507,23510,1,4,0
6732,4,1,23510,23510,23511,0,1,0
6733,2,3,23512,23512,23515,0,3,1
6734,2,1,23514,23515,23516,1,2,0
6735,3,2,23517,23517,23519,0,2,1
6736,2,3,23519,23519,23522,0,3,0
6737,4,3,23523,23523,23526,0,3,1
6738,5,2,23528,23528,23530,0,2,2
6739,2,1,23530,23530,23531,0,1,0
6740,5,3,23535,23535,23538,0,3,4
6741,3,1,23538,23538,23539,0,1,0
6742,5,2,23543,23543,23545,0,2,4
6743,2,2,23545,23545,23547,0,2,0
6744,2,3,23547,23547,23550,0,3,0
6745,3,3,23550,23550,23553,0,3,0
6746,3,1,23553,23553,23554,0,1,0
6747,3,2,23556,23556,23558,0,2,2
6748,2,1,23558,23558,23559,0,1,0
6749,6,2,23564,23564,23566,0,2,5
6750,6,2,23570,23570,23572,0,2,4
6751,5,3,23575,23575,23578,0,3,3
6752,5,1,23580,23580,23581,0,1,2
6753,2,1,23582,23582,23583,0,1,1
6754,2,3,23584,23584,23587,0,3,1
6755,3,2,23587,23587,23589,0,2,0
6756,3,3,23590,23590,23593,0,3,1
6757,6,1,23596,23596,23597,0,1,3
6758,3,1,23599,23599,23600,0,1,2
6759,2,1,23601,23601,23602,0,1,1
6760,3,2,23604,23604,23606,0,2,2
6761,4,1,23608,23608,23609,0,1,2
6762,3,2,23611,23611,23613,0,2,2
6763,1,1,23612,23613,23614,1,2,0
6764,2,1,23614,23614,23615,0,1,0
6765,6,3,23620,23620,23623,0,3,5
6766,5,1,23625,23625,23626,0,1,2
6767,4,1,23629,23629,23630,0,1,3
6768,3,2,23632,23632,23634,0,2,2
6769,1,1,23633,23634,23635,1,2,0
6770,2,2,23635,23635,23637,0,2,0
6771,5,3,23640,23640,23643,0,3,3
6772,4,1,23644,23644,23645,0,1,1
6773,4,2,23648,23648,23650,0,2,3
6774,6,1,23654,23654,23655,0,1,4
6775,5,2,23659,23659,23661,0,2,4
6776,1,3,23660,23661,23664,1,4,0
6777,1,1,23661,23664,23665,3,4,0
6778,5,2,23666,23666,23668,0,2,1
6779,4,2,23670,23670,23672,0,2,2
6780,6,2,23676,23676,23678,0,2,4
6781,2,1,23678,23678,23679,0,1,0
6782,3,3,23681,23681,23684,0,3,2
6783,3,2,23684,23684,23686,0,2,0
6784,5,3,23689,23689,23692,0,3,3
6785,3,2,23692,23692,23694,0,2,0
6786,2,2,23694,23694,23696,0,2,0
6787,4,2,23698,23698,23700,0,2,2
6788,4,2,23702,23702,23704,0,2,2
6789,4,1,23706,23706,23707,0,1,2
6790,6,2,23712,23712,23714,0,2,5
6791,2,3,23714,23714,23717,0,3,0
6792,3,1,23717,23717,23718,0,1,0
6793,1,1,23718,23718,23719,0,1,0
6794,3,1,23721,23721,23722,0,1,2
6795,3,2,23724,23724,23726,0,2,2
6796,6,3,23730,23730,23733,0,3,4
6797,3,3,23733,23733,23736,0,3,0
6798,5,1,23738,23738,23739,0,1,2
6799,3,2,23741,23741,23743,0,2,2
6800,1,2,23742,23743,23745,1,3,0
6801,2,2,23744,23745,23747,1,3,0
6802,3,3,23747,23747,23750,0,3,0
6803,4,2,23751,23751,23753,0,2,1
6804,6,2,23757,23757,23759,0,2,4
6805,5,3,23762,23762,23765,0,3,3
6806,3,3,23765,23765,23768,0,3,0
6807,1,2,23766,23768,23770,2,4,0
6808,3,2,23769,23770,23772,1,3,0
6809,6,2,23775,23775,23777,0,2,3
6810,5,3,23780,23780,23783,0,3,3
6811,1,2,23781,23783,23785,2,4,0
6812,4,1,23785,23785,23786,0,1,0
6813,6,3,23791,23791,23794,0,3,5
6814,2,2,23793,23794,23796,1,3,0
6815,5,1,23798,23798,23799,0,1,2
6816,2,2,23800,23800,23802,0,2,1
6817,1,1,23801,23802,23803,1,2,0
6818,2,3,23803,23803,23806,0,3,0
6819,2,1,23805,23806,23807,1,2,0
6820,6,3,23811,23811,23814,0,3,4
6821,4,1,23815,23815,23816,0,1,1
6822,3,3,23818,23818,23821,0,3,2
6823,3,1,23821,23821,23822,0,1,0
6824,5,2,23826,23826,23828,0,2,4
6825,5,3,23831,23831,23834,0,3,3
6826,6,1,23837,23837,23838,0,1,3
6827,6,3,23843,23843,23846,0,3,5
6828,2,2,23845,23846,23848,1,3,0
6829,6,1,23851,23851,23852,0,1,3
6830,4,3,23855,23855,23858,0,3,3
6831,6,2,23861,23861,23863,0,2,3
6832,1,2,23862,23863,23865,1,3,0
6833,2,3,23864,23865,23868,1,4,0
6834,4,1,23868,23868,23869,0,1,0
6835,3,2,23871,23871,23873,0,2,2
6836,3,1,23874,23874,23875,0,1,1
6837,2,1,23876,23876,23877,0,1,1
6838,2,2,23878,23878,23880,0,2,1
6839,3,1,23881,23881,23882,0,1,1
6840,2,3,23883,23883,23886,0,3,1
6841,2,3,23885,23886,23889,1,4,0
6842,4,1,23889,23889,23890,0,1,0
6843,5,3,23894,23894,23897,0,3,4
6844,6,2,23900,23900,23902,0,2,3
6845,1,3,23901,23902,23905,1,4,0
6846,4,1,23905,23905,23906,0,1,0
6847,6,3,23911,23911,23914,0,3,5
6848,1,3,23912,23914,23917,2,5,0
6849,2,2,23914,23917,23919,3,5,0
6850,5,1,23919,23919,23920,0,1,0
6851,4,3,23923,23923,23926,0,3,3
6852,1,1,23924,23926,23927,2,3,0
6853,4,1,23928,23928,23929,0,1,1
6854,3,3,23931,23931,23934,0,3,2
6855,1,3,23932,23934,23937,2,5,0
6856,6,3,23938,23938,23941,0,3,1
6857,4,1,23942,23942,23943,0,1,1
6858,1,1,23943,23943,23944,0,1,0
6859,1,1,23944,23944,23945,0,1,0
6860,4,3,23948,23948,23951,0,3,3
6861,2,2,23950,23951,23953,1,3,0
6862,4,1,23954,23954,23955,0,1,1
6863,1,3,23955,23955,23958,0,3,0
6864,5,3,23960,23960,23963,0,3,2
6865,1,2,23961,23963,23965,2,4,0
6866,4,2,23965,23965,23967,0,2,0
6867,5,3,23970,23970,23973,0,3,3
6868,6,3,23976,23976,23979,0,3,3
6869,6,2,23982,23982,23984,0,2,3
6870,5,2,23987,23987,23989,0,2,3
6871,5,2,23992,23992,23994,0,2,3
6872,5,1,23997,23997,23998,0,1,3
6873,5,1,24002,24002,24003,0,1,4
6874,5,3,24007,24007,24010,0,3,4
6875,1,1,24008,24010,24011,2,3,0
6876,3,1,24011,24011,24012,0,1,0
6877,6,3,24017,24017,24020,0,3,5
6878,1,1,24018,24020,24021,2,3,0
6879,3,2,24021,24021,24023,0,2,0
6880,3,2,24024,24024,24026,0,2,1
6881,6,2,24030,24030,24032,0,2,4
6882,1,1,24031,24032,24033,1,2,0
6883,1,3,24032,24033,24036,1,4,0
6884,1,2,24033,24036,24038,3,5,0
6885,6,2,24039,24039,24041,0,2,1
6886,1,2,24040,24041,24043,1,3,0
6887,2,1,24042,24043,24044,1,2,0
6888,3,1,24045,24045,24046,0,1,1
6889,1,3,24046,24046,24049,0,3,0
6890,2,1,24048,24049,24050,1,2,0
6891,5,1,24053,24053,24054,0,1,3
6892,4,1,24057,24057,24058,0,1,3
6893,1,1,24058,24058,24059,0,1,0
6894,2,1,24060,24060,24061,0,1,1
6895,4,1,24064,24064,24065,0,1,3
6896,2,3,24066,24066,24069,0,3,1
6897,2,1,24068,24069,24070,1,2,0
6898,5,2,24073,24073,24075,0,2,3
6899,4,1,24077,24077,24078,0,1,2
6900,5,3,24082,24082,24085,0,3,4
6901,1,2,24083,24085,24087,2,4,0
6902,6,3,24089,24089,24092,0,3,2
6903,5,3,24094,24094,24097,0,3,2
6904,5,3,24099,24099,24102,0,3,2
6905,1,1,24100,24102,24103,2,3,0
6906,1,3,24101,24103,24106,2,5,0
6907,1,3,24102,24106,24109,4,7,0
6908,5,1,24107,24109,24110,2,3,0
6909,2,2,24109,24110,24112,1,3,0
6910,3,2,24112,24112,24114,0,2,0
6911,1,3,24113,24114,24117,1,4,0
6912,2,2,24115,24117,24119,2,4,0
6913,3,1,24118,24119,24120,1,2,0
6914,5,2,24123,24123,24125,0,2,3
6915,3,1,24126,24126,24127,0,1,1
6916,6,2,24132,24132,24134,0,2,5
6917,5,3,24137,24137,24140,0,3,3
6918,3,3,24140,24140,24143,0,3,0
6919,5,2,24145,24145,24147,0,2,2
6920,1,2,24146,24147,24149,1,3,0
6921,5,1,24151,24151,24152,0,1,2
6922,2,1,24153,24153,24154,0,1,1
6923,3,3,24156,24156,24159,0,3,2
6924,3,3,24159,24159,24162,0,3,0
6925,3,2,24162,24162,24164,0,2,0
6926,3,1,24165,24165,24166,0,1,1
6927,2,2,24167,24167,24169,0,2,1
6928,1,3,24168,24169,24172,1,4,0
6929,6,1,24174,24174,24175,0,1,2
6930,6,2,24180,24180,24182,0,2,5
6931,6,1,24186,24186,24187,0,1,4
6932,6,1,24192,24192,24193,0,1,5
6933,3,2,24195,24195,24197,0,2,2
6934,1,1,24196,24197,24198,1,2,0
6935,3,3,24199,24199,24202,0,3,1
6936,1,2,24200,24202,24204,2,4,0
6937,3,3,24203,24204,24207,1,4,0
6938,5,2,24208,24208,24210,0,2,1
6939,1,2,24209,24210,24212,1,3,0
6940,1,3,24210,24212,24215,2,5,0
6941,5,1,24215,24215,24216,0,1,0
6942,6,2,24221,24221,24223,0,2,5
6943,3,2,24224,24224,24226,0,2,1
6944,2,3,24226,24226,24229,0,3,0
6945,4,2,24230,24230,24232,0,2,1
6946,4,3,24234,24234,24237,0,3,2
6947,1,2,24235,24237,24239,2,4,0
6948,2,2,24237,24239,24241,2,4,0
6949,4,3,24241,24241,24244,0,3,0
6950,1,1,24242,24244,24245,2,3,0
6951,2,1,24244,24245,24246,1,2,0
6952,3,2,24247,24247,24249,0,2,1
6953,1,1,24248,24249,24250,1,2,0
6954,4,3,24252,24252,24255,0,3,2
6955,5,1,24257,24257,24258,0,1,2
6956,3,1,24260,24260,24261,0,1,2
6957,6,3,24266,24266,24269,0,3,5
6958,6,3,24272,24272,24275,0,3,3
6959,5,2,24277,24277,24279,0,2,2
6960,4,2,24281,24281,24283,0,2,2
6961,6,1,24287,24287,24288,0,1,4
6962,3,3,24290,24290,24293,0,3,2
6963,3,1,24293,24293,24294,0,1,0
6964,4,3,24297,24297,24300,0,3,3
6965,1,2,24298,24300,24302,2,4,0
6966,1,2,24299,24302,24304,3,5,0
6967,2,1,24301,24304,24305,3,4,0
6968,6,2,24307,24307,24309,0,2,2
6969,6,1,24313,24313,24314,0,1,4
6970,6,1,24319,24319,24320,0,1,5
6971,6,2,24325,24325,24327,0,2,5
6972,1,1,24326,24327,24328,1,2,0
6973,4,2,24330,24330,24332,0,2,2
6974,3,2,24333,24333,24335,0,2,1
6975,3,2,24336,24336,24338,0,2,1
6976,4,2,24340,24340,24342,0,2,2
6977,2,3,24342,24342,24345,0,3,0
6978,2,2,24344,24345,24347,1,3,0
6979,3,1,24347,24347,24348,0,1,0
6980,1,2,24348,24348,24350,0,2,0
6981,2,1,24350,24350,24351,0,1,0
6982,4,1,24354,24354,24355,0,1,3
6983,2,3,24356,24356,24359,0,3,1
6984,6,2,24362,24362,24364,0,2,3
6985,3,2,24365,24365,24367,0,2,1
6986,2,1,24367,24367,24368,0,1,0
6987,6,3,24373,24373,24376,0,3,5
6988,2,1,24375,24376,24377,1,2,0
6989,1,2,24376,24377,24379,1,3,0
6990,2,2,24378,24379,24381,1,3,0
6991,4,3,24382,24382,24385,0,3,1
6992,4,2,24386,24386,24388,0,2,1
6993,2,1,24388,24388,24389,0,1,0
6994,1,2,24389,24389,24391,0,2,0
6995,6,3,24395,24395,24398,0,3,4
6996,2,2,24397,24398,24400,1,3,0
6997,6,2,24403,24403,24405,0,2,3
6998,1,1,24404,24405,24406,1,2,0
6999,3,2,24407,24407,24409,0,2,1
7000,4,3,24411,24411,24414,0,3,2
7001,1,1,24412,24414,24415,2,3,0
7002,2,2,24414,24415,24417,1,3,0
7003,6,3,24420,24420,24423,0,3,3
7004,2,2,24422,24423,24425,1,3,0
7005,3,1,24425,24425,24426,0,1,0
7006,3,1,24428,24428,24429,0,1,2
7007,6,2,24434,24434,24436,0,2,5
7008,6,3,24440,24440,24443,0,3,4
7009,4,2,24444,24444,24446,0,2,1
7010,1,1,24445,24446,24447,1,2,0
7011,4,3,24449,24449,24452,0,3,2
7012,3,3,24452,24452,24455,0,3,0
7013,3,3,24455,24455,24458,0,3,0
7014,4,2,24459,24459,24461,0,2,1
7015,3,3,24462,24462,24465,0,3,1
7016,5,1,24467,24467,24468,0,1,2
7017,3,1,24470,24470,24471,0,1,2
7018,3,3,24473,24473,24476,0,3,2
7019,5,2,24478,24478,24480,0,2,2
7020,6,2,24484,24484,24486,0,2,4
7021,4,3,24488,24488,24491,0,3,2
7022,6,3,24494,24494,24497,0,3,3
7023,1,1,24495,24497,24498,2,3,0
7024,1,1,24496,24498,24499,2,3,0
7025,5,2,24501,24501,24503,0,2,2
7026,1,1,24502,24503,24504,1,2,0
7027,6,2,24508,24508,24510,0,2,4
7028,6,3,24514,24514,24517,0,3,4
7029,3,3,24517,24517,24520,0,3,0
7030,4,1,24521,24521,24522,0,1,1
7031,4,3,24525,24525,24528,0,3,3
7032,5,1,24530,24530,24531,0,1,2
7033,2,3,24532,24532,24535,0,3,1
7034,6,2,24538,24538,24540,0,2,3
7035,6,2,24544,24544,24546,0,2,4
7036,4,1,24548,24548,24549,0,1,2
7037,2,2,24550,24550,24552,0,2,1
7038,2,2,24552,24552,24554,0,2,0
7039,2,2,24554,24554,24556,0,2,0
7040,2,1,24556,24556,24557,0,1,0
7041,5,2,24561,24561,24563,0,2,4
7042,6,2,24567,24567,24569,0,2,4
7043,3,1,24570,24570,24571,0,1,1
7044,6,2,24576,24576,24578,0,2,5
7045,5,3,24581,24581,24584,0,3,3
7046,4,1,24585,24585,24586,0,1,1
7047,4,2,24589,24589,24591,0,2,3
7048,1,2,24590,24591,24593,1,3,0
7049,1,1,24591,24593,24594,2,3,0
7050,5,1,24596,24596,24597,0,1,2
7051,2,3,24598,24598,24601,0,3,1
7052,3,2,24601,24601,24603,0,2,0
7053,2,2,24603,24603,24605,0,2,0
7054,1,3,24604,24605,24608,1,4,0
7055,3,1,24607,24608,24609,1,2,0
7056,3,3,24610,24610,24613,0,3,1
7057,4,2,24614,24614,24616,0,2,1
7058,3,3,24617,24617,24620,0,3,1
7059,1,2,24618,24620,24622,2,4,0
7060,3,1,24621,24622,24623,1,2,0
7061,6,3,24627,24627,24630,0,3,4
7062,6,1,24633,24633,24634,0,1,3
7063,1,3,24634,24634,24637,0,3,0
7064,4,1,24638,24638,24639,0,1,1
7065,6,2,24644,24644,24646,0,2,5
7066,4,1,24648,24648,24649,0,1,2
7067,5,3,24653,24653,24656,0,3,4
7068,1,1,24654,24656,24657,2,3,0
7069,3,2,24657,24657,24659,0,2,0
7070,2,3,24659,24659,24662,0,3,0
7071,6,2,24665,24665,24667,0,2,3
7072,4,3,24669,24669,24672,0,3,2
7073,5,2,24674,24674,24676,0,2,2
7074,5,1,24679,24679,24680,0,1,3
7075,2,2,24681,24681,24683,0,2,1
7076,5,2,24686,24686,24688,0,2,3
7077,3,2,24689,24689,24691,0,2,1
7078,6,1,24695,24695,24696,0,1,4
7079,3,2,24698,24698,24700,0,2,2
7080,6,1,24704,24704,24705,0,1,4
7081,5,2,24709,24709,24711,0,2,4
7082,6,2,24715,24715,24717,0,2,4
7083,1,3,24716,24717,24720,1,4,0
7084,6,3,24722,24722,24725,0,3,2
7085,3,1,24725,24725,24726,0,1,0
7086,6,3,24731,24731,24734,0,3,5
7087,2,3,24733,24734,24737,1,4,0
7088,5,1,24738,24738,24739,0,1,1
7089,1,2,24739,24739,24741,0,2,0
7090,4,2,24743,24743,24745,0,2,2
7091,3,1,24746,24746,24747,0,1,1
7092,3,1,24749,24749,24750,0,1,2
7093,6,3,24755,24755,24758,0,3,5
7094,4,3,24759,24759,24762,0,3,1
7095,3,2,24762,24762,24764,0,2,0
7096,5,2,24767,24767,24769,0,2,3
7097,3,1,24770,24770,24771,0,1,1
7098,6,2,24776,24776,24778,0,2,5
7099,5,3,24781,24781,24784,0,3,3
7100,6,3,24787,24787,24790,0,3,3
7101,3,1,24790,24790,24791,0,1,0
7102,5,2,24795,24795,24797,0,2,4
7103,4,2,24799,24799,24801,0,2,2
7104,6,1,24805,24805,24806,0,1,4
7105,3,3,24808,24808,24811,0,3,2
7106,4,1,24812,24812,24813,0,1,1
7107,3,2,24815,24815,24817,0,2,2
7108,3,2,24818,24818,24820,0,2,1
7109,6,1,24824,24824,24825,0,1,4
7110,4,1,24828,24828,24829,0,1,3
7111,3,2,24831,24831,24833,0,2,2
7112,6,2,24837,24837,24839,0,2,4
7113,2,3,24839,24839,24842,0,3,0
7114,3,2,24842,24842,24844,0,2,0
7115,5,1,24847,24847,24848,0,1,3
7116,1,1,24848,24848,24849,0,1,0
7117,4,2,24852,24852,24854,0,2,3
7118,3,2,24855,24855,24857,0,2,1
7119,3,2,24858,24858,24860,0,2,1
7120,2,2,24860,24860,24862,0,2,0
7121,6,3,24866,24866,24869,0,3,4
7122,1,1,24867,24869,24870,2,3,0
7123,3,1,24870,24870,24871,0,1,0
7124,6,3,24876,24876,24879,0,3,5
7125,5,2,24881,24881,24883,0,2,2
7126,2,2,24883,24883,24885,0,2,0
7127,3,3,24886,24886,24889,0,3,1
7128,2,3,24888,24889,24892,1,4,0
7129,5,2,24893,24893,24895,0,2,1
7130,2,1,24895,24895,24896,0,1,0
7131,3,3,24898,24898,24901,0,3,2
7132,5,2,24903,24903,24905,0,2,2
7133,4,3,24907,24907,24910,0,3,2
7134,4,3,24911,24911,24914,0,3,1
7135,2,1,24913,24914,24915,1,2,0
7136,4,3,24917,24917,24920,0,3,2
7137,3,1,24920,24920,24921,0,1,0
7138,1,3,24921,24921,24924,0,3,0
7139,6,3,24927,24927,24930,0,3,3
7140,5,2,24932,24932,24934,0,2,2
7141,2,2,24934,24934,24936,0,2,0
7142,1,3,24935,24936,24939,1,4,0
7143,5,3,24940,24940,24943,0,3,1
7144,6,3,24946,24946,24949,0,3,3
7145,2,3,24948,24949,24952,1,4,0
7146,6,2,24954,24954,24956,0,2,2
7147,6,1,24960,24960,24961,0,1,4
7148,2,1,24962,24962,24963,0,1,1
7149,3,2,24965,24965,24967,0,2,2
7150,1,2,24966,24967,24969,1,3,0
7151,3,2,24969,24969,24971,0,2,0
7152,3,3,24972,24972,24975,0,3,1
7153,5,3,24977,24977,24980,0,3,2
7154,2,2,24979,24980,24982,1,3,0
7155,6,1,24985,24985,24986,0,1,3
7156,1,3,24986,24986,24989,0,3,0
7157,3,2,24989,24989,24991,0,2,0
7158,2,3,24991,24991,24994,0,3,0
7159,1,1,24992,24994,24995,2,3,0
7160,1,3,24993,24995,24998,2,5,0
7161,5,3,24998,24998,25001,0,3,0
7162,4,1,25002,25002,25003,0,1,1
7163,6,1,25008,25008,25009,0,1,5
7164,3,1,25011,25011,25012,0,1,2
7165,6,3,25017,25017,25020,0,3,5
7166,3,3,25020,25020,25023,0,3,0
7167,5,1,25025,25025,25026,0,1,2
7168,1,3,25026,25026,25029,0,3,0
7169,2,1,25028,25029,25030,1,2,0
7170,5,3,25033,25033,25036,0,3,3
7171,3,1,25036,25036,25037,0,1,0
7172,6,2,25042,25042,25044,0,2,5
7173,2,3,25044,25044,25047,0,3,0
7174,2,3,25046,25047,25050,1,4,0
7175,3,2,25049,25050,25052,1,3,0
7176,6,1,25055,25055,25056,0,1,3
7177,1,2,25056,25056,25058,0,2,0
7178,6,2,25062,25062,25064,0,2,4
7179,1,1,25063,25064,25065,1,2,0
7180,2,3,25065,25065,25068,0,3,0
7181,5,2,25070,25070,25072,0,2,2
7182,1,2,25071,25072,25074,1,3,0
7183,1,1,25072,25074,25075,2,3,0
7184,6,1,25078,25078,25079,0,1,3
7185,2,3,25080,25080,25083,0,3,1
7186,3,3,25083,25083,25086,0,3,0
7187,4,1,25087,25087,25088,0,1,1
7188,4,2,25091,25091,25093,0,2,3
7189,4,2,25095,25095,25097,0,2,2
7190,2,1,25097,25097,25098,0,1,0
7191,4,2,25101,25101,25103,0,2,3
7192,2,1,25103,25103,25104,0,1,0
7193,5,2,25108,25108,25110,0,2,4
7194,2,2,25110,25110,25112,0,2,0
7195,2,1,25112,25112,25113,0,1,0
7196,3,3,25115,25115,25118,0,3,2
7197,3,1,25118,25118,25119,0,1,0
7198,2,3,25120,25120,25123,0,3,1
7199,6,3,25126,25126,25129,0,3,3
7200,2,3,25128,25129,25132,1,4,0
7201,3,1,25131,25132,25133,1,2,0
7202,5,1,25136,25136,25137,0,1,3
7203,2,3,25138,25138,25141,0,3,1
7204,6,2,25144,25144,25146,0,2,3
7205,5,3,25149,25149,25152,0,3,3
7206,3,1,25152,25152,25153,0,1,0
7207,6,3,25158,25158,25161,0,3,5
7208,6,1,25164,25164,25165,0,1,3
7209,4,3,25168,25168,25171,0,3,3
7210,1,3,25169,25171,25174,2,5,0
7211,3,1,25172,25174,25175,2,3,0
7212,4,3,25176,25176,25179,0,3,1
7213,5,2,25181,25181,25183,0,2,2
7214,6,3,25187,25187,25190,0,3,4
7215,1,2,25188,25190,25192,2,4,0
7216,2,3,25190,25192,25195,2,5,0
7217,4,1,25194,25195,25196,1,2,0
7218,3,3,25197,25197,25200,0,3,1
7219,1,1,25198,25200,25201,2,3,0
7220,2,1,25200,25201,25202,1,2,0
7221,3,1,25203,25203,25204,0,1,1
7222,5,2,25208,25208,25210,0,2,4
7223,2,2,25210,25210,25212,0,2,0
7224,2,3,25212,25212,25215,0,3,0
7225,5,3,25217,25217,25220,0,3,2
7226,2,2,25219,25220,25222,1,3,0
7227,5,3,25224,25224,25227,0,3,2
7228,4,1,25228,25228,25229,0,1,1
7229,3,1,25231,25231,25232,0,1,2
7230,3,1,25234,25234,25235,0,1,2
7231,3,3,25237,25237,25240,0,3,2
7232,3,1,25240,25240,25241,0,1,0
7233,2,1,25242,25242,25243,0,1,1
7234,2,3,25244,25244,25247,0,3,1
7235,5,3,25249,25249,25252,0,3,2
7236,5,2,25254,25254,25256,0,2,2
7237,5,2,25259,25259,25261,0,2,3
7238,3,1,25262,25262,25263,0,1,1
7239,3,1,25265,25265,25266,0,1,2
7240,3,3,25268,25268,25271,0,3,2
7241,5,2,25273,25273,25275,0,2,2
7242,4,1,25277,25277,25278,0,1,2
7243,3,3,25280,25280,25283,0,3,2
7244,3,3,25283,25283,25286,0,3,0
7245,4,1,25287,25287,25288,0,1,1
7246,1,2,25288,25288,25290,0,2,0
7247,1,2,25289,25290,25292,1,3,0
7248,4,3,25293,25293,25296,0,3,1
7249,5,1,25298,25298,25299,0,1,2
7250,3,1,25301,25301,25302,0,1,2
7251,6,1,25307,25307,25308,0,1,5
7252,3,3,25310,25310,25313,0,3,2
7253,6,2,25316,25316,25318,0,2,3
7254,2,2,25318,25318,25320,0,2,0
7255,6,3,25324,25324,25327,0,3,4
7256,3,3,25327,25327,25330,0,3,0
7257,6,2,25333,25333,25335,0,2,3
7258,1,3,25334,25335,25338,1,4,0
7259,5,3,25339,25339,25342,0,3,1
7260,3,1,25342,25342,25343,0,1,0
7261,1,1,25343,25343,25344,0,1,0
7262,3,2,25346,25346,25348,0,2,2
7263,5,2,25351,25351,25353,0,2,3
7264,4,3,25355,25355,25358,0,3,2
7265,5,2,25360,25360,25362,0,2,2
7266,1,1,25361,25362,25363,1,2,0
7267,4,3,25365,25365,25368,0,3,2
7268,4,2,25369,25369,25371,0,2,1
7269,5,2,25374,25374,25376,0,2,3
7270,5,1,25379,25379,25380,0,1,3
7271,3,1,25382,25382,25383,0,1,2
7272,2,2,25384,25384,25386,0,2,1
7273,1,3,25385,25386,25389,1,4,0
7274,6,2,25391,25391,25393,0,2,2
7275,6,3,25397,25397,25400,0,3,4
7276,5,3,25402,25402,25405,0,3,2
7277,5,2,25407,25407,25409,0,2,2
7278,5,3,25412,25412,25415,0,3,3
7279,5,3,25417,25417,25420,0,3,2
7280,3,1,25420,25420,25421,0,1,0
7281,1,2,25421,25421,25423,0,2,0
7282,4,3,25425,25425,25428,0,3,2
7283,2,1,25427,25428,25429,1,2,0
7284,1,3,25428,25429,25432,1,4,0
7285,1,1,25429,25432,25433,3,4,0
7286,2,1,25431,25433,25434,2,3,0
7287,2,3,25433,25434,25437,1,4,0
7288,1,2,25434,25437,25439,3,5,0
7289,4,3,25438,25439,25442,1,4,0
7290,5,3,25443,25443,25446,0,3,1
7291,6,2,25449,25449,25451,0,2,3
7292,1,2,25450,25451,25453,1,3,0
7293,6,1,25456,25456,25457,0,1,3
7294,2,2,25458,25458,25460,0,2,1
7295,6,3,25464,25464,25467,0,3,4
7296,4,2,25468,25468,25470,0,2,1
7297,6,1,25474,25474,25475,0,1,4
7298,5,1,25479,25479,25480,0,1,4
7299,5,3,25484,25484,25487,0,3,4
7300,6,1,25490,25490,25491,0,1,3
7301,4,1,25494,25494,25495,0,1,3
7302,3,2,25497,25497,25499,0,2,2
7303,6,2,25503,25503,25505,0,2,4
7304,1,3,25504,25505,25508,1,4,0
7305,5,1,25509,25509,25510,0,1,1
7306,6,2,25515,25515,25517,0,2,5
7307,4,1,25519,25519,25520,0,1,2
7308,3,3,25522,25522,25525,0,3,2
7309,3,1,25525,25525,25526,0,1,0
7310,6,2,25531,25531,25533,0,2,5
7311,2,2,25533,25533,25535,0,2,0
7312,5,1,25538,25538,25539,0,1,3
7313,5,3,25543,25543,25546,0,3,4
7314,5,3,25548,25548,25551,0,3,2
7315,5,3,25553,25553,25556,0,3,2
7316,3,2,25556,25556,25558,0,2,0
7317,2,2,25558,25558,25560,0,2,0
7318,2,1,25560,25560,25561,0,1,0
7319,2,2,25562,25562,25564,0,2,1
7320,1,2,25563,25564,25566,1,3,0
7321,3,3,25566,25566,25569,0,3,0
7322,4,2,25570,25570,25572,0,2,1
7323,1,2,25571,25572,25574,1,3,0
7324,3,1,25574,25574,25575,0,1,0
7325,3,3,25577,25577,25580,0,3,2
7326,1,2,25578,25580,25582,2,4,0
7327,3,2,25581,25582,25584,1,3,0
7328,1,1,25582,25584,25585,2,3,0
7329,6,3,25588,25588,25591,0,3,3
7330,2,3,25590,25591,25594,1,4,0
7331,2,2,25592,25594,25596,2,4,0
7332,2,1,25594,25596,25597,2,3,0
7333,1,2,25595,25597,25599,2,4,0
7334,6,2,25601,25601,25603,0,2,2
7335,4,1,25605,25605,25606,0,1,2
7336,2,1,25607,25607,25608,0,1,1
7337,2,2,25609,25609,25611,0,2,1
7338,3,2,25612,25612,25614,0,2,1
7339,5,3,25617,25617,25620,0,3,3
7340,2,2,25619,25620,25622,1,3,0
7341,5,1,25624,25624,25625,0,1,2
7342,2,3,25626,25626,25629,0,3,1
7343,3,1,25629,25629,25630,0,1,0
7344,4,2,25633,25633,25635,0,2,3
7345,4,3,25637,25637,25640,0,3,2
7346,3,3,25640,25640,25643,0,3,0
7347,1,3,25641,25643,25646,2,5,0
7348,6,2,25647,25647,25649,0,2,1
7349,6,2,25653,25653,25655,0,2,4
7350,2,3,25655,25655,25658,0,3,0
7351,4,1,25659,25659,25660,0,1,1
7352,5,2,25664,25664,25666,0,2,4
7353,6,2,25670,25670,25672,0,2,4
7354,2,2,25672,25672,25674,0,2,0
7355,1,2,25673,25674,25676,1,3,0
7356,3,3,25676,25676,25679,0,3,0
7357,4,1,25680,25680,25681,0,1,1
7358,3,1,25683,25683,25684,0,1,2
7359,5,3,25688,25688,25691,0,3,4
7360,6,2,25694,25694,25696,0,2,3
7361,5,3,25699,25699,25702,0,3,3
7362,3,2,25702,25702,25704,0,2,0
7363,3,3,25705,25705,25708,0,3,1
7364,3,1,25708,25708,25709,0,1,0
7365,1,3,25709,25709,25712,0,3,0
7366,5,2,25714,25714,25716,0,2,2
7367,4,2,25718,25718,25720,0,2,2
7368,4,3,25722,25722,25725,0,3,2
7369,4,1,25726,25726,25727,0,1,1
7370,5,1,25731,25731,25732,0,1,4
7371,1,2,25732,25732,25734,0,2,0
7372,3,3,25735,25735,25738,0,3,1
7373,3,1,25738,25738,25739,0,1,0
7374,5,2,25743,25743,25745,0,2,4
7375,6,3,25749,25749,25752,0,3,4
7376,5,1,25754,25754,25755,0,1,2
7377,1,3,25755,25755,25758,0,3,0
7378,3,2,25758,25758,25760,0,2,0
7379,5,1,25763,25763,25764,0,1,3
7380,3,2,25766,25766,25768,0,2,2
7381,5,3,25771,25771,25774,0,3,3
7382,2,1,25773,25774,25775,1,2,0
7383,5,1,25778,25778,25779,0,1,3
7384,4,2,25782,25782,25784,0,2,3
7385,5,2,25787,25787,25789,0,2,3
7386,4,2,25791,25791,25793,0,2,2
7387,2,3,25793,25793,25796,0,3,0
7388,1,2,25794,25796,25798,2,4,0
7389,1,3,25795,25798,25801,3,6,0
7390,6,2,25801,25801,25803,0,2,0
7391,3,2,25804,25804,25806,0,2,1
7392,3,2,25807,25807,25809,0,2,1
7393,4,3,25811,25811,25814,0,3,2
7394,6,1,25817,25817,25818,0,1,3
7395,2,3,25819,25819,25822,0,3,1
7396,1,1,25820,25822,25823,2,3,0
7397,4,2,25824,25824,25826,0,2,1
7398,6,2,25830,25830,25832,0,2,4
7399,3,2,25833,25833,25835,0,2,1
7400,1,1,25834,25835,25836,1,2,0
7401,3,2,25837,25837,25839,0,2,1
7402,4,2,25841,25841,25843,0,2,2
7403,2,2,25843,25843,25845,0,2,0
7404,6,3,25849,25849,25852,0,3,4
7405,4,2,25853,25853,25855,0,2,1
7406,1,2,25854,25855,25857,1,3,0
7407,2,3,25856,25857,25860,1,4,0
7408,1,1,25857,25860,25861,3,4,0
7409,6,2,25863,25863,25865,0,2,2
7410,2,1,25865,25865,25866,0,1,0
7411,3,2,25868,25868,25870,0,2,2
7412,3,2,25871,25871,25873,0,2,1
7413,2,2,25873,25873,25875,0,2,0
7414,3,1,25876,25876,25877,0,1,1
7415,2,2,25878,25878,25880,0,2,1
7416,6,3,25884,25884,25887,0,3,4
7417,3,3,25887,25887,25890,0,3,0
7418,2,3,25889,25890,25893,1,4,0
7419,4,2,25893,25893,25895,0,2,0
7420,5,2,25898,25898,25900,0,2,3
7421,1,3,25899,25900,25903,1,4,0
7422,2,2,25901,25903,25905,2,4,0
7423,5,2,25906,25906,25908,0,2,1
7424,2,2,25908,25908,25910,0,2,0
7425,1,1,25909,25910,25911,1,2,0
7426,2,3,25911,25911,25914,0,3,0
7427,3,1,25914,25914,25915,0,1,0
7428,1,2,25915,25915,25917,0,2,0
7429,5,3,25920,25920,25923,0,3,3
7430,1,1,25921,25923,25924,2,3,0
7431,3,2,25924,25924,25926,0,2,0
7432,3,1,25927,25927,25928,0,1,1
7433,6,1,25933,25933,25934,0,1,5
7434,3,2,25936,25936,25938,0,2,2
7435,2,3,25938,25938,25941,0,3,0
7436,3,1,25941,25941,25942,0,1,0
7437,4,2,25945,25945,25947,0,2,3
7438,2,3,25947,25947,25950,0,3,0
7439,4,1,25951,25951,25952,0,1,1
7440,3,3,25954,25954,25957,0,3,2
7441,2,1,25956,25957,25958,1,2,0
7442,5,2,25961,25961,25963,0,2,3
7443,6,1,25967,25967,25968,0,1,4
7444,6,3,25973,25973,25976,0,3,5
7445,6,1,25979,25979,25980,0,1,3
7446,1,1,25980,25980,25981,0,1,0
7447,4,3,25984,25984,25987,0,3,3
7448,6,3,25990,25990,25993,0,3,3
7449,3,1,25993,25993,25994,0,1,0
7450,3,3,25996,25996,25999,0,3,2
7451,2,1,25998,25999,26000,1,2,0
7452,5,2,26003,26003,26005,0,2,3
7453,4,3,26007,26007,26010,0,3,2
7454,2,1,26009,26010,26011,1,2,0
7455,4,1,26013,26013,26014,0,1,2
7456,2,3,26015,26015,26018,0,3,1
7457,4,1,26019,26019,26020,0,1,1
7458,5,2,26024,26024,26026,0,2,4
7459,2,2,26026,26026,26028,0,2,0
7460,1,3,26027,26028,26031,1,4,0
7461,4,3,26031,26031,26034,0,3,0
7462,4,1,26035,26035,26036,0,1,1
7463,6,1,26041,26041,26042,0,1,5
7464,1,1,26042,26042,26043,0,1,0
7465,2,3,26044,26044,26047,0,3,1
7466,4,2,26048,26048,26050,0,2,1
7467,4,1,26052,26052,26053,0,1,2
7468,2,2,26054,26054,26056,0,2,1
7469,1,1,26055,26056,26057,1,2,0
7470,1,2,26056,26057,26059,1,3,0
7471,4,2,26060,26060,26062,0,2,1
7472,1,2,26061,26062,26064,1,3,0
7473,4,3,26065,26065,26068,0,3,1
7474,4,1,26069,26069,26070,0,1,1
7475,5,3,26074,26074,26077,0,3,4
7476,1,2,26075,26077,26079,2,4,0
7477,4,2,26079,26079,26081,0,2,0
7478,1,3,26080,26081,26084,1,4,0
7479,2,1,26082,26084,26085,2,3,0
7480,1,2,26083,26085,26087,2,4,0
7481,5,3,26088,26088,26091,0,3,1
7482,4,3,26092,26092,26095,0,3,1
7483,4,2,26096,26096,26098,0,2,1
7484,3,3,26099,26099,26102,0,3,1
7485,2,2,26101,26102,26104,1,3,0
7486,3,2,26104,26104,26106,0,2,0
7487,5,1,26109,26109,26110,0,1,3
7488,1,1,26110,26110,26111,0,1,0
7489,6,2,26116,26116,26118,0,2,5
7490,4,1,26120,26120,26121,0,1,2
7491,5,1,26125,26125,26126,0,1,4
7492,2,3,26127,26127,26130,0,3,1
7493,3,1,26130,26130,26131,0,1,0
7494,4,2,26134,26134,26136,0,2,3
7495,4,3,26138,26138,26141,0,3,2
7496,5,2,26143,26143,26145,0,2,2
7497,6,3,26149,26149,26152,0,3,4
7498,1,3,26150,26152,26155,2,5,0
7499,2,1,26152,26155,26156,3,4,0
7500,5,2,26157,26157,26159,0,2,1
7501,1,3,26158,26159,26162,1,4,0
7502,1,1,26159,26162,26163,3,4,0
7503,5,2,26164,26164,26166,0,2,1
7504,2,1,26166,26166,26167,0,1,0
7505,4,1,26170,26170,26171,0,1,3
7506,6,2,26176,26176,26178,0,2,5
7507,4,2,26180,26180,26182,0,2,2
7508,5,2,26185,26185,26187,0,2,3
7509,5,2,26190,26190,26192,0,2,3
7510,3,1,26193,26193,26194,0,1,1
7511,6,3,26199,26199,26202,0,3,5
7512,4,2,26203,26203,26205,0,2,1
7513,4,2,26207,26207,26209,0,2,2
7514,2,1,26209,26209,26210,0,1,0
7515,2,1,26211,26211,26212,0,1,1
7516,4,3,26215,26215,26218,0,3,3
7517,4,2,26219,26219,26221,0,2,1
7518,2,1,26221,26221,26222,0,1,0
7519,4,1,26225,26225,26226,0,1,3
7520,3,2,26228,26228,26230,0,2,2
7521,6,2,26234,26234,26236,0,2,4
7522,2,2,26236,26236,26238,0,2,0
7523,3,2,26239,26239,26241,0,2,1
7524,3,1,26242,26242,26243,0,1,1
7525,6,3,26248,26248,26251,0,3,5
7526,5,1,26253,26253,26254,0,1,2
7527,2,3,26255,26255,26258,0,3,1
7528,4,2,26259,26259,26261,0,2,1
7529,2,3,26261,26261,26264,0,3,0
7530,3,2,26264,26264,26266,0,2,0
7531,2,2,26266,26266,26268,0,2,0
7532,3,1,26269,26269,26270,0,1,1
7533,2,3,26271,26271,26274,0,3,1
7534,2,2,26273,26274,26276,1,3,0
7535,4,2,26277,26277,26279,0,2,1
7536,4,1,26281,26281,26282,0,1,2
7537,6,2,26287,26287,26289,0,2,5
7538,6,3,26293,26293,26296,0,3,4
7539,5,1,26298,26298,26299,0,1,2
7540,4,1,26302,26302,26303,0,1,3
7541,4,3,26306,26306,26309,0,3,3
7542,5,1,26311,26311,26312,0,1,2
7543,5,2,26316,26316,26318,0,2,4
7544,5,1,26321,26321,26322,0,1,3
7545,6,2,26327,26327,26329,0,2,5
7546,3,3,26330,26330,26333,0,3,1
7547,4,3,26334,26334,26337,0,3,1
7548,5,3,26339,26339,26342,0,3,2
7549,4,1,26343,26343,26344,0,1,1
7550,4,1,26347,26347,26348,0,1,3
7551,3,3,26350,26350,26353,0,3,2
7552,1,2,26351,26353,26355,2,4,0
7553,6,2,26357,26357,26359,0,2,2
7554,6,3,26363,26363,26366,0,3,4
7555,3,1,26366,26366,26367,0,1,0
7556,1,2,26367,26367,26369,0,2,0
7557,1,2,26368,26369,26371,1,3,0
7558,5,2,26373,26373,26375,0,2,2
7559,5,3,26378,26378,26381,0,3,3
7560,3,2,26381,26381,26383,0,2,0
7561,4,1,26385,26385,26386,0,1,2
7562,1,1,26386,26386,26387,0,1,0
7563,1,2,26387,26387,26389,0,2,0
7564,1,2,26388,26389,26391,1,3,0
7565,5,3,26393,26393,26396,0,3,2
7566,6,3,26399,26399,26402,0,3,3
7567,6,1,26405,26405,26406,0,1,3
7568,4,3,26409,26409,26412,0,3,3
7569,2,3,26411,26412,26415,1,4,0
7570,6,3,26417,26417,26420,0,3,2
7571,5,2,26422,26422,26424,0,2,2
7572,6,2,26428,26428,26430,0,2,4
7573,2,3,26430,26430,26433,0,3,0
7574,4,1,26434,26434,26435,0,1,1
7575,1,3,26435,26435,26438,0,3,0
7576,2,2,26437,26438,26440,1,3,0
7577,1,2,26438,26440,26442,2,4,0
7578,1,2,26439,26442,26444,3,5,0
7579,4,1,26443,26444,26445,1,2,0
7580,4,3,26447,26447,26450,0,3,2
7581,6,3,26453,26453,26456,0,3,3
7582,6,3,26459,26459,26462,0,3,3
7583,2,3,26461,26462,26465,1,4,0
7584,1,2,26462,26465,26467,3,5,0
7585,3,2,26465,26467,26469,2,4,0
7586,4,1,26469,26469,26470,0,1,0
7587,6,3,26475,26475,26478,0,3,5
7588,2,1,26477,26478,26479,1,2,0
7589,6,3,26483,26483,26486,0,3,4
7590,6,1,26489,26489,26490,0,1,3
7591,5,2,26494,26494,26496,0,2,4
7592,5,2,26499,26499,26501,0,2,3
7593,2,2,26501,26501,26503,0,2,0
7594,1,1,26502,26503,26504,1,2,0
7595,4,1,26506,26506,26507,0,1,2
7596,4,3,26510,26510,26513,0,3,3
7597,1,1,26511,26513,26514,2,3,0
7598,1,1,26512,26514,26515,2,3,0
7599,5,3,26517,26517,26520,0,3,2
7600,2,2,26519,26520,26522,1,3,0
7601,6,1,26525,26525,26526,0,1,3
7602,4,2,26529,26529,26531,0,2,3
7603,4,3,26533,26533,26536,0,3,2
7604,3,2,26536,26536,26538,0,2,0
7605,1,1,26537,26538,26539,1,2,0
7606,3,3,26540,26540,26543,0,3,1
7607,5,2,26545,26545,26547,0,2,2
7608,3,1,26548,26548,26549,0,1,1
7609,4,3,26552,26552,26555,0,3,3
7610,3,2,26555,26555,26557,0,2,0
7611,2,2,26557,26557,26559,0,2,0
7612,3,3,26560,26560,26563,0,3,1
7613,6,2,26566,26566,26568,0,2,3
7614,2,2,26568,26568,26570,0,2,0
7615,6,3,26574,26574,26577,0,3,4
7616,6,1,26580,26580,26581,0,1,3
7617,6,3,26586,26586,26589,0,3,5
7618,4,3,26590,26590,26593,0,3,1
7619,6,3,26596,26596,26599,0,3,3
7620,5,2,26601,26601,26603,0,2,2
7621,5,1,26606,26606,26607,0,1,3
7622,4,1,26610,26610,26611,0,1,3
7623,5,2,26615,26615,26617,0,2,4
7624,6,2,26621,26621,26623,0,2,4
7625,5,3,26626,26626,26629,0,3,3
7626,1,2,26627,26629,26631,2,4,0
7627,5,1,26632,26632,26633,0,1,1
7628,3,1,26635,26635,26636,0,1,2
7629,5,2,26640,26640,26642,0,2,4
7630,5,2,26645,26645,26647,0,2,3
7631,2,2,26647,26647,26649,0,2,0
7632,6,3,26653,26653,26656,0,3,4
7633,1,1,26654,26656,26657,2,3,0
7634,4,1,26658,26658,26659,0,1,1
7635,1,3,26659,26659,26662,0,3,0
7636,3,2,26662,26662,26664,0,2,0
7637,2,3,26664,26664,26667,0,3,0
7638,2,2,26666,26667,26669,1,3,0
7639,6,1,26672,26672,26673,0,1,3
7640,4,3,26676,26676,26679,0,3,3
7641,6,3,26682,26682,26685,0,3,3
7642,6,2,26688,26688,26690,0,2,3
7643,1,3,26689,26690,26693,1,4,0
7644,1,3,26690,26693,26696,3,6,0
7645,3,3,26693,26696,26699,3,6,0
7646,5,3,26698,26699,26702,1,4,0
7647,1,2,26699,26702,26704,3,5,0
7648,3,1,26702,26704,26705,2,3,0
7649,5,3,26707,26707,26710,0,3,2
7650,5,3,26712,26712,26715,0,3,2
7651,6,3,26718,26718,26721,0,3,3
7652,5,1,26723,26723,26724,0,1,2
7653,1,2,26724,26724,26726,0,2,0
7654,5,2,26729,26729,26731,0,2,3
7655,2,2,26731,26731,26733,0,2,0
7656,4,3,26735,26735,26738,0,3,2
7657,4,2,26739,26739,26741,0,2,1
7658,1,3,26740,26741,26744,1,4,0
7659,4,2,26744,26744,26746,0,2,0
7660,2,3,26746,26746,26749,0,3,0
7661,5,1,26751,26751,26752,0,1,2
7662,1,3,26752,26752,26755,0,3,0
7663,2,1,26754,26755,26756,1,2,0
7664,6,3,26760,26760,26763,0,3,4
7665,5,2,26765,26765,26767,0,2,2
7666,2,2,26767,26767,26769,0,2,0
7667,3,1,26770,26770,26771,0,1,1
7668,6,1,26776,26776,26777,0,1,5
7669,6,2,26782,26782,26784,0,2,5
7670,2,1,26784,26784,26785,0,1,0
7671,1,3,26785,26785,26788,0,3,0
7672,4,2,26789,26789,26791,0,2,1
7673,2,1,26791,26791,26792,0,1,0
7674,1,2,26792,26792,26794,0,2,0
7675,6,2,26798,26798,26800,0,2,4
7676,3,2,26801,26801,26803,0,2,1
7677,4,1,26805,26805,26806,0,1,2
7678,4,2,26809,26809,26811,0,2,3
7679,1,1,26810,26811,26812,1,2,0
7680,1,2,26811,26812,26814,1,3,0
7681,3,1,26814,26814,26815,0,1,0
7682,1,2,26815,26815,26817,0,2,0
7683,5,2,26820,26820,26822,0,2,3
7684,6,2,26826,26826,26828,0,2,4
7685,5,3,26831,26831,26834,0,3,3
7686,3,1,26834,26834,26835,0,1,0
7687,4,1,26838,26838,26839,0,1,3
7688,5,2,26843,26843,26845,0,2,4
7689,1,2,26844,26845,26847,1,3,0
7690,2,3,26846,26847,26850,1,4,0
7691,2,2,26848,26850,26852,2,4,0
7692,1,2,26849,26852,26854,3,5,0
7693,1,2,26850,26854,26856,4,6,0
7694,3,2,26853,26856,26858,3,5,0
7695,5,3,26858,26858,26861,0,3,0
7696,2,3,26860,26861,26864,1,4,0
7697,5,1,26865,26865,26866,0,1,1
7698,2,2,26867,26867,26869,0,2,1
7699,4,2,26871,26871,26873,0,2,2
7700,6,1,26877,26877,26878,0,1,4
7701,3,1,26880,26880,26881,0,1,2
7702,3,1,26883,26883,26884,0,1,2
7703,4,3,26887,26887,26890,0,3,3
7704,1,2,26888,26890,26892,2,4,0
7705,4,2,26892,26892,26894,0,2,0
7706,2,3,26894,26894,26897,0,3,0
7707,1,2,26895,26897,26899,2,4,0
7708,2,1,26897,26899,26900,2,3,0
7709,4,2,26901,26901,26903,0,2,1
7710,1,3,26902,26903,26906,1,4,0
7711,3,3,26905,26906,26909,1,4,0
7712,5,3,26910,26910,26913,0,3,1
7713,3,2,26913,26913,26915,0,2,0
7714,1,1,26914,26915,26916,1,2,0
7715,2,2,26916,26916,26918,0,2,0
7716,1,3,26917,26918,26921,1,4,0
7717,2,1,26919,26921,26922,2,3,0
7718,2,1,26921,26922,26923,1,2,0
7719,1,2,26922,26923,26925,1,3,0
7720,5,1,26927,26927,26928,0,1,2
7721,3,3,26930,26930,26933,0,3,2
7722,3,3,26933,26933,26936,0,3,0
7723,6,2,26939,26939,26941,0,2,3
7724,5,2,26944,26944,26946,0,2,3
7725,6,1,26950,26950,26951,0,1,4
7726,4,2,26954,26954,26956,0,2,3
7727,3,3,26957,26957,26960,0,3,1
7728,5,2,26962,26962,26964,0,2,2
7729,2,1,26964,26964,26965,0,1,0
7730,3,2,26967,26967,26969,0,2,2
7731,3,3,26970,26970,26973,0,3,1
7732,3,1,26973,26973,26974,0,1,0
7733,5,1,26978,26978,26979,0,1,4
7734,2,2,26980,26980,26982,0,2,1
7735,3,3,26983,26983,26986,0,3,1
7736,2,1,26985,26986,26987,1,2,0
7737,6,1,26991,26991,26992,0,1,4
7738,5,1,26996,26996,26997,0,1,4
7739,2,2,26998,26998,27000,0,2,1
7740,5,3,27003,27003,27006,0,3,3
7741,2,2,27005,27006,27008,1,3,0
7742,5,3,27010,27010,27013,0,3,2
7743,5,2,27015,27015,27017,0,2,2
7744,3,2,27018,27018,27020,0,2,1
7745,3,2,27021,27021,27023,0,2,1
7746,4,1,27025,27025,27026,0,1,2
7747,3,1,27028,27028,27029,0,1,2
7748,4,1,27032,27032,27033,0,1,3
7749,3,3,27035,27035,27038,0,3,2
7750,5,3,27040,27040,27043,0,3,2
7751,6,3,27046,27046,27049,0,3,3
7752,3,2,27049,27049,27051,0,2,0
7753,2,1,27051,27051,27052,0,1,0
7754,5,3,27056,27056,27059,0,3,4
7755,2,2,27058,27059,27061,1,3,0
7756,6,2,27064,27064,27066,0,2,3
7757,1,1,27065,27066,27067,1,2,0
7758,3,2,27068,27068,27070,0,2,1
7759,6,1,27074,27074,27075,0,1,4
7760,5,2,27079,27079,27081,0,2,4
7761,6,2,27085,27085,27087,0,2,4
7762,3,3,27088,27088,27091,0,3,1
7763,2,2,27090,27091,27093,1,3,0
7764,1,3,27091,27093,27096,2,5,0
7765,2,2,27093,27096,27098,3,5,0
7766,4,1,27097,27098,27099,1,2,0
7767,3,1,27100,27100,27101,0,1,1
7768,4,2,27104,27104,27106,0,2,3
7769,6,3,27110,27110,27113,0,3,4
7770,6,2,27116,27116,27118,0,2,3
7771,3,3,27119,27119,27122,0,3,1
7772,4,1,27123,27123,27124,0,1,1
7773,1,1,27124,27124,27125,0,1,0
7774,3,2,27127,27127,27129,0,2,2
7775,5,2,27132,27132,27134,0,2,3
7776,3,1,27135,27135,27136,0,1,1
7777,1,3,27136,27136,27139,0,3,0
7778,5,3,27141,27141,27144,0,3,2
7779,2,1,27143,27144,27145,1,2,0
7780,3,2,27146,27146,27148,0,2,1
7781,5,3,27151,27151,27154,0,3,3
7782,4,2,27155,27155,27157,0,2,1
7783,1,3,27156,27157,27160,1,4,0
7784,4,1,27160,27160,27161,0,1,0
7785,4,2,27164,27164,27166,0,2,3
7786,2,3,27166,27166,27169,0,3,0
7787,3,1,27169,27169,27170,0,1,0
7788,2,2,27171,27171,27173,0,2,1
7789,4,1,27175,27175,27176,0,1,2
7790,5,3,27180,27180,27183,0,3,4
7791,4,3,27184,27184,27187,0,3,1
7792,4,2,27188,27188,27190,0,2,1
7793,6,2,27194,27194,27196,0,2,4
7794,4,1,27198,27198,27199,0,1,2
7795,2,3,27200,27200,27203,0,3,1
7796,5,2,27205,27205,27207,0,2,2
7797,1,2,27206,27207,27209,1,3,0
7798,1,2,27207,27209,27211,2,4,0
7799,4,1,27211,27211,27212,0,1,0
7800,6,1,27217,27217,27218,0,1,5
7801,1,2,27218,27218,27220,0,2,0
7802,2,2,27220,27220,27222,0,2,0
7803,3,3,27223,27223,27226,0,3,1
7804,4,3,27227,27227,27230,0,3,1
7805,3,1,27230,27230,27231,0,1,0
7806,2,3,27232,27232,27235,0,3,1
7807,1,2,27233,27235,27237,2,4,0
7808,1,2,27234,27237,27239,3,5,0
7809,6,3,27240,27240,27243,0,3,1
7810,3,1,27243,27243,27244,0,1,0
7811,2,2,27245,27245,27247,0,2,1
7812,2,2,27247,27247,27249,0,2,0
7813,4,1,27251,27251,27252,0,1,2
7814,2,3,27253,27253,27256,0,3,1
7815,4,3,27257,27257,27260,0,3,1
7816,2,2,27259,27260,27262,1,3,0
7817,1,1,27260,27262,27263,2,3,0
7818,6,1,27266,27266,27267,0,1,3
7819,3,2,27269,27269,27271,0,2,2
7820,4,2,27273,27273,27275,0,2,2
7821,6,1,27279,27279,27280,0,1,4
7822,4,1,27283,27283,27284,0,1,3
7823,2,1,27285,27285,27286,0,1,1
7824,6,3,27291,27291,27294,0,3,5
7825,3,1,27294,27294,27295,0,1,0
7826,4,1,27298,27298,27299,0,1,3
7827,3,3,27301,27301,27304,0,3,2
7828,1,3,27302,27304,27307,2,5,0
7829,6,2,27308,27308,27310,0,2,1
7830,4,2,27312,27312,27314,0,2,2
7831,5,3,27317,27317,27320,0,3,3
7832,5,1,27322,27322,27323,0,1,2
7833,4,2,27326,27326,27328,0,2,3
7834,1,2,27327,27328,27330,1,3,0
7835,5,3,27332,27332,27335,0,3,2
7836,6,3,27338,27338,27341,0,3,3
7837,3,2,27341,27341,27343,0,2,0
7838,2,2,27343,27343,27345,0,2,0
7839,1,2,27344,27345,27347,1,3,0
7840,6,1,27350,27350,27351,0,1,3
7841,4,1,27354,27354,27355,0,1,3
7842,2,2,27356,27356,27358,0,2,1
7843,4,1,27360,27360,27361,0,1,2
7844,6,2,27366,27366,27368,0,2,5
7845,4,2,27370,27370,27372,0,2,2
7846,1,2,27371,27372,27374,1,3,0
7847,5,3,27376,27376,27379,0,3,2
7848,1,2,27377,27379,27381,2,4,0
7849,3,2,27380,27381,27383,1,3,0
7850,2,1,27382,27383,27384,1,2,0
7851,3,2,27385,27385,27387,0,2,1
7852,2,3,27387,27387,27390,0,3,0
7853,5,3,27392,27392,27395,0,3,2
7854,2,2,27394,27395,27397,1,3,0
7855,5,3,27399,27399,27402,0,3,2
7856,3,3,27402,27402,27405,0,3,0
7857,4,2,27406,27406,27408,0,2,1
7858,6,2,27412,27412,27414,0,2,4
7859,6,2,27418,27418,27420,0,2,4
7860,3,3,27421,27421,27424,0,3,1
7861,6,3,27427,27427,27430,0,3,3
7862,6,1,27433,27433,27434,0,1,3
7863,2,2,27435,27435,27437,0,2,1
7864,6,2,27441,27441,27443,0,2,4
7865,3,3,27444,27444,27447,0,3,1
7866,5,1,27449,27449,27450,0,1,2
7867,5,2,27454,27454,27456,0,2,4
7868,5,2,27459,27459,27461,0,2,3
7869,5,2,27464,27464,27466,0,2,3
7870,3,3,27467,27467,27470,0,3,1
7871,6,2,27473,27473,27475,0,2,3
7872,1,3,27474,27475,27478,1,4,0
7873,2,2,27476,27478,27480,2,4,0
7874,5,3,27481,27481,27484,0,3,1
7875,5,1,27486,27486,27487,0,1,2
7876,5,3,27491,27491,27494,0,3,4
7877,3,1,27494,27494,27495,0,1,0
7878,5,1,27499,27499,27500,0,1,4
7879,3,2,27502,27502,27504,0,2,2
7880,6,1,27508,27508,27509,0,1,4
7881,3,1,27511,27511,27512,0,1,2
7882,5,2,27516,27516,27518,0,2,4
7883,2,3,27518,27518,27521,0,3,0
7884,5,1,27523,27523,27524,0,1,2
7885,4,2,27527,27527,27529,0,2,3
7886,2,2,27529,27529,27531,0,2,0
7887,3,3,27532,27532,27535,0,3,1
7888,4,3,27536,27536,27539,0,3,1
7889,4,2,27540,27540,27542,0,2,1
7890,6,2,27546,27546,27548,0,2,4
7891,6,3,27552,27552,27555,0,3,4
7892,2,2,27554,27555,27557,1,3,0
7893,3,3,27557,27557,27560,0,3,0
7894,3,3,27560,27560,27563,0,3,0
7895,6,1,27566,27566,27567,0,1,3
7896,3,3,27569,27569,27572,0,3,2
7897,6,3,27575,27575,27578,0,3,3
7898,5,1,27580,27580,27581,0,1,2
7899,3,2,27583,27583,27585,0,2,2
7900,4,2,27587,27587,27589,0,2,2
7901,5,3,27592,27592,27595,0,3,3
7902,1,3,27593,27595,27598,2,5,0
7903,5,1,27598,27598,27599,0,1,0
7904,2,3,27600,27600,27603,0,3,1
7905,2,2,27602,27603,27605,1,3,0
7906,1,2,27603,27605,27607,2,4,0
7907,2,3,27605,27607,27610,2,5,0
7908,2,1,27607,27610,27611,3,4,0
7909,1,2,27608,27611,27613,3,5,0
7910,3,1,27611,27613,27614,2,3,0
7911,1,3,27612,27614,27617,2,5,0
7912,6,3,27618,27618,27621,0,3,1
7913,6,2,27624,27624,27626,0,2,3
7914,5,2,27629,27629,27631,0,2,3
7915,5,3,27634,27634,27637,0,3,3
7916,6,1,27640,27640,27641,0,1,3
7917,4,2,27644,27644,27646,0,2,3
7918,3,2,27647,27647,27649,0,2,1
7919,3,3,27650,27650,27653,0,3,1
7920,2,1,27652,27653,27654,1,2,0
7921,4,2,27656,27656,27658,0,2,2
7922,6,1,27662,27662,27663,0,1,4
7923,3,2,27665,27665,27667,0,2,2
7924,3,1,27668,27668,27669,0,1,1
7925,3,2,27671,27671,27673,0,2,2
7926,6,3,27677,27677,27680,0,3,4
7927,6,1,27683,27683,27684,0,1,3
7928,4,3,27687,27687,27690,0,3,3
7929,1,3,27688,27690,27693,2,5,0
7930,5,1,27693,27693,27694,0,1,0
7931,5,3,27698,27698,27701,0,3,4
7932,3,3,27701,27701,27704,0,3,0
7933,5,1,27706,27706,27707,0,1,2
7934,1,1,27707,27707,27708,0,1,0
7935,5,3,27712,27712,27715,0,3,4
7936,3,3,27715,27715,27718,0,3,0
7937,6,2,27721,27721,27723,0,2,3
7938,3,2,27724,27724,27726,0,2,1
7939,1,1,27725,27726,27727,1,2,0
7940,2,2,27727,27727,27729,0,2,0
7941,1,1,27728,27729,27730,1,2,0
7942,5,1,27733,27733,27734,0,1,3
7943,6,2,27739,27739,27741,0,2,5
7944,3,3,27742,27742,27745,0,3,1
7945,2,3,27744,27745,27748,1,4,0
7946,2,2,27746,27748,27750,2,4,0
7947,4,3,27750,27750,27753,0,3,0
7948,6,2,27756,27756,27758,0,2,3
7949,5,3,27761,27761,27764,0,3,3
7950,5,2,27766,27766,27768,0,2,2
7951,3,1,27769,27769,27770,0,1,1
7952,3,3,27772,27772,27775,0,3,2
7953,2,3,27774,27775,27778,1,4,0
7954,5,3,27779,27779,27782,0,3,1
7955,4,3,27783,27783,27786,0,3,1
7956,4,2,27787,27787,27789,0,2,1
7957,4,1,27791,27791,27792,0,1,2
7958,1,3,27792,27792,27795,0,3,0
7959,5,3,27797,27797,27800,0,3,2
7960,4,1,27801,27801,27802,0,1,1
7961,1,1,27802,27802,27803,0,1,0
7962,5,3,27807,27807,27810,0,3,4
7963,2,2,27809,27810,27812,1,3,0
7964,1,1,27810,27812,27813,2,3,0
7965,4,1,27814,27814,27815,0,1,1
7966,6,1,27820,27820,27821,0,1,5
7967,1,3,27821,27821,27824,0,3,0
7968,2,1,27823,27824,27825,1,2,0
7969,5,1,27828,27828,27829,0,1,3
7970,2,2,27830,27830,27832,0,2,1
7971,1,2,27831,27832,27834,1,3,0
7972,5,2,27836,27836,27838,0,2,2
7973,4,1,27840,27840,27841,0,1,2
7974,1,1,27841,27841,27842,0,1,0
7975,1,1,27842,27842,27843,0,1,0
7976,4,1,27846,27846,27847,0,1,3
7977,5,3,27851,27851,27854,0,3,4
7978,5,2,27856,27856,27858,0,2,2
7979,1,2,27857,27858,27860,1,3,0
7980,2,3,27859,27860,27863,1,4,0
7981,1,3,27860,27863,27866,3,6,0
7982,1,3,27861,27866,27869,5,8,0
7983,2,2,27863,27869,27871,6,8,0
7984,2,1,27865,27871,27872,6,7,0
7985,6,3,27871,27872,27875,1,4,0
7986,1,1,27872,27875,27876,3,4,0
7987,5,2,27877,27877,27879,0,2,1
7988,1,2,27878,27879,27881,1,3,0
7989,6,2,27884,27884,27886,0,2,3
7990,3,2,27887,27887,27889,0,2,1
7991,6,1,27893,27893,27894,0,1,4
7992,6,2,27899,27899,27901,0,2,5
7993,5,3,27904,27904,27907,0,3,3
7994,3,3,27907,27907,27910,0,3,0
7995,4,2,27911,27911,27913,0,2,1
7996,3,1,27914,27914,27915,0,1,1
7997,2,2,27916,27916,27918,0,2,1
7998,5,3,27921,27921,27924,0,3,3
7999,1,1,27922,27924,27925,2,3,0
8000,6,3,27928,27928,27931,0,3,3
8001,5,2,27933,27933,27935,0,2,2
8002,5,1,27938,27938,27939,0,1,3
8003,2,3,27940,27940,27943,0,3,1
8004,1,2,27941,27943,27945,2,4,0
8005,4,2,27945,27945,27947,0,2,0
8006,5,3,27950,27950,27953,0,3,3
8007,3,2,27953,27953,27955,0,2,0
8008,5,1,27958,27958,27959,0,1,3
8009,3,1,27961,27961,27962,0,1,2
8010,5,1,27966,27966,27967,0,1,4
8011,5,3,27971,27971,27974,0,3,4
8012,1,2,27972,27974,27976,2,4,0
8013,4,2,27976,27976,27978,0,2,0
8014,6,2,27982,27982,27984,0,2,4
8015,3,3,27985,27985,27988,0,3,1
8016,5,1,27990,27990,27991,0,1,2
8017,1,2,27991,27991,27993,0,2,0
8018,1,2,27992,27993,27995,1,3,0
8019,1,1,27993,27995,27996,2,3,0
8020,3,1,27996,27996,27997,0,1,0
8021,5,3,28001,28001,28004,0,3,4
8022,5,3,28006,28006,28009,0,3,2
8023,2,2,28008,28009,28011,1,3,0
8024,4,2,28012,28012,28014,0,2,1
8025,2,1,28014,28014,28015,0,1,0
8026,3,2,28017,28017,28019,0,2,2
8027,3,3,28020,28020,28023,0,3,1
8028,5,1,28025,28025,28026,0,1,2
8029,5,2,28030,28030,28032,0,2,4
8030,6,2,28036,28036,28038,0,2,4
8031,1,2,28037,28038,28040,1,3,0
8032,3,3,28040,28040,28043,0,3,0
8033,1,3,28041,28043,28046,2,5,0
8034,3,3,28044,28046,28049,2,5,0
8035,4,1,28048,28049,28050,1,2,0
8036,2,1,28050,28050,28051,0,1,0
8037,5,2,28055,28055,28057,0,2,4
8038,6,2,28061,28061,28063,0,2,4
8039,1,1,28062,28063,28064,1,2,0
8040,3,1,28065,28065,28066,0,1,1
8041,3,1,28068,28068,28069,0,1,2
8042,2,3,28070,28070,28073,0,3,1
8043,2,3,28072,28073,28076,1,4,0
8044,1,2,28073,28076,28078,3,5,0
8045,3,2,28076,28078,28080,2,4,0
8046,3,1,28079,28080,28081,1,2,0
8047,4,2,28083,28083,28085,0,2,2
8048,2,1,28085,28085,28086,0,1,0
8049,3,2,28088,28088,28090,0,2,2
8050,6,1,28094,28094,28095,0,1,4
8051,2,2,28096,28096,28098,0,2,1
8052,2,3,28098,28098,28101,0,3,0
8053,4,2,28102,28102,28104,0,2,1
8054,5,3,28107,28107,28110,0,3,3
8055,1,3,28108,28110,28113,2,5,0
8056,6,3,28114,28114,28117,0,3,1
8057,6,1,28120,28120,28121,0,1,3
8058,1,2,28121,28121,28123,0,2,0
8059,5,1,28126,28126,28127,0,1,3
8060,1,1,28127,28127,28128,0,1,0
8061,5,1,28132,28132,28133,0,1,4
8062,5,3,28137,28137,28140,0,3,4
8063,4,3,28141,28141,28144,0,3,1
8064,5,1,28146,28146,28147,0,1,2
8065,3,3,28149,28149,28152,0,3,2
8066,3,1,28152,28152,28153,0,1,0
8067,2,1,28154,28154,28155,0,1,1
8068,1,3,28155,28155,28158,0,3,0
8069,1,2,28156,28158,28160,2,4,0
8070,2,1,28158,28160,28161,2,3,0
8071,5,1,28163,28163,28164,0,1,2
8072,6,1,28169,28169,28170,0,1,5
8073,2,2,28171,28171,28173,0,2,1
8074,2,3,28173,28173,28176,0,3,0
8075,3,3,28176,28176,28179,0,3,0
8076,6,3,28182,28182,28185,0,3,3
8077,3,1,28185,28185,28186,0,1,0
8078,1,1,28186,28186,28187,0,1,0
8079,6,2,28192,28192,28194,0,2,5
8080,6,1,28198,28198,28199,0,1,4
8081,2,1,28200,28200,28201,0,1,1
8082,6,2,28206,28206,28208,0,2,5
8083,5,2,28211,28211,28213,0,2,3
8084,6,2,28217,28217,28219,0,2,4
8085,4,3,28221,28221,28224,0,3,2
8086,1,2,28222,28224,28226,2,4,0
8087,2,3,28224,28226,28229,2,5,0
8088,6,3,28230,28230,28233,0,3,1
8089,2,3,28232,28233,28236,1,4,0
8090,1,3,28233,28236,28239,3,6,0
8091,6,3,28239,28239,28242,0,3,0
8092,6,2,28245,28245,28247,0,2,3
8093,1,3,28246,28247,28250,1,4,0
8094,4,3,28250,28250,28253,0,3,0
8095,4,1,28254,28254,28255,0,1,1
8096,5,3,28259,28259,28262,0,3,4
8097,1,2,28260,28262,28264,2,4,0
8098,2,2,28262,28264,28266,2,4,0
8099,6,1,28268,28268,28269,0,1,2
8100,4,2,28272,28272,28274,0,2,3
8101,3,3,28275,28275,28278,0,3,1
8102,6,2,28281,28281,28283,0,2,3
8103,1,2,28282,28283,28285,1,3,0
8104,2,2,28284,28285,28287,1,3,0
8105,4,1,28288,28288,28289,0,1,1
8106,6,2,28294,28294,28296,0,2,5
8107,4,1,28298,28298,28299,0,1,2
8108,5,2,28303,28303,28305,0,2,4
8109,4,3,28307,28307,28310,0,3,2
8110,1,1,28308,28310,28311,2,3,0
8111,2,2,28310,28311,28313,1,3,0
8112,2,3,28312,28313,28316,1,4,0
8113,6,3,28318,28318,28321,0,3,2
8114,3,3,28321,28321,28324,0,3,0
8115,1,3,28322,28324,28327,2,5,0
8116,5,1,28327,28327,28328,0,1,0
8117,2,3,28329,28329,28332,0,3,1
8118,5,1,28334,28334,28335,0,1,2
8119,6,3,28340,28340,28343,0,3,5
8120,5,3,28345,28345,28348,0,3,2
8121,2,2,28347,28348,28350,1,3,0
8122,3,3,28350,28350,28353,0,3,0
8123,6,2,28356,28356,28358,0,2,3
8124,2,2,28358,28358,28360,0,2,0
8125,5,1,28363,28363,28364,0,1,3
8126,6,1,28369,28369,28370,0,1,5
8127,4,3,28373,28373,28376,0,3,3
8128,3,2,28376,28376,28378,0,2,0
8129,5,3,28381,28381,28384,0,3,3
8130,5,2,28386,28386,28388,0,2,2
8131,1,2,28387,28388,28390,1,3,0
8132,3,1,28390,28390,28391,0,1,0
8133,4,3,28394,28394,28397,0,3,3
8134,2,1,28396,28397,28398,1,2,0
8135,6,2,28402,28402,28404,0,2,4
8136,3,3,28405,28405,28408,0,3,1
8137,5,3,28410,28410,28413,0,3,2
8138,3,2,28413,28413,28415,0,2,0
8139,4,3,28417,28417,28420,0,3,2
8140,2,3,28419,28420,28423,1,4,0
8141,6,2,28425,28425,28427,0,2,2
8142,4,3,28429,28429,28432,0,3,2
8143,2,3,28431,28432,28435,1,4,0
8144,3,2,28434,28435,28437,1,3,0
8145,6,3,28440,28440,28443,0,3,3
8146,4,3,28444,28444,28447,0,3,1
8147,6,3,28450,28450,28453,0,3,3
8148,1,3,28451,28453,28456,2,5,0
8149,1,2,28452,28456,28458,4,6,0
8150,1,1,28453,28458,28459,5,6,0
8151,5,1,28458,28459,28460,1,2,0
8152,3,3,28461,28461,28464,0,3,1
8153,1,3,28462,28464,28467,2,5,0
8154,3,3,28465,28467,28470,2,5,0
8155,5,3,28470,28470,28473,0,3,0
8156,3,3,28473,28473,28476,0,3,0
8157,4,1,28477,28477,28478,0,1,1
8158,6,2,28483,28483,28485,0,2,5
8159,4,1,28487,28487,28488,0,1,2
8160,4,1,28491,28491,28492,0,1,3
8161,6,2,28497,28497,28499,0,2,5
8162,2,2,28499,28499,28501,0,2,0
8163,3,3,28502,28502,28505,0,3,1
8164,6,2,28508,28508,28510,0,2,3
8165,4,3,28512,28512,28515,0,3,2
8166,4,3,28516,28516,28519,0,3,1
8167,2,3,28518,28519,28522,1,4,0
8168,1,1,28519,28522,28523,3,4,0
8169,3,3,28522,28523,28526,1,4,0
8170,2,1,28524,28526,28527,2,3,0
8171,2,2,28526,28527,28529,1,3,0
8172,4,3,28530,28530,28533,0,3,1
8173,6,2,28536,28536,28538,0,2,3
8174,3,1,28539,28539,28540,0,1,1
8175,1,1,28540,28540,28541,0,1,0
8176,4,2,28544,28544,28546,0,2,3
8177,1,3,28545,28546,28549,1,4,0
8178,3,1,28548,28549,28550,1,2,0
8179,6,1,28554,28554,28555,0,1,4
8180,1,3,28555,28555,28558,0,3,0
8181,6,3,28561,28561,28564,0,3,3
8182,3,1,28564,28564,28565,0,1,0
8183,2,3,28566,28566,28569,0,3,1
8184,3,2,28569,28569,28571,0,2,0
8185,1,1,28570,28571,28572,1,2,0
8186,2,2,28572,28572,28574,0,2,0
8187,6,3,28578,28578,28581,0,3,4
8188,3,1,28581,28581,28582,0,1,0
8189,2,3,28583,28583,28586,0,3,1
8190,2,2,28585,28586,28588,1,3,0
8191,3,1,28588,28588,28589,0,1,0
8192,6,1,28594,28594,28595,0,1,5
8193,4,3,28598,28598,28601,0,3,3
8194,2,2,28600,28601,28603,1,3,0
8195,5,3,28605,28605,28608,0,3,2
8196,3,1,28608,28608,28609,0,1,0
8197,5,2,28613,28613,28615,0,2,4
8198,2,1,28615,28615,28616,0,1,0
8199,3,3,28618,28618,28621,0,3,2
8200,1,2,28619,28621,28623,2,4,0
8201,1,3,28620,28623,28626,3,6,0
8202,6,1,28626,28626,28627,0,1,0
8203,4,1,28630,28630,28631,0,1,3
8204,1,3,28631,28631,28634,0,3,0
8205,3,2,28634,28634,28636,0,2,0
8206,4,1,28638,28638,28639,0,1,2
8207,1,3,28639,28639,28642,0,3,0
8208,2,1,28641,28642,28643,1,2,0
8209,2,3,28643,28643,28646,0,3,0
8210,4,2,28647,28647,28649,0,2,1
8211,3,2,28650,28650,28652,0,2,1
8212,3,2,28653,28653,28655,0,2,1
8213,4,1,28657,28657,28658,0,1,2
8214,3,1,28660,28660,28661,0,1,2
8215,4,2,28664,28664,28666,0,2,3
8216,1,2,28665,28666,28668,1,3,0
8217,3,3,28668,28668,28671,0,3,0
8218,2,2,28670,28671,28673,1,3,0
8219,2,3,28672,28673,28676,1,4,0
8220,6,2,28678,28678,28680,0,2,2
8221,4,1,28682,28682,28683,0,1,2
8222,4,2,28686,28686,28688,0,2,3
8223,6,3,28692,28692,28695,0,3,4
8224,4,2,28696,28696,28698,0,2,1
8225,5,1,28701,28701,28702,0,1,3
8226,1,2,28702,28702,28704,0,2,0
8227,6,1,28708,28708,28709,0,1,4
8228,4,1,28712,28712,28713,0,1,3
8229,3,2,28715,28715,28717,0,2,2
8230,4,1,28719,28719,28720,0,1,2
8231,1,2,28720,28720,28722,0,2,0
8232,1,3,28721,28722,28725,1,4,0
8233,1,2,28722,28725,28727,3,5,0
8234,1,1,28723,28727,28728,4,5,0
8235,6,2,28729,28729,28731,0,2,1
8236,1,3,28730,28731,28734,1,4,0
8237,5,2,28735,28735,28737,0,2,1
8238,3,1,28738,28738,28739,0,1,1
8239,2,3,28740,28740,28743,0,3,1
8240,3,2,28743,28743,28745,0,2,0
8241,3,3,28746,28746,28749,0,3,1
8242,3,1,28749,28749,28750,0,1,0
8243,4,3,28753,28753,28756,0,3,3
8244,1,1,28754,28756,28757,2,3,0
8245,4,2,28758,28758,28760,0,2,1
8246,2,1,28760,28760,28761,0,1,0
8247,5,1,28765,28765,28766,0,1,4
8248,6,2,28771,28771,28773,0,2,5
8249,1,1,28772,28773,28774,1,2,0
8250,2,3,28774,28774,28777,0,3,0
8251,4,1,28778,28778,28779,0,1,1
8252,5,3,28783,28783,28786,0,3,4
8253,6,1,28789,28789,28790,0,1,3
8254,6,3,28795,28795,28798,0,3,5
8255,2,1,28797,28798,28799,1,2,0
8256,3,1,28800,28800,28801,0,1,1
8257,5,2,28805,28805,28807,0,2,4
8258,1,2,28806,28807,28809,1,3,0
8259,2,1,28808,28809,28810,1,2,0
8260,4,3,28812,28812,28815,0,3,2
8261,2,3,28814,28815,28818,1,4,0
8262,5,1,28819,28819,28820,0,1,1
8263,5,2,28824,28824,28826,0,2,4
8264,1,3,28825,28826,28829,1,4,0
8265,3,3,28828,28829,28832,1,4,0
8266,6,3,28834,28834,28837,0,3,2
8267,1,3,28835,28837,28840,2,5,0
8268,4,3,28839,28840,28843,1,4,0
8269,5,1,28844,28844,28845,0,1,1
8270,5,3,28849,28849,28852,0,3,4
8271,3,1,28852,28852,28853,0,1,0
8272,4,2,28856,28856,28858,0,2,3
8273,3,3,28859,28859,28862,0,3,1
8274,1,1,28860,28862,28863,2,3,0
8275,4,1,28864,28864,28865,0,1,1
8276,3,2,28867,28867,28869,0,2,2
8277,4,2,28871,28871,28873,0,2,2
8278,1,2,28872,28873,28875,1,3,0
8279,5,1,28877,28877,28878,0,1,2
8280,2,1,28879,28879,28880,0,1,1
8281,2,1,28881,28881,28882,0,1,1
8282,5,1,28886,28886,28887,0,1,4
8283,1,1,28887,28887,28888,0,1,0
8284,2,2,28889,28889,28891,0,2,1
8285,5,2,28894,28894,28896,0,2,3
8286,1,1,28895,28896,28897,1,2,0
8287,2,1,28897,28897,28898,0,1,0
8288,3,3,28900,28900,28903,0,3,2
8289,2,3,28902,28903,28906,1,4,0
8290,2,2,28904,28906,28908,2,4,0
8291,2,2,28906,28908,28910,2,4,0
8292,4,2,28910,28910,28912,0,2,0
8293,2,1,28912,28912,28913,0,1,0
8294,5,3,28917,28917,28920,0,3,4
8295,2,3,28919,28920,28923,1,4,0
8296,5,1,28924,28924,28925,0,1,1
8297,3,1,28927,28927,28928,0,1,2
8298,5,1,28932,28932,28933,0,1,4
8299,6,1,28938,28938,28939,0,1,5
8300,6,2,28944,28944,28946,0,2,5
8301,2,2,28946,28946,28948,0,2,0
8302,5,1,28951,28951,28952,0,1,3
8303,6,2,28957,28957,28959,0,2,5
8304,4,1,28961,28961,28962,0,1,2
8305,2,2,28963,28963,28965,0,2,1
8306,3,1,28966,28966,28967,0,1,1
8307,1,3,28967,28967,28970,0,3,0
8308,2,1,28969,28970,28971,1,2,0
8309,2,3,28971,28971,28974,0,3,0
8310,2,1,28973,28974,28975,1,2,0
8311,5,1,28978,28978,28979,0,1,3
8312,3,3,28981,28981,28984,0,3,2
8313,5,3,28986,28986,28989,0,3,2
8314,1,3,28987,28989,28992,2,5,0
8315,3,1,28990,28992,28993,2,3,0
8316,4,2,28994,28994,28996,0,2,1
8317,2,1,28996,28996,28997,0,1,0
8318,5,3,29001,29001,29004,0,3,4
8319,6,3,29007,29007,29010,0,3,3
8320,4,1,29011,29011,29012,0,1,1
8321,2,1,29013,29013,29014,0,1,1
8322,4,2,29017,29017,29019,0,2,3
8323,4,1,29021,29021,29022,0,1,2
8324,6,1,29027,29027,29028,0,1,5
8325,2,3,29029,29029,29032,0,3,1
8326,5,2,29034,29034,29036,0,2,2
8327,4,3,29038,29038,29041,0,3,2
8328,4,3,29042,29042,29045,0,3,1
8329,6,3,29048,29048,29051,0,3,3
8330,5,3,29053,29053,29056,0,3,2
8331,5,2,29058,29058,29060,0,2,2
8332,2,2,29060,29060,29062,0,2,0
8333,4,1,29064,29064,29065,0,1,2
8334,4,2,29068,29068,29070,0,2,3
8335,5,2,29073,29073,29075,0,2,3
8336,5,2,29078,29078,29080,0,2,3
8337,5,3,29083,29083,29086,0,3,3
8338,1,3,29084,29086,29089,2,5,0
8339,5,1,29089,29089,29090,0,1,0
8340,3,2,29092,29092,29094,0,2,2
8341,6,2,29098,29098,29100,0,2,4
8342,2,2,29100,29100,29102,0,2,0
8343,6,1,29106,29106,29107,0,1,4
8344,6,3,29112,29112,29115,0,3,5
8345,1,3,29113,29115,29118,2,5,0
8346,6,1,29119,29119,29120,0,1,1
8347,6,1,29125,29125,29126,0,1,5
8348,2,1,29127,29127,29128,0,1,1
8349,3,3,29130,29130,29133,0,3,2
8350,6,1,29136,29136,29137,0,1,3
8351,4,3,29140,29140,29143,0,3,3
8352,1,1,29141,29143,29144,2,3,0
8353,6,2,29147,29147,29149,0,2,3
8354,5,1,29152,29152,29153,0,1,3
8355,3,1,29155,29155,29156,0,1,2
8356,6,3,29161,29161,29164,0,3,5
8357,1,3,29162,29164,29167,2,5,0
8358,5,1,29167,29167,29168,0,1,0
8359,5,3,29172,29172,29175,0,3,4
8360,1,3,29173,29175,29178,2,5,0
8361,3,3,29176,29178,29181,2,5,0
8362,2,2,29178,29181,29183,3,5,0
8363,4,1,29182,29183,29184,1,2,0
8364,3,2,29185,29185,29187,0,2,1
8365,2,2,29187,29187,29189,0,2,0
8366,2,3,29189,29189,29192,0,3,0
8367,6,2,29195,29195,29197,0,2,3
8368,3,3,29198,29198,29201,0,3,1
8369,5,2,29203,29203,29205,0,2,2
8370,6,3,29209,29209,29212,0,3,4
8371,6,2,29215,29215,29217,0,2,3
8372,4,2,29219,29219,29221,0,2,2
8373,4,1,29223,29223,29224,0,1,2
8374,1,2,29224,29224,29226,0,2,0
8375,5,2,29229,29229,29231,0,2,3
8376,2,2,29231,29231,29233,0,2,0
8377,6,2,29237,29237,29239,0,2,4
8378,2,1,29239,29239,29240,0,1,0
8379,3,1,29242,29242,29243,0,1,2
8380,6,1,29248,29248,29249,0,1,5
8381,2,1,29250,29250,29251,0,1,1
8382,2,1,29252,29252,29253,0,1,1
8383,1,2,29253,29253,29255,0,2,0
8384,6,3,29259,29259,29262,0,3,4
8385,1,2,29260,29262,29264,2,4,0
8386,5,2,29265,29265,29267,0,2,1
8387,5,3,29270,29270,29273,0,3,3
8388,5,3,29275,29275,29278,0,3,2
8389,5,2,29280,29280,29282,0,2,2
8390,6,2,29286,29286,29288,0,2,4
8391,3,2,29289,29289,29291,0,2,1
8392,6,1,29295,29295,29296,0,1,4
8393,5,3,29300,29300,29303,0,3,4
8394,1,2,29301,29303,29305,2,4,0
8395,5,2,29306,29306,29308,0,2,1
8396,5,1,29311,29311,29312,0,1,3
8397,1,2,29312,29312,29314,0,2,0
8398,1,1,29313,29314,29315,1,2,0
8399,5,2,29318,29318,29320,0,2,3
8400,5,3,29323,29323,29326,0,3,3
8401,6,3,29329,29329,29332,0,3,3
8402,2,2,29331,29332,29334,1,3,0
8403,4,1,29335,29335,29336,0,1,1
8404,5,1,29340,29340,29341,0,1,4
8405,6,2,29346,29346,29348,0,2,5
8406,6,1,29352,29352,29353,0,1,4
8407,6,3,29358,29358,29361,0,3,5
8408,2,3,29360,29361,29364,1,4,0
8409,4,2,29364,29364,29366,0,2,0
8410,3,1,29367,29367,29368,0,1,1
8411,3,1,29370,29370,29371,0,1,2
8412,1,2,29371,29371,29373,0,2,0
8413,1,2,29372,29373,29375,1,3,0
8414,5,2,29377,29377,29379,0,2,2
8415,5,1,29382,29382,29383,0,1,3
8416,6,3,29388,29388,29391,0,3,5
8417,4,1,29392,29392,29393,0,1,1
8418,6,1,29398,29398,29399,0,1,5
8419,2,3,29400,29400,29403,0,3,1
8420,6,3,29406,29406,29409,0,3,3
8421,1,2,29407,29409,29411,2,4,0
8422,5,2,29412,29412,29414,0,2,1
8423,1,3,29413,29414,29417,1,4,0
8424,1,1,29414,29417,29418,3,4,0
8425,6,1,29420,29420,29421,0,1,2
8426,6,3,29426,29426,29429,0,3,5
8427,5,2,29431,29431,29433,0,2,2
8428,5,2,29436,29436,29438,0,2,3
8429,3,1,29439,29439,29440,0,1,1
8430,6,3,29445,29445,29448,0,3,5
8431,6,2,29451,29451,29453,0,2,3
8432,6,1,29457,29457,29458,0,1,4
8433,2,2,29459,29459,29461,0,2,1
8434,5,3,29464,29464,29467,0,3,3
8435,1,2,29465,29467,29469,2,4,0
8436,1,1,29466,29469,29470,3,4,0
8437,4,2,29470,29470,29472,0,2,0
8438,3,1,29473,29473,29474,0,1,1
8439,4,1,29477,29477,29478,0,1,3
8440,3,1,29480,29480,29481,0,1,2
8441,1,2,29481,29481,29483,0,2,0
8442,3,1,29484,29484,29485,0,1,1
8443,5,1,29489,29489,29490,0,1,4
8444,3,2,29492,29492,29494,0,2,2
8445,1,2,29493,29494,29496,1,3,0
8446,1,3,29494,29496,29499,2,5,0
8447,6,1,29500,29500,29501,0,1,1
8448,6,2,29506,29506,29508,0,2,5
8449,1,3,29507,29508,29511,1,4,0
8450,6,2,29513,29513,29515,0,2,2
8451,3,1,29516,29516,29517,0,1,1
8452,4,3,29520,29520,29523,0,3,3
8453,6,1,29526,29526,29527,0,1,3
8454,1,1,29527,29527,29528,0,1,0
8455,4,2,29531,29531,29533,0,2,3
8456,3,2,29534,29534,29536,0,2,1
8457,2,3,29536,29536,29539,0,3,0
8458,6,1,29542,29542,29543,0,1,3
8459,6,2,29548,29548,29550,0,2,5
8460,6,3,29554,29554,29557,0,3,4
8461,6,1,29560,29560,29561,0,1,3
8462,2,2,29562,29562,29564,0,2,1
8463,3,1,29565,29565,29566,0,1,1
8464,2,1,29567,29567,29568,0,1,1
8465,4,1,29571,29571,29572,0,1,3
8466,2,1,29573,29573,29574,0,1,1
8467,1,3,29574,29574,29577,0,3,0
8468,2,1,29576,29577,29578,1,2,0
8469,3,1,29579,29579,29580,0,1,1
8470,6,2,29585,29585,29587,0,2,5
8471,2,1,29587,29587,29588,0,1,0
8472,1,3,29588,29588,29591,0,3,0
8473,4,1,29592,29592,29593,0,1,1
8474,6,1,29598,29598,29599,0,1,5
8475,4,2,29602,29602,29604,0,2,3
8476,2,2,29604,29604,29606,0,2,0
8477,2,2,29606,29606,29608,0,2,0
8478,6,2,29612,29612,29614,0,2,4
8479,3,1,29615,29615,29616,0,1,1
8480,1,1,29616,29616,29617,0,1,0
8481,6,2,29622,29622,29624,0,2,5
8482,5,3,29627,29627,29630,0,3,3
8483,4,3,29631,29631,29634,0,3,1
8484,6,2,29637,29637,29639,0,2,3
8485,2,3,29639,29639,29642,0,3,0
8486,4,2,29643,29643,29645,0,2,1
8487,5,1,29648,29648,29649,0,1,3
8488,2,1,29650,29650,29651,0,1,1
8489,5,2,29655,29655,29657,0,2,4
8490,1,2,29656,29657,29659,1,3,0
8491,6,1,29662,29662,29663,0,1,3
8492,3,2,29665,29665,29667,0,2,2
8493,2,3,29667,29667,29670,0,3,0
8494,3,3,29670,29670,29673,0,3,0
8495,2,1,29672,29673,29674,1,2,0
8496,4,2,29676,29676,29678,0,2,2
8497,5,2,29681,29681,29683,0,2,3
8498,6,3,29687,29687,29690,0,3,4
8499,6,2,29693,29693,29695,0,2,3
8500,5,3,29698,29698,29701,0,3,3
8501,3,1,29701,29701,29702,0,1,0
8502,3,3,29704,29704,29707,0,3,2
8503,1,2,29705,29707,29709,2,4,0
8504,4,2,29709,29709,29711,0,2,0
8505,6,2,29715,29715,29717,0,2,4
8506,5,1,29720,29720,29721,0,1,3
8507,5,1,29725,29725,29726,0,1,4
8508,2,2,29727,29727,29729,0,2,1
8509,6,1,29733,29733,29734,0,1,4
8510,4,3,29737,29737,29740,0,3,3
8511,5,1,29742,29742,29743,0,1,2
8512,4,3,29746,29746,29749,0,3,3
8513,3,1,29749,29749,29750,0,1,0
8514,1,2,29750,29750,29752,0,2,0
8515,2,1,29752,29752,29753,0,1,0
8516,5,1,29757,29757,29758,0,1,4
8517,5,3,29762,29762,29765,0,3,4
8518,6,2,29768,29768,29770,0,2,3
8519,1,1,29769,29770,29771,1,2,0
8520,6,3,29775,29775,29778,0,3,4
8521,2,2,29777,29778,29780,1,3,0
8522,1,3,29778,29780,29783,2,5,0
8523,3,2,29781,29783,29785,2,4,0
8524,2,2,29783,29785,29787,2,4,0
8525,5,1,29788,29788,29789,0,1,1
8526,3,2,29791,29791,29793,0,2,2
8527,6,2,29797,29797,29799,0,2,4
8528,3,1,29800,29800,29801,0,1,1
8529,5,3,29805,29805,29808,0,3,4
8530,2,1,29807,29808,29809,1,2,0
8531,6,3,29813,29813,29816,0,3,4
8532,2,2,29815,29816,29818,1,3,0
8533,5,1,29820,29820,29821,0,1,2
8534,4,1,29824,29824,29825,0,1,3
8535,5,2,29829,29829,29831,0,2,4
8536,5,2,29834,29834,29836,0,2,3
8537,4,1,29838,29838,29839,0,1,2
8538,6,1,29844,29844,29845,0,1,5
8539,6,2,29850,29850,29852,0,2,5
8540,4,1,29854,29854,29855,0,1,2
8541,2,3,29856,29856,29859,0,3,1
8542,3,2,29859,29859,29861,0,2,0
8543,5,1,29864,29864,29865,0,1,3
8544,2,3,29866,29866,29869,0,3,1
8545,6,3,29872,29872,29875,0,3,3
8546,6,3,29878,29878,29881,0,3,3
8547,4,2,29882,29882,29884,0,2,1
8548,3,2,29885,29885,29887,0,2,1
8549,1,2,29886,29887,29889,1,3,0
8550,2,3,29888,29889,29892,1,4,0
8551,3,1,29891,29892,29893,1,2,0
8552,3,3,29894,29894,29897,0,3,1
8553,2,3,29896,29897,29900,1,4,0
8554,3,3,29899,29900,29903,1,4,0
8555,3,2,29902,29903,29905,1,3,0
8556,5,3,29907,29907,29910,0,3,2
8557,3,3,29910,29910,29913,0,3,0
8558,4,1,29914,29914,29915,0,1,1
8559,5,3,29919,29919,29922,0,3,4
8560,6,3,29925,29925,29928,0,3,3
8561,1,2,29926,29928,29930,2,4,0
8562,4,1,29930,29930,29931,0,1,0
8563,5,1,29935,29935,29936,0,1,4
8564,1,1,29936,29936,29937,0,1,0
8565,2,2,29938,29938,29940,0,2,1
8566,1,3,29939,29940,29943,1,4,0
8567,6,1,29945,29945,29946,0,1,2
8568,5,2,29950,29950,29952,0,2,4
8569,4,2,29954,29954,29956,0,2,2
8570,3,1,29957,29957,29958,0,1,1
8571,3,3,29960,29960,29963,0,3,2
8572,4,3,29964,29964,29967,0,3,1
8573,4,2,29968,29968,29970,0,2,1
8574,4,1,29972,29972,29973,0,1,2
8575,1,3,29973,29973,29976,0,3,0
8576,3,1,29976,29976,29977,0,1,0
8577,2,2,29978,29978,29980,0,2,1
8578,1,2,29979,29980,29982,1,3,0
8579,2,2,29981,29982,29984,1,3,0
8580,1,3,29982,29984,29987,2,5,0
8581,1,3,29983,29987,29990,4,7,0
8582,1,3,29984,29990,29993,6,9,0
8583,3,2,29987,29993,29995,6,8,0
8584,4,1,29991,29995,29996,4,5,0
8585,5,1,29996,29996,29997,0,1,0
8586,6,2,30002,30002,30004,0,2,5
8587,4,2,30006,30006,30008,0,2,2
8588,3,3,30009,30009,30012,0,3,1
8589,1,3,30010,30012,30015,2,5,0
8590,1,2,30011,30015,30017,4,6,0
8591,3,3,30014,30017,30020,3,6,0
8592,4,2,30018,30020,30022,2,4,0
8593,5,3,30023,30023,30026,0,3,1
8594,5,1,30028,30028,30029,0,1,2
8595,3,1,30031,30031,30032,0,1,2
8596,6,3,30037,30037,30040,0,3,5
8597,2,2,30039,30040,30042,1,3,0
8598,5,3,30044,30044,30047,0,3,2
8599,6,1,30050,30050,30051,0,1,3
8600,3,2,30053,30053,30055,0,2,2
8601,4,3,30057,30057,30060,0,3,2
8602,3,1,30060,30060,30061,0,1,0
8603,3,2,30063,30063,30065,0,2,2
8604,6,3,30069,30069,30072,0,3,4
8605,1,2,30070,30072,30074,2,4,0
8606,3,1,30073,30074,30075,1,2,0
8607,5,3,30078,30078,30081,0,3,3
8608,2,2,30080,30081,30083,1,3,0
8609,1,1,30081,30083,30084,2,3,0
8610,2,1,30083,30084,30085,1,2,0
8611,6,3,30089,30089,30092,0,3,4
8612,2,2,30091,30092,30094,1,3,0
8613,2,3,30093,30094,30097,1,4,0
8614,5,2,30098,30098,30100,0,2,1
8615,2,3,30100,30100,30103,0,3,0
8616,3,1,30103,30103,30104,0,1,0
8617,4,2,30107,30107,30109,0,2,3
8618,5,1,30112,30112,30113,0,1,3
8619,3,3,30115,30115,30118,0,3,2
8620,4,3,30119,30119,30122,0,3,1
8621,1,3,30120,30122,30125,2,5,0
8622,6,3,30126,30126,30129,0,3,1
8623,5,2,30131,30131,30133,0,2,2
8624,1,2,30132,30133,30135,1,3,0
8625,5,3,30137,30137,30140,0,3,2
8626,3,3,30140,30140,30143,0,3,0
8627,5,2,30145,30145,30147,0,2,2
8628,4,1,30149,30149,30150,0,1,2
8629,5,1,30154,30154,30155,0,1,4
8630,5,3,30159,30159,30162,0,3,4
8631,6,2,30165,30165,30167,0,2,3
8632,1,3,30166,30167,30170,1,4,0
8633,1,3,30167,30170,30173,3,6,0
8634,5,2,30172,30173,30175,1,3,0
8635,2,1,30174,30175,30176,1,2,0
8636,1,1,30175,30176,30177,1,2,0
8637,3,3,30178,30178,30181,0,3,1
8638,1,3,30179,30181,30184,2,5,0
8639,4,3,30183,30184,30187,1,4,0
8640,2,1,30185,30187,30188,2,3,0
8641,4,2,30189,30189,30191,0,2,1
8642,5,1,30194,30194,30195,0,1,3
8643,4,1,30198,30198,30199,0,1,3
8644,2,3,30200,30200,30203,0,3,1
8645,5,2,30205,30205,30207,0,2,2
8646,2,1,30207,30207,30208,0,1,0
8647,5,1,30212,30212,30213,0,1,4
8648,6,2,30218,30218,30220,0,2,5
8649,3,1,30221,30221,30222,0,1,1
8650,3,3,30224,30224,30227,0,3,2
8651,4,3,30228,30228,30231,0,3,1
8652,2,1,30230,30231,30232,1,2,0
8653,5,2,30235,30235,30237,0,2,3
8654,6,2,30241,30241,30243,0,2,4
8655,1,3,30242,30243,30246,1,4,0
8656,3,2,30245,30246,30248,1,3,0
8657,4,2,30249,30249,30251,0,2,1
8658,5,3,30254,30254,30257,0,3,3
8659,3,3,30257,30257,30260,0,3,0
8660,1,3,30258,30260,30263,2,5,0
8661,1,1,30259,30263,30264,4,5,0
8662,2,1,30261,30264,30265,3,4,0
8663,4,1,30265,30265,30266,0,1,0
8664,4,3,30269,30269,30272,0,3,3
8665,4,3,30273,30273,30276,0,3,1
8666,3,3,30276,30276,30279,0,3,0
8667,4,3,30280,30280,30283,0,3,1
8668,1,3,30281,30283,30286,2,5,0
8669,1,1,30282,30286,30287,4,5,0
8670,5,3,30287,30287,30290,0,3,0
8671,5,1,30292,30292,30293,0,1,2
8672,6,3,30298,30298,30301,0,3,5
8673,5,1,30303,30303,30304,0,1,2
8674,6,3,30309,30309,30312,0,3,5
8675,3,3,30312,30312,30315,0,3,0
8676,3,3,30315,30315,30318,0,3,0
8677,1,2,30316,30318,30320,2,4,0
8678,6,1,30322,30322,30323,0,1,2
8679,6,3,30328,30328,30331,0,3,5
8680,1,3,30329,30331,30334,2,5,0
8681,5,1,30334,30334,30335,0,1,0
8682,5,3,30339,30339,30342,0,3,4
8683,3,2,30342,30342,30344,0,2,0
8684,6,1,30348,30348,30349,0,1,4
8685,4,3,30352,30352,30355,0,3,3
8686,6,3,30358,30358,30361,0,3,3
8687,5,1,30363,30363,30364,0,1,2
8688,5,2,30368,30368,30370,0,2,4
8689,6,3,30374,30374,30377,0,3,4
8690,5,1,30379,30379,30380,0,1,2
8691,1,1,30380,30380,30381,0,1,0
8692,4,3,30384,30384,30387,0,3,3
8693,3,1,30387,30387,30388,0,1,0
8694,5,1,30392,30392,30393,0,1,4
8695,3,1,30395,30395,30396,0,1,2
8696,6,1,30401,30401,30402,0,1,5
8697,4,2,30405,30405,30407,0,2,3
8698,6,2,30411,30411,30413,0,2,4
8699,2,2,30413,30413,30415,0,2,0
8700,6,2,30419,30419,30421,0,2,4
8701,3,3,30422,30422,30425,0,3,1
8702,2,3,30424,30425,30428,1,4,0
8703,3,2,30427,30428,30430,1,3,0
8704,6,1,30433,30433,30434,0,1,3
8705,6,2,30439,30439,30441,0,2,5
8706,2,2,30441,30441,30443,0,2,0
8707,3,2,30444,30444,30446,0,2,1
8708,5,2,30449,30449,30451,0,2,3
8709,1,2,30450,30451,30453,1,3,0
8710,4,2,30454,30454,30456,0,2,1
8711,1,3,30455,30456,30459,1,4,0
8712,6,2,30461,30461,30463,0,2,2
8713,6,1,30467,30467,30468,0,1,4
8714,4,3,30471,30471,30474,0,3,3
8715,6,3,30477,30477,30480,0,3,3
8716,1,1,30478,30480,30481,2,3,0
8717,4,1,30482,30482,30483,0,1,1
8718,2,2,30484,30484,30486,0,2,1
8719,4,1,30488,30488,30489,0,1,2
8720,1,3,30489,30489,30492,0,3,0
8721,1,2,30490,30492,30494,2,4,0
8722,5,1,30495,30495,30496,0,1,1
8723,1,3,30496,30496,30499,0,3,0
8724,5,3,30501,30501,30504,0,3,2
8725,6,2,30507,30507,30509,0,2,3
8726,1,3,30508,30509,30512,1,4,0
8727,1,2,30509,30512,30514,3,5,0
8728,1,1,30510,30514,30515,4,5,0
8729,3,1,30513,30515,30516,2,3,0
8730,2,2,30515,30516,30518,1,3,0
8731,1,2,30516,30518,30520,2,4,0
8732,3,3,30519,30520,30523,1,4,0
8733,6,1,30525,30525,30526,0,1,2
8734,5,2,30530,30530,30532,0,2,4
8735,2,2,30532,30532,30534,0,2,0
8736,6,3,30538,30538,30541,0,3,4
8737,3,3,30541,30541,30544,0,3,0
8738,4,1,30545,30545,30546,0,1,1
8739,5,3,30550,30550,30553,0,3,4
8740,2,1,30552,30553,30554,1,2,0
8741,1,2,30553,30554,30556,1,3,0
8742,6,2,30559,30559,30561,0,2,3
8743,4,1,30563,30563,30564,0,1,2
8744,6,3,30569,30569,30572,0,3,5
8745,3,1,30572,30572,30573,0,1,0
8746,4,3,30576,30576,30579,0,3,3
8747,6,3,30582,30582,30585,0,3,3
8748,3,2,30585,30585,30587,0,2,0
8749,6,1,30591,30591,30592,0,1,4
8750,6,3,30597,30597,30600,0,3,5
8751,6,3,30603,30603,30606,0,3,3
8752,5,1,30608,30608,30609,0,1,2
8753,4,2,30612,30612,30614,0,2,3
8754,3,1,30615,30615,30616,0,1,1
8755,1,2,30616,30616,30618,0,2,0
8756,5,2,30621,30621,30623,0,2,3
8757,6,1,30627,30627,30628,0,1,4
8758,2,2,30629,30629,30631,0,2,1
8759,4,1,30633,30633,30634,0,1,2
8760,4,2,30637,30637,30639,0,2,3
8761,5,3,30642,30642,30645,0,3,3
8762,4,2,30646,30646,30648,0,2,1
8763,1,1,30647,30648,30649,1,2,0
8764,3,2,30650,30650,30652,0,2,1
8765,2,2,30652,30652,30654,0,2,0
8766,3,1,30655,30655,30656,0,1,1
8767,5,2,30660,30660,30662,0,2,4
8768,3,3,30663,30663,30666,0,3,1
8769,1,3,30664,30666,30669,2,5,0
8770,6,3,30670,30670,30673,0,3,1
8771,2,3,30672,30673,30676,1,4,0
8772,5,1,30677,30677,30678,0,1,1
8773,3,2,30680,30680,30682,0,2,2
8774,5,3,30685,30685,30688,0,3,3
8775,2,2,30687,30688,30690,1,3,0
8776,2,1,30689,30690,30691,1,2,0
8777,5,3,30694,30694,30697,0,3,3
8778,6,1,30700,30700,30701,0,1,3
8779,4,2,30704,30704,30706,0,2,3
8780,5,1,30709,30709,30710,0,1,3
8781,2,1,30711,30711,30712,0,1,1
8782,6,3,30717,30717,30720,0,3,5
8783,4,2,30721,30721,30723,0,2,1
8784,5,2,30726,30726,30728,0,2,3
8785,1,3,30727,30728,30731,1,4,0
8786,1,2,30728,30731,30733,3,5,0
8787,6,1,30734,30734,30735,0,1,1
8788,4,2,30738,30738,30740,0,2,3
8789,3,3,30741,30741,30744,0,3,1
8790,5,2,30746,30746,30748,0,2,2
8791,4,3,30750,30750,30753,0,3,2
8792,6,2,30756,30756,30758,0,2,3
8793,2,3,30758,30758,30761,0,3,0
8794,2,1,30760,30761,30762,1,2,0
8795,4,3,30764,30764,30767,0,3,2
8796,1,2,30765,30767,30769,2,4,0
8797,1,3,30766,30769,30772,3,6,0
8798,4,1,30770,30772,30773,2,3,0
8799,5,2,30775,30775,30777,0,2,2
8800,1,1,30776,30777,30778,1,2,0
8801,4,2,30780,30780,30782,0,2,2
8802,4,1,30784,30784,30785,0,1,2
8803,6,1,30790,30790,30791,0,1,5
8804,6,1,30796,30796,30797,0,1,5
8805,4,3,30800,30800,30803,0,3,3
8806,2,3,30802,30803,30806,1,4,0
8807,5,3,30807,30807,30810,0,3,1
8808,6,2,30813,30813,30815,0,2,3
8809,4,2,30817,30817,30819,0,2,2
8810,5,3,30822,30822,30825,0,3,3
8811,2,3,30824,30825,30828,1,4,0
8812,1,2,30825,30828,30830,3,5,0
8813,1,3,30826,30830,30833,4,7,0
8814,4,3,30830,30833,30836,3,6,0
8815,5,3,30835,30836,30839,1,4,0
8816,4,1,30839,30839,30840,0,1,0
8817,1,1,30840,30840,30841,0,1,0
8818,2,3,30842,30842,30845,0,3,1
8819,5,1,30847,30847,30848,0,1,2
8820,6,1,30853,30853,30854,0,1,5
8821,3,2,30856,30856,30858,0,2,2
8822,5,1,30861,30861,30862,0,1,3
8823,1,2,30862,30862,30864,0,2,0
8824,5,1,30867,30867,30868,0,1,3
8825,4,2,30871,30871,30873,0,2,3
8826,6,1,30877,30877,30878,0,1,4
8827,3,1,30880,30880,30881,0,1,2
8828,4,2,30884,30884,30886,0,2,3
8829,5,2,30889,30889,30891,0,2,3
8830,3,1,30892,30892,30893,0,1,1
8831,5,3,30897,30897,30900,0,3,4
8832,4,2,30901,30901,30903,0,2,1
8833,6,2,30907,30907,30909,0,2,4
8834,3,3,30910,30910,30913,0,3,1
8835,3,3,30913,30913,30916,0,3,0
8836,2,2,30915,30916,30918,1,3,0
8837,5,1,30920,30920,30921,0,1,2
8838,6,3,30926,30926,30929,0,3,5
8839,3,3,30929,30929,30932,0,3,0
8840,3,1,30932,30932,30933,0,1,0
8841,1,3,30933,30933,30936,0,3,0
8842,5,1,30938,30938,30939,0,1,2
8843,2,1,30940,30940,30941,0,1,1
8844,4,2,30944,30944,30946,0,2,3
8845,1,2,30945,30946,30948,1,3,0
8846,5,3,30950,30950,30953,0,3,2
8847,3,3,30953,30953,30956,0,3,0
8848,4,1,30957,30957,30958,0,1,1
8849,1,3,30958,30958,30961,0,3,0
8850,3,1,30961,30961,30962,0,1,0
8851,3,1,30964,30964,30965,0,1,2
8852,2,2,30966,30966,30968,0,2,1
8853,4,3,30970,30970,30973,0,3,2
8854,1,1,30971,30973,30974,2,3,0
8855,4,3,30975,30975,30978,0,3,1
8856,2,1,30977,30978,30979,1,2,0
8857,6,3,30983,30983,30986,0,3,4
8858,5,1,30988,30988,30989,0,1,2
8859,1,3,30989,30989,30992,0,3,0
8860,1,1,30990,30992,30993,2,3,0
8861,1,1,30991,30993,30994,2,3,0
8862,4,3,30995,30995,30998,0,3,1
8863,4,1,30999,30999,31000,0,1,1
8864,1,1,31000,31000,31001,0,1,0
8865,2,1,31002,31002,31003,0,1,1
8866,1,3,31003,31003,31006,0,3,0
8867,2,1,31005,31006,31007,1,2,0
8868,5,2,31010,31010,31012,0,2,3
8869,3,3,31013,31013,31016,0,3,1
8870,5,1,31018,31018,31019,0,1,2
8871,4,2,31022,31022,31024,0,2,3
8872,2,3,31024,31024,31027,0,3,0
8873,6,3,31030,31030,31033,0,3,3
8874,3,1,31033,31033,31034,0,1,0
8875,2,1,31035,31035,31036,0,1,1
8876,4,1,31039,31039,31040,0,1,3
8877,4,1,31043,31043,31044,0,1,3
8878,4,3,31047,31047,31050,0,3,3
8879,3,1,31050,31050,31051,0,1,0
8880,1,2,31051,31051,31053,0,2,0
8881,5,2,31056,31056,31058,0,2,3
8882,6,2,31062,31062,31064,0,2,4
8883,3,2,31065,31065,31067,0,2,1
8884,2,1,31067,31067,31068,0,1,0
8885,6,1,31073,31073,31074,0,1,5
8886,4,3,31077,31077,31080,0,3,3
8887,3,2,31080,31080,31082,0,2,0
8888,4,1,31084,31084,31085,0,1,2
8889,4,2,31088,31088,31090,0,2,3
8890,6,2,31094,31094,31096,0,2,4
8891,1,3,31095,31096,31099,1,4,0
8892,5,3,31100,31100,31103,0,3,1
8893,1,3,31101,31103,31106,2,5,0
8894,1,3,31102,31106,31109,4,7,0
8895,4,1,31106,31109,31110,3,4,0
8896,1,1,31107,31110,31111,3,4,0
8897,2,3,31109,31111,31114,2,5,0
8898,3,2,31112,31114,31116,2,4,0
8899,6,1,31118,31118,31119,0,1,2
8900,4,2,31122,31122,31124,0,2,3
8901,1,1,31123,31124,31125,1,2,0
8902,1,1,31124,31125,31126,1,2,0
8903,4,3,31128,31128,31131,0,3,2
8904,5,3,31133,31133,31136,0,3,2
8905,1,2,31134,31136,31138,2,4,0
8906,3,3,31137,31138,31141,1,4,0
8907,5,3,31142,31142,31145,0,3,1
8908,5,3,31147,31147,31150,0,3,2
8909,1,3,31148,31150,31153,2,5,0
8910,1,1,31149,31153,31154,4,5,0
8911,1,2,31150,31154,31156,4,6,0
8912,3,2,31153,31156,31158,3,5,0
8913,6,3,31159,31159,31162,0,3,1
8914,1,2,31160,31162,31164,2,4,0
8915,1,3,31161,31164,31167,3,6,0
8916,2,2,31163,31167,31169,4,6,0
8917,6,3,31169,31169,31172,0,3,0
8918,1,2,31170,31172,31174,2,4,0
8919,5,3,31175,31175,31178,0,3,1
8920,5,2,31180,31180,31182,0,2,2
8921,4,2,31184,31184,31186,0,2,2
8922,2,3,31186,31186,31189,0,3,0
8923,4,1,31190,31190,31191,0,1,1
8924,5,2,31195,31195,31197,0,2,4
8925,4,1,31199,31199,31200,0,1,2
8926,1,2,31200,31200,31202,0,2,0
8927,5,2,31205,31205,31207,0,2,3
8928,1,1,31206,31207,31208,1,2,0
8929,4,3,31210,31210,31213,0,3,2
8930,4,1,31214,31214,31215,0,1,1
8931,4,1,31218,31218,31219,0,1,3
8932,6,1,31224,31224,31225,0,1,5
8933,3,2,31227,31227,31229,0,2,2
8934,4,3,31231,31231,31234,0,3,2
8935,5,3,31236,31236,31239,0,3,2
8936,4,2,31240,31240,31242,0,2,1
8937,1,3,31241,31242,31245,1,4,0
8938,6,1,31247,31247,31248,0,1,2
8939,1,2,31248,31248,31250,0,2,0
8940,5,3,31253,31253,31256,0,3,3
8941,3,3,31256,31256,31259,0,3,0
8942,1,2,31257,31259,31261,2,4,0
8943,4,3,31261,31261,31264,0,3,0
8944,6,2,31267,31267,31269,0,2,3
8945,2,2,31269,31269,31271,0,2,0
8946,3,2,31272,31272,31274,0,2,1
8947,6,1,31278,31278,31279,0,1,4
8948,3,2,31281,31281,31283,0,2,2
8949,3,2,31284,31284,31286,0,2,1
8950,4,3,31288,31288,31291,0,3,2
8951,1,1,31289,31291,31292,2,3,0
8952,6,3,31295,31295,31298,0,3,3
8953,5,3,31300,31300,31303,0,3,2
8954,3,3,31303,31303,31306,0,3,0
8955,3,2,31306,31306,31308,0,2,0
8956,6,2,31312,31312,31314,0,2,4
8957,1,3,31313,31314,31317,1,4,0
8958,3,2,31316,31317,31319,1,3,0
8959,4,2,31320,31320,31322,0,2,1
8960,1,3,31321,31322,31325,1,4,0
8961,3,2,31324,31325,31327,1,3,0
8962,2,3,31326,31327,31330,1,4,0
8963,1,1,31327,31330,31331,3,4,0
8964,5,2,31332,31332,31334,0,2,1
8965,5,2,31337,31337,31339,0,2,3
8966,2,3,31339,31339,31342,0,3,0
8967,5,3,31344,31344,31347,0,3,2
8968,2,1,31346,31347,31348,1,2,0
8969,5,3,31351,31351,31354,0,3,3
8970,3,1,31354,31354,31355,0,1,0
8971,6,2,31360,31360,31362,0,2,5
8972,4,2,31364,31364,31366,0,2,2
8973,4,3,31368,31368,31371,0,3,2
8974,6,2,31374,31374,31376,0,2,3
8975,2,1,31376,31376,31377,0,1,0
8976,2,1,31378,31378,31379,0,1,1
8977,1,2,31379,31379,31381,0,2,0
8978,1,2,31380,31381,31383,1,3,0
8979,4,1,31384,31384,31385,0,1,1
8980,1,1,31385,31385,31386,0,1,0
8981,4,2,31389,31389,31391,0,2,3
8982,3,3,31392,31392,31395,0,3,1
8983,4,1,31396,31396,31397,0,1,1
8984,5,1,31401,31401,31402,0,1,4
8985,2,2,31403,31403,31405,0,2,1
8986,4,2,31407,31407,31409,0,2,2
8987,3,3,31410,31410,31413,0,3,1
8988,6,2,31416,31416,31418,0,2,3
8989,3,2,31419,31419,31421,0,2,1
8990,1,3,31420,31421,31424,1,4,0
8991,3,3,31423,31424,31427,1,4,0
8992,3,3,31426,31427,31430,1,4,0
8993,5,1,31431,31431,31432,0,1,1
8994,1,3,31432,31432,31435,0,3,0
8995,3,3,31435,31435,31438,0,3,0
8996,6,2,31441,31441,31443,0,2,3
8997,1,3,31442,31443,31446,1,4,0
8998,1,1,31443,31446,31447,3,4,0
8999,1,2,31444,31447,31449,3,5,0
9000,6,2,31450,31450,31452,0,2,1
9001,6,3,31456,31456,31459,0,3,4
9002,3,3,31459,31459,31462,0,3,0
9003,2,2,31461,31462,31464,1,3,0
9004,4,2,31465,31465,31467,0,2,1
9005,3,3,31468,31468,31471,0,3,1
9006,1,1,31469,31471,31472,2,3,0
9007,2,1,31471,31472,31473,1,2,0
9008,1,3,31472,31473,31476,1,4,0
9009,5,2,31477,31477,31479,0,2,1
9010,1,3,31478,31479,31482,1,4,0
9011,6,3,31484,31484,31487,0,3,2
9012,5,3,31489,31489,31492,0,3,2
9013,5,1,31494,31494,31495,0,1,2
9014,3,3,31497,31497,31500,0,3,2
9015,4,2,31501,31501,31503,0,2,1
9016,5,1,31506,31506,31507,0,1,3
9017,3,3,31509,31509,31512,0,3,2
9018,6,1,31515,31515,31516,0,1,3
9019,3,3,31518,31518,31521,0,3,2
9020,4,3,31522,31522,31525,0,3,1
9021,2,3,31524,31525,31528,1,4,0
9022,2,2,31526,31528,31530,2,4,0
9023,6,2,31532,31532,31534,0,2,2
9024,5,3,31537,31537,31540,0,3,3
9025,2,3,31539,31540,31543,1,4,0
9026,1,3,31540,31543,31546,3,6,0
9027,5,1,31545,31546,31547,1,2,0
9028,6,2,31551,31551,31553,0,2,4
9029,2,1,31553,31553,31554,0,1,0
9030,2,1,31555,31555,31556,0,1,1
9031,3,2,31558,31558,31560,0,2,2
9032,1,2,31559,31560,31562,1,3,0
9033,3,3,31562,31562,31565,0,3,0
9034,4,3,31566,31566,31569,0,3,1
9035,4,2,31570,31570,31572,0,2,1
9036,5,3,31575,31575,31578,0,3,3
9037,3,1,31578,31578,31579,0,1,0
9038,1,3,31579,31579,31582,0,3,0
9039,1,1,31580,31582,31583,2,3,0
9040,5,2,31585,31585,31587,0,2,2
9041,1,1,31586,31587,31588,1,2,0
9042,6,2,31592,31592,31594,0,2,4
9043,4,3,31596,31596,31599,0,3,2
9044,5,1,31601,31601,31602,0,1,2
9045,4,2,31605,31605,31607,0,2,3
9046,1,2,31606,31607,31609,1,3,0
9047,2,2,31608,31609,31611,1,3,0
9048,6,3,31614,31614,31617,0,3,3
9049,1,1,31615,31617,31618,2,3,0
9050,5,3,31620,31620,31623,0,3,2
9051,1,2,31621,31623,31625,2,4,0
9052,6,2,31627,31627,31629,0,2,2
9053,2,3,31629,31629,31632,0,3,0
9054,3,3,31632,31632,31635,0,3,0
9055,6,1,31638,31638,31639,0,1,3
9056,2,3,31640,31640,31643,0,3,1
9057,1,3,31641,31643,31646,2,5,0
9058,2,3,31643,31646,31649,3,6,0
9059,4,2,31647,31649,31651,2,4,0
9060,3,2,31650,31651,31653,1,3,0
9061,3,2,31653,31653,31655,0,2,0
9062,2,2,31655,31655,31657,0,2,0
9063,1,2,31656,31657,31659,1,3,0
9064,4,3,31660,31660,31663,0,3,1
9065,6,2,31666,31666,31668,0,2,3
9066,6,1,31672,31672,31673,0,1,4
9067,5,3,31677,31677,31680,0,3,4
9068,3,3,31680,31680,31683,0,3,0
9069,2,3,31682,31683,31686,1,4,0
9070,3,2,31685,31686,31688,1,3,0
9071,6,2,31691,31691,31693,0,2,3
9072,6,1,31697,31697,31698,0,1,4
9073,1,2,31698,31698,31700,0,2,0
9074,2,3,31700,31700,31703,0,3,0
9075,4,3,31704,31704,31707,0,3,1
9076,1,2,31705,31707,31709,2,4,0
9077,5,2,31710,31710,31712,0,2,1
9078,4,1,31714,31714,31715,0,1,2
9079,6,2,31720,31720,31722,0,2,5
9080,2,3,31722,31722,31725,0,3,0
9081,1,1,31723,31725,31726,2,3,0
9082,4,2,31727,31727,31729,0,2,1
9083,3,1,31730,31730,31731,0,1,1
9084,4,3,31734,31734,31737,0,3,3
9085,6,3,31740,31740,31743,0,3,3
9086,2,2,31742,31743,31745,1,3,0
9087,2,2,31744,31745,31747,1,3,0
9088,2,2,31746,31747,31749,1,3,0
9089,4,3,31750,31750,31753,0,3,1
9090,1,1,31751,31753,31754,2,3,0
9091,2,2,31753,31754,31756,1,3,0
9092,3,1,31756,31756,31757,0,1,0
9093,6,2,31762,31762,31764,0,2,5
9094,2,2,31764,31764,31766,0,2,0
9095,1,2,31765,31766,31768,1,3,0
9096,4,3,31769,31769,31772,0,3,1
9097,6,2,31775,31775,31777,0,2,3
9098,2,3,31777,31777,31780,0,3,0
9099,4,1,31781,31781,31782,0,1,1
9100,1,1,31782,31782,31783,0,1,0
9101,2,1,31784,31784,31785,0,1,1
9102,2,3,31786,31786,31789,0,3,1
9103,5,1,31791,31791,31792,0,1,2
9104,3,3,31794,31794,31797,0,3,2
9105,4,3,31798,31798,31801,0,3,1
9106,1,2,31799,31801,31803,2,4,0
9107,1,1,31800,31803,31804,3,4,0
9108,3,2,31803,31804,31806,1,3,0
9109,1,1,31804,31806,31807,2,3,0
9110,5,1,31809,31809,31810,0,1,2
9111,5,1,31814,31814,31815,0,1,4
9112,6,1,31820,31820,31821,0,1,5
9113,6,3,31826,31826,31829,0,3,5
9114,4,3,31830,31830,31833,0,3,1
9115,3,2,31833,31833,31835,0,2,0
9116,2,2,31835,31835,31837,0,2,0
9117,2,3,31837,31837,31840,0,3,0
9118,4,2,31841,31841,31843,0,2,1
9119,5,3,31846,31846,31849,0,3,3
9120,2,3,31848,31849,31852,1,4,0
9121,1,3,31849,31852,31855,3,6,0
9122,6,3,31855,31855,31858,0,3,0
9123,5,3,31860,31860,31863,0,3,2
9124,2,3,31862,31863,31866,1,4,0
9125,4,2,31866,31866,31868,0,2,0
9126,3,1,31869,31869,31870,0,1,1
9127,1,1,31870,31870,31871,0,1,0
9128,3,2,31873,31873,31875,0,2,2
9129,6,2,31879,31879,31881,0,2,4
9130,3,2,31882,31882,31884,0,2,1
9131,3,2,31885,31885,31887,0,2,1
9132,3,2,31888,31888,31890,0,2,1
9133,1,3,31889,31890,31893,1,4,0
9134,1,2,31890,31893,31895,3,5,0
9135,5,1,31895,31895,31896,0,1,0
9136,3,1,31898,31898,31899,0,1,2
9137,5,3,31903,31903,31906,0,3,4
9138,5,1,31908,31908,31909,0,1,2
9139,3,2,31911,31911,31913,0,2,2
9140,6,2,31917,31917,31919,0,2,4
9141,4,1,31921,31921,31922,0,1,2
9142,1,3,31922,31922,31925,0,3,0
9143,6,1,31928,31928,31929,0,1,3
9144,2,1,31930,31930,31931,0,1,1
9145,5,2,31935,31935,31937,0,2,4
9146,5,1,31940,31940,31941,0,1,3
9147,5,2,31945,31945,31947,0,2,4
9148,1,3,31946,31947,31950,1,4,0
9149,1,3,31947,31950,31953,3,6,0
9150,1,3,31948,31953,31956,5,8,0
9151,3,3,31951,31956,31959,5,8,0
9152,6,2,31957,31959,31961,2,4,0
9153,6,2,31963,31963,31965,0,2,2
9154,4,1,31967,31967,31968,0,1,2
9155,5,1,31972,31972,31973,0,1,4
9156,4,3,31976,31976,31979,0,3,3
9157,5,2,31981,31981,31983,0,2,2
9158,4,1,31985,31985,31986,0,1,2
9159,4,3,31989,31989,31992,0,3,3
9160,4,2,31993,31993,31995,0,2,1
9161,5,2,31998,31998,32000,0,2,3
9162,4,1,32002,32002,32003,0,1,2
9163,2,3,32004,32004,32007,0,3,1
9164,1,2,32005,32007,32009,2,4,0
9165,6,2,32011,32011,32013,0,2,2
9166,1,2,32012,32013,32015,1,3,0
9167,3,2,32015,32015,32017,0,2,0
9168,3,3,32018,32018,32021,0,3,1
9169,2,1,32020,32021,32022,1,2,0
9170,4,3,32024,32024,32027,0,3,2
9171,6,2,32030,32030,32032,0,2,3
9172,6,3,32036,32036,32039,0,3,4
9173,6,1,32042,32042,32043,0,1,3
9174,2,2,32044,32044,32046,0,2,1
9175,6,2,32050,32050,32052,0,2,4
9176,6,2,32056,32056,32058,0,2,4
9177,1,1,32057,32058,32059,1,2,0
9178,3,1,32060,32060,32061,0,1,1
9179,5,1,32065,32065,32066,0,1,4
9180,6,1,32071,32071,32072,0,1,5
9181,4,1,32075,32075,32076,0,1,3
9182,5,1,32080,32080,32081,0,1,4
9183,2,3,32082,32082,32085,0,3,1
9184,6,2,32088,32088,32090,0,2,3
9185,1,2,32089,32090,32092,1,3,0
9186,6,2,32095,32095,32097,0,2,3
9187,6,3,32101,32101,32104,0,3,4
9188,3,3,32104,32104,32107,0,3,0
9189,2,2,32106,32107,32109,1,3,0
9190,3,1,32109,32109,32110,0,1,0
9191,6,3,32115,32115,32118,0,3,5
9192,1,1,32116,32118,32119,2,3,0
9193,3,3,32119,32119,32122,0,3,0
9194,2,1,32121,32122,32123,1,2,0
9195,1,2,32122,32123,32125,1,3,0
9196,6,2,32128,32128,32130,0,2,3
9197,5,3,32133,32133,32136,0,3,3
9198,2,2,32135,32136,32138,1,3,0
9199,1,3,32136,32138,32141,2,5,0
9200,2,2,32138,32141,32143,3,5,0
9201,1,3,32139,32143,32146,4,7,0
9202,6,3,32145,32146,32149,1,4,0
9203,6,3,32151,32151,32154,0,3,2
9204,3,1,32154,32154,32155,0,1,0
9205,2,2,32156,32156,32158,0,2,1
9206,5,2,32161,32161,32163,0,2,3
9207,4,3,32165,32165,32168,0,3,2
9208,4,1,32169,32169,32170,0,1,1
9209,6,1,32175,32175,32176,0,1,5
9210,1,3,32176,32176,32179,0,3,0
9211,3,1,32179,32179,32180,0,1,0
9212,5,1,32184,32184,32185,0,1,4
9213,2,3,32186,32186,32189,0,3,1
9214,2,1,32188,32189,32190,1,2,0
9215,4,3,32192,32192,32195,0,3,2
9216,3,3,32195,32195,32198,0,3,0
9217,5,2,32200,32200,32202,0,2,2
9218,6,3,32206,32206,32209,0,3,4
9219,5,3,32211,32211,32214,0,3,2
9220,1,1,32212,32214,32215,2,3,0
9221,6,1,32218,32218,32219,0,1,3
9222,5,1,32223,32223,32224,0,1,4
9223,6,2,32229,32229,32231,0,2,5
9224,2,2,32231,32231,32233,0,2,0
9225,2,2,32233,32233,32235,0,2,0
9226,4,1,32237,32237,32238,0,1,2
9227,1,1,32238,32238,32239,0,1,0
9228,6,1,32244,32244,32245,0,1,5
9229,6,3,32250,32250,32253,0,3,5
9230,4,2,32254,32254,32256,0,2,1
9231,4,3,32258,32258,32261,0,3,2
9232,5,2,32263,32263,32265,0,2,2
9233,4,2,32267,32267,32269,0,2,2
9234,2,3,32269,32269,32272,0,3,0
9235,4,1,32273,32273,32274,0,1,1
9236,4,1,32277,32277,32278,0,1,3
9237,6,1,32283,32283,32284,0,1,5
9238,5,1,32288,32288,32289,0,1,4
9239,5,1,32293,32293,32294,0,1,4
9240,4,1,32297,32297,32298,0,1,3
9241,4,3,32301,32301,32304,0,3,3
9242,2,2,32303,32304,32306,1,3,0
9243,1,3,32304,32306,32309,2,5,0
9244,5,3,32309,32309,32312,0,3,0
9245,4,3,32313,32313,32316,0,3,1
9246,3,3,32316,32316,32319,0,3,0
9247,5,1,32321,32321,32322,0,1,2
9248,5,3,32326,32326,32329,0,3,4
9249,2,1,32328,32329,32330,1,2,0
9250,6,3,32334,32334,32337,0,3,4
9251,6,3,32340,32340,32343,0,3,3
9252,1,1,32341,32343,32344,2,3,0
9253,6,2,32347,32347,32349,0,2,3
9254,2,1,32349,32349,32350,0,1,0
9255,4,1,32353,32353,32354,0,1,3
9256,2,1,32355,32355,32356,0,1,1
9257,5,2,32360,32360,32362,0,2,4
9258,5,2,32365,32365,32367,0,2,3
9259,2,3,32367,32367,32370,0,3,0
9260,3,3,32370,32370,32373,0,3,0
9261,3,1,32373,32373,32374,0,1,0
9262,2,3,32375,32375,32378,0,3,1
9263,3,3,32378,32378,32381,0,3,0
9264,5,3,32383,32383,32386,0,3,2
9265,5,2,32388,32388,32390,0,2,2
9266,5,1,32393,32393,32394,0,1,3
9267,3,3,32396,32396,32399,0,3,2
9268,4,2,32400,32400,32402,0,2,1
9269,4,2,32404,32404,32406,0,2,2
9270,4,1,32408,32408,32409,0,1,2
9271,4,2,32412,32412,32414,0,2,3
9272,1,3,32413,32414,32417,1,4,0
9273,3,3,32416,32417,32420,1,4,0
9274,2,2,32418,32420,32422,2,4,0
9275,2,1,32420,32422,32423,2,3,0
9276,4,1,32424,32424,32425,0,1,1
9277,6,2,32430,32430,32432,0,2,5
9278,6,3,32436,32436,32439,0,3,4
9279,4,1,32440,32440,32441,0,1,1
9280,2,1,32442,32442,32443,0,1,1
9281,3,2,32445,32445,32447,0,2,2
9282,5,1,32450,32450,32451,0,1,3
9283,3,2,32453,32453,32455,0,2,2
9284,2,3,32455,32455,32458,0,3,0
9285,5,1,32460,32460,32461,0,1,2
9286,3,1,32463,32463,32464,0,1,2
9287,3,2,32466,32466,32468,0,2,2
9288,6,3,32472,32472,32475,0,3,4
9289,4,2,32476,32476,32478,0,2,1
9290,3,1,32479,32479,32480,0,1,1
9291,6,3,32485,32485,32488,0,3,5
9292,6,1,32491,32491,32492,0,1,3
9293,3,2,32494,32494,32496,0,2,2
9294,2,3,32496,32496,32499,0,3,0
9295,5,1,32501,32501,32502,0,1,2
9296,2,2,32503,32503,32505,0,2,1
9297,5,2,32508,32508,32510,0,2,3
9298,3,2,32511,32511,32513,0,2,1
9299,3,1,32514,32514,32515,0,1,1
9300,3,3,32517,32517,32520,0,3,2
9301,3,2,32520,32520,32522,0,2,0
9302,6,1,32526,32526,32527,0,1,4
9303,1,2,32527,32527,32529,0,2,0
9304,2,1,32529,32529,32530,0,1,0
9305,4,2,32533,32533,32535,0,2,3
9306,3,1,32536,32536,32537,0,1,1
9307,5,3,32541,32541,32544,0,3,4
9308,3,2,32544,32544,32546,0,2,0
9309,5,3,32549,32549,32552,0,3,3
9310,2,2,32551,32552,32554,1,3,0
9311,4,1,32555,32555,32556,0,1,1
9312,1,3,32556,32556,32559,0,3,0
9313,1,1,32557,32559,32560,2,3,0
9314,2,3,32559,32560,32563,1,4,0
9315,6,2,32565,32565,32567,0,2,2
9316,1,2,32566,32567,32569,1,3,0
9317,1,2,32567,32569,32571,2,4,0
9318,5,3,32572,32572,32575,0,3,1
9319,2,2,32574,32575,32577,1,3,0
9320,4,3,32578,32578,32581,0,3,1
9321,5,1,32583,32583,32584,0,1,2
9322,6,1,32589,32589,32590,0,1,5
9323,3,2,32592,32592,32594,0,2,2
9324,2,2,32594,32594,32596,0,2,0
9325,4,3,32598,32598,32601,0,3,2
9326,1,2,32599,32601,32603,2,4,0
9327,5,3,32604,32604,32607,0,3,1
9328,6,2,32610,32610,32612,0,2,3
9329,6,1,32616,32616,32617,0,1,4
9330,2,3,32618,32618,32621,0,3,1
9331,1,3,32619,32621,32624,2,5,0
9332,5,1,32624,32624,32625,0,1,0
9333,3,3,32627,32627,32630,0,3,2
9334,1,1,32628,32630,32631,2,3,0
9335,1,2,32629,32631,32633,2,4,0
9336,2,3,32631,32633,32636,2,5,0
9337,1,1,32632,32636,32637,4,5,0
9338,5,2,32637,32637,32639,0,2,0
9339,1,2,32638,32639,32641,1,3,0
9340,1,3,32639,32641,32644,2,5,0
9341,2,3,32641,32644,32647,3,6,0
9342,4,2,32645,32647,32649,2,4,0
9343,1,2,32646,32649,32651,3,5,0
9344,2,1,32648,32651,32652,3,4,0
9345,1,2,32649,32652,32654,3,5,0
9346,4,3,32653,32654,32657,1,4,0
9347,3,1,32656,32657,32658,1,2,0
9348,6,1,32662,32662,32663,0,1,4
9349,4,1,32666,32666,32667,0,1,3
9350,1,3,32667,32667,32670,0,3,0
9351,5,3,32672,32672,32675,0,3,2
9352,4,3,32676,32676,32679,0,3,1
9353,6,3,32682,32682,32685,0,3,3
9354,3,3,32685,32685,32688,0,3,0
9355,4,3,32689,32689,32692,0,3,1
9356,1,2,32690,32692,32694,2,4,0
9357,1,2,32691,32694,32696,3,5,0
9358,5,1,32696,32696,32697,0,1,0
9359,5,1,32701,32701,32702,0,1,4
9360,2,3,32703,32703,32706,0,3,1
9361,1,2,32704,32706,32708,2,4,0
9362,2,2,32706,32708,32710,2,4,0
9363,3,2,32709,32710,32712,1,3,0
9364,2,3,32711,32712,32715,1,4,0
9365,5,3,32716,32716,32719,0,3,1
9366,5,3,32721,32721,32724,0,3,2
9367,6,1,32727,32727,32728,0,1,3
9368,1,1,32728,32728,32729,0,1,0
9369,6,3,32734,32734,32737,0,3,5
9370,4,1,32738,32738,32739,0,1,1
9371,1,3,32739,32739,32742,0,3,0
9372,6,2,32745,32745,32747,0,2,3
9373,3,1,32748,32748,32749,0,1,1
9374,6,3,32754,32754,32757,0,3,5
9375,1,1,32755,32757,32758,2,3,0
9376,6,2,32761,32761,32763,0,2,3
9377,4,1,32765,32765,32766,0,1,2
9378,1,2,32766,32766,32768,0,2,0
9379,3,1,32769,32769,32770,0,1,1
9380,2,1,32771,32771,32772,0,1,1
9381,3,2,32774,32774,32776,0,2,2
9382,6,1,32780,32780,32781,0,1,4
9383,6,3,32786,32786,32789,0,3,5
9384,3,1,32789,32789,32790,0,1,0
9385,3,3,32792,32792,32795,0,3,2
9386,1,1,32793,32795,32796,2,3,0
9387,4,1,32797,32797,32798,0,1,1
9388,6,2,32803,32803,32805,0,2,5
9389,6,2,32809,32809,32811,0,2,4
9390,1,2,32810,32811,32813,1,3,0
9391,5,3,32815,32815,32818,0,3,2
9392,1,2,32816,32818,32820,2,4,0
9393,5,3,32821,32821,32824,0,3,1
9394,4,3,32825,32825,32828,0,3,1
9395,4,3,32829,32829,32832,0,3,1
9396,4,2,32833,32833,32835,0,2,1
9397,3,3,32836,32836,32839,0,3,1
9398,3,2,32839,32839,32841,0,2,0
9399,1,2,32840,32841,32843,1,3,0
9400,2,2,32842,32843,32845,1,3,0
9401,5,1,32847,32847,32848,0,1,2
9402,2,3,32849,32849,32852,0,3,1
9403,5,3,32854,32854,32857,0,3,2
9404,3,3,32857,32857,32860,0,3,0
9405,4,2,32861,32861,32863,0,2,1
9406,5,1,32866,32866,32867,0,1,3
9407,4,2,32870,32870,32872,0,2,3
9408,1,1,32871,32872,32873,1,2,0
9409,2,3,32873,32873,32876,0,3,0
9410,4,3,32877,32877,32880,0,3,1
9411,6,3,32883,32883,32886,0,3,3
9412,5,3,32888,32888,32891,0,3,2
9413,5,2,32893,32893,32895,0,2,2
9414,3,3,32896,32896,32899,0,3,1
9415,2,1,32898,32899,32900,1,2,0
9416,3,1,32901,32901,32902,0,1,1
9417,3,2,32904,32904,32906,0,2,2
9418,4,2,32908,32908,32910,0,2,2
9419,5,1,32913,32913,32914,0,1,3
9420,3,3,32916,32916,32919,0,3,2
9421,2,2,32918,32919,32921,1,3,0
9422,6,3,32924,32924,32927,0,3,3
9423,4,2,32928,32928,32930,0,2,1
9424,2,2,32930,32930,32932,0,2,0
9425,4,2,32934,32934,32936,0,2,2
9426,2,3,32936,32936,32939,0,3,0
9427,5,3,32941,32941,32944,0,3,2
9428,2,1,32943,32944,32945,1,2,0
9429,3,3,32946,32946,32949,0,3,1
9430,3,2,32949,32949,32951,0,2,0
9431,3,2,32952,32952,32954,0,2,1
9432,6,2,32958,32958,32960,0,2,4
9433,2,2,32960,32960,32962,0,2,0
9434,2,1,32962,32962,32963,0,1,0
9435,3,1,32965,32965,32966,0,1,2
9436,4,2,32969,32969,32971,0,2,3
9437,4,3,32973,32973,32976,0,3,2
9438,6,1,32979,32979,32980,0,1,3
9439,6,2,32985,32985,32987,0,2,5
9440,6,3,32991,32991,32994,0,3,4
9441,6,3,32997,32997,33000,0,3,3
9442,2,2,32999,33000,33002,1,3,0
9443,1,2,33000,33002,33004,2,4,0
9444,3,2,33003,33004,33006,1,3,0
9445,4,3,33007,33007,33010,0,3,1
9446,5,2,33012,33012,33014,0,2,2
9447,6,1,33018,33018,33019,0,1,4
9448,1,2,33019,33019,33021,0,2,0
9449,4,1,33023,33023,33024,0,1,2
9450,4,3,33027,33027,33030,0,3,3
9451,3,1,33030,33030,33031,0,1,0
9452,5,1,33035,33035,33036,0,1,4
9453,2,3,33037,33037,33040,0,3,1
9454,6,2,33043,33043,33045,0,2,3
9455,3,2,33046,33046,33048,0,2,1
9456,1,2,33047,33048,33050,1,3,0
9457,1,2,33048,33050,33052,2,4,0
9458,5,3,33053,33053,33056,0,3,1
9459,3,1,33056,33056,33057,0,1,0
9460,2,2,33058,33058,33060,0,2,1
9461,3,3,33061,33061,33064,0,3,1
9462,3,1,33064,33064,33065,0,1,0
9463,1,3,33065,33065,33068,0,3,0
9464,3,3,33068,33068,33071,0,3,0
9465,5,3,33073,33073,33076,0,3,2
9466,1,1,33074,33076,33077,2,3,0
9467,2,1,33076,33077,33078,1,2,0
9468,5,3,33081,33081,33084,0,3,3
9469,2,1,33083,33084,33085,1,2,0
9470,2,1,33085,33085,33086,0,1,0
9471,1,2,33086,33086,33088,0,2,0
9472,2,1,33088,33088,33089,0,1,0
9473,1,3,33089,33089,33092,0,3,0
9474,3,3,33092,33092,33095,0,3,0
9475,2,2,33094,33095,33097,1,3,0
9476,3,1,33097,33097,33098,0,1,0
9477,4,3,33101,33101,33104,0,3,3
9478,5,1,33106,33106,33107,0,1,2
9479,4,3,33110,33110,33113,0,3,3
9480,6,3,33116,33116,33119,0,3,3
9481,3,3,33119,33119,33122,0,3,0
9482,3,1,33122,33122,33123,0,1,0
9483,5,3,33127,33127,33130,0,3,4
9484,1,2,33128,33130,33132,2,4,0
9485,5,2,33133,33133,33135,0,2,1
9486,4,3,33137,33137,33140,0,3,2
9487,6,1,33143,33143,33144,0,1,3
9488,6,1,33149,33149,33150,0,1,5
9489,3,2,33152,33152,33154,0,2,2
9490,2,3,33154,33154,33157,0,3,0
9491,3,2,33157,33157,33159,0,2,0
9492,1,1,33158,33159,33160,1,2,0
9493,4,2,33162,33162,33164,0,2,2
9494,4,1,33166,33166,33167,0,1,2
9495,3,1,33169,33169,33170,0,1,2
9496,5,1,33174,33174,33175,0,1,4
9497,3,2,33177,33177,33179,0,2,2
9498,1,1,33178,33179,33180,1,2,0
9499,4,1,33182,33182,33183,0,1,2
9500,2,1,33184,33184,33185,0,1,1
9501,4,3,33188,33188,33191,0,3,3
9502,3,1,33191,33191,33192,0,1,0
9503,2,2,33193,33193,33195,0,2,1
9504,2,1,33195,33195,33196,0,1,0
9505,3,3,33198,33198,33201,0,3,2
9506,3,3,33201,33201,33204,0,3,0
9507,2,3,33203,33204,33207,1,4,0
9508,4,2,33207,33207,33209,0,2,0
9509,3,3,33210,33210,33213,0,3,1
9510,5,3,33215,33215,33218,0,3,2
9511,2,2,33217,33218,33220,1,3,0
9512,5,2,33222,33222,33224,0,2,2
9513,3,3,33225,33225,33228,0,3,1
9514,4,2,33229,33229,33231,0,2,1
9515,5,1,33234,33234,33235,0,1,3
9516,5,3,33239,33239,33242,0,3,4
9517,1,1,33240,33242,33243,2,3,0
9518,3,2,33243,33243,33245,0,2,0
9519,3,2,33246,33246,33248,0,2,1
9520,3,1,33249,33249,33250,0,1,1
9521,5,1,33254,33254,33255,0,1,4
9522,6,2,33260,33260,33262,0,2,5
9523,3,2,33263,33263,33265,0,2,1
9524,6,2,33269,33269,33271,0,2,4
9525,1,3,33270,33271,33274,1,4,0
9526,5,3,33275,33275,33278,0,3,1
9527,3,2,33278,33278,33280,0,2,0
9528,4,3,33282,33282,33285,0,3,2
9529,2,3,33284,33285,33288,1,4,0
9530,3,2,33287,33288,33290,1,3,0
9531,1,2,33288,33290,33292,2,4,0
9532,1,2,33289,33292,33294,3,5,0
9533,4,2,33293,33294,33296,1,3,0
9534,3,2,33296,33296,33298,0,2,0
9535,5,3,33301,33301,33304,0,3,3
9536,6,2,33307,33307,33309,0,2,3
9537,5,1,33312,33312,33313,0,1,3
9538,4,2,33316,33316,33318,0,2,3
9539,3,2,33319,33319,33321,0,2,1
9540,4,2,33323,33323,33325,0,2,2
9541,6,3,33329,33329,33332,0,3,4
9542,2,3,33331,33332,33335,1,4,0
9543,3,3,33334,33335,33338,1,4,0
9544,4,1,33338,33338,33339,0,1,0
9545,6,2,33344,33344,33346,0,2,5
9546,1,3,33345,33346,33349,1,4,0
9547,2,2,33347,33349,33351,2,4,0
9548,3,2,33350,33351,33353,1,3,0
9549,4,1,33354,33354,33355,0,1,1
9550,2,2,33356,33356,33358,0,2,1
9551,4,2,33360,33360,33362,0,2,2
9552,6,1,33366,33366,33367,0,1,4
9553,5,3,33371,33371,33374,0,3,4
9554,1,2,33372,33374,33376,2,4,0
9555,3,3,33375,33376,33379,1,4,0
9556,4,2,33379,33379,33381,0,2,0
9557,2,3,33381,33381,33384,0,3,0
9558,5,1,33386,33386,33387,0,1,2
9559,3,3,33389,33389,33392,0,3,2
9560,1,2,33390,33392,33394,2,4,0
9561,4,3,33394,33394,33397,0,3,0
9562,6,1,33400,33400,33401,0,1,3
9563,5,3,33405,33405,33408,0,3,4
9564,5,3,33410,33410,33413,0,3,2
9565,1,2,33411,33413,33415,2,4,0
9566,4,1,33415,33415,33416,0,1,0
9567,2,2,33417,33417,33419,0,2,1
9568,5,3,33422,33422,33425,0,3,3
9569,4,1,33426,33426,33427,0,1,1
9570,5,3,33431,33431,33434,0,3,4
9571,4,3,33435,33435,33438,0,3,1
9572,3,2,33438,33438,33440,0,2,0
9573,2,3,33440,33440,33443,0,3,0
9574,3,2,33443,33443,33445,0,2,0
9575,4,1,33447,33447,33448,0,1,2
9576,2,1,33449,33449,33450,0,1,1
9577,6,2,33455,33455,33457,0,2,5
9578,3,3,33458,33458,33461,0,3,1
9579,1,1,33459,33461,33462,2,3,0
9580,6,2,33465,33465,33467,0,2,3
9581,5,1,33470,33470,33471,0,1,3
9582,1,1,33471,33471,33472,0,1,0
9583,3,1,33474,33474,33475,0,1,2
9584,3,2,33477,33477,33479,0,2,2
9585,2,2,33479,33479,33481,0,2,0
9586,4,1,33483,33483,33484,0,1,2
9587,4,3,33487,33487,33490,0,3,3
9588,5,3,33492,33492,33495,0,3,2
9589,1,1,33493,33495,33496,2,3,0
9590,6,2,33499,33499,33501,0,2,3
9591,3,3,33502,33502,33505,0,3,1
9592,3,2,33505,33505,33507,0,2,0
9593,1,2,33506,33507,33509,1,3,0
9594,3,1,33509,33509,33510,0,1,0
9595,3,2,33512,33512,33514,0,2,2
9596,6,3,33518,33518,33521,0,3,4
9597,4,2,33522,33522,33524,0,2,1
9598,1,2,33523,33524,33526,1,3,0
9599,3,1,33526,33526,33527,0,1,0
9600,4,3,33530,33530,33533,0,3,3
9601,1,1,33531,33533,33534,2,3,0
9602,5,1,33536,33536,33537,0,1,2
9603,3,2,33539,33539,33541,0,2,2
9604,1,2,33540,33541,33543,1,3,0
9605,4,3,33544,33544,33547,0,3,1
9606,5,3,33549,33549,33552,0,3,2
9607,1,2,33550,33552,33554,2,4,0
9608,5,1,33555,33555,33556,0,1,1
9609,6,1,33561,33561,33562,0,1,5
9610,4,2,33565,33565,33567,0,2,3
9611,3,1,33568,33568,33569,0,1,1
9612,6,2,33574,33574,33576,0,2,5
9613,4,2,33578,33578,33580,0,2,2
9614,1,1,33579,33580,33581,1,2,0
9615,4,1,33583,33583,33584,0,1,2
9616,2,1,33585,33585,33586,0,1,1
9617,1,3,33586,33586,33589,0,3,0
9618,3,2,33589,33589,33591,0,2,0
9619,1,1,33590,33591,33592,1,2,0
9620,3,1,33593,33593,33594,0,1,1
9621,5,1,33598,33598,33599,0,1,4
9622,6,3,33604,33604,33607,0,3,5
9623,1,1,33605,33607,33608,2,3,0
9624,4,3,33609,33609,33612,0,3,1
9625,1,1,33610,33612,33613,2,3,0
9626,5,1,33615,33615,33616,0,1,2
9627,3,2,33618,33618,33620,0,2,2
9628,4,2,33622,33622,33624,0,2,2
9629,3,2,33625,33625,33627,0,2,1
9630,5,1,33630,33630,33631,0,1,3
9631,5,2,33635,33635,33637,0,2,4
9632,6,3,33641,33641,33644,0,3,4
9633,1,2,33642,33644,33646,2,4,0
9634,6,1,33648,33648,33649,0,1,2
9635,4,1,33652,33652,33653,0,1,3
9636,2,3,33654,33654,33657,0,3,1
9637,4,3,33658,33658,33661,0,3,1
9638,3,3,33661,33661,33664,0,3,0
9639,6,2,33667,33667,33669,0,2,3
9640,5,2,33672,33672,33674,0,2,3
9641,5,1,33677,33677,33678,0,1,3
9642,4,2,33681,33681,33683,0,2,3
9643,3,1,33684,33684,33685,0,1,1
9644,1,1,33685,33685,33686,0,1,0
9645,5,1,33690,33690,33691,0,1,4
9646,1,1,33691,33691,33692,0,1,0
9647,5,1,33696,33696,33697,0,1,4
9648,2,3,33698,33698,33701,0,3,1
9649,2,2,33700,33701,33703,1,3,0
9650,3,2,33703,33703,33705,0,2,0
9651,2,1,33705,33705,33706,0,1,0
9652,2,3,33707,33707,33710,0,3,1
9653,4,1,33711,33711,33712,0,1,1
9654,2,1,33713,33713,33714,0,1,1
9655,2,1,33715,33715,33716,0,1,1
9656,6,2,33721,33721,33723,0,2,5
9657,4,3,33725,33725,33728,0,3,2
9658,3,3,33728,33728,33731,0,3,0
9659,1,2,33729,33731,33733,2,4,0
9660,2,2,33731,33733,33735,2,4,0
9661,2,1,33733,33735,33736,2,3,0
9662,1,2,33734,33736,33738,2,4,0
9663,6,2,33740,33740,33742,0,2,2
9664,2,3,33742,33742,33745,0,3,0
9665,1,2,33743,33745,33747,2,4,0
9666,6,2,33749,33749,33751,0,2,2
9667,1,2,33750,33751,33753,1,3,0
9668,5,3,33755,33755,33758,0,3,2
9669,2,3,33757,33758,33761,1,4,0
9670,4,2,33761,33761,33763,0,2,0
9671,2,1,33763,33763,33764,0,1,0
9672,3,3,33766,33766,33769,0,3,2
9673,2,1,33768,33769,33770,1,2,0
9674,3,2,33771,33771,33773,0,2,1
9675,1,3,33772,33773,33776,1,4,0
9676,3,3,33775,33776,33779,1,4,0
9677,3,2,33778,33779,33781,1,3,0
9678,1,3,33779,33781,33784,2,5,0
9679,3,1,33782,33784,33785,2,3,0
9680,1,2,33783,33785,33787,2,4,0
9681,3,2,33786,33787,33789,1,3,0
9682,1,3,33787,33789,33792,2,5,0
9683,5,2,33792,33792,33794,0,2,0
9684,5,2,33797,33797,33799,0,2,3
9685,3,1,33800,33800,33801,0,1,1
9686,6,2,33806,33806,33808,0,2,5
9687,1,3,33807,33808,33811,1,4,0
9688,1,3,33808,33811,33814,3,6,0
9689,4,3,33812,33814,33817,2,5,0
9690,6,3,33818,33818,33821,0,3,1
9691,1,3,33819,33821,33824,2,5,0
9692,2,1,33821,33824,33825,3,4,0
9693,3,1,33824,33825,33826,1,2,0
9694,4,2,33828,33828,33830,0,2,2
9695,3,2,33831,33831,33833,0,2,1
9696,5,1,33836,33836,33837,0,1,3
9697,2,2,33838,33838,33840,0,2,1
9698,2,3,33840,33840,33843,0,3,0
9699,6,2,33846,33846,33848,0,2,3
9700,4,1,33850,33850,33851,0,1,2
9701,2,1,33852,33852,33853,0,1,1
9702,3,3,33855,33855,33858,0,3,2
9703,5,3,33860,33860,33863,0,3,2
9704,6,2,33866,33866,33868,0,2,3
9705,3,3,33869,33869,33872,0,3,1
9706,1,3,33870,33872,33875,2,5,0
9707,2,1,33872,33875,33876,3,4,0
9708,5,1,33877,33877,33878,0,1,1
9709,2,3,33879,33879,33882,0,3,1
9710,2,1,33881,33882,33883,1,2,0
9711,6,2,33887,33887,33889,0,2,4
9712,6,1,33893,33893,33894,0,1,4
9713,3,2,33896,33896,33898,0,2,2
9714,5,3,33901,33901,33904,0,3,3
9715,2,2,33903,33904,33906,1,3,0
9716,3,3,33906,33906,33909,0,3,0
9717,5,1,33911,33911,33912,0,1,2
9718,2,3,33913,33913,33916,0,3,1
9719,2,2,33915,33916,33918,1,3,0
9720,1,2,33916,33918,33920,2,4,0
9721,5,3,33921,33921,33924,0,3,1
9722,1,1,33922,33924,33925,2,3,0
9723,3,1,33925,33925,33926,0,1,0
9724,3,3,33928,33928,33931,0,3,2
9725,5,3,33933,33933,33936,0,3,2
9726,4,2,33937,33937,33939,0,2,1
9727,5,1,33942,33942,33943,0,1,3
9728,1,3,33943,33943,33946,0,3,0
9729,4,3,33947,33947,33950,0,3,1
9730,4,3,33951,33951,33954,0,3,1
9731,1,1,33952,33954,33955,2,3,0
9732,4,3,33956,33956,33959,0,3,1
9733,1,1,33957,33959,33960,2,3,0
9734,1,3,33958,33960,33963,2,5,0
9735,4,3,33962,33963,33966,1,4,0
9736,1,3,33963,33966,33969,3,6,0
9737,1,3,33964,33969,33972,5,8,0
9738,5,1,33969,33972,33973,3,4,0
9739,3,1,33972,33973,33974,1,2,0
9740,1,3,33973,33974,33977,1,4,0
9741,2,2,33975,33977,33979,2,4,0
9742,6,1,33981,33981,33982,0,1,2
9743,5,3,33986,33986,33989,0,3,4
9744,3,3,33989,33989,33992,0,3,0
9745,5,3,33994,33994,33997,0,3,2
9746,3,1,33997,33997,33998,0,1,0
9747,2,3,33999,33999,34002,0,3,1
9748,4,3,34003,34003,34006,0,3,1
9749,5,3,34008,34008,34011,0,3,2
9750,3,2,34011,34011,34013,0,2,0
9751,5,1,34016,34016,34017,0,1,3
9752,5,3,34021,34021,34024,0,3,4
9753,5,2,34026,34026,34028,0,2,2
9754,3,1,34029,34029,34030,0,1,1
9755,2,3,34031,34031,34034,0,3,1
9756,1,3,34032,34034,34037,2,5,0
9757,5,3,34037,34037,34040,0,3,0
9758,5,2,34042,34042,34044,0,2,2
9759,3,2,34045,34045,34047,0,2,1
9760,2,1,34047,34047,34048,0,1,0
9761,3,3,34050,34050,34053,0,3,2
9762,4,3,34054,34054,34057,0,3,1
9763,6,1,34060,34060,34061,0,1,3
9764,5,3,34065,34065,34068,0,3,4
9765,1,3,34066,34068,34071,2,5,0
9766,1,2,34067,34071,34073,4,6,0
9767,5,3,34072,34073,34076,1,4,0
9768,6,3,34078,34078,34081,0,3,2
9769,3,2,34081,34081,34083,0,2,0
9770,1,2,34082,34083,34085,1,3,0
9771,4,1,34086,34086,34087,0,1,1
9772,4,2,34090,34090,34092,0,2,3
9773,3,3,34093,34093,34096,0,3,1
9774,4,2,34097,34097,34099,0,2,1
9775,3,1,34100,34100,34101,0,1,1
9776,6,1,34106,34106,34107,0,1,5
9777,4,1,34110,34110,34111,0,1,3
9778,1,3,34111,34111,34114,0,3,0
9779,3,2,34114,34114,34116,0,2,0
9780,2,1,34116,34116,34117,0,1,0
9781,5,3,34121,34121,34124,0,3,4
9782,5,3,34126,34126,34129,0,3,2
9783,2,1,34128,34129,34130,1,2,0
9784,6,3,34134,34134,34137,0,3,4
9785,2,1,34136,34137,34138,1,2,0
9786,3,3,34139,34139,34142,0,3,1
9787,5,1,34144,34144,34145,0,1,2
9788,1,1,34145,34145,34146,0,1,0
9789,1,2,34146,34146,34148,0,2,0
9790,1,2,34147,34148,34150,1,3,0
9791,1,2,34148,34150,34152,2,4,0
9792,4,2,34152,34152,34154,0,2,0
9793,4,2,34156,34156,34158,0,2,2
9794,2,2,34158,34158,34160,0,2,0
9795,6,2,34164,34164,34166,0,2,4
9796,1,3,34165,34166,34169,1,4,0
9797,1,3,34166,34169,34172,3,6,0
9798,3,3,34169,34172,34175,3,6,0
9799,3,2,34172,34175,34177,3,5,0
9800,6,1,34178,34178,34179,0,1,1
9801,5,1,34183,34183,34184,0,1,4
9802,1,1,34184,34184,34185,0,1,0
9803,2,3,34186,34186,34189,0,3,1
9804,2,3,34188,34189,34192,1,4,0
9805,4,1,34192,34192,34193,0,1,0
9806,5,1,34197,34197,34198,0,1,4
9807,5,2,34202,34202,34204,0,2,4
9808,2,3,34204,34204,34207,0,3,0
9809,1,2,34205,34207,34209,2,4,0
9810,5,2,34210,34210,34212,0,2,1
9811,6,3,34216,34216,34219,0,3,4
9812,3,2,34219,34219,34221,0,2,0
9813,6,2,34225,34225,34227,0,2,4
9814,3,1,34228,34228,34229,0,1,1
9815,5,1,34233,34233,34234,0,1,4
9816,3,3,34236,34236,34239,0,3,2
9817,6,1,34242,34242,34243,0,1,3
9818,2,1,34244,34244,34245,0,1,1
9819,4,3,34248,34248,34251,0,3,3
9820,2,1,34250,34251,34252,1,2,0
9821,5,2,34255,34255,34257,0,2,3
9822,1,1,34256,34257,34258,1,2,0
9823,1,1,34257,34258,34259,1,2,0
9824,4,2,34261,34261,34263,0,2,2
9825,2,1,34263,34263,34264,0,1,0
9826,4,3,34267,34267,34270,0,3,3
9827,6,2,34273,34273,34275,0,2,3
9828,4,3,34277,34277,34280,0,3,2
9829,6,3,34283,34283,34286,0,3,3
9830,2,1,34285,34286,34287,1,2,0
9831,4,3,34289,34289,34292,0,3,2
9832,1,2,34290,34292,34294,2,4,0
9833,2,3,34292,34294,34297,2,5,0
9834,1,1,34293,34297,34298,4,5,0
9835,4,1,34297,34298,34299,1,2,0
9836,1,2,34298,34299,34301,1,3,0
9837,4,2,34302,34302,34304,0,2,1
9838,1,3,34303,34304,34307,1,4,0
9839,2,2,34305,34307,34309,2,4,0
9840,6,2,34311,34311,34313,0,2,2
9841,6,3,34317,34317,34320,0,3,4
9842,6,3,34323,34323,34326,0,3,3
9843,6,2,34329,34329,34331,0,2,3
9844,2,3,34331,34331,34334,0,3,0
9845,1,2,34332,34334,34336,2,4,0
9846,1,2,34333,34336,34338,3,5,0
9847,3,1,34336,34338,34339,2,3,0
9848,3,3,34339,34339,34342,0,3,0
9849,6,3,34345,34345,34348,0,3,3
9850,3,3,34348,34348,34351,0,3,0
9851,2,1,34350,34351,34352,1,2,0
9852,6,3,34356,34356,34359,0,3,4
9853,2,2,34358,34359,34361,1,3,0
9854,3,2,34361,34361,34363,0,2,0
9855,1,2,34362,34363,34365,1,3,0
9856,5,3,34367,34367,34370,0,3,2
9857,2,1,34369,34370,34371,1,2,0
9858,1,1,34370,34371,34372,1,2,0
9859,4,2,34374,34374,34376,0,2,2
9860,5,3,34379,34379,34382,0,3,3
9861,3,1,34382,34382,34383,0,1,0
9862,5,3,34387,34387,34390,0,3,4
9863,3,2,34390,34390,34392,0,2,0
9864,2,1,34392,34392,34393,0,1,0
9865,6,3,34398,34398,34401,0,3,5
9866,4,2,34402,34402,34404,0,2,1
9867,6,2,34408,34408,34410,0,2,4
9868,3,3,34411,34411,34414,0,3,1
9869,4,1,34415,34415,34416,0,1,1
9870,5,1,34420,34420,34421,0,1,4
9871,5,1,34425,34425,34426,0,1,4
9872,6,3,34431,34431,34434,0,3,5
9873,2,3,34433,34434,34437,1,4,0
9874,5,3,34438,34438,34441,0,3,1
9875,1,2,34439,34441,34443,2,4,0
9876,6,3,34445,34445,34448,0,3,2
9877,2,2,34447,34448,34450,1,3,0
9878,6,1,34453,34453,34454,0,1,3
9879,3,1,34456,34456,34457,0,1,2
9880,2,2,34458,34458,34460,0,2,1
9881,6,1,34464,34464,34465,0,1,4
9882,3,2,34467,34467,34469,0,2,2
9883,3,2,34470,34470,34472,0,2,1
9884,6,2,34476,34476,34478,0,2,4
9885,2,1,34478,34478,34479,0,1,0
9886,5,2,34483,34483,34485,0,2,4
9887,1,1,34484,34485,34486,1,2,0
9888,1,3,34485,34486,34489,1,4,0
9889,6,1,34491,34491,34492,0,1,2
9890,6,2,34497,34497,34499,0,2,5
9891,5,3,34502,34502,34505,0,3,3
9892,6,1,34508,34508,34509,0,1,3
9893,6,3,34514,34514,34517,0,3,5
9894,2,3,34516,34517,34520,1,4,0
9895,5,3,34521,34521,34524,0,3,1
9896,4,2,34525,34525,34527,0,2,1
9897,6,2,34531,34531,34533,0,2,4
9898,2,2,34533,34533,34535,0,2,0
9899,1,3,34534,34535,34538,1,4,0
9900,6,2,34540,34540,34542,0,2,2
9901,4,2,34544,34544,34546,0,2,2
9902,4,1,34548,34548,34549,0,1,2
9903,2,2,34550,34550,34552,0,2,1
9904,4,3,34554,34554,34557,0,3,2
9905,3,3,34557,34557,34560,0,3,0
9906,6,3,34563,34563,34566,0,3,3
9907,6,2,34569,34569,34571,0,2,3
9908,6,2,34575,34575,34577,0,2,4
9909,5,2,34580,34580,34582,0,2,3
9910,6,2,34586,34586,34588,0,2,4
9911,2,2,34588,34588,34590,0,2,0
9912,2,3,34590,34590,34593,0,3,0
9913,5,2,34595,34595,34597,0,2,2
9914,3,1,34598,34598,34599,0,1,1
9915,2,1,34600,34600,34601,0,1,1
9916,4,3,34604,34604,34607,0,3,3
9917,3,2,34607,34607,34609,0,2,0
9918,4,1,34611,34611,34612,0,1,2
9919,4,3,34615,34615,34618,0,3,3
9920,1,3,34616,34618,34621,2,5,0
9921,2,3,34618,34621,34624,3,6,0
9922,1,3,34619,34624,34627,5,8,0
9923,4,1,34623,34627,34628,4,5,0
9924,2,3,34625,34628,34631,3,6,0
9925,4,2,34629,34631,34633,2,4,0
9926,4,1,34633,34633,34634,0,1,0
9927,5,3,34638,34638,34641,0,3,4
9928,2,2,34640,34641,34643,1,3,0
9929,3,2,34643,34643,34645,0,2,0
9930,1,1,34644,34645,34646,1,2,0
9931,5,3,34649,34649,34652,0,3,3
9932,6,2,34655,34655,34657,0,2,3
9933,2,3,34657,34657,34660,0,3,0
9934,2,2,34659,34660,34662,1,3,0
9935,4,1,34663,34663,34664,0,1,1
9936,1,3,34664,34664,34667,0,3,0
9937,2,2,34666,34667,34669,1,3,0
9938,3,2,34669,34669,34671,0,2,0
9939,5,3,34674,34674,34677,0,3,3
9940,3,2,34677,34677,34679,0,2,0
9941,3,1,34680,34680,34681,0,1,1
9942,2,3,34682,34682,34685,0,3,1
9943,3,2,34685,34685,34687,0,2,0
9944,4,2,34689,34689,34691,0,2,2
9945,5,3,34694,34694,34697,0,3,3
9946,6,1,34700,34700,34701,0,1,3
9947,5,2,34705,34705,34707,0,2,4
9948,6,3,34711,34711,34714,0,3,4
9949,6,1,34717,34717,34718,0,1,3
9950,3,3,34720,34720,34723,0,3,2
9951,3,2,34723,34723,34725,0,2,0
9952,2,3,34725,34725,34728,0,3,0
9953,4,2,34729,34729,34731,0,2,1
9954,5,3,34734,34734,34737,0,3,3
9955,5,1,34739,34739,34740,0,1,2
9956,2,3,34741,34741,34744,0,3,1
9957,4,3,34745,34745,34748,0,3,1
9958,1,3,34746,34748,34751,2,5,0
9959,2,1,34748,34751,34752,3,4,0
9960,3,1,34751,34752,34753,1,2,0
9961,3,2,34754,34754,34756,0,2,1
9962,3,3,34757,34757,34760,0,3,1
9963,5,3,34762,34762,34765,0,3,2
9964,1,3,34763,34765,34768,2,5,0
9965,2,2,34765,34768,34770,3,5,0
9966,2,1,34767,34770,34771,3,4,0
9967,4,1,34771,34771,34772,0,1,0
9968,2,3,34773,34773,34776,0,3,1
9969,3,3,34776,34776,34779,0,3,0
9970,6,3,34782,34782,34785,0,3,3
9971,3,2,34785,34785,34787,0,2,0
9972,6,2,34791,34791,34793,0,2,4
9973,6,1,34797,34797,34798,0,1,4
9974,4,1,34801,34801,34802,0,1,3
9975,3,2,34804,34804,34806,0,2,2
9976,4,2,34808,34808,34810,0,2,2
9977,3,3,34811,34811,34814,0,3,1
9978,6,2,34817,34817,34819,0,2,3
9979,5,2,34822,34822,34824,0,2,3
9980,1,1,34823,34824,34825,1,2,0
9981,2,2,34825,34825,34827,0,2,0
9982,4,1,34829,34829,34830,0,1,2
9983,5,3,34834,34834,34837,0,3,4
9984,4,2,34838,34838,34840,0,2,1
9985,1,1,34839,34840,34841,1,2,0
9986,1,3,34840,34841,34844,1,4,0
9987,4,3,34844,34844,34847,0,3,0
9988,5,1,34849,34849,34850,0,1,2
9989,1,1,34850,34850,34851,0,1,0
9990,6,2,34856,34856,34858,0,2,5
9991,3,1,34859,34859,34860,0,1,1
9992,3,2,34862,34862,34864,0,2,2
9993,3,3,34865,34865,34868,0,3,1
9994,1,2,34866,34868,34870,2,4,0
9995,4,3,34870,34870,34873,0,3,0
9996,3,1,34873,34873,34874,0,1,0
9997,3,2,34876,34876,34878,0,2,2
9998,2,1,34878,34878,34879,0,1,0
9999,4,2,34882,34882,34884,0,2,3
10000,2,1,34884,34884,34885,0,1,0
10001,4,1,34888,34888,34889,0,1,3
10002,2,2,34890,34890,34892,0,2,1
10003,3,2,34893,34893,34895,0,2,1
10004,3,3,34896,34896,34899,0,3,1
10005,4,2,34900,34900,34902,0,2,1
10006,1,1,34901,34902,34903,1,2,0
10007,3,1,34904,34904,34905,0,1,1
10008,1,3,34905,34905,34908,0,3,0
10009,4,1,34909,34909,34910,0,1,1
10010,3,1,34912,34912,34913,0,1,2
10011,5,1,34917,34917,34918,0,1,4
10012,2,3,34919,34919,34922,0,3,1
10013,3,2,34922,34922,34924,0,2,0
10014,2,3,34924,34924,34927,0,3,0
10015,5,1,34929,34929,34930,0,1,2
10016,5,2,34934,34934,34936,0,2,4
10017,5,1,34939,34939,34940,0,1,3
10018,2,2,34941,34941,34943,0,2,1
10019,5,2,34946,34946,34948,0,2,3
10020,1,2,34947,34948,34950,1,3,0
10021,3,1,34950,34950,34951,0,1,0
10022,5,2,34955,34955,34957,0,2,4
10023,2,1,34957,34957,34958,0,1,0
10024,3,3,34960,34960,34963,0,3,2
10025,2,2,34962,34963,34965,1,3,0
10026,4,3,34966,34966,34969,0,3,1
10027,1,1,34967,34969,34970,2,3,0
10028,5,1,34972,34972,34973,0,1,2
10029,5,3,34977,34977,34980,0,3,4
10030,3,2,34980,34980,34982,0,2,0
10031,5,2,34985,34985,34987,0,2,3
10032,3,2,34988,34988,34990,0,2,1
10033,1,1,34989,34990,34991,1,2,0
10034,6,2,34995,34995,34997,0,2,4
10035,6,3,35001,35001,35004,0,3,4
10036,4,1,35005,35005,35006,0,1,1
10037,5,1,35010,35010,35011,0,1,4
10038,3,2,35013,35013,35015,0,2,2
10039,1,1,35014,35015,35016,1,2,0
10040,2,3,35016,35016,35019,0,3,0
10041,4,2,35020,35020,35022,0,2,1
10042,3,2,35023,35023,35025,0,2,1
10043,3,3,35026,35026,35029,0,3,1
10044,5,3,35031,35031,35034,0,3,2
10045,4,3,35035,35035,35038,0,3,1
10046,3,3,35038,35038,35041,0,3,0
10047,6,1,35044,35044,35045,0,1,3
10048,4,3,35048,35048,35051,0,3,3
10049,3,2,35051,35051,35053,0,2,0
10050,2,1,35053,35053,35054,0,1,0
10051,6,3,35059,35059,35062,0,3,5
10052,3,1,35062,35062,35063,0,1,0
10053,1,1,35063,35063,35064,0,1,0
10054,5,3,35068,35068,35071,0,3,4
10055,5,2,35073,35073,35075,0,2,2
10056,2,2,35075,35075,35077,0,2,0
10057,1,2,35076,35077,35079,1,3,0
10058,6,2,35082,35082,35084,0,2,3
10059,6,1,35088,35088,35089,0,1,4
10060,5,2,35093,35093,35095,0,2,4
10061,6,3,35099,35099,35102,0,3,4
10062,6,2,35105,35105,35107,0,2,3
10063,4,1,35109,35109,35110,0,1,2
10064,5,1,35114,35114,35115,0,1,4
10065,3,1,35117,35117,35118,0,1,2
10066,6,2,35123,35123,35125,0,2,5
10067,3,2,35126,35126,35128,0,2,1
10068,4,2,35130,35130,35132,0,2,2
10069,3,1,35133,35133,35134,0,1,1
10070,2,1,35135,35135,35136,0,1,1
10071,3,1,35138,35138,35139,0,1,2
10072,3,1,35141,35141,35142,0,1,2
10073,2,2,35143,35143,35145,0,2,1
10074,2,2,35145,35145,35147,0,2,0
10075,1,1,35146,35147,35148,1,2,0
10076,5,1,35151,35151,35152,0,1,3
10077,1,3,35152,35152,35155,0,3,0
10078,6,3,35158,35158,35161,0,3,3
10079,6,2,35164,35164,35166,0,2,3
10080,6,2,35170,35170,35172,0,2,4
10081,3,2,35173,35173,35175,0,2,1
10082,3,3,35176,35176,35179,0,3,1
10083,4,2,35180,35180,35182,0,2,1
10084,6,2,35186,35186,35188,0,2,4
10085,4,3,35190,35190,35193,0,3,2
10086,1,1,35191,35193,35194,2,3,0
10087,5,3,35196,35196,35199,0,3,2
10088,3,3,35199,35199,35202,0,3,0
10089,1,2,35200,35202,35204,2,4,0
10090,2,2,35202,35204,35206,2,4,0
10091,2,2,35204,35206,35208,2,4,0
10092,6,3,35210,35210,35213,0,3,2
10093,2,3,35212,35213,35216,1,4,0
10094,3,3,35215,35216,35219,1,4,0
10095,3,3,35218,35219,35222,1,4,0
10096,2,1,35220,35222,35223,2,3,0
10097,4,1,35224,35224,35225,0,1,1
10098,4,3,35228,35228,35231,0,3,3
10099,2,3,35230,35231,35234,1,4,0
10100,5,2,35235,35235,35237,0,2,1
10101,2,3,35237,35237,35240,0,3,0
10102,2,1,35239,35240,35241,1,2,0
10103,2,3,35241,35241,35244,0,3,0
10104,4,1,35245,35245,35246,0,1,1
10105,5,2,35250,35250,35252,0,2,4
10106,5,2,35255,35255,35257,0,2,3
10107,1,3,35256,35257,35260,1,4,0
10108,5,3,35261,35261,35264,0,3,1
10109,3,2,35264,35264,35266,0,2,0
10110,6,2,35270,35270,35272,0,2,4
10111,3,3,35273,35273,35276,0,3,1
10112,4,1,35277,35277,35278,0,1,1
10113,5,1,35282,35282,35283,0,1,4
10114,2,1,35284,35284,35285,0,1,1
10115,6,1,35290,35290,35291,0,1,5
10116,1,2,35291,35291,35293,0,2,0
10117,4,3,35295,35295,35298,0,3,2
10118,6,2,35301,35301,35303,0,2,3
10119,6,2,35307,35307,35309,0,2,4
10120,1,1,35308,35309,35310,1,2,0
10121,4,3,35312,35312,35315,0,3,2
10122,1,2,35313,35315,35317,2,4,0
10123,3,3,35316,35317,35320,1,4,0
10124,2,3,35318,35320,35323,2,5,0
10125,2,1,35320,35323,35324,3,4,0
10126,4,1,35324,35324,35325,0,1,0
10127,6,1,35330,35330,35331,0,1,5
10128,3,2,35333,35333,35335,0,2,2
10129,2,3,35335,35335,35338,0,3,0
10130,1,3,35336,35338,35341,2,5,0
10131,3,2,35339,35341,35343,2,4,0
10132,6,3,35345,35345,35348,0,3,2
10133,1,2,35346,35348,35350,2,4,0
10134,3,1,35349,35350,35351,1,2,0
10135,5,2,35354,35354,35356,0,2,3
10136,3,3,35357,35357,35360,0,3,1
10137,4,3,35361,35361,35364,0,3,1
10138,1,3,35362,35364,35367,2,5,0
10139,1,3,35363,35367,35370,4,7,0
10140,3,2,35366,35370,35372,4,6,0
10141,1,3,35367,35372,35375,5,8,0
10142,5,3,35372,35375,35378,3,6,0
10143,2,2,35374,35378,35380,4,6,0
10144,3,3,35377,35380,35383,3,6,0
10145,2,1,35379,35383,35384,4,5,0
10146,5,1,35384,35384,35385,0,1,0
10147,1,2,35385,35385,35387,0,2,0
10148,5,2,35390,35390,35392,0,2,3
10149,3,3,35393,35393,35396,0,3,1
10150,3,3,35396,35396,35399,0,3,0
10151,5,1,35401,35401,35402,0,1,2
10152,1,3,35402,35402,35405,0,3,0
10153,4,3,35406,35406,35409,0,3,1
10154,5,3,35411,35411,35414,0,3,2
10155,3,2,35414,35414,35416,0,2,0
10156,3,2,35417,35417,35419,0,2,1
10157,1,2,35418,35419,35421,1,3,0
10158,2,1,35420,35421,35422,1,2,0
10159,6,3,35426,35426,35429,0,3,4
10160,6,2,35432,35432,35434,0,2,3
10161,1,1,35433,35434,35435,1,2,0
10162,4,1,35437,35437,35438,0,1,2
10163,6,1,35443,35443,35444,0,1,5
10164,1,2,35444,35444,35446,0,2,0
10165,2,3,35446,35446,35449,0,3,0
10166,2,3,35448,35449,35452,1,4,0
10167,5,2,35453,35453,35455,0,2,1
10168,5,3,35458,35458,35461,0,3,3
10169,6,3,35464,35464,35467,0,3,3
10170,1,1,35465,35467,35468,2,3,0
10171,3,2,35468,35468,35470,0,2,0
10172,3,1,35471,35471,35472,0,1,1
10173,2,1,35473,35473,35474,0,1,1
10174,4,3,35477,35477,35480,0,3,3
10175,1,2,35478,35480,35482,2,4,0
10176,3,1,35481,35482,35483,1,2,0
10177,6,2,35487,35487,35489,0,2,4
10178,2,1,35489,35489,35490,0,1,0
10179,3,2,35492,35492,35494,0,2,2
10180,4,2,35496,35496,35498,0,2,2
10181,5,1,35501,35501,35502,0,1,3
10182,2,3,35503,35503,35506,0,3,1
10183,1,3,35504,35506,35509,2,5,0
10184,6,2,35510,35510,35512,0,2,1
10185,4,3,35514,35514,35517,0,3,2
10186,2,2,35516,35517,35519,1,3,0
10187,4,1,35520,35520,35521,0,1,1
10188,2,1,35522,35522,35523,0,1,1
10189,6,2,35528,35528,35530,0,2,5
10190,6,3,35534,35534,35537,0,3,4
10191,2,1,35536,35537,35538,1,2,0
10192,6,2,35542,35542,35544,0,2,4
10193,1,1,35543,35544,35545,1,2,0
10194,3,3,35546,35546,35549,0,3,1
10195,5,2,35551,35551,35553,0,2,2
10196,6,3,35557,35557,35560,0,3,4
10197,5,3,35562,35562,35565,0,3,2
10198,4,2,35566,35566,35568,0,2,1
10199,3,1,35569,35569,35570,0,1,1
10200,4,3,35573,35573,35576,0,3,3
10201,4,1,35577,35577,35578,0,1,1
10202,1,2,35578,35578,35580,0,2,0
10203,2,2,35580,35580,35582,0,2,0
10204,2,1,35582,35582,35583,0,1,0
10205,6,2,35588,35588,35590,0,2,5
10206,6,3,35594,35594,35597,0,3,4
10207,4,1,35598,35598,35599,0,1,1
10208,2,2,35600,35600,35602,0,2,1
10209,1,3,35601,35602,35605,1,4,0
10210,2,2,35603,35605,35607,2,4,0
10211,2,2,35605,35607,35609,2,4,0
10212,3,1,35608,35609,35610,1,2,0
10213,5,3,35613,35613,35616,0,3,3
10214,4,2,35617,35617,35619,0,2,1
10215,6,3,35623,35623,35626,0,3,4
10216,2,2,35625,35626,35628,1,3,0
10217,6,3,35631,35631,35634,0,3,3
10218,4,3,35635,35635,35638,0,3,1
10219,5,2,35640,35640,35642,0,2,2
10220,2,1,35642,35642,35643,0,1,0
10221,3,1,35645,35645,35646,0,1,2
10222,1,2,35646,35646,35648,0,2,0
10223,4,1,35650,35650,35651,0,1,2
10224,4,1,35654,35654,35655,0,1,3
10225,4,1,35658,35658,35659,0,1,3
10226,5,1,35663,35663,35664,0,1,4
10227,2,3,35665,35665,35668,0,3,1
10228,2,2,35667,35668,35670,1,3,0
10229,4,1,35671,35671,35672,0,1,1
10230,4,1,35675,35675,35676,0,1,3
10231,6,2,35681,35681,35683,0,2,5
10232,5,2,35686,35686,35688,0,2,3
10233,5,3,35691,35691,35694,0,3,3
10234,6,2,35697,35697,35699,0,2,3
10235,5,1,35702,35702,35703,0,1,3
10236,4,2,35706,35706,35708,0,2,3
10237,1,1,35707,35708,35709,1,2,0
10238,4,3,35711,35711,35714,0,3,2
10239,3,1,35714,35714,35715,0,1,0
10240,2,3,35716,35716,35719,0,3,1
10241,1,3,35717,35719,35722,2,5,0
10242,1,2,35718,35722,35724,4,6,0
10243,3,3,35721,35724,35727,3,6,0
10244,1,1,35722,35727,35728,5,6,0
10245,4,1,35726,35728,35729,2,3,0
10246,4,2,35730,35730,35732,0,2,1
10247,6,1,35736,35736,35737,0,1,4
10248,1,1,35737,35737,35738,0,1,0
10249,5,3,35742,35742,35745,0,3,4
10250,5,3,35747,35747,35750,0,3,2
10251,6,3,35753,35753,35756,0,3,3
10252,5,1,35758,35758,35759,0,1,2
10253,1,3,35759,35759,35762,0,3,0
10254,4,3,35763,35763,35766,0,3,1
10255,6,1,35769,35769,35770,0,1,3
10256,5,1,35774,35774,35775,0,1,4
10257,1,2,35775,35775,35777,0,2,0
10258,3,3,35778,35778,35781,0,3,1
10259,3,2,35781,35781,35783,0,2,0
10260,1,2,35782,35783,35785,1,3,0
10261,1,2,35783,35785,35787,2,4,0
10262,1,2,35784,35787,35789,3,5,0
10263,6,2,35790,35790,35792,0,2,1
10264,2,1,35792,35792,35793,0,1,0
10265,6,1,35798,35798,35799,0,1,5
10266,1,2,35799,35799,35801,0,2,0
10267,1,2,35800,35801,35803,1,3,0
10268,4,1,35804,35804,35805,0,1,1
10269,5,2,35809,35809,35811,0,2,4
10270,1,3,35810,35811,35814,1,4,0
10271,4,2,35814,35814,35816,0,2,0
10272,6,1,35820,35820,35821,0,1,4
10273,5,1,35825,35825,35826,0,1,4
10274,2,3,35827,35827,35830,0,3,1
10275,3,3,35830,35830,35833,0,3,0
10276,6,3,35836,35836,35839,0,3,3
10277,5,2,35841,35841,35843,0,2,2
10278,4,2,35845,35845,35847,0,2,2
10279,1,2,35846,35847,35849,1,3,0
10280,3,3,35849,35849,35852,0,3,0
10281,1,2,35850,35852,35854,2,4,0
10282,2,2,35852,35854,35856,2,4,0
10283,5,2,35857,35857,35859,0,2,1
10284,2,3,35859,35859,35862,0,3,0
10285,3,2,35862,35862,35864,0,2,0
10286,4,3,35866,35866,35869,0,3,2
10287,2,2,35868,35869,35871,1,3,0
10288,4,1,35872,35872,35873,0,1,1
10289,4,3,35876,35876,35879,0,3,3
10290,4,2,35880,35880,35882,0,2,1
10291,4,1,35884,35884,35885,0,1,2
10292,3,2,35887,35887,35889,0,2,2
10293,3,1,35890,35890,35891,0,1,1
10294,1,2,35891,35891,35893,0,2,0
10295,5,3,35896,35896,35899,0,3,3
10296,3,2,35899,35899,35901,0,2,0
10297,1,2,35900,35901,35903,1,3,0
10298,4,1,35904,35904,35905,0,1,1
10299,1,2,35905,35905,35907,0,2,0
10300,5,3,35910,35910,35913,0,3,3
10301,1,2,35911,35913,35915,2,4,0
10302,2,1,35913,35915,35916,2,3,0
10303,1,2,35914,35916,35918,2,4,0
10304,1,2,35915,35918,35920,3,5,0
10305,4,3,35919,35920,35923,1,4,0
10306,3,1,35922,35923,35924,1,2,0
10307,1,3,35923,35924,35927,1,4,0
10308,2,1,35925,35927,35928,2,3,0
10309,4,3,35929,35929,35932,0,3,1
10310,1,1,35930,35932,35933,2,3,0
10311,4,3,35934,35934,35937,0,3,1
10312,4,3,35938,35938,35941,0,3,1
10313,4,1,35942,35942,35943,0,1,1
10314,2,3,35944,35944,35947,0,3,1
10315,4,2,35948,35948,35950,0,2,1
10316,6,3,35954,35954,35957,0,3,4
10317,3,2,35957,35957,35959,0,2,0
10318,1,1,35958,35959,35960,1,2,0
10319,1,2,35959,35960,35962,1,3,0
10320,5,1,35964,35964,35965,0,1,2
10321,4,1,35968,35968,35969,0,1,3
10322,2,2,35970,35970,35972,0,2,1
10323,1,3,35971,35972,35975,1,4,0
10324,6,3,35977,35977,35980,0,3,2
10325,5,3,35982,35982,35985,0,3,2
10326,2,1,35984,35985,35986,1,2,0
10327,1,1,35985,35986,35987,1,2,0
10328,1,1,35986,35987,35988,1,2,0
10329,1,2,35987,35988,35990,1,3,0
10330,1,1,35988,35990,35991,2,3,0
10331,6,2,35994,35994,35996,0,2,3
10332,2,3,35996,35996,35999,0,3,0
10333,3,3,35999,35999,36002,0,3,0
10334,3,1,36002,36002,36003,0,1,0
10335,2,1,36004,36004,36005,0,1,1
10336,1,3,36005,36005,36008,0,3,0
10337,5,3,36010,36010,36013,0,3,2
10338,2,1,36012,36013,36014,1,2,0
10339,1,1,36013,36014,36015,1,2,0
10340,3,1,36016,36016,36017,0,1,1
10341,4,2,36020,36020,36022,0,2,3
10342,4,2,36024,36024,36026,0,2,2
10343,3,1,36027,36027,36028,0,1,1
10344,1,3,36028,36028,36031,0,3,0
10345,6,2,36034,36034,36036,0,2,3
10346,2,1,36036,36036,36037,0,1,0
10347,4,3,36040,36040,36043,0,3,3
10348,5,3,36045,36045,36048,0,3,2
10349,2,3,36047,36048,36051,1,4,0
10350,6,1,36053,36053,36054,0,1,2
10351,1,3,36054,36054,36057,0,3,0
10352,3,3,36057,36057,36060,0,3,0
10353,2,1,36059,36060,36061,1,2,0
10354,5,3,36064,36064,36067,0,3,3
10355,2,2,36066,36067,36069,1,3,0
10356,4,3,36070,36070,36073,0,3,1
10357,1,3,36071,36073,36076,2,5,0
10358,2,1,36073,36076,36077,3,4,0
10359,2,3,36075,36077,36080,2,5,0
10360,5,3,36080,36080,36083,0,3,0
10361,4,3,36084,36084,36087,0,3,1
10362,6,1,36090,36090,36091,0,1,3
10363,1,1,36091,36091,36092,0,1,0
10364,5,2,36096,36096,36098,0,2,4
10365,5,3,36101,36101,36104,0,3,3
10366,2,3,36103,36104,36107,1,4,0
10367,6,1,36109,36109,36110,0,1,2
10368,4,1,36113,36113,36114,0,1,3
10369,2,3,36115,36115,36118,0,3,1
10370,6,3,36121,36121,36124,0,3,3
10371,2,1,36123,36124,36125,1,2,0
10372,4,3,36127,36127,36130,0,3,2
10373,5,3,36132,36132,36135,0,3,2
10374,2,1,36134,36135,36136,1,2,0
10375,1,3,36135,36136,36139,1,4,0
10376,3,2,36138,36139,36141,1,3,0
10377,2,1,36140,36141,36142,1,2,0
10378,6,2,36146,36146,36148,0,2,4
10379,4,1,36150,36150,36151,0,1,2
10380,5,1,36155,36155,36156,0,1,4
10381,5,1,36160,36160,36161,0,1,4
10382,6,3,36166,36166,36169,0,3,5
10383,4,3,36170,36170,36173,0,3,1
10384,4,1,36174,36174,36175,0,1,1
10385,6,1,36180,36180,36181,0,1,5
10386,2,2,36182,36182,36184,0,2,1
10387,6,2,36188,36188,36190,0,2,4
10388,4,2,36192,36192,36194,0,2,2
10389,4,2,36196,36196,36198,0,2,2
10390,2,1,36198,36198,36199,0,1,0
10391,4,2,36202,36202,36204,0,2,3
10392,5,1,36207,36207,36208,0,1,3
10393,1,2,36208,36208,36210,0,2,0
10394,1,1,36209,36210,36211,1,2,0
10395,2,2,36211,36211,36213,0,2,0
10396,3,1,36214,36214,36215,0,1,1
10397,4,2,36218,36218,36220,0,2,3
10398,2,2,36220,36220,36222,0,2,0
10399,6,1,36226,36226,36227,0,1,4
10400,5,1,36231,36231,36232,0,1,4
10401,3,1,36234,36234,36235,0,1,2
10402,6,2,36240,36240,36242,0,2,5
10403,4,2,36244,36244,36246,0,2,2
10404,2,2,36246,36246,36248,0,2,0
10405,2,3,36248,36248,36251,0,3,0
10406,1,1,36249,36251,36252,2,3,0
10407,6,3,36255,36255,36258,0,3,3
10408,4,1,36259,36259,36260,0,1,1
10409,6,1,36265,36265,36266,0,1,5
10410,1,3,36266,36266,36269,0,3,0
10411,5,2,36271,36271,36273,0,2,2
10412,5,2,36276,36276,36278,0,2,3
10413,3,1,36279,36279,36280,0,1,1
10414,6,3,36285,36285,36288,0,3,5
10415,3,2,36288,36288,36290,0,2,0
10416,4,1,36292,36292,36293,0,1,2
10417,3,2,36295,36295,36297,0,2,2
10418,5,1,36300,36300,36301,0,1,3
10419,4,3,36304,36304,36307,0,3,3
10420,2,1,36306,36307,36308,1,2,0
10421,1,3,36307,36308,36311,1,4,0
10422,1,3,36308,36311,36314,3,6,0
10423,4,2,36312,36314,36316,2,4,0
10424,6,3,36318,36318,36321,0,3,2
10425,3,1,36321,36321,36322,0,1,0
10426,3,3,36324,36324,36327,0,3,2
10427,4,3,36328,36328,36331,0,3,1
10428,4,1,36332,36332,36333,0,1,1
10429,1,3,36333,36333,36336,0,3,0
10430,2,2,36335,36336,36338,1,3,0
10431,6,3,36341,36341,36344,0,3,3
10432,4,2,36345,36345,36347,0,2,1
10433,5,3,36350,36350,36353,0,3,3
10434,4,3,36354,36354,36357,0,3,1
10435,3,2,36357,36357,36359,0,2,0
10436,6,1,36363,36363,36364,0,1,4
10437,4,3,36367,36367,36370,0,3,3
10438,3,3,36370,36370,36373,0,3,0
10439,5,1,36375,36375,36376,0,1,2
10440,3,3,36378,36378,36381,0,3,2
10441,5,2,36383,36383,36385,0,2,2
10442,5,1,36388,36388,36389,0,1,3
10443,3,3,36391,36391,36394,0,3,2
10444,6,1,36397,36397,36398,0,1,3
10445,1,3,36398,36398,36401,0,3,0
10446,2,3,36400,36401,36404,1,4,0
10447,2,2,36402,36404,36406,2,4,0
10448,6,3,36408,36408,36411,0,3,2
10449,1,1,36409,36411,36412,2,3,0
10450,3,2,36412,36412,36414,0,2,0
10451,6,3,36418,36418,36421,0,3,4
10452,5,3,36423,36423,36426,0,3,2
10453,6,3,36429,36429,36432,0,3,3
10454,2,1,36431,36432,36433,1,2,0
10455,5,1,36436,36436,36437,0,1,3
10456,4,2,36440,36440,36442,0,2,3
10457,3,1,36443,36443,36444,0,1,1
10458,4,1,36447,36447,36448,0,1,3
10459,1,3,36448,36448,36451,0,3,0
10460,5,2,36453,36453,36455,0,2,2
10461,4,1,36457,36457,36458,0,1,2
10462,1,2,36458,36458,36460,0,2,0
10463,6,1,36464,36464,36465,0,1,4
10464,6,2,36470,36470,36472,0,2,5
10465,6,3,36476,36476,36479,0,3,4
10466,4,2,36480,36480,36482,0,2,1
10467,1,3,36481,36482,36485,1,4,0
10468,1,2,36482,36485,36487,3,5,0
10469,2,3,36484,36487,36490,3,6,0
10470,6,1,36490,36490,36491,0,1,0
10471,6,1,36496,36496,36497,0,1,5
10472,3,1,36499,36499,36500,0,1,2
10473,5,1,36504,36504,36505,0,1,4
10474,2,3,36506,36506,36509,0,3,1
10475,5,3,36511,36511,36514,0,3,2
10476,5,2,36516,36516,36518,0,2,2
10477,3,1,36519,36519,36520,0,1,1
10478,1,3,36520,36520,36523,0,3,0
10479,4,3,36524,36524,36527,0,3,1
10480,5,1,36529,36529,36530,0,1,2
10481,3,1,36532,36532,36533,0,1,2
10482,2,2,36534,36534,36536,0,2,1
10483,2,1,36536,36536,36537,0,1,0
10484,3,1,36539,36539,36540,0,1,2
10485,5,1,36544,36544,36545,0,1,4
10486,5,2,36549,36549,36551,0,2,4
10487,1,2,36550,36551,36553,1,3,0
10488,3,3,36553,36553,36556,0,3,0
10489,1,1,36554,36556,36557,2,3,0
10490,2,1,36556,36557,36558,1,2,0
10491,1,3,36557,36558,36561,1,4,0
10492,2,2,36559,36561,36563,2,4,0
10493,1,1,36560,36563,36564,3,4,0
10494,1,1,36561,36564,36565,3,4,0
10495,6,1,36567,36567,36568,0,1,2
10496,3,2,36570,36570,36572,0,2,2
10497,3,1,36573,36573,36574,0,1,1
10498,3,3,36576,36576,36579,0,3,2
10499,4,3,36580,36580,36583,0,3,1
10500,6,2,36586,36586,36588,0,2,3
10501,1,3,36587,36588,36591,1,4,0
10502,5,2,36592,36592,36594,0,2,1
10503,5,2,36597,36597,36599,0,2,3
10504,5,2,36602,36602,36604,0,2,3
10505,5,1,36607,36607,36608,0,1,3
10506,1,3,36608,36608,36611,0,3,0
10507,4,3,36612,36612,36615,0,3,1
10508,2,3,36614,36615,36618,1,4,0
10509,1,3,36615,36618,36621,3,6,0
10510,6,2,36621,36621,36623,0,2,0
10511,3,2,36624,36624,36626,0,2,1
10512,5,3,36629,36629,36632,0,3,3
10513,6,2,36635,36635,36637,0,2,3
10514,1,3,36636,36637,36640,1,4,0
10515,5,2,36641,36641,36643,0,2,1
10516,5,3,36646,36646,36649,0,3,3
10517,6,1,36652,36652,36653,0,1,3
10518,4,1,36656,36656,36657,0,1,3
10519,4,2,36660,36660,36662,0,2,3
10520,3,1,36663,36663,36664,0,1,1
10521,5,2,36668,36668,36670,0,2,4
10522,6,1,36674,36674,36675,0,1,4
10523,2,3,36676,36676,36679,0,3,1
10524,2,3,36678,36679,36682,1,4,0
10525,4,1,36682,36682,36683,0,1,0
10526,6,3,36688,36688,36691,0,3,5
10527,5,2,36693,36693,36695,0,2,2
10528,3,2,36696,36696,36698,0,2,1
10529,5,3,36701,36701,36704,0,3,3
10530,6,3,36707,36707,36710,0,3,3
10531,2,2,36709,36710,36712,1,3,0
10532,6,2,36715,36715,36717,0,2,3
10533,2,3,36717,36717,36720,0,3,0
10534,1,1,36718,36720,36721,2,3,0
10535,5,2,36723,36723,36725,0,2,2
10536,3,1,36726,36726,36727,0,1,1
10537,2,3,36728,36728,36731,0,3,1
10538,1,1,36729,36731,36732,2,3,0
10539,6,3,36735,36735,36738,0,3,3
10540,3,1,36738,36738,36739,0,1,0
10541,3,3,36741,36741,36744,0,3,2
10542,3,3,36744,36744,36747,0,3,0
10543,3,3,36747,36747,36750,0,3,0
10544,4,1,36751,36751,36752,0,1,1
10545,1,2,36752,36752,36754,0,2,0
10546,4,1,36756,36756,36757,0,1,2
10547,2,1,36758,36758,36759,0,1,1
10548,3,2,36761,36761,36763,0,2,2
10549,6,1,36767,36767,36768,0,1,4
10550,2,3,36769,36769,36772,0,3,1
10551,1,1,36770,36772,36773,2,3,0
10552,2,1,36772,36773,36774,1,2,0
10553,3,1,36775,36775,36776,0,1,1
10554,5,2,36780,36780,36782,0,2,4
10555,2,3,36782,36782,36785,0,3,0
10556,1,1,36783,36785,36786,2,3,0
10557,1,1,36784,36786,36787,2,3,0
10558,5,2,36789,36789,36791,0,2,2
10559,1,3,36790,36791,36794,1,4,0
10560,4,1,36794,36794,36795,0,1,0
10561,6,1,36800,36800,36801,0,1,5
10562,4,3,36804,36804,36807,0,3,3
10563,6,3,36810,36810,36813,0,3,3
10564,1,2,36811,36813,36815,2,4,0
10565,3,2,36814,36815,36817,1,3,0
10566,5,1,36819,36819,36820,0,1,2
10567,2,2,36821,36821,36823,0,2,1
10568,5,3,36826,36826,36829,0,3,3
10569,2,3,36828,36829,36832,1,4,0
10570,4,3,36832,36832,36835,0,3,0
10571,5,1,36837,36837,36838,0,1,2
10572,3,2,36840,36840,36842,0,2,2
10573,4,2,36844,36844,36846,0,2,2
10574,5,1,36849,36849,36850,0,1,3
10575,4,3,36853,36853,36856,0,3,3
10576,5,2,36858,36858,36860,0,2,2
10577,3,2,36861,36861,36863,0,2,1
10578,6,3,36867,36867,36870,0,3,4
10579,4,2,36871,36871,36873,0,2,1
10580,5,2,36876,36876,36878,0,2,3
10581,3,1,36879,36879,36880,0,1,1
10582,1,2,36880,36880,36882,0,2,0
10583,5,2,36885,36885,36887,0,2,3
10584,5,2,36890,36890,36892,0,2,3
10585,2,1,36892,36892,36893,0,1,0
10586,3,3,36895,36895,36898,0,3,2
10587,1,1,36896,36898,36899,2,3,0
10588,4,2,36900,36900,36902,0,2,1
10589,4,2,36904,36904,36906,0,2,2
10590,3,2,36907,36907,36909,0,2,1
10591,1,1,36908,36909,36910,1,2,0
10592,3,1,36911,36911,36912,0,1,1
10593,6,3,36917,36917,36920,0,3,5
10594,2,2,36919,36920,36922,1,3,0
10595,4,1,36923,36923,36924,0,1,1
10596,3,1,36926,36926,36927,0,1,2
10597,3,1,36929,36929,36930,0,1,2
10598,3,2,36932,36932,36934,0,2,2
10599,2,1,36934,36934,36935,0,1,0
10600,5,1,36939,36939,36940,0,1,4
10601,4,2,36943,36943,36945,0,2,3
10602,4,1,36947,36947,36948,0,1,2
10603,4,2,36951,36951,36953,0,2,3
10604,1,3,36952,36953,36956,1,4,0
10605,5,2,36957,36957,36959,0,2,1
10606,4,1,36961,36961,36962,0,1,2
10607,5,2,36966,36966,36968,0,2,4
10608,3,1,36969,36969,36970,0,1,1
10609,3,1,36972,36972,36973,0,1,2
10610,6,3,36978,36978,36981,0,3,5
10611,4,2,36982,36982,36984,0,2,1
10612,5,2,36987,36987,36989,0,2,3
10613,5,3,36992,36992,36995,0,3,3
10614,6,3,36998,36998,37001,0,3,3
10615,4,2,37002,37002,37004,0,2,1
10616,4,3,37006,37006,37009,0,3,2
10617,4,2,37010,37010,37012,0,2,1
10618,2,3,37012,37012,37015,0,3,0
10619,6,1,37018,37018,37019,0,1,3
10620,4,2,37022,37022,37024,0,2,3
10621,1,3,37023,37024,37027,1,4,0
10622,1,2,37024,37027,37029,3,5,0
10623,5,1,37029,37029,37030,0,1,0
10624,1,3,37030,37030,37033,0,3,0
10625,6,3,37036,37036,37039,0,3,3
10626,2,1,37038,37039,37040,1,2,0
10627,2,1,37040,37040,37041,0,1,0
10628,5,1,37045,37045,37046,0,1,4
10629,6,3,37051,37051,37054,0,3,5
10630,6,2,37057,37057,37059,0,2,3
10631,3,1,37060,37060,37061,0,1,1
10632,5,3,37065,37065,37068,0,3,4
10633,2,3,37067,37068,37071,1,4,0
10634,1,2,37068,37071,37073,3,5,0
10635,2,2,37070,37073,37075,3,5,0
10636,4,2,37074,37075,37077,1,3,0
10637,3,2,37077,37077,37079,0,2,0
10638,6,1,37083,37083,37084,0,1,4
10639,6,2,37089,37089,37091,0,2,5
10640,2,1,37091,37091,37092,0,1,0
10641,6,2,37097,37097,37099,0,2,5
10642,6,3,37103,37103,37106,0,3,4
10643,2,2,37105,37106,37108,1,3,0
10644,3,1,37108,37108,37109,0,1,0
10645,5,1,37113,37113,37114,0,1,4
10646,4,2,37117,37117,37119,0,2,3
10647,5,1,37122,37122,37123,0,1,3
10648,5,2,37127,37127,37129,0,2,4
10649,4,1,37131,37131,37132,0,1,2
10650,1,1,37132,37132,37133,0,1,0
10651,4,3,37136,37136,37139,0,3,3
10652,2,2,37138,37139,37141,1,3,0
10653,4,3,37142,37142,37145,0,3,1
10654,6,2,37148,37148,37150,0,2,3
10655,1,1,37149,37150,37151,1,2,0
10656,2,1,37151,37151,37152,0,1,0
10657,1,3,37152,37152,37155,0,3,0
10658,5,2,37157,37157,37159,0,2,2
10659,6,1,37163,37163,37164,0,1,4
10660,6,1,37169,37169,37170,0,1,5
10661,2,3,37171,37171,37174,0,3,1
10662,6,3,37177,37177,37180,0,3,3
10663,2,1,37179,37180,37181,1,2,0
10664,5,2,37184,37184,37186,0,2,3
10665,3,2,37187,37187,37189,0,2,1
10666,5,1,37192,37192,37193,0,1,3
10667,2,1,37194,37194,37195,0,1,1
10668,2,3,37196,37196,37199,0,3,1
10669,5,2,37201,37201,37203,0,2,2
10670,1,1,37202,37203,37204,1,2,0
10671,3,3,37205,37205,37208,0,3,1
10672,2,3,37207,37208,37211,1,4,0
10673,5,3,37212,37212,37215,0,3,1
10674,2,2,37214,37215,37217,1,3,0
10675,5,2,37219,37219,37221,0,2,2
10676,6,1,37225,37225,37226,0,1,4
10677,3,3,37228,37228,37231,0,3,2
10678,6,3,37234,37234,37237,0,3,3
10679,5,2,37239,37239,37241,0,2,2
10680,3,2,37242,37242,37244,0,2,1
10681,2,3,37244,37244,37247,0,3,0
10682,4,3,37248,37248,37251,0,3,1
10683,3,1,37251,37251,37252,0,1,0
10684,3,3,37254,37254,37257,0,3,2
10685,2,3,37256,37257,37260,1,4,0
10686,3,2,37259,37260,37262,1,3,0
10687,6,1,37265,37265,37266,0,1,3
10688,5,2,37270,37270,37272,0,2,4
10689,5,2,37275,37275,37277,0,2,3
10690,3,2,37278,37278,37280,0,2,1
10691,5,1,37283,37283,37284,0,1,3
10692,1,1,37284,37284,37285,0,1,0
10693,4,2,37288,37288,37290,0,2,3
10694,6,1,37294,37294,37295,0,1,4
10695,4,1,37298,37298,37299,0,1,3
10696,2,2,37300,37300,37302,0,2,1
10697,1,1,37301,37302,37303,1,2,0
10698,2,1,37303,37303,37304,0,1,0
10699,2,3,37305,37305,37308,0,3,1
10700,3,1,37308,37308,37309,0,1,0
10701,4,3,37312,37312,37315,0,3,3
10702,2,1,37314,37315,37316,1,2,0
10703,5,3,37319,37319,37322,0,3,3
10704,5,1,37324,37324,37325,0,1,2
10705,4,2,37328,37328,37330,0,2,3
10706,1,2,37329,37330,37332,1,3,0
10707,1,1,37330,37332,37333,2,3,0
10708,4,1,37334,37334,37335,0,1,1
10709,1,2,37335,37335,37337,0,2,0
10710,4,3,37339,37339,37342,0,3,2
10711,6,3,37345,37345,37348,0,3,3
10712,1,3,37346,37348,37351,2,5,0
10713,4,2,37350,37351,37353,1,3,0
10714,4,3,37354,37354,37357,0,3,1
10715,3,1,37357,37357,37358,0,1,0
10716,2,2,37359,37359,37361,0,2,1
10717,6,2,37365,37365,37367,0,2,4
10718,1,2,37366,37367,37369,1,3,0
10719,1,1,37367,37369,37370,2,3,0
10720,6,1,37373,37373,37374,0,1,3
10721,5,1,37378,37378,37379,0,1,4
10722,6,3,37384,37384,37387,0,3,5
10723,1,3,37385,37387,37390,2,5,0
10724,5,3,37390,37390,37393,0,3,0
10725,4,1,37394,37394,37395,0,1,1
10726,4,1,37398,37398,37399,0,1,3
10727,5,2,37403,37403,37405,0,2,4
10728,6,2,37409,37409,37411,0,2,4
10729,3,1,37412,37412,37413,0,1,1
10730,5,2,37417,37417,37419,0,2,4
10731,1,2,37418,37419,37421,1,3,0
10732,6,1,37424,37424,37425,0,1,3
10733,3,1,37427,37427,37428,0,1,2
10734,5,3,37432,37432,37435,0,3,4
10735,3,1,37435,37435,37436,0,1,0
10736,5,2,37440,37440,37442,0,2,4
10737,4,1,37444,37444,37445,0,1,2
10738,6,1,37450,37450,37451,0,1,5
10739,1,1,37451,37451,37452,0,1,0
10740,1,1,37452,37452,37453,0,1,0
10741,2,1,37454,37454,37455,0,1,1
10742,1,3,37455,37455,37458,0,3,0
10743,6,2,37461,37461,37463,0,2,3
10744,5,1,37466,37466,37467,0,1,3
10745,6,2,37472,37472,37474,0,2,5
10746,3,2,37475,37475,37477,0,2,1
10747,5,2,37480,37480,37482,0,2,3
10748,4,3,37484,37484,37487,0,3,2
10749,4,3,37488,37488,37491,0,3,1
10750,6,1,37494,37494,37495,0,1,3
10751,3,3,37497,37497,37500,0,3,2
10752,4,1,37501,37501,37502,0,1,1
10753,4,3,37505,37505,37508,0,3,3
10754,5,2,37510,37510,37512,0,2,2
10755,5,3,37515,37515,37518,0,3,3
10756,3,3,37518,37518,37521,0,3,0
10757,3,1,37521,37521,37522,0,1,0
10758,6,1,37527,37527,37528,0,1,5
10759,6,3,37533,37533,37536,0,3,5
10760,5,2,37538,37538,37540,0,2,2
10761,1,3,37539,37540,37543,1,4,0
10762,6,3,37545,37545,37548,0,3,2
10763,5,1,37550,37550,37551,0,1,2
10764,4,3,37554,37554,37557,0,3,3
10765,5,2,37559,37559,37561,0,2,2
10766,3,3,37562,37562,37565,0,3,1
10767,6,2,37568,37568,37570,0,2,3
10768,1,3,37569,37570,37573,1,4,0
10769,5,3,37574,37574,37577,0,3,1
10770,2,3,37576,37577,37580,1,4,0
10771,5,3,37581,37581,37584,0,3,1
10772,2,1,37583,37584,37585,1,2,0
10773,5,3,37588,37588,37591,0,3,3
10774,4,3,37592,37592,37595,0,3,1
10775,5,1,37597,37597,37598,0,1,2
10776,4,1,37601,37601,37602,0,1,3
10777,6,1,37607,37607,37608,0,1,5
10778,3,2,37610,37610,37612,0,2,2
10779,1,1,37611,37612,37613,1,2,0
10780,6,3,37617,37617,37620,0,3,4
10781,4,2,37621,37621,37623,0,2,1
10782,4,3,37625,37625,37628,0,3,2
10783,2,2,37627,37628,37630,1,3,0
10784,4,1,37631,37631,37632,0,1,1
10785,4,3,37635,37635,37638,0,3,3
10786,1,1,37636,37638,37639,2,3,0
10787,6,2,37642,37642,37644,0,2,3
10788,1,1,37643,37644,37645,1,2,0
10789,5,1,37648,37648,37649,0,1,3
10790,6,3,37654,37654,37657,0,3,5
10791,2,3,37656,37657,37660,1,4,0
10792,2,2,37658,37660,37662,2,4,0
10793,3,3,37661,37662,37665,1,4,0
10794,5,3,37666,37666,37669,0,3,1
10795,4,2,37670,37670,37672,0,2,1
10796,1,2,37671,37672,37674,1,3,0
10797,5,3,37676,37676,37679,0,3,2
10798,3,2,37679,37679,37681,0,2,0
10799,1,3,37680,37681,37684,1,4,0
10800,3,1,37683,37684,37685,1,2,0
10801,4,1,37687,37687,37688,0,1,2
10802,2,3,37689,37689,37692,0,3,1
10803,1,1,37690,37692,37693,2,3,0
10804,6,3,37696,37696,37699,0,3,3
10805,4,1,37700,37700,37701,0,1,1
10806,3,3,37703,37703,37706,0,3,2
10807,1,3,37704,37706,37709,2,5,0
10808,2,3,37706,37709,37712,3,6,0
10809,1,2,37707,37712,37714,5,7,0
10810,6,1,37713,37714,37715,1,2,0
10811,2,2,37715,37715,37717,0,2,0
10812,1,3,37716,37717,37720,1,4,0
10813,3,3,37719,37720,37723,1,4,0
10814,4,3,37723,37723,37726,0,3,0
10815,5,3,37728,37728,37731,0,3,2
10816,6,3,37734,37734,37737,0,3,3
10817,2,2,37736,37737,37739,1,3,0
10818,5,1,37741,37741,37742,0,1,2
10819,5,1,37746,37746,37747,0,1,4
10820,2,3,37748,37748,37751,0,3,1
10821,1,2,37749,37751,37753,2,4,0
10822,2,1,37751,37753,37754,2,3,0
10823,5,1,37756,37756,37757,0,1,2
10824,2,1,37758,37758,37759,0,1,1
10825,3,1,37761,37761,37762,0,1,2
10826,2,2,37763,37763,37765,0,2,1
10827,1,1,37764,37765,37766,1,2,0
10828,3,3,37767,37767,37770,0,3,1
10829,1,2,37768,37770,37772,2,4,0
10830,6,2,37774,37774,37776,0,2,2
10831,1,3,37775,37776,37779,1,4,0
10832,3,2,37778,37779,37781,1,3,0
10833,5,3,37783,37783,37786,0,3,2
10834,5,1,37788,37788,37789,0,1,2
10835,3,3,37791,37791,37794,0,3,2
10836,5,2,37796,37796,37798,0,2,2
10837,3,2,37799,37799,37801,0,2,1
10838,2,1,37801,37801,37802,0,1,0
10839,1,1,37802,37802,37803,0,1,0
10840,3,1,37805,37805,37806,0,1,2
10841,4,1,37809,37809,37810,0,1,3
10842,2,3,37811,37811,37814,0,3,1
10843,3,2,37814,37814,37816,0,2,0
10844,5,3,37819,37819,37822,0,3,3
10845,5,1,37824,37824,37825,0,1,2
10846,1,1,37825,37825,37826,0,1,0
10847,1,2,37826,37826,37828,0,2,0
10848,3,3,37829,37829,37832,0,3,1
10849,6,3,37835,37835,37838,0,3,3
10850,4,1,37839,37839,37840,0,1,1
10851,5,1,37844,37844,37845,0,1,4
10852,1,3,37845,37845,37848,0,3,0
10853,5,3,37850,37850,37853,0,3,2
10854,4,3,37854,37854,37857,0,3,1
10855,6,3,37860,37860,37863,0,3,3
10856,4,1,37864,37864,37865,0,1,1
10857,5,3,37869,37869,37872,0,3,4
10858,4,1,37873,37873,37874,0,1,1
10859,4,2,37877,37877,37879,0,2,3
10860,6,2,37883,37883,37885,0,2,4
10861,1,2,37884,37885,37887,1,3,0
10862,5,2,37889,37889,37891,0,2,2
10863,2,2,37891,37891,37893,0,2,0
10864,3,2,37894,37894,37896,0,2,1
10865,2,1,37896,37896,37897,0,1,0
10866,4,3,37900,37900,37903,0,3,3
10867,3,3,37903,37903,37906,0,3,0
10868,2,2,37905,37906,37908,1,3,0
10869,4,1,37909,37909,37910,0,1,1
10870,3,1,37912,37912,37913,0,1,2
10871,5,1,37917,37917,37918,0,1,4
10872,1,3,37918,37918,37921,0,3,0
10873,1,1,37919,37921,37922,2,3,0
10874,2,3,37921,37922,37925,1,4,0
10875,2,3,37923,37925,37928,2,5,0
10876,3,1,37926,37928,37929,2,3,0
10877,3,2,37929,37929,37931,0,2,0
10878,2,1,37931,37931,37932,0,1,0
10879,4,2,37935,37935,37937,0,2,3
10880,1,1,37936,37937,37938,1,2,0
10881,4,2,37940,37940,37942,0,2,2
10882,6,2,37946,37946,37948,0,2,4
10883,6,1,37952,37952,37953,0,1,4
10884,1,3,37953,37953,37956,0,3,0
10885,2,2,37955,37956,37958,1,3,0
10886,1,2,37956,37958,37960,2,4,0
10887,5,2,37961,37961,37963,0,2,1
10888,3,1,37964,37964,37965,0,1,1
10889,1,2,37965,37965,37967,0,2,0
10890,3,2,37968,37968,37970,0,2,1
10891,5,2,37973,37973,37975,0,2,3
10892,3,1,37976,37976,37977,0,1,1
10893,2,2,37978,37978,37980,0,2,1
10894,3,3,37981,37981,37984,0,3,1
10895,1,3,37982,37984,37987,2,5,0
10896,2,3,37984,37987,37990,3,6,0
10897,6,1,37990,37990,37991,0,1,0
10898,1,3,37991,37991,37994,0,3,0
10899,1,1,37992,37994,37995,2,3,0
10900,5,2,37997,37997,37999,0,2,2
10901,3,3,38000,38000,38003,0,3,1
10902,5,1,38005,38005,38006,0,1,2
10903,5,2,38010,38010,38012,0,2,4
10904,4,1,38014,38014,38015,0,1,2
10905,3,2,38017,38017,38019,0,2,2
10906,4,2,38021,38021,38023,0,2,2
10907,1,3,38022,38023,38026,1,4,0
10908,3,3,38025,38026,38029,1,4,0
10909,5,2,38030,38030,38032,0,2,1
10910,6,3,38036,38036,38039,0,3,4
10911,6,1,38042,38042,38043,0,1,3
10912,3,2,38045,38045,38047,0,2,2
10913,5,2,38050,38050,38052,0,2,3
10914,1,3,38051,38052,38055,1,4,0
10915,5,2,38056,38056,38058,0,2,1
10916,3,3,38059,38059,38062,0,3,1
10917,3,2,38062,38062,38064,0,2,0
10918,4,3,38066,38066,38069,0,3,2
10919,5,2,38071,38071,38073,0,2,2
10920,3,2,38074,38074,38076,0,2,1
10921,6,2,38080,38080,38082,0,2,4
10922,6,2,38086,38086,38088,0,2,4
10923,1,1,38087,38088,38089,1,2,0
10924,5,3,38092,38092,38095,0,3,3
10925,1,2,38093,38095,38097,2,4,0
10926,1,1,38094,38097,38098,3,4,0
10927,5,3,38099,38099,38102,0,3,1
10928,4,1,38103,38103,38104,0,1,1
10929,1,1,38104,38104,38105,0,1,0
10930,4,1,38108,38108,38109,0,1,3
10931,2,3,38110,38110,38113,0,3,1
10932,1,2,38111,38113,38115,2,4,0
10933,1,1,38112,38115,38116,3,4,0
10934,1,1,38113,38116,38117,3,4,0
10935,5,1,38118,38118,38119,0,1,1
10936,6,2,38124,38124,38126,0,2,5
10937,5,1,38129,38129,38130,0,1,3
10938,1,1,38130,38130,38131,0,1,0
10939,2,3,38132,38132,38135,0,3,1
10940,3,1,38135,38135,38136,0,1,0
10941,2,1,38137,38137,38138,0,1,1
10942,3,1,38140,38140,38141,0,1,2
10943,3,3,38143,38143,38146,0,3,2
10944,5,2,38148,38148,38150,0,2,2
10945,2,3,38150,38150,38153,0,3,0
10946,5,3,38155,38155,38158,0,3,2
10947,3,3,38158,38158,38161,0,3,0
10948,1,1,38159,38161,38162,2,3,0
10949,4,1,38163,38163,38164,0,1,1
10950,2,3,38165,38165,38168,0,3,1
10951,5,3,38170,38170,38173,0,3,2
10952,2,3,38172,38173,38176,1,4,0
10953,2,1,38174,38176,38177,2,3,0
10954,3,1,38177,38177,38178,0,1,0
10955,1,1,38178,38178,38179,0,1,0
10956,2,2,38180,38180,38182,0,2,1
10957,2,1,38182,38182,38183,0,1,0
10958,6,1,38188,38188,38189,0,1,5
10959,6,3,38194,38194,38197,0,3,5
10960,1,2,38195,38197,38199,2,4,0
10961,4,2,38199,38199,38201,0,2,0
10962,2,1,38201,38201,38202,0,1,0
10963,3,2,38204,38204,38206,0,2,2
10964,6,1,38210,38210,38211,0,1,4
10965,1,3,38211,38211,38214,0,3,0
10966,5,3,38216,38216,38219,0,3,2
10967,1,1,38217,38219,38220,2,3,0
10968,3,2,38220,38220,38222,0,2,0
10969,1,2,38221,38222,38224,1,3,0
10970,5,3,38226,38226,38229,0,3,2
10971,2,3,38228,38229,38232,1,4,0
10972,3,2,38231,38232,38234,1,3,0
10973,4,3,38235,38235,38238,0,3,1
10974,2,2,38237,38238,38240,1,3,0
10975,3,3,38240,38240,38243,0,3,0
10976,2,3,38242,38243,38246,1,4,0
10977,4,2,38246,38246,38248,0,2,0
10978,1,2,38247,38248,38250,1,3,0
10979,4,3,38251,38251,38254,0,3,1
10980,3,1,38254,38254,38255,0,1,0
10981,6,1,38260,38260,38261,0,1,5
10982,6,3,38266,38266,38269,0,3,5
10983,5,1,38271,38271,38272,0,1,2
10984,2,3,38273,38273,38276,0,3,1
10985,6,3,38279,38279,38282,0,3,3
10986,1,2,38280,38282,38284,2,4,0
10987,3,3,38283,38284,38287,1,4,0
10988,4,1,38287,38287,38288,0,1,0
10989,3,1,38290,38290,38291,0,1,2
10990,2,2,38292,38292,38294,0,2,1
10991,1,1,38293,38294,38295,1,2,0
10992,3,2,38296,38296,38298,0,2,1
10993,3,2,38299,38299,38301,0,2,1
10994,1,1,38300,38301,38302,1,2,0
10995,4,3,38304,38304,38307,0,3,2
10996,1,2,38305,38307,38309,2,4,0
10997,1,3,38306,38309,38312,3,6,0
10998,5,1,38311,38312,38313,1,2,0
10999,2,2,38313,38313,38315,0,2,0
11000,2,2,38315,38315,38317,0,2,0
11001,4,1,38319,38319,38320,0,1,2
11002,4,3,38323,38323,38326,0,3,3
11003,1,1,38324,38326,38327,2,3,0
11004,1,2,38325,38327,38329,2,4,0
11005,1,2,38326,38329,38331,3,5,0
11006,1,2,38327,38331,38333,4,6,0
11007,4,2,38331,38333,38335,2,4,0
11008,1,3,38332,38335,38338,3,6,0
11009,6,1,38338,38338,38339,0,1,0
11010,2,3,38340,38340,38343,0,3,1
11011,5,1,38345,38345,38346,0,1,2
11012,1,3,38346,38346,38349,0,3,0
11013,3,2,38349,38349,38351,0,2,0
11014,2,2,38351,38351,38353,0,2,0
11015,2,3,38353,38353,38356,0,3,0
11016,4,1,38357,38357,38358,0,1,1
11017,4,1,38361,38361,38362,0,1,3
11018,6,3,38367,38367,38370,0,3,5
11019,6,3,38373,38373,38376,0,3,3
11020,3,1,38376,38376,38377,0,1,0
11021,4,2,38380,38380,38382,0,2,3
11022,5,1,38385,38385,38386,0,1,3
11023,2,2,38387,38387,38389,0,2,1
11024,1,2,38388,38389,38391,1,3,0
11025,6,3,38394,38394,38397,0,3,3
11026,1,3,38395,38397,38400,2,5,0
11027,3,2,38398,38400,38402,2,4,0
11028,1,3,38399,38402,38405,3,6,0
11029,6,2,38405,38405,38407,0,2,0
11030,1,2,38406,38407,38409,1,3,0
11031,2,2,38408,38409,38411,1,3,0
11032,4,1,38412,38412,38413,0,1,1
11033,5,3,38417,38417,38420,0,3,4
11034,1,2,38418,38420,38422,2,4,0
11035,2,2,38420,38422,38424,2,4,0
11036,5,2,38425,38425,38427,0,2,1
11037,1,1,38426,38427,38428,1,2,0
11038,3,1,38429,38429,38430,0,1,1
11039,2,1,38431,38431,38432,0,1,1
11040,1,1,38432,38432,38433,0,1,0
11041,5,2,38437,38437,38439,0,2,4
11042,4,3,38441,38441,38444,0,3,2
11043,3,1,38444,38444,38445,0,1,0
11044,5,1,38449,38449,38450,0,1,4
11045,4,3,38453,38453,38456,0,3,3
11046,6,2,38459,38459,38461,0,2,3
11047,3,2,38462,38462,38464,0,2,1
11048,4,1,38466,38466,38467,0,1,2
11049,5,1,38471,38471,38472,0,1,4
11050,4,3,38475,38475,38478,0,3,3
11051,2,2,38477,38478,38480,1,3,0
11052,1,2,38478,38480,38482,2,4,0
11053,6,3,38484,38484,38487,0,3,2
11054,3,3,38487,38487,38490,0,3,0
11055,2,1,38489,38490,38491,1,2,0
11056,6,2,38495,38495,38497,0,2,4
11057,1,3,38496,38497,38500,1,4,0
11058,5,1,38501,38501,38502,0,1,1
11059,3,1,38504,38504,38505,0,1,2
11060,4,3,38508,38508,38511,0,3,3
11061,2,2,38510,38511,38513,1,3,0
11062,6,2,38516,38516,38518,0,2,3
11063,1,3,38517,38518,38521,1,4,0
11064,5,1,38522,38522,38523,0,1,1
11065,1,3,38523,38523,38526,0,3,0
11066,3,3,38526,38526,38529,0,3,0
11067,1,2,38527,38529,38531,2,4,0
11068,1,3,38528,38531,38534,3,6,0
11069,5,3,38533,38534,38537,1,4,0
11070,1,2,38534,38537,38539,3,5,0
11071,3,2,38537,38539,38541,2,4,0
11072,1,3,38538,38541,38544,3,6,0
11073,2,1,38540,38544,38545,4,5,0
11074,5,2,38545,38545,38547,0,2,0
11075,2,3,38547,38547,38550,0,3,0
11076,3,3,38550,38550,38553,0,3,0
11077,6,3,38556,38556,38559,0,3,3
11078,1,3,38557,38559,38562,2,5,0
11079,6,1,38563,38563,38564,0,1,1
11080,2,3,38565,38565,38568,0,3,1
11081,6,1,38571,38571,38572,0,1,3
11082,4,2,38575,38575,38577,0,2,3
11083,2,3,38577,38577,38580,0,3,0
11084,5,3,38582,38582,38585,0,3,2
11085,1,2,38583,38585,38587,2,4,0
11086,2,1,38585,38587,38588,2,3,0
11087,5,1,38590,38590,38591,0,1,2
11088,5,1,38595,38595,38596,0,1,4
11089,4,3,38599,38599,38602,0,3,3
11090,2,2,38601,38602,38604,1,3,0
11091,5,1,38606,38606,38607,0,1,2
11092,6,1,38612,38612,38613,0,1,5
11093,3,2,38615,38615,38617,0,2,2
11094,3,3,38618,38618,38621,0,3,1
11095,2,1,38620,38621,38622,1,2,0
11096,6,2,38626,38626,38628,0,2,4
11097,5,2,38631,38631,38633,0,2,3
11098,4,3,38635,38635,38638,0,3,2
11099,1,1,38636,38638,38639,2,3,0
11100,4,1,38640,38640,38641,0,1,1
11101,2,2,38642,38642,38644,0,2,1
11102,5,3,38647,38647,38650,0,3,3
11103,3,3,38650,38650,38653,0,3,0
11104,4,3,38654,38654,38657,0,3,1
11105,6,1,38660,38660,38661,0,1,3
11106,6,1,38666,38666,38667,0,1,5
11107,2,1,38668,38668,38669,0,1,1
11108,5,2,38673,38673,38675,0,2,4
11109,6,1,38679,38679,38680,0,1,4
11110,2,2,38681,38681,38683,0,2,1
11111,4,1,38685,38685,38686,0,1,2
11112,6,1,38691,38691,38692,0,1,5
11113,2,1,38693,38693,38694,0,1,1
11114,6,2,38699,38699,38701,0,2,5
11115,2,1,38701,38701,38702,0,1,0
11116,5,3,38706,38706,38709,0,3,4
11117,2,3,38708,38709,38712,1,4,0
11118,5,2,38713,38713,38715,0,2,1
11119,4,1,38717,38717,38718,0,1,2
11120,3,3,38720,38720,38723,0,3,2
11121,5,3,38725,38725,38728,0,3,2
11122,6,3,38731,38731,38734,0,3,3
11123,1,3,38732,38734,38737,2,5,0
11124,1,3,38733,38737,38740,4,7,0
11125,4,2,38737,38740,38742,3,5,0
11126,6,2,38743,38743,38745,0,2,1
11127,2,1,38745,38745,38746,0,1,0
11128,2,3,38747,38747,38750,0,3,1
11129,5,3,38752,38752,38755,0,3,2
11130,5,3,38757,38757,38760,0,3,2
11131,6,2,38763,38763,38765,0,2,3
11132,6,1,38769,38769,38770,0,1,4
11133,4,1,38773,38773,38774,0,1,3
11134,3,2,38776,38776,38778,0,2,2
11135,3,1,38779,38779,38780,0,1,1
11136,4,1,38783,38783,38784,0,1,3
11137,3,1,38786,38786,38787,0,1,2
11138,5,1,38791,38791,38792,0,1,4
11139,5,3,38796,38796,38799,0,3,4
11140,2,3,38798,38799,38802,1,4,0
11141,2,3,38800,38802,38805,2,5,0
11142,3,2,38803,38805,38807,2,4,0
11143,1,2,38804,38807,38809,3,5,0
11144,4,3,38808,38809,38812,1,4,0
11145,3,3,38811,38812,38815,1,4,0
11146,4,3,38815,38815,38818,0,3,0
11147,4,3,38819,38819,38822,0,3,1
11148,3,3,38822,38822,38825,0,3,0
11149,3,2,38825,38825,38827,0,2,0
11150,2,1,38827,38827,38828,0,1,0
11151,6,1,38833,38833,38834,0,1,5
11152,6,2,38839,38839,38841,0,2,5
11153,1,3,38840,38841,38844,1,4,0
11154,6,3,38846,38846,38849,0,3,2
11155,3,1,38849,38849,38850,0,1,0
11156,4,1,38853,38853,38854,0,1,3
11157,2,2,38855,38855,38857,0,2,1
11158,6,3,38861,38861,38864,0,3,4
11159,6,2,38867,38867,38869,0,2,3
11160,6,2,38873,38873,38875,0,2,4
11161,4,2,38877,38877,38879,0,2,2
11162,4,1,38881,38881,38882,0,1,2
11163,4,3,38885,38885,38888,0,3,3
11164,3,2,38888,38888,38890,0,2,0
11165,3,2,38891,38891,38893,0,2,1
11166,6,3,38897,38897,38900,0,3,4
11167,3,1,38900,38900,38901,0,1,0
11168,6,3,38906,38906,38909,0,3,5
11169,2,2,38908,38909,38911,1,3,0
11170,6,2,38914,38914,38916,0,2,3
11171,3,3,38917,38917,38920,0,3,1
11172,6,3,38923,38923,38926,0,3,3
11173,6,1,38929,38929,38930,0,1,3
11174,2,2,38931,38931,38933,0,2,1
11175,3,2,38934,38934,38936,0,2,1
11176,3,1,38937,38937,38938,0,1,1
11177,5,3,38942,38942,38945,0,3,4
11178,2,1,38944,38945,38946,1,2,0
11179,1,3,38945,38946,38949,1,4,0
11180,3,2,38948,38949,38951,1,3,0
11181,2,1,38950,38951,38952,1,2,0
11182,1,1,38951,38952,38953,1,2,0
11183,4,1,38955,38955,38956,0,1,2
11184,2,3,38957,38957,38960,0,3,1
11185,5,1,38962,38962,38963,0,1,2
11186,5,1,38967,38967,38968,0,1,4
11187,1,3,38968,38968,38971,0,3,0
11188,4,3,38972,38972,38975,0,3,1
11189,4,1,38976,38976,38977,0,1,1
11190,4,2,38980,38980,38982,0,2,3
11191,5,1,38985,38985,38986,0,1,3
11192,5,1,38990,38990,38991,0,1,4
11193,1,3,38991,38991,38994,0,3,0
11194,4,1,38995,38995,38996,0,1,1
11195,1,1,38996,38996,38997,0,1,0
11196,2,2,38998,38998,39000,0,2,1
11197,2,2,39000,39000,39002,0,2,0
11198,5,1,39005,39005,39006,0,1,3
11199,3,3,39008,39008,39011,0,3,2
11200,6,3,39014,39014,39017,0,3,3
11201,5,2,39019,39019,39021,0,2,2
11202,6,2,39025,39025,39027,0,2,4
11203,1,2,39026,39027,39029,1,3,0
11204,4,1,39030,39030,39031,0,1,1
11205,6,3,39036,39036,39039,0,3,5
11206,6,1,39042,39042,39043,0,1,3
11207,3,2,39045,39045,39047,0,2,2
11208,2,3,39047,39047,39050,0,3,0
11209,1,3,39048,39050,39053,2,5,0
11210,5,3,39053,39053,39056,0,3,0
11211,4,1,39057,39057,39058,0,1,1
11212,1,3,39058,39058,39061,0,3,0
11213,4,1,39062,39062,39063,0,1,1
11214,2,2,39064,39064,39066,0,2,1
11215,4,1,39068,39068,39069,0,1,2
11216,3,2,39071,39071,39073,0,2,2
11217,6,3,39077,39077,39080,0,3,4
11218,5,2,39082,39082,39084,0,2,2
11219,1,1,39083,39084,39085,1,2,0
11220,6,3,39089,39089,39092,0,3,4
11221,1,2,39090,39092,39094,2,4,0
11222,6,2,39096,39096,39098,0,2,2
11223,3,3,39099,39099,39102,0,3,1
11224,6,3,39105,39105,39108,0,3,3
11225,3,1,39108,39108,39109,0,1,0
11226,2,3,39110,39110,39113,0,3,1
11227,5,2,39115,39115,39117,0,2,2
11228,1,3,39116,39117,39120,1,4,0
11229,1,1,39117,39120,39121,3,4,0
11230,3,3,39120,39121,39124,1,4,0
11231,2,1,39122,39124,39125,2,3,0
11232,4,2,39126,39126,39128,0,2,1
11233,1,3,39127,39128,39131,1,4,0
11234,1,3,39128,39131,39134,3,6,0
11235,6,1,39134,39134,39135,0,1,0
11236,6,2,39140,39140,39142,0,2,5
11237,6,2,39146,39146,39148,0,2,4
11238,6,2,39152,39152,39154,0,2,4
11239,6,3,39158,39158,39161,0,3,4
11240,1,2,39159,39161,39163,2,4,0
11241,2,3,39161,39163,39166,2,5,0
11242,5,3,39166,39166,39169,0,3,0
11243,1,1,39167,39169,39170,2,3,0
11244,1,1,39168,39170,39171,2,3,0
11245,2,3,39170,39171,39174,1,4,0
11246,6,2,39176,39176,39178,0,2,2
11247,4,1,39180,39180,39181,0,1,2
11248,6,1,39186,39186,39187,0,1,5
11249,1,3,39187,39187,39190,0,3,0
11250,3,1,39190,39190,39191,0,1,0
11251,6,1,39196,39196,39197,0,1,5
11252,1,2,39197,39197,39199,0,2,0
11253,4,2,39201,39201,39203,0,2,2
11254,1,3,39202,39203,39206,1,4,0
11255,6,1,39208,39208,39209,0,1,2
11256,5,1,39213,39213,39214,0,1,4
11257,3,1,39216,39216,39217,0,1,2
11258,5,1,39221,39221,39222,0,1,4
11259,3,2,39224,39224,39226,0,2,2
11260,5,3,39229,39229,39232,0,3,3
11261,3,2,39232,39232,39234,0,2,0
11262,3,2,39235,39235,39237,0,2,1
11263,1,2,39236,39237,39239,1,3,0
11264,4,2,39240,39240,39242,0,2,1
11265,6,1,39246,39246,39247,0,1,4
11266,6,3,39252,39252,39255,0,3,5
11267,4,3,39256,39256,39259,0,3,1
11268,3,1,39259,39259,39260,0,1,0
11269,4,3,39263,39263,39266,0,3,3
11270,1,3,39264,39266,39269,2,5,0
11271,2,2,39266,39269,39271,3,5,0
11272,5,3,39271,39271,39274,0,3,0
11273,1,1,39272,39274,39275,2,3,0
11274,4,3,39276,39276,39279,0,3,1
11275,1,1,39277,39279,39280,2,3,0
11276,1,1,39278,39280,39281,2,3,0
11277,1,3,39279,39281,39284,2,5,0
11278,4,2,39283,39284,39286,1,3,0
11279,5,3,39288,39288,39291,0,3,2
11280,6,3,39294,39294,39297,0,3,3
11281,1,3,39295,39297,39300,2,5,0
11282,5,3,39300,39300,39303,0,3,0
11283,3,2,39303,39303,39305,0,2,0
11284,6,3,39309,39309,39312,0,3,4
11285,6,2,39315,39315,39317,0,2,3
11286,5,1,39320,39320,39321,0,1,3
11287,4,3,39324,39324,39327,0,3,3
11288,3,2,39327,39327,39329,0,2,0
11289,2,3,39329,39329,39332,0,3,0
11290,6,3,39335,39335,39338,0,3,3
11291,2,1,39337,39338,39339,1,2,0
11292,1,2,39338,39339,39341,1,3,0
11293,3,2,39341,39341,39343,0,2,0
11294,2,1,39343,39343,39344,0,1,0
11295,6,3,39349,39349,39352,0,3,5
11296,4,2,39353,39353,39355,0,2,1
11297,4,3,39357,39357,39360,0,3,2
11298,1,3,39358,39360,39363,2,5,0
11299,4,3,39362,39363,39366,1,4,0
11300,1,3,39363,39366,39369,3,6,0
11301,6,2,39369,39369,39371,0,2,0
11302,3,3,39372,39372,39375,0,3,1
11303,2,3,39374,39375,39378,1,4,0
11304,4,2,39378,39378,39380,0,2,0
11305,5,2,39383,39383,39385,0,2,3
11306,3,2,39386,39386,39388,0,2,1
11307,6,3,39392,39392,39395,0,3,4
11308,3,1,39395,39395,39396,0,1,0
11309,4,1,39399,39399,39400,0,1,3
11310,3,1,39402,39402,39403,0,1,2
11311,5,2,39407,39407,39409,0,2,4
11312,5,2,39412,39412,39414,0,2,3
11313,6,3,39418,39418,39421,0,3,4
11314,5,1,39423,39423,39424,0,1,2
11315,1,3,39424,39424,39427,0,3,0
11316,6,3,39430,39430,39433,0,3,3
11317,5,3,39435,39435,39438,0,3,2
11318,2,3,39437,39438,39441,1,4,0
11319,5,2,39442,39442,39444,0,2,1
11320,5,1,39447,39447,39448,0,1,3
11321,6,2,39453,39453,39455,0,2,5
11322,4,1,39457,39457,39458,0,1,2
11323,5,3,39462,39462,39465,0,3,4
11324,6,2,39468,39468,39470,0,2,3
11325,6,1,39474,39474,39475,0,1,4
11326,3,2,39477,39477,39479,0,2,2
11327,3,2,39480,39480,39482,0,2,1
11328,4,1,39484,39484,39485,0,1,2
11329,1,3,39485,39485,39488,0,3,0
11330,6,1,39491,39491,39492,0,1,3
11331,4,2,39495,39495,39497,0,2,3
11332,4,1,39499,39499,39500,0,1,2
11333,3,1,39502,39502,39503,0,1,2
11334,3,3,39505,39505,39508,0,3,2
11335,3,1,39508,39508,39509,0,1,0
11336,2,1,39510,39510,39511,0,1,1
11337,6,3,39516,39516,39519,0,3,5
11338,6,1,39522,39522,39523,0,1,3
11339,3,2,39525,39525,39527,0,2,2
11340,4,2,39529,39529,39531,0,2,2
11341,6,1,39535,39535,39536,0,1,4
11342,5,3,39540,39540,39543,0,3,4
11343,2,2,39542,39543,39545,1,3,0
11344,2,1,39544,39545,39546,1,2,0
11345,4,1,39548,39548,39549,0,1,2
11346,2,1,39550,39550,39551,0,1,1
11347,4,3,39554,39554,39557,0,3,3
11348,2,2,39556,39557,39559,1,3,0
11349,4,1,39560,39560,39561,0,1,1
11350,6,2,39566,39566,39568,0,2,5
11351,6,3,39572,39572,39575,0,3,4
11352,6,1,39578,39578,39579,0,1,3
11353,4,3,39582,39582,39585,0,3,3
11354,5,2,39587,39587,39589,0,2,2
11355,1,3,39588,39589,39592,1,4,0
11356,1,2,39589,39592,39594,3,5,0
11357,3,2,39592,39594,39596,2,4,0
11358,1,1,39593,39596,39597,3,4,0
11359,6,2,39599,39599,39601,0,2,2
11360,4,2,39603,39603,39605,0,2,2
11361,4,2,39607,39607,39609,0,2,2
11362,4,3,39611,39611,39614,0,3,2
11363,3,1,39614,39614,39615,0,1,0
11364,4,2,39618,39618,39620,0,2,3
11365,3,1,39621,39621,39622,0,1,1
11366,6,3,39627,39627,39630,0,3,5
11367,3,3,39630,39630,39633,0,3,0
11368,5,3,39635,39635,39638,0,3,2
11369,2,3,39637,39638,39641,1,4,0
11370,3,3,39640,39641,39644,1,4,0
11371,1,3,39641,39644,39647,3,6,0
11372,5,1,39646,39647,39648,1,2,0
11373,1,1,39647,39648,39649,1,2,0
11374,6,1,39653,39653,39654,0,1,4
11375,2,3,39655,39655,39658,0,3,1
11376,4,3,39659,39659,39662,0,3,1
11377,3,2,39662,39662,39664,0,2,0
11378,1,2,39663,39664,39666,1,3,0
11379,6,3,39669,39669,39672,0,3,3
11380,2,2,39671,39672,39674,1,3,0
11381,2,3,39673,39674,39677,1,4,0
11382,2,3,39675,39677,39680,2,5,0
11383,2,1,39677,39680,39681,3,4,0
11384,2,1,39679,39681,39682,2,3,0
11385,4,2,39683,39683,39685,0,2,1
11386,1,3,39684,39685,39688,1,4,0
11387,5,2,39689,39689,39691,0,2,1
11388,2,2,39691,39691,39693,0,2,0
11389,4,2,39695,39695,39697,0,2,2
11390,6,3,39701,39701,39704,0,3,4
11391,1,3,39702,39704,39707,2,5,0
11392,1,2,39703,39707,39709,4,6,0
11393,6,1,39709,39709,39710,0,1,0
11394,5,2,39714,39714,39716,0,2,4
11395,1,2,39715,39716,39718,1,3,0
11396,3,2,39718,39718,39720,0,2,0
11397,4,3,39722,39722,39725,0,3,2
11398,4,1,39726,39726,39727,0,1,1
11399,6,2,39732,39732,39734,0,2,5
11400,4,2,39736,39736,39738,0,2,2
11401,3,3,39739,39739,39742,0,3,1
11402,5,1,39744,39744,39745,0,1,2
11403,6,1,39750,39750,39751,0,1,5
11404,3,3,39753,39753,39756,0,3,2
11405,2,1,39755,39756,39757,1,2,0
11406,5,1,39760,39760,39761,0,1,3
11407,4,3,39764,39764,39767,0,3,3
11408,1,1,39765,39767,39768,2,3,0
11409,6,2,39771,39771,39773,0,2,3
11410,2,2,39773,39773,39775,0,2,0
11411,1,2,39774,39775,39777,1,3,0
11412,1,1,39775,39777,39778,2,3,0
11413,5,1,39780,39780,39781,0,1,2
11414,1,1,39781,39781,39782,0,1,0
11415,1,1,39782,39782,39783,0,1,0
11416,4,2,39786,39786,39788,0,2,3
11417,4,2,39790,39790,39792,0,2,2
11418,5,3,39795,39795,39798,0,3,3
11419,3,1,39798,39798,39799,0,1,0
11420,6,3,39804,39804,39807,0,3,5
11421,6,1,39810,39810,39811,0,1,3
11422,2,1,39812,39812,39813,0,1,1
11423,6,2,39818,39818,39820,0,2,5
11424,3,1,39821,39821,39822,0,1,1
11425,5,1,39826,39826,39827,0,1,4
11426,3,3,39829,39829,39832,0,3,2
11427,3,1,39832,39832,39833,0,1,0
11428,5,1,39837,39837,39838,0,1,4
11429,3,1,39840,39840,39841,0,1,2
11430,4,1,39844,39844,39845,0,1,3
11431,4,3,39848,39848,39851,0,3,3
11432,2,3,39850,39851,39854,1,4,0
11433,3,2,39853,39854,39856,1,3,0
11434,6,3,39859,39859,39862,0,3,3
11435,3,3,39862,39862,39865,0,3,0
11436,3,3,39865,39865,39868,0,3,0
11437,6,1,39871,39871,39872,0,1,3
11438,1,3,39872,39872,39875,0,3,0
11439,4,2,39876,39876,39878,0,2,1
11440,6,3,39882,39882,39885,0,3,4
11441,2,2,39884,39885,39887,1,3,0
11442,6,2,39890,39890,39892,0,2,3
11443,6,2,39896,39896,39898,0,2,4
11444,2,1,39898,39898,39899,0,1,0
11445,3,2,39901,39901,39903,0,2,2
11446,6,2,39907,39907,39909,0,2,4
11447,1,3,39908,39909,39912,1,4,0
11448,6,1,39914,39914,39915,0,1,2
11449,5,1,39919,39919,39920,0,1,4
11450,4,3,39923,39923,39926,0,3,3
11451,2,2,39925,39926,39928,1,3,0
11452,1,1,39926,39928,39929,2,3,0
11453,3,3,39929,39929,39932,0,3,0
11454,5,1,39934,39934,39935,0,1,2
11455,5,1,39939,39939,39940,0,1,4
11456,6,1,39945,39945,39946,0,1,5
11457,5,1,39950,39950,39951,0,1,4
11458,3,2,39953,39953,39955,0,2,2
11459,3,3,39956,39956,39959,0,3,1
11460,3,1,39959,39959,39960,0,1,0
11461,6,3,39965,39965,39968,0,3,5
11462,6,1,39971,39971,39972,0,1,3
11463,4,2,39975,39975,39977,0,2,3
11464,3,1,39978,39978,39979,0,1,1
11465,5,1,39983,39983,39984,0,1,4
11466,2,3,39985,39985,39988,0,3,1
11467,2,2,39987,39988,39990,1,3,0
11468,2,1,39989,39990,39991,1,2,0
11469,2,3,39991,39991,39994,0,3,0
11470,5,2,39996,39996,39998,0,2,2
11471,3,3,39999,39999,40002,0,3,1
11472,5,2,40004,40004,40006,0,2,2
11473,4,2,40008,40008,40010,0,2,2
11474,3,1,40011,40011,40012,0,1,1
11475,6,2,40017,40017,40019,0,2,5
11476,1,3,40018,40019,40022,1,4,0
11477,2,2,40020,40022,40024,2,4,0
11478,5,3,40025,40025,40028,0,3,1
11479,4,2,40029,40029,40031,0,2,1
11480,1,2,40030,40031,40033,1,3,0
11481,5,2,40035,40035,40037,0,2,2
11482,1,2,40036,40037,40039,1,3,0
11483,2,1,40038,40039,40040,1,2,0
11484,5,3,40043,40043,40046,0,3,3
11485,6,3,40049,40049,40052,0,3,3
11486,2,2,40051,40052,40054,1,3,0
11487,6,2,40057,40057,40059,0,2,3
11488,5,1,40062,40062,40063,0,1,3
11489,6,2,40068,40068,40070,0,2,5
11490,2,1,40070,40070,40071,0,1,0
11491,3,3,40073,40073,40076,0,3,2
11492,1,2,40074,40076,40078,2,4,0
11493,5,2,40079,40079,40081,0,2,1
11494,2,2,40081,40081,40083,0,2,0
11495,5,3,40086,40086,40089,0,3,3
11496,3,1,40089,40089,40090,0,1,0
11497,1,2,40090,40090,40092,0,2,0
11498,1,2,40091,40092,40094,1,3,0
11499,1,1,40092,40094,40095,2,3,0
11500,4,1,40096,40096,40097,0,1,1
11501,4,2,40100,40100,40102,0,2,3
11502,4,2,40104,40104,40106,0,2,2
11503,2,2,40106,40106,40108,0,2,0
11504,5,2,40111,40111,40113,0,2,3
11505,6,1,40117,40117,40118,0,1,4
11506,3,1,40120,40120,40121,0,1,2
11507,6,3,40126,40126,40129,0,3,5
11508,4,1,40130,40130,40131,0,1,1
11509,2,1,40132,40132,40133,0,1,1
11510,6,3,40138,40138,40141,0,3,5
11511,2,1,40140,40141,40142,1,2,0
11512,5,3,40145,40145,40148,0,3,3
11513,3,1,40148,40148,40149,0,1,0
11514,2,1,40150,40150,40151,0,1,1
11515,6,2,40156,40156,40158,0,2,5
11516,3,2,40159,40159,40161,0,2,1
11517,3,1,40162,40162,40163,0,1,1
11518,3,2,40165,40165,40167,0,2,2
11519,6,3,40171,40171,40174,0,3,4
11520,5,3,40176,40176,40179,0,3,2
11521,3,2,40179,40179,40181,0,2,0
11522,1,1,40180,40181,40182,1,2,0
11523,3,1,40183,40183,40184,0,1,1
11524,5,3,40188,40188,40191,0,3,4
11525,6,2,40194,40194,40196,0,2,3
11526,1,2,40195,40196,40198,1,3,0
11527,3,2,40198,40198,40200,0,2,0
11528,6,2,40204,40204,40206,0,2,4
11529,1,3,40205,40206,40209,1,4,0
11530,3,2,40208,40209,40211,1,3,0
11531,6,1,40214,40214,40215,0,1,3
11532,2,1,40216,40216,40217,0,1,1
11533,3,1,40219,40219,40220,0,1,2
11534,6,1,40225,40225,40226,0,1,5
11535,6,3,40231,40231,40234,0,3,5
11536,4,3,40235,40235,40238,0,3,1
11537,4,1,40239,40239,40240,0,1,1
11538,5,1,40244,40244,40245,0,1,4
11539,5,2,40249,40249,40251,0,2,4
11540,2,3,40251,40251,40254,0,3,0
11541,1,2,40252,40254,40256,2,4,0
11542,2,3,40254,40256,40259,2,5,0
11543,2,1,40256,40259,40260,3,4,0
11544,4,2,40260,40260,40262,0,2,0
11545,3,1,40263,40263,40264,0,1,1
11546,6,3,40269,40269,40272,0,3,5
11547,4,2,40273,40273,40275,0,2,1
11548,3,3,40276,40276,40279,0,3,1
11549,5,3,40281,40281,40284,0,3,2
11550,6,1,40287,40287,40288,0,1,3
11551,1,2,40288,40288,40290,0,2,0
11552,1,2,40289,40290,40292,1,3,0
11553,1,1,40290,40292,40293,2,3,0
11554,6,1,40296,40296,40297,0,1,3
11555,1,1,40297,40297,40298,0,1,0
11556,4,1,40301,40301,40302,0,1,3
11557,1,3,40302,40302,40305,0,3,0
11558,2,3,40304,40305,40308,1,4,0
11559,1,3,40305,40308,40311,3,6,0
11560,4,3,40309,40311,40314,2,5,0
11561,5,1,40314,40314,40315,0,1,0
11562,5,3,40319,40319,40322,0,3,4
11563,4,3,40323,40323,40326,0,3,1
11564,2,3,40325,40326,40329,1,4,0
11565,2,3,40327,40329,40332,2,5,0
11566,2,2,40329,40332,40334,3,5,0
11567,1,1,40330,40334,40335,4,5,0
11568,5,1,40335,40335,40336,0,1,0
11569,6,1,40341,40341,40342,0,1,5
11570,6,2,40347,40347,40349,0,2,5
11571,4,2,40351,40351,40353,0,2,2
11572,2,2,40353,40353,40355,0,2,0
11573,1,3,40354,40355,40358,1,4,0
11574,4,1,40358,40358,40359,0,1,0
11575,1,1,40359,40359,40360,0,1,0
11576,1,2,40360,40360,40362,0,2,0
11577,1,2,40361,40362,40364,1,3,0
11578,3,2,40364,40364,40366,0,2,0
11579,2,3,40366,40366,40369,0,3,0
11580,6,3,40372,40372,40375,0,3,3
11581,6,2,40378,40378,40380,0,2,3
11582,3,2,40381,40381,40383,0,2,1
11583,6,3,40387,40387,40390,0,3,4
11584,2,3,40389,40390,40393,1,4,0
11585,2,3,40391,40393,40396,2,5,0
11586,3,1,40394,40396,40397,2,3,0
11587,4,3,40398,40398,40401,0,3,1
11588,1,3,40399,40401,40404,2,5,0
11589,2,2,40401,40404,40406,3,5,0
11590,4,2,40405,40406,40408,1,3,0
11591,4,3,40409,40409,40412,0,3,1
11592,1,1,40410,40412,40413,2,3,0
11593,3,2,40413,40413,40415,0,2,0
11594,4,2,40417,40417,40419,0,2,2
11595,3,2,40420,40420,40422,0,2,1
11596,4,2,40424,40424,40426,0,2,2
11597,3,3,40427,40427,40430,0,3,1
11598,5,3,40432,40432,40435,0,3,2
11599,1,2,40433,40435,40437,2,4,0
11600,3,3,40436,40437,40440,1,4,0
11601,6,2,40442,40442,40444,0,2,2
11602,3,2,40445,40445,40447,0,2,1
11603,2,3,40447,40447,40450,0,3,0
11604,1,3,40448,40450,40453,2,5,0
11605,6,1,40454,40454,40455,0,1,1
11606,5,3,40459,40459,40462,0,3,4
11607,5,1,40464,40464,40465,0,1,2
11608,3,2,40467,40467,40469,0,2,2
11609,2,2,40469,40469,40471,0,2,0
11610,1,2,40470,40471,40473,1,3,0
11611,3,2,40473,40473,40475,0,2,0
11612,4,2,40477,40477,40479,0,2,2
11613,6,2,40483,40483,40485,0,2,4
11614,1,1,40484,40485,40486,1,2,0
11615,1,2,40485,40486,40488,1,3,0
11616,4,1,40489,40489,40490,0,1,1
11617,6,3,40495,40495,40498,0,3,5
11618,5,3,40500,40500,40503,0,3,2
11619,3,1,40503,40503,40504,0,1,0
11620,4,1,40507,40507,40508,0,1,3
11621,4,3,40511,40511,40514,0,3,3
11622,1,3,40512,40514,40517,2,5,0
11623,2,2,40514,40517,40519,3,5,0
11624,6,1,40520,40520,40521,0,1,1
11625,6,3,40526,40526,40529,0,3,5
11626,5,2,40531,40531,40533,0,2,2
11627,3,3,40534,40534,40537,0,3,1
11628,1,3,40535,40537,40540,2,5,0
11629,1,2,40536,40540,40542,4,6,0
11630,3,3,40539,40542,40545,3,6,0
11631,5,3,40544,40545,40548,1,4,0
11632,2,2,40546,40548,40550,2,4,0
11633,1,2,40547,40550,40552,3,5,0
11634,1,2,40548,40552,40554,4,6,0
11635,2,3,40550,40554,40557,4,7,0
11636,6,3,40556,40557,40560,1,4,0
11637,2,1,40558,40560,40561,2,3,0
11638,2,1,40560,40561,40562,1,2,0
11639,5,1,40565,40565,40566,0,1,3
11640,3,3,40568,40568,40571,0,3,2
11641,2,2,40570,40571,40573,1,3,0
11642,3,1,40573,40573,40574,0,1,0
11643,2,1,40575,40575,40576,0,1,1
11644,4,1,40579,40579,40580,0,1,3
11645,5,3,40584,40584,40587,0,3,4
11646,3,2,40587,40587,40589,0,2,0
11647,1,1,40588,40589,40590,1,2,0
11648,3,1,40591,40591,40592,0,1,1
11649,3,1,40594,40594,40595,0,1,2
11650,2,3,40596,40596,40599,0,3,1
11651,5,3,40601,40601,40604,0,3,2
11652,4,1,40605,40605,40606,0,1,1
11653,4,1,40609,40609,40610,0,1,3
11654,2,1,40611,40611,40612,0,1,1
11655,1,3,40612,40612,40615,0,3,0
11656,5,3,40617,40617,40620,0,3,2
11657,3,1,40620,40620,40621,0,1,0
11658,4,1,40624,40624,40625,0,1,3
11659,3,1,40627,40627,40628,0,1,2
11660,1,1,40628,40628,40629,0,1,0
11661,3,1,40631,40631,40632,0,1,2
11662,4,3,40635,40635,40638,0,3,3
11663,2,1,40637,40638,40639,1,2,0
11664,6,2,40643,40643,40645,0,2,4
11665,1,3,40644,40645,40648,1,4,0
11666,2,1,40646,40648,40649,2,3,0
11667,6,1,40652,40652,40653,0,1,3
11668,5,1,40657,40657,40658,0,1,4
11669,6,1,40663,40663,40664,0,1,5
11670,5,2,40668,40668,40670,0,2,4
11671,1,1,40669,40670,40671,1,2,0
11672,3,1,40672,40672,40673,0,1,1
11673,2,1,40674,40674,40675,0,1,1
11674,6,1,40680,40680,40681,0,1,5
11675,6,2,40686,40686,40688,0,2,5
11676,6,3,40692,40692,40695,0,3,4
11677,1,3,40693,40695,40698,2,5,0
11678,6,2,40699,40699,40701,0,2,1
11679,1,1,40700,40701,40702,1,2,0
11680,3,3,40703,40703,40706,0,3,1
11681,3,2,40706,40706,40708,0,2,0
11682,1,1,40707,40708,40709,1,2,0
11683,5,2,40712,40712,40714,0,2,3
11684,1,2,40713,40714,40716,1,3,0
11685,1,1,40714,40716,40717,2,3,0
11686,2,3,40716,40717,40720,1,4,0
11687,4,1,40720,40720,40721,0,1,0
11688,2,2,40722,40722,40724,0,2,1
11689,3,3,40725,40725,40728,0,3,1
11690,1,2,40726,40728,40730,2,4,0
11691,5,1,40731,40731,40732,0,1,1
11692,2,3,40733,40733,40736,0,3,1
11693,3,3,40736,40736,40739,0,3,0
11694,4,2,40740,40740,40742,0,2,1
11695,2,2,40742,40742,40744,0,2,0
11696,6,3,40748,40748,40751,0,3,4
11697,1,3,40749,40751,40754,2,5,0
11698,1,1,40750,40754,40755,4,5,0
11699,4,3,40754,40755,40758,1,4,0
11700,4,3,40758,40758,40761,0,3,0
11701,4,1,40762,40762,40763,0,1,1
11702,3,3,40765,40765,40768,0,3,2
11703,6,1,40771,40771,40772,0,1,3
11704,6,3,40777,40777,40780,0,3,5
11705,2,3,40779,40780,40783,1,4,0
11706,6,1,40785,40785,40786,0,1,2
11707,4,1,40789,40789,40790,0,1,3
11708,1,1,40790,40790,40791,0,1,0
11709,1,2,40791,40791,40793,0,2,0
11710,4,2,40795,40795,40797,0,2,2
11711,4,1,40799,40799,40800,0,1,2
11712,2,2,40801,40801,40803,0,2,1
11713,6,1,40807,40807,40808,0,1,4
11714,3,3,40810,40810,40813,0,3,2
11715,4,3,40814,40814,40817,0,3,1
11716,1,1,40815,40817,40818,2,3,0
11717,6,2,40821,40821,40823,0,2,3
11718,6,1,40827,40827,40828,0,1,4
11719,6,2,40833,40833,40835,0,2,5
11720,1,1,40834,40835,40836,1,2,0
11721,1,3,40835,40836,40839,1,4,0
11722,1,3,40836,40839,40842,3,6,0
11723,6,1,40842,40842,40843,0,1,0
11724,1,3,40843,40843,40846,0,3,0
11725,2,3,40845,40846,40849,1,4,0
11726,4,1,40849,40849,40850,0,1,0
11727,1,1,40850,40850,40851,0,1,0
11728,4,3,40854,40854,40857,0,3,3
11729,4,2,40858,40858,40860,0,2,1
11730,5,1,40863,40863,40864,0,1,3
11731,3,3,40866,40866,40869,0,3,2
11732,2,1,40868,40869,40870,1,2,0
11733,3,3,40871,40871,40874,0,3,1
11734,2,2,40873,40874,40876,1,3,0
11735,4,1,40877,40877,40878,0,1,1
11736,6,3,40883,40883,40886,0,3,5
11737,6,1,40889,40889,40890,0,1,3
11738,2,3,40891,40891,40894,0,3,1
11739,2,2,40893,40894,40896,1,3,0
11740,1,1,40894,40896,40897,2,3,0
11741,4,1,40898,40898,40899,0,1,1
11742,6,2,40904,40904,40906,0,2,5
11743,1,1,40905,40906,40907,1,2,0
11744,2,1,40907,40907,40908,0,1,0
11745,3,3,40910,40910,40913,0,3,2
11746,5,3,40915,40915,40918,0,3,2
11747,6,2,40921,40921,40923,0,2,3
11748,4,1,40925,40925,40926,0,1,2
11749,2,3,40927,40927,40930,0,3,1
11750,3,2,40930,40930,40932,0,2,0
11751,2,1,40932,40932,40933,0,1,0
11752,1,1,40933,40933,40934,0,1,0
11753,5,2,40938,40938,40940,0,2,4
11754,2,2,40940,40940,40942,0,2,0
11755,2,1,40942,40942,40943,0,1,0
11756,5,2,40947,40947,40949,0,2,4
11757,1,3,40948,40949,40952,1,4,0
11758,4,3,40952,40952,40955,0,3,0
11759,5,2,40957,40957,40959,0,2,2
11760,6,1,40963,40963,40964,0,1,4
11761,4,1,40967,40967,40968,0,1,3
11762,5,1,40972,40972,40973,0,1,4
11763,1,3,40973,40973,40976,0,3,0
11764,6,3,40979,40979,40982,0,3,3
11765,5,3,40984,40984,40987,0,3,2
11766,6,3,40990,40990,40993,0,3,3
11767,1,1,40991,40993,40994,2,3,0
11768,1,3,40992,40994,40997,2,5,0
11769,4,3,40996,40997,41000,1,4,0
11770,6,1,41002,41002,41003,0,1,2
11771,2,1,41004,41004,41005,0,1,1
11772,1,1,41005,41005,41006,0,1,0
11773,4,3,41009,41009,41012,0,3,3
11774,5,3,41014,41014,41017,0,3,2
11775,5,2,41019,41019,41021,0,2,2
11776,5,1,41024,41024,41025,0,1,3
11777,2,1,41026,41026,41027,0,1,1
11778,3,1,41029,41029,41030,0,1,2
11779,1,1,41030,41030,41031,0,1,0
11780,1,1,41031,41031,41032,0,1,0
11781,1,2,41032,41032,41034,0,2,0
11782,6,1,41038,41038,41039,0,1,4
11783,2,2,41040,41040,41042,0,2,1
11784,1,1,41041,41042,41043,1,2,0
11785,5,3,41046,41046,41049,0,3,3
11786,3,3,41049,41049,41052,0,3,0
11787,2,1,41051,41052,41053,1,2,0
11788,3,2,41054,41054,41056,0,2,1
11789,4,2,41058,41058,41060,0,2,2
11790,4,3,41062,41062,41065,0,3,2
11791,2,3,41064,41065,41068,1,4,0
11792,4,1,41068,41068,41069,0,1,0
11793,4,3,41072,41072,41075,0,3,3
11794,5,2,41077,41077,41079,0,2,2
11795,4,1,41081,41081,41082,0,1,2
11796,3,3,41084,41084,41087,0,3,2
11797,4,3,41088,41088,41091,0,3,1
11798,2,3,41090,41091,41094,1,4,0
11799,5,3,41095,41095,41098,0,3,1
11800,6,1,41101,41101,41102,0,1,3
11801,3,2,41104,41104,41106,0,2,2
11802,4,2,41108,41108,41110,0,2,2
11803,6,3,41114,41114,41117,0,3,4
11804,1,1,41115,41117,41118,2,3,0
11805,2,2,41117,41118,41120,1,3,0
11806,6,2,41123,41123,41125,0,2,3
11807,2,1,41125,41125,41126,0,1,0
11808,4,2,41129,41129,41131,0,2,3
11809,3,2,41132,41132,41134,0,2,1
11810,2,1,41134,41134,41135,0,1,0
11811,2,3,41136,41136,41139,0,3,1
11812,4,3,41140,41140,41143,0,3,1
11813,3,3,41143,41143,41146,0,3,0
11814,1,2,41144,41146,41148,2,4,0
11815,4,1,41148,41148,41149,0,1,0
11816,5,1,41153,41153,41154,0,1,4
11817,3,1,41156,41156,41157,0,1,2
11818,6,2,41162,41162,41164,0,2,5
11819,6,2,41168,41168,41170,0,2,4
11820,1,2,41169,41170,41172,1,3,0
11821,4,1,41173,41173,41174,0,1,1
11822,2,1,41175,41175,41176,0,1,1
11823,5,1,41180,41180,41181,0,1,4
11824,2,3,41182,41182,41185,0,3,1
11825,2,1,41184,41185,41186,1,2,0
11826,2,2,41186,41186,41188,0,2,0
11827,6,1,41192,41192,41193,0,1,4
11828,3,2,41195,41195,41197,0,2,2
11829,3,2,41198,41198,41200,0,2,1
11830,2,1,41200,41200,41201,0,1,0
11831,3,1,41203,41203,41204,0,1,2
11832,5,1,41208,41208,41209,0,1,4
11833,4,1,41212,41212,41213,0,1,3
11834,1,1,41213,41213,41214,0,1,0
11835,5,2,41218,41218,41220,0,2,4
11836,3,2,41221,41221,41223,0,2,1
11837,4,3,41225,41225,41228,0,3,2
11838,2,3,41227,41228,41231,1,4,0
11839,6,3,41233,41233,41236,0,3,2
11840,1,1,41234,41236,41237,2,3,0
11841,2,3,41236,41237,41240,1,4,0
11842,1,2,41237,41240,41242,3,5,0
11843,4,3,41241,41242,41245,1,4,0
11844,2,2,41243,41245,41247,2,4,0
11845,4,3,41247,41247,41250,0,3,0
11846,6,1,41253,41253,41254,0,1,3
11847,4,2,41257,41257,41259,0,2,3
11848,5,3,41262,41262,41265,0,3,3
11849,4,1,41266,41266,41267,0,1,1
11850,2,3,41268,41268,41271,0,3,1
11851,6,1,41274,41274,41275,0,1,3
11852,4,1,41278,41278,41279,0,1,3
11853,4,3,41282,41282,41285,0,3,3
11854,1,3,41283,41285,41288,2,5,0
11855,6,3,41289,41289,41292,0,3,1
11856,4,1,41293,41293,41294,0,1,1
11857,2,3,41295,41295,41298,0,3,1
11858,3,1,41298,41298,41299,0,1,0
11859,1,1,41299,41299,41300,0,1,0
11860,4,3,41303,41303,41306,0,3,3
11861,4,1,41307,41307,41308,0,1,1
11862,2,3,41309,41309,41312,0,3,1
11863,2,1,41311,41312,41313,1,2,0
11864,2,2,41313,41313,41315,0,2,0
11865,3,3,41316,41316,41319,0,3,1
11866,6,3,41322,41322,41325,0,3,3
11867,3,3,41325,41325,41328,0,3,0
11868,1,3,41326,41328,41331,2,5,0
11869,3,3,41329,41331,41334,2,5,0
11870,1,3,41330,41334,41337,4,7,0
11871,1,2,41331,41337,41339,6,8,0
11872,1,3,41332,41339,41342,7,10,0
11873,3,3,41335,41342,41345,7,10,0
11874,1,3,41336,41345,41348,9,12,0
11875,2,2,41338,41348,41350,10,12,0
11876,2,3,41340,41350,41353,10,13,0
11877,4,3,41344,41353,41356,9,12,0
11878,4,2,41348,41356,41358,8,10,0
11879,4,3,41352,41358,41361,6,9,0
11880,5,2,41357,41361,41363,4,6,0
11881,2,2,41359,41363,41365,4,6,0
11882,6,1,41365,41365,41366,0,1,0
11883,6,1,41371,41371,41372,0,1,5
11884,6,1,41377,41377,41378,0,1,5
11885,3,2,41380,41380,41382,0,2,2
11886,1,2,41381,41382,41384,1,3,0
11887,4,2,41385,41385,41387,0,2,1
11888,6,1,41391,41391,41392,0,1,4
11889,5,1,41396,41396,41397,0,1,4
11890,4,2,41400,41400,41402,0,2,3
11891,5,1,41405,41405,41406,0,1,3
11892,5,3,41410,41410,41413,0,3,4
11893,4,1,41414,41414,41415,0,1,1
11894,4,3,41418,41418,41421,0,3,3
11895,1,3,41419,41421,41424,2,5,0
11896,5,2,41424,41424,41426,0,2,0
11897,5,2,41429,41429,41431,0,2,3
11898,5,1,41434,41434,41435,0,1,3
11899,4,2,41438,41438,41440,0,2,3
11900,1,3,41439,41440,41443,1,4,0
11901,3,3,41442,41443,41446,1,4,0
11902,6,1,41448,41448,41449,0,1,2
11903,4,2,41452,41452,41454,0,2,3
11904,4,1,41456,41456,41457,0,1,2
11905,2,1,41458,41458,41459,0,1,1
11906,2,2,41460,41460,41462,0,2,1
11907,2,2,41462,41462,41464,0,2,0
11908,2,2,41464,41464,41466,0,2,0
11909,3,2,41467,41467,41469,0,2,1
11910,5,1,41472,41472,41473,0,1,3
11911,2,1,41474,41474,41475,0,1,1
11912,5,1,41479,41479,41480,0,1,4
11913,4,2,41483,41483,41485,0,2,3
11914,5,1,41488,41488,41489,0,1,3
11915,4,2,41492,41492,41494,0,2,3
11916,6,2,41498,41498,41500,0,2,4
11917,6,2,41504,41504,41506,0,2,4
11918,5,1,41509,41509,41510,0,1,3
11919,1,1,41510,41510,41511,0,1,0
11920,1,1,41511,41511,41512,0,1,0
11921,4,1,41515,41515,41516,0,1,3
11922,2,3,41517,41517,41520,0,3,1
11923,4,1,41521,41521,41522,0,1,1
11924,4,3,41525,41525,41528,0,3,3
11925,6,1,41531,41531,41532,0,1,3
11926,6,2,41537,41537,41539,0,2,5
11927,6,1,41543,41543,41544,0,1,4
11928,2,1,41545,41545,41546,0,1,1
11929,4,2,41549,41549,41551,0,2,3
11930,3,1,41552,41552,41553,0,1,1
11931,4,1,41556,41556,41557,0,1,3
11932,5,3,41561,41561,41564,0,3,4
11933,6,2,41567,41567,41569,0,2,3
11934,1,1,41568,41569,41570,1,2,0
11935,2,3,41570,41570,41573,0,3,0
11936,1,2,41571,41573,41575,2,4,0
11937,1,1,41572,41575,41576,3,4,0
11938,6,1,41578,41578,41579,0,1,2
11939,3,2,41581,41581,41583,0,2,2
11940,5,1,41586,41586,41587,0,1,3
11941,6,2,41592,41592,41594,0,2,5
11942,6,2,41598,41598,41600,0,2,4
11943,1,1,41599,41600,41601,1,2,0
11944,4,1,41603,41603,41604,0,1,2
11945,5,3,41608,41608,41611,0,3,4
11946,3,1,41611,41611,41612,0,1,0
11947,5,1,41616,41616,41617,0,1,4
11948,3,1,41619,41619,41620,0,1,2
11949,4,2,41623,41623,41625,0,2,3
11950,6,3,41629,41629,41632,0,3,4
11951,1,1,41630,41632,41633,2,3,0
11952,4,3,41634,41634,41637,0,3,1
11953,6,1,41640,41640,41641,0,1,3
11954,4,1,41644,41644,41645,0,1,3
11955,2,1,41646,41646,41647,0,1,1
11956,4,2,41650,41650,41652,0,2,3
11957,3,2,41653,41653,41655,0,2,1
11958,6,3,41659,41659,41662,0,3,4
11959,6,3,41665,41665,41668,0,3,3
11960,6,3,41671,41671,41674,0,3,3
11961,1,2,41672,41674,41676,2,4,0
11962,4,2,41676,41676,41678,0,2,0
11963,5,2,41681,41681,41683,0,2,3
11964,3,3,41684,41684,41687,0,3,1
11965,5,3,41689,41689,41692,0,3,2
11966,3,2,41692,41692,41694,0,2,0
11967,1,3,41693,41694,41697,1,4,0
11968,1,2,41694,41697,41699,3,5,0
11969,4,3,41698,41699,41702,1,4,0
11970,5,1,41703,41703,41704,0,1,1
11971,1,3,41704,41704,41707,0,3,0
11972,6,1,41710,41710,41711,0,1,3
11973,1,1,41711,41711,41712,0,1,0
11974,4,2,41715,41715,41717,0,2,3
11975,2,2,41717,41717,41719,0,2,0
11976,2,1,41719,41719,41720,0,1,0
11977,3,1,41722,41722,41723,0,1,2
11978,2,1,41724,41724,41725,0,1,1
11979,4,2,41728,41728,41730,0,2,3
11980,6,1,41734,41734,41735,0,1,4
11981,6,3,41740,41740,41743,0,3,5
11982,5,3,41745,41745,41748,0,3,2
11983,1,2,41746,41748,41750,2,4,0
11984,4,1,41750,41750,41751,0,1,0
11985,2,1,41752,41752,41753,0,1,1
11986,1,3,41753,41753,41756,0,3,0
11987,6,2,41759,41759,41761,0,2,3
11988,6,3,41765,41765,41768,0,3,4
11989,6,1,41771,41771,41772,0,1,3
11990,4,3,41775,41775,41778,0,3,3
11991,4,1,41779,41779,41780,0,1,1
11992,6,2,41785,41785,41787,0,2,5
11993,5,3,41790,41790,41793,0,3,3
11994,2,2,41792,41793,41795,1,3,0
11995,6,3,41798,41798,41801,0,3,3
11996,1,2,41799,41801,41803,2,4,0
11997,5,2,41804,41804,41806,0,2,1
11998,5,2,41809,41809,41811,0,2,3
11999,5,3,41814,41814,41817,0,3,3
12000,6,3,41820,41820,41823,0,3,3
12001,5,3,41825,41825,41828,0,3,2
12002,1,1,41826,41828,41829,2,3,0
12003,4,2,41830,41830,41832,0,2,1
12004,2,3,41832,41832,41835,0,3,0
12005,1,3,41833,41835,41838,2,5,0
12006,1,3,41834,41838,41841,4,7,0
12007,4,1,41838,41841,41842,3,4,0
12008,3,3,41841,41842,41845,1,4,0
12009,6,1,41847,41847,41848,0,1,2
12010,4,2,41851,41851,41853,0,2,3
12011,6,1,41857,41857,41858,0,1,4
12012,1,2,41858,41858,41860,0,2,0
12013,5,2,41863,41863,41865,0,2,3
12014,6,3,41869,41869,41872,0,3,4
12015,5,1,41874,41874,41875,0,1,2
12016,2,1,41876,41876,41877,0,1,1
12017,1,2,41877,41877,41879,0,2,0
12018,3,1,41880,41880,41881,0,1,1
12019,2,3,41882,41882,41885,0,3,1
12020,1,1,41883,41885,41886,2,3,0
12021,5,3,41888,41888,41891,0,3,2
12022,3,2,41891,41891,41893,0,2,0
12023,3,2,41894,41894,41896,0,2,1
12024,6,3,41900,41900,41903,0,3,4
12025,6,3,41906,41906,41909,0,3,3
12026,6,3,41912,41912,41915,0,3,3
12027,1,2,41913,41915,41917,2,4,0
12028,1,1,41914,41917,41918,3,4,0
12029,3,2,41917,41918,41920,1,3,0
12030,3,1,41920,41920,41921,0,1,0
12031,2,2,41922,41922,41924,0,2,1
12032,6,1,41928,41928,41929,0,1,4
12033,6,2,41934,41934,41936,0,2,5
12034,2,3,41936,41936,41939,0,3,0
12035,3,1,41939,41939,41940,0,1,0
12036,5,1,41944,41944,41945,0,1,4
12037,2,1,41946,41946,41947,0,1,1
12038,6,3,41952,41952,41955,0,3,5
12039,2,1,41954,41955,41956,1,2,0
12040,2,2,41956,41956,41958,0,2,0
12041,2,2,41958,41958,41960,0,2,0
12042,3,2,41961,41961,41963,0,2,1
12043,1,1,41962,41963,41964,1,2,0
12044,2,1,41964,41964,41965,0,1,0
12045,3,1,41967,41967,41968,0,1,2
12046,2,3,41969,41969,41972,0,3,1
12047,3,2,41972,41972,41974,0,2,0
12048,3,2,41975,41975,41977,0,2,1
12049,1,2,41976,41977,41979,1,3,0
12050,1,1,41977,41979,41980,2,3,0
12051,3,1,41980,41980,41981,0,1,0
12052,2,1,41982,41982,41983,0,1,1
12053,1,1,41983,41983,41984,0,1,0
12054,4,3,41987,41987,41990,0,3,3
12055,5,3,41992,41992,41995,0,3,2
12056,1,2,41993,41995,41997,2,4,0
12057,4,2,41997,41997,41999,0,2,0
12058,6,1,42003,42003,42004,0,1,4
12059,4,3,42007,42007,42010,0,3,3
12060,1,2,42008,42010,42012,2,4,0
12061,1,2,42009,42012,42014,3,5,0
12062,6,1,42015,42015,42016,0,1,1
12063,3,2,42018,42018,42020,0,2,2
12064,4,3,42022,42022,42025,0,3,2
12065,1,2,42023,42025,42027,2,4,0
12066,1,2,42024,42027,42029,3,5,0
12067,4,2,42028,42029,42031,1,3,0
12068,4,2,42032,42032,42034,0,2,1
12069,2,2,42034,42034,42036,0,2,0
12070,1,2,42035,42036,42038,1,3,0
12071,6,3,42041,42041,42044,0,3,3
12072,5,3,42046,42046,42049,0,3,2
12073,2,1,42048,42049,42050,1,2,0
12074,3,3,42051,42051,42054,0,3,1
12075,1,1,42052,42054,42055,2,3,0
12076,5,2,42057,42057,42059,0,2,2
12077,3,1,42060,42060,42061,0,1,1
12078,4,3,42064,42064,42067,0,3,3
12079,1,2,42065,42067,42069,2,4,0
12080,6,3,42071,42071,42074,0,3,2
12081,2,3,42073,42074,42077,1,4,0
12082,4,3,42077,42077,42080,0,3,0
12083,4,2,42081,42081,42083,0,2,1
12084,2,3,42083,42083,42086,0,3,0
12085,6,1,42089,42089,42090,0,1,3
12086,2,1,42091,42091,42092,0,1,1
12087,1,3,42092,42092,42095,0,3,0
12088,6,2,42098,42098,42100,0,2,3
12089,1,3,42099,42100,42103,1,4,0
12090,1,3,42100,42103,42106,3,6,0
12091,1,2,42101,42106,42108,5,7,0
12092,4,1,42105,42108,42109,3,4,0
12093,3,2,42108,42109,42111,1,3,0
12094,2,3,42110,42111,42114,1,4,0
12095,5,3,42115,42115,42118,0,3,1
12096,1,2,42116,42118,42120,2,4,0
12097,3,1,42119,42120,42121,1,2,0
12098,4,3,42123,42123,42126,0,3,2
12099,1,1,42124,42126,42127,2,3,0
12100,5,3,42129,42129,42132,0,3,2
12101,3,2,42132,42132,42134,0,2,0
12102,6,2,42138,42138,42140,0,2,4
12103,2,3,42140,42140,42143,0,3,0
12104,4,1,42144,42144,42145,0,1,1
12105,6,2,42150,42150,42152,0,2,5
12106,1,1,42151,42152,42153,1,2,0
12107,2,2,42153,42153,42155,0,2,0
12108,4,2,42157,42157,42159,0,2,2
12109,6,2,42163,42163,42165,0,2,4
12110,5,1,42168,42168,42169,0,1,3
12111,4,3,42172,42172,42175,0,3,3
12112,4,1,42176,42176,42177,0,1,1
12113,3,3,42179,42179,42182,0,3,2
12114,3,3,42182,42182,42185,0,3,0
12115,1,2,42183,42185,42187,2,4,0
12116,2,3,42185,42187,42190,2,5,0
12117,6,1,42191,42191,42192,0,1,1
12118,4,1,42195,42195,42196,0,1,3
12119,5,3,42200,42200,42203,0,3,4
12120,3,2,42203,42203,42205,0,2,0
12121,5,2,42208,42208,42210,0,2,3
12122,2,2,42210,42210,42212,0,2,0
12123,1,2,42211,42212,42214,1,3,0
12124,1,2,42212,42214,42216,2,4,0
12125,4,2,42216,42216,42218,0,2,0
12126,4,3,42220,42220,42223,0,3,2
12127,2,3,42222,42223,42226,1,4,0
12128,1,3,42223,42226,42229,3,6,0
12129,4,1,42227,42229,42230,2,3,0
12130,1,1,42228,42230,42231,2,3,0
12131,1,3,42229,42231,42234,2,5,0
12132,5,2,42234,42234,42236,0,2,0
12133,4,2,42238,42238,42240,0,2,2
12134,6,2,42244,42244,42246,0,2,4
12135,5,2,42249,42249,42251,0,2,3
12136,6,2,42255,42255,42257,0,2,4
12137,3,1,42258,42258,42259,0,1,1
12138,5,2,42263,42263,42265,0,2,4
12139,5,2,42268,42268,42270,0,2,3
12140,1,1,42269,42270,42271,1,2,0
12141,5,2,42274,42274,42276,0,2,3
12142,5,1,42279,42279,42280,0,1,3
12143,5,2,42284,42284,42286,0,2,4
12144,3,1,42287,42287,42288,0,1,1
12145,6,2,42293,42293,42295,0,2,5
12146,1,2,42294,42295,42297,1,3,0
12147,6,1,42300,42300,42301,0,1,3
12148,6,1,42306,42306,42307,0,1,5
12149,4,3,42310,42310,42313,0,3,3
12150,3,2,42313,42313,42315,0,2,0
12151,3,3,42316,42316,42319,0,3,1
12152,5,3,42321,42321,42324,0,3,2
12153,1,1,42322,42324,42325,2,3,0
12154,5,2,42327,42327,42329,0,2,2
12155,5,1,42332,42332,42333,0,1,3
12156,1,1,42333,42333,42334,0,1,0
12157,1,1,42334,42334,42335,0,1,0
12158,3,2,42337,42337,42339,0,2,2
12159,6,2,42343,42343,42345,0,2,4
12160,3,3,42346,42346,42349,0,3,1
12161,6,3,42352,42352,42355,0,3,3
12162,2,2,42354,42355,42357,1,3,0
12163,2,3,42356,42357,42360,1,4,0
12164,6,3,42362,42362,42365,0,3,2
12165,5,3,42367,42367,42370,0,3,2
12166,2,2,42369,42370,42372,1,3,0
12167,3,2,42372,42372,42374,0,2,0
12168,2,3,42374,42374,42377,0,3,0
12169,1,1,42375,42377,42378,2,3,0
12170,3,3,42378,42378,42381,0,3,0
12171,3,1,42381,42381,42382,0,1,0
12172,1,1,42382,42382,42383,0,1,0
12173,1,3,42383,42383,42386,0,3,0
12174,4,3,42387,42387,42390,0,3,1
12175,1,1,42388,42390,42391,2,3,0
12176,3,2,42391,42391,42393,0,2,0
12177,4,1,42395,42395,42396,0,1,2
12178,2,3,42397,42397,42400,0,3,1
12179,4,2,42401,42401,42403,0,2,1
12180,3,3,42404,42404,42407,0,3,1
12181,5,3,42409,42409,42412,0,3,2
12182,4,1,42413,42413,42414,0,1,1
12183,6,1,42419,42419,42420,0,1,5
12184,6,2,42425,42425,42427,0,2,5
12185,4,1,42429,42429,42430,0,1,2
12186,5,1,42434,42434,42435,0,1,4
12187,5,1,42439,42439,42440,0,1,4
12188,3,3,42442,42442,42445,0,3,2
12189,4,3,42446,42446,42449,0,3,1
12190,2,3,42448,42449,42452,1,4,0
12191,4,3,42452,42452,42455,0,3,0
12192,1,1,42453,42455,42456,2,3,0
12193,3,3,42456,42456,42459,0,3,0
12194,3,3,42459,42459,42462,0,3,0
12195,4,3,42463,42463,42466,0,3,1
12196,3,1,42466,42466,42467,0,1,0
12197,1,2,42467,42467,42469,0,2,0
12198,1,3,42468,42469,42472,1,4,0
12199,3,1,42471,42472,42473,1,2,0
12200,1,3,42472,42473,42476,1,4,0
12201,6,2,42478,42478,42480,0,2,2
12202,2,3,42480,42480,42483,0,3,0
12203,4,1,42484,42484,42485,0,1,1
12204,4,3,42488,42488,42491,0,3,3
12205,6,2,42494,42494,42496,0,2,3
12206,5,1,42499,42499,42500,0,1,3
12207,5,2,42504,42504,42506,0,2,4
12208,6,1,42510,42510,42511,0,1,4
12209,6,2,42516,42516,42518,0,2,5
12210,3,2,42519,42519,42521,0,2,1
12211,4,2,42523,42523,42525,0,2,2
12212,6,1,42529,42529,42530,0,1,4
12213,6,2,42535,42535,42537,0,2,5
12214,6,2,42541,42541,42543,0,2,4
12215,4,1,42545,42545,42546,0,1,2
12216,5,3,42550,42550,42553,0,3,4
12217,6,3,42556,42556,42559,0,3,3
12218,3,2,42559,42559,42561,0,2,0
12219,6,2,42565,42565,42567,0,2,4
12220,1,3,42566,42567,42570,1,4,0
12221,4,1,42570,42570,42571,0,1,0
12222,6,1,42576,42576,42577,0,1,5
12223,4,3,42580,42580,42583,0,3,3
12224,4,3,42584,42584,42587,0,3,1
12225,1,2,42585,42587,42589,2,4,0
12226,1,3,42586,42589,42592,3,6,0
12227,1,3,42587,42592,42595,5,8,0
12228,2,2,42589,42595,42597,6,8,0
12229,1,1,42590,42597,42598,7,8,0
12230,5,2,42595,42598,42600,3,5,0
12231,3,2,42598,42600,42602,2,4,0
12232,2,2,42600,42602,42604,2,4,0
12233,3,1,42603,42604,42605,1,2,0
12234,2,2,42605,42605,42607,0,2,0
12235,2,1,42607,42607,42608,0,1,0
12236,4,3,42611,42611,42614,0,3,3
12237,1,1,42612,42614,42615,2,3,0
12238,6,3,42618,42618,42621,0,3,3
12239,4,1,42622,42622,42623,0,1,1
12240,6,3,42628,42628,42631,0,3,5
12241,5,2,42633,42633,42635,0,2,2
12242,5,3,42638,42638,42641,0,3,3
12243,3,2,42641,42641,42643,0,2,0
12244,3,3,42644,42644,42647,0,3,1
12245,6,1,42650,42650,42651,0,1,3
12246,6,3,42656,42656,42659,0,3,5
12247,3,1,42659,42659,42660,0,1,0
12248,1,1,42660,42660,42661,0,1,0
12249,5,2,42665,42665,42667,0,2,4
12250,1,3,42666,42667,42670,1,4,0
12251,6,1,42672,42672,42673,0,1,2
12252,1,3,42673,42673,42676,0,3,0
12253,1,2,42674,42676,42678,2,4,0
12254,2,3,42676,42678,42681,2,5,0
12255,4,3,42680,42681,42684,1,4,0
12256,3,1,42683,42684,42685,1,2,0
12257,6,2,42689,42689,42691,0,2,4
12258,1,2,42690,42691,42693,1,3,0
12259,1,2,42691,42693,42695,2,4,0
12260,2,3,42693,42695,42698,2,5,0
12261,1,1,42694,42698,42699,4,5,0
12262,5,1,42699,42699,42700,0,1,0
12263,3,3,42702,42702,42705,0,3,2
12264,1,2,42703,42705,42707,2,4,0
12265,1,3,42704,42707,42710,3,6,0
12266,6,3,42710,42710,42713,0,3,0
12267,1,2,42711,42713,42715,2,4,0
12268,1,2,42712,42715,42717,3,5,0
12269,3,3,42715,42717,42720,2,5,0
12270,5,1,42720,42720,42721,0,1,0
12271,5,1,42725,42725,42726,0,1,4
12272,6,2,42731,42731,42733,0,2,5
12273,5,1,42736,42736,42737,0,1,3
12274,2,3,42738,42738,42741,0,3,1
12275,2,3,42740,42741,42744,1,4,0
12276,2,3,42742,42744,42747,2,5,0
12277,3,1,42745,42747,42748,2,3,0
12278,3,1,42748,42748,42749,0,1,0
12279,2,3,42750,42750,42753,0,3,1
12280,3,3,42753,42753,42756,0,3,0
12281,5,3,42758,42758,42761,0,3,2
12282,4,3,42762,42762,42765,0,3,1
12283,4,3,42766,42766,42769,0,3,1
12284,1,1,42767,42769,42770,2,3,0
12285,6,3,42773,42773,42776,0,3,3
12286,6,2,42779,42779,42781,0,2,3
12287,2,3,42781,42781,42784,0,3,0
12288,5,2,42786,42786,42788,0,2,2
12289,4,3,42790,42790,42793,0,3,2
12290,4,2,42794,42794,42796,0,2,1
12291,6,2,42800,42800,42802,0,2,4
12292,6,3,42806,42806,42809,0,3,4
12293,2,1,42808,42809,42810,1,2,0
12294,1,2,42809,42810,42812,1,3,0
12295,1,3,42810,42812,42815,2,5,0
12296,2,3,42812,42815,42818,3,6,0
12297,5,2,42817,42818,42820,1,3,0
12298,1,2,42818,42820,42822,2,4,0
12299,2,3,42820,42822,42825,2,5,0
12300,6,3,42826,42826,42829,0,3,1
12301,1,3,42827,42829,42832,2,5,0
12302,6,1,42833,42833,42834,0,1,1
12303,2,2,42835,42835,42837,0,2,1
12304,1,1,42836,42837,42838,1,2,0
12305,2,1,42838,42838,42839,0,1,0
12306,5,1,42843,42843,42844,0,1,4
12307,5,1,42848,42848,42849,0,1,4
12308,1,2,42849,42849,42851,0,2,0
12309,1,2,42850,42851,42853,1,3,0
12310,1,2,42851,42853,42855,2,4,0
12311,5,1,42856,42856,42857,0,1,1
12312,2,1,42858,42858,42859,0,1,1
12313,5,3,42863,42863,42866,0,3,4
12314,4,1,42867,42867,42868,0,1,1
12315,6,1,42873,42873,42874,0,1,5
12316,4,2,42877,42877,42879,0,2,3
12317,2,3,42879,42879,42882,0,3,0
12318,4,2,42883,42883,42885,0,2,1
12319,2,2,42885,42885,42887,0,2,0
12320,2,3,42887,42887,42890,0,3,0
12321,2,1,42889,42890,42891,1,2,0
12322,4,2,42893,42893,42895,0,2,2
12323,6,3,42899,42899,42902,0,3,4
12324,5,2,42904,42904,42906,0,2,2
12325,2,3,42906,42906,42909,0,3,0
12326,4,3,42910,42910,42913,0,3,1
12327,5,2,42915,42915,42917,0,2,2
12328,6,2,42921,42921,42923,0,2,4
12329,6,2,42927,42927,42929,0,2,4
12330,6,2,42933,42933,42935,0,2,4
12331,5,3,42938,42938,42941,0,3,3
12332,1,1,42939,42941,42942,2,3,0
12333,4,2,42943,42943,42945,0,2,1
12334,2,1,42945,42945,42946,0,1,0
12335,4,3,42949,42949,42952,0,3,3
12336,2,3,42951,42952,42955,1,4,0
12337,5,3,42956,42956,42959,0,3,1
12338,4,2,42960,42960,42962,0,2,1
12339,6,1,42966,42966,42967,0,1,4
12340,3,3,42969,42969,42972,0,3,2
12341,4,3,42973,42973,42976,0,3,1
12342,3,1,42976,42976,42977,0,1,0
12343,5,3,42981,42981,42984,0,3,4
12344,2,3,42983,42984,42987,1,4,0
12345,6,1,42989,42989,42990,0,1,2
12346,3,3,42992,42992,42995,0,3,2
12347,3,1,42995,42995,42996,0,1,0
12348,3,1,42998,42998,42999,0,1,2
12349,2,2,43000,43000,43002,0,2,1
12350,5,3,43005,43005,43008,0,3,3
12351,1,2,43006,43008,43010,2,4,0
12352,5,2,43011,43011,43013,0,2,1
12353,2,1,43013,43013,43014,0,1,0
12354,3,1,43016,43016,43017,0,1,2
12355,3,1,43019,43019,43020,0,1,2
12356,2,1,43021,43021,43022,0,1,1
12357,5,1,43026,43026,43027,0,1,4
12358,6,2,43032,43032,43034,0,2,5
12359,6,1,43038,43038,43039,0,1,4
12360,5,2,43043,43043,43045,0,2,4
12361,6,3,43049,43049,43052,0,3,4
12362,6,2,43055,43055,43057,0,2,3
12363,6,3,43061,43061,43064,0,3,4
12364,2,1,43063,43064,43065,1,2,0
12365,4,1,43067,43067,43068,0,1,2
12366,2,2,43069,43069,43071,0,2,1
12367,5,2,43074,43074,43076,0,2,3
12368,2,2,43076,43076,43078,0,2,0
12369,3,1,43079,43079,43080,0,1,1
12370,1,3,43080,43080,43083,0,3,0
12371,2,3,43082,43083,43086,1,4,0
12372,2,1,43084,43086,43087,2,3,0
12373,6,1,43090,43090,43091,0,1,3
12374,6,3,43096,43096,43099,0,3,5
12375,3,1,43099,43099,43100,0,1,0
12376,2,3,43101,43101,43104,0,3,1
12377,4,1,43105,43105,43106,0,1,1
12378,6,2,43111,43111,43113,0,2,5
12379,1,2,43112,43113,43115,1,3,0
12380,2,1,43114,43115,43116,1,2,0
12381,5,2,43119,43119,43121,0,2,3
12382,2,2,43121,43121,43123,0,2,0
12383,4,1,43125,43125,43126,0,1,2
12384,5,1,43130,43130,43131,0,1,4
12385,4,3,43134,43134,43137,0,3,3
12386,6,3,43140,43140,43143,0,3,3
12387,2,1,43142,43143,43144,1,2,0
12388,4,2,43146,43146,43148,0,2,2
12389,6,2,43152,43152,43154,0,2,4
12390,4,1,43156,43156,43157,0,1,2
12391,5,3,43161,43161,43164,0,3,4
12392,6,2,43167,43167,43169,0,2,3
12393,5,3,43172,43172,43175,0,3,3
12394,4,3,43176,43176,43179,0,3,1
12395,1,3,43177,43179,43182,2,5,0
12396,2,2,43179,43182,43184,3,5,0
12397,3,3,43182,43184,43187,2,5,0
12398,2,2,43184,43187,43189,3,5,0
12399,6,3,43190,43190,43193,0,3,1
12400,2,1,43192,43193,43194,1,2,0
12401,3,3,43195,43195,43198,0,3,1
12402,3,1,43198,43198,43199,0,1,0
12403,1,2,43199,43199,43201,0,2,0
12404,2,2,43201,43201,43203,0,2,0
12405,5,1,43206,43206,43207,0,1,3
12406,6,3,43212,43212,43215,0,3,5
12407,6,3,43218,43218,43221,0,3,3
12408,6,3,43224,43224,43227,0,3,3
12409,1,2,43225,43227,43229,2,4,0
12410,4,3,43229,43229,43232,0,3,0
12411,5,1,43234,43234,43235,0,1,2
12412,4,1,43238,43238,43239,0,1,3
12413,6,1,43244,43244,43245,0,1,5
12414,1,2,43245,43245,43247,0,2,0
12415,4,1,43249,43249,43250,0,1,2
12416,2,1,43251,43251,43252,0,1,1
12417,4,1,43255,43255,43256,0,1,3
12418,6,3,43261,43261,43264,0,3,5
12419,5,3,43266,43266,43269,0,3,2
12420,5,3,43271,43271,43274,0,3,2
12421,3,2,43274,43274,43276,0,2,0
12422,3,3,43277,43277,43280,0,3,1
12423,1,1,43278,43280,43281,2,3,0
12424,6,1,43284,43284,43285,0,1,3
12425,5,2,43289,43289,43291,0,2,4
12426,5,2,43294,43294,43296,0,2,3
12427,3,3,43297,43297,43300,0,3,1
12428,6,2,43303,43303,43305,0,2,3
12429,1,1,43304,43305,43306,1,2,0
12430,1,1,43305,43306,43307,1,2,0
12431,4,1,43309,43309,43310,0,1,2
12432,6,3,43315,43315,43318,0,3,5
12433,2,3,43317,43318,43321,1,4,0
12434,1,1,43318,43321,43322,3,4,0
12435,4,1,43322,43322,43323,0,1,0
12436,1,3,43323,43323,43326,0,3,0
12437,2,3,43325,43326,43329,1,4,0
12438,6,3,43331,43331,43334,0,3,2
12439,4,1,43335,43335,43336,0,1,1
12440,5,3,43340,43340,43343,0,3,4
12441,5,3,43345,43345,43348,0,3,2
12442,1,2,43346,43348,43350,2,4,0
12443,4,1,43350,43350,43351,0,1,0
12444,2,3,43352,43352,43355,0,3,1
12445,1,1,43353,43355,43356,2,3,0
12446,2,3,43355,43356,43359,1,4,0
12447,6,3,43361,43361,43364,0,3,2
12448,5,1,43366,43366,43367,0,1,2
12449,2,2,43368,43368,43370,0,2,1
12450,5,2,43373,43373,43375,0,2,3
12451,1,2,43374,43375,43377,1,3,0
12452,4,1,43378,43378,43379,0,1,1
12453,6,1,43384,43384,43385,0,1,5
12454,2,1,43386,43386,43387,0,1,1
12455,5,3,43391,43391,43394,0,3,4
12456,1,1,43392,43394,43395,2,3,0
12457,2,1,43394,43395,43396,1,2,0
12458,2,3,43396,43396,43399,0,3,0
12459,4,2,43400,43400,43402,0,2,1
12460,6,3,43406,43406,43409,0,3,4
12461,5,2,43411,43411,43413,0,2,2
12462,3,2,43414,43414,43416,0,2,1
12463,4,2,43418,43418,43420,0,2,2
12464,4,2,43422,43422,43424,0,2,2
12465,1,3,43423,43424,43427,1,4,0
12466,1,3,43424,43427,43430,3,6,0
12467,5,2,43429,43430,43432,1,3,0
12468,4,1,43433,43433,43434,0,1,1
12469,3,2,43436,43436,43438,0,2,2
12470,1,3,43437,43438,43441,1,4,0
12471,1,2,43438,43441,43443,3,5,0
12472,2,1,43440,43443,43444,3,4,0
12473,5,2,43445,43445,43447,0,2,1
12474,4,3,43449,43449,43452,0,3,2
12475,2,3,43451,43452,43455,1,4,0
12476,2,2,43453,43455,43457,2,4,0
12477,2,2,43455,43457,43459,2,4,0
12478,1,3,43456,43459,43462,3,6,0
12479,5,2,43461,43462,43464,1,3,0
12480,4,3,43465,43465,43468,0,3,1
12481,1,1,43466,43468,43469,2,3,0
12482,2,1,43468,43469,43470,1,2,0
12483,6,1,43474,43474,43475,0,1,4
12484,4,2,43478,43478,43480,0,2,3
12485,1,1,43479,43480,43481,1,2,0
12486,2,3,43481,43481,43484,0,3,0
12487,3,2,43484,43484,43486,0,2,0
12488,2,3,43486,43486,43489,0,3,0
12489,2,1,43488,43489,43490,1,2,0
12490,5,1,43493,43493,43494,0,1,3
12491,2,1,43495,43495,43496,0,1,1
12492,3,3,43498,43498,43501,0,3,2
12493,4,2,43502,43502,43504,0,2,1
12494,1,1,43503,43504,43505,1,2,0
12495,2,1,43505,43505,43506,0,1,0
12496,2,1,43507,43507,43508,0,1,1
12497,3,3,43510,43510,43513,0,3,2
12498,3,1,43513,43513,43514,0,1,0
12499,4,2,43517,43517,43519,0,2,3
12500,5,1,43522,43522,43523,0,1,3
12501,5,3,43527,43527,43530,0,3,4
12502,6,1,43533,43533,43534,0,1,3
12503,6,2,43539,43539,43541,0,2,5
12504,2,1,43541,43541,43542,0,1,0
12505,5,2,43546,43546,43548,0,2,4
12506,6,3,43552,43552,43555,0,3,4
12507,5,3,43557,43557,43560,0,3,2
12508,2,3,43559,43560,43563,1,4,0
12509,4,1,43563,43563,43564,0,1,0
12510,1,2,43564,43564,43566,0,2,0
12511,4,1,43568,43568,43569,0,1,2
12512,3,2,43571,43571,43573,0,2,2
12513,6,3,43577,43577,43580,0,3,4
12514,4,1,43581,43581,43582,0,1,1
12515,2,1,43583,43583,43584,0,1,1
12516,1,1,43584,43584,43585,0,1,0
12517,2,1,43586,43586,43587,0,1,1
12518,5,3,43591,43591,43594,0,3,4
12519,3,3,43594,43594,43597,0,3,0
12520,4,3,43598,43598,43601,0,3,1
12521,3,1,43601,43601,43602,0,1,0
12522,6,1,43607,43607,43608,0,1,5
12523,1,2,43608,43608,43610,0,2,0
12524,4,2,43612,43612,43614,0,2,2
12525,6,3,43618,43618,43621,0,3,4
12526,4,2,43622,43622,43624,0,2,1
12527,1,2,43623,43624,43626,1,3,0
12528,2,3,43625,43626,43629,1,4,0
12529,5,3,43630,43630,43633,0,3,1
12530,2,3,43632,43633,43636,1,4,0
12531,1,2,43633,43636,43638,3,5,0
12532,6,1,43639,43639,43640,0,1,1
12533,5,1,43644,43644,43645,0,1,4
12534,3,3,43647,43647,43650,0,3,2
12535,6,2,43653,43653,43655,0,2,3
12536,6,1,43659,43659,43660,0,1,4
12537,2,2,43661,43661,43663,0,2,1
12538,6,1,43667,43667,43668,0,1,4
12539,4,3,43671,43671,43674,0,3,3
12540,2,3,43673,43674,43677,1,4,0
12541,1,2,43674,43677,43679,3,5,0
12542,6,2,43680,43680,43682,0,2,1
12543,3,3,43683,43683,43686,0,3,1
12544,3,1,43686,43686,43687,0,1,0
12545,2,1,43688,43688,43689,0,1,1
12546,4,1,43692,43692,43693,0,1,3
12547,4,1,43696,43696,43697,0,1,3
12548,5,3,43701,43701,43704,0,3,4
12549,4,1,43705,43705,43706,0,1,1
12550,6,3,43711,43711,43714,0,3,5
12551,5,2,43716,43716,43718,0,2,2
12552,5,3,43721,43721,43724,0,3,3
12553,3,3,43724,43724,43727,0,3,0
12554,4,2,43728,43728,43730,0,2,1
12555,1,1,43729,43730,43731,1,2,0
12556,4,1,43733,43733,43734,0,1,2
12557,3,1,43736,43736,43737,0,1,2
12558,3,1,43739,43739,43740,0,1,2
12559,3,1,43742,43742,43743,0,1,2
12560,5,1,43747,43747,43748,0,1,4
12561,5,1,43752,43752,43753,0,1,4
12562,4,1,43756,43756,43757,0,1,3
12563,1,1,43757,43757,43758,0,1,0
12564,2,2,43759,43759,43761,0,2,1
12565,3,2,43762,43762,43764,0,2,1
12566,6,3,43768,43768,43771,0,3,4
12567,6,3,43774,43774,43777,0,3,3
12568,4,1,43778,43778,43779,0,1,1
12569,5,2,43783,43783,43785,0,2,4
12570,2,2,43785,43785,43787,0,2,0
12571,6,2,43791,43791,43793,0,2,4
12572,5,3,43796,43796,43799,0,3,3
12573,6,2,43802,43802,43804,0,2,3
12574,3,3,43805,43805,43808,0,3,1
12575,1,2,43806,43808,43810,2,4,0
12576,1,2,43807,43810,43812,3,5,0
12577,6,2,43813,43813,43815,0,2,1
12578,2,2,43815,43815,43817,0,2,0
12579,3,2,43818,43818,43820,0,2,1
12580,1,2,43819,43820,43822,1,3,0
12581,5,3,43824,43824,43827,0,3,2
12582,5,2,43829,43829,43831,0,2,2
12583,5,2,43834,43834,43836,0,2,3
12584,3,2,43837,43837,43839,0,2,1
12585,1,2,43838,43839,43841,1,3,0
12586,1,1,43839,43841,43842,2,3,0
12587,2,3,43841,43842,43845,1,4,0
12588,5,2,43846,43846,43848,0,2,1
12589,4,1,43850,43850,43851,0,1,2
12590,1,1,43851,43851,43852,0,1,0
12591,3,3,43854,43854,43857,0,3,2
12592,1,2,43855,43857,43859,2,4,0
12593,1,1,43856,43859,43860,3,4,0
12594,1,3,43857,43860,43863,3,6,0
12595,4,3,43861,43863,43866,2,5,0
12596,3,3,43864,43866,43869,2,5,0
12597,6,2,43870,43870,43872,0,2,1
12598,5,3,43875,43875,43878,0,3,3
12599,1,1,43876,43878,43879,2,3,0
12600,3,3,43879,43879,43882,0,3,0
12601,3,3,43882,43882,43885,0,3,0
12602,6,3,43888,43888,43891,0,3,3
12603,5,3,43893,43893,43896,0,3,2
12604,3,1,43896,43896,43897,0,1,0
12605,4,1,43900,43900,43901,0,1,3
12606,4,3,43904,43904,43907,0,3,3
12607,2,3,43906,43907,43910,1,4,0
12608,6,1,43912,43912,43913,0,1,2
12609,4,2,43916,43916,43918,0,2,3
12610,6,1,43922,43922,43923,0,1,4
12611,5,1,43927,43927,43928,0,1,4
12612,4,1,43931,43931,43932,0,1,3
12613,3,1,43934,43934,43935,0,1,2
12614,2,2,43936,43936,43938,0,2,1
12615,1,2,43937,43938,43940,1,3,0
12616,5,3,43942,43942,43945,0,3,2
12617,1,3,43943,43945,43948,2,5,0
12618,2,3,43945,43948,43951,3,6,0
12619,1,2,43946,43951,43953,5,7,0
12620,5,1,43951,43953,43954,2,3,0
12621,6,2,43957,43957,43959,0,2,3
12622,6,3,43963,43963,43966,0,3,4
12623,4,3,43967,43967,43970,0,3,1
12624,3,3,43970,43970,43973,0,3,0
12625,2,1,43972,43973,43974,1,2,0
12626,6,1,43978,43978,43979,0,1,4
12627,6,1,43984,43984,43985,0,1,5
12628,5,1,43989,43989,43990,0,1,4
12629,6,3,43995,43995,43998,0,3,5
12630,2,3,43997,43998,44001,1,4,0
12631,6,1,44003,44003,44004,0,1,2
12632,5,3,44008,44008,44011,0,3,4
12633,1,1,44009,44011,44012,2,3,0
12634,3,3,44012,44012,44015,0,3,0
12635,1,1,44013,44015,44016,2,3,0
12636,6,1,44019,44019,44020,0,1,3
12637,3,1,44022,44022,44023,0,1,2
12638,3,3,44025,44025,44028,0,3,2
12639,3,2,44028,44028,44030,0,2,0
12640,6,1,44034,44034,44035,0,1,4
12641,5,2,44039,44039,44041,0,2,4
12642,4,2,44043,44043,44045,0,2,2
12643,3,1,44046,44046,44047,0,1,1
12644,4,1,44050,44050,44051,0,1,3
12645,1,2,44051,44051,44053,0,2,0
12646,4,1,44055,44055,44056,0,1,2
12647,1,2,44056,44056,44058,0,2,0
12648,1,1,44057,44058,44059,1,2,0
12649,3,1,44060,44060,44061,0,1,1
12650,5,2,44065,44065,44067,0,2,4
12651,5,3,44070,44070,44073,0,3,3
12652,2,1,44072,44073,44074,1,2,0
12653,1,2,44073,44074,44076,1,3,0
12654,1,3,44074,44076,44079,2,5,0
12655,1,2,44075,44079,44081,4,6,0
12656,2,1,44077,44081,44082,4,5,0
12657,2,1,44079,44082,44083,3,4,0
12658,4,1,44083,44083,44084,0,1,0
12659,4,1,44087,44087,44088,0,1,3
12660,1,3,44088,44088,44091,0,3,0
12661,4,3,44092,44092,44095,0,3,1
12662,4,2,44096,44096,44098,0,2,1
12663,5,2,44101,44101,44103,0,2,3
12664,1,3,44102,44103,44106,1,4,0
12665,5,1,44107,44107,44108,0,1,1
12666,4,2,44111,44111,44113,0,2,3
12667,5,2,44116,44116,44118,0,2,3
12668,4,1,44120,44120,44121,0,1,2
12669,5,1,44125,44125,44126,0,1,4
12670,4,3,44129,44129,44132,0,3,3
12671,3,1,44132,44132,44133,0,1,0
12672,4,1,44136,44136,44137,0,1,3
12673,5,3,44141,44141,44144,0,3,4
12674,4,3,44145,44145,44148,0,3,1
12675,5,3,44150,44150,44153,0,3,2
12676,6,1,44156,44156,44157,0,1,3
12677,2,1,44158,44158,44159,0,1,1
12678,5,3,44163,44163,44166,0,3,4
12679,3,2,44166,44166,44168,0,2,0
12680,4,3,44170,44170,44173,0,3,2
12681,2,3,44172,44173,44176,1,4,0
12682,5,2,44177,44177,44179,0,2,1
12683,6,1,44183,44183,44184,0,1,4
12684,1,2,44184,44184,44186,0,2,0
12685,6,1,44190,44190,44191,0,1,4
12686,3,3,44193,44193,44196,0,3,2
12687,6,1,44199,44199,44200,0,1,3
12688,2,1,44201,44201,44202,0,1,1
12689,3,3,44204,44204,44207,0,3,2
12690,6,1,44210,44210,44211,0,1,3
12691,2,1,44212,44212,44213,0,1,1
12692,4,2,44216,44216,44218,0,2,3
12693,4,3,44220,44220,44223,0,3,2
12694,4,2,44224,44224,44226,0,2,1
12695,3,3,44227,44227,44230,0,3,1
12696,2,2,44229,44230,44232,1,3,0
12697,1,2,44230,44232,44234,2,4,0
12698,3,1,44233,44234,44235,1,2,0
12699,1,3,44234,44235,44238,1,4,0
12700,5,2,44239,44239,44241,0,2,1
12701,3,3,44242,44242,44245,0,3,1
12702,4,3,44246,44246,44249,0,3,1
12703,4,1,44250,44250,44251,0,1,1
12704,5,2,44255,44255,44257,0,2,4
12705,1,2,44256,44257,44259,1,3,0
12706,4,2,44260,44260,44262,0,2,1
12707,3,2,44263,44263,44265,0,2,1
12708,2,2,44265,44265,44267,0,2,0
12709,5,2,44270,44270,44272,0,2,3
12710,4,3,44274,44274,44277,0,3,2
12711,2,1,44276,44277,44278,1,2,0
12712,2,2,44278,44278,44280,0,2,0
12713,6,1,44284,44284,44285,0,1,4
12714,5,2,44289,44289,44291,0,2,4
12715,2,2,44291,44291,44293,0,2,0
12716,6,1,44297,44297,44298,0,1,4
12717,5,3,44302,44302,44305,0,3,4
12718,1,3,44303,44305,44308,2,5,0
12719,4,1,44307,44308,44309,1,2,0
12720,5,2,44312,44312,44314,0,2,3
12721,1,1,44313,44314,44315,1,2,0
12722,3,2,44316,44316,44318,0,2,1
12723,2,3,44318,44318,44321,0,3,0
12724,3,3,44321,44321,44324,0,3,0
12725,3,3,44324,44324,44327,0,3,0
12726,4,1,44328,44328,44329,0,1,1
12727,1,2,44329,44329,44331,0,2,0
12728,1,1,44330,44331,44332,1,2,0
12729,4,1,44334,44334,44335,0,1,2
12730,3,3,44337,44337,44340,0,3,2
12731,4,3,44341,44341,44344,0,3,1
12732,1,1,44342,44344,44345,2,3,0
12733,5,3,44347,44347,44350,0,3,2
12734,6,2,44353,44353,44355,0,2,3
12735,2,1,44355,44355,44356,0,1,0
12736,3,1,44358,44358,44359,0,1,2
12737,5,1,44363,44363,44364,0,1,4
12738,3,3,44366,44366,44369,0,3,2
12739,2,3,44368,44369,44372,1,4,0
12740,1,3,44369,44372,44375,3,6,0
12741,6,1,44375,44375,44376,0,1,0
12742,4,3,44379,44379,44382,0,3,3
12743,4,3,44383,44383,44386,0,3,1
12744,6,3,44389,44389,44392,0,3,3
12745,5,3,44394,44394,44397,0,3,2
12746,4,3,44398,44398,44401,0,3,1
12747,6,1,44404,44404,44405,0,1,3
12748,2,1,44406,44406,44407,0,1,1
12749,4,2,44410,44410,44412,0,2,3
12750,3,1,44413,44413,44414,0,1,1
12751,3,3,44416,44416,44419,0,3,2
12752,6,3,44422,44422,44425,0,3,3
12753,6,3,44428,44428,44431,0,3,3
12754,5,2,44433,44433,44435,0,2,2
12755,2,3,44435,44435,44438,0,3,0
12756,1,3,44436,44438,44441,2,5,0
12757,1,3,44437,44441,44444,4,7,0
12758,3,1,44440,44444,44445,4,5,0
12759,2,3,44442,44445,44448,3,6,0
12760,4,1,44446,44448,44449,2,3,0
12761,6,2,44452,44452,44454,0,2,3
12762,2,3,44454,44454,44457,0,3,0
12763,2,2,44456,44457,44459,1,3,0
12764,1,1,44457,44459,44460,2,3,0
12765,4,2,44461,44461,44463,0,2,1
12766,3,1,44464,44464,44465,0,1,1
12767,2,2,44466,44466,44468,0,2,1
12768,4,1,44470,44470,44471,0,1,2
12769,6,1,44476,44476,44477,0,1,5
12770,6,1,44482,44482,44483,0,1,5
12771,3,1,44485,44485,44486,0,1,2
12772,2,2,44487,44487,44489,0,2,1
12773,1,3,44488,44489,44492,1,4,0
12774,5,2,44493,44493,44495,0,2,1
12775,6,1,44499,44499,44500,0,1,4
12776,6,3,44505,44505,44508,0,3,5
12777,3,2,44508,44508,44510,0,2,0
12778,1,2,44509,44510,44512,1,3,0
12779,3,1,44512,44512,44513,0,1,0
12780,5,2,44517,44517,44519,0,2,4
12781,2,1,44519,44519,44520,0,1,0
12782,6,2,44525,44525,44527,0,2,5
12783,4,2,44529,44529,44531,0,2,2
12784,6,2,44535,44535,44537,0,2,4
12785,6,1,44541,44541,44542,0,1,4
12786,6,1,44547,44547,44548,0,1,5
12787,5,3,44552,44552,44555,0,3,4
12788,1,1,44553,44555,44556,2,3,0
12789,2,2,44555,44556,44558,1,3,0
12790,2,1,44557,44558,44559,1,2,0
12791,1,1,44558,44559,44560,1,2,0
12792,6,1,44564,44564,44565,0,1,4
12793,5,1,44569,44569,44570,0,1,4
12794,4,3,44573,44573,44576,0,3,3
12795,1,2,44574,44576,44578,2,4,0
12796,1,3,44575,44578,44581,3,6,0
12797,3,1,44578,44581,44582,3,4,0
12798,6,2,44584,44584,44586,0,2,2
12799,2,1,44586,44586,44587,0,1,0
12800,2,2,44588,44588,44590,0,2,1
12801,4,2,44592,44592,44594,0,2,2
12802,1,3,44593,44594,44597,1,4,0
12803,3,3,44596,44597,44600,1,4,0
12804,4,2,44600,44600,44602,0,2,0
12805,1,1,44601,44602,44603,1,2,0
12806,5,1,44606,44606,44607,0,1,3
12807,2,2,44608,44608,44610,0,2,1
12808,3,2,44611,44611,44613,0,2,1
12809,6,2,44617,44617,44619,0,2,4
12810,1,1,44618,44619,44620,1,2,0
12811,5,1,44623,44623,44624,0,1,3
12812,3,1,44626,44626,44627,0,1,2
12813,6,3,44632,44632,44635,0,3,5
12814,2,3,44634,44635,44638,1,4,0
12815,6,3,44640,44640,44643,0,3,2
12816,1,2,44641,44643,44645,2,4,0
12817,4,3,44645,44645,44648,0,3,0
12818,3,3,44648,44648,44651,0,3,0
12819,6,2,44654,44654,44656,0,2,3
12820,4,3,44658,44658,44661,0,3,2
12821,4,1,44662,44662,44663,0,1,1
12822,1,2,44663,44663,44665,0,2,0
12823,2,2,44665,44665,44667,0,2,0
12824,4,3,44669,44669,44672,0,3,2
12825,3,2,44672,44672,44674,0,2,0
12826,6,1,44678,44678,44679,0,1,4
12827,5,2,44683,44683,44685,0,2,4
12828,3,2,44686,44686,44688,0,2,1
12829,4,2,44690,44690,44692,0,2,2
12830,2,1,44692,44692,44693,0,1,0
12831,6,1,44698,44698,44699,0,1,5
12832,3,2,44701,44701,44703,0,2,2
12833,3,1,44704,44704,44705,0,1,1
12834,4,2,44708,44708,44710,0,2,3
12835,3,2,44711,44711,44713,0,2,1
12836,6,2,44717,44717,44719,0,2,4
12837,6,2,44723,44723,44725,0,2,4
12838,1,1,44724,44725,44726,1,2,0
12839,5,2,44729,44729,44731,0,2,3
12840,3,2,44732,44732,44734,0,2,1
12841,6,1,44738,44738,44739,0,1,4
12842,6,1,44744,44744,44745,0,1,5
12843,1,1,44745,44745,44746,0,1,0
12844,5,3,44750,44750,44753,0,3,4
12845,6,1,44756,44756,44757,0,1,3
12846,2,3,44758,44758,44761,0,3,1
12847,4,2,44762,44762,44764,0,2,1
12848,5,1,44767,44767,44768,0,1,3
12849,2,3,44769,44769,44772,0,3,1
12850,3,2,44772,44772,44774,0,2,0
12851,4,2,44776,44776,44778,0,2,2
12852,2,3,44778,44778,44781,0,3,0
12853,1,3,44779,44781,44784,2,5,0
12854,2,2,44781,44784,44786,3,5,0
12855,3,3,44784,44786,44789,2,5,0
12856,5,1,44789,44789,44790,0,1,0
12857,5,3,44794,44794,44797,0,3,4
12858,1,2,44795,44797,44799,2,4,0
12859,2,2,44797,44799,44801,2,4,0
12860,1,3,44798,44801,44804,3,6,0
12861,6,2,44804,44804,44806,0,2,0
12862,2,1,44806,44806,44807,0,1,0
12863,3,3,44809,44809,44812,0,3,2
12864,4,2,44813,44813,44815,0,2,1
12865,3,2,44816,44816,44818,0,2,1
12866,5,1,44821,44821,44822,0,1,3
12867,5,2,44826,44826,44828,0,2,4
12868,3,1,44829,44829,44830,0,1,1
12869,1,1,44830,44830,44831,0,1,0
12870,6,2,44836,44836,44838,0,2,5
12871,3,2,44839,44839,44841,0,2,1
12872,1,1,44840,44841,44842,1,2,0
12873,1,1,44841,44842,44843,1,2,0
12874,5,3,44846,44846,44849,0,3,3
12875,2,3,44848,44849,44852,1,4,0
12876,6,3,44854,44854,44857,0,3,2
12877,4,1,44858,44858,44859,0,1,1
12878,1,3,44859,44859,44862,0,3,0
12879,3,3,44862,44862,44865,0,3,0
12880,4,2,44866,44866,44868,0,2,1
12881,4,3,44870,44870,44873,0,3,2
12882,4,1,44874,44874,44875,0,1,1
12883,4,2,44878,44878,44880,0,2,3
12884,6,2,44884,44884,44886,0,2,4
12885,6,3,44890,44890,44893,0,3,4
12886,4,3,44894,44894,44897,0,3,1
12887,1,1,44895,44897,44898,2,3,0
12888,6,1,44901,44901,44902,0,1,3
12889,6,3,44907,44907,44910,0,3,5
12890,5,3,44912,44912,44915,0,3,2
12891,6,1,44918,44918,44919,0,1,3
12892,3,3,44921,44921,44924,0,3,2
12893,4,3,44925,44925,44928,0,3,1
12894,4,2,44929,44929,44931,0,2,1
12895,6,1,44935,44935,44936,0,1,4
12896,1,2,44936,44936,44938,0,2,0
12897,3,2,44939,44939,44941,0,2,1
12898,3,3,44942,44942,44945,0,3,1
12899,1,3,44943,44945,44948,2,5,0
12900,4,1,44947,44948,44949,1,2,0
12901,5,2,44952,44952,44954,0,2,3
12902,4,2,44956,44956,44958,0,2,2
12903,1,1,44957,44958,44959,1,2,0
12904,3,2,44960,44960,44962,0,2,1
12905,6,3,44966,44966,44969,0,3,4
12906,2,1,44968,44969,44970,1,2,0
12907,1,2,44969,44970,44972,1,3,0
12908,3,2,44972,44972,44974,0,2,0
12909,6,2,44978,44978,44980,0,2,4
12910,2,1,44980,44980,44981,0,1,0
12911,4,1,44984,44984,44985,0,1,3
12912,3,2,44987,44987,44989,0,2,2
12913,4,2,44991,44991,44993,0,2,2
12914,3,2,44994,44994,44996,0,2,1
12915,5,3,44999,44999,45002,0,3,3
12916,4,1,45003,45003,45004,0,1,1
12917,4,1,45007,45007,45008,0,1,3
12918,1,3,45008,45008,45011,0,3,0
12919,5,3,45013,45013,45016,0,3,2
12920,4,2,45017,45017,45019,0,2,1
12921,5,1,45022,45022,45023,0,1,3
12922,4,2,45026,45026,45028,0,2,3
12923,6,3,45032,45032,45035,0,3,4
12924,4,1,45036,45036,45037,0,1,1
12925,5,2,45041,45041,45043,0,2,4
12926,2,3,45043,45043,45046,0,3,0
12927,1,2,45044,45046,45048,2,4,0
12928,4,1,45048,45048,45049,0,1,0
12929,4,3,45052,45052,45055,0,3,3
12930,3,2,45055,45055,45057,0,2,0
12931,5,2,45060,45060,45062,0,2,3
12932,4,3,45064,45064,45067,0,3,2
12933,1,2,45065,45067,45069,2,4,0
12934,1,1,45066,45069,45070,3,4,0
12935,3,1,45069,45070,45071,1,2,0
12936,6,2,45075,45075,45077,0,2,4
12937,1,1,45076,45077,45078,1,2,0
12938,2,2,45078,45078,45080,0,2,0
12939,5,2,45083,45083,45085,0,2,3
12940,2,1,45085,45085,45086,0,1,0
12941,1,1,45086,45086,45087,0,1,0
12942,5,1,45091,45091,45092,0,1,4
12943,1,1,45092,45092,45093,0,1,0
12944,6,1,45098,45098,45099,0,1,5
12945,6,2,45104,45104,45106,0,2,5
12946,1,3,45105,45106,45109,1,4,0
12947,6,2,45111,45111,45113,0,2,2
12948,4,1,45115,45115,45116,0,1,2
12949,2,2,45117,45117,45119,0,2,1
12950,1,3,45118,45119,45122,1,4,0
12951,6,2,45124,45124,45126,0,2,2
12952,6,2,45130,45130,45132,0,2,4
12953,3,3,45133,45133,45136,0,3,1
12954,5,1,45138,45138,45139,0,1,2
12955,6,1,45144,45144,45145,0,1,5
12956,3,2,45147,45147,45149,0,2,2
12957,3,3,45150,45150,45153,0,3,1
12958,5,2,45155,45155,45157,0,2,2
12959,6,3,45161,45161,45164,0,3,4
12960,3,2,45164,45164,45166,0,2,0
12961,4,1,45168,45168,45169,0,1,2
12962,6,2,45174,45174,45176,0,2,5
12963,2,2,45176,45176,45178,0,2,0
12964,1,3,45177,45178,45181,1,4,0
12965,2,1,45179,45181,45182,2,3,0
12966,5,3,45184,45184,45187,0,3,2
12967,3,3,45187,45187,45190,0,3,0
12968,4,2,45191,45191,45193,0,2,1
12969,4,1,45195,45195,45196,0,1,2
12970,1,2,45196,45196,45198,0,2,0
12971,6,1,45202,45202,45203,0,1,4
12972,5,1,45207,45207,45208,0,1,4
12973,1,1,45208,45208,45209,0,1,0
12974,4,2,45212,45212,45214,0,2,3
12975,5,1,45217,45217,45218,0,1,3
12976,5,1,45222,45222,45223,0,1,4
12977,5,2,45227,45227,45229,0,2,4
12978,5,2,45232,45232,45234,0,2,3
12979,2,3,45234,45234,45237,0,3,0
12980,1,1,45235,45237,45238,2,3,0
12981,1,1,45236,45238,45239,2,3,0
12982,2,1,45238,45239,45240,1,2,0
12983,6,2,45244,45244,45246,0,2,4
12984,2,1,45246,45246,45247,0,1,0
12985,1,2,45247,45247,45249,0,2,0
12986,6,2,45253,45253,45255,0,2,4
12987,3,3,45256,45256,45259,0,3,1
12988,2,3,45258,45259,45262,1,4,0
12989,2,3,45260,45262,45265,2,5,0
12990,5,2,45265,45265,45267,0,2,0
12991,3,1,45268,45268,45269,0,1,1
12992,2,3,45270,45270,45273,0,3,1
12993,4,2,45274,45274,45276,0,2,1
12994,1,1,45275,45276,45277,1,2,0
12995,6,2,45281,45281,45283,0,2,4
12996,4,1,45285,45285,45286,0,1,2
12997,6,3,45291,45291,45294,0,3,5
12998,6,1,45297,45297,45298,0,1,3
12999,3,2,45300,45300,45302,0,2,2
13000,6,1,45306,45306,45307,0,1,4
13001,4,3,45310,45310,45313,0,3,3
13002,6,3,45316,45316,45319,0,3,3
13003,3,1,45319,45319,45320,0,1,0
13004,5,3,45324,45324,45327,0,3,4
13005,4,2,45328,45328,45330,0,2,1
13006,3,2,45331,45331,45333,0,2,1
13007,4,1,45335,45335,45336,0,1,2
13008,5,3,45340,45340,45343,0,3,4
13009,3,2,45343,45343,45345,0,2,0
13010,6,3,45349,45349,45352,0,3,4
13011,2,2,45351,45352,45354,1,3,0
13012,6,2,45357,45357,45359,0,2,3
13013,4,2,45361,45361,45363,0,2,2
13014,2,2,45363,45363,45365,0,2,0
13015,3,1,45366,45366,45367,0,1,1
13016,6,1,45372,45372,45373,0,1,5
13017,6,2,45378,45378,45380,0,2,5
13018,1,2,45379,45380,45382,1,3,0
13019,2,1,45381,45382,45383,1,2,0
13020,6,3,45387,45387,45390,0,3,4
13021,3,2,45390,45390,45392,0,2,0
13022,2,3,45392,45392,45395,0,3,0
13023,3,2,45395,45395,45397,0,2,0
13024,3,2,45398,45398,45400,0,2,1
13025,1,3,45399,45400,45403,1,4,0
13026,3,2,45402,45403,45405,1,3,0
13027,5,3,45407,45407,45410,0,3,2
13028,5,2,45412,45412,45414,0,2,2
13029,5,3,45417,45417,45420,0,3,3
13030,3,1,45420,45420,45421,0,1,0
13031,3,3,45423,45423,45426,0,3,2
13032,2,1,45425,45426,45427,1,2,0
13033,6,2,45431,45431,45433,0,2,4
13034,1,3,45432,45433,45436,1,4,0
13035,4,3,45436,45436,45439,0,3,0
13036,5,2,45441,45441,45443,0,2,2
13037,3,1,45444,45444,45445,0,1,1
13038,6,3,45450,45450,45453,0,3,5
13039,5,1,45455,45455,45456,0,1,2
13040,3,3,45458,45458,45461,0,3,2
13041,3,1,45461,45461,45462,0,1,0
13042,6,2,45467,45467,45469,0,2,5
13043,2,2,45469,45469,45471,0,2,0
13044,1,2,45470,45471,45473,1,3,0
13045,5,1,45475,45475,45476,0,1,2
13046,1,1,45476,45476,45477,0,1,0
13047,5,1,45481,45481,45482,0,1,4
13048,2,1,45483,45483,45484,0,1,1
13049,6,2,45489,45489,45491,0,2,5
13050,2,1,45491,45491,45492,0,1,0
13051,1,2,45492,45492,45494,0,2,0
13052,4,1,45496,45496,45497,0,1,2
13053,4,1,45500,45500,45501,0,1,3
13054,5,2,45505,45505,45507,0,2,4
13055,6,3,45511,45511,45514,0,3,4
13056,5,1,45516,45516,45517,0,1,2
13057,3,2,45519,45519,45521,0,2,2
13058,4,2,45523,45523,45525,0,2,2
13059,4,3,45527,45527,45530,0,3,2
13060,4,1,45531,45531,45532,0,1,1
13061,1,2,45532,45532,45534,0,2,0
13062,2,2,45534,45534,45536,0,2,0
13063,1,1,45535,45536,45537,1,2,0
13064,5,2,45540,45540,45542,0,2,3
13065,1,3,45541,45542,45545,1,4,0
13066,1,1,45542,45545,45546,3,4,0
13067,5,1,45547,45547,45548,0,1,1
13068,5,3,45552,45552,45555,0,3,4
13069,6,2,45558,45558,45560,0,2,3
13070,2,1,45560,45560,45561,0,1,0
13071,3,2,45563,45563,45565,0,2,2
13072,2,3,45565,45565,45568,0,3,0
13073,4,2,45569,45569,45571,0,2,1
13074,1,1,45570,45571,45572,1,2,0
13075,1,3,45571,45572,45575,1,4,0
13076,6,3,45577,45577,45580,0,3,2
13077,4,2,45581,45581,45583,0,2,1
13078,3,3,45584,45584,45587,0,3,1
13079,5,3,45589,45589,45592,0,3,2
13080,4,1,45593,45593,45594,0,1,1
13081,2,1,45595,45595,45596,0,1,1
13082,6,1,45601,45601,45602,0,1,5
13083,4,2,45605,45605,45607,0,2,3
13084,5,2,45610,45610,45612,0,2,3
13085,1,2,45611,45612,45614,1,3,0
13086,1,2,45612,45614,45616,2,4,0
13087,6,2,45618,45618,45620,0,2,2
13088,5,3,45623,45623,45626,0,3,3
13089,3,1,45626,45626,45627,0,1,0
13090,4,3,45630,45630,45633,0,3,3
13091,1,1,45631,45633,45634,2,3,0
13092,5,1,45636,45636,45637,0,1,2
13093,4,3,45640,45640,45643,0,3,3
13094,3,3,45643,45643,45646,0,3,0
13095,1,1,45644,45646,45647,2,3,0
13096,3,3,45647,45647,45650,0,3,0
13097,5,2,45652,45652,45654,0,2,2
13098,3,2,45655,45655,45657,0,2,1
13099,6,3,45661,45661,45664,0,3,4
13100,3,3,45664,45664,45667,0,3,0
13101,4,1,45668,45668,45669,0,1,1
13102,1,1,45669,45669,45670,0,1,0
13103,4,3,45673,45673,45676,0,3,3
13104,2,1,45675,45676,45677,1,2,0
13105,1,3,45676,45677,45680,1,4,0
13106,6,2,45682,45682,45684,0,2,2
13107,5,1,45687,45687,45688,0,1,3
13108,5,2,45692,45692,45694,0,2,4
13109,5,1,45697,45697,45698,0,1,3
13110,4,1,45701,45701,45702,0,1,3
13111,2,3,45703,45703,45706,0,3,1
13112,5,3,45708,45708,45711,0,3,2
13113,2,3,45710,45711,45714,1,4,0
13114,2,1,45712,45714,45715,2,3,0
13115,6,2,45718,45718,45720,0,2,3
13116,1,2,45719,45720,45722,1,3,0
13117,6,2,45725,45725,45727,0,2,3
13118,3,2,45728,45728,45730,0,2,1
13119,1,1,45729,45730,45731,1,2,0
13120,4,1,45733,45733,45734,0,1,2
13121,2,2,45735,45735,45737,0,2,1
13122,6,3,45741,45741,45744,0,3,4
13123,6,2,45747,45747,45749,0,2,3
13124,1,2,45748,45749,45751,1,3,0
13125,5,1,45753,45753,45754,0,1,2
13126,1,1,45754,45754,45755,0,1,0
13127,4,3,45758,45758,45761,0,3,3
13128,2,2,45760,45761,45763,1,3,0
13129,3,2,45763,45763,45765,0,2,0
13130,3,2,45766,45766,45768,0,2,1
13131,1,2,45767,45768,45770,1,3,0
13132,6,2,45773,45773,45775,0,2,3
13133,3,2,45776,45776,45778,0,2,1
13134,5,3,45781,45781,45784,0,3,3
13135,6,1,45787,45787,45788,0,1,3
13136,2,2,45789,45789,45791,0,2,1
13137,3,3,45792,45792,45795,0,3,1
13138,5,1,45797,45797,45798,0,1,2
13139,2,3,45799,45799,45802,0,3,1
13140,3,1,45802,45802,45803,0,1,0
13141,1,3,45803,45803,45806,0,3,0
13142,1,1,45804,45806,45807,2,3,0
13143,1,1,45805,45807,45808,2,3,0
13144,5,2,45810,45810,45812,0,2,2
13145,4,2,45814,45814,45816,0,2,2
13146,5,2,45819,45819,45821,0,2,3
13147,5,3,45824,45824,45827,0,3,3
13148,4,1,45828,45828,45829,0,1,1
13149,3,2,45831,45831,45833,0,2,2
13150,6,1,45837,45837,45838,0,1,4
13151,6,3,45843,45843,45846,0,3,5
13152,2,1,45845,45846,45847,1,2,0
13153,5,3,45850,45850,45853,0,3,3
13154,1,1,45851,45853,45854,2,3,0
13155,4,2,45855,45855,45857,0,2,1
13156,5,3,45860,45860,45863,0,3,3
13157,4,2,45864,45864,45866,0,2,1
13158,1,1,45865,45866,45867,1,2,0
13159,4,1,45869,45869,45870,0,1,2
13160,3,1,45872,45872,45873,0,1,2
13161,3,1,45875,45875,45876,0,1,2
13162,2,2,45877,45877,45879,0,2,1
13163,6,3,45883,45883,45886,0,3,4
13164,2,2,45885,45886,45888,1,3,0
13165,3,2,45888,45888,45890,0,2,0
13166,4,2,45892,45892,45894,0,2,2
13167,1,3,45893,45894,45897,1,4,0
13168,5,2,45898,45898,45900,0,2,1
13169,3,3,45901,45901,45904,0,3,1
13170,4,2,45905,45905,45907,0,2,1
13171,4,3,45909,45909,45912,0,3,2
13172,5,2,45914,45914,45916,0,2,2
13173,5,1,45919,45919,45920,0,1,3
13174,3,1,45922,45922,45923,0,1,2
13175,3,1,45925,45925,45926,0,1,2
13176,2,3,45927,45927,45930,0,3,1
13177,1,1,45928,45930,45931,2,3,0
13178,6,1,45934,45934,45935,0,1,3
13179,3,2,45937,45937,45939,0,2,2
13180,5,1,45942,45942,45943,0,1,3
13181,5,2,45947,45947,45949,0,2,4
13182,5,2,45952,45952,45954,0,2,3
13183,6,1,45958,45958,45959,0,1,4
13184,5,2,45963,45963,45965,0,2,4
13185,2,3,45965,45965,45968,0,3,0
13186,1,1,45966,45968,45969,2,3,0
13187,1,3,45967,45969,45972,2,5,0
13188,5,3,45972,45972,45975,0,3,0
13189,6,1,45978,45978,45979,0,1,3
13190,5,3,45983,45983,45986,0,3,4
13191,5,1,45988,45988,45989,0,1,2
13192,6,2,45994,45994,45996,0,2,5
13193,4,3,45998,45998,46001,0,3,2
13194,5,3,46003,46003,46006,0,3,2
13195,4,3,46007,46007,46010,0,3,1
13196,6,2,46013,46013,46015,0,2,3
13197,2,1,46015,46015,46016,0,1,0
13198,4,1,46019,46019,46020,0,1,3
13199,2,2,46021,46021,46023,0,2,1
13200,2,2,46023,46023,46025,0,2,0
13201,5,3,46028,46028,46031,0,3,3
13202,2,2,46030,46031,46033,1,3,0
13203,6,3,46036,46036,46039,0,3,3
13204,2,2,46038,46039,46041,1,3,0
13205,1,3,46039,46041,46044,2,5,0
13206,3,2,46042,46044,46046,2,4,0
13207,1,1,46043,46046,46047,3,4,0
13208,4,3,46047,46047,46050,0,3,0
13209,1,3,46048,46050,46053,2,5,0
13210,4,2,46052,46053,46055,1,3,0
13211,5,1,46057,46057,46058,0,1,2
13212,6,1,46063,46063,46064,0,1,5
13213,1,3,46064,46064,46067,0,3,0
13214,5,3,46069,46069,46072,0,3,2
13215,3,3,46072,46072,46075,0,3,0
13216,6,3,46078,46078,46081,0,3,3
13217,4,3,46082,46082,46085,0,3,1
13218,5,2,46087,46087,46089,0,2,2
13219,2,2,46089,46089,46091,0,2,0
13220,3,3,46092,46092,46095,0,3,1
13221,1,1,46093,46095,46096,2,3,0
13222,3,1,46096,46096,46097,0,1,0
13223,1,1,46097,46097,46098,0,1,0
13224,3,1,46100,46100,46101,0,1,2
13225,1,2,46101,46101,46103,0,2,0
13226,4,2,46105,46105,46107,0,2,2
13227,3,1,46108,46108,46109,0,1,1
13228,3,3,46111,46111,46114,0,3,2
13229,2,2,46113,46114,46116,1,3,0
13230,4,3,46117,46117,46120,0,3,1
13231,1,3,46118,46120,46123,2,5,0
13232,6,2,46124,46124,46126,0,2,1
13233,1,3,46125,46126,46129,1,4,0
13234,3,3,46128,46129,46132,1,4,0
13235,1,2,46129,46132,46134,3,5,0
13236,3,2,46132,46134,46136,2,4,0
13237,3,1,46135,46136,46137,1,2,0
13238,1,1,46136,46137,46138,1,2,0
13239,2,3,46138,46138,46141,0,3,0
13240,5,3,46143,46143,46146,0,3,2
13241,5,2,46148,46148,46150,0,2,2
13242,2,3,46150,46150,46153,0,3,0
13243,2,3,46152,46153,46156,1,4,0
13244,6,3,46158,46158,46161,0,3,2
13245,4,1,46162,46162,46163,0,1,1
13246,6,3,46168,46168,46171,0,3,5
13247,5,3,46173,46173,46176,0,3,2
13248,1,2,46174,46176,46178,2,4,0
13249,5,1,46179,46179,46180,0,1,1
13250,3,2,46182,46182,46184,0,2,2
13251,1,3,46183,46184,46187,1,4,0
13252,3,1,46186,46187,46188,1,2,0
13253,6,1,46192,46192,46193,0,1,4
13254,2,1,46194,46194,46195,0,1,1
13255,1,2,46195,46195,46197,0,2,0
13256,4,2,46199,46199,46201,0,2,2
13257,4,1,46203,46203,46204,0,1,2
13258,6,3,46209,46209,46212,0,3,5
13259,4,1,46213,46213,46214,0,1,1
13260,4,3,46217,46217,46220,0,3,3
13261,5,3,46222,46222,46225,0,3,2
13262,3,1,46225,46225,46226,0,1,0
13263,4,3,46229,46229,46232,0,3,3
13264,6,2,46235,46235,46237,0,2,3
13265,3,2,46238,46238,46240,0,2,1
13266,5,2,46243,46243,46245,0,2,3
13267,2,3,46245,46245,46248,0,3,0
13268,6,3,46251,46251,46254,0,3,3
13269,6,3,46257,46257,46260,0,3,3
13270,5,3,46262,46262,46265,0,3,2
13271,4,3,46266,46266,46269,0,3,1
13272,5,2,46271,46271,46273,0,2,2
13273,5,1,46276,46276,46277,0,1,3
13274,3,3,46279,46279,46282,0,3,2
13275,6,3,46285,46285,46288,0,3,3
13276,5,1,46290,46290,46291,0,1,2
13277,3,3,46293,46293,46296,0,3,2
13278,4,3,46297,46297,46300,0,3,1
13279,4,1,46301,46301,46302,0,1,1
13280,3,3,46304,46304,46307,0,3,2
13281,2,3,46306,46307,46310,1,4,0
13282,1,2,46307,46310,46312,3,5,0
13283,3,3,46310,46312,46315,2,5,0
13284,3,3,46313,46315,46318,2,5,0
13285,3,3,46316,46318,46321,2,5,0
13286,5,1,46321,46321,46322,0,1,0
13287,4,1,46325,46325,46326,0,1,3
13288,4,1,46329,46329,46330,0,1,3
13289,2,2,46331,46331,46333,0,2,1
13290,6,3,46337,46337,46340,0,3,4
13291,5,3,46342,46342,46345,0,3,2
13292,6,3,46348,46348,46351,0,3,3
13293,3,1,46351,46351,46352,0,1,0
13294,2,3,46353,46353,46356,0,3,1
13295,6,2,46359,46359,46361,0,2,3
13296,6,3,46365,46365,46368,0,3,4
13297,1,3,46366,46368,46371,2,5,0
13298,3,2,46369,46371,46373,2,4,0
13299,2,1,46371,46373,46374,2,3,0
13300,6,3,46377,46377,46380,0,3,3
13301,2,2,46379,46380,46382,1,3,0
13302,4,3,46383,46383,46386,0,3,1
13303,3,1,46386,46386,46387,0,1,0
13304,1,2,46387,46387,46389,0,2,0
13305,1,2,46388,46389,46391,1,3,0
13306,3,1,46391,46391,46392,0,1,0
13307,1,2,46392,46392,46394,0,2,0
13308,5,3,46397,46397,46400,0,3,3
13309,5,2,46402,46402,46404,0,2,2
13310,3,1,46405,46405,46406,0,1,1
13311,4,1,46409,46409,46410,0,1,3
13312,1,2,46410,46410,46412,0,2,0
13313,2,1,46412,46412,46413,0,1,0
13314,4,2,46416,46416,46418,0,2,3
13315,4,2,46420,46420,46422,0,2,2
13316,5,2,46425,46425,46427,0,2,3
13317,2,2,46427,46427,46429,0,2,0
13318,4,3,46431,46431,46434,0,3,2
13319,6,3,46437,46437,46440,0,3,3
13320,6,2,46443,46443,46445,0,2,3
13321,5,2,46448,46448,46450,0,2,3
13322,2,1,46450,46450,46451,0,1,0
13323,6,1,46456,46456,46457,0,1,5
13324,3,2,46459,46459,46461,0,2,2
13325,4,2,46463,46463,46465,0,2,2
13326,2,1,46465,46465,46466,0,1,0
13327,3,2,46468,46468,46470,0,2,2
13328,4,1,46472,46472,46473,0,1,2
13329,6,2,46478,46478,46480,0,2,5
13330,4,3,46482,46482,46485,0,3,2
13331,6,2,46488,46488,46490,0,2,3
13332,5,3,46493,46493,46496,0,3,3
13333,3,3,46496,46496,46499,0,3,0
13334,6,1,46502,46502,46503,0,1,3
13335,6,2,46508,46508,46510,0,2,5
13336,6,2,46514,46514,46516,0,2,4
13337,3,3,46517,46517,46520,0,3,1
13338,4,1,46521,46521,46522,0,1,1
13339,6,1,46527,46527,46528,0,1,5
13340,2,3,46529,46529,46532,0,3,1
13341,4,1,46533,46533,46534,0,1,1
13342,5,1,46538,46538,46539,0,1,4
13343,6,2,46544,46544,46546,0,2,5
13344,2,2,46546,46546,46548,0,2,0
13345,6,3,46552,46552,46555,0,3,4
13346,1,1,46553,46555,46556,2,3,0
13347,5,3,46558,46558,46561,0,3,2
13348,4,3,46562,46562,46565,0,3,1
13349,1,3,46563,46565,46568,2,5,0
13350,3,1,46566,46568,46569,2,3,0
13351,3,3,46569,46569,46572,0,3,0
13352,2,3,46571,46572,46575,1,4,0
13353,6,3,46577,46577,46580,0,3,2
13354,5,1,46582,46582,46583,0,1,2
13355,3,2,46585,46585,46587,0,2,2
13356,1,3,46586,46587,46590,1,4,0
13357,1,2,46587,46590,46592,3,5,0
13358,2,2,46589,46592,46594,3,5,0
13359,6,1,46595,46595,46596,0,1,1
13360,5,1,46600,46600,46601,0,1,4
13361,3,2,46603,46603,46605,0,2,2
13362,1,2,46604,46605,46607,1,3,0
13363,1,3,46605,46607,46610,2,5,0
13364,1,3,46606,46610,46613,4,7,0
13365,6,3,46612,46613,46616,1,4,0
13366,6,3,46618,46618,46621,0,3,2
13367,6,3,46624,46624,46627,0,3,3
13368,5,2,46629,46629,46631,0,2,2
13369,2,1,46631,46631,46632,0,1,0
13370,6,3,46637,46637,46640,0,3,5
13371,6,2,46643,46643,46645,0,2,3
13372,1,2,46644,46645,46647,1,3,0
13373,1,3,46645,46647,46650,2,5,0
13374,6,1,46651,46651,46652,0,1,1
13375,5,3,46656,46656,46659,0,3,4
13376,5,2,46661,46661,46663,0,2,2
13377,5,2,46666,46666,46668,0,2,3
13378,5,1,46671,46671,46672,0,1,3
13379,3,3,46674,46674,46677,0,3,2
13380,3,1,46677,46677,46678,0,1,0
13381,6,3,46683,46683,46686,0,3,5
13382,4,2,46687,46687,46689,0,2,1
13383,3,3,46690,46690,46693,0,3,1
13384,2,3,46692,46693,46696,1,4,0
13385,2,3,46694,46696,46699,2,5,0
13386,5,3,46699,46699,46702,0,3,0
13387,1,1,46700,46702,46703,2,3,0
13388,2,3,46702,46703,46706,1,4,0
13389,4,1,46706,46706,46707,0,1,0
13390,3,1,46709,46709,46710,0,1,2
13391,1,2,46710,46710,46712,0,2,0
13392,5,3,46715,46715,46718,0,3,3
13393,2,1,46717,46718,46719,1,2,0
13394,6,2,46723,46723,46725,0,2,4
13395,1,2,46724,46725,46727,1,3,0
13396,4,2,46728,46728,46730,0,2,1
13397,3,1,46731,46731,46732,0,1,1
13398,6,3,46737,46737,46740,0,3,5
13399,6,1,46743,46743,46744,0,1,3
13400,6,1,46749,46749,46750,0,1,5
13401,3,1,46752,46752,46753,0,1,2
13402,4,1,46756,46756,46757,0,1,3
13403,3,2,46759,46759,46761,0,2,2
13404,2,3,46761,46761,46764,0,3,0
13405,6,2,46767,46767,46769,0,2,3
13406,6,2,46773,46773,46775,0,2,4
13407,2,2,46775,46775,46777,0,2,0
13408,3,2,46778,46778,46780,0,2,1
13409,6,1,46784,46784,46785,0,1,4
13410,5,3,46789,46789,46792,0,3,4
13411,3,3,46792,46792,46795,0,3,0
13412,3,3,46795,46795,46798,0,3,0
13413,1,3,46796,46798,46801,2,5,0
13414,6,2,46802,46802,46804,0,2,1
13415,5,3,46807,46807,46810,0,3,3
13416,2,1,46809,46810,46811,1,2,0
13417,6,2,46815,46815,46817,0,2,4
13418,5,2,46820,46820,46822,0,2,3
13419,5,1,46825,46825,46826,0,1,3
13420,5,1,46830,46830,46831,0,1,4
13421,2,2,46832,46832,46834,0,2,1
13422,3,3,46835,46835,46838,0,3,1
13423,4,1,46839,46839,46840,0,1,1
13424,4,2,46843,46843,46845,0,2,3
13425,1,2,46844,46845,46847,1,3,0
13426,2,1,46846,46847,46848,1,2,0
13427,4,1,46850,46850,46851,0,1,2
13428,1,1,46851,46851,46852,0,1,0
13429,2,1,46853,46853,46854,0,1,1
13430,3,3,46856,46856,46859,0,3,2
13431,5,2,46861,46861,46863,0,2,2
13432,6,3,46867,46867,46870,0,3,4
13433,1,2,46868,46870,46872,2,4,0
13434,2,2,46870,46872,46874,2,4,0
13435,3,2,46873,46874,46876,1,3,0
13436,5,1,46878,46878,46879,0,1,2
13437,6,2,46884,46884,46886,0,2,5
13438,2,2,46886,46886,46888,0,2,0
13439,1,1,46887,46888,46889,1,2,0
13440,3,3,46890,46890,46893,0,3,1
13441,4,3,46894,46894,46897,0,3,1
13442,4,1,46898,46898,46899,0,1,1
13443,4,2,46902,46902,46904,0,2,3
13444,4,1,46906,46906,46907,0,1,2
13445,1,2,46907,46907,46909,0,2,0
13446,4,1,46911,46911,46912,0,1,2
13447,6,3,46917,46917,46920,0,3,5
13448,5,2,46922,46922,46924,0,2,2
13449,2,1,46924,46924,46925,0,1,0
13450,5,2,46929,46929,46931,0,2,4
13451,5,1,46934,46934,46935,0,1,3
13452,2,1,46936,46936,46937,0,1,1
13453,5,3,46941,46941,46944,0,3,4
13454,3,1,46944,46944,46945,0,1,0
13455,4,1,46948,46948,46949,0,1,3
13456,3,3,46951,46951,46954,0,3,2
13457,6,3,46957,46957,46960,0,3,3
13458,3,2,46960,46960,46962,0,2,0
13459,2,1,46962,46962,46963,0,1,0
13460,1,2,46963,46963,46965,0,2,0
13461,1,2,46964,46965,46967,1,3,0
13462,5,1,46969,46969,46970,0,1,2
13463,6,1,46975,46975,46976,0,1,5
13464,1,1,46976,46976,46977,0,1,0
13465,2,3,46978,46978,46981,0,3,1
13466,6,3,46984,46984,46987,0,3,3
13467,2,1,46986,46987,46988,1,2,0
13468,1,2,46987,46988,46990,1,3,0
13469,4,3,46991,46991,46994,0,3,1
13470,6,1,46997,46997,46998,0,1,3
13471,4,1,47001,47001,47002,0,1,3
13472,4,1,47005,47005,47006,0,1,3
13473,6,3,47011,47011,47014,0,3,5
13474,2,3,47013,47014,47017,1,4,0
13475,1,2,47014,47017,47019,3,5,0
13476,3,3,47017,47019,47022,2,5,0
13477,1,2,47018,47022,47024,4,6,0
13478,4,2,47022,47024,47026,2,4,0
13479,5,2,47027,47027,47029,0,2,1
13480,6,2,47033,47033,47035,0,2,4
13481,1,2,47034,47035,47037,1,3,0
13482,1,1,47035,47037,47038,2,3,0
13483,5,1,47040,47040,47041,0,1,2
13484,2,2,47042,47042,47044,0,2,1
13485,6,2,47048,47048,47050,0,2,4
13486,5,1,47053,47053,47054,0,1,3
13487,6,3,47059,47059,47062,0,3,5
13488,5,2,47064,47064,47066,0,2,2
13489,4,2,47068,47068,47070,0,2,2
13490,6,3,47074,47074,47077,0,3,4
13491,2,3,47076,47077,47080,1,4,0
13492,1,1,47077,47080,47081,3,4,0
13493,2,1,47079,47081,47082,2,3,0
13494,5,1,47084,47084,47085,0,1,2
13495,6,3,47090,47090,47093,0,3,5
13496,6,3,47096,47096,47099,0,3,3
13497,4,2,47100,47100,47102,0,2,1
13498,2,2,47102,47102,47104,0,2,0
13499,4,2,47106,47106,47108,0,2,2
13500,3,1,47109,47109,47110,0,1,1
13501,5,3,47114,47114,47117,0,3,4
13502,3,1,47117,47117,47118,0,1,0
13503,5,1,47122,47122,47123,0,1,4
13504,4,1,47126,47126,47127,0,1,3
13505,4,2,47130,47130,47132,0,2,3
13506,6,1,47136,47136,47137,0,1,4
13507,3,3,47139,47139,47142,0,3,2
13508,5,2,47144,47144,47146,0,2,2
13509,1,1,47145,47146,47147,1,2,0
13510,5,2,47150,47150,47152,0,2,3
13511,3,2,47153,47153,47155,0,2,1
13512,1,2,47154,47155,47157,1,3,0
13513,4,1,47158,47158,47159,0,1,1
13514,1,2,47159,47159,47161,0,2,0
13515,4,2,47163,47163,47165,0,2,2
13516,2,1,47165,47165,47166,0,1,0
13517,2,1,47167,47167,47168,0,1,1
13518,4,2,47171,47171,47173,0,2,3
13519,6,1,47177,47177,47178,0,1,4
13520,6,3,47183,47183,47186,0,3,5
13521,1,1,47184,47186,47187,2,3,0
13522,3,3,47187,47187,47190,0,3,0
13523,5,2,47192,47192,47194,0,2,2
13524,5,2,47197,47197,47199,0,2,3
13525,2,3,47199,47199,47202,0,3,0
13526,1,1,47200,47202,47203,2,3,0
13527,6,3,47206,47206,47209,0,3,3
13528,4,3,47210,47210,47213,0,3,1
13529,4,2,47214,47214,47216,0,2,1
13530,3,1,47217,47217,47218,0,1,1
13531,6,1,47223,47223,47224,0,1,5
13532,6,3,47229,47229,47232,0,3,5
13533,3,1,47232,47232,47233,0,1,0
13534,2,2,47234,47234,47236,0,2,1
13535,2,3,47236,47236,47239,0,3,0
13536,1,3,47237,47239,47242,2,5,0
13537,1,3,47238,47242,47245,4,7,0
13538,5,3,47243,47245,47248,2,5,0
13539,4,1,47247,47248,47249,1,2,0
13540,5,2,47252,47252,47254,0,2,3
13541,6,3,47258,47258,47261,0,3,4
13542,6,3,47264,47264,47267,0,3,3
13543,3,3,47267,47267,47270,0,3,0
13544,5,3,47272,47272,47275,0,3,2
13545,2,3,47274,47275,47278,1,4,0
13546,1,2,47275,47278,47280,3,5,0
13547,3,3,47278,47280,47283,2,5,0
13548,6,1,47284,47284,47285,0,1,1
13549,6,1,47290,47290,47291,0,1,5
13550,1,2,47291,47291,47293,0,2,0
13551,1,2,47292,47293,47295,1,3,0
13552,3,2,47295,47295,47297,0,2,0
13553,3,2,47298,47298,47300,0,2,1
13554,5,1,47303,47303,47304,0,1,3
13555,5,2,47308,47308,47310,0,2,4
13556,5,1,47313,47313,47314,0,1,3
13557,2,1,47315,47315,47316,0,1,1
13558,4,1,47319,47319,47320,0,1,3
13559,2,3,47321,47321,47324,0,3,1
13560,1,1,47322,47324,47325,2,3,0
13561,5,1,47327,47327,47328,0,1,2
13562,3,3,47330,47330,47333,0,3,2
13563,4,3,47334,47334,47337,0,3,1
13564,6,3,47340,47340,47343,0,3,3
13565,2,2,47342,47343,47345,1,3,0
13566,3,1,47345,47345,47346,0,1,0
13567,3,3,47348,47348,47351,0,3,2
13568,4,3,47352,47352,47355,0,3,1
13569,1,3,47353,47355,47358,2,5,0
13570,5,2,47358,47358,47360,0,2,0
13571,1,2,47359,47360,47362,1,3,0
13572,3,1,47362,47362,47363,0,1,0
13573,1,2,47363,47363,47365,0,2,0
13574,4,1,47367,47367,47368,0,1,2
13575,4,3,47371,47371,47374,0,3,3
13576,6,2,47377,47377,47379,0,2,3
13577,1,3,47378,47379,47382,1,4,0
13578,1,2,47379,47382,47384,3,5,0
13579,6,3,47385,47385,47388,0,3,1
13580,6,1,47391,47391,47392,0,1,3
13581,5,1,47396,47396,47397,0,1,4
13582,1,2,47397,47397,47399,0,2,0
13583,4,2,47401,47401,47403,0,2,2
13584,6,1,47407,47407,47408,0,1,4
13585,5,2,47412,47412,47414,0,2,4
13586,5,2,47417,47417,47419,0,2,3
13587,1,3,47418,47419,47422,1,4,0
13588,6,1,47424,47424,47425,0,1,2
13589,6,3,47430,47430,47433,0,3,5
13590,3,3,47433,47433,47436,0,3,0
13591,1,2,47434,47436,47438,2,4,0
13592,4,3,47438,47438,47441,0,3,0
13593,4,1,47442,47442,47443,0,1,1
13594,2,2,47444,47444,47446,0,2,1
13595,1,1,47445,47446,47447,1,2,0
13596,4,2,47449,47449,47451,0,2,2
13597,2,3,47451,47451,47454,0,3,0
13598,2,1,47453,47454,47455,1,2,0
13599,1,2,47454,47455,47457,1,3,0
13600,2,3,47456,47457,47460,1,4,0
13601,4,3,47460,47460,47463,0,3,0
13602,1,3,47461,47463,47466,2,5,0
13603,5,1,47466,47466,47467,0,1,0
13604,2,1,47468,47468,47469,0,1,1
13605,1,1,47469,47469,47470,0,1,0
13606,5,1,47474,47474,47475,0,1,4
13607,2,1,47476,47476,47477,0,1,1
13608,2,1,47478,47478,47479,0,1,1
13609,6,3,47484,47484,47487,0,3,5
13610,5,2,47489,47489,47491,0,2,2
13611,3,3,47492,47492,47495,0,3,1
13612,3,2,47495,47495,47497,0,2,0
13613,1,2,47496,47497,47499,1,3,0
13614,3,3,47499,47499,47502,0,3,0
13615,4,3,47503,47503,47506,0,3,1
13616,6,3,47509,47509,47512,0,3,3
13617,5,3,47514,47514,47517,0,3,2
13618,2,3,47516,47517,47520,1,4,0
13619,3,3,47519,47520,47523,1,4,0
13620,3,1,47522,47523,47524,1,2,0
13621,5,3,47527,47527,47530,0,3,3
13622,4,3,47531,47531,47534,0,3,1
13623,5,3,47536,47536,47539,0,3,2
13624,1,1,47537,47539,47540,2,3,0
13625,2,2,47539,47540,47542,1,3,0
13626,5,1,47544,47544,47545,0,1,2
13627,4,2,47548,47548,47550,0,2,3
13628,3,1,47551,47551,47552,0,1,1
13629,4,3,47555,47555,47558,0,3,3
13630,4,2,47559,47559,47561,0,2,1
13631,2,2,47561,47561,47563,0,2,0
13632,1,2,47562,47563,47565,1,3,0
13633,1,2,47563,47565,47567,2,4,0
13634,3,2,47566,47567,47569,1,3,0
13635,1,2,47567,47569,47571,2,4,0
13636,5,1,47572,47572,47573,0,1,1
13637,1,1,47573,47573,47574,0,1,0
13638,1,1,47574,47574,47575,0,1,0
13639,2,1,47576,47576,47577,0,1,1
13640,2,1,47578,47578,47579,0,1,1
13641,1,1,47579,47579,47580,0,1,0
13642,2,1,47581,47581,47582,0,1,1
13643,6,1,47587,47587,47588,0,1,5
13644,2,1,47589,47589,47590,0,1,1
13645,6,3,47595,47595,47598,0,3,5
13646,3,1,47598,47598,47599,0,1,0
13647,2,3,47600,47600,47603,0,3,1
13648,2,3,47602,47603,47606,1,4,0
13649,3,1,47605,47606,47607,1,2,0
13650,2,1,47607,47607,47608,0,1,0
13651,5,2,47612,47612,47614,0,2,4
13652,1,3,47613,47614,47617,1,4,0
13653,5,2,47618,47618,47620,0,2,1
13654,2,3,47620,47620,47623,0,3,0
13655,1,1,47621,47623,47624,2,3,0
13656,3,3,47624,47624,47627,0,3,0
13657,3,3,47627,47627,47630,0,3,0
13658,3,2,47630,47630,47632,0,2,0
13659,1,3,47631,47632,47635,1,4,0
13660,5,3,47636,47636,47639,0,3,1
13661,1,3,47637,47639,47642,2,5,0
13662,1,1,47638,47642,47643,4,5,0
13663,2,3,47640,47643,47646,3,6,0
13664,3,1,47643,47646,47647,3,4,0
13665,5,3,47648,47648,47651,0,3,1
13666,5,3,47653,47653,47656,0,3,2
13667,1,3,47654,47656,47659,2,5,0
13668,2,3,47656,47659,47662,3,6,0
13669,2,2,47658,47662,47664,4,6,0
13670,1,2,47659,47664,47666,5,7,0
13671,3,1,47662,47666,47667,4,5,0
13672,6,1,47668,47668,47669,0,1,1
13673,5,2,47673,47673,47675,0,2,4
13674,6,2,47679,47679,47681,0,2,4
13675,4,3,47683,47683,47686,0,3,2
13676,6,2,47689,47689,47691,0,2,3
13677,4,2,47693,47693,47695,0,2,2
13678,6,3,47699,47699,47702,0,3,4
13679,2,2,47701,47702,47704,1,3,0
13680,5,2,47706,47706,47708,0,2,2
13681,6,3,47712,47712,47715,0,3,4
13682,4,3,47716,47716,47719,0,3,1
13683,5,2,47721,47721,47723,0,2,2
13684,1,3,47722,47723,47726,1,4,0
13685,2,2,47724,47726,47728,2,4,0
13686,5,3,47729,47729,47732,0,3,1
13687,4,3,47733,47733,47736,0,3,1
13688,3,2,47736,47736,47738,0,2,0
13689,4,3,47740,47740,47743,0,3,2
13690,4,2,47744,47744,47746,0,2,1
13691,4,1,47748,47748,47749,0,1,2
13692,2,3,47750,47750,47753,0,3,1
13693,2,1,47752,47753,47754,1,2,0
13694,4,1,47756,47756,47757,0,1,2
13695,3,3,47759,47759,47762,0,3,2
13696,3,2,47762,47762,47764,0,2,0
13697,4,1,47766,47766,47767,0,1,2
13698,5,1,47771,47771,47772,0,1,4
13699,5,2,47776,47776,47778,0,2,4
13700,2,3,47778,47778,47781,0,3,0
13701,3,3,47781,47781,47784,0,3,0
13702,1,2,47782,47784,47786,2,4,0
13703,4,3,47786,47786,47789,0,3,0
13704,5,3,47791,47791,47794,0,3,2
13705,4,3,47795,47795,47798,0,3,1
13706,3,2,47798,47798,47800,0,2,0
13707,4,2,47802,47802,47804,0,2,2
13708,6,3,47808,47808,47811,0,3,4
13709,4,1,47812,47812,47813,0,1,1
13710,1,1,47813,47813,47814,0,1,0
13711,6,1,47819,47819,47820,0,1,5
13712,4,1,47823,47823,47824,0,1,3
13713,5,1,47828,47828,47829,0,1,4
13714,6,1,47834,47834,47835,0,1,5
13715,3,2,47837,47837,47839,0,2,2
13716,6,2,47843,47843,47845,0,2,4
13717,6,3,47849,47849,47852,0,3,4
13718,6,2,47855,47855,47857,0,2,3
13719,6,2,47861,47861,47863,0,2,4
13720,2,2,47863,47863,47865,0,2,0
13721,5,3,47868,47868,47871,0,3,3
13722,4,1,47872,47872,47873,0,1,1
13723,3,1,47875,47875,47876,0,1,2
13724,6,3,47881,47881,47884,0,3,5
13725,2,3,47883,47884,47887,1,4,0
13726,3,2,47886,47887,47889,1,3,0
13727,6,1,47892,47892,47893,0,1,3
13728,3,1,47895,47895,47896,0,1,2
13729,3,3,47898,47898,47901,0,3,2
13730,4,3,47902,47902,47905,0,3,1
13731,5,2,47907,47907,47909,0,2,2
13732,3,2,47910,47910,47912,0,2,1
13733,4,1,47914,47914,47915,0,1,2
13734,4,1,47918,47918,47919,0,1,3
13735,2,2,47920,47920,47922,0,2,1
13736,5,3,47925,47925,47928,0,3,3
13737,5,1,47930,47930,47931,0,1,2
13738,4,2,47934,47934,47936,0,2,3
13739,4,3,47938,47938,47941,0,3,2
13740,3,2,47941,47941,47943,0,2,0
13741,1,3,47942,47943,47946,1,4,0
13742,1,2,47943,47946,47948,3,5,0
13743,3,1,47946,47948,47949,2,3,0
13744,5,3,47951,47951,47954,0,3,2
13745,3,2,47954,47954,47956,0,2,0
13746,4,1,47958,47958,47959,0,1,2
13747,1,3,47959,47959,47962,0,3,0
13748,5,3,47964,47964,47967,0,3,2
13749,2,3,47966,47967,47970,1,4,0
13750,6,3,47972,47972,47975,0,3,2
13751,1,1,47973,47975,47976,2,3,0
13752,4,2,47977,47977,47979,0,2,1
13753,4,3,47981,47981,47984,0,3,2
13754,4,3,47985,47985,47988,0,3,1
13755,1,1,47986,47988,47989,2,3,0
13756,2,1,47988,47989,47990,1,2,0
13757,3,1,47991,47991,47992,0,1,1
13758,6,1,47997,47997,47998,0,1,5
13759,6,3,48003,48003,48006,0,3,5
13760,3,2,48006,48006,48008,0,2,0
13761,2,1,48008,48008,48009,0,1,0
13762,1,1,48009,48009,48010,0,1,0
13763,2,3,48011,48011,48014,0,3,1
13764,2,3,48013,48014,48017,1,4,0
13765,6,1,48019,48019,48020,0,1,2
13766,3,3,48022,48022,48025,0,3,2
13767,2,1,48024,48025,48026,1,2,0
13768,5,1,48029,48029,48030,0,1,3
13769,2,3,48031,48031,48034,0,3,1
13770,5,3,48036,48036,48039,0,3,2
13771,4,2,48040,48040,48042,0,2,1
13772,5,3,48045,48045,48048,0,3,3
13773,1,3,48046,48048,48051,2,5,0
13774,5,3,48051,48051,48054,0,3,0
13775,3,1,48054,48054,48055,0,1,0
13776,1,1,48055,48055,48056,0,1,0
13777,5,3,48060,48060,48063,0,3,4
13778,5,1,48065,48065,48066,0,1,2
13779,5,1,48070,48070,48071,0,1,4
13780,5,3,48075,48075,48078,0,3,4
13781,6,1,48081,48081,48082,0,1,3
13782,2,1,48083,48083,48084,0,1,1
13783,4,3,48087,48087,48090,0,3,3
13784,1,1,48088,48090,48091,2,3,0
13785,3,3,48091,48091,48094,0,3,0
13786,6,1,48097,48097,48098,0,1,3
13787,4,2,48101,48101,48103,0,2,3
13788,3,2,48104,48104,48106,0,2,1
13789,5,2,48109,48109,48111,0,2,3
13790,2,1,48111,48111,48112,0,1,0
13791,4,1,48115,48115,48116,0,1,3
13792,6,1,48121,48121,48122,0,1,5
13793,5,1,48126,48126,48127,0,1,4
13794,6,3,48132,48132,48135,0,3,5
13795,3,1,48135,48135,48136,0,1,0
13796,4,1,48139,48139,48140,0,1,3
13797,1,1,48140,48140,48141,0,1,0
13798,3,2,48143,48143,48145,0,2,2
13799,1,2,48144,48145,48147,1,3,0
13800,5,1,48149,48149,48150,0,1,2
13801,6,3,48155,48155,48158,0,3,5
13802,6,3,48161,48161,48164,0,3,3
13803,2,3,48163,48164,48167,1,4,0
13804,6,3,48169,48169,48172,0,3,2
13805,6,3,48175,48175,48178,0,3,3
13806,1,1,48176,48178,48179,2,3,0
13807,3,1,48179,48179,48180,0,1,0
13808,2,1,48181,48181,48182,0,1,1
13809,3,2,48184,48184,48186,0,2,2
13810,4,3,48188,48188,48191,0,3,2
13811,3,1,48191,48191,48192,0,1,0
13812,2,2,48193,48193,48195,0,2,1
13813,3,1,48196,48196,48197,0,1,1
13814,6,3,48202,48202,48205,0,3,5
13815,3,3,48205,48205,48208,0,3,0
13816,1,3,48206,48208,48211,2,5,0
13817,1,3,48207,48211,48214,4,7,0
13818,6,1,48213,48214,48215,1,2,0
13819,6,2,48219,48219,48221,0,2,4
13820,6,1,48225,48225,48226,0,1,4
13821,5,2,48230,48230,48232,0,2,4
13822,5,3,48235,48235,48238,0,3,3
13823,1,2,48236,48238,48240,2,4,0
13824,2,2,48238,48240,48242,2,4,0
13825,1,3,48239,48242,48245,3,6,0
13826,3,2,48242,48245,48247,3,5,0
13827,5,1,48247,48247,48248,0,1,0
13828,6,3,48253,48253,48256,0,3,5
13829,2,3,48255,48256,48259,1,4,0
13830,4,3,48259,48259,48262,0,3,0
13831,3,2,48262,48262,48264,0,2,0
13832,3,3,48265,48265,48268,0,3,1
13833,5,1,48270,48270,48271,0,1,2
13834,4,3,48274,48274,48277,0,3,3
13835,1,1,48275,48277,48278,2,3,0
13836,6,1,48281,48281,48282,0,1,3
13837,2,3,48283,48283,48286,0,3,1
13838,3,1,48286,48286,48287,0,1,0
13839,4,3,48290,48290,48293,0,3,3
13840,6,3,48296,48296,48299,0,3,3
13841,1,1,48297,48299,48300,2,3,0
13842,4,3,48301,48301,48304,0,3,1
13843,1,1,48302,48304,48305,2,3,0
13844,3,2,48305,48305,48307,0,2,0
13845,1,3,48306,48307,48310,1,4,0
13846,4,1,48310,48310,48311,0,1,0
13847,5,1,48315,48315,48316,0,1,4
13848,2,2,48317,48317,48319,0,2,1
13849,6,2,48323,48323,48325,0,2,4
13850,2,1,48325,48325,48326,0,1,0
13851,6,2,48331,48331,48333,0,2,5
13852,6,3,48337,48337,48340,0,3,4
13853,1,2,48338,48340,48342,2,4,0
13854,4,3,48342,48342,48345,0,3,0
13855,5,2,48347,48347,48349,0,2,2
13856,1,3,48348,48349,48352,1,4,0
13857,6,1,48354,48354,48355,0,1,2
13858,1,3,48355,48355,48358,0,3,0
13859,2,3,48357,48358,48361,1,4,0
13860,6,2,48363,48363,48365,0,2,2
13861,1,1,48364,48365,48366,1,2,0
13862,5,2,48369,48369,48371,0,2,3
13863,6,2,48375,48375,48377,0,2,4
13864,5,3,48380,48380,48383,0,3,3
13865,5,1,48385,48385,48386,0,1,2
13866,5,3,48390,48390,48393,0,3,4
13867,1,1,48391,48393,48394,2,3,0
13868,3,2,48394,48394,48396,0,2,0
13869,6,2,48400,48400,48402,0,2,4
13870,6,2,48406,48406,48408,0,2,4
13871,6,2,48412,48412,48414,0,2,4
13872,5,3,48417,48417,48420,0,3,3
13873,6,3,48423,48423,48426,0,3,3
13874,2,1,48425,48426,48427,1,2,0
13875,1,1,48426,48427,48428,1,2,0
13876,3,3,48429,48429,48432,0,3,1
13877,3,3,48432,48432,48435,0,3,0
13878,4,2,48436,48436,48438,0,2,1
13879,5,2,48441,48441,48443,0,2,3
13880,6,1,48447,48447,48448,0,1,4
13881,1,3,48448,48448,48451,0,3,0
13882,6,2,48454,48454,48456,0,2,3
13883,2,2,48456,48456,48458,0,2,0
13884,6,3,48462,48462,48465,0,3,4
13885,2,1,48464,48465,48466,1,2,0
13886,6,1,48470,48470,48471,0,1,4
13887,6,2,48476,48476,48478,0,2,5
13888,4,1,48480,48480,48481,0,1,2
13889,3,1,48483,48483,48484,0,1,2
13890,2,1,48485,48485,48486,0,1,1
13891,5,2,48490,48490,48492,0,2,4
13892,1,2,48491,48492,48494,1,3,0
13893,3,2,48494,48494,48496,0,2,0
13894,5,3,48499,48499,48502,0,3,3
13895,6,1,48505,48505,48506,0,1,3
13896,4,3,48509,48509,48512,0,3,3
13897,6,2,48515,48515,48517,0,2,3
13898,5,2,48520,48520,48522,0,2,3
13899,6,2,48526,48526,48528,0,2,4
13900,6,1,48532,48532,48533,0,1,4
13901,1,3,48533,48533,48536,0,3,0
13902,4,1,48537,48537,48538,0,1,1
13903,6,2,48543,48543,48545,0,2,5
13904,2,1,48545,48545,48546,0,1,0
13905,6,3,48551,48551,48554,0,3,5
13906,4,3,48555,48555,48558,0,3,1
13907,6,3,48561,48561,48564,0,3,3
13908,6,3,48567,48567,48570,0,3,3
13909,6,1,48573,48573,48574,0,1,3
13910,5,1,48578,48578,48579,0,1,4
13911,4,2,48582,48582,48584,0,2,3
13912,4,2,48586,48586,48588,0,2,2
13913,2,3,48588,48588,48591,0,3,0
13914,4,1,48592,48592,48593,0,1,1
13915,5,1,48597,48597,48598,0,1,4
13916,4,2,48601,48601,48603,0,2,3
13917,1,2,48602,48603,48605,1,3,0
13918,4,2,48606,48606,48608,0,2,1
13919,3,1,48609,48609,48610,0,1,1
13920,6,1,48615,48615,48616,0,1,5
13921,2,2,48617,48617,48619,0,2,1
13922,5,1,48622,48622,48623,0,1,3
13923,6,3,48628,48628,48631,0,3,5
13924,5,2,48633,48633,48635,0,2,2
13925,4,3,48637,48637,48640,0,3,2
13926,1,3,48638,48640,48643,2,5,0
13927,6,1,48644,48644,48645,0,1,1
13928,4,3,48648,48648,48651,0,3,3
13929,1,3,48649,48651,48654,2,5,0
13930,1,3,48650,48654,48657,4,7,0
13931,3,2,48653,48657,48659,4,6,0
13932,5,2,48658,48659,48661,1,3,0
13933,1,3,48659,48661,48664,2,5,0
13934,3,2,48662,48664,48666,2,4,0
13935,2,3,48664,48666,48669,2,5,0
13936,1,2,48665,48669,48671,4,6,0
13937,2,2,48667,48671,48673,4,6,0
13938,5,2,48672,48673,48675,1,3,0
13939,5,3,48677,48677,48680,0,3,2
13940,6,2,48683,48683,48685,0,2,3
13941,6,1,48689,48689,48690,0,1,4
13942,2,1,48691,48691,48692,0,1,1
13943,6,3,48697,48697,48700,0,3,5
13944,2,2,48699,48700,48702,1,3,0
13945,5,2,48704,48704,48706,0,2,2
13946,6,3,48710,48710,48713,0,3,4
13947,5,1,48715,48715,48716,0,1,2
13948,4,1,48719,48719,48720,0,1,3
13949,1,2,48720,48720,48722,0,2,0
13950,5,3,48725,48725,48728,0,3,3
13951,6,1,48731,48731,48732,0,1,3
13952,5,3,48736,48736,48739,0,3,4
13953,3,3,48739,48739,48742,0,3,0
13954,6,3,48745,48745,48748,0,3,3
13955,6,2,48751,48751,48753,0,2,3
13956,3,3,48754,48754,48757,0,3,1
13957,3,3,48757,48757,48760,0,3,0
13958,6,2,48763,48763,48765,0,2,3
13959,3,2,48766,48766,48768,0,2,1
13960,3,1,48769,48769,48770,0,1,1
13961,4,1,48773,48773,48774,0,1,3
13962,2,1,48775,48775,48776,0,1,1
13963,3,1,48778,48778,48779,0,1,2
13964,6,3,48784,48784,48787,0,3,5
13965,4,3,48788,48788,48791,0,3,1
13966,1,3,48789,48791,48794,2,5,0
13967,5,3,48794,48794,48797,0,3,0
13968,1,1,48795,48797,48798,2,3,0
13969,5,3,48800,48800,48803,0,3,2
13970,1,1,48801,48803,48804,2,3,0
13971,6,2,48807,48807,48809,0,2,3
13972,5,1,48812,48812,48813,0,1,3
13973,3,3,48815,48815,48818,0,3,2
13974,5,1,48820,48820,48821,0,1,2
13975,5,3,48825,48825,48828,0,3,4
13976,5,2,48830,48830,48832,0,2,2
13977,4,3,48834,48834,48837,0,3,2
13978,4,2,48838,48838,48840,0,2,1
13979,3,3,48841,48841,48844,0,3,1
13980,6,2,48847,48847,48849,0,2,3
13981,6,3,48853,48853,48856,0,3,4
13982,6,1,48859,48859,48860,0,1,3
13983,1,1,48860,48860,48861,0,1,0
13984,1,3,48861,48861,48864,0,3,0
13985,6,1,48867,48867,48868,0,1,3
13986,4,1,48871,48871,48872,0,1,3
13987,5,2,48876,48876,48878,0,2,4
13988,5,3,48881,48881,48884,0,3,3
13989,4,2,48885,48885,48887,0,2,1
13990,4,1,48889,48889,48890,0,1,2
13991,4,1,48893,48893,48894,0,1,3
13992,5,3,48898,48898,48901,0,3,4
13993,4,2,48902,48902,48904,0,2,1
13994,5,1,48907,48907,48908,0,1,3
13995,2,1,48909,48909,48910,0,1,1
13996,3,3,48912,48912,48915,0,3,2
13997,3,1,48915,48915,48916,0,1,0
13998,3,2,48918,48918,48920,0,2,2
13999,4,3,48922,48922,48925,0,3,2
14000,6,2,48928,48928,48930,0,2,3
14001,4,1,48932,48932,48933,0,1,2
14002,5,2,48937,48937,48939,0,2,4
14003,4,1,48941,48941,48942,0,1,2
14004,4,1,48945,48945,48946,0,1,3
14005,5,2,48950,48950,48952,0,2,4
14006,2,3,48952,48952,48955,0,3,0
14007,2,1,48954,48955,48956,1,2,0
14008,5,2,48959,48959,48961,0,2,3
14009,1,1,48960,48961,48962,1,2,0
14010,4,2,48964,48964,48966,0,2,2
14011,6,1,48970,48970,48971,0,1,4
14012,5,2,48975,48975,48977,0,2,4
14013,5,1,48980,48980,48981,0,1,3
14014,3,2,48983,48983,48985,0,2,2
14015,3,3,48986,48986,48989,0,3,1
14016,4,2,48990,48990,48992,0,2,1
14017,1,3,48991,48992,48995,1,4,0
14018,2,1,48993,48995,48996,2,3,0
14019,6,1,48999,48999,49000,0,1,3
14020,6,1,49005,49005,49006,0,1,5
14021,6,3,49011,49011,49014,0,3,5
14022,2,1,49013,49014,49015,1,2,0
14023,4,1,49017,49017,49018,0,1,2
14024,5,3,49022,49022,49025,0,3,4
14025,2,2,49024,49025,49027,1,3,0
14026,2,2,49026,49027,49029,1,3,0
14027,4,1,49030,49030,49031,0,1,1
14028,5,3,49035,49035,49038,0,3,4
14029,3,3,49038,49038,49041,0,3,0
14030,3,3,49041,49041,49044,0,3,0
14031,6,1,49047,49047,49048,0,1,3
14032,5,1,49052,49052,49053,0,1,4
14033,2,3,49054,49054,49057,0,3,1
14034,4,1,49058,49058,49059,0,1,1
14035,2,1,49060,49060,49061,0,1,1
14036,2,1,49062,49062,49063,0,1,1
14037,3,3,49065,49065,49068,0,3,2
14038,6,1,49071,49071,49072,0,1,3
14039,5,1,49076,49076,49077,0,1,4
14040,1,1,49077,49077,49078,0,1,0
14041,2,3,49079,49079,49082,0,3,1
14042,3,2,49082,49082,49084,0,2,0
14043,3,3,49085,49085,49088,0,3,1
14044,1,1,49086,49088,49089,2,3,0
14045,1,1,49087,49089,49090,2,3,0
14046,2,1,49089,49090,49091,1,2,0
14047,5,3,49094,49094,49097,0,3,3
14048,2,3,49096,49097,49100,1,4,0
14049,6,1,49102,49102,49103,0,1,2
14050,3,2,49105,49105,49107,0,2,2
14051,2,2,49107,49107,49109,0,2,0
14052,4,1,49111,49111,49112,0,1,2
14053,4,2,49115,49115,49117,0,2,3
14054,6,3,49121,49121,49124,0,3,4
14055,4,1,49125,49125,49126,0,1,1
14056,2,2,49127,49127,49129,0,2,1
14057,2,2,49129,49129,49131,0,2,0
14058,4,1,49133,49133,49134,0,1,2
14059,4,2,49137,49137,49139,0,2,3
14060,5,1,49142,49142,49143,0,1,3
14061,1,1,49143,49143,49144,0,1,0
14062,4,1,49147,49147,49148,0,1,3
14063,1,2,49148,49148,49150,0,2,0
14064,2,1,49150,49150,49151,0,1,0
14065,3,2,49153,49153,49155,0,2,2
14066,5,1,49158,49158,49159,0,1,3
14067,5,1,49163,49163,49164,0,1,4
14068,2,3,49165,49165,49168,0,3,1
14069,5,2,49170,49170,49172,0,2,2
14070,4,1,49174,49174,49175,0,1,2
14071,2,2,49176,49176,49178,0,2,1
14072,1,1,49177,49178,49179,1,2,0
14073,5,2,49182,49182,49184,0,2,3
14074,1,2,49183,49184,49186,1,3,0
14075,1,1,49184,49186,49187,2,3,0
14076,5,1,49189,49189,49190,0,1,2
14077,6,3,49195,49195,49198,0,3,5
14078,1,2,49196,49198,49200,2,4,0
14079,5,1,49201,49201,49202,0,1,1
14080,6,3,49207,49207,49210,0,3,5
14081,5,2,49212,49212,49214,0,2,2
14082,2,2,49214,49214,49216,0,2,0
14083,5,1,49219,49219,49220,0,1,3
14084,4,2,49223,49223,49225,0,2,3
14085,6,3,49229,49229,49232,0,3,4
14086,2,1,49231,49232,49233,1,2,0
14087,3,1,49234,49234,49235,0,1,1
14088,5,2,49239,49239,49241,0,2,4
14089,6,3,49245,49245,49248,0,3,4
14090,1,1,49246,49248,49249,2,3,0
14091,1,1,49247,49249,49250,2,3,0
14092,3,1,49250,49250,49251,0,1,0
14093,4,2,49254,49254,49256,0,2,3
14094,2,3,49256,49256,49259,0,3,0
14095,3,3,49259,49259,49262,0,3,0
14096,5,2,49264,49264,49266,0,2,2
14097,3,1,49267,49267,49268,0,1,1
14098,3,1,49270,49270,49271,0,1,2
14099,5,1,49275,49275,49276,0,1,4
14100,5,3,49280,49280,49283,0,3,4
14101,5,3,49285,49285,49288,0,3,2
14102,1,2,49286,49288,49290,2,4,0
14103,3,3,49289,49290,49293,1,4,0
14104,6,3,49295,49295,49298,0,3,2
14105,3,2,49298,49298,49300,0,2,0
14106,3,1,49301,49301,49302,0,1,1
14107,2,2,49303,49303,49305,0,2,1
14108,5,1,49308,49308,49309,0,1,3
14109,3,3,49311,49311,49314,0,3,2
14110,5,2,49316,49316,49318,0,2,2
14111,3,2,49319,49319,49321,0,2,1
14112,4,2,49323,49323,49325,0,2,2
14113,1,3,49324,49325,49328,1,4,0
14114,3,1,49327,49328,49329,1,2,0
14115,4,2,49331,49331,49333,0,2,2
14116,2,1,49333,49333,49334,0,1,0
14117,5,2,49338,49338,49340,0,2,4
14118,5,2,49343,49343,49345,0,2,3
14119,6,3,49349,49349,49352,0,3,4
14120,4,1,49353,49353,49354,0,1,1
14121,4,2,49357,49357,49359,0,2,3
14122,3,2,49360,49360,49362,0,2,1
14123,5,1,49365,49365,49366,0,1,3
14124,2,2,49367,49367,49369,0,2,1
14125,4,2,49371,49371,49373,0,2,2
14126,6,2,49377,49377,49379,0,2,4
14127,6,3,49383,49383,49386,0,3,4
14128,1,2,49384,49386,49388,2,4,0
14129,2,3,49386,49388,49391,2,5,0
14130,6,2,49392,49392,49394,0,2,1
14131,1,2,49393,49394,49396,1,3,0
14132,6,3,49399,49399,49402,0,3,3
14133,2,1,49401,49402,49403,1,2,0
14134,4,1,49405,49405,49406,0,1,2
14135,4,3,49409,49409,49412,0,3,3
14136,6,3,49415,49415,49418,0,3,3
14137,3,3,49418,49418,49421,0,3,0
14138,5,2,49423,49423,49425,0,2,2
14139,5,1,49428,49428,49429,0,1,3
14140,5,1,49433,49433,49434,0,1,4
14141,4,3,49437,49437,49440,0,3,3
14142,4,3,49441,49441,49444,0,3,1
14143,1,1,49442,49444,49445,2,3,0
14144,6,2,49448,49448,49450,0,2,3
14145,2,3,49450,49450,49453,0,3,0
14146,4,1,49454,49454,49455,0,1,1
14147,3,3,49457,49457,49460,0,3,2
14148,3,2,49460,49460,49462,0,2,0
14149,1,3,49461,49462,49465,1,4,0
14150,3,3,49464,49465,49468,1,4,0
14151,1,3,49465,49468,49471,3,6,0
14152,5,3,49470,49471,49474,1,4,0
14153,5,1,49475,49475,49476,0,1,1
14154,6,1,49481,49481,49482,0,1,5
14155,4,3,49485,49485,49488,0,3,3
14156,6,2,49491,49491,49493,0,2,3
14157,4,1,49495,49495,49496,0,1,2
14158,1,1,49496,49496,49497,0,1,0
14159,6,2,49502,49502,49504,0,2,5
14160,6,3,49508,49508,49511,0,3,4
14161,1,1,49509,49511,49512,2,3,0
14162,2,1,49511,49512,49513,1,2,0
14163,1,3,49512,49513,49516,1,4,0
14164,5,2,49517,49517,49519,0,2,1
14165,4,1,49521,49521,49522,0,1,2
14166,2,3,49523,49523,49526,0,3,1
14167,2,1,49525,49526,49527,1,2,0
14168,5,2,49530,49530,49532,0,2,3
14169,5,2,49535,49535,49537,0,2,3
14170,5,3,49540,49540,49543,0,3,3
14171,5,1,49545,49545,49546,0,1,2
14172,4,1,49549,49549,49550,0,1,3
14173,5,3,49554,49554,49557,0,3,4
14174,2,2,49556,49557,49559,1,3,0
14175,1,1,49557,49559,49560,2,3,0
14176,2,1,49559,49560,49561,1,2,0
14177,3,1,49562,49562,49563,0,1,1
14178,3,2,49565,49565,49567,0,2,2
14179,1,1,49566,49567,49568,1,2,0
14180,3,1,49569,49569,49570,0,1,1
14181,1,2,49570,49570,49572,0,2,0
14182,5,3,49575,49575,49578,0,3,3
14183,6,3,49581,49581,49584,0,3,3
14184,2,2,49583,49584,49586,1,3,0
14185,1,3,49584,49586,49589,2,5,0
14186,4,2,49588,49589,49591,1,3,0
14187,5,1,49593,49593,49594,0,1,2
14188,1,3,49594,49594,49597,0,3,0
14189,5,1,49599,49599,49600,0,1,2
14190,2,1,49601,49601,49602,0,1,1
14191,4,1,49605,49605,49606,0,1,3
14192,5,1,49610,49610,49611,0,1,4
14193,2,3,49612,49612,49615,0,3,1
14194,3,1,49615,49615,49616,0,1,0
14195,3,2,49618,49618,49620,0,2,2
14196,2,1,49620,49620,49621,0,1,0
14197,5,3,49625,49625,49628,0,3,4
14198,3,3,49628,49628,49631,0,3,0
14199,1,3,49629,49631,49634,2,5,0
14200,1,3,49630,49634,49637,4,7,0
14201,1,1,49631,49637,49638,6,7,0
14202,2,2,49633,49638,49640,5,7,0
14203,2,2,49635,49640,49642,5,7,0
14204,5,2,49640,49642,49644,2,4,0
14205,2,3,49642,49644,49647,2,5,0
14206,4,2,49646,49647,49649,1,3,0
14207,5,1,49651,49651,49652,0,1,2
14208,1,1,49652,49652,49653,0,1,0
14209,2,2,49654,49654,49656,0,2,1
14210,1,3,49655,49656,49659,1,4,0
14211,1,1,49656,49659,49660,3,4,0
14212,4,3,49660,49660,49663,0,3,0
14213,5,2,49665,49665,49667,0,2,2
14214,4,2,49669,49669,49671,0,2,2
14215,2,3,49671,49671,49674,0,3,0
14216,2,1,49673,49674,49675,1,2,0
14217,4,3,49677,49677,49680,0,3,2
14218,4,2,49681,49681,49683,0,2,1
14219,5,1,49686,49686,49687,0,1,3
14220,6,3,49692,49692,49695,0,3,5
14221,4,3,49696,49696,49699,0,3,1
14222,5,2,49701,49701,49703,0,2,2
14223,6,3,49707,49707,49710,0,3,4
14224,4,3,49711,49711,49714,0,3,1
14225,1,2,49712,49714,49716,2,4,0
14226,6,3,49718,49718,49721,0,3,2
14227,5,3,49723,49723,49726,0,3,2
14228,3,3,49726,49726,49729,0,3,0
14229,4,2,49730,49730,49732,0,2,1
14230,4,3,49734,49734,49737,0,3,2
14231,2,3,49736,49737,49740,1,4,0
14232,4,1,49740,49740,49741,0,1,0
14233,3,3,49743,49743,49746,0,3,2
14234,6,2,49749,49749,49751,0,2,3
14235,5,3,49754,49754,49757,0,3,3
14236,4,1,49758,49758,49759,0,1,1
14237,3,2,49761,49761,49763,0,2,2
14238,2,1,49763,49763,49764,0,1,0
14239,4,1,49767,49767,49768,0,1,3
14240,2,3,49769,49769,49772,0,3,1
14241,2,1,49771,49772,49773,1,2,0
14242,5,2,49776,49776,49778,0,2,3
14243,6,3,49782,49782,49785,0,3,4
14244,3,3,49785,49785,49788,0,3,0
14245,6,1,49791,49791,49792,0,1,3
14246,2,1,49793,49793,49794,0,1,1
14247,4,3,49797,49797,49800,0,3,3
14248,5,2,49802,49802,49804,0,2,2
14249,6,1,49808,49808,49809,0,1,4
14250,6,2,49814,49814,49816,0,2,5
14251,2,1,49816,49816,49817,0,1,0
14252,4,1,49820,49820,49821,0,1,3
14253,5,1,49825,49825,49826,0,1,4
14254,1,1,49826,49826,49827,0,1,0
14255,4,1,49830,49830,49831,0,1,3
14256,4,2,49834,49834,49836,0,2,3
14257,1,1,49835,49836,49837,1,2,0
14258,1,3,49836,49837,49840,1,4,0
14259,3,2,49839,49840,49842,1,3,0
14260,2,1,49841,49842,49843,1,2,0
14261,2,3,49843,49843,49846,0,3,0
14262,1,2,49844,49846,49848,2,4,0
14263,3,3,49847,49848,49851,1,4,0
14264,6,1,49853,49853,49854,0,1,2
14265,2,3,49855,49855,49858,0,3,1
14266,4,2,49859,49859,49861,0,2,1
14267,6,1,49865,49865,49866,0,1,4
14268,3,3,49868,49868,49871,0,3,2
14269,4,1,49872,49872,49873,0,1,1
14270,5,1,49877,49877,49878,0,1,4
14271,6,2,49883,49883,49885,0,2,5
14272,3,1,49886,49886,49887,0,1,1
14273,2,3,49888,49888,49891,0,3,1
14274,1,3,49889,49891,49894,2,5,0
14275,1,1,49890,49894,49895,4,5,0
14276,2,1,49892,49895,49896,3,4,0
14277,3,2,49895,49896,49898,1,3,0
14278,2,3,49897,49898,49901,1,4,0
14279,3,2,49900,49901,49903,1,3,0
14280,6,2,49906,49906,49908,0,2,3
14281,3,1,49909,49909,49910,0,1,1
14282,1,2,49910,49910,49912,0,2,0
14283,6,2,49916,49916,49918,0,2,4
14284,1,3,49917,49918,49921,1,4,0
14285,5,1,49922,49922,49923,0,1,1
14286,4,1,49926,49926,49927,0,1,3
14287,1,2,49927,49927,49929,0,2,0
14288,4,2,49931,49931,49933,0,2,2
14289,6,1,49937,49937,49938,0,1,4
14290,4,3,49941,49941,49944,0,3,3
14291,4,1,49945,49945,49946,0,1,1
14292,6,3,49951,49951,49954,0,3,5
14293,6,3,49957,49957,49960,0,3,3
14294,6,3,49963,49963,49966,0,3,3
14295,4,1,49967,49967,49968,0,1,1
14296,1,2,49968,49968,49970,0,2,0
14297,5,2,49973,49973,49975,0,2,3
14298,5,2,49978,49978,49980,0,2,3
14299,6,1,49984,49984,49985,0,1,4
14300,5,2,49989,49989,49991,0,2,4
14301,2,2,49991,49991,49993,0,2,0
14302,3,1,49994,49994,49995,0,1,1
14303,5,1,49999,49999,50000,0,1,4
14304,4,3,50003,50003,50006,0,3,3
14305,5,1,50008,50008,50009,0,1,2
14306,5,3,50013,50013,50016,0,3,4
14307,6,1,50019,50019,50020,0,1,3
14308,6,3,50025,50025,50028,0,3,5
14309,3,3,50028,50028,50031,0,3,0
14310,5,3,50033,50033,50036,0,3,2
14311,5,1,50038,50038,50039,0,1,2
14312,4,1,50042,50042,50043,0,1,3
14313,5,3,50047,50047,50050,0,3,4
14314,5,1,50052,50052,50053,0,1,2
14315,2,3,50054,50054,50057,0,3,1
14316,4,2,50058,50058,50060,0,2,1
14317,3,1,50061,50061,50062,0,1,1
14318,3,1,50064,50064,50065,0,1,2
14319,1,1,50065,50065,50066,0,1,0
14320,6,3,50071,50071,50074,0,3,5
14321,2,2,50073,50074,50076,1,3,0
14322,6,2,50079,50079,50081,0,2,3
14323,5,3,50084,50084,50087,0,3,3
14324,6,2,50090,50090,50092,0,2,3
14325,2,1,50092,50092,50093,0,1,0
14326,1,1,50093,50093,50094,0,1,0
14327,3,1,50096,50096,50097,0,1,2
14328,1,3,50097,50097,50100,0,3,0
14329,6,3,50103,50103,50106,0,3,3
14330,1,3,50104,50106,50109,2,5,0
14331,3,3,50107,50109,50112,2,5,0
14332,1,1,50108,50112,50113,4,5,0
14333,4,1,50112,50113,50114,1,2,0
14334,6,1,50118,50118,50119,0,1,4
14335,5,1,50123,50123,50124,0,1,4
14336,6,1,50129,50129,50130,0,1,5
14337,5,2,50134,50134,50136,0,2,4
14338,4,3,50138,50138,50141,0,3,2
14339,6,2,50144,50144,50146,0,2,3
14340,5,3,50149,50149,50152,0,3,3
14341,1,3,50150,50152,50155,2,5,0
14342,4,3,50154,50155,50158,1,4,0
14343,5,1,50159,50159,50160,0,1,1
14344,2,3,50161,50161,50164,0,3,1
14345,6,2,50167,50167,50169,0,2,3
14346,2,1,50169,50169,50170,0,1,0
14347,6,2,50175,50175,50177,0,2,5
14348,4,3,50179,50179,50182,0,3,2
14349,1,1,50180,50182,50183,2,3,0
14350,2,1,50182,50183,50184,1,2,0
14351,5,1,50187,50187,50188,0,1,3
14352,4,2,50191,50191,50193,0,2,3
14353,5,3,50196,50196,50199,0,3,3
14354,5,1,50201,50201,50202,0,1,2
14355,5,3,50206,50206,50209,0,3,4
14356,2,3,50208,50209,50212,1,4,0
14357,3,1,50211,50212,50213,1,2,0
14358,6,2,50217,50217,50219,0,2,4
14359,3,3,50220,50220,50223,0,3,1
14360,1,1,50221,50223,50224,2,3,0
14361,1,3,50222,50224,50227,2,5,0
14362,1,1,50223,50227,50228,4,5,0
14363,3,2,50226,50228,50230,2,4,0
14364,2,1,50228,50230,50231,2,3,0
14365,2,1,50230,50231,50232,1,2,0
14366,4,3,50234,50234,50237,0,3,2
14367,3,2,50237,50237,50239,0,2,0
14368,3,2,50240,50240,50242,0,2,1
14369,6,1,50246,50246,50247,0,1,4
14370,4,1,50250,50250,50251,0,1,3
14371,1,1,50251,50251,50252,0,1,0
14372,5,3,50256,50256,50259,0,3,4
14373,5,2,50261,50261,50263,0,2,2
14374,1,2,50262,50263,50265,1,3,0
14375,2,3,50264,50265,50268,1,4,0
14376,3,3,50267,50268,50271,1,4,0
14377,6,1,50273,50273,50274,0,1,2
14378,1,2,50274,50274,50276,0,2,0
14379,3,3,50277,50277,50280,0,3,1
14380,2,1,50279,50280,50281,1,2,0
14381,6,3,50285,50285,50288,0,3,4
14382,3,3,50288,50288,50291,0,3,0
14383,6,3,50294,50294,50297,0,3,3
14384,1,3,50295,50297,50300,2,5,0
14385,3,2,50298,50300,50302,2,4,0
14386,6,2,50304,50304,50306,0,2,2
14387,4,2,50308,50308,50310,0,2,2
14388,2,2,50310,50310,50312,0,2,0
14389,3,3,50313,50313,50316,0,3,1
14390,2,1,50315,50316,50317,1,2,0
14391,1,3,50316,50317,50320,1,4,0
14392,5,1,50321,50321,50322,0,1,1
14393,3,3,50324,50324,50327,0,3,2
14394,6,1,50330,50330,50331,0,1,3
14395,2,2,50332,50332,50334,0,2,1
14396,1,2,50333,50334,50336,1,3,0
14397,1,2,50334,50336,50338,2,4,0
14398,6,1,50340,50340,50341,0,1,2
14399,2,3,50342,50342,50345,0,3,1
14400,6,1,50348,50348,50349,0,1,3
14401,2,1,50350,50350,50351,0,1,1
14402,1,2,50351,50351,50353,0,2,0
14403,4,1,50355,50355,50356,0,1,2
14404,4,2,50359,50359,50361,0,2,3
14405,4,2,50363,50363,50365,0,2,2
14406,2,3,50365,50365,50368,0,3,0
14407,2,1,50367,50368,50369,1,2,0
14408,3,1,50370,50370,50371,0,1,1
14409,6,3,50376,50376,50379,0,3,5
14410,5,2,50381,50381,50383,0,2,2
14411,5,1,50386,50386,50387,0,1,3
14412,5,1,50391,50391,50392,0,1,4
14413,2,1,50393,50393,50394,0,1,1
14414,4,2,50397,50397,50399,0,2,3
14415,3,2,50400,50400,50402,0,2,1
14416,1,1,50401,50402,50403,1,2,0
14417,3,1,50404,50404,50405,0,1,1
14418,2,2,50406,50406,50408,0,2,1
14419,1,1,50407,50408,50409,1,2,0
14420,6,3,50413,50413,50416,0,3,4
14421,2,2,50415,50416,50418,1,3,0
14422,6,2,50421,50421,50423,0,2,3
14423,4,2,50425,50425,50427,0,2,2
14424,4,2,50429,50429,50431,0,2,2
14425,1,1,50430,50431,50432,1,2,0
14426,4,2,50434,50434,50436,0,2,2
14427,1,1,50435,50436,50437,1,2,0
14428,5,2,50440,50440,50442,0,2,3
14429,4,2,50444,50444,50446,0,2,2
14430,6,3,50450,50450,50453,0,3,4
14431,4,3,50454,50454,50457,0,3,1
14432,3,2,50457,50457,50459,0,2,0
14433,4,1,50461,50461,50462,0,1,2
14434,2,3,50463,50463,50466,0,3,1
14435,2,1,50465,50466,50467,1,2,0
14436,4,3,50469,50469,50472,0,3,2
14437,1,1,50470,50472,50473,2,3,0
14438,3,1,50473,50473,50474,0,1,0
14439,1,1,50474,50474,50475,0,1,0
14440,6,2,50480,50480,50482,0,2,5
14441,6,1,50486,50486,50487,0,1,4
14442,4,3,50490,50490,50493,0,3,3
14443,3,3,50493,50493,50496,0,3,0
14444,6,1,50499,50499,50500,0,1,3
14445,4,1,50503,50503,50504,0,1,3
14446,2,3,50505,50505,50508,0,3,1
14447,4,2,50509,50509,50511,0,2,1
14448,6,1,50515,50515,50516,0,1,4
14449,5,3,50520,50520,50523,0,3,4
14450,3,1,50523,50523,50524,0,1,0
14451,6,2,50529,50529,50531,0,2,5
14452,5,2,50534,50534,50536,0,2,3
14453,5,2,50539,50539,50541,0,2,3
14454,1,3,50540,50541,50544,1,4,0
14455,1,2,50541,50544,50546,3,5,0
14456,4,1,50545,50546,50547,1,2,0
14457,4,3,50549,50549,50552,0,3,2
14458,6,1,50555,50555,50556,0,1,3
14459,2,3,50557,50557,50560,0,3,1
14460,4,2,50561,50561,50563,0,2,1
14461,5,3,50566,50566,50569,0,3,3
14462,3,1,50569,50569,50570,0,1,0
14463,6,3,50575,50575,50578,0,3,5
14464,4,1,50579,50579,50580,0,1,1
14465,2,3,50581,50581,50584,0,3,1
14466,5,1,50586,50586,50587,0,1,2
14467,1,2,50587,50587,50589,0,2,0
14468,5,2,50592,50592,50594,0,2,3
14469,1,3,50593,50594,50597,1,4,0
14470,1,2,50594,50597,50599,3,5,0
14471,4,2,50598,50599,50601,1,3,0
14472,5,3,50603,50603,50606,0,3,2
14473,6,1,50609,50609,50610,0,1,3
14474,3,2,50612,50612,50614,0,2,2
14475,1,2,50613,50614,50616,1,3,0
14476,1,2,50614,50616,50618,2,4,0
14477,2,3,50616,50618,50621,2,5,0
14478,5,3,50621,50621,50624,0,3,0
14479,6,3,50627,50627,50630,0,3,3
14480,3,2,50630,50630,50632,0,2,0
14481,3,2,50633,50633,50635,0,2,1
14482,5,1,50638,50638,50639,0,1,3
14483,5,2,50643,50643,50645,0,2,4
14484,4,2,50647,50647,50649,0,2,2
14485,3,2,50650,50650,50652,0,2,1
14486,4,3,50654,50654,50657,0,3,2
14487,6,1,50660,50660,50661,0,1,3
14488,3,2,50663,50663,50665,0,2,2
14489,1,1,50664,50665,50666,1,2,0
14490,3,1,50667,50667,50668,0,1,1
14491,5,1,50672,50672,50673,0,1,4
14492,5,3,50677,50677,50680,0,3,4
14493,2,2,50679,50680,50682,1,3,0
14494,5,2,50684,50684,50686,0,2,2
14495,4,2,50688,50688,50690,0,2,2
14496,2,2,50690,50690,50692,0,2,0
14497,4,3,50694,50694,50697,0,3,2
14498,1,1,50695,50697,50698,2,3,0
14499,4,2,50699,50699,50701,0,2,1
14500,1,1,50700,50701,50702,1,2,0
14501,3,2,50703,50703,50705,0,2,1
14502,2,3,50705,50705,50708,0,3,0
14503,5,3,50710,50710,50713,0,3,2
14504,2,2,50712,50713,50715,1,3,0
14505,1,1,50713,50715,50716,2,3,0
14506,4,3,50717,50717,50720,0,3,1
14507,3,2,50720,50720,50722,0,2,0
14508,5,3,50725,50725,50728,0,3,3
14509,3,3,50728,50728,50731,0,3,0
14510,6,3,50734,50734,50737,0,3,3
14511,6,2,50740,50740,50742,0,2,3
14512,4,3,50744,50744,50747,0,3,2
14513,5,2,50749,50749,50751,0,2,2
14514,2,3,50751,50751,50754,0,3,0
14515,2,3,50753,50754,50757,1,4,0
14516,5,3,50758,50758,50761,0,3,1
14517,5,1,50763,50763,50764,0,1,2
14518,6,2,50769,50769,50771,0,2,5
14519,6,2,50775,50775,50777,0,2,4
14520,5,2,50780,50780,50782,0,2,3
14521,4,3,50784,50784,50787,0,3,2
14522,3,1,50787,50787,50788,0,1,0
14523,1,1,50788,50788,50789,0,1,0
14524,5,2,50793,50793,50795,0,2,4
14525,1,1,50794,50795,50796,1,2,0
14526,4,3,50798,50798,50801,0,3,2
14527,5,3,50803,50803,50806,0,3,2
14528,2,1,50805,50806,50807,1,2,0
14529,6,2,50811,50811,50813,0,2,4
14530,2,2,50813,50813,50815,0,2,0
14531,6,1,50819,50819,50820,0,1,4
14532,5,2,50824,50824,50826,0,2,4
14533,6,3,50830,50830,50833,0,3,4
14534,3,2,50833,50833,50835,0,2,0
14535,2,1,50835,50835,50836,0,1,0
14536,6,1,50841,50841,50842,0,1,5
14537,5,3,50846,50846,50849,0,3,4
14538,4,1,50850,50850,50851,0,1,1
14539,4,2,50854,50854,50856,0,2,3
14540,1,3,50855,50856,50859,1,4,0
14541,5,2,50860,50860,50862,0,2,1
14542,1,3,50861,50862,50865,1,4,0
14543,5,1,50866,50866,50867,0,1,1
14544,1,2,50867,50867,50869,0,2,0
14545,6,1,50873,50873,50874,0,1,4
14546,2,1,50875,50875,50876,0,1,1
14547,5,2,50880,50880,50882,0,2,4
14548,4,2,50884,50884,50886,0,2,2
14549,1,3,50885,50886,50889,1,4,0
14550,1,1,50886,50889,50890,3,4,0
14551,4,3,50890,50890,50893,0,3,0
14552,1,1,50891,50893,50894,2,3,0
14553,5,3,50896,50896,50899,0,3,2
14554,3,1,50899,50899,50900,0,1,0
14555,4,1,50903,50903,50904,0,1,3
14556,5,3,50908,50908,50911,0,3,4
14557,3,3,50911,50911,50914,0,3,0
14558,5,3,50916,50916,50919,0,3,2
14559,3,2,50919,50919,50921,0,2,0
14560,6,3,50925,50925,50928,0,3,4
14561,5,2,50930,50930,50932,0,2,2
14562,1,3,50931,50932,50935,1,4,0
14563,2,1,50933,50935,50936,2,3,0
14564,1,2,50934,50936,50938,2,4,0
14565,1,2,50935,50938,50940,3,5,0
14566,6,1,50941,50941,50942,0,1,1
14567,6,3,50947,50947,50950,0,3,5
14568,6,1,50953,50953,50954,0,1,3
14569,4,1,50957,50957,50958,0,1,3
14570,4,1,50961,50961,50962,0,1,3
14571,5,2,50966,50966,50968,0,2,4
14572,4,2,50970,50970,50972,0,2,2
14573,3,1,50973,50973,50974,0,1,1
14574,6,3,50979,50979,50982,0,3,5
14575,5,2,50984,50984,50986,0,2,2
14576,4,1,50988,50988,50989,0,1,2
14577,4,2,50992,50992,50994,0,2,3
14578,6,1,50998,50998,50999,0,1,4
14579,4,1,51002,51002,51003,0,1,3
14580,3,3,51005,51005,51008,0,3,2
14581,6,3,51011,51011,51014,0,3,3
14582,2,2,51013,51014,51016,1,3,0
14583,5,1,51018,51018,51019,0,1,2
14584,3,3,51021,51021,51024,0,3,2
14585,1,1,51022,51024,51025,2,3,0
14586,6,3,51028,51028,51031,0,3,3
14587,4,2,51032,51032,51034,0,2,1
14588,6,1,51038,51038,51039,0,1,4
14589,1,2,51039,51039,51041,0,2,0
14590,1,1,51040,51041,51042,1,2,0
14591,1,2,51041,51042,51044,1,3,0
14592,4,3,51045,51045,51048,0,3,1
14593,2,3,51047,51048,51051,1,4,0
14594,2,2,51049,51051,51053,2,4,0
14595,5,2,51054,51054,51056,0,2,1
14596,4,3,51058,51058,51061,0,3,2
14597,3,3,51061,51061,51064,0,3,0
14598,2,2,51063,51064,51066,1,3,0
14599,4,2,51067,51067,51069,0,2,1
14600,4,3,51071,51071,51074,0,3,2
14601,5,2,51076,51076,51078,0,2,2
14602,6,3,51082,51082,51085,0,3,4
14603,2,3,51084,51085,51088,1,4,0
14604,6,3,51090,51090,51093,0,3,2
14605,6,1,51096,51096,51097,0,1,3
14606,4,3,51100,51100,51103,0,3,3
14607,6,3,51106,51106,51109,0,3,3
14608,4,1,51110,51110,51111,0,1,1
14609,2,2,51112,51112,51114,0,2,1
14610,6,3,51118,51118,51121,0,3,4
14611,5,1,51123,51123,51124,0,1,2
14612,4,1,51127,51127,51128,0,1,3
14613,6,2,51133,51133,51135,0,2,5
14614,1,2,51134,51135,51137,1,3,0
14615,6,2,51140,51140,51142,0,2,3
14616,3,1,51143,51143,51144,0,1,1
14617,3,3,51146,51146,51149,0,3,2
14618,6,2,51152,51152,51154,0,2,3
14619,5,1,51157,51157,51158,0,1,3
14620,2,3,51159,51159,51162,0,3,1
14621,3,1,51162,51162,51163,0,1,0
14622,3,1,51165,51165,51166,0,1,2
14623,1,2,51166,51166,51168,0,2,0
14624,6,1,51172,51172,51173,0,1,4
14625,6,1,51178,51178,51179,0,1,5
14626,5,3,51183,51183,51186,0,3,4
14627,3,3,51186,51186,51189,0,3,0
14628,3,2,51189,51189,51191,0,2,0
14629,2,1,51191,51191,51192,0,1,0
14630,6,2,51197,51197,51199,0,2,5
14631,2,2,51199,51199,51201,0,2,0
14632,5,2,51204,51204,51206,0,2,3
14633,5,1,51209,51209,51210,0,1,3
14634,1,2,51210,51210,51212,0,2,0
14635,3,1,51213,51213,51214,0,1,1
14636,3,1,51216,51216,51217,0,1,2
14637,2,2,51218,51218,51220,0,2,1
14638,5,3,51223,51223,51226,0,3,3
14639,1,2,51224,51226,51228,2,4,0
14640,6,3,51230,51230,51233,0,3,2
14641,2,1,51232,51233,51234,1,2,0
14642,4,2,51236,51236,51238,0,2,2
14643,1,3,51237,51238,51241,1,4,0
14644,1,3,51238,51241,51244,3,6,0
14645,1,3,51239,51244,51247,5,8,0
14646,6,2,51245,51247,51249,2,4,0
14647,5,1,51250,51250,51251,0,1,1
14648,1,1,51251,51251,51252,0,1,0
14649,2,3,51253,51253,51256,0,3,1
14650,1,3,51254,51256,51259,2,5,0
14651,2,2,51256,51259,51261,3,5,0
14652,6,3,51262,51262,51265,0,3,1
14653,6,3,51268,51268,51271,0,3,3
14654,2,3,51270,51271,51274,1,4,0
14655,5,3,51275,51275,51278,0,3,1
14656,5,1,51280,51280,51281,0,1,2
14657,3,2,51283,51283,51285,0,2,2
14658,1,1,51284,51285,51286,1,2,0
14659,5,2,51289,51289,51291,0,2,3
14660,6,2,51295,51295,51297,0,2,4
14661,1,2,51296,51297,51299,1,3,0
14662,5,1,51301,51301,51302,0,1,2
14663,3,1,51304,51304,51305,0,1,2
14664,4,2,51308,51308,51310,0,2,3
14665,3,1,51311,51311,51312,0,1,1
14666,4,3,51315,51315,51318,0,3,3
14667,1,1,51316,51318,51319,2,3,0
14668,5,3,51321,51321,51324,0,3,2
14669,1,1,51322,51324,51325,2,3,0
14670,6,2,51328,51328,51330,0,2,3
14671,4,3,51332,51332,51335,0,3,2
14672,1,2,51333,51335,51337,2,4,0
14673,1,1,51334,51337,51338,3,4,0
14674,5,3,51339,51339,51342,0,3,1
14675,5,1,51344,51344,51345,0,1,2
14676,1,3,51345,51345,51348,0,3,0
14677,3,3,51348,51348,51351,0,3,0
14678,2,2,51350,51351,51353,1,3,0
14679,4,2,51354,51354,51356,0,2,1
14680,4,3,51358,51358,51361,0,3,2
14681,4,3,51362,51362,51365,0,3,1
14682,2,3,51364,51365,51368,1,4,0
14683,4,3,51368,51368,51371,0,3,0
14684,6,2,51374,51374,51376,0,2,3
14685,4,3,51378,51378,51381,0,3,2
14686,4,3,51382,51382,51385,0,3,1
14687,5,3,51387,51387,51390,0,3,2
14688,4,1,51391,51391,51392,0,1,1
14689,1,1,51392,51392,51393,0,1,0
14690,5,1,51397,51397,51398,0,1,4
14691,5,3,51402,51402,51405,0,3,4
14692,2,2,51404,51405,51407,1,3,0
14693,3,2,51407,51407,51409,0,2,0
14694,1,1,51408,51409,51410,1,2,0
14695,3,2,51411,51411,51413,0,2,1
14696,4,2,51415,51415,51417,0,2,2
14697,3,1,51418,51418,51419,0,1,1
14698,5,3,51423,51423,51426,0,3,4
14699,1,2,51424,51426,51428,2,4,0
14700,4,1,51428,51428,51429,0,1,0
14701,5,2,51433,51433,51435,0,2,4
14702,3,1,51436,51436,51437,0,1,1
14703,1,1,51437,51437,51438,0,1,0
14704,6,3,51443,51443,51446,0,3,5
14705,4,3,51447,51447,51450,0,3,1
14706,6,2,51453,51453,51455,0,2,3
14707,3,3,51456,51456,51459,0,3,1
14708,6,1,51462,51462,51463,0,1,3
14709,5,2,51467,51467,51469,0,2,4
14710,2,3,51469,51469,51472,0,3,0
14711,2,3,51471,51472,51475,1,4,0
14712,6,3,51477,51477,51480,0,3,2
14713,3,2,51480,51480,51482,0,2,0
14714,6,3,51486,51486,51489,0,3,4
14715,6,1,51492,51492,51493,0,1,3
14716,5,1,51497,51497,51498,0,1,4
14717,4,3,51501,51501,51504,0,3,3
14718,5,1,51506,51506,51507,0,1,2
14719,6,1,51512,51512,51513,0,1,5
14720,3,1,51515,51515,51516,0,1,2
14721,5,3,51520,51520,51523,0,3,4
14722,1,2,51521,51523,51525,2,4,0
14723,4,2,51525,51525,51527,0,2,0
14724,4,3,51529,51529,51532,0,3,2
14725,6,2,51535,51535,51537,0,2,3
14726,2,1,51537,51537,51538,0,1,0
14727,4,1,51541,51541,51542,0,1,3
14728,1,3,51542,51542,51545,0,3,0
14729,6,1,51548,51548,51549,0,1,3
14730,3,2,51551,51551,51553,0,2,2
14731,5,3,51556,51556,51559,0,3,3
14732,5,1,51561,51561,51562,0,1,2
14733,5,1,51566,51566,51567,0,1,4
14734,6,1,51572,51572,51573,0,1,5
14735,2,2,51574,51574,51576,0,2,1
14736,2,2,51576,51576,51578,0,2,0
14737,4,3,51580,51580,51583,0,3,2
14738,6,2,51586,51586,51588,0,2,3
14739,4,1,51590,51590,51591,0,1,2
14740,1,3,51591,51591,51594,0,3,0
14741,6,3,51597,51597,51600,0,3,3
14742,2,3,51599,51600,51603,1,4,0
14743,1,3,51600,51603,51606,3,6,0
14744,6,1,51606,51606,51607,0,1,0
14745,3,3,51609,51609,51612,0,3,2
14746,6,3,51615,51615,51618,0,3,3
14747,2,1,51617,51618,51619,1,2,0
14748,1,1,51618,51619,51620,1,2,0
14749,6,3,51624,51624,51627,0,3,4
14750,5,1,51629,51629,51630,0,1,2
14751,2,1,51631,51631,51632,0,1,1
14752,5,3,51636,51636,51639,0,3,4
14753,3,3,51639,51639,51642,0,3,0
14754,2,2,51641,51642,51644,1,3,0
14755,6,2,51647,51647,51649,0,2,3
14756,1,3,51648,51649,51652,1,4,0
14757,2,3,51650,51652,51655,2,5,0
14758,6,1,51656,51656,51657,0,1,1
14759,2,1,51658,51658,51659,0,1,1
14760,4,2,51662,51662,51664,0,2,3
14761,2,1,51664,51664,51665,0,1,0
14762,6,3,51670,51670,51673,0,3,5
14763,2,3,51672,51673,51676,1,4,0
14764,5,3,51677,51677,51680,0,3,1
14765,3,1,51680,51680,51681,0,1,0
14766,3,3,51683,51683,51686,0,3,2
14767,4,1,51687,51687,51688,0,1,1
14768,6,1,51693,51693,51694,0,1,5
14769,3,2,51696,51696,51698,0,2,2
14770,1,3,51697,51698,51701,1,4,0
14771,5,3,51702,51702,51705,0,3,1
14772,6,1,51708,51708,51709,0,1,3
14773,1,3,51709,51709,51712,0,3,0
14774,3,2,51712,51712,51714,0,2,0
14775,6,2,51718,51718,51720,0,2,4
14776,4,2,51722,51722,51724,0,2,2
14777,3,2,51725,51725,51727,0,2,1
14778,2,2,51727,51727,51729,0,2,0
14779,5,3,51732,51732,51735,0,3,3
14780,3,2,51735,51735,51737,0,2,0
14781,4,2,51739,51739,51741,0,2,2
14782,6,2,51745,51745,51747,0,2,4
14783,1,2,51746,51747,51749,1,3,0
14784,6,3,51752,51752,51755,0,3,3
14785,6,1,51758,51758,51759,0,1,3
14786,3,3,51761,51761,51764,0,3,2
14787,3,2,51764,51764,51766,0,2,0
14788,4,3,51768,51768,51771,0,3,2
14789,1,2,51769,51771,51773,2,4,0
14790,6,2,51775,51775,51777,0,2,2
14791,6,3,51781,51781,51784,0,3,4
14792,1,3,51782,51784,51787,2,5,0
14793,4,1,51786,51787,51788,1,2,0
14794,3,1,51789,51789,51790,0,1,1
14795,2,2,51791,51791,51793,0,2,1
14796,4,2,51795,51795,51797,0,2,2
14797,3,2,51798,51798,51800,0,2,1
14798,2,2,51800,51800,51802,0,2,0
14799,5,3,51805,51805,51808,0,3,3
14800,1,1,51806,51808,51809,2,3,0
14801,2,1,51808,51809,51810,1,2,0
14802,4,1,51812,51812,51813,0,1,2
14803,1,3,51813,51813,51816,0,3,0
14804,6,2,51819,51819,51821,0,2,3
14805,1,3,51820,51821,51824,1,4,0
14806,3,3,51823,51824,51827,1,4,0
14807,3,1,51826,51827,51828,1,2,0
14808,5,1,51831,51831,51832,0,1,3
14809,2,3,51833,51833,51836,0,3,1
14810,3,2,51836,51836,51838,0,2,0
14811,6,3,51842,51842,51845,0,3,4
14812,4,2,51846,51846,51848,0,2,1
14813,3,3,51849,51849,51852,0,3,1
14814,3,1,51852,51852,51853,0,1,0
14815,3,3,51855,51855,51858,0,3,2
14816,1,2,51856,51858,51860,2,4,0
14817,6,2,51862,51862,51864,0,2,2
14818,2,2,51864,51864,51866,0,2,0
14819,3,2,51867,51867,51869,0,2,1
14820,4,1,51871,51871,51872,0,1,2
14821,2,2,51873,51873,51875,0,2,1
14822,6,3,51879,51879,51882,0,3,4
14823,2,2,51881,51882,51884,1,3,0
14824,5,1,51886,51886,51887,0,1,2
14825,2,2,51888,51888,51890,0,2,1
14826,6,1,51894,51894,51895,0,1,4
14827,5,1,51899,51899,51900,0,1,4
14828,1,2,51900,51900,51902,0,2,0
14829,3,3,51903,51903,51906,0,3,1
14830,3,2,51906,51906,51908,0,2,0
14831,1,3,51907,51908,51911,1,4,0
14832,3,1,51910,51911,51912,1,2,0
14833,6,3,51916,51916,51919,0,3,4
14834,2,1,51918,51919,51920,1,2,0
14835,1,2,51919,51920,51922,1,3,0
14836,1,1,51920,51922,51923,2,3,0
14837,1,3,51921,51923,51926,2,5,0
14838,3,1,51924,51926,51927,2,3,0
14839,6,1,51930,51930,51931,0,1,3
14840,2,1,51932,51932,51933,0,1,1
14841,2,3,51934,51934,51937,0,3,1
14842,4,3,51938,51938,51941,0,3,1
14843,1,1,51939,51941,51942,2,3,0
14844,3,3,51942,51942,51945,0,3,0
14845,2,2,51944,51945,51947,1,3,0
14846,3,1,51947,51947,51948,0,1,0
14847,2,1,51949,51949,51950,0,1,1
14848,6,3,51955,51955,51958,0,3,5
14849,2,2,51957,51958,51960,1,3,0
14850,1,3,51958,51960,51963,2,5,0
14851,6,1,51964,51964,51965,0,1,1
14852,2,1,51966,51966,51967,0,1,1
14853,2,3,51968,51968,51971,0,3,1
14854,3,1,51971,51971,51972,0,1,0
14855,2,3,51973,51973,51976,0,3,1
14856,6,3,51979,51979,51982,0,3,3
14857,1,3,51980,51982,51985,2,5,0
14858,4,3,51984,51985,51988,1,4,0
14859,1,1,51985,51988,51989,3,4,0
14860,5,2,51990,51990,51992,0,2,1
14861,1,2,51991,51992,51994,1,3,0
14862,3,2,51994,51994,51996,0,2,0
14863,1,1,51995,51996,51997,1,2,0
14864,1,3,51996,51997,52000,1,4,0
14865,2,2,51998,52000,52002,2,4,0
14866,6,2,52004,52004,52006,0,2,2
14867,1,1,52005,52006,52007,1,2,0
14868,5,1,52010,52010,52011,0,1,3
14869,3,2,52013,52013,52015,0,2,2
14870,1,3,52014,52015,52018,1,4,0
14871,6,2,52020,52020,52022,0,2,2
14872,4,3,52024,52024,52027,0,3,2
14873,3,3,52027,52027,52030,0,3,0
14874,6,1,52033,52033,52034,0,1,3
14875,6,3,52039,52039,52042,0,3,5
14876,1,2,52040,52042,52044,2,4,0
14877,6,3,52046,52046,52049,0,3,2
14878,6,3,52052,52052,52055,0,3,3
14879,6,3,52058,52058,52061,0,3,3
14880,6,2,52064,52064,52066,0,2,3
14881,5,1,52069,52069,52070,0,1,3
14882,3,1,52072,52072,52073,0,1,2
14883,3,3,52075,52075,52078,0,3,2
14884,5,3,52080,52080,52083,0,3,2
14885,5,3,52085,52085,52088,0,3,2
14886,2,1,52087,52088,52089,1,2,0
14887,1,3,52088,52089,52092,1,4,0
14888,3,2,52091,52092,52094,1,3,0
14889,1,3,52092,52094,52097,2,5,0
14890,4,2,52096,52097,52099,1,3,0
14891,2,2,52098,52099,52101,1,3,0
14892,1,2,52099,52101,52103,2,4,0
14893,2,3,52101,52103,52106,2,5,0
14894,2,2,52103,52106,52108,3,5,0
14895,6,2,52109,52109,52111,0,2,1
14896,3,1,52112,52112,52113,0,1,1
14897,6,2,52118,52118,52120,0,2,5
14898,3,2,52121,52121,52123,0,2,1
14899,4,1,52125,52125,52126,0,1,2
14900,5,3,52130,52130,52133,0,3,4
14901,6,3,52136,52136,52139,0,3,3
14902,2,3,52138,52139,52142,1,4,0
14903,5,1,52143,52143,52144,0,1,1
14904,3,3,52146,52146,52149,0,3,2
14905,3,3,52149,52149,52152,0,3,0
14906,3,1,52152,52152,52153,0,1,0
14907,3,2,52155,52155,52157,0,2,2
14908,4,1,52159,52159,52160,0,1,2
14909,5,1,52164,52164,52165,0,1,4
14910,1,1,52165,52165,52166,0,1,0
14911,5,2,52170,52170,52172,0,2,4
14912,2,1,52172,52172,52173,0,1,0
14913,3,3,52175,52175,52178,0,3,2
14914,2,2,52177,52178,52180,1,3,0
14915,1,1,52178,52180,52181,2,3,0
14916,4,1,52182,52182,52183,0,1,1
14917,6,1,52188,52188,52189,0,1,5
14918,1,3,52189,52189,52192,0,3,0
14919,6,1,52195,52195,52196,0,1,3
14920,1,3,52196,52196,52199,0,3,0
14921,6,1,52202,52202,52203,0,1,3
14922,6,2,52208,52208,52210,0,2,5
14923,3,2,52211,52211,52213,0,2,1
14924,6,3,52217,52217,52220,0,3,4
14925,1,2,52218,52220,52222,2,4,0
14926,2,2,52220,52222,52224,2,4,0
14927,6,1,52226,52226,52227,0,1,2
14928,5,3,52231,52231,52234,0,3,4
14929,4,3,52235,52235,52238,0,3,1
14930,6,1,52241,52241,52242,0,1,3
14931,1,2,52242,52242,52244,0,2,0
14932,2,2,52244,52244,52246,0,2,0
14933,3,3,52247,52247,52250,0,3,1
14934,4,3,52251,52251,52254,0,3,1
14935,5,1,52256,52256,52257,0,1,2
14936,2,3,52258,52258,52261,0,3,1
14937,5,2,52263,52263,52265,0,2,2
14938,1,3,52264,52265,52268,1,4,0
14939,5,1,52269,52269,52270,0,1,1
14940,6,1,52275,52275,52276,0,1,5
14941,3,1,52278,52278,52279,0,1,2
14942,6,2,52284,52284,52286,0,2,5
14943,2,1,52286,52286,52287,0,1,0
14944,2,2,52288,52288,52290,0,2,1
14945,6,2,52294,52294,52296,0,2,4
14946,5,1,52299,52299,52300,0,1,3
14947,2,3,52301,52301,52304,0,3,1
14948,2,3,52303,52304,52307,1,4,0
14949,6,2,52309,52309,52311,0,2,2
14950,3,2,52312,52312,52314,0,2,1
14951,6,1,52318,52318,52319,0,1,4
14952,4,3,52322,52322,52325,0,3,3
14953,2,2,52324,52325,52327,1,3,0
14954,1,1,52325,52327,52328,2,3,0
14955,6,2,52331,52331,52333,0,2,3
14956,1,2,52332,52333,52335,1,3,0
14957,3,2,52335,52335,52337,0,2,0
14958,2,1,52337,52337,52338,0,1,0
14959,5,2,52342,52342,52344,0,2,4
14960,4,2,52346,52346,52348,0,2,2
14961,3,2,52349,52349,52351,0,2,1
14962,2,3,52351,52351,52354,0,3,0
14963,1,2,52352,52354,52356,2,4,0
14964,3,3,52355,52356,52359,1,4,0
14965,1,2,52356,52359,52361,3,5,0
14966,4,2,52360,52361,52363,1,3,0
14967,2,2,52362,52363,52365,1,3,0
14968,5,1,52367,52367,52368,0,1,2
14969,1,2,52368,52368,52370,0,2,0
14970,3,3,52371,52371,52374,0,3,1
14971,6,2,52377,52377,52379,0,2,3
14972,5,3,52382,52382,52385,0,3,3
14973,6,1,52388,52388,52389,0,1,3
14974,3,1,52391,52391,52392,0,1,2
14975,1,1,52392,52392,52393,0,1,0
14976,4,2,52396,52396,52398,0,2,3
14977,6,2,52402,52402,52404,0,2,4
14978,2,2,52404,52404,52406,0,2,0
14979,6,3,52410,52410,52413,0,3,4
14980,6,3,52416,52416,52419,0,3,3
14981,3,3,52419,52419,52422,0,3,0
14982,3,2,52422,52422,52424,0,2,0
14983,5,3,52427,52427,52430,0,3,3
14984,4,1,52431,52431,52432,0,1,1
14985,1,3,52432,52432,52435,0,3,0
14986,2,3,52434,52435,52438,1,4,0
14987,2,2,52436,52438,52440,2,4,0
14988,1,2,52437,52440,52442,3,5,0
14989,2,1,52439,52442,52443,3,4,0
14990,4,3,52443,52443,52446,0,3,0
14991,4,3,52447,52447,52450,0,3,1
14992,4,1,52451,52451,52452,0,1,1
14993,1,1,52452,52452,52453,0,1,0
14994,4,1,52456,52456,52457,0,1,3
14995,4,3,52460,52460,52463,0,3,3
14996,4,3,52464,52464,52467,0,3,1
14997,3,1,52467,52467,52468,0,1,0
14998,1,2,52468,52468,52470,0,2,0
14999,4,2,52472,52472,52474,0,2,2
15000,2,3,52474,52474,52477,0,3,0
15001,1,3,52475,52477,52480,2,5,0
15002,1,1,52476,52480,52481,4,5,0
15003,3,3,52479,52481,52484,2,5,0
15004,1,2,52480,52484,52486,4,6,0
15005,4,2,52484,52486,52488,2,4,0
15006,4,1,52488,52488,52489,0,1,0
15007,5,3,52493,52493,52496,0,3,4
15008,2,1,52495,52496,52497,1,2,0
15009,2,3,52497,52497,52500,0,3,0
15010,2,1,52499,52500,52501,1,2,0
15011,2,3,52501,52501,52504,0,3,0
15012,2,1,52503,52504,52505,1,2,0
15013,5,1,52508,52508,52509,0,1,3
15014,2,2,52510,52510,52512,0,2,1
15015,2,2,52512,52512,52514,0,2,0
15016,2,2,52514,52514,52516,0,2,0
15017,2,3,52516,52516,52519,0,3,0
15018,4,3,52520,52520,52523,0,3,1
15019,4,3,52524,52524,52527,0,3,1
15020,1,1,52525,52527,52528,2,3,0
15021,6,3,52531,52531,52534,0,3,3
15022,6,2,52537,52537,52539,0,2,3
15023,5,1,52542,52542,52543,0,1,3
15024,4,1,52546,52546,52547,0,1,3
15025,1,3,52547,52547,52550,0,3,0
15026,5,2,52552,52552,52554,0,2,2
15027,6,2,52558,52558,52560,0,2,4
15028,3,1,52561,52561,52562,0,1,1
15029,4,3,52565,52565,52568,0,3,3
15030,6,2,52571,52571,52573,0,2,3
15031,5,3,52576,52576,52579,0,3,3
15032,2,2,52578,52579,52581,1,3,0
15033,1,2,52579,52581,52583,2,4,0
15034,5,3,52584,52584,52587,0,3,1
15035,2,2,52586,52587,52589,1,3,0
15036,6,3,52592,52592,52595,0,3,3
15037,3,2,52595,52595,52597,0,2,0
15038,3,1,52598,52598,52599,0,1,1
15039,3,1,52601,52601,52602,0,1,2
15040,6,2,52607,52607,52609,0,2,5
15041,6,3,52613,52613,52616,0,3,4
15042,4,1,52617,52617,52618,0,1,1
15043,2,2,52619,52619,52621,0,2,1
15044,6,1,52625,52625,52626,0,1,4
15045,3,3,52628,52628,52631,0,3,2
15046,3,1,52631,52631,52632,0,1,0
15047,5,2,52636,52636,52638,0,2,4
15048,1,1,52637,52638,52639,1,2,0
15049,5,3,52642,52642,52645,0,3,3
15050,5,3,52647,52647,52650,0,3,2
15051,5,3,52652,52652,52655,0,3,2
15052,6,3,52658,52658,52661,0,3,3
15053,6,1,52664,52664,52665,0,1,3
15054,5,3,52669,52669,52672,0,3,4
15055,6,1,52675,52675,52676,0,1,3
15056,5,3,52680,52680,52683,0,3,4
15057,2,2,52682,52683,52685,1,3,0
15058,6,3,52688,52688,52691,0,3,3
15059,5,2,52693,52693,52695,0,2,2
15060,3,1,52696,52696,52697,0,1,1
15061,3,1,52699,52699,52700,0,1,2
15062,6,1,52705,52705,52706,0,1,5
15063,4,2,52709,52709,52711,0,2,3
15064,4,2,52713,52713,52715,0,2,2
15065,4,3,52717,52717,52720,0,3,2
15066,1,3,52718,52720,52723,2,5,0
15067,5,3,52723,52723,52726,0,3,0
15068,1,1,52724,52726,52727,2,3,0
15069,4,2,52728,52728,52730,0,2,1
15070,1,2,52729,52730,52732,1,3,0
15071,6,2,52735,52735,52737,0,2,3
15072,5,2,52740,52740,52742,0,2,3
15073,2,3,52742,52742,52745,0,3,0
15074,3,3,52745,52745,52748,0,3,0
15075,5,1,52750,52750,52751,0,1,2
15076,4,3,52754,52754,52757,0,3,3
15077,4,2,52758,52758,52760,0,2,1
15078,1,3,52759,52760,52763,1,4,0
15079,6,3,52765,52765,52768,0,3,2
15080,5,3,52770,52770,52773,0,3,2
15081,4,3,52774,52774,52777,0,3,1
15082,5,3,52779,52779,52782,0,3,2
15083,1,1,52780,52782,52783,2,3,0
15084,4,3,52784,52784,52787,0,3,1
15085,3,1,52787,52787,52788,0,1,0
15086,6,1,52793,52793,52794,0,1,5
15087,4,3,52797,52797,52800,0,3,3
15088,2,3,52799,52800,52803,1,4,0
15089,4,2,52803,52803,52805,0,2,0
15090,4,1,52807,52807,52808,0,1,2
15091,6,2,52813,52813,52815,0,2,5
15092,1,2,52814,52815,52817,1,3,0
15093,1,3,52815,52817,52820,2,5,0
15094,2,1,52817,52820,52821,3,4,0
15095,2,2,52819,52821,52823,2,4,0
15096,1,2,52820,52823,52825,3,5,0
15097,5,2,52825,52825,52827,0,2,0
15098,5,3,52830,52830,52833,0,3,3
15099,4,2,52834,52834,52836,0,2,1
15100,4,2,52838,52838,52840,0,2,2
15101,1,2,52839,52840,52842,1,3,0
15102,4,2,52843,52843,52845,0,2,1
15103,5,1,52848,52848,52849,0,1,3
15104,2,3,52850,52850,52853,0,3,1
15105,4,2,52854,52854,52856,0,2,1
15106,5,2,52859,52859,52861,0,2,3
15107,1,3,52860,52861,52864,1,4,0
15108,4,2,52864,52864,52866,0,2,0
15109,3,3,52867,52867,52870,0,3,1
15110,4,1,52871,52871,52872,0,1,1
15111,3,2,52874,52874,52876,0,2,2
15112,6,2,52880,52880,52882,0,2,4
15113,2,2,52882,52882,52884,0,2,0
15114,2,2,52884,52884,52886,0,2,0
15115,3,1,52887,52887,52888,0,1,1
15116,2,3,52889,52889,52892,0,3,1
15117,5,2,52894,52894,52896,0,2,2
15118,1,3,52895,52896,52899,1,4,0
15119,1,2,52896,52899,52901,3,5,0
15120,3,3,52899,52901,52904,2,5,0
15121,3,2,52902,52904,52906,2,4,0
15122,2,1,52904,52906,52907,2,3,0
15123,3,1,52907,52907,52908,0,1,0
15124,2,1,52909,52909,52910,0,1,1
15125,1,3,52910,52910,52913,0,3,0
15126,4,1,52914,52914,52915,0,1,1
15127,4,3,52918,52918,52921,0,3,3
15128,2,1,52920,52921,52922,1,2,0
15129,1,2,52921,52922,52924,1,3,0
15130,5,1,52926,52926,52927,0,1,2
15131,4,3,52930,52930,52933,0,3,3
15132,6,2,52936,52936,52938,0,2,3
15133,3,2,52939,52939,52941,0,2,1
15134,4,1,52943,52943,52944,0,1,2
15135,6,2,52949,52949,52951,0,2,5
15136,2,3,52951,52951,52954,0,3,0
15137,5,1,52956,52956,52957,0,1,2
15138,5,2,52961,52961,52963,0,2,4
15139,5,3,52966,52966,52969,0,3,3
15140,2,1,52968,52969,52970,1,2,0
15141,6,1,52974,52974,52975,0,1,4
15142,2,1,52976,52976,52977,0,1,1
15143,1,2,52977,52977,52979,0,2,0
15144,6,1,52983,52983,52984,0,1,4
15145,3,1,52986,52986,52987,0,1,2
15146,4,2,52990,52990,52992,0,2,3
15147,1,2,52991,52992,52994,1,3,0
15148,3,3,52994,52994,52997,0,3,0
15149,3,3,52997,52997,53000,0,3,0
15150,5,3,53002,53002,53005,0,3,2
15151,4,1,53006,53006,53007,0,1,1
15152,6,2,53012,53012,53014,0,2,5
15153,1,3,53013,53014,53017,1,4,0
15154,5,3,53018,53018,53021,0,3,1
15155,2,2,53020,53021,53023,1,3,0
15156,1,2,53021,53023,53025,2,4,0
15157,1,1,53022,53025,53026,3,4,0
15158,6,3,53028,53028,53031,0,3,2
15159,1,3,53029,53031,53034,2,5,0
15160,4,1,53033,53034,53035,1,2,0
15161,4,2,53037,53037,53039,0,2,2
15162,6,1,53043,53043,53044,0,1,4
15163,4,2,53047,53047,53049,0,2,3
15164,6,1,53053,53053,53054,0,1,4
15165,6,2,53059,53059,53061,0,2,5
15166,2,1,53061,53061,53062,0,1,0
15167,3,2,53064,53064,53066,0,2,2
15168,5,3,53069,53069,53072,0,3,3
15169,5,2,53074,53074,53076,0,2,2
15170,4,2,53078,53078,53080,0,2,2
15171,2,2,53080,53080,53082,0,2,0
15172,1,3,53081,53082,53085,1,4,0
15173,1,3,53082,53085,53088,3,6,0
15174,3,3,53085,53088,53091,3,6,0
15175,6,1,53091,53091,53092,0,1,0
15176,4,3,53095,53095,53098,0,3,3
15177,4,2,53099,53099,53101,0,2,1
15178,6,2,53105,53105,53107,0,2,4
15179,1,1,53106,53107,53108,1,2,0
15180,3,3,53109,53109,53112,0,3,1
15181,2,1,53111,53112,53113,1,2,0
15182,3,2,53114,53114,53116,0,2,1
15183,2,2,53116,53116,53118,0,2,0
15184,5,1,53121,53121,53122,0,1,3
15185,1,3,53122,53122,53125,0,3,0
15186,6,3,53128,53128,53131,0,3,3
15187,5,1,53133,53133,53134,0,1,2
15188,1,2,53134,53134,53136,0,2,0
15189,5,3,53139,53139,53142,0,3,3
15190,6,3,53145,53145,53148,0,3,3
15191,3,2,53148,53148,53150,0,2,0
15192,4,1,53152,53152,53153,0,1,2
15193,1,2,53153,53153,53155,0,2,0
15194,6,3,53159,53159,53162,0,3,4
15195,5,3,53164,53164,53167,0,3,2
15196,4,3,53168,53168,53171,0,3,1
15197,5,1,53173,53173,53174,0,1,2
15198,2,2,53175,53175,53177,0,2,1
15199,6,2,53181,53181,53183,0,2,4
15200,4,3,53185,53185,53188,0,3,2
15201,3,2,53188,53188,53190,0,2,0
15202,1,1,53189,53190,53191,1,2,0
15203,2,2,53191,53191,53193,0,2,0
15204,4,3,53195,53195,53198,0,3,2
15205,6,1,53201,53201,53202,0,1,3
15206,2,1,53203,53203,53204,0,1,1
15207,3,2,53206,53206,53208,0,2,2
15208,3,1,53209,53209,53210,0,1,1
15209,5,3,53214,53214,53217,0,3,4
15210,6,3,53220,53220,53223,0,3,3
15211,6,1,53226,53226,53227,0,1,3
15212,5,3,53231,53231,53234,0,3,4
15213,2,3,53233,53234,53237,1,4,0
15214,4,3,53237,53237,53240,0,3,0
15215,1,1,53238,53240,53241,2,3,0
15216,6,1,53244,53244,53245,0,1,3
15217,2,2,53246,53246,53248,0,2,1
15218,1,2,53247,53248,53250,1,3,0
15219,6,2,53253,53253,53255,0,2,3
15220,3,1,53256,53256,53257,0,1,1
15221,4,2,53260,53260,53262,0,2,3
15222,3,2,53263,53263,53265,0,2,1
15223,2,1,53265,53265,53266,0,1,0
15224,5,1,53270,53270,53271,0,1,4
15225,4,3,53274,53274,53277,0,3,3
15226,1,1,53275,53277,53278,2,3,0
15227,1,1,53276,53278,53279,2,3,0
15228,4,1,53280,53280,53281,0,1,1
15229,5,2,53285,53285,53287,0,2,4
15230,5,3,53290,53290,53293,0,3,3
15231,6,1,53296,53296,53297,0,1,3
15232,5,3,53301,53301,53304,0,3,4
15233,4,3,53305,53305,53308,0,3,1
15234,1,2,53306,53308,53310,2,4,0
15235,6,2,53312,53312,53314,0,2,2
15236,6,1,53318,53318,53319,0,1,4
15237,3,3,53321,53321,53324,0,3,2
15238,2,3,53323,53324,53327,1,4,0
15239,5,1,53328,53328,53329,0,1,1
15240,2,2,53330,53330,53332,0,2,1
15241,3,2,53333,53333,53335,0,2,1
15242,5,2,53338,53338,53340,0,2,3
15243,4,3,53342,53342,53345,0,3,2
15244,5,3,53347,53347,53350,0,3,2
15245,5,3,53352,53352,53355,0,3,2
15246,6,3,53358,53358,53361,0,3,3
15247,3,3,53361,53361,53364,0,3,0
15248,1,1,53362,53364,53365,2,3,0
15249,2,1,53364,53365,53366,1,2,0
15250,3,1,53367,53367,53368,0,1,1
15251,5,1,53372,53372,53373,0,1,4
15252,1,3,53373,53373,53376,0,3,0
15253,1,1,53374,53376,53377,2,3,0
15254,1,2,53375,53377,53379,2,4,0
15255,2,2,53377,53379,53381,2,4,0
15256,6,1,53383,53383,53384,0,1,2
15257,2,1,53385,53385,53386,0,1,1
15258,2,2,53387,53387,53389,0,2,1
15259,1,2,53388,53389,53391,1,3,0
15260,6,2,53394,53394,53396,0,2,3
15261,2,2,53396,53396,53398,0,2,0
15262,3,2,53399,53399,53401,0,2,1
15263,4,2,53403,53403,53405,0,2,2
15264,3,3,53406,53406,53409,0,3,1
15265,1,2,53407,53409,53411,2,4,0
15266,1,2,53408,53411,53413,3,5,0
15267,5,2,53413,53413,53415,0,2,0
15268,6,3,53419,53419,53422,0,3,4
15269,4,3,53423,53423,53426,0,3,1
15270,1,2,53424,53426,53428,2,4,0
15271,2,1,53426,53428,53429,2,3,0
15272,1,2,53427,53429,53431,2,4,0
15273,2,2,53429,53431,53433,2,4,0
15274,1,2,53430,53433,53435,3,5,0
15275,4,2,53434,53435,53437,1,3,0
15276,1,1,53435,53437,53438,2,3,0
15277,5,2,53440,53440,53442,0,2,2
15278,1,1,53441,53442,53443,1,2,0
15279,1,3,53442,53443,53446,1,4,0
15280,6,2,53448,53448,53450,0,2,2
15281,4,1,53452,53452,53453,0,1,2
15282,2,2,53454,53454,53456,0,2,1
15283,6,1,53460,53460,53461,0,1,4
15284,6,2,53466,53466,53468,0,2,5
15285,5,1,53471,53471,53472,0,1,3
15286,1,3,53472,53472,53475,0,3,0
15287,6,2,53478,53478,53480,0,2,3
15288,2,2,53480,53480,53482,0,2,0
15289,1,3,53481,53482,53485,1,4,0
15290,6,1,53487,53487,53488,0,1,2
15291,2,3,53489,53489,53492,0,3,1
15292,4,3,53493,53493,53496,0,3,1
15293,5,3,53498,53498,53501,0,3,2
15294,2,3,53500,53501,53504,1,4,0
15295,3,3,53503,53504,53507,1,4,0
15296,4,3,53507,53507,53510,0,3,0
15297,6,1,53513,53513,53514,0,1,3
15298,5,1,53518,53518,53519,0,1,4
15299,4,1,53522,53522,53523,0,1,3
15300,3,3,53525,53525,53528,0,3,2
15301,3,2,53528,53528,53530,0,2,0
15302,4,2,53532,53532,53534,0,2,2
15303,2,2,53534,53534,53536,0,2,0
15304,1,2,53535,53536,53538,1,3,0
15305,1,2,53536,53538,53540,2,4,0
15306,1,1,53537,53540,53541,3,4,0
15307,2,3,53539,53541,53544,2,5,0
15308,5,1,53544,53544,53545,0,1,0
15309,2,1,53546,53546,53547,0,1,1
15310,4,1,53550,53550,53551,0,1,3
15311,3,3,53553,53553,53556,0,3,2
15312,1,3,53554,53556,53559,2,5,0
15313,4,1,53558,53559,53560,1,2,0
15314,2,2,53560,53560,53562,0,2,0
15315,3,1,53563,53563,53564,0,1,1
15316,6,1,53569,53569,53570,0,1,5
15317,4,3,53573,53573,53576,0,3,3
15318,3,1,53576,53576,53577,0,1,0
15319,5,1,53581,53581,53582,0,1,4
15320,5,1,53586,53586,53587,0,1,4
15321,5,1,53591,53591,53592,0,1,4
15322,2,1,53593,53593,53594,0,1,1
15323,6,2,53599,53599,53601,0,2,5
15324,3,1,53602,53602,53603,0,1,1
15325,1,3,53603,53603,53606,0,3,0
15326,3,2,53606,53606,53608,0,2,0
15327,3,2,53609,53609,53611,0,2,1
15328,4,1,53613,53613,53614,0,1,2
15329,5,3,53618,53618,53621,0,3,4
15330,3,1,53621,53621,53622,0,1,0
15331,2,1,53623,53623,53624,0,1,1
15332,1,3,53624,53624,53627,0,3,0
15333,4,1,53628,53628,53629,0,1,1
15334,6,1,53634,53634,53635,0,1,5
15335,3,1,53637,53637,53638,0,1,2
15336,4,2,53641,53641,53643,0,2,3
15337,4,2,53645,53645,53647,0,2,2
15338,6,2,53651,53651,53653,0,2,4
15339,1,1,53652,53653,53654,1,2,0
15340,1,1,53653,53654,53655,1,2,0
15341,4,3,53657,53657,53660,0,3,2
15342,3,1,53660,53660,53661,0,1,0
15343,2,3,53662,53662,53665,0,3,1
15344,4,2,53666,53666,53668,0,2,1
15345,6,3,53672,53672,53675,0,3,4
15346,6,1,53678,53678,53679,0,1,3
15347,3,2,53681,53681,53683,0,2,2
15348,5,1,53686,53686,53687,0,1,3
15349,1,1,53687,53687,53688,0,1,0
15350,4,3,53691,53691,53694,0,3,3
15351,6,2,53697,53697,53699,0,2,3
15352,1,2,53698,53699,53701,1,3,0
15353,4,2,53702,53702,53704,0,2,1
15354,5,3,53707,53707,53710,0,3,3
15355,6,1,53713,53713,53714,0,1,3
15356,6,3,53719,53719,53722,0,3,5
15357,5,3,53724,53724,53727,0,3,2
15358,4,3,53728,53728,53731,0,3,1
15359,3,2,53731,53731,53733,0,2,0
15360,3,2,53734,53734,53736,0,2,1
15361,6,2,53740,53740,53742,0,2,4
15362,5,2,53745,53745,53747,0,2,3
15363,1,2,53746,53747,53749,1,3,0
15364,4,1,53750,53750,53751,0,1,1
15365,5,1,53755,53755,53756,0,1,4
15366,5,1,53760,53760,53761,0,1,4
15367,5,2,53765,53765,53767,0,2,4
15368,6,3,53771,53771,53774,0,3,4
15369,6,3,53777,53777,53780,0,3,3
15370,4,3,53781,53781,53784,0,3,1
15371,2,1,53783,53784,53785,1,2,0
15372,2,3,53785,53785,53788,0,3,0
15373,2,2,53787,53788,53790,1,3,0
15374,4,1,53791,53791,53792,0,1,1
15375,4,2,53795,53795,53797,0,2,3
15376,5,3,53800,53800,53803,0,3,3
15377,2,2,53802,53803,53805,1,3,0
15378,4,3,53806,53806,53809,0,3,1
15379,4,3,53810,53810,53813,0,3,1
15380,3,2,53813,53813,53815,0,2,0
15381,1,1,53814,53815,53816,1,2,0
15382,1,2,53815,53816,53818,1,3,0
15383,4,1,53819,53819,53820,0,1,1
15384,3,3,53822,53822,53825,0,3,2
15385,2,3,53824,53825,53828,1,4,0
15386,3,3,53827,53828,53831,1,4,0
15387,4,2,53831,53831,53833,0,2,0
15388,5,3,53836,53836,53839,0,3,3
15389,4,3,53840,53840,53843,0,3,1
15390,6,3,53846,53846,53849,0,3,3
15391,5,2,53851,53851,53853,0,2,2
15392,3,1,53854,53854,53855,0,1,1
15393,3,1,53857,53857,53858,0,1,2
15394,6,2,53863,53863,53865,0,2,5
15395,5,3,53868,53868,53871,0,3,3
15396,4,3,53872,53872,53875,0,3,1
15397,3,2,53875,53875,53877,0,2,0
15398,1,1,53876,53877,53878,1,2,0
15399,1,3,53877,53878,53881,1,4,0
15400,3,1,53880,53881,53882,1,2,0
15401,3,3,53883,53883,53886,0,3,1
15402,3,1,53886,53886,53887,0,1,0
15403,1,3,53887,53887,53890,0,3,0
15404,5,2,53892,53892,53894,0,2,2
15405,5,2,53897,53897,53899,0,2,3
15406,1,1,53898,53899,53900,1,2,0
15407,5,1,53903,53903,53904,0,1,3
15408,1,3,53904,53904,53907,0,3,0
15409,3,1,53907,53907,53908,0,1,0
15410,2,3,53909,53909,53912,0,3,1
15411,3,3,53912,53912,53915,0,3,0
15412,6,2,53918,53918,53920,0,2,3
15413,2,1,53920,53920,53921,0,1,0
15414,3,2,53923,53923,53925,0,2,2
15415,6,3,53929,53929,53932,0,3,4
15416,4,3,53933,53933,53936,0,3,1
15417,5,3,53938,53938,53941,0,3,2
15418,1,2,53939,53941,53943,2,4,0
15419,6,1,53945,53945,53946,0,1,2
15420,5,1,53950,53950,53951,0,1,4
15421,5,3,53955,53955,53958,0,3,4
15422,6,3,53961,53961,53964,0,3,3
15423,2,3,53963,53964,53967,1,4,0
15424,1,1,53964,53967,53968,3,4,0
15425,2,2,53966,53968,53970,2,4,0
15426,1,1,53967,53970,53971,3,4,0
15427,2,2,53969,53971,53973,2,4,0
15428,5,1,53974,53974,53975,0,1,1
15429,6,3,53980,53980,53983,0,3,5
15430,4,2,53984,53984,53986,0,2,1
15431,3,1,53987,53987,53988,0,1,1
15432,1,1,53988,53988,53989,0,1,0
15433,3,3,53991,53991,53994,0,3,2
15434,2,3,53993,53994,53997,1,4,0
15435,2,1,53995,53997,53998,2,3,0
15436,6,2,54001,54001,54003,0,2,3
15437,5,1,54006,54006,54007,0,1,3
15438,3,3,54009,54009,54012,0,3,2
15439,2,1,54011,54012,54013,1,2,0
15440,5,2,54016,54016,54018,0,2,3
15441,2,1,54018,54018,54019,0,1,0
15442,3,2,54021,54021,54023,0,2,2
15443,4,1,54025,54025,54026,0,1,2
15444,5,3,54030,54030,54033,0,3,4
15445,2,1,54032,54033,54034,1,2,0
15446,6,2,54038,54038,54040,0,2,4
15447,6,2,54044,54044,54046,0,2,4
15448,6,1,54050,54050,54051,0,1,4
15449,3,1,54053,54053,54054,0,1,2
15450,6,3,54059,54059,54062,0,3,5
15451,6,1,54065,54065,54066,0,1,3
15452,2,1,54067,54067,54068,0,1,1
15453,2,3,54069,54069,54072,0,3,1
15454,1,3,54070,54072,54075,2,5,0
15455,5,1,54075,54075,54076,0,1,0
15456,1,3,54076,54076,54079,0,3,0
15457,2,3,54078,54079,54082,1,4,0
15458,1,2,54079,54082,54084,3,5,0
15459,1,3,54080,54084,54087,4,7,0
15460,5,1,54085,54087,54088,2,3,0
15461,2,1,54087,54088,54089,1,2,0
15462,3,3,54090,54090,54093,0,3,1
15463,6,2,54096,54096,54098,0,2,3
15464,2,2,54098,54098,54100,0,2,0
15465,4,3,54102,54102,54105,0,3,2
15466,6,2,54108,54108,54110,0,2,3
15467,2,2,54110,54110,54112,0,2,0
15468,1,1,54111,54112,54113,1,2,0
15469,4,3,54115,54115,54118,0,3,2
15470,4,2,54119,54119,54121,0,2,1
15471,4,2,54123,54123,54125,0,2,2
15472,6,2,54129,54129,54131,0,2,4
15473,1,3,54130,54131,54134,1,4,0
15474,2,3,54132,54134,54137,2,5,0
15475,4,3,54136,54137,54140,1,4,0
15476,5,2,54141,54141,54143,0,2,1
15477,4,3,54145,54145,54148,0,3,2
15478,2,1,54147,54148,54149,1,2,0
15479,2,1,54149,54149,54150,0,1,0
15480,6,1,54155,54155,54156,0,1,5
15481,3,1,54158,54158,54159,0,1,2
15482,5,1,54163,54163,54164,0,1,4
15483,2,2,54165,54165,54167,0,2,1
15484,1,2,54166,54167,54169,1,3,0
15485,4,1,54170,54170,54171,0,1,1
15486,5,1,54175,54175,54176,0,1,4
15487,3,1,54178,54178,54179,0,1,2
15488,3,1,54181,54181,54182,0,1,2
15489,1,2,54182,54182,54184,0,2,0
15490,4,2,54186,54186,54188,0,2,2
15491,5,2,54191,54191,54193,0,2,3
15492,6,2,54197,54197,54199,0,2,4
15493,4,2,54201,54201,54203,0,2,2
15494,5,3,54206,54206,54209,0,3,3
15495,3,3,54209,54209,54212,0,3,0
15496,5,2,54214,54214,54216,0,2,2
15497,3,3,54217,54217,54220,0,3,1
15498,1,1,54218,54220,54221,2,3,0
15499,4,2,54222,54222,54224,0,2,1
15500,5,3,54227,54227,54230,0,3,3
15501,2,3,54229,54230,54233,1,4,0
15502,1,2,54230,54233,54235,3,5,0
15503,4,1,54234,54235,54236,1,2,0
15504,6,3,54240,54240,54243,0,3,4
15505,5,2,54245,54245,54247,0,2,2
15506,4,3,54249,54249,54252,0,3,2
15507,2,1,54251,54252,54253,1,2,0
15508,5,2,54256,54256,54258,0,2,3
15509,2,2,54258,54258,54260,0,2,0
15510,4,3,54262,54262,54265,0,3,2
15511,1,1,54263,54265,54266,2,3,0
15512,5,1,54268,54268,54269,0,1,2
15513,3,3,54271,54271,54274,0,3,2
15514,3,3,54274,54274,54277,0,3,0
15515,5,3,54279,54279,54282,0,3,2
15516,1,2,54280,54282,54284,2,4,0
15517,6,2,54286,54286,54288,0,2,2
15518,6,1,54292,54292,54293,0,1,4
15519,6,3,54298,54298,54301,0,3,5
15520,1,3,54299,54301,54304,2,5,0
15521,5,2,54304,54304,54306,0,2,0
15522,1,1,54305,54306,54307,1,2,0
15523,1,2,54306,54307,54309,1,3,0
15524,2,2,54308,54309,54311,1,3,0
15525,5,2,54313,54313,54315,0,2,2
15526,3,3,54316,54316,54319,0,3,1
15527,5,2,54321,54321,54323,0,2,2
15528,6,3,54327,54327,54330,0,3,4
15529,3,3,54330,54330,54333,0,3,0
15530,5,2,54335,54335,54337,0,2,2
15531,2,2,54337,54337,54339,0,2,0
15532,4,2,54341,54341,54343,0,2,2
15533,2,3,54343,54343,54346,0,3,0
15534,3,3,54346,54346,54349,0,3,0
15535,3,1,54349,54349,54350,0,1,0
15536,1,2,54350,54350,54352,0,2,0
15537,5,3,54355,54355,54358,0,3,3
15538,6,1,54361,54361,54362,0,1,3
15539,1,1,54362,54362,54363,0,1,0
15540,1,2,54363,54363,54365,0,2,0
15541,4,1,54367,54367,54368,0,1,2
15542,1,3,54368,54368,54371,0,3,0
15543,1,3,54369,54371,54374,2,5,0
15544,4,1,54373,54374,54375,1,2,0
15545,1,1,54374,54375,54376,1,2,0
15546,2,3,54376,54376,54379,0,3,0
15547,3,3,54379,54379,54382,0,3,0
15548,2,1,54381,54382,54383,1,2,0
15549,2,2,54383,54383,54385,0,2,0
15550,2,2,54385,54385,54387,0,2,0
15551,2,1,54387,54387,54388,0,1,0
15552,5,3,54392,54392,54395,0,3,4
15553,6,2,54398,54398,54400,0,2,3
15554,6,2,54404,54404,54406,0,2,4
15555,4,2,54408,54408,54410,0,2,2
15556,1,1,54409,54410,54411,1,2,0
15557,5,2,54414,54414,54416,0,2,3
15558,2,3,54416,54416,54419,0,3,0
15559,2,1,54418,54419,54420,1,2,0
15560,4,3,54422,54422,54425,0,3,2
15561,4,3,54426,54426,54429,0,3,1
15562,4,1,54430,54430,54431,0,1,1
15563,6,2,54436,54436,54438,0,2,5
15564,3,3,54439,54439,54442,0,3,1
15565,2,2,54441,54442,54444,1,3,0
15566,4,1,54445,54445,54446,0,1,1
15567,3,2,54448,54448,54450,0,2,2
15568,1,1,54449,54450,54451,1,2,0
15569,4,3,54453,54453,54456,0,3,2
15570,5,3,54458,54458,54461,0,3,2
15571,2,1,54460,54461,54462,1,2,0
15572,4,1,54464,54464,54465,0,1,2
15573,4,2,54468,54468,54470,0,2,3
15574,1,3,54469,54470,54473,1,4,0
15575,1,1,54470,54473,54474,3,4,0
15576,6,3,54476,54476,54479,0,3,2
15577,6,1,54482,54482,54483,0,1,3
15578,2,1,54484,54484,54485,0,1,1
15579,6,3,54490,54490,54493,0,3,5
15580,6,3,54496,54496,54499,0,3,3
15581,1,1,54497,54499,54500,2,3,0
15582,5,2,54502,54502,54504,0,2,2
15583,2,3,54504,54504,54507,0,3,0
15584,2,2,54506,54507,54509,1,3,0
15585,5,1,54511,54511,54512,0,1,2
15586,3,3,54514,54514,54517,0,3,2
15587,1,1,54515,54517,54518,2,3,0
15588,4,2,54519,54519,54521,0,2,1
15589,3,2,54522,54522,54524,0,2,1
15590,5,1,54527,54527,54528,0,1,3
15591,2,2,54529,54529,54531,0,2,1
15592,4,3,54533,54533,54536,0,3,2
15593,1,1,54534,54536,54537,2,3,0
15594,2,3,54536,54537,54540,1,4,0
15595,4,1,54540,54540,54541,0,1,0
15596,5,3,54545,54545,54548,0,3,4
15597,3,1,54548,54548,54549,0,1,0
15598,5,3,54553,54553,54556,0,3,4
15599,2,1,54555,54556,54557,1,2,0
15600,4,2,54559,54559,54561,0,2,2
15601,3,1,54562,54562,54563,0,1,1
15602,3,1,54565,54565,54566,0,1,2
15603,3,2,54568,54568,54570,0,2,2
15604,6,3,54574,54574,54577,0,3,4
15605,5,2,54579,54579,54581,0,2,2
15606,1,2,54580,54581,54583,1,3,0
15607,5,3,54585,54585,54588,0,3,2
15608,2,2,54587,54588,54590,1,3,0
15609,3,3,54590,54590,54593,0,3,0
15610,4,3,54594,54594,54597,0,3,1
15611,3,1,54597,54597,54598,0,1,0
15612,5,1,54602,54602,54603,0,1,4
15613,1,1,54603,54603,54604,0,1,0
15614,1,3,54604,54604,54607,0,3,0
15615,3,3,54607,54607,54610,0,3,0
15616,3,3,54610,54610,54613,0,3,0
15617,1,2,54611,54613,54615,2,4,0
15618,1,2,54612,54615,54617,3,5,0
15619,3,2,54615,54617,54619,2,4,0
15620,3,3,54618,54619,54622,1,4,0
15621,4,3,54622,54622,54625,0,3,0
15622,6,3,54628,54628,54631,0,3,3
15623,3,3,54631,54631,54634,0,3,0
15624,3,1,54634,54634,54635,0,1,0
15625,6,2,54640,54640,54642,0,2,5
15626,6,1,54646,54646,54647,0,1,4
15627,6,1,54652,54652,54653,0,1,5
15628,1,3,54653,54653,54656,0,3,0
15629,5,3,54658,54658,54661,0,3,2
15630,1,3,54659,54661,54664,2,5,0
15631,2,2,54661,54664,54666,3,5,0
15632,5,2,54666,54666,54668,0,2,0
15633,3,2,54669,54669,54671,0,2,1
15634,1,2,54670,54671,54673,1,3,0
15635,6,2,54676,54676,54678,0,2,3
15636,4,3,54680,54680,54683,0,3,2
15637,3,3,54683,54683,54686,0,3,0
15638,5,1,54688,54688,54689,0,1,2
15639,4,2,54692,54692,54694,0,2,3
15640,4,2,54696,54696,54698,0,2,2
15641,5,3,54701,54701,54704,0,3,3
15642,2,2,54703,54704,54706,1,3,0
15643,6,1,54709,54709,54710,0,1,3
15644,3,3,54712,54712,54715,0,3,2
15645,3,3,54715,54715,54718,0,3,0
15646,2,3,54717,54718,54721,1,4,0
15647,2,2,54719,54721,54723,2,4,0
15648,5,2,54724,54724,54726,0,2,1
15649,2,3,54726,54726,54729,0,3,0
15650,5,2,54731,54731,54733,0,2,2
15651,5,2,54736,54736,54738,0,2,3
15652,3,2,54739,54739,54741,0,2,1
15653,3,2,54742,54742,54744,0,2,1
15654,2,2,54744,54744,54746,0,2,0
15655,6,3,54750,54750,54753,0,3,4
15656,2,1,54752,54753,54754,1,2,0
15657,5,3,54757,54757,54760,0,3,3
15658,2,1,54759,54760,54761,1,2,0
15659,3,2,54762,54762,54764,0,2,1
15660,5,2,54767,54767,54769,0,2,3
15661,4,2,54771,54771,54773,0,2,2
15662,6,2,54777,54777,54779,0,2,4
15663,3,2,54780,54780,54782,0,2,1
15664,4,3,54784,54784,54787,0,3,2
15665,4,2,54788,54788,54790,0,2,1
15666,4,2,54792,54792,54794,0,2,2
15667,1,3,54793,54794,54797,1,4,0
15668,3,3,54796,54797,54800,1,4,0
15669,2,1,54798,54800,54801,2,3,0
15670,3,1,54801,54801,54802,0,1,0
15671,3,3,54804,54804,54807,0,3,2
15672,4,1,54808,54808,54809,0,1,1
15673,4,2,54812,54812,54814,0,2,3
15674,6,1,54818,54818,54819,0,1,4
15675,1,1,54819,54819,54820,0,1,0
15676,1,3,54820,54820,54823,0,3,0
15677,6,1,54826,54826,54827,0,1,3
15678,6,3,54832,54832,54835,0,3,5
15679,3,3,54835,54835,54838,0,3,0
15680,2,1,54837,54838,54839,1,2,0
15681,3,3,54840,54840,54843,0,3,1
15682,3,3,54843,54843,54846,0,3,0
15683,6,3,54849,54849,54852,0,3,3
15684,1,2,54850,54852,54854,2,4,0
15685,2,1,54852,54854,54855,2,3,0
15686,4,3,54856,54856,54859,0,3,1
15687,3,3,54859,54859,54862,0,3,0
15688,6,1,54865,54865,54866,0,1,3
15689,4,1,54869,54869,54870,0,1,3
15690,2,2,54871,54871,54873,0,2,1
15691,2,1,54873,54873,54874,0,1,0
15692,3,2,54876,54876,54878,0,2,2
15693,3,1,54879,54879,54880,0,1,1
15694,4,3,54883,54883,54886,0,3,3
15695,2,3,54885,54886,54889,1,4,0
15696,4,3,54889,54889,54892,0,3,0
15697,3,1,54892,54892,54893,0,1,0
15698,4,1,54896,54896,54897,0,1,3
15699,1,1,54897,54897,54898,0,1,0
15700,1,2,54898,54898,54900,0,2,0
15701,3,1,54901,54901,54902,0,1,1
15702,4,2,54905,54905,54907,0,2,3
15703,5,2,54910,54910,54912,0,2,3
15704,3,3,54913,54913,54916,0,3,1
15705,5,2,54918,54918,54920,0,2,2
15706,4,3,54922,54922,54925,0,3,2
15707,2,1,54924,54925,54926,1,2,0
15708,6,2,54930,54930,54932,0,2,4
15709,2,2,54932,54932,54934,0,2,0
15710,3,1,54935,54935,54936,0,1,1
15711,3,2,54938,54938,54940,0,2,2
15712,6,3,54944,54944,54947,0,3,4
15713,6,2,54950,54950,54952,0,2,3
15714,3,1,54953,54953,54954,0,1,1
15715,5,1,54958,54958,54959,0,1,4
15716,5,3,54963,54963,54966,0,3,4
15717,6,3,54969,54969,54972,0,3,3
15718,1,1,54970,54972,54973,2,3,0
15719,4,2,54974,54974,54976,0,2,1
15720,5,2,54979,54979,54981,0,2,3
15721,1,3,54980,54981,54984,1,4,0
15722,6,1,54986,54986,54987,0,1,2
15723,2,3,54988,54988,54991,0,3,1
15724,1,3,54989,54991,54994,2,5,0
15725,2,3,54991,54994,54997,3,6,0
15726,4,1,54995,54997,54998,2,3,0
15727,6,2,55001,55001,55003,0,2,3
15728,5,2,55006,55006,55008,0,2,3
15729,6,1,55012,55012,55013,0,1,4
15730,3,3,55015,55015,55018,0,3,2
15731,2,2,55017,55018,55020,1,3,0
15732,5,1,55022,55022,55023,0,1,2
15733,5,2,55027,55027,55029,0,2,4
15734,2,2,55029,55029,55031,0,2,0
15735,5,1,55034,55034,55035,0,1,3
15736,1,2,55035,55035,55037,0,2,0
15737,1,1,55036,55037,55038,1,2,0
15738,5,3,55041,55041,55044,0,3,3
15739,1,2,55042,55044,55046,2,4,0
15740,5,2,55047,55047,55049,0,2,1
15741,4,3,55051,55051,55054,0,3,2
15742,3,1,55054,55054,55055,0,1,0
15743,4,3,55058,55058,55061,0,3,3
15744,1,3,55059,55061,55064,2,5,0
15745,6,2,55065,55065,55067,0,2,1
15746,1,1,55066,55067,55068,1,2,0
15747,6,1,55072,55072,55073,0,1,4
15748,2,3,55074,55074,55077,0,3,1
15749,2,2,55076,55077,55079,1,3,0
15750,4,2,55080,55080,55082,0,2,1
15751,3,2,55083,55083,55085,0,2,1
15752,5,2,55088,55088,55090,0,2,3
15753,6,2,55094,55094,55096,0,2,4
15754,6,1,55100,55100,55101,0,1,4
15755,4,2,55104,55104,55106,0,2,3
15756,6,3,55110,55110,55113,0,3,4
15757,3,2,55113,55113,55115,0,2,0
15758,3,2,55116,55116,55118,0,2,1
15759,1,3,55117,55118,55121,1,4,0
15760,4,2,55121,55121,55123,0,2,0
15761,5,2,55126,55126,55128,0,2,3
15762,5,1,55131,55131,55132,0,1,3
15763,2,3,55133,55133,55136,0,3,1
15764,3,3,55136,55136,55139,0,3,0
15765,6,2,55142,55142,55144,0,2,3
15766,3,1,55145,55145,55146,0,1,1
15767,4,3,55149,55149,55152,0,3,3
15768,3,2,55152,55152,55154,0,2,0
15769,1,2,55153,55154,55156,1,3,0
15770,4,3,55157,55157,55160,0,3,1
15771,3,2,55160,55160,55162,0,2,0
15772,6,2,55166,55166,55168,0,2,4
15773,5,3,55171,55171,55174,0,3,3
15774,4,3,55175,55175,55178,0,3,1
15775,6,1,55181,55181,55182,0,1,3
15776,1,1,55182,55182,55183,0,1,0
15777,5,2,55187,55187,55189,0,2,4
15778,4,2,55191,55191,55193,0,2,2
15779,3,2,55194,55194,55196,0,2,1
15780,1,3,55195,55196,55199,1,4,0
15781,1,2,55196,55199,55201,3,5,0
15782,5,3,55201,55201,55204,0,3,0
15783,3,3,55204,55204,55207,0,3,0
15784,3,1,55207,55207,55208,0,1,0
15785,6,3,55213,55213,55216,0,3,5
15786,6,2,55219,55219,55221,0,2,3
15787,5,3,55224,55224,55227,0,3,3
15788,6,3,55230,55230,55233,0,3,3
15789,1,2,55231,55233,55235,2,4,0
15790,6,2,55237,55237,55239,0,2,2
15791,3,3,55240,55240,55243,0,3,1
15792,2,2,55242,55243,55245,1,3,0
15793,1,2,55243,55245,55247,2,4,0
15794,6,2,55249,55249,55251,0,2,2
15795,1,3,55250,55251,55254,1,4,0
15796,5,2,55255,55255,55257,0,2,1
15797,5,3,55260,55260,55263,0,3,3
15798,6,2,55266,55266,55268,0,2,3
15799,6,3,55272,55272,55275,0,3,4
15800,1,3,55273,55275,55278,2,5,0
15801,3,3,55276,55278,55281,2,5,0
15802,3,2,55279,55281,55283,2,4,0
15803,3,3,55282,55283,55286,1,4,0
15804,4,2,55286,55286,55288,0,2,0
15805,6,2,55292,55292,55294,0,2,4
15806,6,1,55298,55298,55299,0,1,4
15807,2,2,55300,55300,55302,0,2,1
15808,3,3,55303,55303,55306,0,3,1
15809,2,3,55305,55306,55309,1,4,0
15810,3,2,55308,55309,55311,1,3,0
15811,4,1,55312,55312,55313,0,1,1
15812,5,1,55317,55317,55318,0,1,4
15813,6,1,55323,55323,55324,0,1,5
15814,5,3,55328,55328,55331,0,3,4
15815,5,2,55333,55333,55335,0,2,2
15816,4,2,55337,55337,55339,0,2,2
15817,2,1,55339,55339,55340,0,1,0
15818,4,1,55343,55343,55344,0,1,3
15819,5,2,55348,55348,55350,0,2,4
15820,2,1,55350,55350,55351,0,1,0
15821,3,2,55353,55353,55355,0,2,2
15822,5,3,55358,55358,55361,0,3,3
15823,6,3,55364,55364,55367,0,3,3
15824,2,2,55366,55367,55369,1,3,0
15825,1,1,55367,55369,55370,2,3,0
15826,3,1,55370,55370,55371,0,1,0
15827,5,3,55375,55375,55378,0,3,4
15828,4,3,55379,55379,55382,0,3,1
15829,2,3,55381,55382,55385,1,4,0
15830,1,2,55382,55385,55387,3,5,0
15831,6,2,55388,55388,55390,0,2,1
15832,3,2,55391,55391,55393,0,2,1
15833,5,2,55396,55396,55398,0,2,3
15834,3,3,55399,55399,55402,0,3,1
15835,6,1,55405,55405,55406,0,1,3
15836,3,3,55408,55408,55411,0,3,2
15837,3,2,55411,55411,55413,0,2,0
15838,5,1,55416,55416,55417,0,1,3
15839,1,1,55417,55417,55418,0,1,0
15840,4,2,55421,55421,55423,0,2,3
15841,6,1,55427,55427,55428,0,1,4
15842,5,1,55432,55432,55433,0,1,4
15843,5,3,55437,55437,55440,0,3,4
15844,4,1,55441,55441,55442,0,1,1
15845,3,2,55444,55444,55446,0,2,2
15846,1,3,55445,55446,55449,1,4,0
15847,4,3,55449,55449,55452,0,3,0
15848,1,1,55450,55452,55453,2,3,0
15849,5,3,55455,55455,55458,0,3,2
15850,5,2,55460,55460,55462,0,2,2
15851,2,1,55462,55462,55463,0,1,0
15852,1,3,55463,55463,55466,0,3,0
15853,2,3,55465,55466,55469,1,4,0
15854,5,3,55470,55470,55473,0,3,1
15855,5,1,55475,55475,55476,0,1,2
15856,6,2,55481,55481,55483,0,2,5
15857,4,3,55485,55485,55488,0,3,2
15858,2,1,55487,55488,55489,1,2,0
15859,6,3,55493,55493,55496,0,3,4
15860,3,1,55496,55496,55497,0,1,0
15861,6,1,55502,55502,55503,0,1,5
15862,6,3,55508,55508,55511,0,3,5
15863,4,3,55512,55512,55515,0,3,1
15864,6,1,55518,55518,55519,0,1,3
15865,2,1,55520,55520,55521,0,1,1
15866,4,3,55524,55524,55527,0,3,3
15867,1,3,55525,55527,55530,2,5,0
15868,6,3,55531,55531,55534,0,3,1
15869,5,2,55536,55536,55538,0,2,2
15870,1,1,55537,55538,55539,1,2,0
15871,4,2,55541,55541,55543,0,2,2
15872,3,3,55544,55544,55547,0,3,1
15873,5,3,55549,55549,55552,0,3,2
15874,4,3,55553,55553,55556,0,3,1
15875,6,2,55559,55559,55561,0,2,3
15876,1,2,55560,55561,55563,1,3,0
15877,4,1,55564,55564,55565,0,1,1
15878,4,3,55568,55568,55571,0,3,3
15879,2,1,55570,55571,55572,1,2,0
15880,3,1,55573,55573,55574,0,1,1
15881,3,3,55576,55576,55579,0,3,2
15882,2,1,55578,55579,55580,1,2,0
15883,1,2,55579,55580,55582,1,3,0
15884,4,3,55583,55583,55586,0,3,1
15885,5,3,55588,55588,55591,0,3,2
15886,4,3,55592,55592,55595,0,3,1
15887,6,3,55598,55598,55601,0,3,3
15888,3,3,55601,55601,55604,0,3,0
15889,4,1,55605,55605,55606,0,1,1
15890,4,2,55609,55609,55611,0,2,3
15891,1,1,55610,55611,55612,1,2,0
15892,3,3,55613,55613,55616,0,3,1
15893,3,3,55616,55616,55619,0,3,0
15894,1,1,55617,55619,55620,2,3,0
15895,6,2,55623,55623,55625,0,2,3
15896,1,1,55624,55625,55626,1,2,0
15897,1,1,55625,55626,55627,1,2,0
15898,2,2,55627,55627,55629,0,2,0
15899,1,1,55628,55629,55630,1,2,0
15900,1,1,55629,55630,55631,1,2,0
15901,4,1,55633,55633,55634,0,1,2
15902,3,3,55636,55636,55639,0,3,2
15903,3,2,55639,55639,55641,0,2,0
15904,4,2,55643,55643,55645,0,2,2
15905,5,3,55648,55648,55651,0,3,3
15906,1,1,55649,55651,55652,2,3,0
15907,1,2,55650,55652,55654,2,4,0
15908,4,2,55654,55654,55656,0,2,0
15909,5,2,55659,55659,55661,0,2,3
15910,4,3,55663,55663,55666,0,3,2
15911,2,3,55665,55666,55669,1,4,0
15912,6,3,55671,55671,55674,0,3,2
15913,6,1,55677,55677,55678,0,1,3
15914,1,1,55678,55678,55679,0,1,0
15915,6,3,55684,55684,55687,0,3,5
15916,4,1,55688,55688,55689,0,1,1
15917,3,1,55691,55691,55692,0,1,2
15918,1,2,55692,55692,55694,0,2,0
15919,5,3,55697,55697,55700,0,3,3
15920,3,3,55700,55700,55703,0,3,0
15921,4,3,55704,55704,55707,0,3,1
15922,6,3,55710,55710,55713,0,3,3
15923,6,1,55716,55716,55717,0,1,3
15924,5,3,55721,55721,55724,0,3,4
15925,2,3,55723,55724,55727,1,4,0
15926,6,2,55729,55729,55731,0,2,2
15927,4,2,55733,55733,55735,0,2,2
15928,1,3,55734,55735,55738,1,4,0
15929,4,2,55738,55738,55740,0,2,0
15930,4,2,55742,55742,55744,0,2,2
15931,6,2,55748,55748,55750,0,2,4
15932,2,1,55750,55750,55751,0,1,0
15933,6,1,55756,55756,55757,0,1,5
15934,2,3,55758,55758,55761,0,3,1
15935,5,3,55763,55763,55766,0,3,2
15936,6,1,55769,55769,55770,0,1,3
15937,2,1,55771,55771,55772,0,1,1
15938,2,3,55773,55773,55776,0,3,1
15939,3,2,55776,55776,55778,0,2,0
15940,4,1,55780,55780,55781,0,1,2
15941,4,3,55784,55784,55787,0,3,3
15942,5,2,55789,55789,55791,0,2,2
15943,4,2,55793,55793,55795,0,2,2
15944,1,3,55794,55795,55798,1,4,0
15945,2,1,55796,55798,55799,2,3,0
15946,5,1,55801,55801,55802,0,1,2
15947,1,2,55802,55802,55804,0,2,0
15948,6,3,55808,55808,55811,0,3,4
15949,1,1,55809,55811,55812,2,3,0
15950,1,1,55810,55812,55813,2,3,0
15951,1,1,55811,55813,55814,2,3,0
15952,4,3,55815,55815,55818,0,3,1
15953,3,3,55818,55818,55821,0,3,0
15954,1,2,55819,55821,55823,2,4,0
15955,5,1,55824,55824,55825,0,1,1
15956,2,2,55826,55826,55828,0,2,1
15957,2,3,55828,55828,55831,0,3,0
15958,1,2,55829,55831,55833,2,4,0
15959,2,1,55831,55833,55834,2,3,0
15960,4,3,55835,55835,55838,0,3,1
15961,4,2,55839,55839,55841,0,2,1
15962,1,1,55840,55841,55842,1,2,0
15963,4,3,55844,55844,55847,0,3,2
15964,5,3,55849,55849,55852,0,3,2
15965,1,3,55850,55852,55855,2,5,0
15966,6,3,55856,55856,55859,0,3,1
15967,3,2,55859,55859,55861,0,2,0
15968,5,3,55864,55864,55867,0,3,3
15969,2,1,55866,55867,55868,1,2,0
15970,6,3,55872,55872,55875,0,3,4
15971,4,3,55876,55876,55879,0,3,1
15972,2,2,55878,55879,55881,1,3,0
15973,4,2,55882,55882,55884,0,2,1
15974,2,1,55884,55884,55885,0,1,0
15975,2,1,55886,55886,55887,0,1,1
15976,2,2,55888,55888,55890,0,2,1
15977,4,2,55892,55892,55894,0,2,2
15978,1,1,55893,55894,55895,1,2,0
15979,3,1,55896,55896,55897,0,1,1
15980,2,2,55898,55898,55900,0,2,1
15981,4,1,55902,55902,55903,0,1,2
15982,2,2,55904,55904,55906,0,2,1
15983,5,1,55909,55909,55910,0,1,3
15984,1,1,55910,55910,55911,0,1,0
15985,1,1,55911,55911,55912,0,1,0
15986,4,1,55915,55915,55916,0,1,3
15987,4,2,55919,55919,55921,0,2,3
15988,3,3,55922,55922,55925,0,3,1
15989,6,3,55928,55928,55931,0,3,3
15990,2,1,55930,55931,55932,1,2,0
15991,3,2,55933,55933,55935,0,2,1
15992,6,2,55939,55939,55941,0,2,4
15993,4,2,55943,55943,55945,0,2,2
15994,1,2,55944,55945,55947,1,3,0
15995,3,2,55947,55947,55949,0,2,0
15996,1,1,55948,55949,55950,1,2,0
15997,1,3,55949,55950,55953,1,4,0
15998,6,3,55955,55955,55958,0,3,2
15999,2,1,55957,55958,55959,1,2,0
16000,4,3,55961,55961,55964,0,3,2
16001,5,3,55966,55966,55969,0,3,2
16002,4,1,55970,55970,55971,0,1,1
16003,4,1,55974,55974,55975,0,1,3
16004,2,2,55976,55976,55978,0,2,1
16005,5,3,55981,55981,55984,0,3,3
16006,4,3,55985,55985,55988,0,3,1
16007,1,3,55986,55988,55991,2,5,0
16008,1,2,55987,55991,55993,4,6,0
16009,6,3,55993,55993,55996,0,3,0
16010,2,3,55995,55996,55999,1,4,0
16011,4,3,55999,55999,56002,0,3,0
16012,4,1,56003,56003,56004,0,1,1
16013,2,1,56005,56005,56006,0,1,1
16014,5,3,56010,56010,56013,0,3,4
16015,4,3,56014,56014,56017,0,3,1
16016,1,2,56015,56017,56019,2,4,0
16017,1,3,56016,56019,56022,3,6,0
16018,5,1,56021,56022,56023,1,2,0
16019,4,2,56025,56025,56027,0,2,2
16020,1,3,56026,56027,56030,1,4,0
16021,5,1,56031,56031,56032,0,1,1
16022,6,1,56037,56037,56038,0,1,5
16023,6,1,56043,56043,56044,0,1,5
16024,1,1,56044,56044,56045,0,1,0
16025,4,2,56048,56048,56050,0,2,3
16026,2,1,56050,56050,56051,0,1,0
16027,4,1,56054,56054,56055,0,1,3
16028,6,1,56060,56060,56061,0,1,5
16029,2,3,56062,56062,56065,0,3,1
16030,6,2,56068,56068,56070,0,2,3
16031,2,3,56070,56070,56073,0,3,0
16032,2,2,56072,56073,56075,1,3,0
16033,1,1,56073,56075,56076,2,3,0
16034,5,2,56078,56078,56080,0,2,2
16035,3,1,56081,56081,56082,0,1,1
16036,2,3,56083,56083,56086,0,3,1
16037,6,1,56089,56089,56090,0,1,3
16038,5,1,56094,56094,56095,0,1,4
16039,1,3,56095,56095,56098,0,3,0
16040,3,2,56098,56098,56100,0,2,0
16041,4,3,56102,56102,56105,0,3,2
16042,1,2,56103,56105,56107,2,4,0
16043,3,3,56106,56107,56110,1,4,0
16044,4,2,56110,56110,56112,0,2,0
16045,6,1,56116,56116,56117,0,1,4
16046,1,2,56117,56117,56119,0,2,0
16047,1,2,56118,56119,56121,1,3,0
16048,4,3,56122,56122,56125,0,3,1
16049,1,3,56123,56125,56128,2,5,0
16050,6,1,56129,56129,56130,0,1,1
16051,3,3,56132,56132,56135,0,3,2
16052,1,3,56133,56135,56138,2,5,0
16053,6,2,56139,56139,56141,0,2,1
16054,6,1,56145,56145,56146,0,1,4
16055,5,3,56150,56150,56153,0,3,4
16056,4,3,56154,56154,56157,0,3,1
16057,3,3,56157,56157,56160,0,3,0
16058,2,2,56159,56160,56162,1,3,0
16059,2,1,56161,56162,56163,1,2,0
16060,2,2,56163,56163,56165,0,2,0
16061,2,1,56165,56165,56166,0,1,0
16062,4,2,56169,56169,56171,0,2,3
16063,2,3,56171,56171,56174,0,3,0
16064,3,2,56174,56174,56176,0,2,0
16065,4,2,56178,56178,56180,0,2,2
16066,2,1,56180,56180,56181,0,1,0
16067,2,3,56182,56182,56185,0,3,1
16068,5,1,56187,56187,56188,0,1,2
16069,4,1,56191,56191,56192,0,1,3
16070,3,1,56194,56194,56195,0,1,2
16071,1,1,56195,56195,56196,0,1,0
16072,1,3,56196,56196,56199,0,3,0
16073,4,1,56200,56200,56201,0,1,1
16074,3,2,56203,56203,56205,0,2,2
16075,3,2,56206,56206,56208,0,2,1
16076,6,2,56212,56212,56214,0,2,4
16077,4,1,56216,56216,56217,0,1,2
16078,5,1,56221,56221,56222,0,1,4
16079,5,1,56226,56226,56227,0,1,4
16080,2,1,56228,56228,56229,0,1,1
16081,3,3,56231,56231,56234,0,3,2
16082,1,3,56232,56234,56237,2,5,0
16083,3,1,56235,56237,56238,2,3,0
16084,2,1,56237,56238,56239,1,2,0
16085,1,1,56238,56239,56240,1,2,0
16086,3,3,56241,56241,56244,0,3,1
16087,2,2,56243,56244,56246,1,3,0
16088,5,3,56248,56248,56251,0,3,2
16089,3,3,56251,56251,56254,0,3,0
16090,2,2,56253,56254,56256,1,3,0
16091,6,3,56259,56259,56262,0,3,3
16092,3,3,56262,56262,56265,0,3,0
16093,6,2,56268,56268,56270,0,2,3
16094,1,3,56269,56270,56273,1,4,0
16095,6,2,56275,56275,56277,0,2,2
16096,5,2,56280,56280,56282,0,2,3
16097,3,3,56283,56283,56286,0,3,1
16098,2,1,56285,56286,56287,1,2,0
16099,6,1,56291,56291,56292,0,1,4
16100,4,3,56295,56295,56298,0,3,3
16101,4,2,56299,56299,56301,0,2,1
16102,3,2,56302,56302,56304,0,2,1
16103,2,1,56304,56304,56305,0,1,0
16104,5,1,56309,56309,56310,0,1,4
16105,3,2,56312,56312,56314,0,2,2
16106,6,1,56318,56318,56319,0,1,4
16107,1,1,56319,56319,56320,0,1,0
16108,6,3,56325,56325,56328,0,3,5
16109,4,3,56329,56329,56332,0,3,1
16110,2,3,56331,56332,56335,1,4,0
16111,6,3,56337,56337,56340,0,3,2
16112,3,3,56340,56340,56343,0,3,0
16113,6,1,56346,56346,56347,0,1,3
16114,3,2,56349,56349,56351,0,2,2
16115,4,2,56353,56353,56355,0,2,2
16116,3,1,56356,56356,56357,0,1,1
16117,4,3,56360,56360,56363,0,3,3
16118,5,3,56365,56365,56368,0,3,2
16119,5,2,56370,56370,56372,0,2,2
16120,4,1,56374,56374,56375,0,1,2
16121,5,1,56379,56379,56380,0,1,4
16122,4,3,56383,56383,56386,0,3,3
16123,1,3,56384,56386,56389,2,5,0
16124,3,1,56387,56389,56390,2,3,0
16125,5,2,56392,56392,56394,0,2,2
16126,1,3,56393,56394,56397,1,4,0
16127,1,2,56394,56397,56399,3,5,0
16128,4,2,56398,56399,56401,1,3,0
16129,4,1,56402,56402,56403,0,1,1
16130,5,1,56407,56407,56408,0,1,4
16131,4,2,56411,56411,56413,0,2,3
16132,2,1,56413,56413,56414,0,1,0
16133,6,2,56419,56419,56421,0,2,5
16134,6,3,56425,56425,56428,0,3,4
16135,2,3,56427,56428,56431,1,4,0
16136,2,2,56429,56431,56433,2,4,0
16137,2,1,56431,56433,56434,2,3,0
16138,5,3,56436,56436,56439,0,3,2
16139,1,3,56437,56439,56442,2,5,0
16140,2,3,56439,56442,56445,3,6,0
16141,6,1,56445,56445,56446,0,1,0
16142,1,2,56446,56446,56448,0,2,0
16143,2,1,56448,56448,56449,0,1,0
16144,3,1,56451,56451,56452,0,1,2
16145,6,3,56457,56457,56460,0,3,5
16146,6,1,56463,56463,56464,0,1,3
16147,5,3,56468,56468,56471,0,3,4
16148,1,2,56469,56471,56473,2,4,0
16149,5,2,56474,56474,56476,0,2,1
16150,2,1,56476,56476,56477,0,1,0
16151,4,1,56480,56480,56481,0,1,3
16152,6,2,56486,56486,56488,0,2,5
16153,3,3,56489,56489,56492,0,3,1
16154,5,1,56494,56494,56495,0,1,2
16155,5,3,56499,56499,56502,0,3,4
16156,2,1,56501,56502,56503,1,2,0
16157,2,3,56503,56503,56506,0,3,0
16158,6,3,56509,56509,56512,0,3,3
16159,3,1,56512,56512,56513,0,1,0
16160,5,3,56517,56517,56520,0,3,4
16161,4,1,56521,56521,56522,0,1,1
16162,2,1,56523,56523,56524,0,1,1
16163,6,1,56529,56529,56530,0,1,5
16164,2,1,56531,56531,56532,0,1,1
16165,2,1,56533,56533,56534,0,1,1
16166,4,2,56537,56537,56539,0,2,3
16167,2,3,56539,56539,56542,0,3,0
16168,6,2,56545,56545,56547,0,2,3
16169,5,3,56550,56550,56553,0,3,3
16170,3,1,56553,56553,56554,0,1,0
16171,4,1,56557,56557,56558,0,1,3
16172,2,2,56559,56559,56561,0,2,1
16173,2,1,56561,56561,56562,0,1,0
16174,3,2,56564,56564,56566,0,2,2
16175,6,3,56570,56570,56573,0,3,4
16176,6,3,56576,56576,56579,0,3,3
16177,6,3,56582,56582,56585,0,3,3
16178,4,2,56586,56586,56588,0,2,1
16179,4,3,56590,56590,56593,0,3,2
16180,5,1,56595,56595,56596,0,1,2
16181,1,2,56596,56596,56598,0,2,0
16182,3,1,56599,56599,56600,0,1,1
16183,6,3,56605,56605,56608,0,3,5
16184,2,2,56607,56608,56610,1,3,0
16185,5,3,56612,56612,56615,0,3,2
16186,4,1,56616,56616,56617,0,1,1
16187,2,1,56618,56618,56619,0,1,1
16188,6,1,56624,56624,56625,0,1,5
16189,4,1,56628,56628,56629,0,1,3
16190,3,3,56631,56631,56634,0,3,2
16191,6,1,56637,56637,56638,0,1,3
16192,5,1,56642,56642,56643,0,1,4
16193,5,2,56647,56647,56649,0,2,4
16194,1,2,56648,56649,56651,1,3,0
16195,6,2,56654,56654,56656,0,2,3
16196,2,2,56656,56656,56658,0,2,0
16197,2,2,56658,56658,56660,0,2,0
16198,2,1,56660,56660,56661,0,1,0
16199,2,3,56662,56662,56665,0,3,1
16200,4,3,56666,56666,56669,0,3,1
16201,2,1,56668,56669,56670,1,2,0
16202,3,2,56671,56671,56673,0,2,1
16203,6,1,56677,56677,56678,0,1,4
16204,5,2,56682,56682,56684,0,2,4
16205,3,2,56685,56685,56687,0,2,1
16206,1,3,56686,56687,56690,1,4,0
16207,5,3,56691,56691,56694,0,3,1
16208,2,2,56693,56694,56696,1,3,0
16209,2,1,56695,56696,56697,1,2,0
16210,1,2,56696,56697,56699,1,3,0
16211,4,2,56700,56700,56702,0,2,1
16212,5,3,56705,56705,56708,0,3,3
16213,5,3,56710,56710,56713,0,3,2
16214,2,2,56712,56713,56715,1,3,0
16215,3,3,56715,56715,56718,0,3,0
16216,1,3,56716,56718,56721,2,5,0
16217,3,3,56719,56721,56724,2,5,0
16218,1,2,56720,56724,56726,4,6,0
16219,3,2,56723,56726,56728,3,5,0
16220,1,3,56724,56728,56731,4,7,0
16221,4,3,56728,56731,56734,3,6,0
16222,1,1,56729,56734,56735,5,6,0
16223,4,3,56733,56735,56738,2,5,0
16224,3,2,56736,56738,56740,2,4,0
16225,5,2,56741,56741,56743,0,2,1
16226,4,3,56745,56745,56748,0,3,2
16227,3,1,56748,56748,56749,0,1,0
16228,3,2,56751,56751,56753,0,2,2
16229,1,2,56752,56753,56755,1,3,0
16230,6,2,56758,56758,56760,0,2,3
16231,5,2,56763,56763,56765,0,2,3
16232,1,1,56764,56765,56766,1,2,0
16233,1,3,56765,56766,56769,1,4,0
16234,5,2,56770,56770,56772,0,2,1
16235,4,2,56774,56774,56776,0,2,2
16236,3,3,56777,56777,56780,0,3,1
16237,1,1,56778,56780,56781,2,3,0
16238,5,1,56783,56783,56784,0,1,2
16239,6,2,56789,56789,56791,0,2,5
16240,6,2,56795,56795,56797,0,2,4
16241,3,2,56798,56798,56800,0,2,1
16242,3,1,56801,56801,56802,0,1,1
16243,3,3,56804,56804,56807,0,3,2
16244,2,3,56806,56807,56810,1,4,0
16245,4,2,56810,56810,56812,0,2,0
16246,1,1,56811,56812,56813,1,2,0
16247,5,1,56816,56816,56817,0,1,3
16248,1,2,56817,56817,56819,0,2,0
16249,2,3,56819,56819,56822,0,3,0
16250,1,3,56820,56822,56825,2,5,0
16251,1,1,56821,56825,56826,4,5,0
16252,6,2,56827,56827,56829,0,2,1
16253,6,1,56833,56833,56834,0,1,4
16254,3,1,56836,56836,56837,0,1,2
16255,4,1,56840,56840,56841,0,1,3
16256,4,2,56844,56844,56846,0,2,3
16257,2,2,56846,56846,56848,0,2,0
16258,3,3,56849,56849,56852,0,3,1
16259,3,2,56852,56852,56854,0,2,0
16260,4,3,56856,56856,56859,0,3,2
16261,6,1,56862,56862,56863,0,1,3
16262,2,3,56864,56864,56867,0,3,1
16263,1,3,56865,56867,56870,2,5,0
16264,2,3,56867,56870,56873,3,6,0
16265,2,3,56869,56873,56876,4,7,0
16266,5,3,56874,56876,56879,2,5,0
16267,6,2,56880,56880,56882,0,2,1
16268,6,2,56886,56886,56888,0,2,4
16269,3,1,56889,56889,56890,0,1,1
16270,4,1,56893,56893,56894,0,1,3
16271,2,3,56895,56895,56898,0,3,1
16272,3,3,56898,56898,56901,0,3,0
16273,6,3,56904,56904,56907,0,3,3
16274,5,3,56909,56909,56912,0,3,2
16275,2,1,56911,56912,56913,1,2,0
16276,5,2,56916,56916,56918,0,2,3
16277,1,1,56917,56918,56919,1,2,0
16278,6,2,56923,56923,56925,0,2,4
16279,5,3,56928,56928,56931,0,3,3
16280,3,3,56931,56931,56934,0,3,0
16281,3,1,56934,56934,56935,0,1,0
16282,1,2,56935,56935,56937,0,2,0
16283,5,1,56940,56940,56941,0,1,3
16284,1,1,56941,56941,56942,0,1,0
16285,3,1,56944,56944,56945,0,1,2
16286,1,2,56945,56945,56947,0,2,0
16287,6,1,56951,56951,56952,0,1,4
16288,5,3,56956,56956,56959,0,3,4
16289,5,2,56961,56961,56963,0,2,2
16290,6,2,56967,56967,56969,0,2,4
16291,1,2,56968,56969,56971,1,3,0
16292,4,2,56972,56972,56974,0,2,1
16293,6,3,56978,56978,56981,0,3,4
16294,4,3,56982,56982,56985,0,3,1
16295,1,1,56983,56985,56986,2,3,0
16296,2,2,56985,56986,56988,1,3,0
16297,5,1,56990,56990,56991,0,1,2
16298,5,1,56995,56995,56996,0,1,4
16299,1,2,56996,56996,56998,0,2,0
16300,2,2,56998,56998,57000,0,2,0
16301,3,1,57001,57001,57002,0,1,1
16302,3,2,57004,57004,57006,0,2,2
16303,5,2,57009,57009,57011,0,2,3
16304,4,2,57013,57013,57015,0,2,2
16305,3,3,57016,57016,57019,0,3,1
16306,2,3,57018,57019,57022,1,4,0
16307,5,2,57023,57023,57025,0,2,1
16308,3,1,57026,57026,57027,0,1,1
16309,4,1,57030,57030,57031,0,1,3
16310,5,1,57035,57035,57036,0,1,4
16311,4,2,57039,57039,57041,0,2,3
16312,4,1,57043,57043,57044,0,1,2
16313,1,2,57044,57044,57046,0,2,0
16314,2,1,57046,57046,57047,0,1,0
16315,5,3,57051,57051,57054,0,3,4
16316,3,2,57054,57054,57056,0,2,0
16317,1,3,57055,57056,57059,1,4,0
16318,5,2,57060,57060,57062,0,2,1
16319,4,2,57064,57064,57066,0,2,2
16320,4,1,57068,57068,57069,0,1,2
16321,4,3,57072,57072,57075,0,3,3
16322,4,2,57076,57076,57078,0,2,1
16323,6,2,57082,57082,57084,0,2,4
16324,4,3,57086,57086,57089,0,3,2
16325,1,2,57087,57089,57091,2,4,0
16326,1,3,57088,57091,57094,3,6,0
16327,4,2,57092,57094,57096,2,4,0
16328,4,1,57096,57096,57097,0,1,0
16329,6,3,57102,57102,57105,0,3,5
16330,1,1,57103,57105,57106,2,3,0
16331,5,3,57108,57108,57111,0,3,2
16332,2,1,57110,57111,57112,1,2,0
16333,6,2,57116,57116,57118,0,2,4
16334,2,2,57118,57118,57120,0,2,0
16335,1,3,57119,57120,57123,1,4,0
16336,2,2,57121,57123,57125,2,4,0
16337,4,2,57125,57125,57127,0,2,0
16338,6,2,57131,57131,57133,0,2,4
16339,3,1,57134,57134,57135,0,1,1
16340,3,3,57137,57137,57140,0,3,2
16341,3,2,57140,57140,57142,0,2,0
16342,2,2,57142,57142,57144,0,2,0
16343,2,2,57144,57144,57146,0,2,0
16344,5,3,57149,57149,57152,0,3,3
16345,5,3,57154,57154,57157,0,3,2
16346,3,1,57157,57157,57158,0,1,0
16347,2,2,57159,57159,57161,0,2,1
16348,5,2,57164,57164,57166,0,2,3
16349,6,1,57170,57170,57171,0,1,4
16350,5,3,57175,57175,57178,0,3,4
16351,3,2,57178,57178,57180,0,2,0
16352,4,2,57182,57182,57184,0,2,2
16353,3,2,57185,57185,57187,0,2,1
16354,4,1,57189,57189,57190,0,1,2
16355,6,2,57195,57195,57197,0,2,5
16356,6,3,57201,57201,57204,0,3,4
16357,3,2,57204,57204,57206,0,2,0
16358,6,3,57210,57210,57213,0,3,4
16359,3,1,57213,57213,57214,0,1,0
16360,2,2,57215,57215,57217,0,2,1
16361,1,3,57216,57217,57220,1,4,0
16362,5,1,57221,57221,57222,0,1,1
16363,2,1,57223,57223,57224,0,1,1
16364,2,2,57225,57225,57227,0,2,1
16365,5,2,57230,57230,57232,0,2,3
16366,2,2,57232,57232,57234,0,2,0
16367,2,1,57234,57234,57235,0,1,0
16368,4,1,57238,57238,57239,0,1,3
16369,3,3,57241,57241,57244,0,3,2
16370,5,1,57246,57246,57247,0,1,2
16371,1,1,57247,57247,57248,0,1,0
16372,1,3,57248,57248,57251,0,3,0
16373,4,3,57252,57252,57255,0,3,1
16374,4,1,57256,57256,57257,0,1,1
16375,5,2,57261,57261,57263,0,2,4
16376,1,2,57262,57263,57265,1,3,0
16377,1,3,57263,57265,57268,2,5,0
16378,6,2,57269,57269,57271,0,2,1
16379,2,2,57271,57271,57273,0,2,0
16380,4,3,57275,57275,57278,0,3,2
16381,1,3,57276,57278,57281,2,5,0
16382,5,3,57281,57281,57284,0,3,0
16383,2,2,57283,57284,57286,1,3,0
16384,1,2,57284,57286,57288,2,4,0
16385,4,3,57288,57288,57291,0,3,0
16386,3,3,57291,57291,57294,0,3,0
16387,2,3,57293,57294,57297,1,4,0
16388,3,1,57296,57297,57298,1,2,0
16389,6,1,57302,57302,57303,0,1,4
16390,4,2,57306,57306,57308,0,2,3
16391,5,1,57311,57311,57312,0,1,3
16392,6,1,57317,57317,57318,0,1,5
16393,5,3,57322,57322,57325,0,3,4
16394,6,3,57328,57328,57331,0,3,3
16395,2,1,57330,57331,57332,1,2,0
16396,3,1,57333,57333,57334,0,1,1
16397,1,1,57334,57334,57335,0,1,0
16398,4,2,57338,57338,57340,0,2,3
16399,2,3,57340,57340,57343,0,3,0
16400,1,3,57341,57343,57346,2,5,0
16401,1,2,57342,57346,57348,4,6,0
16402,3,2,57345,57348,57350,3,5,0
16403,1,2,57346,57350,57352,4,6,0
16404,2,3,57348,57352,57355,4,7,0
16405,4,1,57352,57355,57356,3,4,0
16406,6,3,57358,57358,57361,0,3,2
16407,6,1,57364,57364,57365,0,1,3
16408,4,1,57368,57368,57369,0,1,3
16409,5,2,57373,57373,57375,0,2,4
16410,5,3,57378,57378,57381,0,3,3
16411,1,2,57379,57381,57383,2,4,0
16412,4,3,57383,57383,57386,0,3,0
16413,4,1,57387,57387,57388,0,1,1
16414,2,3,57389,57389,57392,0,3,1
16415,2,3,57391,57392,57395,1,4,0
16416,3,2,57394,57395,57397,1,3,0
16417,4,2,57398,57398,57400,0,2,1
16418,2,3,57400,57400,57403,0,3,0
16419,6,2,57406,57406,57408,0,2,3
16420,1,1,57407,57408,57409,1,2,0
16421,5,3,57412,57412,57415,0,3,3
16422,4,2,57416,57416,57418,0,2,1
16423,6,1,57422,57422,57423,0,1,4
16424,4,3,57426,57426,57429,0,3,3
16425,4,3,57430,57430,57433,0,3,1
16426,5,1,57435,57435,57436,0,1,2
16427,4,1,57439,57439,57440,0,1,3
16428,5,3,57444,57444,57447,0,3,4
16429,3,2,57447,57447,57449,0,2,0
16430,2,3,57449,57449,57452,0,3,0
16431,2,3,57451,57452,57455,1,4,0
16432,2,2,57453,57455,57457,2,4,0
16433,3,1,57456,57457,57458,1,2,0
16434,1,2,57457,57458,57460,1,3,0
16435,2,1,57459,57460,57461,1,2,0
16436,1,3,57460,57461,57464,1,4,0
16437,5,3,57465,57465,57468,0,3,1
16438,3,3,57468,57468,57471,0,3,0
16439,4,1,57472,57472,57473,0,1,1
16440,1,3,57473,57473,57476,0,3,0
16441,6,3,57479,57479,57482,0,3,3
16442,6,3,57485,57485,57488,0,3,3
16443,1,2,57486,57488,57490,2,4,0
16444,3,3,57489,57490,57493,1,4,0
16445,6,1,57495,57495,57496,0,1,2
16446,1,3,57496,57496,57499,0,3,0
16447,4,1,57500,57500,57501,0,1,1
16448,2,1,57502,57502,57503,0,1,1
16449,6,1,57508,57508,57509,0,1,5
16450,3,2,57511,57511,57513,0,2,2
16451,2,2,57513,57513,57515,0,2,0
16452,1,3,57514,57515,57518,1,4,0
16453,4,1,57518,57518,57519,0,1,0
16454,2,1,57520,57520,57521,0,1,1
16455,1,1,57521,57521,57522,0,1,0
16456,3,3,57524,57524,57527,0,3,2
16457,1,3,57525,57527,57530,2,5,0
16458,4,1,57529,57530,57531,1,2,0
16459,3,1,57532,57532,57533,0,1,1
16460,1,2,57533,57533,57535,0,2,0
16461,4,1,57537,57537,57538,0,1,2
16462,1,2,57538,57538,57540,0,2,0
16463,1,3,57539,57540,57543,1,4,0
16464,1,3,57540,57543,57546,3,6,0
16465,2,2,57542,57546,57548,4,6,0
16466,3,1,57545,57548,57549,3,4,0
16467,5,1,57550,57550,57551,0,1,1
16468,4,3,57554,57554,57557,0,3,3
16469,6,2,57560,57560,57562,0,2,3
16470,5,3,57565,57565,57568,0,3,3
16471,4,2,57569,57569,57571,0,2,1
16472,1,3,57570,57571,57574,1,4,0
16473,6,1,57576,57576,57577,0,1,2
16474,4,2,57580,57580,57582,0,2,3
16475,6,1,57586,57586,57587,0,1,4
16476,1,2,57587,57587,57589,0,2,0
16477,6,2,57593,57593,57595,0,2,4
16478,2,2,57595,57595,57597,0,2,0
16479,3,3,57598,57598,57601,0,3,1
16480,3,1,57601,57601,57602,0,1,0
16481,4,1,57605,57605,57606,0,1,3
16482,4,1,57609,57609,57610,0,1,3
16483,4,2,57613,57613,57615,0,2,3
16484,4,3,57617,57617,57620,0,3,2
16485,3,1,57620,57620,57621,0,1,0
16486,2,2,57622,57622,57624,0,2,1
16487,6,2,57628,57628,57630,0,2,4
16488,6,1,57634,57634,57635,0,1,4
16489,4,3,57638,57638,57641,0,3,3
16490,5,3,57643,57643,57646,0,3,2
16491,6,2,57649,57649,57651,0,2,3
16492,1,2,57650,57651,57653,1,3,0
16493,3,3,57653,57653,57656,0,3,0
16494,4,1,57657,57657,57658,0,1,1
16495,4,3,57661,57661,57664,0,3,3
16496,6,1,57667,57667,57668,0,1,3
16497,5,1,57672,57672,57673,0,1,4
16498,5,3,57677,57677,57680,0,3,4
16499,2,3,57679,57680,57683,1,4,0
16500,6,2,57685,57685,57687,0,2,2
16501,5,3,57690,57690,57693,0,3,3
16502,1,2,57691,57693,57695,2,4,0
16503,2,2,57693,57695,57697,2,4,0
16504,1,3,57694,57697,57700,3,6,0
16505,6,3,57700,57700,57703,0,3,0
16506,4,2,57704,57704,57706,0,2,1
16507,3,2,57707,57707,57709,0,2,1
16508,2,2,57709,57709,57711,0,2,0
16509,3,1,57712,57712,57713,0,1,1
16510,4,3,57716,57716,57719,0,3,3
16511,4,1,57720,57720,57721,0,1,1
16512,6,3,57726,57726,57729,0,3,5
16513,1,1,57727,57729,57730,2,3,0
16514,2,1,57729,57730,57731,1,2,0
16515,4,3,57733,57733,57736,0,3,2
16516,2,1,57735,57736,57737,1,2,0
16517,4,3,57739,57739,57742,0,3,2
16518,1,1,57740,57742,57743,2,3,0
16519,3,1,57743,57743,57744,0,1,0
16520,4,1,57747,57747,57748,0,1,3
16521,3,3,57750,57750,57753,0,3,2
16522,3,2,57753,57753,57755,0,2,0
16523,4,3,57757,57757,57760,0,3,2
16524,3,3,57760,57760,57763,0,3,0
16525,3,1,57763,57763,57764,0,1,0
16526,2,1,57765,57765,57766,0,1,1
16527,4,3,57769,57769,57772,0,3,3
16528,1,2,57770,57772,57774,2,4,0
16529,2,3,57772,57774,57777,2,5,0
16530,1,2,57773,57777,57779,4,6,0
16531,2,3,57775,57779,57782,4,7,0
16532,2,3,57777,57782,57785,5,8,0
16533,1,1,57778,57785,57786,7,8,0
16534,6,1,57784,57786,57787,2,3,0
16535,3,1,57787,57787,57788,0,1,0
16536,1,2,57788,57788,57790,0,2,0
16537,2,3,57790,57790,57793,0,3,0
16538,2,3,57792,57793,57796,1,4,0
16539,5,3,57797,57797,57800,0,3,1
16540,6,1,57803,57803,57804,0,1,3
16541,4,2,57807,57807,57809,0,2,3
16542,5,1,57812,57812,57813,0,1,3
16543,1,1,57813,57813,57814,0,1,0
16544,6,1,57819,57819,57820,0,1,5
16545,1,3,57820,57820,57823,0,3,0
16546,6,3,57826,57826,57829,0,3,3
16547,1,3,57827,57829,57832,2,5,0
16548,2,1,57829,57832,57833,3,4,0
16549,1,1,57830,57833,57834,3,4,0
16550,2,2,57832,57834,57836,2,4,0
16551,5,2,57837,57837,57839,0,2,1
16552,4,2,57841,57841,57843,0,2,2
16553,2,2,57843,57843,57845,0,2,0
16554,5,3,57848,57848,57851,0,3,3
16555,2,3,57850,57851,57854,1,4,0
16556,6,2,57856,57856,57858,0,2,2
16557,6,3,57862,57862,57865,0,3,4
16558,4,2,57866,57866,57868,0,2,1
16559,2,2,57868,57868,57870,0,2,0
16560,4,2,57872,57872,57874,0,2,2
16561,3,2,57875,57875,57877,0,2,1
16562,4,1,57879,57879,57880,0,1,2
16563,3,1,57882,57882,57883,0,1,2
16564,6,1,57888,57888,57889,0,1,5
16565,1,2,57889,57889,57891,0,2,0
16566,2,2,57891,57891,57893,0,2,0
16567,2,1,57893,57893,57894,0,1,0
16568,5,3,57898,57898,57901,0,3,4
16569,6,1,57904,57904,57905,0,1,3
16570,3,1,57907,57907,57908,0,1,2
16571,6,3,57913,57913,57916,0,3,5
16572,6,3,57919,57919,57922,0,3,3
16573,5,2,57924,57924,57926,0,2,2
16574,2,2,57926,57926,57928,0,2,0
16575,6,1,57932,57932,57933,0,1,4
16576,4,3,57936,57936,57939,0,3,3
16577,3,2,57939,57939,57941,0,2,0
16578,1,3,57940,57941,57944,1,4,0
16579,5,3,57945,57945,57948,0,3,1
16580,3,1,57948,57948,57949,0,1,0
16581,2,2,57950,57950,57952,0,2,1
16582,3,2,57953,57953,57955,0,2,1
16583,4,3,57957,57957,57960,0,3,2
16584,4,2,57961,57961,57963,0,2,1
16585,1,3,57962,57963,57966,1,4,0
16586,5,3,57967,57967,57970,0,3,1
16587,4,1,57971,57971,57972,0,1,1
16588,4,2,57975,57975,57977,0,2,3
16589,4,1,57979,57979,57980,0,1,2
16590,4,2,57983,57983,57985,0,2,3
16591,5,3,57988,57988,57991,0,3,3
16592,5,3,57993,57993,57996,0,3,2
16593,1,2,57994,57996,57998,2,4,0
16594,6,1,58000,58000,58001,0,1,2
16595,5,1,58005,58005,58006,0,1,4
16596,3,3,58008,58008,58011,0,3,2
16597,3,1,58011,58011,58012,0,1,0
16598,3,1,58014,58014,58015,0,1,2
16599,5,2,58019,58019,58021,0,2,4
16600,6,2,58025,58025,58027,0,2,4
16601,3,3,58028,58028,58031,0,3,1
16602,2,3,58030,58031,58034,1,4,0
16603,4,2,58034,58034,58036,0,2,0
16604,4,1,58038,58038,58039,0,1,2
16605,4,2,58042,58042,58044,0,2,3
16606,5,2,58047,58047,58049,0,2,3
16607,4,2,58051,58051,58053,0,2,2
16608,1,1,58052,58053,58054,1,2,0
16609,5,1,58057,58057,58058,0,1,3
16610,5,1,58062,58062,58063,0,1,4
16611,3,1,58065,58065,58066,0,1,2
16612,3,1,58068,58068,58069,0,1,2
16613,3,1,58071,58071,58072,0,1,2
16614,5,2,58076,58076,58078,0,2,4
16615,6,2,58082,58082,58084,0,2,4
16616,1,2,58083,58084,58086,1,3,0
16617,1,2,58084,58086,58088,2,4,0
16618,3,2,58087,58088,58090,1,3,0
16619,2,3,58089,58090,58093,1,4,0
16620,5,2,58094,58094,58096,0,2,1
16621,3,1,58097,58097,58098,0,1,1
16622,5,1,58102,58102,58103,0,1,4
16623,5,3,58107,58107,58110,0,3,4
16624,2,1,58109,58110,58111,1,2,0
16625,3,3,58112,58112,58115,0,3,1
16626,2,1,58114,58115,58116,1,2,0
16627,3,1,58117,58117,58118,0,1,1
16628,2,3,58119,58119,58122,0,3,1
16629,2,1,58121,58122,58123,1,2,0
16630,2,3,58123,58123,58126,0,3,0
16631,1,1,58124,58126,58127,2,3,0
16632,4,1,58128,58128,58129,0,1,1
16633,1,2,58129,58129,58131,0,2,0
16634,1,1,58130,58131,58132,1,2,0
16635,5,3,58135,58135,58138,0,3,3
16636,1,2,58136,58138,58140,2,4,0
16637,1,1,58137,58140,58141,3,4,0
16638,4,2,58141,58141,58143,0,2,0
16639,1,3,58142,58143,58146,1,4,0
16640,4,2,58146,58146,58148,0,2,0
16641,6,1,58152,58152,58153,0,1,4
16642,6,1,58158,58158,58159,0,1,5
16643,6,1,58164,58164,58165,0,1,5
16644,5,1,58169,58169,58170,0,1,4
16645,6,1,58175,58175,58176,0,1,5
16646,6,3,58181,58181,58184,0,3,5
16647,6,2,58187,58187,58189,0,2,3
16648,4,3,58191,58191,58194,0,3,2
16649,2,2,58193,58194,58196,1,3,0
16650,4,1,58197,58197,58198,0,1,1
16651,3,1,58200,58200,58201,0,1,2
16652,2,3,58202,58202,58205,0,3,1
16653,2,2,58204,58205,58207,1,3,0
16654,4,3,58208,58208,58211,0,3,1
16655,6,3,58214,58214,58217,0,3,3
16656,5,1,58219,58219,58220,0,1,2
16657,5,3,58224,58224,58227,0,3,4
16658,1,3,58225,58227,58230,2,5,0
16659,6,1,58231,58231,58232,0,1,1
16660,5,1,58236,58236,58237,0,1,4
16661,5,1,58241,58241,58242,0,1,4
16662,2,3,58243,58243,58246,0,3,1
16663,5,1,58248,58248,58249,0,1,2
16664,5,3,58253,58253,58256,0,3,4
16665,5,1,58258,58258,58259,0,1,2
16666,2,1,58260,58260,58261,0,1,1
16667,2,3,58262,58262,58265,0,3,1
16668,2,1,58264,58265,58266,1,2,0
16669,4,1,58268,58268,58269,0,1,2
16670,2,3,58270,58270,58273,0,3,1
16671,3,1,58273,58273,58274,0,1,0
16672,3,1,58276,58276,58277,0,1,2
16673,5,1,58281,58281,58282,0,1,4
16674,2,2,58283,58283,58285,0,2,1
16675,3,2,58286,58286,58288,0,2,1
16676,5,3,58291,58291,58294,0,3,3
16677,2,2,58293,58294,58296,1,3,0
16678,1,1,58294,58296,58297,2,3,0
16679,3,2,58297,58297,58299,0,2,0
16680,6,3,58303,58303,58306,0,3,4
16681,5,3,58308,58308,58311,0,3,2
16682,2,1,58310,58311,58312,1,2,0
16683,1,2,58311,58312,58314,1,3,0
16684,3,3,58314,58314,58317,0,3,0
16685,2,3,58316,58317,58320,1,4,0
16686,6,1,58322,58322,58323,0,1,2
16687,4,2,58326,58326,58328,0,2,3
16688,1,1,58327,58328,58329,1,2,0
16689,4,1,58331,58331,58332,0,1,2
16690,4,1,58335,58335,58336,0,1,3
16691,3,2,58338,58338,58340,0,2,2
16692,2,3,58340,58340,58343,0,3,0
16693,2,3,58342,58343,58346,1,4,0
16694,3,3,58345,58346,58349,1,4,0
16695,4,3,58349,58349,58352,0,3,0
16696,5,1,58354,58354,58355,0,1,2
16697,2,1,58356,58356,58357,0,1,1
16698,2,2,58358,58358,58360,0,2,1
16699,6,2,58364,58364,58366,0,2,4
16700,5,1,58369,58369,58370,0,1,3
16701,2,1,58371,58371,58372,0,1,1
16702,2,3,58373,58373,58376,0,3,1
16703,3,1,58376,58376,58377,0,1,0
16704,3,1,58379,58379,58380,0,1,2
16705,2,2,58381,58381,58383,0,2,1
16706,2,1,58383,58383,58384,0,1,0
16707,5,3,58388,58388,58391,0,3,4
16708,4,3,58392,58392,58395,0,3,1
16709,6,1,58398,58398,58399,0,1,3
16710,1,1,58399,58399,58400,0,1,0
16711,3,2,58402,58402,58404,0,2,2
16712,6,2,58408,58408,58410,0,2,4
16713,1,1,58409,58410,58411,1,2,0
16714,4,3,58413,58413,58416,0,3,2
16715,5,1,58418,58418,58419,0,1,2
16716,6,2,58424,58424,58426,0,2,5
16717,6,2,58430,58430,58432,0,2,4
16718,4,1,58434,58434,58435,0,1,2
16719,2,1,58436,58436,58437,0,1,1
16720,5,1,58441,58441,58442,0,1,4
16721,4,2,58445,58445,58447,0,2,3
16722,5,2,58450,58450,58452,0,2,3
16723,3,2,58453,58453,58455,0,2,1
16724,4,1,58457,58457,58458,0,1,2
16725,5,1,58462,58462,58463,0,1,4
16726,2,2,58464,58464,58466,0,2,1
16727,4,3,58468,58468,58471,0,3,2
16728,2,2,58470,58471,58473,1,3,0
16729,2,2,58472,58473,58475,1,3,0
16730,2,3,58474,58475,58478,1,4,0
16731,4,1,58478,58478,58479,0,1,0
16732,4,1,58482,58482,58483,0,1,3
16733,2,2,58484,58484,58486,0,2,1
16734,4,2,58488,58488,58490,0,2,2
16735,2,3,58490,58490,58493,0,3,0
16736,2,3,58492,58493,58496,1,4,0
16737,2,3,58494,58496,58499,2,5,0
16738,2,3,58496,58499,58502,3,6,0
16739,4,1,58500,58502,58503,2,3,0
16740,2,1,58502,58503,58504,1,2,0
16741,4,2,58506,58506,58508,0,2,2
16742,5,2,58511,58511,58513,0,2,3
16743,3,1,58514,58514,58515,0,1,1
16744,2,3,58516,58516,58519,0,3,1
16745,2,1,58518,58519,58520,1,2,0
16746,5,1,58523,58523,58524,0,1,3
16747,5,1,58528,58528,58529,0,1,4
16748,5,1,58533,58533,58534,0,1,4
16749,3,1,58536,58536,58537,0,1,2
16750,3,2,58539,58539,58541,0,2,2
16751,6,2,58545,58545,58547,0,2,4
16752,3,3,58548,58548,58551,0,3,1
16753,3,2,58551,58551,58553,0,2,0
16754,2,1,58553,58553,58554,0,1,0
16755,5,3,58558,58558,58561,0,3,4
16756,4,1,58562,58562,58563,0,1,1
16757,4,3,58566,58566,58569,0,3,3
16758,2,2,58568,58569,58571,1,3,0
16759,6,3,58574,58574,58577,0,3,3
16760,3,3,58577,58577,58580,0,3,0
16761,3,3,58580,58580,58583,0,3,0
16762,3,3,58583,58583,58586,0,3,0
16763,6,1,58589,58589,58590,0,1,3
16764,1,2,58590,58590,58592,0,2,0
16765,1,2,58591,58592,58594,1,3,0
16766,4,2,58595,58595,58597,0,2,1
16767,3,2,58598,58598,58600,0,2,1
16768,6,2,58604,58604,58606,0,2,4
16769,2,3,58606,58606,58609,0,3,0
16770,3,2,58609,58609,58611,0,2,0
16771,2,2,58611,58611,58613,0,2,0
16772,1,1,58612,58613,58614,1,2,0
16773,6,3,58618,58618,58621,0,3,4
16774,4,3,58622,58622,58625,0,3,1
16775,3,3,58625,58625,58628,0,3,0
16776,3,2,58628,58628,58630,0,2,0
16777,2,2,58630,58630,58632,0,2,0
16778,5,2,58635,58635,58637,0,2,3
16779,2,2,58637,58637,58639,0,2,0
16780,3,3,58640,58640,58643,0,3,1
16781,6,2,58646,58646,58648,0,2,3
16782,4,2,58650,58650,58652,0,2,2
16783,1,1,58651,58652,58653,1,2,0
16784,2,1,58653,58653,58654,0,1,0
16785,2,1,58655,58655,58656,0,1,1
16786,3,3,58658,58658,58661,0,3,2
16787,4,2,58662,58662,58664,0,2,1
16788,5,2,58667,58667,58669,0,2,3
16789,2,2,58669,58669,58671,0,2,0
16790,1,1,58670,58671,58672,1,2,0
16791,3,3,58673,58673,58676,0,3,1
16792,1,2,58674,58676,58678,2,4,0
16793,5,3,58679,58679,58682,0,3,1
16794,1,3,58680,58682,58685,2,5,0
16795,2,3,58682,58685,58688,3,6,0
16796,1,3,58683,58688,58691,5,8,0
16797,5,1,58688,58691,58692,3,4,0
16798,2,3,58690,58692,58695,2,5,0
16799,6,3,58696,58696,58699,0,3,1
16800,2,2,58698,58699,58701,1,3,0
16801,4,3,58702,58702,58705,0,3,1
16802,5,2,58707,58707,58709,0,2,2
16803,1,1,58708,58709,58710,1,2,0
16804,4,3,58712,58712,58715,0,3,2
16805,1,3,58713,58715,58718,2,5,0
16806,6,3,58719,58719,58722,0,3,1
16807,3,1,58722,58722,58723,0,1,0
16808,5,3,58727,58727,58730,0,3,4
16809,5,1,58732,58732,58733,0,1,2
16810,4,2,58736,58736,58738,0,2,3
16811,5,2,58741,58741,58743,0,2,3
16812,3,2,58744,58744,58746,0,2,1
16813,3,3,58747,58747,58750,0,3,1
16814,6,3,58753,58753,58756,0,3,3
16815,5,2,58758,58758,58760,0,2,2
16816,1,2,58759,58760,58762,1,3,0
16817,3,3,58762,58762,58765,0,3,0
16818,5,2,58767,58767,58769,0,2,2
16819,3,3,58770,58770,58773,0,3,1
16820,5,2,58775,58775,58777,0,2,2
16821,4,3,58779,58779,58782,0,3,2
16822,5,2,58784,58784,58786,0,2,2
16823,6,3,58790,58790,58793,0,3,4
16824,5,1,58795,58795,58796,0,1,2
16825,6,2,58801,58801,58803,0,2,5
16826,1,3,58802,58803,58806,1,4,0
16827,4,1,58806,58806,58807,0,1,0
16828,3,2,58809,58809,58811,0,2,2
16829,6,2,58815,58815,58817,0,2,4
16830,2,3,58817,58817,58820,0,3,0
16831,4,1,58821,58821,58822,0,1,1
16832,6,3,58827,58827,58830,0,3,5
16833,1,2,58828,58830,58832,2,4,0
16834,2,2,58830,58832,58834,2,4,0
16835,3,1,58833,58834,58835,1,2,0
16836,4,1,58837,58837,58838,0,1,2
16837,6,1,58843,58843,58844,0,1,5
16838,5,2,58848,58848,58850,0,2,4
16839,4,2,58852,58852,58854,0,2,2
16840,1,3,58853,58854,58857,1,4,0
16841,4,3,58857,58857,58860,0,3,0
16842,4,2,58861,58861,58863,0,2,1
16843,3,2,58864,58864,58866,0,2,1
16844,4,2,58868,58868,58870,0,2,2
16845,5,2,58873,58873,58875,0,2,3
16846,6,1,58879,58879,58880,0,1,4
16847,6,1,58885,58885,58886,0,1,5
16848,4,2,58889,58889,58891,0,2,3
16849,2,2,58891,58891,58893,0,2,0
16850,2,2,58893,58893,58895,0,2,0
16851,3,1,58896,58896,58897,0,1,1
16852,3,3,58899,58899,58902,0,3,2
16853,2,2,58901,58902,58904,1,3,0
16854,5,1,58906,58906,58907,0,1,2
16855,1,1,58907,58907,58908,0,1,0
16856,6,2,58913,58913,58915,0,2,5
16857,4,2,58917,58917,58919,0,2,2
16858,2,1,58919,58919,58920,0,1,0
16859,3,1,58922,58922,58923,0,1,2
16860,6,1,58928,58928,58929,0,1,5
16861,4,3,58932,58932,58935,0,3,3
16862,4,1,58936,58936,58937,0,1,1
16863,2,3,58938,58938,58941,0,3,1
16864,6,3,58944,58944,58947,0,3,3
16865,2,2,58946,58947,58949,1,3,0
16866,4,1,58950,58950,58951,0,1,1
16867,1,3,58951,58951,58954,0,3,0
16868,6,2,58957,58957,58959,0,2,3
16869,4,1,58961,58961,58962,0,1,2
16870,4,1,58965,58965,58966,0,1,3
16871,3,3,58968,58968,58971,0,3,2
16872,2,3,58970,58971,58974,1,4,0
16873,4,3,58974,58974,58977,0,3,0
16874,3,2,58977,58977,58979,0,2,0
16875,5,3,58982,58982,58985,0,3,3
16876,4,1,58986,58986,58987,0,1,1
16877,1,1,58987,58987,58988,0,1,0
16878,3,1,58990,58990,58991,0,1,2
16879,2,3,58992,58992,58995,0,3,1
16880,1,1,58993,58995,58996,2,3,0
16881,1,1,58994,58996,58997,2,3,0
16882,3,1,58997,58997,58998,0,1,0
16883,6,3,59003,59003,59006,0,3,5
16884,4,2,59007,59007,59009,0,2,1
16885,1,3,59008,59009,59012,1,4,0
16886,4,3,59012,59012,59015,0,3,0
16887,1,2,59013,59015,59017,2,4,0
16888,1,2,59014,59017,59019,3,5,0
16889,2,2,59016,59019,59021,3,5,0
16890,3,1,59019,59021,59022,2,3,0
16891,5,2,59024,59024,59026,0,2,2
16892,4,2,59028,59028,59030,0,2,2
16893,3,2,59031,59031,59033,0,2,1
16894,1,1,59032,59033,59034,1,2,0
16895,3,1,59035,59035,59036,0,1,1
16896,4,3,59039,59039,59042,0,3,3
16897,2,1,59041,59042,59043,1,2,0
16898,6,3,59047,59047,59050,0,3,4
16899,4,1,59051,59051,59052,0,1,1
16900,5,2,59056,59056,59058,0,2,4
16901,6,3,59062,59062,59065,0,3,4
16902,2,3,59064,59065,59068,1,4,0
16903,5,3,59069,59069,59072,0,3,1
16904,6,1,59075,59075,59076,0,1,3
16905,2,1,59077,59077,59078,0,1,1
16906,2,2,59079,59079,59081,0,2,1
16907,2,1,59081,59081,59082,0,1,0
16908,6,3,59087,59087,59090,0,3,5
16909,4,3,59091,59091,59094,0,3,1
16910,1,3,59092,59094,59097,2,5,0
16911,2,2,59094,59097,59099,3,5,0
16912,5,3,59099,59099,59102,0,3,0
16913,1,3,59100,59102,59105,2,5,0
16914,3,3,59103,59105,59108,2,5,0
16915,6,2,59109,59109,59111,0,2,1
16916,5,3,59114,59114,59117,0,3,3
16917,4,1,59118,59118,59119,0,1,1
16918,3,2,59121,59121,59123,0,2,2
16919,2,1,59123,59123,59124,0,1,0
16920,1,2,59124,59124,59126,0,2,0
16921,5,1,59129,59129,59130,0,1,3
16922,4,2,59133,59133,59135,0,2,3
16923,3,2,59136,59136,59138,0,2,1
16924,5,2,59141,59141,59143,0,2,3
16925,3,3,59144,59144,59147,0,3,1
16926,6,2,59150,59150,59152,0,2,3
16927,6,3,59156,59156,59159,0,3,4
16928,1,2,59157,59159,59161,2,4,0
16929,3,3,59160,59161,59164,1,4,0
16930,1,3,59161,59164,59167,3,6,0
16931,5,3,59166,59167,59170,1,4,0
16932,3,1,59169,59170,59171,1,2,0
16933,5,2,59174,59174,59176,0,2,3
16934,2,3,59176,59176,59179,0,3,0
16935,6,3,59182,59182,59185,0,3,3
16936,1,2,59183,59185,59187,2,4,0
16937,6,1,59189,59189,59190,0,1,2
16938,6,3,59195,59195,59198,0,3,5
16939,1,2,59196,59198,59200,2,4,0
16940,6,3,59202,59202,59205,0,3,2
16941,5,2,59207,59207,59209,0,2,2
16942,5,2,59212,59212,59214,0,2,3
16943,2,3,59214,59214,59217,0,3,0
16944,1,3,59215,59217,59220,2,5,0
16945,5,3,59220,59220,59223,0,3,0
16946,1,2,59221,59223,59225,2,4,0
16947,1,1,59222,59225,59226,3,4,0
16948,4,1,59226,59226,59227,0,1,0
16949,1,3,59227,59227,59230,0,3,0
16950,4,1,59231,59231,59232,0,1,1
16951,5,2,59236,59236,59238,0,2,4
16952,4,3,59240,59240,59243,0,3,2
16953,1,3,59241,59243,59246,2,5,0
16954,3,1,59244,59246,59247,2,3,0
16955,1,2,59245,59247,59249,2,4,0
16956,3,1,59248,59249,59250,1,2,0
16957,2,3,59250,59250,59253,0,3,0
16958,4,3,59254,59254,59257,0,3,1
16959,5,2,59259,59259,59261,0,2,2
16960,2,3,59261,59261,59264,0,3,0
16961,4,2,59265,59265,59267,0,2,1
16962,3,1,59268,59268,59269,0,1,1
16963,2,3,59270,59270,59273,0,3,1
16964,1,2,59271,59273,59275,2,4,0
16965,3,3,59274,59275,59278,1,4,0
16966,3,1,59277,59278,59279,1,2,0
16967,3,1,59280,59280,59281,0,1,1
16968,5,3,59285,59285,59288,0,3,4
16969,5,1,59290,59290,59291,0,1,2
16970,2,3,59292,59292,59295,0,3,1
16971,4,3,59296,59296,59299,0,3,1
16972,2,2,59298,59299,59301,1,3,0
16973,1,2,59299,59301,59303,2,4,0
16974,4,3,59303,59303,59306,0,3,0
16975,3,2,59306,59306,59308,0,2,0
16976,6,3,59312,59312,59315,0,3,4
16977,3,3,59315,59315,59318,0,3,0
16978,5,3,59320,59320,59323,0,3,2
16979,4,1,59324,59324,59325,0,1,1
16980,6,3,59330,59330,59333,0,3,5
16981,2,2,59332,59333,59335,1,3,0
16982,1,1,59333,59335,59336,2,3,0
16983,6,2,59339,59339,59341,0,2,3
16984,3,1,59342,59342,59343,0,1,1
16985,1,1,59343,59343,59344,0,1,0
16986,3,1,59346,59346,59347,0,1,2
16987,6,2,59352,59352,59354,0,2,5
16988,2,1,59354,59354,59355,0,1,0
16989,1,1,59355,59355,59356,0,1,0
16990,1,1,59356,59356,59357,0,1,0
16991,6,3,59362,59362,59365,0,3,5
16992,5,3,59367,59367,59370,0,3,2
16993,1,3,59368,59370,59373,2,5,0
16994,2,3,59370,59373,59376,3,6,0
16995,3,2,59373,59376,59378,3,5,0
16996,5,2,59378,59378,59380,0,2,0
16997,4,3,59382,59382,59385,0,3,2
16998,6,1,59388,59388,59389,0,1,3
16999,6,3,59394,59394,59397,0,3,5
17000,4,3,59398,59398,59401,0,3,1
17001,2,2,59400,59401,59403,1,3,0
17002,2,3,59402,59403,59406,1,4,0
17003,5,3,59407,59407,59410,0,3,1
17004,4,2,59411,59411,59413,0,2,1
17005,3,2,59414,59414,59416,0,2,1
17006,4,2,59418,59418,59420,0,2,2
17007,3,2,59421,59421,59423,0,2,1
17008,6,3,59427,59427,59430,0,3,4
17009,6,2,59433,59433,59435,0,2,3
17010,2,1,59435,59435,59436,0,1,0
17011,1,2,59436,59436,59438,0,2,0
17012,5,2,59441,59441,59443,0,2,3
17013,3,1,59444,59444,59445,0,1,1
17014,6,1,59450,59450,59451,0,1,5
17015,5,1,59455,59455,59456,0,1,4
17016,4,1,59459,59459,59460,0,1,3
17017,6,1,59465,59465,59466,0,1,5
17018,5,2,59470,59470,59472,0,2,4
17019,2,1,59472,59472,59473,0,1,0
17020,4,3,59476,59476,59479,0,3,3
17021,3,3,59479,59479,59482,0,3,0
17022,1,2,59480,59482,59484,2,4,0
17023,1,2,59481,59484,59486,3,5,0
17024,6,3,59487,59487,59490,0,3,1
17025,4,3,59491,59491,59494,0,3,1
17026,5,2,59496,59496,59498,0,2,2
17027,3,3,59499,59499,59502,0,3,1
17028,3,3,59502,59502,59505,0,3,0
17029,2,3,59504,59505,59508,1,4,0
17030,1,3,59505,59508,59511,3,6,0
17031,5,2,59510,59511,59513,1,3,0
17032,2,1,59512,59513,59514,1,2,0
17033,6,1,59518,59518,59519,0,1,4
17034,6,3,59524,59524,59527,0,3,5
17035,6,1,59530,59530,59531,0,1,3
17036,4,2,59534,59534,59536,0,2,3
17037,4,2,59538,59538,59540,0,2,2
17038,6,2,59544,59544,59546,0,2,4
17039,1,2,59545,59546,59548,1,3,0
17040,4,3,59549,59549,59552,0,3,1
17041,2,3,59551,59552,59555,1,4,0
17042,5,3,59556,59556,59559,0,3,1
17043,4,2,59560,59560,59562,0,2,1
17044,6,3,59566,59566,59569,0,3,4
17045,5,3,59571,59571,59574,0,3,2
17046,4,2,59575,59575,59577,0,2,1
17047,6,2,59581,59581,59583,0,2,4
17048,3,2,59584,59584,59586,0,2,1
17049,6,1,59590,59590,59591,0,1,4
17050,3,2,59593,59593,59595,0,2,2
17051,6,2,59599,59599,59601,0,2,4
17052,6,1,59605,59605,59606,0,1,4
17053,5,2,59610,59610,59612,0,2,4
17054,2,3,59612,59612,59615,0,3,0
17055,6,3,59618,59618,59621,0,3,3
17056,2,2,59620,59621,59623,1,3,0
17057,4,2,59624,59624,59626,0,2,1
17058,4,1,59628,59628,59629,0,1,2
17059,6,3,59634,59634,59637,0,3,5
17060,2,1,59636,59637,59638,1,2,0
17061,5,1,59641,59641,59642,0,1,3
17062,6,1,59647,59647,59648,0,1,5
17063,3,1,59650,59650,59651,0,1,2
17064,4,3,59654,59654,59657,0,3,3
17065,3,1,59657,59657,59658,0,1,0
17066,2,2,59659,59659,59661,0,2,1
17067,1,1,59660,59661,59662,1,2,0
17068,3,3,59663,59663,59666,0,3,1
17069,3,1,59666,59666,59667,0,1,0
17070,5,3,59671,59671,59674,0,3,4
17071,2,2,59673,59674,59676,1,3,0
17072,2,2,59675,59676,59678,1,3,0
17073,1,2,59676,59678,59680,2,4,0
17074,5,1,59681,59681,59682,0,1,1
17075,3,2,59684,59684,59686,0,2,2
17076,1,1,59685,59686,59687,1,2,0
17077,2,3,59687,59687,59690,0,3,0
17078,6,2,59693,59693,59695,0,2,3
17079,3,2,59696,59696,59698,0,2,1
17080,4,2,59700,59700,59702,0,2,2
17081,3,1,59703,59703,59704,0,1,1
17082,4,3,59707,59707,59710,0,3,3
17083,5,1,59712,59712,59713,0,1,2
17084,1,3,59713,59713,59716,0,3,0
17085,3,2,59716,59716,59718,0,2,0
17086,2,3,59718,59718,59721,0,3,0
17087,4,3,59722,59722,59725,0,3,1
17088,3,3,59725,59725,59728,0,3,0
17089,2,2,59727,59728,59730,1,3,0
17090,5,2,59732,59732,59734,0,2,2
17091,4,2,59736,59736,59738,0,2,2
17092,4,2,59740,59740,59742,0,2,2
17093,5,2,59745,59745,59747,0,2,3
17094,6,2,59751,59751,59753,0,2,4
17095,1,1,59752,59753,59754,1,2,0
17096,6,1,59758,59758,59759,0,1,4
17097,4,2,59762,59762,59764,0,2,3
17098,1,1,59763,59764,59765,1,2,0
17099,5,2,59768,59768,59770,0,2,3
17100,5,3,59773,59773,59776,0,3,3
17101,4,1,59777,59777,59778,0,1,1
17102,5,1,59782,59782,59783,0,1,4
17103,3,3,59785,59785,59788,0,3,2
17104,6,1,59791,59791,59792,0,1,3
17105,3,2,59794,59794,59796,0,2,2
17106,4,2,59798,59798,59800,0,2,2
17107,1,3,59799,59800,59803,1,4,0
17108,4,2,59803,59803,59805,0,2,0
17109,3,1,59806,59806,59807,0,1,1
17110,4,2,59810,59810,59812,0,2,3
17111,2,2,59812,59812,59814,0,2,0
17112,1,1,59813,59814,59815,1,2,0
17113,4,3,59817,59817,59820,0,3,2
17114,5,2,59822,59822,59824,0,2,2
17115,1,3,59823,59824,59827,1,4,0
17116,4,1,59827,59827,59828,0,1,0
17117,6,1,59833,59833,59834,0,1,5
17118,2,2,59835,59835,59837,0,2,1
17119,2,2,59837,59837,59839,0,2,0
17120,5,3,59842,59842,59845,0,3,3
17121,4,2,59846,59846,59848,0,2,1
17122,3,2,59849,59849,59851,0,2,1
17123,2,2,59851,59851,59853,0,2,0
17124,5,2,59856,59856,59858,0,2,3
17125,4,2,59860,59860,59862,0,2,2
17126,3,1,59863,59863,59864,0,1,1
17127,2,2,59865,59865,59867,0,2,1
17128,3,3,59868,59868,59871,0,3,1
17129,3,3,59871,59871,59874,0,3,0
17130,5,1,59876,59876,59877,0,1,2
17131,6,2,59882,59882,59884,0,2,5
17132,2,2,59884,59884,59886,0,2,0
17133,5,1,59889,59889,59890,0,1,3
17134,6,2,59895,59895,59897,0,2,5
17135,3,2,59898,59898,59900,0,2,1
17136,6,3,59904,59904,59907,0,3,4
17137,4,1,59908,59908,59909,0,1,1
17138,1,2,59909,59909,59911,0,2,0
17139,1,1,59910,59911,59912,1,2,0
17140,2,3,59912,59912,59915,0,3,0
17141,3,1,59915,59915,59916,0,1,0
17142,3,2,59918,59918,59920,0,2,2
17143,6,2,59924,59924,59926,0,2,4
17144,1,2,59925,59926,59928,1,3,0
17145,4,2,59929,59929,59931,0,2,1
17146,2,2,59931,59931,59933,0,2,0
17147,2,1,59933,59933,59934,0,1,0
17148,1,2,59934,59934,59936,0,2,0
17149,5,3,59939,59939,59942,0,3,3
17150,1,2,59940,59942,59944,2,4,0
17151,6,3,59946,59946,59949,0,3,2
17152,3,2,59949,59949,59951,0,2,0
17153,4,1,59953,59953,59954,0,1,2
17154,1,1,59954,59954,59955,0,1,0
17155,5,3,59959,59959,59962,0,3,4
17156,6,3,59965,59965,59968,0,3,3
17157,4,2,59969,59969,59971,0,2,1
17158,1,3,59970,59971,59974,1,4,0
17159,3,1,59973,59974,59975,1,2,0
17160,2,1,59975,59975,59976,0,1,0
17161,6,2,59981,59981,59983,0,2,5
17162,2,3,59983,59983,59986,0,3,0
17163,1,1,59984,59986,59987,2,3,0
17164,5,1,59989,59989,59990,0,1,2
17165,5,3,59994,59994,59997,0,3,4
17166,3,2,59997,59997,59999,0,2,0
17167,2,1,59999,59999,60000,0,1,0
17168,4,2,60003,60003,60005,0,2,3
17169,4,3,60007,60007,60010,0,3,2
17170,5,2,60012,60012,60014,0,2,2
17171,6,2,60018,60018,60020,0,2,4
17172,1,2,60019,60020,60022,1,3,0
17173,4,1,60023,60023,60024,0,1,1
17174,6,3,60029,60029,60032,0,3,5
17175,2,1,60031,60032,60033,1,2,0
17176,1,1,60032,60033,60034,1,2,0
17177,6,1,60038,60038,60039,0,1,4
17178,4,3,60042,60042,60045,0,3,3
17179,4,1,60046,60046,60047,0,1,1
17180,5,1,60051,60051,60052,0,1,4
17181,3,1,60054,60054,60055,0,1,2
17182,5,3,60059,60059,60062,0,3,4
17183,1,1,60060,60062,60063,2,3,0
17184,6,2,60066,60066,60068,0,2,3
17185,1,1,60067,60068,60069,1,2,0
17186,6,3,60073,60073,60076,0,3,4
17187,3,2,60076,60076,60078,0,2,0
17188,6,2,60082,60082,60084,0,2,4
17189,6,2,60088,60088,60090,0,2,4
17190,4,2,60092,60092,60094,0,2,2
17191,5,1,60097,60097,60098,0,1,3
17192,1,3,60098,60098,60101,0,3,0
17193,1,2,60099,60101,60103,2,4,0
17194,3,1,60102,60103,60104,1,2,0
17195,5,1,60107,60107,60108,0,1,3
17196,2,2,60109,60109,60111,0,2,1
17197,6,1,60115,60115,60116,0,1,4
17198,5,1,60120,60120,60121,0,1,4
17199,5,3,60125,60125,60128,0,3,4
17200,3,2,60128,60128,60130,0,2,0
17201,2,3,60130,60130,60133,0,3,0
17202,5,1,60135,60135,60136,0,1,2
17203,1,1,60136,60136,60137,0,1,0
17204,3,1,60139,60139,60140,0,1,2
17205,1,2,60140,60140,60142,0,2,0
17206,4,3,60144,60144,60147,0,3,2
17207,1,2,60145,60147,60149,2,4,0
17208,6,2,60151,60151,60153,0,2,2
17209,1,2,60152,60153,60155,1,3,0
17210,4,2,60156,60156,60158,0,2,1
17211,1,3,60157,60158,60161,1,4,0
17212,1,1,60158,60161,60162,3,4,0
17213,6,1,60164,60164,60165,0,1,2
17214,3,2,60167,60167,60169,0,2,2
17215,3,3,60170,60170,60173,0,3,1
17216,2,1,60172,60173,60174,1,2,0
17217,3,2,60175,60175,60177,0,2,1
17218,5,1,60180,60180,60181,0,1,3
17219,4,1,60184,60184,60185,0,1,3
17220,1,1,60185,60185,60186,0,1,0
17221,4,3,60189,60189,60192,0,3,3
17222,5,3,60194,60194,60197,0,3,2
17223,2,2,60196,60197,60199,1,3,0
17224,1,2,60197,60199,60201,2,4,0
17225,4,2,60201,60201,60203,0,2,0
17226,5,1,60206,60206,60207,0,1,3
17227,2,2,60208,60208,60210,0,2,1
17228,1,1,60209,60210,60211,1,2,0
17229,6,3,60215,60215,60218,0,3,4
17230,6,1,60221,60221,60222,0,1,3
17231,3,1,60224,60224,60225,0,1,2
17232,5,3,60229,60229,60232,0,3,4
17233,4,2,60233,60233,60235,0,2,1
17234,5,3,60238,60238,60241,0,3,3
17235,3,2,60241,60241,60243,0,2,0
17236,5,1,60246,60246,60247,0,1,3
17237,1,1,60247,60247,60248,0,1,0
17238,3,1,60250,60250,60251,0,1,2
17239,5,2,60255,60255,60257,0,2,4
17240,2,2,60257,60257,60259,0,2,0
17241,5,2,60262,60262,60264,0,2,3
17242,3,3,60265,60265,60268,0,3,1
17243,2,3,60267,60268,60271,1,4,0
17244,4,3,60271,60271,60274,0,3,0
17245,4,2,60275,60275,60277,0,2,1
17246,6,3,60281,60281,60284,0,3,4
17247,3,3,60284,60284,60287,0,3,0
17248,2,1,60286,60287,60288,1,2,0
17249,4,3,60290,60290,60293,0,3,2
17250,4,2,60294,60294,60296,0,2,1
17251,5,2,60299,60299,60301,0,2,3
17252,1,3,60300,60301,60304,1,4,0
17253,1,2,60301,60304,60306,3,5,0
17254,4,2,60305,60306,60308,1,3,0
17255,1,1,60306,60308,60309,2,3,0
17256,1,2,60307,60309,60311,2,4,0
17257,5,3,60312,60312,60315,0,3,1
17258,6,3,60318,60318,60321,0,3,3
17259,5,2,60323,60323,60325,0,2,2
17260,5,2,60328,60328,60330,0,2,3
17261,6,2,60334,60334,60336,0,2,4
17262,2,3,60336,60336,60339,0,3,0
17263,1,3,60337,60339,60342,2,5,0
17264,3,2,60340,60342,60344,2,4,0
17265,1,1,60341,60344,60345,3,4,0
17266,1,2,60342,60345,60347,3,5,0
17267,6,2,60348,60348,60350,0,2,1
17268,4,1,60352,60352,60353,0,1,2
17269,3,1,60355,60355,60356,0,1,2
17270,6,3,60361,60361,60364,0,3,5
17271,5,3,60366,60366,60369,0,3,2
17272,1,1,60367,60369,60370,2,3,0
17273,1,2,60368,60370,60372,2,4,0
17274,1,2,60369,60372,60374,3,5,0
17275,1,3,60370,60374,60377,4,7,0
17276,2,1,60372,60377,60378,5,6,0
17277,2,1,60374,60378,60379,4,5,0
17278,5,3,60379,60379,60382,0,3,0
17279,3,3,60382,60382,60385,0,3,0
17280,5,3,60387,60387,60390,0,3,2
17281,1,3,60388,60390,60393,2,5,0
17282,6,3,60394,60394,60397,0,3,1
17283,2,3,60396,60397,60400,1,4,0
17284,4,1,60400,60400,60401,0,1,0
17285,3,3,60403,60403,60406,0,3,2
17286,3,3,60406,60406,60409,0,3,0
17287,4,3,60410,60410,60413,0,3,1
17288,3,3,60413,60413,60416,0,3,0
17289,2,3,60415,60416,60419,1,4,0
17290,5,3,60420,60420,60423,0,3,1
17291,5,3,60425,60425,60428,0,3,2
17292,4,2,60429,60429,60431,0,2,1
17293,1,2,60430,60431,60433,1,3,0
17294,3,3,60433,60433,60436,0,3,0
17295,6,1,60439,60439,60440,0,1,3
17296,1,2,60440,60440,60442,0,2,0
17297,1,2,60441,60442,60444,1,3,0
17298,3,3,60444,60444,60447,0,3,0
17299,6,1,60450,60450,60451,0,1,3
17300,2,3,60452,60452,60455,0,3,1
17301,1,1,60453,60455,60456,2,3,0
17302,3,3,60456,60456,60459,0,3,0
17303,4,1,60460,60460,60461,0,1,1
17304,1,3,60461,60461,60464,0,3,0
17305,1,1,60462,60464,60465,2,3,0
17306,3,3,60465,60465,60468,0,3,0
17307,6,3,60471,60471,60474,0,3,3
17308,6,3,60477,60477,60480,0,3,3
17309,6,3,60483,60483,60486,0,3,3
17310,4,1,60487,60487,60488,0,1,1
17311,3,3,60490,60490,60493,0,3,2
17312,4,2,60494,60494,60496,0,2,1
17313,4,3,60498,60498,60501,0,3,2
17314,2,2,60500,60501,60503,1,3,0
17315,5,3,60505,60505,60508,0,3,2
17316,4,3,60509,60509,60512,0,3,1
17317,5,3,60514,60514,60517,0,3,2
17318,5,3,60519,60519,60522,0,3,2
17319,1,1,60520,60522,60523,2,3,0
17320,3,3,60523,60523,60526,0,3,0
17321,2,1,60525,60526,60527,1,2,0
17322,3,2,60528,60528,60530,0,2,1
17323,5,3,60533,60533,60536,0,3,3
17324,2,1,60535,60536,60537,1,2,0
17325,5,3,60540,60540,60543,0,3,3
17326,4,1,60544,60544,60545,0,1,1
17327,1,2,60545,60545,60547,0,2,0
17328,2,3,60547,60547,60550,0,3,0
17329,5,3,60552,60552,60555,0,3,2
17330,6,3,60558,60558,60561,0,3,3
17331,4,2,60562,60562,60564,0,2,1
17332,6,2,60568,60568,60570,0,2,4
17333,5,2,60573,60573,60575,0,2,3
17334,6,3,60579,60579,60582,0,3,4
17335,1,2,60580,60582,60584,2,4,0
17336,3,2,60583,60584,60586,1,3,0
17337,3,2,60586,60586,60588,0,2,0
17338,2,3,60588,60588,60591,0,3,0
17339,2,2,60590,60591,60593,1,3,0
17340,1,1,60591,60593,60594,2,3,0
17341,6,1,60597,60597,60598,0,1,3
17342,1,3,60598,60598,60601,0,3,0
17343,5,3,60603,60603,60606,0,3,2
17344,1,3,60604,60606,60609,2,5,0
17345,6,3,60610,60610,60613,0,3,1
17346,6,3,60616,60616,60619,0,3,3
17347,6,3,60622,60622,60625,0,3,3
17348,2,1,60624,60625,60626,1,2,0
17349,1,2,60625,60626,60628,1,3,0
17350,5,2,60630,60630,60632,0,2,2
17351,1,1,60631,60632,60633,1,2,0
17352,6,3,60637,60637,60640,0,3,4
17353,2,3,60639,60640,60643,1,4,0
17354,4,1,60643,60643,60644,0,1,0
17355,6,1,60649,60649,60650,0,1,5
17356,5,1,60654,60654,60655,0,1,4
17357,1,3,60655,60655,60658,0,3,0
17358,4,1,60659,60659,60660,0,1,1
17359,6,1,60665,60665,60666,0,1,5
17360,4,2,60669,60669,60671,0,2,3
17361,5,2,60674,60674,60676,0,2,3
17362,1,2,60675,60676,60678,1,3,0
17363,3,3,60678,60678,60681,0,3,0
17364,1,1,60679,60681,60682,2,3,0
17365,5,2,60684,60684,60686,0,2,2
17366,2,1,60686,60686,60687,0,1,0
17367,6,2,60692,60692,60694,0,2,5
17368,6,1,60698,60698,60699,0,1,4
17369,1,2,60699,60699,60701,0,2,0
17370,5,2,60704,60704,60706,0,2,3
17371,1,1,60705,60706,60707,1,2,0
17372,2,3,60707,60707,60710,0,3,0
17373,1,3,60708,60710,60713,2,5,0
17374,5,2,60713,60713,60715,0,2,0
17375,1,3,60714,60715,60718,1,4,0
17376,3,1,60717,60718,60719,1,2,0
17377,6,2,60723,60723,60725,0,2,4
17378,1,2,60724,60725,60727,1,3,0
17379,2,2,60726,60727,60729,1,3,0
17380,6,2,60732,60732,60734,0,2,3
17381,4,2,60736,60736,60738,0,2,2
17382,6,3,60742,60742,60745,0,3,4
17383,4,1,60746,60746,60747,0,1,1
17384,4,1,60750,60750,60751,0,1,3
17385,1,2,60751,60751,60753,0,2,0
17386,4,1,60755,60755,60756,0,1,2
17387,6,1,60761,60761,60762,0,1,5
17388,3,1,60764,60764,60765,0,1,2
17389,1,2,60765,60765,60767,0,2,0
17390,5,2,60770,60770,60772,0,2,3
17391,5,2,60775,60775,60777,0,2,3
17392,6,1,60781,60781,60782,0,1,4
17393,5,1,60786,60786,60787,0,1,4
17394,1,2,60787,60787,60789,0,2,0
17395,1,2,60788,60789,60791,1,3,0
17396,5,3,60793,60793,60796,0,3,2
17397,6,2,60799,60799,60801,0,2,3
17398,1,1,60800,60801,60802,1,2,0
17399,5,3,60805,60805,60808,0,3,3
17400,1,1,60806,60808,60809,2,3,0
17401,4,1,60810,60810,60811,0,1,1
17402,2,3,60812,60812,60815,0,3,1
17403,1,2,60813,60815,60817,2,4,0
17404,2,1,60815,60817,60818,2,3,0
17405,2,3,60817,60818,60821,1,4,0
17406,4,1,60821,60821,60822,0,1,0
17407,3,2,60824,60824,60826,0,2,2
17408,6,3,60830,60830,60833,0,3,4
17409,2,2,60832,60833,60835,1,3,0
17410,4,1,60836,60836,60837,0,1,1
17411,6,1,60842,60842,60843,0,1,5
17412,6,1,60848,60848,60849,0,1,5
17413,3,3,60851,60851,60854,0,3,2
17414,4,3,60855,60855,60858,0,3,1
17415,4,2,60859,60859,60861,0,2,1
17416,6,1,60865,60865,60866,0,1,4
17417,1,1,60866,60866,60867,0,1,0
17418,2,2,60868,60868,60870,0,2,1
17419,2,3,60870,60870,60873,0,3,0
17420,5,3,60875,60875,60878,0,3,2
17421,1,2,60876,60878,60880,2,4,0
17422,3,2,60879,60880,60882,1,3,0
17423,4,1,60883,60883,60884,0,1,1
17424,3,1,60886,60886,60887,0,1,2
17425,4,1,60890,60890,60891,0,1,3
17426,5,3,60895,60895,60898,0,3,4
17427,6,3,60901,60901,60904,0,3,3
17428,1,3,60902,60904,60907,2,5,0
17429,3,2,60905,60907,60909,2,4,0
17430,3,2,60908,60909,60911,1,3,0
17431,3,2,60911,60911,60913,0,2,0
17432,1,3,60912,60913,60916,1,4,0
17433,3,3,60915,60916,60919,1,4,0
17434,6,1,60921,60921,60922,0,1,2
17435,6,1,60927,60927,60928,0,1,5
17436,5,2,60932,60932,60934,0,2,4
17437,4,2,60936,60936,60938,0,2,2
17438,5,2,60941,60941,60943,0,2,3
17439,5,1,60946,60946,60947,0,1,3
17440,5,2,60951,60951,60953,0,2,4
17441,6,1,60957,60957,60958,0,1,4
17442,3,3,60960,60960,60963,0,3,2
17443,1,1,60961,60963,60964,2,3,0
17444,4,3,60965,60965,60968,0,3,1
17445,4,1,60969,60969,60970,0,1,1
17446,1,1,60970,60970,60971,0,1,0
17447,4,1,60974,60974,60975,0,1,3
17448,2,3,60976,60976,60979,0,3,1
17449,4,2,60980,60980,60982,0,2,1
17450,1,2,60981,60982,60984,1,3,0
17451,1,1,60982,60984,60985,2,3,0
17452,6,2,60988,60988,60990,0,2,3
17453,5,2,60993,60993,60995,0,2,3
17454,2,3,60995,60995,60998,0,3,0
17455,5,3,61000,61000,61003,0,3,2
17456,1,2,61001,61003,61005,2,4,0
17457,2,2,61003,61005,61007,2,4,0
17458,2,2,61005,61007,61009,2,4,0
17459,2,1,61007,61009,61010,2,3,0
17460,2,2,61009,61010,61012,1,3,0
17461,3,3,61012,61012,61015,0,3,0
17462,2,2,61014,61015,61017,1,3,0
17463,4,3,61018,61018,61021,0,3,1
17464,4,3,61022,61022,61025,0,3,1
17465,1,2,61023,61025,61027,2,4,0
17466,5,2,61028,61028,61030,0,2,1
17467,2,2,61030,61030,61032,0,2,0
17468,5,2,61035,61035,61037,0,2,3
17469,2,2,61037,61037,61039,0,2,0
17470,1,3,61038,61039,61042,1,4,0
17471,6,2,61044,61044,61046,0,2,2
17472,6,3,61050,61050,61053,0,3,4
17473,4,3,61054,61054,61057,0,3,1
17474,1,1,61055,61057,61058,2,3,0
17475,2,3,61057,61058,61061,1,4,0
17476,5,1,61062,61062,61063,0,1,1
17477,2,2,61064,61064,61066,0,2,1
17478,4,1,61068,61068,61069,0,1,2
17479,1,1,61069,61069,61070,0,1,0
17480,2,3,61071,61071,61074,0,3,1
17481,2,2,61073,61074,61076,1,3,0
17482,4,1,61077,61077,61078,0,1,1
17483,1,3,61078,61078,61081,0,3,0
17484,2,3,61080,61081,61084,1,4,0
17485,2,3,61082,61084,61087,2,5,0
17486,3,3,61085,61087,61090,2,5,0
17487,1,3,61086,61090,61093,4,7,0
17488,3,3,61089,61093,61096,4,7,0
17489,5,3,61094,61096,61099,2,5,0
17490,2,2,61096,61099,61101,3,5,0
17491,6,3,61102,61102,61105,0,3,1
17492,6,2,61108,61108,61110,0,2,3
17493,4,1,61112,61112,61113,0,1,2
17494,2,3,61114,61114,61117,0,3,1
17495,1,3,61115,61117,61120,2,5,0
17496,6,2,61121,61121,61123,0,2,1
17497,3,3,61124,61124,61127,0,3,1
17498,1,2,61125,61127,61129,2,4,0
17499,2,3,61127,61129,61132,2,5,0
17500,3,2,61130,61132,61134,2,4,0
17501,6,1,61136,61136,61137,0,1,2
17502,3,3,61139,61139,61142,0,3,2
17503,3,1,61142,61142,61143,0,1,0
17504,6,3,61148,61148,61151,0,3,5
17505,1,3,61149,61151,61154,2,5,0
17506,1,1,61150,61154,61155,4,5,0
17507,1,3,61151,61155,61158,4,7,0
17508,1,2,61152,61158,61160,6,8,0
17509,6,2,61158,61160,61162,2,4,0
17510,3,2,61161,61162,61164,1,3,0
17511,6,3,61167,61167,61170,0,3,3
17512,5,1,61172,61172,61173,0,1,2
17513,5,2,61177,61177,61179,0,2,4
17514,1,2,61178,61179,61181,1,3,0
17515,2,2,61180,61181,61183,1,3,0
17516,2,1,61182,61183,61184,1,2,0
17517,2,1,61184,61184,61185,0,1,0
17518,5,2,61189,61189,61191,0,2,4
17519,4,3,61193,61193,61196,0,3,2
17520,4,1,61197,61197,61198,0,1,1
17521,1,1,61198,61198,61199,0,1,0
17522,4,2,61202,61202,61204,0,2,3
17523,4,1,61206,61206,61207,0,1,2
17524,1,2,61207,61207,61209,0,2,0
17525,5,1,61212,61212,61213,0,1,3
17526,3,1,61215,61215,61216,0,1,2
17527,6,3,61221,61221,61224,0,3,5
17528,4,2,61225,61225,61227,0,2,1
17529,3,1,61228,61228,61229,0,1,1
17530,4,1,61232,61232,61233,0,1,3
17531,1,1,61233,61233,61234,0,1,0
17532,5,3,61238,61238,61241,0,3,4
17533,1,2,61239,61241,61243,2,4,0
17534,6,2,61245,61245,61247,0,2,2
17535,6,2,61251,61251,61253,0,2,4
17536,1,3,61252,61253,61256,1,4,0
17537,2,1,61254,61256,61257,2,3,0
17538,5,2,61259,61259,61261,0,2,2
17539,4,2,61263,61263,61265,0,2,2
17540,3,3,61266,61266,61269,0,3,1
17541,1,1,61267,61269,61270,2,3,0
17542,5,1,61272,61272,61273,0,1,2
17543,6,2,61278,61278,61280,0,2,5
17544,2,1,61280,61280,61281,0,1,0
17545,5,3,61285,61285,61288,0,3,4
17546,5,3,61290,61290,61293,0,3,2
17547,1,3,61291,61293,61296,2,5,0
17548,3,3,61294,61296,61299,2,5,0
17549,3,2,61297,61299,61301,2,4,0
17550,3,2,61300,61301,61303,1,3,0
17551,4,1,61304,61304,61305,0,1,1
17552,6,2,61310,61310,61312,0,2,5
17553,3,2,61313,61313,61315,0,2,1
17554,6,1,61319,61319,61320,0,1,4
17555,3,1,61322,61322,61323,0,1,2
17556,5,2,61327,61327,61329,0,2,4
17557,3,2,61330,61330,61332,0,2,1
17558,2,2,61332,61332,61334,0,2,0
17559,2,1,61334,61334,61335,0,1,0
17560,3,3,61337,61337,61340,0,3,2
17561,1,2,61338,61340,61342,2,4,0
17562,4,2,61342,61342,61344,0,2,0
17563,6,2,61348,61348,61350,0,2,4
17564,5,3,61353,61353,61356,0,3,3
17565,1,2,61354,61356,61358,2,4,0
17566,6,1,61360,61360,61361,0,1,2
17567,5,2,61365,61365,61367,0,2,4
17568,1,2,61366,61367,61369,1,3,0
17569,6,2,61372,61372,61374,0,2,3
17570,3,1,61375,61375,61376,0,1,1
17571,3,1,61378,61378,61379,0,1,2
17572,6,3,61384,61384,61387,0,3,5
17573,4,3,61388,61388,61391,0,3,1
17574,3,2,61391,61391,61393,0,2,0
17575,1,3,61392,61393,61396,1,4,0
17576,3,3,61395,61396,61399,1,4,0
17577,2,1,61397,61399,61400,2,3,0
17578,3,3,61400,61400,61403,0,3,0
17579,2,2,61402,61403,61405,1,3,0
17580,1,1,61403,61405,61406,2,3,0
17581,6,3,61409,61409,61412,0,3,3
17582,4,1,61413,61413,61414,0,1,1
17583,2,1,61415,61415,61416,0,1,1
17584,5,2,61420,61420,61422,0,2,4
17585,5,2,61425,61425,61427,0,2,3
17586,5,2,61430,61430,61432,0,2,3
17587,1,2,61431,61432,61434,1,3,0
17588,3,2,61434,61434,61436,0,2,0
17589,1,2,61435,61436,61438,1,3,0
17590,3,2,61438,61438,61440,0,2,0
17591,5,3,61443,61443,61446,0,3,3
17592,5,2,61448,61448,61450,0,2,2
17593,5,3,61453,61453,61456,0,3,3
17594,5,3,61458,61458,61461,0,3,2
17595,4,1,61462,61462,61463,0,1,1
17596,5,1,61467,61467,61468,0,1,4
17597,4,1,61471,61471,61472,0,1,3
17598,4,1,61475,61475,61476,0,1,3
17599,3,2,61478,61478,61480,0,2,2
17600,6,3,61484,61484,61487,0,3,4
17601,4,3,61488,61488,61491,0,3,1
17602,1,1,61489,61491,61492,2,3,0
17603,2,2,61491,61492,61494,1,3,0
17604,4,3,61495,61495,61498,0,3,1
17605,1,1,61496,61498,61499,2,3,0
17606,5,1,61501,61501,61502,0,1,2
17607,6,1,61507,61507,61508,0,1,5
17608,5,3,61512,61512,61515,0,3,4
17609,2,3,61514,61515,61518,1,4,0
17610,1,3,61515,61518,61521,3,6,0
17611,1,2,61516,61521,61523,5,7,0
17612,3,1,61519,61523,61524,4,5,0
17613,1,2,61520,61524,61526,4,6,0
17614,1,2,61521,61526,61528,5,7,0
17615,2,1,61523,61528,61529,5,6,0
17616,1,3,61524,61529,61532,5,8,0
17617,5,3,61529,61532,61535,3,6,0
17618,5,1,61534,61535,61536,1,2,0
17619,4,2,61538,61538,61540,0,2,2
17620,2,2,61540,61540,61542,0,2,0
17621,6,1,61546,61546,61547,0,1,4
17622,4,3,61550,61550,61553,0,3,3
17623,3,2,61553,61553,61555,0,2,0
17624,5,3,61558,61558,61561,0,3,3
17625,2,2,61560,61561,61563,1,3,0
17626,2,3,61562,61563,61566,1,4,0
17627,5,2,61567,61567,61569,0,2,1
17628,2,3,61569,61569,61572,0,3,0
17629,4,2,61573,61573,61575,0,2,1
17630,5,2,61578,61578,61580,0,2,3
17631,3,3,61581,61581,61584,0,3,1
17632,3,2,61584,61584,61586,0,2,0
17633,3,2,61587,61587,61589,0,2,1
17634,1,3,61588,61589,61592,1,4,0
17635,2,3,61590,61592,61595,2,5,0
17636,3,3,61593,61595,61598,2,5,0
17637,4,3,61597,61598,61601,1,4,0
17638,3,1,61600,61601,61602,1,2,0
17639,6,3,61606,61606,61609,0,3,4
17640,1,2,61607,61609,61611,2,4,0
17641,3,2,61610,61611,61613,1,3,0
17642,1,2,61611,61613,61615,2,4,0
17643,1,1,61612,61615,61616,3,4,0
17644,6,1,61618,61618,61619,0,1,2
17645,1,1,61619,61619,61620,0,1,0
17646,4,2,61623,61623,61625,0,2,3
17647,6,3,61629,61629,61632,0,3,4
17648,6,3,61635,61635,61638,0,3,3
17649,2,2,61637,61638,61640,1,3,0
17650,2,1,61639,61640,61641,1,2,0
17651,6,2,61645,61645,61647,0,2,4
17652,5,1,61650,61650,61651,0,1,3
17653,1,3,61651,61651,61654,0,3,0
17654,2,3,61653,61654,61657,1,4,0
17655,2,1,61655,61657,61658,2,3,0
17656,2,3,61657,61658,61661,1,4,0
17657,1,2,61658,61661,61663,3,5,0
17658,1,2,61659,61663,61665,4,6,0
17659,2,3,61661,61665,61668,4,7,0
17660,4,1,61665,61668,61669,3,4,0
17661,4,3,61669,61669,61672,0,3,0
17662,2,3,61671,61672,61675,1,4,0
17663,4,3,61675,61675,61678,0,3,0
17664,4,2,61679,61679,61681,0,2,1
17665,6,3,61685,61685,61688,0,3,4
17666,3,3,61688,61688,61691,0,3,0
17667,3,3,61691,61691,61694,0,3,0
17668,6,3,61697,61697,61700,0,3,3
17669,2,2,61699,61700,61702,1,3,0
17670,5,1,61704,61704,61705,0,1,2
17671,3,1,61707,61707,61708,0,1,2
17672,2,1,61709,61709,61710,0,1,1
17673,2,1,61711,61711,61712,0,1,1
17674,4,3,61715,61715,61718,0,3,3
17675,1,1,61716,61718,61719,2,3,0
17676,4,1,61720,61720,61721,0,1,1
17677,1,3,61721,61721,61724,0,3,0
17678,6,2,61727,61727,61729,0,2,3
17679,6,1,61733,61733,61734,0,1,4
17680,4,1,61737,61737,61738,0,1,3
17681,3,1,61740,61740,61741,0,1,2
17682,1,2,61741,61741,61743,0,2,0
17683,6,1,61747,61747,61748,0,1,4
17684,3,3,61750,61750,61753,0,3,2
17685,6,2,61756,61756,61758,0,2,3
17686,5,1,61761,61761,61762,0,1,3
17687,1,1,61762,61762,61763,0,1,0
17688,5,2,61767,61767,61769,0,2,4
17689,3,3,61770,61770,61773,0,3,1
17690,5,2,61775,61775,61777,0,2,2
17691,6,3,61781,61781,61784,0,3,4
17692,2,1,61783,61784,61785,1,2,0
17693,2,1,61785,61785,61786,0,1,0
17694,5,2,61790,61790,61792,0,2,4
17695,1,2,61791,61792,61794,1,3,0
17696,1,1,61792,61794,61795,2,3,0
17697,4,3,61796,61796,61799,0,3,1
17698,4,2,61800,61800,61802,0,2,1
17699,1,3,61801,61802,61805,1,4,0
17700,1,1,61802,61805,61806,3,4,0
17701,2,2,61804,61806,61808,2,4,0
17702,3,3,61807,61808,61811,1,4,0
17703,6,1,61813,61813,61814,0,1,2
17704,2,3,61815,61815,61818,0,3,1
17705,2,3,61817,61818,61821,1,4,0
17706,6,3,61823,61823,61826,0,3,2
17707,4,1,61827,61827,61828,0,1,1
17708,2,3,61829,61829,61832,0,3,1
17709,6,2,61835,61835,61837,0,2,3
17710,4,2,61839,61839,61841,0,2,2
17711,6,1,61845,61845,61846,0,1,4
17712,1,3,61846,61846,61849,0,3,0
17713,6,1,61852,61852,61853,0,1,3
17714,3,2,61855,61855,61857,0,2,2
17715,5,2,61860,61860,61862,0,2,3
17716,2,3,61862,61862,61865,0,3,0
17717,1,1,61863,61865,61866,2,3,0
17718,1,3,61864,61866,61869,2,5,0
17719,6,2,61870,61870,61872,0,2,1
17720,1,3,61871,61872,61875,1,4,0
17721,4,3,61875,61875,61878,0,3,0
17722,3,1,61878,61878,61879,0,1,0
17723,3,1,61881,61881,61882,0,1,2
17724,2,1,61883,61883,61884,0,1,1
17725,3,1,61886,61886,61887,0,1,2
17726,6,3,61892,61892,61895,0,3,5
17727,1,3,61893,61895,61898,2,5,0
17728,4,2,61897,61898,61900,1,3,0
17729,1,1,61898,61900,61901,2,3,0
17730,4,3,61902,61902,61905,0,3,1
17731,1,3,61903,61905,61908,2,5,0
17732,4,3,61907,61908,61911,1,4,0
17733,1,2,61908,61911,61913,3,5,0
17734,5,1,61913,61913,61914,0,1,0
17735,3,2,61916,61916,61918,0,2,2
17736,6,1,61922,61922,61923,0,1,4
17737,6,2,61928,61928,61930,0,2,5
17738,2,2,61930,61930,61932,0,2,0
17739,6,2,61936,61936,61938,0,2,4
17740,1,2,61937,61938,61940,1,3,0
17741,3,3,61940,61940,61943,0,3,0
17742,2,1,61942,61943,61944,1,2,0
17743,1,1,61943,61944,61945,1,2,0
17744,1,2,61944,61945,61947,1,3,0
17745,4,3,61948,61948,61951,0,3,1
17746,5,1,61953,61953,61954,0,1,2
17747,2,2,61955,61955,61957,0,2,1
17748,3,2,61958,61958,61960,0,2,1
17749,4,2,61962,61962,61964,0,2,2
17750,5,3,61967,61967,61970,0,3,3
17751,5,1,61972,61972,61973,0,1,2
17752,3,3,61975,61975,61978,0,3,2
17753,5,1,61980,61980,61981,0,1,2
17754,5,2,61985,61985,61987,0,2,4
17755,4,1,61989,61989,61990,0,1,2
17756,6,1,61995,61995,61996,0,1,5
17757,2,3,61997,61997,62000,0,3,1
17758,6,3,62003,62003,62006,0,3,3
17759,5,3,62008,62008,62011,0,3,2
17760,4,3,62012,62012,62015,0,3,1
17761,2,2,62014,62015,62017,1,3,0
17762,5,1,62019,62019,62020,0,1,2
17763,1,3,62020,62020,62023,0,3,0
17764,2,3,62022,62023,62026,1,4,0
17765,2,1,62024,62026,62027,2,3,0
17766,2,2,62026,62027,62029,1,3,0
17767,2,1,62028,62029,62030,1,2,0
17768,5,3,62033,62033,62036,0,3,3
17769,4,2,62037,62037,62039,0,2,1
17770,1,1,62038,62039,62040,1,2,0
17771,4,2,62042,62042,62044,0,2,2
17772,6,3,62048,62048,62051,0,3,4
17773,5,2,62053,62053,62055,0,2,2
17774,1,1,62054,62055,62056,1,2,0
17775,5,3,62059,62059,62062,0,3,3
17776,4,3,62063,62063,62066,0,3,1
17777,3,1,62066,62066,62067,0,1,0
17778,2,2,62068,62068,62070,0,2,1
17779,3,2,62071,62071,62073,0,2,1
17780,6,3,62077,62077,62080,0,3,4
17781,2,1,62079,62080,62081,1,2,0
17782,3,2,62082,62082,62084,0,2,1
17783,6,1,62088,62088,62089,0,1,4
17784,6,2,62094,62094,62096,0,2,5
17785,3,1,62097,62097,62098,0,1,1
17786,2,1,62099,62099,62100,0,1,1
17787,5,3,62104,62104,62107,0,3,4
17788,4,2,62108,62108,62110,0,2,1
17789,4,1,62112,62112,62113,0,1,2
17790,3,2,62115,62115,62117,0,2,2
17791,1,1,62116,62117,62118,1,2,0
17792,6,1,62122,62122,62123,0,1,4
17793,6,2,62128,62128,62130,0,2,5
17794,3,3,62131,62131,62134,0,3,1
17795,2,2,62133,62134,62136,1,3,0
17796,6,1,62139,62139,62140,0,1,3
17797,5,2,62144,62144,62146,0,2,4
17798,2,3,62146,62146,62149,0,3,0
17799,6,3,62152,62152,62155,0,3,3
17800,2,1,62154,62155,62156,1,2,0
17801,5,1,62159,62159,62160,0,1,3
17802,1,3,62160,62160,62163,0,3,0
17803,2,1,62162,62163,62164,1,2,0
17804,1,1,62163,62164,62165,1,2,0
17805,2,1,62165,62165,62166,0,1,0
17806,6,1,62171,62171,62172,0,1,5
17807,5,2,62176,62176,62178,0,2,4
17808,4,1,62180,62180,62181,0,1,2
17809,6,1,62186,62186,62187,0,1,5
17810,6,3,62192,62192,62195,0,3,5
17811,4,2,62196,62196,62198,0,2,1
17812,3,2,62199,62199,62201,0,2,1
17813,1,2,62200,62201,62203,1,3,0
17814,2,1,62202,62203,62204,1,2,0
17815,5,3,62207,62207,62210,0,3,3
17816,5,1,62212,62212,62213,0,1,2
17817,3,1,62215,62215,62216,0,1,2
17818,1,1,62216,62216,62217,0,1,0
17819,6,1,62222,62222,62223,0,1,5
17820,1,3,62223,62223,62226,0,3,0
17821,5,2,62228,62228,62230,0,2,2
17822,2,1,62230,62230,62231,0,1,0
17823,4,3,62234,62234,62237,0,3,3
17824,5,2,62239,62239,62241,0,2,2
17825,2,2,62241,62241,62243,0,2,0
17826,5,2,62246,62246,62248,0,2,3
17827,1,2,62247,62248,62250,1,3,0
17828,1,1,62248,62250,62251,2,3,0
17829,2,2,62250,62251,62253,1,3,0
17830,6,3,62256,62256,62259,0,3,3
17831,4,1,62260,62260,62261,0,1,1
17832,2,1,62262,62262,62263,0,1,1
17833,4,3,62266,62266,62269,0,3,3
17834,3,3,62269,62269,62272,0,3,0
17835,4,2,62273,62273,62275,0,2,1
17836,6,3,62279,62279,62282,0,3,4
17837,6,2,62285,62285,62287,0,2,3
17838,2,2,62287,62287,62289,0,2,0
17839,4,2,62291,62291,62293,0,2,2
17840,1,2,62292,62293,62295,1,3,0
17841,6,2,62298,62298,62300,0,2,3
17842,4,2,62302,62302,62304,0,2,2
17843,4,2,62306,62306,62308,0,2,2
17844,6,1,62312,62312,62313,0,1,4
17845,1,2,62313,62313,62315,0,2,0
17846,1,1,62314,62315,62316,1,2,0
17847,1,3,62315,62316,62319,1,4,0
17848,4,1,62319,62319,62320,0,1,0
17849,2,3,62321,62321,62324,0,3,1
17850,6,1,62327,62327,62328,0,1,3
17851,4,1,62331,62331,62332,0,1,3
17852,4,2,62335,62335,62337,0,2,3
17853,2,2,62337,62337,62339,0,2,0
17854,4,3,62341,62341,62344,0,3,2
17855,6,2,62347,62347,62349,0,2,3
17856,3,2,62350,62350,62352,0,2,1
17857,6,1,62356,62356,62357,0,1,4
17858,2,3,62358,62358,62361,0,3,1
17859,5,3,62363,62363,62366,0,3,2
17860,2,1,62365,62366,62367,1,2,0
17861,3,2,62368,62368,62370,0,2,1
17862,1,1,62369,62370,62371,1,2,0
17863,6,2,62375,62375,62377,0,2,4
17864,6,3,62381,62381,62384,0,3,4
17865,6,3,62387,62387,62390,0,3,3
17866,1,3,62388,62390,62393,2,5,0
17867,3,3,62391,62393,62396,2,5,0
17868,4,1,62395,62396,62397,1,2,0
17869,5,3,62400,62400,62403,0,3,3
17870,4,3,62404,62404,62407,0,3,1
17871,4,3,62408,62408,62411,0,3,1
17872,2,2,62410,62411,62413,1,3,0
17873,2,3,62412,62413,62416,1,4,0
17874,6,1,62418,62418,62419,0,1,2
17875,4,3,62422,62422,62425,0,3,3
17876,3,1,62425,62425,62426,0,1,0
17877,3,3,62428,62428,62431,0,3,2
17878,6,1,62434,62434,62435,0,1,3
17879,6,3,62440,62440,62443,0,3,5
17880,5,1,62445,62445,62446,0,1,2
17881,6,3,62451,62451,62454,0,3,5
17882,4,3,62455,62455,62458,0,3,1
17883,2,2,62457,62458,62460,1,3,0
17884,5,3,62462,62462,62465,0,3,2
17885,3,2,62465,62465,62467,0,2,0
17886,5,2,62470,62470,62472,0,2,3
17887,6,3,62476,62476,62479,0,3,4
17888,3,1,62479,62479,62480,0,1,0
17889,2,1,62481,62481,62482,0,1,1
17890,1,2,62482,62482,62484,0,2,0
17891,2,2,62484,62484,62486,0,2,0
17892,5,1,62489,62489,62490,0,1,3
17893,4,3,62493,62493,62496,0,3,3
17894,3,1,62496,62496,62497,0,1,0
17895,5,1,62501,62501,62502,0,1,4
17896,2,2,62503,62503,62505,0,2,1
17897,3,1,62506,62506,62507,0,1,1
17898,4,1,62510,62510,62511,0,1,3
17899,4,1,62514,62514,62515,0,1,3
17900,3,1,62517,62517,62518,0,1,2
17901,5,3,62522,62522,62525,0,3,4
17902,1,2,62523,62525,62527,2,4,0
17903,4,2,62527,62527,62529,0,2,0
17904,2,1,62529,62529,62530,0,1,0
17905,2,3,62531,62531,62534,0,3,1
17906,1,2,62532,62534,62536,2,4,0
17907,5,3,62537,62537,62540,0,3,1
17908,6,1,62543,62543,62544,0,1,3
17909,5,3,62548,62548,62551,0,3,4
17910,5,1,62553,62553,62554,0,1,2
17911,4,2,62557,62557,62559,0,2,3
17912,5,2,62562,62562,62564,0,2,3
17913,3,1,62565,62565,62566,0,1,1
17914,4,1,62569,62569,62570,0,1,3
17915,1,3,62570,62570,62573,0,3,0
17916,1,1,62571,62573,62574,2,3,0
17917,4,1,62575,62575,62576,0,1,1
17918,5,2,62580,62580,62582,0,2,4
17919,5,1,62585,62585,62586,0,1,3
17920,3,3,62588,62588,62591,0,3,2
17921,1,2,62589,62591,62593,2,4,0
17922,3,1,62592,62593,62594,1,2,0
17923,4,1,62596,62596,62597,0,1,2
17924,5,3,62601,62601,62604,0,3,4
17925,5,1,62606,62606,62607,0,1,2
17926,6,2,62612,62612,62614,0,2,5
17927,3,2,62615,62615,62617,0,2,1
17928,3,1,62618,62618,62619,0,1,1
17929,3,1,62621,62621,62622,0,1,2
17930,6,3,62627,62627,62630,0,3,5
17931,2,2,62629,62630,62632,1,3,0
17932,6,3,62635,62635,62638,0,3,3
17933,1,1,62636,62638,62639,2,3,0
17934,3,2,62639,62639,62641,0,2,0
17935,1,3,62640,62641,62644,1,4,0
17936,4,2,62644,62644,62646,0,2,0
17937,2,1,62646,62646,62647,0,1,0
17938,4,1,62650,62650,62651,0,1,3
17939,5,2,62655,62655,62657,0,2,4
17940,1,1,62656,62657,62658,1,2,0
17941,1,1,62657,62658,62659,1,2,0
17942,3,3,62660,62660,62663,0,3,1
17943,1,1,62661,62663,62664,2,3,0
17944,5,3,62666,62666,62669,0,3,2
17945,3,3,62669,62669,62672,0,3,0
17946,4,1,62673,62673,62674,0,1,1
17947,2,3,62675,62675,62678,0,3,1
17948,1,3,62676,62678,62681,2,5,0
17949,4,1,62680,62681,62682,1,2,0
17950,4,2,62684,62684,62686,0,2,2
17951,1,1,62685,62686,62687,1,2,0
17952,2,2,62687,62687,62689,0,2,0
17953,3,1,62690,62690,62691,0,1,1
17954,2,3,62692,62692,62695,0,3,1
17955,5,1,62697,62697,62698,0,1,2
17956,4,1,62701,62701,62702,0,1,3
17957,6,3,62707,62707,62710,0,3,5
17958,5,1,62712,62712,62713,0,1,2
17959,6,1,62718,62718,62719,0,1,5
17960,4,1,62722,62722,62723,0,1,3
17961,6,2,62728,62728,62730,0,2,5
17962,5,3,62733,62733,62736,0,3,3
17963,1,3,62734,62736,62739,2,5,0
17964,4,2,62738,62739,62741,1,3,0
17965,6,3,62744,62744,62747,0,3,3
17966,3,3,62747,62747,62750,0,3,0
17967,2,1,62749,62750,62751,1,2,0
17968,1,2,62750,62751,62753,1,3,0
17969,3,2,62753,62753,62755,0,2,0
17970,2,2,62755,62755,62757,0,2,0
17971,5,3,62760,62760,62763,0,3,3
17972,5,1,62765,62765,62766,0,1,2
17973,2,2,62767,62767,62769,0,2,1
17974,2,1,62769,62769,62770,0,1,0
17975,3,3,62772,62772,62775,0,3,2
17976,1,1,62773,62775,62776,2,3,0
17977,1,2,62774,62776,62778,2,4,0
17978,1,2,62775,62778,62780,3,5,0
17979,2,3,62777,62780,62783,3,6,0
17980,3,3,62780,62783,62786,3,6,0
17981,2,1,62782,62786,62787,4,5,0
17982,3,1,62785,62787,62788,2,3,0
17983,4,2,62789,62789,62791,0,2,1
17984,2,2,62791,62791,62793,0,2,0
17985,3,2,62794,62794,62796,0,2,1
17986,6,2,62800,62800,62802,0,2,4
17987,5,3,62805,62805,62808,0,3,3
17988,1,1,62806,62808,62809,2,3,0
17989,2,3,62808,62809,62812,1,4,0
17990,4,2,62812,62812,62814,0,2,0
17991,5,3,62817,62817,62820,0,3,3
17992,4,2,62821,62821,62823,0,2,1
17993,6,1,62827,62827,62828,0,1,4
17994,3,2,62830,62830,62832,0,2,2
17995,6,2,62836,62836,62838,0,2,4
17996,1,1,62837,62838,62839,1,2,0
17997,4,1,62841,62841,62842,0,1,2
17998,2,3,62843,62843,62846,0,3,1
17999,1,1,62844,62846,62847,2,3,0
18000,6,3,62850,62850,62853,0,3,3
18001,1,1,62851,62853,62854,2,3,0
18002,5,2,62856,62856,62858,0,2,2
18003,3,3,62859,62859,62862,0,3,1
18004,3,2,62862,62862,62864,0,2,0
18005,2,1,62864,62864,62865,0,1,0
18006,6,2,62870,62870,62872,0,2,5
18007,4,1,62874,62874,62875,0,1,2
18008,5,2,62879,62879,62881,0,2,4
18009,2,3,62881,62881,62884,0,3,0
18010,2,2,62883,62884,62886,1,3,0
18011,6,2,62889,62889,62891,0,2,3
18012,4,3,62893,62893,62896,0,3,2
18013,2,3,62895,62896,62899,1,4,0
18014,3,2,62898,62899,62901,1,3,0
18015,6,1,62904,62904,62905,0,1,3
18016,4,2,62908,62908,62910,0,2,3
18017,6,2,62914,62914,62916,0,2,4
18018,4,1,62918,62918,62919,0,1,2
18019,1,1,62919,62919,62920,0,1,0
18020,4,3,62923,62923,62926,0,3,3
18021,2,2,62925,62926,62928,1,3,0
18022,1,1,62926,62928,62929,2,3,0
18023,4,1,62930,62930,62931,0,1,1
18024,1,2,62931,62931,62933,0,2,0
18025,5,2,62936,62936,62938,0,2,3
18026,1,1,62937,62938,62939,1,2,0
18027,4,2,62941,62941,62943,0,2,2
18028,5,3,62946,62946,62949,0,3,3
18029,4,2,62950,62950,62952,0,2,1
18030,5,3,62955,62955,62958,0,3,3
18031,5,2,62960,62960,62962,0,2,2
18032,4,3,62964,62964,62967,0,3,2
18033,6,3,62970,62970,62973,0,3,3
18034,3,2,62973,62973,62975,0,2,0
18035,1,2,62974,62975,62977,1,3,0
18036,2,3,62976,62977,62980,1,4,0
18037,4,3,62980,62980,62983,0,3,0
18038,2,1,62982,62983,62984,1,2,0
18039,1,2,62983,62984,62986,1,3,0
18040,4,3,62987,62987,62990,0,3,1
18041,5,2,62992,62992,62994,0,2,2
18042,3,3,62995,62995,62998,0,3,1
18043,3,3,62998,62998,63001,0,3,0
18044,6,2,63004,63004,63006,0,2,3
18045,1,1,63005,63006,63007,1,2,0
18046,4,1,63009,63009,63010,0,1,2
18047,1,2,63010,63010,63012,0,2,0
18048,2,3,63012,63012,63015,0,3,0
18049,6,1,63018,63018,63019,0,1,3
18050,1,3,63019,63019,63022,0,3,0
18051,1,2,63020,63022,63024,2,4,0
18052,1,1,63021,63024,63025,3,4,0
18053,5,3,63026,63026,63029,0,3,1
18054,6,1,63032,63032,63033,0,1,3
18055,6,1,63038,63038,63039,0,1,5
18056,1,3,63039,63039,63042,0,3,0
18057,1,1,63040,63042,63043,2,3,0
18058,2,1,63042,63043,63044,1,2,0
18059,6,1,63048,63048,63049,0,1,4
18060,2,3,63050,63050,63053,0,3,1
18061,1,2,63051,63053,63055,2,4,0
18062,1,3,63052,63055,63058,3,6,0
18063,1,3,63053,63058,63061,5,8,0
18064,2,2,63055,63061,63063,6,8,0
18065,4,3,63059,63063,63066,4,7,0
18066,1,2,63060,63066,63068,6,8,0
18067,4,2,63064,63068,63070,4,6,0
18068,5,3,63069,63070,63073,1,4,0
18069,5,1,63074,63074,63075,0,1,1
18070,6,1,63080,63080,63081,0,1,5
18071,1,2,63081,63081,63083,0,2,0
18072,1,1,63082,63083,63084,1,2,0
18073,2,2,63084,63084,63086,0,2,0
18074,1,2,63085,63086,63088,1,3,0
18075,4,2,63089,63089,63091,0,2,1
18076,1,3,63090,63091,63094,1,4,0
18077,4,1,63094,63094,63095,0,1,0
18078,6,3,63100,63100,63103,0,3,5
18079,4,2,63104,63104,63106,0,2,1
18080,4,2,63108,63108,63110,0,2,2
18081,6,3,63114,63114,63117,0,3,4
18082,1,1,63115,63117,63118,2,3,0
18083,1,3,63116,63118,63121,2,5,0
18084,4,3,63120,63121,63124,1,4,0
18085,4,3,63124,63124,63127,0,3,0
18086,1,2,63125,63127,63129,2,4,0
18087,3,2,63128,63129,63131,1,3,0
18088,5,3,63133,63133,63136,0,3,2
18089,1,2,63134,63136,63138,2,4,0
18090,4,2,63138,63138,63140,0,2,0
18091,2,1,63140,63140,63141,0,1,0
18092,3,1,63143,63143,63144,0,1,2
18093,2,2,63145,63145,63147,0,2,1
18094,4,1,63149,63149,63150,0,1,2
18095,4,1,63153,63153,63154,0,1,3
18096,5,2,63158,63158,63160,0,2,4
18097,5,2,63163,63163,63165,0,2,3
18098,2,1,63165,63165,63166,0,1,0
18099,1,1,63166,63166,63167,0,1,0
18100,3,2,63169,63169,63171,0,2,2
18101,6,2,63175,63175,63177,0,2,4
18102,5,1,63180,63180,63181,0,1,3
18103,3,2,63183,63183,63185,0,2,2
18104,3,3,63186,63186,63189,0,3,1
18105,2,2,63188,63189,63191,1,3,0
18106,3,3,63191,63191,63194,0,3,0
18107,2,2,63193,63194,63196,1,3,0
18108,4,1,63197,63197,63198,0,1,1
18109,3,3,63200,63200,63203,0,3,2
18110,3,3,63203,63203,63206,0,3,0
18111,1,3,63204,63206,63209,2,5,0
18112,4,2,63208,63209,63211,1,3,0
18113,6,2,63214,63214,63216,0,2,3
18114,4,2,63218,63218,63220,0,2,2
18115,3,2,63221,63221,63223,0,2,1
18116,2,3,63223,63223,63226,0,3,0
18117,3,2,63226,63226,63228,0,2,0
18118,5,3,63231,63231,63234,0,3,3
18119,2,2,63233,63234,63236,1,3,0
18120,4,1,63237,63237,63238,0,1,1
18121,3,1,63240,63240,63241,0,1,2
18122,5,1,63245,63245,63246,0,1,4
18123,5,2,63250,63250,63252,0,2,4
18124,3,1,63253,63253,63254,0,1,1
18125,5,1,63258,63258,63259,0,1,4
18126,4,2,63262,63262,63264,0,2,3
18127,5,1,63267,63267,63268,0,1,3
18128,2,2,63269,63269,63271,0,2,1
18129,4,3,63273,63273,63276,0,3,2
18130,3,2,63276,63276,63278,0,2,0
18131,4,1,63280,63280,63281,0,1,2
18132,5,3,63285,63285,63288,0,3,4
18133,2,2,63287,63288,63290,1,3,0
18134,5,3,63292,63292,63295,0,3,2
18135,5,2,63297,63297,63299,0,2,2
18136,3,3,63300,63300,63303,0,3,1
18137,1,3,63301,63303,63306,2,5,0
18138,5,3,63306,63306,63309,0,3,0
18139,2,1,63308,63309,63310,1,2,0
18140,3,1,63311,63311,63312,0,1,1
18141,6,3,63317,63317,63320,0,3,5
18142,4,2,63321,63321,63323,0,2,1
18143,5,2,63326,63326,63328,0,2,3
18144,5,3,63331,63331,63334,0,3,3
18145,3,3,63334,63334,63337,0,3,0
18146,6,3,63340,63340,63343,0,3,3
18147,4,2,63344,63344,63346,0,2,1
18148,3,2,63347,63347,63349,0,2,1
18149,5,1,63352,63352,63353,0,1,3
18150,1,2,63353,63353,63355,0,2,0
18151,6,3,63359,63359,63362,0,3,4
18152,6,2,63365,63365,63367,0,2,3
18153,2,1,63367,63367,63368,0,1,0
18154,1,1,63368,63368,63369,0,1,0
18155,3,3,63371,63371,63374,0,3,2
18156,1,2,63372,63374,63376,2,4,0
18157,1,3,63373,63376,63379,3,6,0
18158,2,3,63375,63379,63382,4,7,0
18159,1,2,63376,63382,63384,6,8,0
18160,2,2,63378,63384,63386,6,8,0
18161,5,3,63383,63386,63389,3,6,0
18162,3,3,63386,63389,63392,3,6,0
18163,1,1,63387,63392,63393,5,6,0
18164,6,3,63393,63393,63396,0,3,0
18165,3,2,63396,63396,63398,0,2,0
18166,3,1,63399,63399,63400,0,1,1
18167,5,1,63404,63404,63405,0,1,4
18168,3,2,63407,63407,63409,0,2,2
18169,1,1,63408,63409,63410,1,2,0
18170,3,3,63411,63411,63414,0,3,1
18171,3,3,63414,63414,63417,0,3,0
18172,1,3,63415,63417,63420,2,5,0
18173,3,1,63418,63420,63421,2,3,0
18174,6,3,63424,63424,63427,0,3,3
18175,3,3,63427,63427,63430,0,3,0
18176,3,2,63430,63430,63432,0,2,0
18177,1,2,63431,63432,63434,1,3,0
18178,3,2,63434,63434,63436,0,2,0
18179,4,1,63438,63438,63439,0,1,2
18180,4,2,63442,63442,63444,0,2,3
18181,2,2,63444,63444,63446,0,2,0
18182,6,2,63450,63450,63452,0,2,4
18183,5,2,63455,63455,63457,0,2,3
18184,6,2,63461,63461,63463,0,2,4
18185,2,2,63463,63463,63465,0,2,0
18186,3,3,63466,63466,63469,0,3,1
18187,3,2,63469,63469,63471,0,2,0
18188,1,3,63470,63471,63474,1,4,0
18189,1,3,63471,63474,63477,3,6,0
18190,2,3,63473,63477,63480,4,7,0
18191,5,3,63478,63480,63483,2,5,0
18192,4,2,63482,63483,63485,1,3,0
18193,4,1,63486,63486,63487,0,1,1
18194,3,3,63489,63489,63492,0,3,2
18195,2,3,63491,63492,63495,1,4,0
18196,3,3,63494,63495,63498,1,4,0
18197,1,3,63495,63498,63501,3,6,0
18198,2,3,63497,63501,63504,4,7,0
18199,6,1,63503,63504,63505,1,2,0
18200,2,2,63505,63505,63507,0,2,0
18201,1,1,63506,63507,63508,1,2,0
18202,1,1,63507,63508,63509,1,2,0
18203,4,1,63511,63511,63512,0,1,2
18204,3,1,63514,63514,63515,0,1,2
18205,5,2,63519,63519,63521,0,2,4
18206,1,1,63520,63521,63522,1,2,0
18207,6,2,63526,63526,63528,0,2,4
18208,6,2,63532,63532,63534,0,2,4
18209,2,1,63534,63534,63535,0,1,0
18210,3,2,63537,63537,63539,0,2,2
18211,2,1,63539,63539,63540,0,1,0
18212,4,3,63543,63543,63546,0,3,3
18213,6,3,63549,63549,63552,0,3,3
18214,5,1,63554,63554,63555,0,1,2
18215,6,2,63560,63560,63562,0,2,5
18216,5,2,63565,63565,63567,0,2,3
18217,2,2,63567,63567,63569,0,2,0
18218,3,2,63570,63570,63572,0,2,1
18219,4,2,63574,63574,63576,0,2,2
18220,3,3,63577,63577,63580,0,3,1
18221,1,3,63578,63580,63583,2,5,0
18222,1,1,63579,63583,63584,4,5,0
18223,3,3,63582,63584,63587,2,5,0
18224,5,1,63587,63587,63588,0,1,0
18225,1,1,63588,63588,63589,0,1,0
18226,1,1,63589,63589,63590,0,1,0
18227,2,1,63591,63591,63592,0,1,1
18228,5,2,63596,63596,63598,0,2,4
18229,4,2,63600,63600,63602,0,2,2
18230,2,2,63602,63602,63604,0,2,0
18231,1,1,63603,63604,63605,1,2,0
18232,1,2,63604,63605,63607,1,3,0
18233,6,3,63610,63610,63613,0,3,3
18234,4,2,63614,63614,63616,0,2,1
18235,4,3,63618,63618,63621,0,3,2
18236,3,3,63621,63621,63624,0,3,0
18237,3,3,63624,63624,63627,0,3,0
18238,4,1,63628,63628,63629,0,1,1
18239,1,2,63629,63629,63631,0,2,0
18240,5,3,63634,63634,63637,0,3,3
18241,2,3,63636,63637,63640,1,4,0
18242,2,3,63638,63640,63643,2,5,0
18243,2,1,63640,63643,63644,3,4,0
18244,1,1,63641,63644,63645,3,4,0
18245,1,3,63642,63645,63648,3,6,0
18246,5,2,63647,63648,63650,1,3,0
18247,5,3,63652,63652,63655,0,3,2
18248,2,2,63654,63655,63657,1,3,0
18249,3,3,63657,63657,63660,0,3,0
18250,1,1,63658,63660,63661,2,3,0
18251,5,3,63663,63663,63666,0,3,2
18252,5,2,63668,63668,63670,0,2,2
18253,1,1,63669,63670,63671,1,2,0
18254,5,3,63674,63674,63677,0,3,3
18255,6,1,63680,63680,63681,0,1,3
18256,4,3,63684,63684,63687,0,3,3
18257,1,3,63685,63687,63690,2,5,0
18258,4,2,63689,63690,63692,1,3,0
18259,5,1,63694,63694,63695,0,1,2
18260,2,3,63696,63696,63699,0,3,1
18261,1,2,63697,63699,63701,2,4,0
18262,5,1,63702,63702,63703,0,1,1
18263,3,2,63705,63705,63707,0,2,2
18264,1,1,63706,63707,63708,1,2,0
18265,4,2,63710,63710,63712,0,2,2
18266,2,1,63712,63712,63713,0,1,0
18267,6,3,63718,63718,63721,0,3,5
18268,4,2,63722,63722,63724,0,2,1
18269,3,1,63725,63725,63726,0,1,1
18270,5,3,63730,63730,63733,0,3,4
18271,3,1,63733,63733,63734,0,1,0
18272,6,3,63739,63739,63742,0,3,5
18273,4,1,63743,63743,63744,0,1,1
18274,2,1,63745,63745,63746,0,1,1
18275,4,3,63749,63749,63752,0,3,3
18276,4,3,63753,63753,63756,0,3,1
18277,4,1,63757,63757,63758,0,1,1
18278,3,2,63760,63760,63762,0,2,2
18279,6,3,63766,63766,63769,0,3,4
18280,2,3,63768,63769,63772,1,4,0
18281,5,2,63773,63773,63775,0,2,1
18282,5,1,63778,63778,63779,0,1,3
18283,4,2,63782,63782,63784,0,2,3
18284,6,3,63788,63788,63791,0,3,4
18285,1,2,63789,63791,63793,2,4,0
18286,2,3,63791,63793,63796,2,5,0
18287,4,3,63795,63796,63799,1,4,0
18288,3,1,63798,63799,63800,1,2,0
18289,4,1,63802,63802,63803,0,1,2
18290,5,3,63807,63807,63810,0,3,4
18291,6,1,63813,63813,63814,0,1,3
18292,4,3,63817,63817,63820,0,3,3
18293,1,2,63818,63820,63822,2,4,0
18294,1,2,63819,63822,63824,3,5,0
18295,5,2,63824,63824,63826,0,2,0
18296,6,3,63830,63830,63833,0,3,4
18297,4,2,63834,63834,63836,0,2,1
18298,4,1,63838,63838,63839,0,1,2
18299,2,3,63840,63840,63843,0,3,1
18300,3,1,63843,63843,63844,0,1,0
18301,6,2,63849,63849,63851,0,2,5
18302,6,1,63855,63855,63856,0,1,4
18303,5,3,63860,63860,63863,0,3,4
18304,2,1,63862,63863,63864,1,2,0
18305,5,1,63867,63867,63868,0,1,3
18306,6,1,63873,63873,63874,0,1,5
18307,6,3,63879,63879,63882,0,3,5
18308,1,2,63880,63882,63884,2,4,0
18309,3,2,63883,63884,63886,1,3,0
18310,6,1,63889,63889,63890,0,1,3
18311,5,2,63894,63894,63896,0,2,4
18312,3,2,63897,63897,63899,0,2,1
18313,2,2,63899,63899,63901,0,2,0
18314,6,3,63905,63905,63908,0,3,4
18315,2,3,63907,63908,63911,1,4,0
18316,4,3,63911,63911,63914,0,3,0
18317,6,1,63917,63917,63918,0,1,3
18318,5,1,63922,63922,63923,0,1,4
18319,2,1,63924,63924,63925,0,1,1
18320,3,3,63927,63927,63930,0,3,2
18321,3,1,63930,63930,63931,0,1,0
18322,1,2,63931,63931,63933,0,2,0
18323,4,2,63935,63935,63937,0,2,2
18324,3,2,63938,63938,63940,0,2,1
18325,2,1,63940,63940,63941,0,1,0
18326,5,1,63945,63945,63946,0,1,4
18327,4,2,63949,63949,63951,0,2,3
18328,5,3,63954,63954,63957,0,3,3
18329,2,2,63956,63957,63959,1,3,0
18330,1,3,63957,63959,63962,2,5,0
18331,3,1,63960,63962,63963,2,3,0
18332,5,2,63965,63965,63967,0,2,2
18333,3,1,63968,63968,63969,0,1,1
18334,6,1,63974,63974,63975,0,1,5
18335,6,2,63980,63980,63982,0,2,5
18336,1,1,63981,63982,63983,1,2,0
18337,3,3,63984,63984,63987,0,3,1
18338,6,1,63990,63990,63991,0,1,3
18339,1,3,63991,63991,63994,0,3,0
18340,5,1,63996,63996,63997,0,1,2
18341,4,3,64000,64000,64003,0,3,3
18342,4,3,64004,64004,64007,0,3,1
18343,5,2,64009,64009,64011,0,2,2
18344,2,3,64011,64011,64014,0,3,0
18345,6,3,64017,64017,64020,0,3,3
18346,6,1,64023,64023,64024,0,1,3
18347,1,2,64024,64024,64026,0,2,0
18348,2,2,64026,64026,64028,0,2,0
18349,2,2,64028,64028,64030,0,2,0
18350,6,3,64034,64034,64037,0,3,4
18351,5,3,64039,64039,64042,0,3,2
18352,1,2,64040,64042,64044,2,4,0
18353,4,2,64044,64044,64046,0,2,0
18354,5,3,64049,64049,64052,0,3,3
18355,2,3,64051,64052,64055,1,4,0
18356,6,2,64057,64057,64059,0,2,2
18357,4,3,64061,64061,64064,0,3,2
18358,6,3,64067,64067,64070,0,3,3
18359,3,2,64070,64070,64072,0,2,0
18360,1,3,64071,64072,64075,1,4,0
18361,3,3,64074,64075,64078,1,4,0
18362,4,2,64078,64078,64080,0,2,0
18363,6,2,64084,64084,64086,0,2,4
18364,5,2,64089,64089,64091,0,2,3
18365,2,3,64091,64091,64094,0,3,0
18366,1,1,64092,64094,64095,2,3,0
18367,1,3,64093,64095,64098,2,5,0
18368,1,2,64094,64098,64100,4,6,0
18369,3,3,64097,64100,64103,3,6,0
18370,6,3,64103,64103,64106,0,3,0
18371,2,1,64105,64106,64107,1,2,0
18372,6,2,64111,64111,64113,0,2,4
18373,2,3,64113,64113,64116,0,3,0
18374,1,1,64114,64116,64117,2,3,0
18375,5,2,64119,64119,64121,0,2,2
18376,3,1,64122,64122,64123,0,1,1
18377,5,2,64127,64127,64129,0,2,4
18378,1,1,64128,64129,64130,1,2,0
18379,3,3,64131,64131,64134,0,3,1
18380,4,1,64135,64135,64136,0,1,1
18381,5,1,64140,64140,64141,0,1,4
18382,2,3,64142,64142,64145,0,3,1
18383,6,2,64148,64148,64150,0,2,3
18384,3,3,64151,64151,64154,0,3,1
18385,6,2,64157,64157,64159,0,2,3
18386,3,1,64160,64160,64161,0,1,1
18387,2,2,64162,64162,64164,0,2,1
18388,2,2,64164,64164,64166,0,2,0
18389,2,1,64166,64166,64167,0,1,0
18390,5,1,64171,64171,64172,0,1,4
18391,3,3,64174,64174,64177,0,3,2
18392,1,2,64175,64177,64179,2,4,0
18393,3,3,64178,64179,64182,1,4,0
18394,5,1,64183,64183,64184,0,1,1
18395,4,2,64187,64187,64189,0,2,3
18396,6,1,64193,64193,64194,0,1,4
18397,4,3,64197,64197,64200,0,3,3
18398,6,1,64203,64203,64204,0,1,3
18399,2,2,64205,64205,64207,0,2,1
18400,6,2,64211,64211,64213,0,2,4
18401,2,3,64213,64213,64216,0,3,0
18402,3,1,64216,64216,64217,0,1,0
18403,4,3,64220,64220,64223,0,3,3
18404,5,3,64225,64225,64228,0,3,2
18405,3,2,64228,64228,64230,0,2,0
18406,6,2,64234,64234,64236,0,2,4
18407,3,1,64237,64237,64238,0,1,1
18408,3,2,64240,64240,64242,0,2,2
18409,6,2,64246,64246,64248,0,2,4
18410,5,2,64251,64251,64253,0,2,3
18411,1,3,64252,64253,64256,1,4,0
18412,3,1,64255,64256,64257,1,2,0
18413,6,3,64261,64261,64264,0,3,4
18414,1,2,64262,64264,64266,2,4,0
18415,5,3,64267,64267,64270,0,3,1
18416,5,1,64272,64272,64273,0,1,2
18417,4,1,64276,64276,64277,0,1,3
18418,4,3,64280,64280,64283,0,3,3
18419,3,2,64283,64283,64285,0,2,0
18420,2,2,64285,64285,64287,0,2,0
18421,6,3,64291,64291,64294,0,3,4
18422,5,1,64296,64296,64297,0,1,2
18423,2,2,64298,64298,64300,0,2,1
18424,2,1,64300,64300,64301,0,1,0
18425,4,3,64304,64304,64307,0,3,3
18426,2,1,64306,64307,64308,1,2,0
18427,3,1,64309,64309,64310,0,1,1
18428,4,2,64313,64313,64315,0,2,3
18429,6,2,64319,64319,64321,0,2,4
18430,3,2,64322,64322,64324,0,2,1
18431,3,1,64325,64325,64326,0,1,1
18432,3,2,64328,64328,64330,0,2,2
18433,6,2,64334,64334,64336,0,2,4
18434,2,1,64336,64336,64337,0,1,0
18435,2,2,64338,64338,64340,0,2,1
18436,6,3,64344,64344,64347,0,3,4
18437,2,3,64346,64347,64350,1,4,0
18438,1,2,64347,64350,64352,3,5,0
18439,6,3,64353,64353,64356,0,3,1
18440,6,3,64359,64359,64362,0,3,3
18441,4,1,64363,64363,64364,0,1,1
18442,5,2,64368,64368,64370,0,2,4
18443,5,2,64373,64373,64375,0,2,3
18444,5,2,64378,64378,64380,0,2,3
18445,6,2,64384,64384,64386,0,2,4
18446,4,2,64388,64388,64390,0,2,2
18447,6,1,64394,64394,64395,0,1,4
18448,5,2,64399,64399,64401,0,2,4
18449,2,1,64401,64401,64402,0,1,0
18450,2,3,64403,64403,64406,0,3,1
18451,4,3,64407,64407,64410,0,3,1
18452,5,3,64412,64412,64415,0,3,2
18453,2,1,64414,64415,64416,1,2,0
18454,3,3,64417,64417,64420,0,3,1
18455,4,3,64421,64421,64424,0,3,1
18456,6,1,64427,64427,64428,0,1,3
18457,2,1,64429,64429,64430,0,1,1
18458,1,1,64430,64430,64431,0,1,0
18459,6,3,64436,64436,64439,0,3,5
18460,2,2,64438,64439,64441,1,3,0
18461,1,1,64439,64441,64442,2,3,0
18462,5,1,64444,64444,64445,0,1,2
18463,4,1,64448,64448,64449,0,1,3
18464,6,2,64454,64454,64456,0,2,5
18465,5,2,64459,64459,64461,0,2,3
18466,5,2,64464,64464,64466,0,2,3
18467,2,3,64466,64466,64469,0,3,0
18468,1,1,64467,64469,64470,2,3,0
18469,5,1,64472,64472,64473,0,1,2
18470,4,1,64476,64476,64477,0,1,3
18471,2,2,64478,64478,64480,0,2,1
18472,3,2,64481,64481,64483,0,2,1
18473,6,2,64487,64487,64489,0,2,4
18474,4,3,64491,64491,64494,0,3,2
18475,5,3,64496,64496,64499,0,3,2
18476,2,2,64498,64499,64501,1,3,0
18477,3,3,64501,64501,64504,0,3,0
18478,3,1,64504,64504,64505,0,1,0
18479,5,3,64509,64509,64512,0,3,4
18480,2,2,64511,64512,64514,1,3,0
18481,5,2,64516,64516,64518,0,2,2
18482,6,3,64522,64522,64525,0,3,4
18483,6,1,64528,64528,64529,0,1,3
18484,6,3,64534,64534,64537,0,3,5
18485,3,3,64537,64537,64540,0,3,0
18486,4,2,64541,64541,64543,0,2,1
18487,5,1,64546,64546,64547,0,1,3
18488,2,2,64548,64548,64550,0,2,1
18489,3,3,64551,64551,64554,0,3,1
18490,6,3,64557,64557,64560,0,3,3
18491,2,2,64559,64560,64562,1,3,0
18492,2,1,64561,64562,64563,1,2,0
18493,4,2,64565,64565,64567,0,2,2
18494,1,1,64566,64567,64568,1,2,0
18495,2,3,64568,64568,64571,0,3,0
18496,6,3,64574,64574,64577,0,3,3
18497,2,2,64576,64577,64579,1,3,0
18498,4,1,64580,64580,64581,0,1,1
18499,3,1,64583,64583,64584,0,1,2
18500,5,2,64588,64588,64590,0,2,4
18501,3,1,64591,64591,64592,0,1,1
18502,2,2,64593,64593,64595,0,2,1
18503,6,3,64599,64599,64602,0,3,4
18504,5,3,64604,64604,64607,0,3,2
18505,2,1,64606,64607,64608,1,2,0
18506,1,3,64607,64608,64611,1,4,0
18507,3,1,64610,64611,64612,1,2,0
18508,6,2,64616,64616,64618,0,2,4
18509,3,2,64619,64619,64621,0,2,1
18510,4,1,64623,64623,64624,0,1,2
18511,5,2,64628,64628,64630,0,2,4
18512,4,1,64632,64632,64633,0,1,2
18513,4,2,64636,64636,64638,0,2,3
18514,5,2,64641,64641,64643,0,2,3
18515,2,3,64643,64643,64646,0,3,0
18516,1,3,64644,64646,64649,2,5,0
18517,1,3,64645,64649,64652,4,7,0
18518,2,3,64647,64652,64655,5,8,0
18519,6,2,64653,64655,64657,2,4,0
18520,2,3,64655,64657,64660,2,5,0
18521,6,3,64661,64661,64664,0,3,1
18522,4,2,64665,64665,64667,0,2,1
18523,6,3,64671,64671,64674,0,3,4
18524,5,1,64676,64676,64677,0,1,2
18525,1,1,64677,64677,64678,0,1,0
18526,1,3,64678,64678,64681,0,3,0
18527,2,2,64680,64681,64683,1,3,0
18528,5,3,64685,64685,64688,0,3,2
18529,1,1,64686,64688,64689,2,3,0
18530,4,2,64690,64690,64692,0,2,1
18531,5,3,64695,64695,64698,0,3,3
18532,4,2,64699,64699,64701,0,2,1
18533,3,1,64702,64702,64703,0,1,1
18534,6,3,64708,64708,64711,0,3,5
18535,5,1,64713,64713,64714,0,1,2
18536,2,1,64715,64715,64716,0,1,1
18537,4,1,64719,64719,64720,0,1,3
18538,4,2,64723,64723,64725,0,2,3
18539,1,1,64724,64725,64726,1,2,0
18540,1,1,64725,64726,64727,1,2,0
18541,3,2,64728,64728,64730,0,2,1
18542,6,1,64734,64734,64735,0,1,4
18543,5,1,64739,64739,64740,0,1,4
18544,4,1,64743,64743,64744,0,1,3
18545,3,1,64746,64746,64747,0,1,2
18546,3,3,64749,64749,64752,0,3,2
18547,4,2,64753,64753,64755,0,2,1
18548,1,2,64754,64755,64757,1,3,0
18549,4,1,64758,64758,64759,0,1,1
18550,2,2,64760,64760,64762,0,2,1
18551,3,2,64763,64763,64765,0,2,1
18552,4,1,64767,64767,64768,0,1,2
18553,4,3,64771,64771,64774,0,3,3
18554,4,1,64775,64775,64776,0,1,1
18555,1,2,64776,64776,64778,0,2,0
18556,1,2,64777,64778,64780,1,3,0
18557,4,3,64781,64781,64784,0,3,1
18558,5,1,64786,64786,64787,0,1,2
18559,4,3,64790,64790,64793,0,3,3
18560,6,1,64796,64796,64797,0,1,3
18561,5,1,64801,64801,64802,0,1,4
18562,4,1,64805,64805,64806,0,1,3
18563,6,2,64811,64811,64813,0,2,5
18564,1,1,64812,64813,64814,1,2,0
18565,4,3,64816,64816,64819,0,3,2
18566,5,1,64821,64821,64822,0,1,2
18567,6,2,64827,64827,64829,0,2,5
18568,2,1,64829,64829,64830,0,1,0
18569,3,2,64832,64832,64834,0,2,2
18570,1,2,64833,64834,64836,1,3,0
18571,1,1,64834,64836,64837,2,3,0
18572,5,3,64839,64839,64842,0,3,2
18573,3,2,64842,64842,64844,0,2,0
18574,2,2,64844,64844,64846,0,2,0
18575,5,2,64849,64849,64851,0,2,3
18576,3,1,64852,64852,64853,0,1,1
18577,5,3,64857,64857,64860,0,3,4
18578,2,1,64859,64860,64861,1,2,0
18579,3,2,64862,64862,64864,0,2,1
18580,1,2,64863,64864,64866,1,3,0
18581,3,1,64866,64866,64867,0,1,0
18582,6,2,64872,64872,64874,0,2,5
18583,3,3,64875,64875,64878,0,3,1
18584,3,3,64878,64878,64881,0,3,0
18585,3,2,64881,64881,64883,0,2,0
18586,5,2,64886,64886,64888,0,2,3
18587,6,3,64892,64892,64895,0,3,4
18588,3,3,64895,64895,64898,0,3,0
18589,3,2,64898,64898,64900,0,2,0
18590,4,3,64902,64902,64905,0,3,2
18591,2,1,64904,64905,64906,1,2,0
18592,4,2,64908,64908,64910,0,2,2
18593,6,2,64914,64914,64916,0,2,4
18594,6,2,64920,64920,64922,0,2,4
18595,5,1,64925,64925,64926,0,1,3
18596,3,1,64928,64928,64929,0,1,2
18597,1,2,64929,64929,64931,0,2,0
18598,4,3,64933,64933,64936,0,3,2
18599,1,3,64934,64936,64939,2,5,0
18600,5,1,64939,64939,64940,0,1,0
18601,2,1,64941,64941,64942,0,1,1
18602,2,3,64943,64943,64946,0,3,1
18603,3,2,64946,64946,64948,0,2,0
18604,2,1,64948,64948,64949,0,1,0
18605,1,3,64949,64949,64952,0,3,0
18606,4,3,64953,64953,64956,0,3,1
18607,1,3,64954,64956,64959,2,5,0
18608,4,3,64958,64959,64962,1,4,0
18609,6,3,64964,64964,64967,0,3,2
18610,2,2,64966,64967,64969,1,3,0
18611,2,1,64968,64969,64970,1,2,0
18612,2,3,64970,64970,64973,0,3,0
18613,2,3,64972,64973,64976,1,4,0
18614,3,1,64975,64976,64977,1,2,0
18615,1,3,64976,64977,64980,1,4,0
18616,1,3,64977,64980,64983,3,6,0
18617,4,2,64981,64983,64985,2,4,0
18618,1,1,64982,64985,64986,3,4,0
18619,6,3,64988,64988,64991,0,3,2
18620,5,2,64993,64993,64995,0,2,2
18621,2,2,64995,64995,64997,0,2,0
18622,1,1,64996,64997,64998,1,2,0
18623,5,2,65001,65001,65003,0,2,3
18624,1,1,65002,65003,65004,1,2,0
18625,3,2,65005,65005,65007,0,2,1
18626,4,2,65009,65009,65011,0,2,2
18627,1,1,65010,65011,65012,1,2,0
18628,2,3,65012,65012,65015,0,3,0
18629,2,2,65014,65015,65017,1,3,0
18630,1,3,65015,65017,65020,2,5,0
18631,5,2,65020,65020,65022,0,2,0
18632,4,3,65024,65024,65027,0,3,2
18633,1,3,65025,65027,65030,2,5,0
18634,4,3,65029,65030,65033,1,4,0
18635,5,1,65034,65034,65035,0,1,1
18636,5,2,65039,65039,65041,0,2,4
18637,5,3,65044,65044,65047,0,3,3
18638,1,3,65045,65047,65050,2,5,0
18639,4,3,65049,65050,65053,1,4,0
18640,3,1,65052,65053,65054,1,2,0
18641,6,1,65058,65058,65059,0,1,4
18642,2,1,65060,65060,65061,0,1,1
18643,1,2,65061,65061,65063,0,2,0
18644,5,3,65066,65066,65069,0,3,3
18645,1,3,65067,65069,65072,2,5,0
18646,3,1,65070,65072,65073,2,3,0
18647,1,1,65071,65073,65074,2,3,0
18648,6,3,65077,65077,65080,0,3,3
18649,5,1,65082,65082,65083,0,1,2
18650,4,1,65086,65086,65087,0,1,3
18651,5,2,65091,65091,65093,0,2,4
18652,2,1,65093,65093,65094,0,1,0
18653,1,3,65094,65094,65097,0,3,0
18654,2,1,65096,65097,65098,1,2,0
18655,2,3,65098,65098,65101,0,3,0
18656,5,3,65103,65103,65106,0,3,2
18657,3,3,65106,65106,65109,0,3,0
18658,3,3,65109,65109,65112,0,3,0
18659,6,1,65115,65115,65116,0,1,3
18660,6,1,65121,65121,65122,0,1,5
18661,2,1,65123,65123,65124,0,1,1
18662,5,2,65128,65128,65130,0,2,4
18663,3,2,65131,65131,65133,0,2,1
18664,1,2,65132,65133,65135,1,3,0
18665,6,3,65138,65138,65141,0,3,3
18666,2,3,65140,65141,65144,1,4,0
18667,1,3,65141,65144,65147,3,6,0
18668,6,2,65147,65147,65149,0,2,0
18669,1,2,65148,65149,65151,1,3,0
18670,1,2,65149,65151,65153,2,4,0
18671,4,3,65153,65153,65156,0,3,0
18672,3,3,65156,65156,65159,0,3,0
18673,3,3,65159,65159,65162,0,3,0
18674,6,1,65165,65165,65166,0,1,3
18675,3,3,65168,65168,65171,0,3,2
18676,2,1,65170,65171,65172,1,2,0
18677,3,3,65173,65173,65176,0,3,1
18678,3,2,65176,65176,65178,0,2,0
18679,1,2,65177,65178,65180,1,3,0
18680,4,2,65181,65181,65183,0,2,1
18681,2,2,65183,65183,65185,0,2,0
18682,4,3,65187,65187,65190,0,3,2
18683,6,2,65193,65193,65195,0,2,3
18684,1,1,65194,65195,65196,1,2,0
18685,4,3,65198,65198,65201,0,3,2
18686,4,1,65202,65202,65203,0,1,1
18687,2,1,65204,65204,65205,0,1,1
18688,1,3,65205,65205,65208,0,3,0
18689,1,2,65206,65208,65210,2,4,0
18690,2,1,65208,65210,65211,2,3,0
18691,5,1,65213,65213,65214,0,1,2
18692,3,1,65216,65216,65217,0,1,2
18693,3,2,65219,65219,65221,0,2,2
18694,4,3,65223,65223,65226,0,3,2
18695,6,2,65229,65229,65231,0,2,3
18696,2,1,65231,65231,65232,0,1,0
18697,3,3,65234,65234,65237,0,3,2
18698,2,2,65236,65237,65239,1,3,0
18699,1,2,65237,65239,65241,2,4,0
18700,6,2,65243,65243,65245,0,2,2
18701,1,3,65244,65245,65248,1,4,0
18702,6,3,65250,65250,65253,0,3,2
18703,6,3,65256,65256,65259,0,3,3
18704,1,3,65257,65259,65262,2,5,0
18705,4,1,65261,65262,65263,1,2,0
18706,1,2,65262,65263,65265,1,3,0
18707,2,3,65264,65265,65268,1,4,0
18708,1,2,65265,65268,65270,3,5,0
18709,1,1,65266,65270,65271,4,5,0
18710,3,3,65269,65271,65274,2,5,0
18711,2,2,65271,65274,65276,3,5,0
18712,1,2,65272,65276,65278,4,6,0
18713,6,1,65278,65278,65279,0,1,0
18714,3,2,65281,65281,65283,0,2,2
18715,5,3,65286,65286,65289,0,3,3
18716,1,3,65287,65289,65292,2,5,0
18717,6,3,65293,65293,65296,0,3,1
18718,3,1,65296,65296,65297,0,1,0
18719,3,2,65299,65299,65301,0,2,2
18720,5,3,65304,65304,65307,0,3,3
18721,1,3,65305,65307,65310,2,5,0
18722,1,3,65306,65310,65313,4,7,0
18723,3,2,65309,65313,65315,4,6,0
18724,5,3,65314,65315,65318,1,4,0
18725,6,2,65320,65320,65322,0,2,2
18726,6,2,65326,65326,65328,0,2,4
18727,2,3,65328,65328,65331,0,3,0
18728,1,2,65329,65331,65333,2,4,0
18729,2,3,65331,65333,65336,2,5,0
18730,4,3,65335,65336,65339,1,4,0
18731,5,2,65340,65340,65342,0,2,1
18732,1,1,65341,65342,65343,1,2,0
18733,5,2,65346,65346,65348,0,2,3
18734,1,2,65347,65348,65350,1,3,0
18735,5,3,65352,65352,65355,0,3,2
18736,5,1,65357,65357,65358,0,1,2
18737,3,1,65360,65360,65361,0,1,2
18738,6,2,65366,65366,65368,0,2,5
18739,1,1,65367,65368,65369,1,2,0
18740,1,2,65368,65369,65371,1,3,0
18741,2,2,65370,65371,65373,1,3,0
18742,1,1,65371,65373,65374,2,3,0
18743,5,2,65376,65376,65378,0,2,2
18744,2,2,65378,65378,65380,0,2,0
18745,3,2,65381,65381,65383,0,2,1
18746,1,2,65382,65383,65385,1,3,0
18747,3,3,65385,65385,65388,0,3,0
18748,6,2,65391,65391,65393,0,2,3
18749,2,3,65393,65393,65396,0,3,0
18750,4,2,65397,65397,65399,0,2,1
18751,2,2,65399,65399,65401,0,2,0
18752,2,3,65401,65401,65404,0,3,0
18753,3,1,65404,65404,65405,0,1,0
18754,3,2,65407,65407,65409,0,2,2
18755,4,1,65411,65411,65412,0,1,2
18756,5,3,65416,65416,65419,0,3,4
18757,5,3,65421,65421,65424,0,3,2
18758,3,3,65424,65424,65427,0,3,0
18759,3,2,65427,65427,65429,0,2,0
18760,3,3,65430,65430,65433,0,3,1
18761,6,1,65436,65436,65437,0,1,3
18762,5,2,65441,65441,65443,0,2,4
18763,1,1,65442,65443,65444,1,2,0
18764,2,2,65444,65444,65446,0,2,0
18765,1,1,65445,65446,65447,1,2,0
18766,3,3,65448,65448,65451,0,3,1
18767,3,3,65451,65451,65454,0,3,0
18768,4,1,65455,65455,65456,0,1,1
18769,5,2,65460,65460,65462,0,2,4
18770,6,3,65466,65466,65469,0,3,4
18771,6,1,65472,65472,65473,0,1,3
18772,3,2,65475,65475,65477,0,2,2
18773,3,1,65478,65478,65479,0,1,1
18774,4,3,65482,65482,65485,0,3,3
18775,2,1,65484,65485,65486,1,2,0
18776,2,1,65486,65486,65487,0,1,0
18777,1,1,65487,65487,65488,0,1,0
18778,6,3,65493,65493,65496,0,3,5
18779,3,2,65496,65496,65498,0,2,0
18780,4,2,65500,65500,65502,0,2,2
18781,1,2,65501,65502,65504,1,3,0
18782,2,2,65503,65504,65506,1,3,0
18783,4,3,65507,65507,65510,0,3,1
18784,1,3,65508,65510,65513,2,5,0
18785,6,3,65514,65514,65517,0,3,1
18786,1,2,65515,65517,65519,2,4,0
18787,2,3,65517,65519,65522,2,5,0
18788,6,1,65523,65523,65524,0,1,1
18789,5,3,65528,65528,65531,0,3,4
18790,3,2,65531,65531,65533,0,2,0
18791,2,3,65533,65533,65536,0,3,0
18792,2,1,65535,65536,65537,1,2,0
18793,1,2,65536,65537,65539,1,3,0
18794,5,2,65541,65541,65543,0,2,2
18795,5,3,65546,65546,65549,0,3,3
18796,6,2,65552,65552,65554,0,2,3
18797,5,1,65557,65557,65558,0,1,3
18798,2,1,65559,65559,65560,0,1,1
18799,5,3,65564,65564,65567,0,3,4
18800,5,2,65569,65569,65571,0,2,2
18801,1,1,65570,65571,65572,1,2,0
18802,3,2,65573,65573,65575,0,2,1
18803,4,2,65577,65577,65579,0,2,2
18804,3,2,65580,65580,65582,0,2,1
18805,6,3,65586,65586,65589,0,3,4
18806,4,2,65590,65590,65592,0,2,1
18807,5,1,65595,65595,65596,0,1,3
18808,2,1,65597,65597,65598,0,1,1
18809,5,3,65602,65602,65605,0,3,4
18810,5,2,65607,65607,65609,0,2,2
18811,5,3,65612,65612,65615,0,3,3
18812,5,2,65617,65617,65619,0,2,2
18813,1,2,65618,65619,65621,1,3,0
18814,5,1,65623,65623,65624,0,1,2
18815,1,2,65624,65624,65626,0,2,0
18816,6,2,65630,65630,65632,0,2,4
18817,6,2,65636,65636,65638,0,2,4
18818,5,1,65641,65641,65642,0,1,3
18819,6,1,65647,65647,65648,0,1,5
18820,6,1,65653,65653,65654,0,1,5
18821,6,1,65659,65659,65660,0,1,5
18822,3,1,65662,65662,65663,0,1,2
18823,2,1,65664,65664,65665,0,1,1
18824,2,2,65666,65666,65668,0,2,1
18825,2,1,65668,65668,65669,0,1,0
18826,3,3,65671,65671,65674,0,3,2
18827,6,1,65677,65677,65678,0,1,3
18828,3,1,65680,65680,65681,0,1,2
18829,4,1,65684,65684,65685,0,1,3
18830,3,3,65687,65687,65690,0,3,2
18831,4,2,65691,65691,65693,0,2,1
18832,2,3,65693,65693,65696,0,3,0
18833,3,1,65696,65696,65697,0,1,0
18834,3,1,65699,65699,65700,0,1,2
18835,1,3,65700,65700,65703,0,3,0
18836,5,1,65705,65705,65706,0,1,2
18837,6,1,65711,65711,65712,0,1,5
18838,5,3,65716,65716,65719,0,3,4
18839,1,2,65717,65719,65721,2,4,0
18840,1,3,65718,65721,65724,3,6,0
18841,5,2,65723,65724,65726,1,3,0
18842,5,1,65728,65728,65729,0,1,2
18843,2,2,65730,65730,65732,0,2,1
18844,5,3,65735,65735,65738,0,3,3
18845,3,1,65738,65738,65739,0,1,0
18846,2,3,65740,65740,65743,0,3,1
18847,6,1,65746,65746,65747,0,1,3
18848,3,2,65749,65749,65751,0,2,2
18849,2,1,65751,65751,65752,0,1,0
18850,5,3,65756,65756,65759,0,3,4
18851,6,3,65762,65762,65765,0,3,3
18852,2,1,65764,65765,65766,1,2,0
18853,3,1,65767,65767,65768,0,1,1
18854,4,3,65771,65771,65774,0,3,3
18855,5,1,65776,65776,65777,0,1,2
18856,6,2,65782,65782,65784,0,2,5
18857,1,1,65783,65784,65785,1,2,0
18858,3,3,65786,65786,65789,0,3,1
18859,6,3,65792,65792,65795,0,3,3
18860,2,1,65794,65795,65796,1,2,0
18861,3,3,65797,65797,65800,0,3,1
18862,6,2,65803,65803,65805,0,2,3
18863,6,3,65809,65809,65812,0,3,4
18864,4,3,65813,65813,65816,0,3,1
18865,6,2,65819,65819,65821,0,2,3
18866,5,3,65824,65824,65827,0,3,3
18867,3,1,65827,65827,65828,0,1,0
18868,1,3,65828,65828,65831,0,3,0
18869,5,1,65833,65833,65834,0,1,2
18870,1,1,65834,65834,65835,0,1,0
18871,3,1,65837,65837,65838,0,1,2
18872,6,2,65843,65843,65845,0,2,5
18873,3,3,65846,65846,65849,0,3,1
18874,6,1,65852,65852,65853,0,1,3
18875,3,3,65855,65855,65858,0,3,2
18876,1,2,65856,65858,65860,2,4,0
18877,3,2,65859,65860,65862,1,3,0
18878,2,1,65861,65862,65863,1,2,0
18879,3,1,65864,65864,65865,0,1,1
18880,6,1,65870,65870,65871,0,1,5
18881,2,3,65872,65872,65875,0,3,1
18882,2,3,65874,65875,65878,1,4,0
18883,6,2,65880,65880,65882,0,2,2
18884,1,2,65881,65882,65884,1,3,0
18885,6,1,65887,65887,65888,0,1,3
18886,6,1,65893,65893,65894,0,1,5
18887,6,1,65899,65899,65900,0,1,5
18888,6,2,65905,65905,65907,0,2,5
18889,3,2,65908,65908,65910,0,2,1
18890,4,2,65912,65912,65914,0,2,2
18891,6,1,65918,65918,65919,0,1,4
18892,5,1,65923,65923,65924,0,1,4
18893,1,3,65924,65924,65927,0,3,0
18894,6,3,65930,65930,65933,0,3,3
18895,5,3,65935,65935,65938,0,3,2
18896,5,3,65940,65940,65943,0,3,2
18897,1,2,65941,65943,65945,2,4,0
18898,1,1,65942,65945,65946,3,4,0
18899,1,2,65943,65946,65948,3,5,0
18900,4,2,65947,65948,65950,1,3,0
18901,2,2,65949,65950,65952,1,3,0
18902,3,3,65952,65952,65955,0,3,0
18903,3,3,65955,65955,65958,0,3,0
18904,3,3,65958,65958,65961,0,3,0
18905,5,3,65963,65963,65966,0,3,2
18906,1,2,65964,65966,65968,2,4,0
18907,4,3,65968,65968,65971,0,3,0
18908,6,3,65974,65974,65977,0,3,3
18909,3,1,65977,65977,65978,0,1,0
18910,5,2,65982,65982,65984,0,2,4
18911,5,3,65987,65987,65990,0,3,3
18912,4,2,65991,65991,65993,0,2,1
18913,6,3,65997,65997,66000,0,3,4
18914,1,1,65998,66000,66001,2,3,0
18915,5,2,66003,66003,66005,0,2,2
18916,5,1,66008,66008,66009,0,1,3
18917,3,3,66011,66011,66014,0,3,2
18918,3,1,66014,66014,66015,0,1,0
18919,6,2,66020,66020,66022,0,2,5
18920,5,3,66025,66025,66028,0,3,3
18921,4,2,66029,66029,66031,0,2,1
18922,1,2,66030,66031,66033,1,3,0
18923,1,2,66031,66033,66035,2,4,0
18924,2,2,66033,66035,66037,2,4,0
18925,2,2,66035,66037,66039,2,4,0
18926,4,3,66039,66039,66042,0,3,0
18927,3,3,66042,66042,66045,0,3,0
18928,1,3,66043,66045,66048,2,5,0
18929,2,1,66045,66048,66049,3,4,0
18930,2,1,66047,66049,66050,2,3,0
18931,6,3,66053,66053,66056,0,3,3
18932,6,1,66059,66059,66060,0,1,3
18933,3,2,66062,66062,66064,0,2,2
18934,2,3,66064,66064,66067,0,3,0
18935,3,3,66067,66067,66070,0,3,0
18936,1,1,66068,66070,66071,2,3,0
18937,1,3,66069,66071,66074,2,5,0
18938,2,3,66071,66074,66077,3,6,0
18939,4,2,66075,66077,66079,2,4,0
18940,5,1,66080,66080,66081,0,1,1
18941,6,3,66086,66086,66089,0,3,5
18942,3,3,66089,66089,66092,0,3,0
18943,2,1,66091,66092,66093,1,2,0
18944,1,3,66092,66093,66096,1,4,0
18945,2,1,66094,66096,66097,2,3,0
18946,2,1,66096,66097,66098,1,2,0
18947,5,3,66101,66101,66104,0,3,3
18948,5,3,66106,66106,66109,0,3,2
18949,1,3,66107,66109,66112,2,5,0
18950,2,1,66109,66112,66113,3,4,0
18951,5,1,66114,66114,66115,0,1,1
18952,6,2,66120,66120,66122,0,2,5
18953,4,3,66124,66124,66127,0,3,2
18954,6,3,66130,66130,66133,0,3,3
18955,5,2,66135,66135,66137,0,2,2
18956,6,3,66141,66141,66144,0,3,4
18957,4,2,66145,66145,66147,0,2,1
18958,4,2,66149,66149,66151,0,2,2
18959,2,3,66151,66151,66154,0,3,0
18960,3,1,66154,66154,66155,0,1,0
18961,4,1,66158,66158,66159,0,1,3
18962,2,1,66160,66160,66161,0,1,1
18963,6,1,66166,66166,66167,0,1,5
18964,1,2,66167,66167,66169,0,2,0
18965,4,3,66171,66171,66174,0,3,2
18966,4,3,66175,66175,66178,0,3,1
18967,1,3,66176,66178,66181,2,5,0
18968,4,1,66180,66181,66182,1,2,0
18969,3,2,66183,66183,66185,0,2,1
18970,2,2,66185,66185,66187,0,2,0
18971,5,2,66190,66190,66192,0,2,3
18972,1,3,66191,66192,66195,1,4,0
18973,3,1,66194,66195,66196,1,2,0
18974,2,1,66196,66196,66197,0,1,0
18975,4,1,66200,66200,66201,0,1,3
18976,6,1,66206,66206,66207,0,1,5
18977,4,1,66210,66210,66211,0,1,3
18978,1,1,66211,66211,66212,0,1,0
18979,6,1,66217,66217,66218,0,1,5
18980,5,1,66222,66222,66223,0,1,4
18981,5,2,66227,66227,66229,0,2,4
18982,2,2,66229,66229,66231,0,2,0
18983,5,1,66234,66234,66235,0,1,3
18984,3,1,66237,66237,66238,0,1,2
18985,6,1,66243,66243,66244,0,1,5
18986,3,2,66246,66246,66248,0,2,2
18987,4,2,66250,66250,66252,0,2,2
18988,6,1,66256,66256,66257,0,1,4
18989,5,3,66261,66261,66264,0,3,4
18990,2,3,66263,66264,66267,1,4,0
18991,4,3,66267,66267,66270,0,3,0
18992,1,1,66268,66270,66271,2,3,0
18993,3,3,66271,66271,66274,0,3,0
18994,6,3,66277,66277,66280,0,3,3
18995,2,2,66279,66280,66282,1,3,0
18996,1,2,66280,66282,66284,2,4,0
18997,3,1,66283,66284,66285,1,2,0
18998,2,3,66285,66285,66288,0,3,0
18999,2,1,66287,66288,66289,1,2,0
19000,2,2,66289,66289,66291,0,2,0
19001,6,2,66295,66295,66297,0,2,4
19002,6,3,66301,66301,66304,0,3,4
19003,1,1,66302,66304,66305,2,3,0
19004,6,2,66308,66308,66310,0,2,3
19005,6,2,66314,66314,66316,0,2,4
19006,2,2,66316,66316,66318,0,2,0
19007,2,2,66318,66318,66320,0,2,0
19008,2,2,66320,66320,66322,0,2,0
19009,4,3,66324,66324,66327,0,3,2
19010,4,3,66328,66328,66331,0,3,1
19011,4,1,66332,66332,66333,0,1,1
19012,3,2,66335,66335,66337,0,2,2
19013,3,3,66338,66338,66341,0,3,1
19014,1,3,66339,66341,66344,2,5,0
19015,4,2,66343,66344,66346,1,3,0
19016,5,1,66348,66348,66349,0,1,2
19017,4,3,66352,66352,66355,0,3,3
19018,2,1,66354,66355,66356,1,2,0
19019,6,3,66360,66360,66363,0,3,4
19020,3,3,66363,66363,66366,0,3,0
19021,6,1,66369,66369,66370,0,1,3
19022,2,2,66371,66371,66373,0,2,1
19023,5,1,66376,66376,66377,0,1,3
19024,6,2,66382,66382,66384,0,2,5
19025,5,3,66387,66387,66390,0,3,3
19026,4,1,66391,66391,66392,0,1,1
19027,3,2,66394,66394,66396,0,2,2
19028,5,2,66399,66399,66401,0,2,3
19029,3,1,66402,66402,66403,0,1,1
19030,6,2,66408,66408,66410,0,2,5
19031,3,1,66411,66411,66412,0,1,1
19032,6,3,66417,66417,66420,0,3,5
19033,3,3,66420,66420,66423,0,3,0
19034,2,2,66422,66423,66425,1,3,0
19035,1,3,66423,66425,66428,2,5,0
19036,4,3,66427,66428,66431,1,4,0
19037,4,2,66431,66431,66433,0,2,0
19038,2,2,66433,66433,66435,0,2,0
19039,6,3,66439,66439,66442,0,3,4
19040,3,2,66442,66442,66444,0,2,0
19041,5,2,66447,66447,66449,0,2,3
19042,3,3,66450,66450,66453,0,3,1
19043,2,3,66452,66453,66456,1,4,0
19044,1,2,66453,66456,66458,3,5,0
19045,6,3,66459,66459,66462,0,3,1
19046,4,2,66463,66463,66465,0,2,1
19047,4,1,66467,66467,66468,0,1,2
19048,5,2,66472,66472,66474,0,2,4
19049,1,1,66473,66474,66475,1,2,0
19050,5,2,66478,66478,66480,0,2,3
19051,3,3,66481,66481,66484,0,3,1
19052,4,1,66485,66485,66486,0,1,1
19053,2,1,66487,66487,66488,0,1,1
19054,1,2,66488,66488,66490,0,2,0
19055,5,2,66493,66493,66495,0,2,3
19056,3,1,66496,66496,66497,0,1,1
19057,3,2,66499,66499,66501,0,2,2
19058,2,1,66501,66501,66502,0,1,0
19059,5,3,66506,66506,66509,0,3,4
19060,2,3,66508,66509,66512,1,4,0
19061,2,3,66510,66512,66515,2,5,0
19062,3,2,66513,66515,66517,2,4,0
19063,1,1,66514,66517,66518,3,4,0
19064,5,1,66519,66519,66520,0,1,1
19065,2,3,66521,66521,66524,0,3,1
19066,5,2,66526,66526,66528,0,2,2
19067,5,3,66531,66531,66534,0,3,3
19068,2,2,66533,66534,66536,1,3,0
19069,1,1,66534,66536,66537,2,3,0
19070,3,3,66537,66537,66540,0,3,0
19071,4,2,66541,66541,66543,0,2,1
19072,6,2,66547,66547,66549,0,2,4
19073,4,2,66551,66551,66553,0,2,2
19074,2,3,66553,66553,66556,0,3,0
19075,3,2,66556,66556,66558,0,2,0
19076,3,3,66559,66559,66562,0,3,1
19077,6,3,66565,66565,66568,0,3,3
19078,5,2,66570,66570,66572,0,2,2
19079,5,1,66575,66575,66576,0,1,3
19080,5,2,66580,66580,66582,0,2,4
19081,2,2,66582,66582,66584,0,2,0
19082,4,3,66586,66586,66589,0,3,2
19083,1,2,66587,66589,66591,2,4,0
19084,3,2,66590,66591,66593,1,3,0
19085,2,1,66592,66593,66594,1,2,0
19086,4,3,66596,66596,66599,0,3,2
19087,3,1,66599,66599,66600,0,1,0
19088,4,2,66603,66603,66605,0,2,3
19089,2,1,66605,66605,66606,0,1,0
19090,6,2,66611,66611,66613,0,2,5
19091,1,1,66612,66613,66614,1,2,0
19092,3,3,66615,66615,66618,0,3,1
19093,5,2,66620,66620,66622,0,2,2
19094,3,2,66623,66623,66625,0,2,1
19095,3,1,66626,66626,66627,0,1,1
19096,3,2,66629,66629,66631,0,2,2
19097,4,2,66633,66633,66635,0,2,2
19098,6,2,66639,66639,66641,0,2,4
19099,4,2,66643,66643,66645,0,2,2
19100,2,2,66645,66645,66647,0,2,0
19101,4,3,66649,66649,66652,0,3,2
19102,4,3,66653,66653,66656,0,3,1
19103,4,2,66657,66657,66659,0,2,1
19104,3,2,66660,66660,66662,0,2,1
19105,5,2,66665,66665,66667,0,2,3
19106,1,2,66666,66667,66669,1,3,0
19107,1,2,66667,66669,66671,2,4,0
19108,4,3,66671,66671,66674,0,3,0
19109,6,2,66677,66677,66679,0,2,3
19110,6,2,66683,66683,66685,0,2,4
19111,3,1,66686,66686,66687,0,1,1
19112,3,3,66689,66689,66692,0,3,2
19113,2,1,66691,66692,66693,1,2,0
19114,1,3,66692,66693,66696,1,4,0
19115,6,2,66698,66698,66700,0,2,2
19116,3,3,66701,66701,66704,0,3,1
19117,6,2,66707,66707,66709,0,2,3
19118,1,3,66708,66709,66712,1,4,0
19119,6,2,66714,66714,66716,0,2,2
19120,6,3,66720,66720,66723,0,3,4
19121,1,2,66721,66723,66725,2,4,0
19122,1,1,66722,66725,66726,3,4,0
19123,3,1,66725,66726,66727,1,2,0
19124,3,1,66728,66728,66729,0,1,1
19125,6,1,66734,66734,66735,0,1,5
19126,2,1,66736,66736,66737,0,1,1
19127,5,2,66741,66741,66743,0,2,4
19128,6,3,66747,66747,66750,0,3,4
19129,6,2,66753,66753,66755,0,2,3
19130,6,2,66759,66759,66761,0,2,4
19131,1,1,66760,66761,66762,1,2,0
19132,5,3,66765,66765,66768,0,3,3
19133,3,2,66768,66768,66770,0,2,0
19134,5,3,66773,66773,66776,0,3,3
19135,5,1,66778,66778,66779,0,1,2
19136,6,1,66784,66784,66785,0,1,5
19137,4,1,66788,66788,66789,0,1,3
19138,1,2,66789,66789,66791,0,2,0
19139,2,1,66791,66791,66792,0,1,0
19140,4,1,66795,66795,66796,0,1,3
19141,4,1,66799,66799,66800,0,1,3
19142,6,2,66805,66805,66807,0,2,5
19143,6,2,66811,66811,66813,0,2,4
19144,5,3,66816,66816,66819,0,3,3
19145,4,1,66820,66820,66821,0,1,1
19146,3,1,66823,66823,66824,0,1,2
19147,5,3,66828,66828,66831,0,3,4
19148,2,1,66830,66831,66832,1,2,0
19149,1,2,66831,66832,66834,1,3,0
19150,2,1,66833,66834,66835,1,2,0
19151,3,3,66836,66836,66839,0,3,1
19152,2,3,66838,66839,66842,1,4,0
19153,1,2,66839,66842,66844,3,5,0
19154,3,3,66842,66844,66847,2,5,0
19155,1,2,66843,66847,66849,4,6,0
19156,3,3,66846,66849,66852,3,6,0
19157,5,1,66851,66852,66853,1,2,0
19158,5,3,66856,66856,66859,0,3,3
19159,1,1,66857,66859,66860,2,3,0
19160,1,1,66858,66860,66861,2,3,0
19161,4,1,66862,66862,66863,0,1,1
19162,6,1,66868,66868,66869,0,1,5
19163,4,3,66872,66872,66875,0,3,3
19164,5,3,66877,66877,66880,0,3,2
19165,6,1,66883,66883,66884,0,1,3
19166,5,3,66888,66888,66891,0,3,4
19167,2,3,66890,66891,66894,1,4,0
19168,1,2,66891,66894,66896,3,5,0
19169,2,1,66893,66896,66897,3,4,0
19170,4,3,66897,66897,66900,0,3,0
19171,1,3,66898,66900,66903,2,5,0
19172,6,3,66904,66904,66907,0,3,1
19173,6,3,66910,66910,66913,0,3,3
19174,4,3,66914,66914,66917,0,3,1
19175,2,1,66916,66917,66918,1,2,0
19176,3,1,66919,66919,66920,0,1,1
19177,3,3,66922,66922,66925,0,3,2
19178,3,1,66925,66925,66926,0,1,0
19179,6,3,66931,66931,66934,0,3,5
19180,5,2,66936,66936,66938,0,2,2
19181,5,3,66941,66941,66944,0,3,3
19182,6,1,66947,66947,66948,0,1,3
19183,2,1,66949,66949,66950,0,1,1
19184,5,3,66954,66954,66957,0,3,4
19185,2,3,66956,66957,66960,1,4,0
19186,5,2,66961,66961,66963,0,2,1
19187,3,3,66964,66964,66967,0,3,1
19188,1,3,66965,66967,66970,2,5,0
19189,2,2,66967,66970,66972,3,5,0
19190,6,1,66973,66973,66974,0,1,1
19191,1,3,66974,66974,66977,0,3,0
19192,3,2,66977,66977,66979,0,2,0
19193,5,2,66982,66982,66984,0,2,3
19194,5,2,66987,66987,66989,0,2,3
19195,6,2,66993,66993,66995,0,2,4
19196,5,1,66998,66998,66999,0,1,3
19197,1,3,66999,66999,67002,0,3,0
19198,4,2,67003,67003,67005,0,2,1
19199,2,3,67005,67005,67008,0,3,0
19200,5,3,67010,67010,67013,0,3,2
19201,4,2,67014,67014,67016,0,2,1
19202,1,3,67015,67016,67019,1,4,0
19203,3,2,67018,67019,67021,1,3,0
19204,1,2,67019,67021,67023,2,4,0
19205,6,1,67025,67025,67026,0,1,2
19206,3,3,67028,67028,67031,0,3,2
19207,1,3,67029,67031,67034,2,5,0
19208,1,3,67030,67034,67037,4,7,0
19209,4,3,67034,67037,67040,3,6,0
19210,6,2,67040,67040,67042,0,2,0
19211,5,3,67045,67045,67048,0,3,3
19212,2,2,67047,67048,67050,1,3,0
19213,3,1,67050,67050,67051,0,1,0
19214,5,1,67055,67055,67056,0,1,4
19215,5,2,67060,67060,67062,0,2,4
19216,3,2,67063,67063,67065,0,2,1
19217,3,1,67066,67066,67067,0,1,1
19218,1,2,67067,67067,67069,0,2,0
19219,4,2,67071,67071,67073,0,2,2
19220,6,1,67077,67077,67078,0,1,4
19221,2,1,67079,67079,67080,0,1,1
19222,4,1,67083,67083,67084,0,1,3
19223,4,3,67087,67087,67090,0,3,3
19224,5,3,67092,67092,67095,0,3,2
19225,2,3,67094,67095,67098,1,4,0
19226,2,1,67096,67098,67099,2,3,0
19227,6,1,67102,67102,67103,0,1,3
19228,5,3,67107,67107,67110,0,3,4
19229,5,1,67112,67112,67113,0,1,2
19230,3,2,67115,67115,67117,0,2,2
19231,1,3,67116,67117,67120,1,4,0
19232,3,1,67119,67120,67121,1,2,0
19233,5,1,67124,67124,67125,0,1,3
19234,5,3,67129,67129,67132,0,3,4
19235,2,3,67131,67132,67135,1,4,0
19236,3,2,67134,67135,67137,1,3,0
19237,6,3,67140,67140,67143,0,3,3
19238,2,3,67142,67143,67146,1,4,0
19239,3,1,67145,67146,67147,1,2,0
19240,4,1,67149,67149,67150,0,1,2
19241,1,3,67150,67150,67153,0,3,0
19242,2,3,67152,67153,67156,1,4,0
19243,1,2,67153,67156,67158,3,5,0
19244,6,3,67159,67159,67162,0,3,1
19245,2,2,67161,67162,67164,1,3,0
19246,3,1,67164,67164,67165,0,1,0
19247,4,3,67168,67168,67171,0,3,3
19248,5,1,67173,67173,67174,0,1,2
19249,6,2,67179,67179,67181,0,2,5
19250,3,3,67182,67182,67185,0,3,1
19251,1,2,67183,67185,67187,2,4,0
19252,3,3,67186,67187,67190,1,4,0
19253,2,3,67188,67190,67193,2,5,0
19254,6,1,67194,67194,67195,0,1,1
19255,6,2,67200,67200,67202,0,2,5
19256,1,2,67201,67202,67204,1,3,0
19257,4,1,67205,67205,67206,0,1,1
19258,3,3,67208,67208,67211,0,3,2
19259,1,3,67209,67211,67214,2,5,0
19260,5,3,67214,67214,67217,0,3,0
19261,6,1,67220,67220,67221,0,1,3
19262,3,1,67223,67223,67224,0,1,2
19263,4,1,67227,67227,67228,0,1,3
19264,3,1,67230,67230,67231,0,1,2
19265,6,1,67236,67236,67237,0,1,5
19266,4,3,67240,67240,67243,0,3,3
19267,6,1,67246,67246,67247,0,1,3
19268,2,1,67248,67248,67249,0,1,1
19269,2,3,67250,67250,67253,0,3,1
19270,5,3,67255,67255,67258,0,3,2
19271,4,1,67259,67259,67260,0,1,1
19272,1,3,67260,67260,67263,0,3,0
19273,2,1,67262,67263,67264,1,2,0
19274,5,1,67267,67267,67268,0,1,3
19275,6,2,67273,67273,67275,0,2,5
19276,2,2,67275,67275,67277,0,2,0
19277,5,3,67280,67280,67283,0,3,3
19278,3,3,67283,67283,67286,0,3,0
19279,1,2,67284,67286,67288,2,4,0
19280,1,3,67285,67288,67291,3,6,0
19281,2,1,67287,67291,67292,4,5,0
19282,6,3,67293,67293,67296,0,3,1
19283,4,3,67297,67297,67300,0,3,1
19284,3,3,67300,67300,67303,0,3,0
19285,5,1,67305,67305,67306,0,1,2
19286,4,1,67309,67309,67310,0,1,3
19287,4,1,67313,67313,67314,0,1,3
19288,3,2,67316,67316,67318,0,2,2
19289,6,3,67322,67322,67325,0,3,4
19290,2,2,67324,67325,67327,1,3,0
19291,4,1,67328,67328,67329,0,1,1
19292,2,2,67330,67330,67332,0,2,1
19293,4,3,67334,67334,67337,0,3,2
19294,3,3,67337,67337,67340,0,3,0
19295,2,1,67339,67340,67341,1,2,0
19296,3,2,67342,67342,67344,0,2,1
19297,3,3,67345,67345,67348,0,3,1
19298,2,3,67347,67348,67351,1,4,0
19299,4,1,67351,67351,67352,0,1,0
19300,6,1,67357,67357,67358,0,1,5
19301,6,3,67363,67363,67366,0,3,5
19302,2,1,67365,67366,67367,1,2,0
19303,1,2,67366,67367,67369,1,3,0
19304,6,2,67372,67372,67374,0,2,3
19305,5,2,67377,67377,67379,0,2,3
19306,1,1,67378,67379,67380,1,2,0
19307,2,2,67380,67380,67382,0,2,0
19308,1,2,67381,67382,67384,1,3,0
19309,6,1,67387,67387,67388,0,1,3
19310,4,3,67391,67391,67394,0,3,3
19311,1,3,67392,67394,67397,2,5,0
19312,2,2,67394,67397,67399,3,5,0
19313,5,3,67399,67399,67402,0,3,0
19314,6,2,67405,67405,67407,0,2,3
19315,3,3,67408,67408,67411,0,3,1
19316,3,3,67411,67411,67414,0,3,0
19317,6,3,67417,67417,67420,0,3,3
19318,2,2,67419,67420,67422,1,3,0
19319,5,1,67424,67424,67425,0,1,2
19320,2,3,67426,67426,67429,0,3,1
19321,6,2,67432,67432,67434,0,2,3
19322,1,2,67433,67434,67436,1,3,0
19323,6,1,67439,67439,67440,0,1,3
19324,6,3,67445,67445,67448,0,3,5
19325,5,2,67450,67450,67452,0,2,2
19326,3,3,67453,67453,67456,0,3,1
19327,6,2,67459,67459,67461,0,2,3
19328,1,1,67460,67461,67462,1,2,0
19329,2,2,67462,67462,67464,0,2,0
19330,5,3,67467,67467,67470,0,3,3
19331,2,2,67469,67470,67472,1,3,0
19332,6,3,67475,67475,67478,0,3,3
19333,4,3,67479,67479,67482,0,3,1
19334,3,1,67482,67482,67483,0,1,0
19335,4,1,67486,67486,67487,0,1,3
19336,5,2,67491,67491,67493,0,2,4
19337,3,2,67494,67494,67496,0,2,1
19338,1,1,67495,67496,67497,1,2,0
19339,3,1,67498,67498,67499,0,1,1
19340,4,1,67502,67502,67503,0,1,3
19341,5,1,67507,67507,67508,0,1,4
19342,4,2,67511,67511,67513,0,2,3
19343,5,2,67516,67516,67518,0,2,3
19344,4,2,67520,67520,67522,0,2,2
19345,5,1,67525,67525,67526,0,1,3
19346,4,1,67529,67529,67530,0,1,3
19347,5,2,67534,67534,67536,0,2,4
19348,6,3,67540,67540,67543,0,3,4
19349,1,2,67541,67543,67545,2,4,0
19350,6,1,67547,67547,67548,0,1,2
19351,4,3,67551,67551,67554,0,3,3
19352,1,2,67552,67554,67556,2,4,0
19353,2,3,67554,67556,67559,2,5,0
19354,2,2,67556,67559,67561,3,5,0
19355,1,2,67557,67561,67563,4,6,0
19356,1,2,67558,67563,67565,5,7,0
19357,1,3,67559,67565,67568,6,9,0
19358,2,3,67561,67568,67571,7,10,0
19359,4,2,67565,67571,67573,6,8,0
19360,4,3,67569,67573,67576,4,7,0
19361,2,1,67571,67576,67577,5,6,0
19362,3,3,67574,67577,67580,3,6,0
19363,1,1,67575,67580,67581,5,6,0
19364,6,1,67581,67581,67582,0,1,0
19365,5,1,67586,67586,67587,0,1,4
19366,6,2,67592,67592,67594,0,2,5
19367,1,2,67593,67594,67596,1,3,0
19368,4,3,67597,67597,67600,0,3,1
19369,4,1,67601,67601,67602,0,1,1
19370,3,3,67604,67604,67607,0,3,2
19371,6,2,67610,67610,67612,0,2,3
19372,4,3,67614,67614,67617,0,3,2
19373,3,1,67617,67617,67618,0,1,0
19374,3,3,67620,67620,67623,0,3,2
19375,6,1,67626,67626,67627,0,1,3
19376,6,1,67632,67632,67633,0,1,5
19377,4,3,67636,67636,67639,0,3,3
19378,1,1,67637,67639,67640,2,3,0
19379,4,1,67641,67641,67642,0,1,1
19380,1,3,67642,67642,67645,0,3,0
19381,2,2,67644,67645,67647,1,3,0
19382,3,3,67647,67647,67650,0,3,0
19383,3,3,67650,67650,67653,0,3,0
19384,4,2,67654,67654,67656,0,2,1
19385,1,3,67655,67656,67659,1,4,0
19386,3,2,67658,67659,67661,1,3,0
19387,5,1,67663,67663,67664,0,1,2
19388,2,1,67665,67665,67666,0,1,1
19389,6,3,67671,67671,67674,0,3,5
19390,1,1,67672,67674,67675,2,3,0
19391,6,3,67678,67678,67681,0,3,3
19392,6,2,67684,67684,67686,0,2,3
19393,6,2,67690,67690,67692,0,2,4
19394,5,2,67695,67695,67697,0,2,3
19395,2,3,67697,67697,67700,0,3,0
19396,3,3,67700,67700,67703,0,3,0
19397,5,3,67705,67705,67708,0,3,2
19398,4,3,67709,67709,67712,0,3,1
19399,3,3,67712,67712,67715,0,3,0
19400,5,3,67717,67717,67720,0,3,2
19401,5,2,67722,67722,67724,0,2,2
19402,4,1,67726,67726,67727,0,1,2
19403,5,3,67731,67731,67734,0,3,4
19404,5,3,67736,67736,67739,0,3,2
19405,3,1,67739,67739,67740,0,1,0
19406,6,3,67745,67745,67748,0,3,5
19407,4,1,67749,67749,67750,0,1,1
19408,5,1,67754,67754,67755,0,1,4
19409,3,2,67757,67757,67759,0,2,2
19410,1,1,67758,67759,67760,1,2,0
19411,4,3,67762,67762,67765,0,3,2
19412,2,2,67764,67765,67767,1,3,0
19413,1,3,67765,67767,67770,2,5,0
19414,5,3,67770,67770,67773,0,3,0
19415,1,1,67771,67773,67774,2,3,0
19416,4,2,67775,67775,67777,0,2,1
19417,6,1,67781,67781,67782,0,1,4
19418,2,2,67783,67783,67785,0,2,1
19419,2,2,67785,67785,67787,0,2,0
19420,2,2,67787,67787,67789,0,2,0
19421,6,2,67793,67793,67795,0,2,4
19422,4,2,67797,67797,67799,0,2,2
19423,6,2,67803,67803,67805,0,2,4
19424,6,3,67809,67809,67812,0,3,4
19425,5,2,67814,67814,67816,0,2,2
19426,2,1,67816,67816,67817,0,1,0
19427,5,2,67821,67821,67823,0,2,4
19428,1,1,67822,67823,67824,1,2,0
19429,5,2,67827,67827,67829,0,2,3
19430,5,2,67832,67832,67834,0,2,3
19431,1,3,67833,67834,67837,1,4,0
19432,3,2,67836,67837,67839,1,3,0
19433,6,1,67842,67842,67843,0,1,3
19434,4,3,67846,67846,67849,0,3,3
19435,4,3,67850,67850,67853,0,3,1
19436,5,1,67855,67855,67856,0,1,2
19437,4,1,67859,67859,67860,0,1,3
19438,4,3,67863,67863,67866,0,3,3
19439,6,1,67869,67869,67870,0,1,3
19440,6,2,67875,67875,67877,0,2,5
19441,6,2,67881,67881,67883,0,2,4
19442,6,1,67887,67887,67888,0,1,4
19443,6,2,67893,67893,67895,0,2,5
19444,6,2,67899,67899,67901,0,2,4
19445,6,2,67905,67905,67907,0,2,4
19446,4,3,67909,67909,67912,0,3,2
19447,2,3,67911,67912,67915,1,4,0
19448,5,2,67916,67916,67918,0,2,1
19449,6,2,67922,67922,67924,0,2,4
19450,6,3,67928,67928,67931,0,3,4
19451,4,1,67932,67932,67933,0,1,1
19452,5,2,67937,67937,67939,0,2,4
19453,6,1,67943,67943,67944,0,1,4
19454,6,1,67949,67949,67950,0,1,5
19455,3,3,67952,67952,67955,0,3,2
19456,6,1,67958,67958,67959,0,1,3
19457,5,1,67963,67963,67964,0,1,4
19458,4,3,67967,67967,67970,0,3,3
19459,4,2,67971,67971,67973,0,2,1
19460,3,1,67974,67974,67975,0,1,1
19461,5,2,67979,67979,67981,0,2,4
19462,1,3,67980,67981,67984,1,4,0
19463,3,2,67983,67984,67986,1,3,0
19464,6,2,67989,67989,67991,0,2,3
19465,6,2,67995,67995,67997,0,2,4
19466,5,3,68000,68000,68003,0,3,3
19467,3,1,68003,68003,68004,0,1,0
19468,3,1,68006,68006,68007,0,1,2
19469,1,2,68007,68007,68009,0,2,0
19470,4,3,68011,68011,68014,0,3,2
19471,5,2,68016,68016,68018,0,2,2
19472,6,1,68022,68022,68023,0,1,4
19473,5,3,68027,68027,68030,0,3,4
19474,3,1,68030,68030,68031,0,1,0
19475,2,3,68032,68032,68035,0,3,1
19476,2,2,68034,68035,68037,1,3,0
19477,5,3,68039,68039,68042,0,3,2
19478,3,2,68042,68042,68044,0,2,0
19479,1,2,68043,68044,68046,1,3,0
19480,4,1,68047,68047,68048,0,1,1
19481,6,2,68053,68053,68055,0,2,5
19482,1,3,68054,68055,68058,1,4,0
19483,1,1,68055,68058,68059,3,4,0
19484,3,2,68058,68059,68061,1,3,0
19485,6,1,68064,68064,68065,0,1,3
19486,3,1,68067,68067,68068,0,1,2
19487,6,2,68073,68073,68075,0,2,5
19488,6,3,68079,68079,68082,0,3,4
19489,4,3,68083,68083,68086,0,3,1
19490,5,3,68088,68088,68091,0,3,2
19491,1,1,68089,68091,68092,2,3,0
19492,3,1,68092,68092,68093,0,1,0
19493,1,3,68093,68093,68096,0,3,0
19494,4,2,68097,68097,68099,0,2,1
19495,6,1,68103,68103,68104,0,1,4
19496,6,3,68109,68109,68112,0,3,5
19497,2,3,68111,68112,68115,1,4,0
19498,6,1,68117,68117,68118,0,1,2
19499,3,1,68120,68120,68121,0,1,2
19500,1,3,68121,68121,68124,0,3,0
19501,5,2,68126,68126,68128,0,2,2
19502,3,1,68129,68129,68130,0,1,1
19503,1,2,68130,68130,68132,0,2,0
19504,2,1,68132,68132,68133,0,1,0
19505,6,1,68138,68138,68139,0,1,5
19506,5,1,68143,68143,68144,0,1,4
19507,4,2,68147,68147,68149,0,2,3
19508,5,2,68152,68152,68154,0,2,3
19509,2,2,68154,68154,68156,0,2,0
19510,3,1,68157,68157,68158,0,1,1
19511,1,2,68158,68158,68160,0,2,0
19512,1,2,68159,68160,68162,1,3,0
19513,2,3,68161,68162,68165,1,4,0
19514,6,3,68167,68167,68170,0,3,2
19515,1,2,68168,68170,68172,2,4,0
19516,2,2,68170,68172,68174,2,4,0
19517,2,1,68172,68174,68175,2,3,0
19518,6,3,68178,68178,68181,0,3,3
19519,4,1,68182,68182,68183,0,1,1
19520,3,3,68185,68185,68188,0,3,2
19521,1,3,68186,68188,68191,2,5,0
19522,2,3,68188,68191,68194,3,6,0
19523,3,2,68191,68194,68196,3,5,0
19524,6,3,68197,68197,68200,0,3,1
19525,3,3,68200,68200,68203,0,3,0
19526,5,3,68205,68205,68208,0,3,2
19527,4,3,68209,68209,68212,0,3,1
19528,6,3,68215,68215,68218,0,3,3
19529,3,1,68218,68218,68219,0,1,0
19530,1,2,68219,68219,68221,0,2,0
19531,5,2,68224,68224,68226,0,2,3
19532,6,2,68230,68230,68232,0,2,4
19533,3,2,68233,68233,68235,0,2,1
19534,6,3,68239,68239,68242,0,3,4
19535,2,1,68241,68242,68243,1,2,0
19536,1,2,68242,68243,68245,1,3,0
19537,2,1,68244,68245,68246,1,2,0
19538,1,1,68245,68246,68247,1,2,0
19539,5,3,68250,68250,68253,0,3,3
19540,5,3,68255,68255,68258,0,3,2
19541,4,3,68259,68259,68262,0,3,1
19542,1,3,68260,68262,68265,2,5,0
19543,5,2,68265,68265,68267,0,2,0
19544,5,2,68270,68270,68272,0,2,3
19545,2,2,68272,68272,68274,0,2,0
19546,3,2,68275,68275,68277,0,2,1
19547,1,1,68276,68277,68278,1,2,0
19548,2,2,68278,68278,68280,0,2,0
19549,2,2,68280,68280,68282,0,2,0
19550,6,1,68286,68286,68287,0,1,4
19551,4,3,68290,68290,68293,0,3,3
19552,1,3,68291,68293,68296,2,5,0
19553,4,2,68295,68296,68298,1,3,0
19554,6,3,68301,68301,68304,0,3,3
19555,6,3,68307,68307,68310,0,3,3
19556,3,3,68310,68310,68313,0,3,0
19557,5,3,68315,68315,68318,0,3,2
19558,5,1,68320,68320,68321,0,1,2
19559,3,2,68323,68323,68325,0,2,2
19560,6,3,68329,68329,68332,0,3,4
19561,4,3,68333,68333,68336,0,3,1
19562,2,2,68335,68336,68338,1,3,0
19563,2,2,68337,68338,68340,1,3,0
19564,3,1,68340,68340,68341,0,1,0
19565,1,3,68341,68341,68344,0,3,0
19566,2,2,68343,68344,68346,1,3,0
19567,2,1,68345,68346,68347,1,2,0
19568,1,2,68346,68347,68349,1,3,0
19569,5,2,68351,68351,68353,0,2,2
19570,5,1,68356,68356,68357,0,1,3
19571,1,1,68357,68357,68358,0,1,0
19572,6,2,68363,68363,68365,0,2,5
19573,6,1,68369,68369,68370,0,1,4
19574,3,1,68372,68372,68373,0,1,2
19575,4,1,68376,68376,68377,0,1,3
19576,5,1,68381,68381,68382,0,1,4
19577,1,3,68382,68382,68385,0,3,0
19578,5,1,68387,68387,68388,0,1,2
19579,1,2,68388,68388,68390,0,2,0
19580,1,2,68389,68390,68392,1,3,0
19581,4,1,68393,68393,68394,0,1,1
19582,3,1,68396,68396,68397,0,1,2
19583,4,3,68400,68400,68403,0,3,3
19584,4,1,68404,68404,68405,0,1,1
19585,1,3,68405,68405,68408,0,3,0
19586,3,2,68408,68408,68410,0,2,0
19587,4,2,68412,68412,68414,0,2,2
19588,1,3,68413,68414,68417,1,4,0
19589,3,2,68416,68417,68419,1,3,0
19590,3,3,68419,68419,68422,0,3,0
19591,2,1,68421,68422,68423,1,2,0
19592,6,1,68427,68427,68428,0,1,4
19593,2,2,68429,68429,68431,0,2,1
19594,1,2,68430,68431,68433,1,3,0
19595,4,1,68434,68434,68435,0,1,1
19596,1,3,68435,68435,68438,0,3,0
19597,6,3,68441,68441,68444,0,3,3
19598,1,1,68442,68444,68445,2,3,0
19599,6,1,68448,68448,68449,0,1,3
19600,4,3,68452,68452,68455,0,3,3
19601,5,1,68457,68457,68458,0,1,2
19602,2,2,68459,68459,68461,0,2,1
19603,6,2,68465,68465,68467,0,2,4
19604,6,1,68471,68471,68472,0,1,4
19605,5,3,68476,68476,68479,0,3,4
19606,3,2,68479,68479,68481,0,2,0
19607,1,2,68480,68481,68483,1,3,0
19608,3,3,68483,68483,68486,0,3,0
19609,3,1,68486,68486,68487,0,1,0
19610,5,3,68491,68491,68494,0,3,4
19611,1,2,68492,68494,68496,2,4,0
19612,1,1,68493,68496,68497,3,4,0
19613,3,3,68496,68497,68500,1,4,0
19614,1,2,68497,68500,68502,3,5,0
19615,5,2,68502,68502,68504,0,2,0
19616,1,3,68503,68504,68507,1,4,0
19617,3,3,68506,68507,68510,1,4,0
19618,2,1,68508,68510,68511,2,3,0
19619,4,3,68512,68512,68515,0,3,1
19620,1,1,68513,68515,68516,2,3,0
19621,4,3,68517,68517,68520,0,3,1
19622,1,3,68518,68520,68523,2,5,0
19623,2,3,68520,68523,68526,3,6,0
19624,6,1,68526,68526,68527,0,1,0
19625,3,2,68529,68529,68531,0,2,2
19626,6,2,68535,68535,68537,0,2,4
19627,5,2,68540,68540,68542,0,2,3
19628,3,3,68543,68543,68546,0,3,1
19629,1,3,68544,68546,68549,2,5,0
19630,2,3,68546,68549,68552,3,6,0
19631,5,3,68551,68552,68555,1,4,0
19632,4,3,68555,68555,68558,0,3,0
19633,3,3,68558,68558,68561,0,3,0
19634,1,2,68559,68561,68563,2,4,0
19635,5,2,68564,68564,68566,0,2,1
19636,4,3,68568,68568,68571,0,3,2
19637,4,1,68572,68572,68573,0,1,1
19638,3,2,68575,68575,68577,0,2,2
19639,6,3,68581,68581,68584,0,3,4
19640,5,3,68586,68586,68589,0,3,2
19641,6,2,68592,68592,68594,0,2,3
19642,3,2,68595,68595,68597,0,2,1
19643,6,1,68601,68601,68602,0,1,4
19644,6,2,68607,68607,68609,0,2,5
19645,6,2,68613,68613,68615,0,2,4
19646,5,1,68618,68618,68619,0,1,3
19647,1,1,68619,68619,68620,0,1,0
19648,4,2,68623,68623,68625,0,2,3
19649,1,1,68624,68625,68626,1,2,0
19650,4,1,68628,68628,68629,0,1,2
19651,1,2,68629,68629,68631,0,2,0
19652,6,1,68635,68635,68636,0,1,4
19653,1,3,68636,68636,68639,0,3,0
19654,3,2,68639,68639,68641,0,2,0
19655,4,2,68643,68643,68645,0,2,2
19656,1,2,68644,68645,68647,1,3,0
19657,2,3,68646,68647,68650,1,4,0
19658,5,1,68651,68651,68652,0,1,1
19659,1,2,68652,68652,68654,0,2,0
19660,3,1,68655,68655,68656,0,1,1
19661,4,2,68659,68659,68661,0,2,3
19662,3,1,68662,68662,68663,0,1,1
19663,3,3,68665,68665,68668,0,3,2
19664,5,3,68670,68670,68673,0,3,2
19665,2,3,68672,68673,68676,1,4,0
19666,2,2,68674,68676,68678,2,4,0
19667,5,2,68679,68679,68681,0,2,1
19668,3,3,68682,68682,68685,0,3,1
19669,1,1,68683,68685,68686,2,3,0
19670,1,1,68684,68686,68687,2,3,0
19671,2,3,68686,68687,68690,1,4,0
19672,1,1,68687,68690,68691,3,4,0
19673,1,3,68688,68691,68694,3,6,0
19674,2,2,68690,68694,68696,4,6,0
19675,6,2,68696,68696,68698,0,2,0
19676,2,3,68698,68698,68701,0,3,0
19677,2,1,68700,68701,68702,1,2,0
19678,5,3,68705,68705,68708,0,3,3
19679,3,2,68708,68708,68710,0,2,0
19680,5,1,68713,68713,68714,0,1,3
19681,2,1,68715,68715,68716,0,1,1
19682,2,1,68717,68717,68718,0,1,1
19683,1,2,68718,68718,68720,0,2,0
19684,6,2,68724,68724,68726,0,2,4
19685,4,3,68728,68728,68731,0,3,2
19686,2,2,68730,68731,68733,1,3,0
19687,6,1,68736,68736,68737,0,1,3
19688,4,2,68740,68740,68742,0,2,3
19689,6,2,68746,68746,68748,0,2,4
19690,4,1,68750,68750,68751,0,1,2
19691,4,2,68754,68754,68756,0,2,3
19692,6,1,68760,68760,68761,0,1,4
19693,6,1,68766,68766,68767,0,1,5
19694,3,3,68769,68769,68772,0,3,2
19695,6,3,68775,68775,68778,0,3,3
19696,4,2,68779,68779,68781,0,2,1
19697,5,2,68784,68784,68786,0,2,3
19698,2,3,68786,68786,68789,0,3,0
19699,2,3,68788,68789,68792,1,4,0
19700,1,2,68789,68792,68794,3,5,0
19701,3,2,68792,68794,68796,2,4,0
19702,4,3,68796,68796,68799,0,3,0
19703,3,1,68799,68799,68800,0,1,0
19704,2,2,68801,68801,68803,0,2,1
19705,1,3,68802,68803,68806,1,4,0
19706,5,3,68807,68807,68810,0,3,1
19707,1,2,68808,68810,68812,2,4,0
19708,3,3,68811,68812,68815,1,4,0
19709,3,1,68814,68815,68816,1,2,0
19710,3,2,68817,68817,68819,0,2,1
19711,3,2,68820,68820,68822,0,2,1
19712,3,3,68823,68823,68826,0,3,1
19713,5,2,68828,68828,68830,0,2,2
19714,4,1,68832,68832,68833,0,1,2
19715,4,1,68836,68836,68837,0,1,3
19716,2,2,68838,68838,68840,0,2,1
19717,6,1,68844,68844,68845,0,1,4
19718,1,2,68845,68845,68847,0,2,0
19719,1,2,68846,68847,68849,1,3,0
19720,1,2,68847,68849,68851,2,4,0
19721,4,1,68851,68851,68852,0,1,0
19722,2,1,68853,68853,68854,0,1,1
19723,3,2,68856,68856,68858,0,2,2
19724,6,2,68862,68862,68864,0,2,4
19725,2,1,68864,68864,68865,0,1,0
19726,2,1,68866,68866,68867,0,1,1
19727,4,1,68870,68870,68871,0,1,3
19728,3,2,68873,68873,68875,0,2,2
19729,5,2,68878,68878,68880,0,2,3
19730,6,1,68884,68884,68885,0,1,4
19731,1,1,68885,68885,68886,0,1,0
19732,4,2,68889,68889,68891,0,2,3
19733,6,3,68895,68895,68898,0,3,4
19734,2,3,68897,68898,68901,1,4,0
19735,5,1,68902,68902,68903,0,1,1
19736,3,3,68905,68905,68908,0,3,2
19737,3,2,68908,68908,68910,0,2,0
19738,1,2,68909,68910,68912,1,3,0
19739,4,1,68913,68913,68914,0,1,1
19740,1,3,68914,68914,68917,0,3,0
19741,6,1,68920,68920,68921,0,1,3
19742,5,2,68925,68925,68927,0,2,4
19743,6,1,68931,68931,68932,0,1,4
19744,1,3,68932,68932,68935,0,3,0
19745,2,2,68934,68935,68937,1,3,0
19746,6,2,68940,68940,68942,0,2,3
19747,4,3,68944,68944,68947,0,3,2
19748,4,1,68948,68948,68949,0,1,1
19749,2,2,68950,68950,68952,0,2,1
19750,5,2,68955,68955,68957,0,2,3
19751,5,3,68960,68960,68963,0,3,3
19752,4,3,68964,68964,68967,0,3,1
19753,1,2,68965,68967,68969,2,4,0
19754,5,3,68970,68970,68973,0,3,1
19755,1,3,68971,68973,68976,2,5,0
19756,3,1,68974,68976,68977,2,3,0
19757,5,1,68979,68979,68980,0,1,2
19758,2,1,68981,68981,68982,0,1,1
19759,3,2,68984,68984,68986,0,2,2
19760,1,2,68985,68986,68988,1,3,0
19761,5,3,68990,68990,68993,0,3,2
19762,4,2,68994,68994,68996,0,2,1
19763,5,2,68999,68999,69001,0,2,3
19764,6,2,69005,69005,69007,0,2,4
19765,2,3,69007,69007,69010,0,3,0
19766,2,1,69009,69010,69011,1,2,0
19767,1,3,69010,69011,69014,1,4,0
19768,3,1,69013,69014,69015,1,2,0
19769,6,1,69019,69019,69020,0,1,4
19770,1,3,69020,69020,69023,0,3,0
19771,6,3,69026,69026,69029,0,3,3
19772,5,1,69031,69031,69032,0,1,2
19773,3,1,69034,69034,69035,0,1,2
19774,6,3,69040,69040,69043,0,3,5
19775,5,1,69045,69045,69046,0,1,2
19776,5,3,69050,69050,69053,0,3,4
19777,5,2,69055,69055,69057,0,2,2
19778,3,2,69058,69058,69060,0,2,1
19779,5,1,69063,69063,69064,0,1,3
19780,2,1,69065,69065,69066,0,1,1
19781,5,3,69070,69070,69073,0,3,4
19782,1,2,69071,69073,69075,2,4,0
19783,1,2,69072,69075,69077,3,5,0
19784,2,3,69074,69077,69080,3,6,0
19785,5,2,69079,69080,69082,1,3,0
19786,5,1,69084,69084,69085,0,1,2
19787,4,1,69088,69088,69089,0,1,3
19788,5,3,69093,69093,69096,0,3,4
19789,3,1,69096,69096,69097,0,1,0
19790,6,3,69102,69102,69105,0,3,5
19791,4,3,69106,69106,69109,0,3,1
19792,1,1,69107,69109,69110,2,3,0
19793,3,2,69110,69110,69112,0,2,0
19794,3,2,69113,69113,69115,0,2,1
19795,1,1,69114,69115,69116,1,2,0
19796,3,3,69117,69117,69120,0,3,1
19797,5,2,69122,69122,69124,0,2,2
19798,1,2,69123,69124,69126,1,3,0
19799,4,2,69127,69127,69129,0,2,1
19800,1,1,69128,69129,69130,1,2,0
19801,3,3,69131,69131,69134,0,3,1
19802,6,2,69137,69137,69139,0,2,3
19803,2,3,69139,69139,69142,0,3,0
19804,4,2,69143,69143,69145,0,2,1
19805,3,3,69146,69146,69149,0,3,1
19806,3,2,69149,69149,69151,0,2,0
19807,3,1,69152,69152,69153,0,1,1
19808,3,1,69155,69155,69156,0,1,2
19809,4,3,69159,69159,69162,0,3,3
19810,1,2,69160,69162,69164,2,4,0
19811,1,3,69161,69164,69167,3,6,0
19812,3,3,69164,69167,69170,3,6,0
19813,5,3,69169,69170,69173,1,4,0
19814,5,1,69174,69174,69175,0,1,1
19815,2,1,69176,69176,69177,0,1,1
19816,1,3,69177,69177,69180,0,3,0
19817,1,2,69178,69180,69182,2,4,0
19818,5,1,69183,69183,69184,0,1,1
19819,4,1,69187,69187,69188,0,1,3
19820,5,1,69192,69192,69193,0,1,4
19821,6,2,69198,69198,69200,0,2,5
19822,5,1,69203,69203,69204,0,1,3
19823,5,2,69208,69208,69210,0,2,4
19824,6,2,69214,69214,69216,0,2,4
19825,4,2,69218,69218,69220,0,2,2
19826,5,3,69223,69223,69226,0,3,3
19827,4,3,69227,69227,69230,0,3,1
19828,3,2,69230,69230,69232,0,2,0
19829,4,2,69234,69234,69236,0,2,2
19830,1,1,69235,69236,69237,1,2,0
19831,5,1,69240,69240,69241,0,1,3
19832,4,3,69244,69244,69247,0,3,3
19833,1,3,69245,69247,69250,2,5,0
19834,3,3,69248,69250,69253,2,5,0
19835,1,2,69249,69253,69255,4,6,0
19836,3,1,69252,69255,69256,3,4,0
19837,2,2,69254,69256,69258,2,4,0
19838,3,1,69257,69258,69259,1,2,0
19839,2,3,69259,69259,69262,0,3,0
19840,3,2,69262,69262,69264,0,2,0
19841,2,1,69264,69264,69265,0,1,0
19842,3,2,69267,69267,69269,0,2,2
19843,5,3,69272,69272,69275,0,3,3
19844,4,3,69276,69276,69279,0,3,1
19845,2,2,69278,69279,69281,1,3,0
19846,2,2,69280,69281,69283,1,3,0
19847,6,1,69286,69286,69287,0,1,3
19848,6,1,69292,69292,69293,0,1,5
19849,1,3,69293,69293,69296,0,3,0
19850,1,1,69294,69296,69297,2,3,0
19851,2,1,69296,69297,69298,1,2,0
19852,5,2,69301,69301,69303,0,2,3
19853,1,3,69302,69303,69306,1,4,0
19854,4,3,69306,69306,69309,0,3,0
19855,2,1,69308,69309,69310,1,2,0
19856,6,2,69314,69314,69316,0,2,4
19857,3,1,69317,69317,69318,0,1,1
19858,5,3,69322,69322,69325,0,3,4
19859,1,3,69323,69325,69328,2,5,0
19860,6,2,69329,69329,69331,0,2,1
19861,2,1,69331,69331,69332,0,1,0
19862,6,3,69337,69337,69340,0,3,5
19863,6,2,69343,69343,69345,0,2,3
19864,2,2,69345,69345,69347,0,2,0
19865,2,1,69347,69347,69348,0,1,0
19866,2,2,69349,69349,69351,0,2,1
19867,6,2,69355,69355,69357,0,2,4
19868,4,3,69359,69359,69362,0,3,2
19869,4,1,69363,69363,69364,0,1,1
19870,2,2,69365,69365,69367,0,2,1
19871,1,2,69366,69367,69369,1,3,0
19872,6,1,69372,69372,69373,0,1,3
19873,1,1,69373,69373,69374,0,1,0
19874,5,3,69378,69378,69381,0,3,4
19875,5,1,69383,69383,69384,0,1,2
19876,5,3,69388,69388,69391,0,3,4
19877,5,3,69393,69393,69396,0,3,2
19878,6,1,69399,69399,69400,0,1,3
19879,4,3,69403,69403,69406,0,3,3
19880,1,3,69404,69406,69409,2,5,0
19881,1,3,69405,69409,69412,4,7,0
19882,1,2,69406,69412,69414,6,8,0
19883,3,1,69409,69414,69415,5,6,0
19884,3,1,69412,69415,69416,3,4,0
19885,5,3,69417,69417,69420,0,3,1
19886,6,3,69423,69423,69426,0,3,3
19887,1,2,69424,69426,69428,2,4,0
19888,1,2,69425,69428,69430,3,5,0
19889,2,2,69427,69430,69432,3,5,0
19890,5,1,69432,69432,69433,0,1,0
19891,3,3,69435,69435,69438,0,3,2
19892,2,3,69437,69438,69441,1,4,0
19893,4,3,69441,69441,69444,0,3,0
19894,2,3,69443,69444,69447,1,4,0
19895,6,3,69449,69449,69452,0,3,2
19896,3,1,69452,69452,69453,0,1,0
19897,1,3,69453,69453,69456,0,3,0
19898,4,3,69457,69457,69460,0,3,1
19899,6,3,69463,69463,69466,0,3,3
19900,4,1,69467,69467,69468,0,1,1
19901,3,1,69470,69470,69471,0,1,2
19902,4,3,69474,69474,69477,0,3,3
19903,5,3,69479,69479,69482,0,3,2
19904,2,1,69481,69482,69483,1,2,0
19905,6,1,69487,69487,69488,0,1,4
19906,2,3,69489,69489,69492,0,3,1
19907,3,3,69492,69492,69495,0,3,0
19908,3,2,69495,69495,69497,0,2,0
19909,5,2,69500,69500,69502,0,2,3
19910,6,1,69506,69506,69507,0,1,4
19911,5,1,69511,69511,69512,0,1,4
19912,3,1,69514,69514,69515,0,1,2
19913,5,2,69519,69519,69521,0,2,4
19914,2,1,69521,69521,69522,0,1,0
19915,4,1,69525,69525,69526,0,1,3
19916,1,1,69526,69526,69527,0,1,0
19917,6,1,69532,69532,69533,0,1,5
19918,1,2,69533,69533,69535,0,2,0
19919,6,2,69539,69539,69541,0,2,4
19920,2,1,69541,69541,69542,0,1,0
19921,4,2,69545,69545,69547,0,2,3
19922,3,3,69548,69548,69551,0,3,1
19923,1,1,69549,69551,69552,2,3,0
19924,3,2,69552,69552,69554,0,2,0
19925,6,3,69558,69558,69561,0,3,4
19926,5,2,69563,69563,69565,0,2,2
19927,6,3,69569,69569,69572,0,3,4
19928,5,2,69574,69574,69576,0,2,2
19929,2,1,69576,69576,69577,0,1,0
19930,2,1,69578,69578,69579,0,1,1
19931,6,3,69584,69584,69587,0,3,5
19932,3,2,69587,69587,69589,0,2,0
19933,5,1,69592,69592,69593,0,1,3
19934,2,3,69594,69594,69597,0,3,1
19935,4,2,69598,69598,69600,0,2,1
19936,6,1,69604,69604,69605,0,1,4
19937,5,3,69609,69609,69612,0,3,4
19938,6,1,69615,69615,69616,0,1,3
19939,2,3,69617,69617,69620,0,3,1
19940,4,3,69621,69621,69624,0,3,1
19941,6,1,69627,69627,69628,0,1,3
19942,1,3,69628,69628,69631,0,3,0
19943,6,2,69634,69634,69636,0,2,3
19944,5,3,69639,69639,69642,0,3,3
19945,2,1,69641,69642,69643,1,2,0
19946,5,3,69646,69646,69649,0,3,3
19947,4,1,69650,69650,69651,0,1,1
19948,1,2,69651,69651,69653,0,2,0
19949,2,1,69653,69653,69654,0,1,0
19950,4,2,69657,69657,69659,0,2,3
19951,1,2,69658,69659,69661,1,3,0
19952,4,2,69662,69662,69664,0,2,1
19953,3,3,69665,69665,69668,0,3,1
19954,6,1,69671,69671,69672,0,1,3
19955,5,2,69676,69676,69678,0,2,4
19956,6,1,69682,69682,69683,0,1,4
19957,5,1,69687,69687,69688,0,1,4
19958,2,2,69689,69689,69691,0,2,1
19959,4,2,69693,69693,69695,0,2,2
19960,4,2,69697,69697,69699,0,2,2
19961,4,2,69701,69701,69703,0,2,2
19962,1,1,69702,69703,69704,1,2,0
19963,3,1,69705,69705,69706,0,1,1
19964,6,2,69711,69711,69713,0,2,5
19965,2,1,69713,69713,69714,0,1,0
19966,3,2,69716,69716,69718,0,2,2
19967,3,2,69719,69719,69721,0,2,1
19968,2,3,69721,69721,69724,0,3,0
19969,3,1,69724,69724,69725,0,1,0
19970,2,1,69726,69726,69727,0,1,1
19971,1,1,69727,69727,69728,0,1,0
19972,6,2,69733,69733,69735,0,2,5
19973,2,2,69735,69735,69737,0,2,0
19974,4,1,69739,69739,69740,0,1,2
19975,6,1,69745,69745,69746,0,1,5
19976,2,3,69747,69747,69750,0,3,1
19977,2,2,69749,69750,69752,1,3,0
19978,1,3,69750,69752,69755,2,5,0
19979,5,2,69755,69755,69757,0,2,0
19980,6,3,69761,69761,69764,0,3,4
19981,4,1,69765,69765,69766,0,1,1
19982,5,1,69770,69770,69771,0,1,4
19983,3,1,69773,69773,69774,0,1,2
19984,5,2,69778,69778,69780,0,2,4
19985,3,3,69781,69781,69784,0,3,1
19986,1,3,69782,69784,69787,2,5,0
19987,5,2,69787,69787,69789,0,2,0
19988,2,2,69789,69789,69791,0,2,0
19989,4,2,69793,69793,69795,0,2,2
19990,3,3,69796,69796,69799,0,3,1
19991,5,2,69801,69801,69803,0,2,2
19992,3,3,69804,69804,69807,0,3,1
19993,6,3,69810,69810,69813,0,3,3
19994,4,1,69814,69814,69815,0,1,1
19995,1,2,69815,69815,69817,0,2,0
19996,5,2,69820,69820,69822,0,2,3
19997,2,2,69822,69822,69824,0,2,0
19998,2,2,69824,69824,69826,0,2,0
19999,3,3,69827,69827,69830,0,3,1
20000,2,2,69829,69830,69832,1,3,0
20001,6,3,69835,69835,69838,0,3,3
20002,6,2,69841,69841,69843,0,2,3
20003,2,3,69843,69843,69846,0,3,0
20004,1,2,69844,69846,69848,2,4,0
20005,3,2,69847,69848,69850,1,3,0
20006,2,2,69849,69850,69852,1,3,0
20007,4,1,69853,69853,69854,0,1,1
20008,2,3,69855,69855,69858,0,3,1
20009,4,1,69859,69859,69860,0,1,1
20010,5,2,69864,69864,69866,0,2,4
20011,2,2,69866,69866,69868,0,2,0
20012,6,1,69872,69872,69873,0,1,4
20013,1,2,69873,69873,69875,0,2,0
20014,6,1,69879,69879,69880,0,1,4
20015,6,1,69885,69885,69886,0,1,5
20016,4,2,69889,69889,69891,0,2,3
20017,6,2,69895,69895,69897,0,2,4
20018,5,1,69900,69900,69901,0,1,3
20019,5,2,69905,69905,69907,0,2,4
20020,2,1,69907,69907,69908,0,1,0
20021,6,3,69913,69913,69916,0,3,5
20022,2,3,69915,69916,69919,1,4,0
20023,3,1,69918,69919,69920,1,2,0
20024,4,1,69922,69922,69923,0,1,2
20025,5,1,69927,69927,69928,0,1,4
20026,4,2,69931,69931,69933,0,2,3
20027,2,3,69933,69933,69936,0,3,0
20028,5,1,69938,69938,69939,0,1,2
20029,4,3,69942,69942,69945,0,3,3
20030,2,2,69944,69945,69947,1,3,0
20031,1,3,69945,69947,69950,2,5,0
20032,4,3,69949,69950,69953,1,4,0
20033,4,1,69953,69953,69954,0,1,0
20034,6,1,69959,69959,69960,0,1,5
20035,2,2,69961,69961,69963,0,2,1
20036,5,2,69966,69966,69968,0,2,3
20037,1,3,69967,69968,69971,1,4,0
20038,3,2,69970,69971,69973,1,3,0
20039,3,3,69973,69973,69976,0,3,0
20040,1,3,69974,69976,69979,2,5,0
20041,3,2,69977,69979,69981,2,4,0
20042,5,2,69982,69982,69984,0,2,1
20043,2,3,69984,69984,69987,0,3,0
20044,4,1,69988,69988,69989,0,1,1
20045,3,1,69991,69991,69992,0,1,2
20046,6,1,69997,69997,69998,0,1,5
20047,3,2,70000,70000,70002,0,2,2
20048,1,1,70001,70002,70003,1,2,0
20049,6,1,70007,70007,70008,0,1,4
20050,2,1,70009,70009,70010,0,1,1
20051,5,2,70014,70014,70016,0,2,4
20052,2,2,70016,70016,70018,0,2,0
20053,2,3,70018,70018,70021,0,3,0
20054,6,3,70024,70024,70027,0,3,3
20055,3,2,70027,70027,70029,0,2,0
20056,4,3,70031,70031,70034,0,3,2
20057,5,1,70036,70036,70037,0,1,2
20058,4,1,70040,70040,70041,0,1,3
20059,3,1,70043,70043,70044,0,1,2
20060,1,2,70044,70044,70046,0,2,0
20061,3,1,70047,70047,70048,0,1,1
20062,6,3,70053,70053,70056,0,3,5
20063,6,1,70059,70059,70060,0,1,3
20064,5,1,70064,70064,70065,0,1,4
20065,3,3,70067,70067,70070,0,3,2
20066,1,3,70068,70070,70073,2,5,0
20067,6,1,70074,70074,70075,0,1,1
20068,6,2,70080,70080,70082,0,2,5
20069,3,1,70083,70083,70084,0,1,1
20070,4,1,70087,70087,70088,0,1,3
20071,4,1,70091,70091,70092,0,1,3
20072,1,2,70092,70092,70094,0,2,0
20073,2,2,70094,70094,70096,0,2,0
20074,3,2,70097,70097,70099,0,2,1
20075,3,1,70100,70100,70101,0,1,1
20076,1,1,70101,70101,70102,0,1,0
20077,1,3,70102,70102,70105,0,3,0
20078,4,1,70106,70106,70107,0,1,1
20079,3,1,70109,70109,70110,0,1,2
20080,4,2,70113,70113,70115,0,2,3
20081,3,1,70116,70116,70117,0,1,1
20082,2,1,70118,70118,70119,0,1,1
20083,1,3,70119,70119,70122,0,3,0
20084,5,3,70124,70124,70127,0,3,2
20085,2,3,70126,70127,70130,1,4,0
20086,4,3,70130,70130,70133,0,3,0
20087,6,2,70136,70136,70138,0,2,3
20088,5,3,70141,70141,70144,0,3,3
20089,5,1,70146,70146,70147,0,1,2
20090,6,1,70152,70152,70153,0,1,5
20091,5,2,70157,70157,70159,0,2,4
20092,3,1,70160,70160,70161,0,1,1
20093,6,3,70166,70166,70169,0,3,5
20094,5,3,70171,70171,70174,0,3,2
20095,2,3,70173,70174,70177,1,4,0
20096,3,3,70176,70177,70180,1,4,0
20097,3,1,70179,70180,70181,1,2,0
20098,3,2,70182,70182,70184,0,2,1
20099,5,2,70187,70187,70189,0,2,3
20100,5,1,70192,70192,70193,0,1,3
20101,6,1,70198,70198,70199,0,1,5
20102,2,2,70200,70200,70202,0,2,1
20103,4,3,70204,70204,70207,0,3,2
20104,2,1,70206,70207,70208,1,2,0
20105,1,3,70207,70208,70211,1,4,0
20106,2,3,70209,70211,70214,2,5,0
20107,3,2,70212,70214,70216,2,4,0
20108,6,3,70218,70218,70221,0,3,2
20109,5,1,70223,70223,70224,0,1,2
20110,3,1,70226,70226,70227,0,1,2
20111,5,3,70231,70231,70234,0,3,4
20112,4,2,70235,70235,70237,0,2,1
20113,6,2,70241,70241,70243,0,2,4
20114,5,2,70246,70246,70248,0,2,3
20115,4,3,70250,70250,70253,0,3,2
20116,6,2,70256,70256,70258,0,2,3
20117,1,3,70257,70258,70261,1,4,0
20118,6,3,70263,70263,70266,0,3,2
20119,5,3,70268,70268,70271,0,3,2
20120,4,1,70272,70272,70273,0,1,1
20121,2,2,70274,70274,70276,0,2,1
20122,5,1,70279,70279,70280,0,1,3
20123,3,3,70282,70282,70285,0,3,2
20124,3,2,70285,70285,70287,0,2,0
20125,5,1,70290,70290,70291,0,1,3
20126,4,3,70294,70294,70297,0,3,3
20127,1,1,70295,70297,70298,2,3,0
20128,2,3,70297,70298,70301,1,4,0
20129,3,3,70300,70301,70304,1,4,0
20130,6,2,70306,70306,70308,0,2,2
20131,2,2,70308,70308,70310,0,2,0
20132,5,2,70313,70313,70315,0,2,3
20133,6,1,70319,70319,70320,0,1,4
20134,6,2,70325,70325,70327,0,2,5
20135,3,1,70328,70328,70329,0,1,1
20136,6,1,70334,70334,70335,0,1,5
20137,3,3,70337,70337,70340,0,3,2
20138,3,1,70340,70340,70341,0,1,0
20139,5,1,70345,70345,70346,0,1,4
20140,4,1,70349,70349,70350,0,1,3
20141,1,3,70350,70350,70353,0,3,0
20142,5,1,70355,70355,70356,0,1,2
20143,1,1,70356,70356,70357,0,1,0
20144,2,2,70358,70358,70360,0,2,1
20145,6,3,70364,70364,70367,0,3,4
20146,3,2,70367,70367,70369,0,2,0
20147,2,1,70369,70369,70370,0,1,0
20148,5,3,70374,70374,70377,0,3,4
20149,4,2,70378,70378,70380,0,2,1
20150,3,3,70381,70381,70384,0,3,1
20151,6,1,70387,70387,70388,0,1,3
20152,4,1,70391,70391,70392,0,1,3
20153,3,1,70394,70394,70395,0,1,2
20154,4,2,70398,70398,70400,0,2,3
20155,3,1,70401,70401,70402,0,1,1
20156,6,2,70407,70407,70409,0,2,5
20157,5,3,70412,70412,70415,0,3,3
20158,4,2,70416,70416,70418,0,2,1
20159,4,3,70420,70420,70423,0,3,2
20160,6,1,70426,70426,70427,0,1,3
20161,4,3,70430,70430,70433,0,3,3
20162,2,3,70432,70433,70436,1,4,0
20163,5,1,70437,70437,70438,0,1,1
20164,5,2,70442,70442,70444,0,2,4
20165,1,3,70443,70444,70447,1,4,0
20166,6,2,70449,70449,70451,0,2,2
20167,3,1,70452,70452,70453,0,1,1
20168,2,3,70454,70454,70457,0,3,1
20169,5,1,70459,70459,70460,0,1,2
20170,6,2,70465,70465,70467,0,2,5
20171,5,2,70470,70470,70472,0,2,3
20172,5,3,70475,70475,70478,0,3,3
20173,6,2,70481,70481,70483,0,2,3
20174,1,1,70482,70483,70484,1,2,0
20175,6,3,70488,70488,70491,0,3,4
20176,2,1,70490,70491,70492,1,2,0
20177,4,2,70494,70494,70496,0,2,2
20178,1,1,70495,70496,70497,1,2,0
20179,1,1,70496,70497,70498,1,2,0
20180,1,2,70497,70498,70500,1,3,0
20181,2,1,70499,70500,70501,1,2,0
20182,6,2,70505,70505,70507,0,2,4
20183,3,3,70508,70508,70511,0,3,1
20184,2,1,70510,70511,70512,1,2,0
20185,2,2,70512,70512,70514,0,2,0
20186,6,2,70518,70518,70520,0,2,4
20187,5,1,70523,70523,70524,0,1,3
20188,4,1,70527,70527,70528,0,1,3
20189,6,1,70533,70533,70534,0,1,5
20190,5,2,70538,70538,70540,0,2,4
20191,2,2,70540,70540,70542,0,2,0
20192,3,3,70543,70543,70546,0,3,1
20193,3,2,70546,70546,70548,0,2,0
20194,3,2,70549,70549,70551,0,2,1
20195,4,3,70553,70553,70556,0,3,2
20196,5,1,70558,70558,70559,0,1,2
20197,2,3,70560,70560,70563,0,3,1
20198,3,3,70563,70563,70566,0,3,0
20199,1,2,70564,70566,70568,2,4,0
20200,1,3,70565,70568,70571,3,6,0
20201,1,2,70566,70571,70573,5,7,0
20202,1,1,70567,70573,70574,6,7,0
20203,5,2,70572,70574,70576,2,4,0
20204,1,3,70573,70576,70579,3,6,0
20205,4,1,70577,70579,70580,2,3,0
20206,2,3,70579,70580,70583,1,4,0
20207,2,1,70581,70583,70584,2,3,0
20208,2,1,70583,70584,70585,1,2,0
20209,5,3,70588,70588,70591,0,3,3
20210,1,3,70589,70591,70594,2,5,0
20211,5,3,70594,70594,70597,0,3,0
20212,6,1,70600,70600,70601,0,1,3
20213,3,2,70603,70603,70605,0,2,2
20214,1,2,70604,70605,70607,1,3,0
20215,1,1,70605,70607,70608,2,3,0
20216,3,1,70608,70608,70609,0,1,0
20217,6,3,70614,70614,70617,0,3,5
20218,4,2,70618,70618,70620,0,2,1
20219,1,1,70619,70620,70621,1,2,0
20220,4,2,70623,70623,70625,0,2,2
20221,6,1,70629,70629,70630,0,1,4
20222,5,2,70634,70634,70636,0,2,4
20223,5,2,70639,70639,70641,0,2,3
20224,3,1,70642,70642,70643,0,1,1
20225,1,3,70643,70643,70646,0,3,0
20226,3,1,70646,70646,70647,0,1,0
20227,4,3,70650,70650,70653,0,3,3
20228,5,3,70655,70655,70658,0,3,2
20229,4,2,70659,70659,70661,0,2,1
20230,4,3,70663,70663,70666,0,3,2
20231,3,3,70666,70666,70669,0,3,0
20232,1,1,70667,70669,70670,2,3,0
20233,6,1,70673,70673,70674,0,1,3
20234,2,1,70675,70675,70676,0,1,1
20235,2,3,70677,70677,70680,0,3,1
20236,5,3,70682,70682,70685,0,3,2
20237,3,1,70685,70685,70686,0,1,0
20238,1,3,70686,70686,70689,0,3,0
20239,3,2,70689,70689,70691,0,2,0
20240,5,1,70694,70694,70695,0,1,3
20241,2,3,70696,70696,70699,0,3,1
20242,1,1,70697,70699,70700,2,3,0
20243,3,2,70700,70700,70702,0,2,0
20244,1,2,70701,70702,70704,1,3,0
20245,3,2,70704,70704,70706,0,2,0
20246,4,2,70708,70708,70710,0,2,2
20247,1,1,70709,70710,70711,1,2,0
20248,4,3,70713,70713,70716,0,3,2
20249,1,1,70714,70716,70717,2,3,0
20250,5,2,70719,70719,70721,0,2,2
20251,1,2,70720,70721,70723,1,3,0
20252,2,1,70722,70723,70724,1,2,0
20253,5,2,70727,70727,70729,0,2,3
20254,6,1,70733,70733,70734,0,1,4
20255,1,3,70734,70734,70737,0,3,0
20256,5,3,70739,70739,70742,0,3,2
20257,1,2,70740,70742,70744,2,4,0
20258,1,2,70741,70744,70746,3,5,0
20259,4,2,70745,70746,70748,1,3,0
20260,4,2,70749,70749,70751,0,2,1
20261,3,2,70752,70752,70754,0,2,1
20262,4,3,70756,70756,70759,0,3,2
20263,5,3,70761,70761,70764,0,3,2
20264,3,1,70764,70764,70765,0,1,0
20265,2,1,70766,70766,70767,0,1,1
20266,5,1,70771,70771,70772,0,1,4
20267,3,2,70774,70774,70776,0,2,2
20268,1,3,70775,70776,70779,1,4,0
20269,2,2,70777,70779,70781,2,4,0
20270,1,3,70778,70781,70784,3,6,0
20271,3,3,70781,70784,70787,3,6,0
20272,1,3,70782,70787,70790,5,8,0
20273,2,1,70784,70790,70791,6,7,0
20274,3,3,70787,70791,70794,4,7,0
20275,4,1,70791,70794,70795,3,4,0
20276,6,3,70797,70797,70800,0,3,2
20277,1,2,70798,70800,70802,2,4,0
20278,5,3,70803,70803,70806,0,3,1
20279,4,2,70807,70807,70809,0,2,1
20280,2,3,70809,70809,70812,0,3,0
20281,4,1,70813,70813,70814,0,1,1
20282,2,3,70815,70815,70818,0,3,1
20283,5,1,70820,70820,70821,0,1,2
20284,2,1,70822,70822,70823,0,1,1
20285,1,1,70823,70823,70824,0,1,0
20286,5,1,70828,70828,70829,0,1,4
20287,5,2,70833,70833,70835,0,2,4
20288,5,3,70838,70838,70841,0,3,3
20289,2,2,70840,70841,70843,1,3,0
20290,1,3,70841,70843,70846,2,5,0
20291,1,1,70842,70846,70847,4,5,0
20292,6,3,70848,70848,70851,0,3,1
20293,6,1,70854,70854,70855,0,1,3
20294,2,1,70856,70856,70857,0,1,1
20295,2,3,70858,70858,70861,0,3,1
20296,3,2,70861,70861,70863,0,2,0
20297,6,2,70867,70867,70869,0,2,4
20298,5,3,70872,70872,70875,0,3,3
20299,2,3,70874,70875,70878,1,4,0
20300,5,3,70879,70879,70882,0,3,1
20301,6,1,70885,70885,70886,0,1,3
20302,5,2,70890,70890,70892,0,2,4
20303,5,3,70895,70895,70898,0,3,3
20304,3,2,70898,70898,70900,0,2,0
20305,1,3,70899,70900,70903,1,4,0
20306,5,2,70904,70904,70906,0,2,1
20307,2,2,70906,70906,70908,0,2,0
20308,3,3,70909,70909,70912,0,3,1
20309,5,2,70914,70914,70916,0,2,2
20310,4,1,70918,70918,70919,0,1,2
20311,4,3,70922,70922,70925,0,3,3
20312,5,2,70927,70927,70929,0,2,2
20313,4,3,70931,70931,70934,0,3,2
20314,3,2,70934,70934,70936,0,2,0
20315,5,2,70939,70939,70941,0,2,3
20316,5,3,70944,70944,70947,0,3,3
20317,5,2,70949,70949,70951,0,2,2
20318,6,2,70955,70955,70957,0,2,4
20319,1,2,70956,70957,70959,1,3,0
20320,3,3,70959,70959,70962,0,3,0
20321,2,1,70961,70962,70963,1,2,0
20322,4,1,70965,70965,70966,0,1,2
20323,2,2,70967,70967,70969,0,2,1
20324,3,2,70970,70970,70972,0,2,1
20325,5,2,70975,70975,70977,0,2,3
20326,4,2,70979,70979,70981,0,2,2
20327,3,3,70982,70982,70985,0,3,1
20328,4,2,70986,70986,70988,0,2,1
20329,6,2,70992,70992,70994,0,2,4
20330,2,2,70994,70994,70996,0,2,0
20331,1,1,70995,70996,70997,1,2,0
20332,2,1,70997,70997,70998,0,1,0
20333,2,2,70999,70999,71001,0,2,1
20334,3,1,71002,71002,71003,0,1,1
20335,6,3,71008,71008,71011,0,3,5
20336,2,1,71010,71011,71012,1,2,0
20337,2,1,71012,71012,71013,0,1,0
20338,4,1,71016,71016,71017,0,1,3
20339,3,2,71019,71019,71021,0,2,2
20340,6,2,71025,71025,71027,0,2,4
20341,3,1,71028,71028,71029,0,1,1
20342,3,3,71031,71031,71034,0,3,2
20343,6,1,71037,71037,71038,0,1,3
20344,6,3,71043,71043,71046,0,3,5
20345,2,2,71045,71046,71048,1,3,0
20346,1,2,71046,71048,71050,2,4,0
20347,4,3,71050,71050,71053,0,3,0
20348,2,2,71052,71053,71055,1,3,0
20349,1,2,71053,71055,71057,2,4,0
20350,2,2,71055,71057,71059,2,4,0
20351,5,2,71060,71060,71062,0,2,1
20352,1,1,71061,71062,71063,1,2,0
20353,4,2,71065,71065,71067,0,2,2
20354,1,3,71066,71067,71070,1,4,0
20355,6,3,71072,71072,71075,0,3,2
20356,6,2,71078,71078,71080,0,2,3
20357,3,3,71081,71081,71084,0,3,1
20358,5,1,71086,71086,71087,0,1,2
20359,1,2,71087,71087,71089,0,2,0
20360,3,1,71090,71090,71091,0,1,1
20361,1,3,71091,71091,71094,0,3,0
20362,3,1,71094,71094,71095,0,1,0
20363,6,2,71100,71100,71102,0,2,5
20364,5,1,71105,71105,71106,0,1,3
20365,3,3,71108,71108,71111,0,3,2
20366,5,3,71113,71113,71116,0,3,2
20367,3,2,71116,71116,71118,0,2,0
20368,3,1,71119,71119,71120,0,1,1
20369,2,2,71121,71121,71123,0,2,1
20370,5,1,71126,71126,71127,0,1,3
20371,2,1,71128,71128,71129,0,1,1
20372,4,1,71132,71132,71133,0,1,3
20373,3,1,71135,71135,71136,0,1,2
20374,2,1,71137,71137,71138,0,1,1
20375,5,1,71142,71142,71143,0,1,4
20376,5,3,71147,71147,71150,0,3,4
20377,1,2,71148,71150,71152,2,4,0
20378,1,3,71149,71152,71155,3,6,0
20379,5,2,71154,71155,71157,1,3,0
20380,1,1,71155,71157,71158,2,3,0
20381,1,1,71156,71158,71159,2,3,0
20382,5,1,71161,71161,71162,0,1,2
20383,4,3,71165,71165,71168,0,3,3
20384,6,2,71171,71171,71173,0,2,3
20385,3,1,71174,71174,71175,0,1,1
20386,1,1,71175,71175,71176,0,1,0
20387,6,3,71181,71181,71184,0,3,5
20388,4,3,71185,71185,71188,0,3,1
20389,5,3,71190,71190,71193,0,3,2
20390,2,3,71192,71193,71196,1,4,0
20391,5,2,71197,71197,71199,0,2,1
20392,1,3,71198,71199,71202,1,4,0
20393,3,3,71201,71202,71205,1,4,0
20394,2,2,71203,71205,71207,2,4,0
20395,3,1,71206,71207,71208,1,2,0
20396,5,3,71211,71211,71214,0,3,3
20397,2,3,71213,71214,71217,1,4,0
20398,2,1,71215,71217,71218,2,3,0
20399,1,3,71216,71218,71221,2,5,0
20400,2,3,71218,71221,71224,3,6,0
20401,2,1,71220,71224,71225,4,5,0
20402,1,1,71221,71225,71226,4,5,0
20403,4,3,71225,71226,71229,1,4,0
20404,3,3,71228,71229,71232,1,4,0
20405,2,1,71230,71232,71233,2,3,0
20406,1,1,71231,71233,71234,2,3,0
20407,3,3,71234,71234,71237,0,3,0
20408,2,2,71236,71237,71239,1,3,0
20409,2,3,71238,71239,71242,1,4,0
20410,2,3,71240,71242,71245,2,5,0
20411,5,2,71245,71245,71247,0,2,0
20412,3,2,71248,71248,71250,0,2,1
20413,3,3,71251,71251,71254,0,3,1
20414,4,1,71255,71255,71256,0,1,1
20415,3,3,71258,71258,71261,0,3,2
20416,3,1,71261,71261,71262,0,1,0
20417,5,3,71266,71266,71269,0,3,4
20418,1,1,71267,71269,71270,2,3,0
20419,1,2,71268,71270,71272,2,4,0
20420,3,2,71271,71272,71274,1,3,0
20421,6,3,71277,71277,71280,0,3,3
20422,3,3,71280,71280,71283,0,3,0
20423,6,3,71286,71286,71289,0,3,3
20424,2,2,71288,71289,71291,1,3,0
20425,2,3,71290,71291,71294,1,4,0
20426,6,2,71296,71296,71298,0,2,2
20427,2,3,71298,71298,71301,0,3,0
20428,1,2,71299,71301,71303,2,4,0
20429,3,2,71302,71303,71305,1,3,0
20430,4,1,71306,71306,71307,0,1,1
20431,4,3,71310,71310,71313,0,3,3
20432,3,1,71313,71313,71314,0,1,0
20433,1,1,71314,71314,71315,0,1,0
20434,6,1,71320,71320,71321,0,1,5
20435,2,2,71322,71322,71324,0,2,1
20436,1,3,71323,71324,71327,1,4,0
20437,4,2,71327,71327,71329,0,2,0
20438,4,1,71331,71331,71332,0,1,2
20439,2,1,71333,71333,71334,0,1,1
20440,4,3,71337,71337,71340,0,3,3
20441,3,2,71340,71340,71342,0,2,0
20442,1,1,71341,71342,71343,1,2,0
20443,3,3,71344,71344,71347,0,3,1
20444,1,1,71345,71347,71348,2,3,0
20445,2,1,71347,71348,71349,1,2,0
20446,2,3,71349,71349,71352,0,3,0
20447,5,1,71354,71354,71355,0,1,2
20448,1,1,71355,71355,71356,0,1,0
20449,5,3,71360,71360,71363,0,3,4
20450,2,1,71362,71363,71364,1,2,0
20451,5,3,71367,71367,71370,0,3,3
20452,4,1,71371,71371,71372,0,1,1
20453,3,3,71374,71374,71377,0,3,2
20454,4,1,71378,71378,71379,0,1,1
20455,3,3,71381,71381,71384,0,3,2
20456,3,3,71384,71384,71387,0,3,0
20457,3,2,71387,71387,71389,0,2,0
20458,5,2,71392,71392,71394,0,2,3
20459,3,2,71395,71395,71397,0,2,1
20460,2,1,71397,71397,71398,0,1,0
20461,6,3,71403,71403,71406,0,3,5
20462,2,1,71405,71406,71407,1,2,0
20463,5,2,71410,71410,71412,0,2,3
20464,4,3,71414,71414,71417,0,3,2
20465,6,1,71420,71420,71421,0,1,3
20466,4,2,71424,71424,71426,0,2,3
20467,2,3,71426,71426,71429,0,3,0
20468,6,2,71432,71432,71434,0,2,3
20469,1,1,71433,71434,71435,1,2,0
20470,3,3,71436,71436,71439,0,3,1
20471,4,2,71440,71440,71442,0,2,1
20472,3,1,71443,71443,71444,0,1,1
20473,1,1,71444,71444,71445,0,1,0
20474,6,3,71450,71450,71453,0,3,5
20475,5,3,71455,71455,71458,0,3,2
20476,5,2,71460,71460,71462,0,2,2
20477,4,3,71464,71464,71467,0,3,2
20478,1,2,71465,71467,71469,2,4,0
20479,5,2,71470,71470,71472,0,2,1
20480,4,2,71474,71474,71476,0,2,2
20481,4,3,71478,71478,71481,0,3,2
20482,6,2,71484,71484,71486,0,2,3
20483,1,1,71485,71486,71487,1,2,0
20484,5,3,71490,71490,71493,0,3,3
20485,4,3,71494,71494,71497,0,3,1
20486,2,3,71496,71497,71500,1,4,0
20487,4,2,71500,71500,71502,0,2,0
20488,6,2,71506,71506,71508,0,2,4
20489,3,2,71509,71509,71511,0,2,1
20490,2,2,71511,71511,71513,0,2,0
20491,3,3,71514,71514,71517,0,3,1
20492,2,2,71516,71517,71519,1,3,0
20493,6,2,71522,71522,71524,0,2,3
20494,1,1,71523,71524,71525,1,2,0
20495,3,3,71526,71526,71529,0,3,1
20496,2,2,71528,71529,71531,1,3,0
20497,5,3,71533,71533,71536,0,3,2
20498,3,1,71536,71536,71537,0,1,0
20499,1,3,71537,71537,71540,0,3,0
20500,2,2,71539,71540,71542,1,3,0
20501,5,1,71544,71544,71545,0,1,2
20502,4,3,71548,71548,71551,0,3,3
20503,3,2,71551,71551,71553,0,2,0
20504,3,1,71554,71554,71555,0,1,1
20505,5,3,71559,71559,71562,0,3,4
20506,4,3,71563,71563,71566,0,3,1
20507,1,2,71564,71566,71568,2,4,0
20508,4,2,71568,71568,71570,0,2,0
20509,5,3,71573,71573,71576,0,3,3
20510,3,3,71576,71576,71579,0,3,0
20511,5,3,71581,71581,71584,0,3,2
20512,4,3,71585,71585,71588,0,3,1
20513,2,2,71587,71588,71590,1,3,0
20514,2,3,71589,71590,71593,1,4,0
20515,6,2,71595,71595,71597,0,2,2
20516,1,2,71596,71597,71599,1,3,0
20517,3,3,71599,71599,71602,0,3,0
20518,1,2,71600,71602,71604,2,4,0
20519,4,1,71604,71604,71605,0,1,0
20520,6,2,71610,71610,71612,0,2,5
20521,4,3,71614,71614,71617,0,3,2
20522,6,1,71620,71620,71621,0,1,3
20523,5,1,71625,71625,71626,0,1,4
20524,2,1,71627,71627,71628,0,1,1
20525,6,2,71633,71633,71635,0,2,5
20526,2,2,71635,71635,71637,0,2,0
20527,6,3,71641,71641,71644,0,3,4
20528,3,1,71644,71644,71645,0,1,0
20529,3,1,71647,71647,71648,0,1,2
20530,5,3,71652,71652,71655,0,3,4
20531,3,2,71655,71655,71657,0,2,0
20532,4,2,71659,71659,71661,0,2,2
20533,1,3,71660,71661,71664,1,4,0
20534,3,3,71663,71664,71667,1,4,0
20535,3,3,71666,71667,71670,1,4,0
20536,4,3,71670,71670,71673,0,3,0
20537,3,2,71673,71673,71675,0,2,0
20538,2,2,71675,71675,71677,0,2,0
20539,5,3,71680,71680,71683,0,3,3
20540,3,3,71683,71683,71686,0,3,0
20541,4,2,71687,71687,71689,0,2,1
20542,2,3,71689,71689,71692,0,3,0
20543,1,1,71690,71692,71693,2,3,0
20544,5,1,71695,71695,71696,0,1,2
20545,6,2,71701,71701,71703,0,2,5
20546,3,2,71704,71704,71706,0,2,1
20547,5,2,71709,71709,71711,0,2,3
20548,2,3,71711,71711,71714,0,3,0
20549,5,3,71716,71716,71719,0,3,2
20550,1,1,71717,71719,71720,2,3,0
20551,3,3,71720,71720,71723,0,3,0
20552,5,3,71725,71725,71728,0,3,2
20553,5,1,71730,71730,71731,0,1,2
20554,6,1,71736,71736,71737,0,1,5
20555,6,1,71742,71742,71743,0,1,5
20556,3,1,71745,71745,71746,0,1,2
20557,1,1,71746,71746,71747,0,1,0
20558,4,2,71750,71750,71752,0,2,3
20559,1,2,71751,71752,71754,1,3,0
20560,1,1,71752,71754,71755,2,3,0
20561,1,3,71753,71755,71758,2,5,0
20562,3,3,71756,71758,71761,2,5,0
20563,5,2,71761,71761,71763,0,2,0
20564,3,1,71764,71764,71765,0,1,1
20565,1,3,71765,71765,71768,0,3,0
20566,6,2,71771,71771,71773,0,2,3
20567,6,2,71777,71777,71779,0,2,4
20568,6,3,71783,71783,71786,0,3,4
20569,2,1,71785,71786,71787,1,2,0
20570,4,3,71789,71789,71792,0,3,2
20571,1,3,71790,71792,71795,2,5,0
20572,4,1,71794,71795,71796,1,2,0
20573,6,3,71800,71800,71803,0,3,4
20574,3,1,71803,71803,71804,0,1,0
20575,4,2,71807,71807,71809,0,2,3
20576,5,1,71812,71812,71813,0,1,3
20577,1,2,71813,71813,71815,0,2,0
20578,2,2,71815,71815,71817,0,2,0
20579,5,1,71820,71820,71821,0,1,3
20580,4,1,71824,71824,71825,0,1,3
20581,4,2,71828,71828,71830,0,2,3
20582,5,1,71833,71833,71834,0,1,3
20583,3,3,71836,71836,71839,0,3,2
20584,5,3,71841,71841,71844,0,3,2
20585,2,1,71843,71844,71845,1,2,0
20586,1,1,71844,71845,71846,1,2,0
20587,6,1,71850,71850,71851,0,1,4
20588,5,1,71855,71855,71856,0,1,4
20589,5,2,71860,71860,71862,0,2,4
20590,3,1,71863,71863,71864,0,1,1
20591,2,3,71865,71865,71868,0,3,1
20592,4,2,71869,71869,71871,0,2,1
20593,2,1,71871,71871,71872,0,1,0
20594,4,1,71875,71875,71876,0,1,3
20595,4,3,71879,71879,71882,0,3,3
20596,3,3,71882,71882,71885,0,3,0
20597,1,1,71883,71885,71886,2,3,0
20598,6,2,71889,71889,71891,0,2,3
20599,2,2,71891,71891,71893,0,2,0
20600,4,2,71895,71895,71897,0,2,2
20601,1,1,71896,71897,71898,1,2,0
20602,2,3,71898,71898,71901,0,3,0
20603,6,2,71904,71904,71906,0,2,3
20604,6,1,71910,71910,71911,0,1,4
20605,5,2,71915,71915,71917,0,2,4
20606,1,1,71916,71917,71918,1,2,0
20607,1,2,71917,71918,71920,1,3,0
20608,5,1,71922,71922,71923,0,1,2
20609,1,2,71923,71923,71925,0,2,0
20610,5,2,71928,71928,71930,0,2,3
20611,5,1,71933,71933,71934,0,1,3
20612,6,1,71939,71939,71940,0,1,5
20613,3,3,71942,71942,71945,0,3,2
20614,3,2,71945,71945,71947,0,2,0
20615,4,1,71949,71949,71950,0,1,2
20616,4,2,71953,71953,71955,0,2,3
20617,4,1,71957,71957,71958,0,1,2
20618,6,3,71963,71963,71966,0,3,5
20619,1,2,71964,71966,71968,2,4,0
20620,3,2,71967,71968,71970,1,3,0
20621,4,3,71971,71971,71974,0,3,1
20622,4,1,71975,71975,71976,0,1,1
20623,2,1,71977,71977,71978,0,1,1
20624,5,3,71982,71982,71985,0,3,4
20625,5,1,71987,71987,71988,0,1,2
20626,2,3,71989,71989,71992,0,3,1
20627,6,1,71995,71995,71996,0,1,3
20628,4,1,71999,71999,72000,0,1,3
20629,5,2,72004,72004,72006,0,2,4
20630,6,3,72010,72010,72013,0,3,4
20631,1,2,72011,72013,72015,2,4,0
20632,6,1,72017,72017,72018,0,1,2
20633,6,3,72023,72023,72026,0,3,5
20634,2,2,72025,72026,72028,1,3,0
20635,6,1,72031,72031,72032,0,1,3
20636,4,3,72035,72035,72038,0,3,3
20637,5,2,72040,72040,72042,0,2,2
20638,4,1,72044,72044,72045,0,1,2
20639,3,3,72047,72047,72050,0,3,2
20640,2,3,72049,72050,72053,1,4,0
20641,3,2,72052,72053,72055,1,3,0
20642,5,1,72057,72057,72058,0,1,2
20643,6,2,72063,72063,72065,0,2,5
20644,6,2,72069,72069,72071,0,2,4
20645,6,2,72075,72075,72077,0,2,4
20646,3,2,72078,72078,72080,0,2,1
20647,6,3,72084,72084,72087,0,3,4
20648,6,3,72090,72090,72093,0,3,3
20649,2,2,72092,72093,72095,1,3,0
20650,4,2,72096,72096,72098,0,2,1
20651,2,2,72098,72098,72100,0,2,0
20652,2,2,72100,72100,72102,0,2,0
20653,3,1,72103,72103,72104,0,1,1
20654,3,3,72106,72106,72109,0,3,2
20655,3,2,72109,72109,72111,0,2,0
20656,2,3,72111,72111,72114,0,3,0
20657,6,1,72117,72117,72118,0,1,3
20658,1,1,72118,72118,72119,0,1,0
20659,4,2,72122,72122,72124,0,2,3
20660,2,1,72124,72124,72125,0,1,0
20661,6,3,72130,72130,72133,0,3,5
20662,6,1,72136,72136,72137,0,1,3
20663,4,1,72140,72140,72141,0,1,3
20664,6,2,72146,72146,72148,0,2,5
20665,2,3,72148,72148,72151,0,3,0
20666,4,1,72152,72152,72153,0,1,1
20667,3,3,72155,72155,72158,0,3,2
20668,4,1,72159,72159,72160,0,1,1
20669,5,1,72164,72164,72165,0,1,4
20670,6,1,72170,72170,72171,0,1,5
20671,5,1,72175,72175,72176,0,1,4
20672,3,2,72178,72178,72180,0,2,2
20673,3,1,72181,72181,72182,0,1,1
20674,3,3,72184,72184,72187,0,3,2
20675,4,2,72188,72188,72190,0,2,1
20676,2,2,72190,72190,72192,0,2,0
20677,6,3,72196,72196,72199,0,3,4
20678,6,1,72202,72202,72203,0,1,3
20679,5,3,72207,72207,72210,0,3,4
20680,2,2,72209,72210,72212,1,3,0
20681,1,1,72210,72212,72213,2,3,0
20682,3,1,72213,72213,72214,0,1,0
20683,4,2,72217,72217,72219,0,2,3
20684,4,2,72221,72221,72223,0,2,2
20685,4,1,72225,72225,72226,0,1,2
20686,3,3,72228,72228,72231,0,3,2
20687,6,3,72234,72234,72237,0,3,3
20688,3,3,72237,72237,72240,0,3,0
20689,2,2,72239,72240,72242,1,3,0
20690,2,1,72241,72242,72243,1,2,0
20691,2,3,72243,72243,72246,0,3,0
20692,4,1,72247,72247,72248,0,1,1
20693,4,2,72251,72251,72253,0,2,3
20694,3,1,72254,72254,72255,0,1,1
20695,4,1,72258,72258,72259,0,1,3
20696,2,2,72260,72260,72262,0,2,1
20697,3,2,72263,72263,72265,0,2,1
20698,1,2,72264,72265,72267,1,3,0
20699,6,2,72270,72270,72272,0,2,3
20700,3,1,72273,72273,72274,0,1,1
20701,6,3,72279,72279,72282,0,3,5
20702,6,1,72285,72285,72286,0,1,3
20703,6,1,72291,72291,72292,0,1,5
20704,4,3,72295,72295,72298,0,3,3
20705,1,3,72296,72298,72301,2,5,0
20706,2,1,72298,72301,72302,3,4,0
20707,2,1,72300,72302,72303,2,3,0
20708,6,1,72306,72306,72307,0,1,3
20709,1,3,72307,72307,72310,0,3,0
20710,2,3,72309,72310,72313,1,4,0
20711,1,3,72310,72313,72316,3,6,0
20712,6,1,72316,72316,72317,0,1,0
20713,1,1,72317,72317,72318,0,1,0
20714,4,2,72321,72321,72323,0,2,3
20715,4,3,72325,72325,72328,0,3,2
20716,4,1,72329,72329,72330,0,1,1
20717,5,3,72334,72334,72337,0,3,4
20718,5,3,72339,72339,72342,0,3,2
20719,1,3,72340,72342,72345,2,5,0
20720,6,2,72346,72346,72348,0,2,1
20721,6,3,72352,72352,72355,0,3,4
20722,1,2,72353,72355,72357,2,4,0
20723,6,1,72359,72359,72360,0,1,2
20724,2,2,72361,72361,72363,0,2,1
20725,4,3,72365,72365,72368,0,3,2
20726,6,3,72371,72371,72374,0,3,3
20727,6,1,72377,72377,72378,0,1,3
20728,5,2,72382,72382,72384,0,2,4
20729,4,1,72386,72386,72387,0,1,2
20730,1,3,72387,72387,72390,0,3,0
20731,1,3,72388,72390,72393,2,5,0
20732,2,3,72390,72393,72396,3,6,0
20733,4,2,72394,72396,72398,2,4,0
20734,1,3,72395,72398,72401,3,6,0
20735,6,3,72401,72401,72404,0,3,0
20736,3,1,72404,72404,72405,0,1,0
20737,6,1,72410,72410,72411,0,1,5
20738,2,1,72412,72412,72413,0,1,1
20739,6,3,72418,72418,72421,0,3,5
20740,4,1,72422,72422,72423,0,1,1
20741,4,3,72426,72426,72429,0,3,3
20742,4,2,72430,72430,72432,0,2,1
20743,3,3,72433,72433,72436,0,3,1
20744,4,1,72437,72437,72438,0,1,1
20745,2,3,72439,72439,72442,0,3,1
20746,3,1,72442,72442,72443,0,1,0
20747,4,3,72446,72446,72449,0,3,3
20748,1,2,72447,72449,72451,2,4,0
20749,2,1,72449,72451,72452,2,3,0
20750,3,3,72452,72452,72455,0,3,0
20751,1,2,72453,72455,72457,2,4,0
20752,5,1,72458,72458,72459,0,1,1
20753,3,3,72461,72461,72464,0,3,2
20754,2,3,72463,72464,72467,1,4,0
20755,3,1,72466,72467,72468,1,2,0
20756,1,3,72467,72468,72471,1,4,0
20757,3,1,72470,72471,72472,1,2,0
20758,2,2,72472,72472,72474,0,2,0
20759,3,1,72475,72475,72476,0,1,1
20760,4,2,72479,72479,72481,0,2,3
20761,1,3,72480,72481,72484,1,4,0
20762,1,3,72481,72484,72487,3,6,0
20763,3,2,72484,72487,72489,3,5,0
20764,5,1,72489,72489,72490,0,1,0
20765,6,3,72495,72495,72498,0,3,5
20766,1,2,72496,72498,72500,2,4,0
20767,3,1,72499,72500,72501,1,2,0
20768,5,3,72504,72504,72507,0,3,3
20769,3,2,72507,72507,72509,0,2,0
20770,2,3,72509,72509,72512,0,3,0
20771,4,3,72513,72513,72516,0,3,1
20772,6,1,72519,72519,72520,0,1,3
20773,5,3,72524,72524,72527,0,3,4
20774,4,3,72528,72528,72531,0,3,1
20775,3,1,72531,72531,72532,0,1,0
20776,5,1,72536,72536,72537,0,1,4
20777,1,2,72537,72537,72539,0,2,0
20778,1,1,72538,72539,72540,1,2,0
20779,2,2,72540,72540,72542,0,2,0
20780,5,2,72545,72545,72547,0,2,3
20781,3,3,72548,72548,72551,0,3,1
20782,6,3,72554,72554,72557,0,3,3
20783,6,3,72560,72560,72563,0,3,3
20784,2,1,72562,72563,72564,1,2,0
20785,6,3,72568,72568,72571,0,3,4
20786,2,2,72570,72571,72573,1,3,0
20787,4,3,72574,72574,72577,0,3,1
20788,2,3,72576,72577,72580,1,4,0
20789,2,3,72578,72580,72583,2,5,0
20790,5,1,72583,72583,72584,0,1,0
20791,2,1,72585,72585,72586,0,1,1
20792,1,1,72586,72586,72587,0,1,0
20793,6,3,72592,72592,72595,0,3,5
20794,1,2,72593,72595,72597,2,4,0
20795,2,2,72595,72597,72599,2,4,0
20796,5,2,72600,72600,72602,0,2,1
20797,6,1,72606,72606,72607,0,1,4
20798,5,2,72611,72611,72613,0,2,4
20799,5,3,72616,72616,72619,0,3,3
20800,2,2,72618,72619,72621,1,3,0
20801,6,2,72624,72624,72626,0,2,3
20802,3,2,72627,72627,72629,0,2,1
20803,5,3,72632,72632,72635,0,3,3
20804,4,1,72636,72636,72637,0,1,1
20805,4,2,72640,72640,72642,0,2,3
20806,1,2,72641,72642,72644,1,3,0
20807,5,3,72646,72646,72649,0,3,2
20808,3,2,72649,72649,72651,0,2,0
20809,3,1,72652,72652,72653,0,1,1
20810,1,2,72653,72653,72655,0,2,0
20811,2,3,72655,72655,72658,0,3,0
20812,6,1,72661,72661,72662,0,1,3
20813,3,2,72664,72664,72666,0,2,2
20814,4,2,72668,72668,72670,0,2,2
20815,1,2,72669,72670,72672,1,3,0
20816,2,2,72671,72672,72674,1,3,0
20817,1,1,72672,72674,72675,2,3,0
20818,6,1,72678,72678,72679,0,1,3
20819,1,1,72679,72679,72680,0,1,0
20820,6,2,72685,72685,72687,0,2,5
20821,1,3,72686,72687,72690,1,4,0
20822,4,1,72690,72690,72691,0,1,0
20823,4,3,72694,72694,72697,0,3,3
20824,5,1,72699,72699,72700,0,1,2
20825,4,1,72703,72703,72704,0,1,3
20826,6,1,72709,72709,72710,0,1,5
20827,4,1,72713,72713,72714,0,1,3
20828,4,1,72717,72717,72718,0,1,3
20829,3,2,72720,72720,72722,0,2,2
20830,1,3,72721,72722,72725,1,4,0
20831,1,2,72722,72725,72727,3,5,0
20832,1,2,72723,72727,72729,4,6,0
20833,4,2,72727,72729,72731,2,4,0
20834,2,3,72729,72731,72734,2,5,0
20835,5,3,72734,72734,72737,0,3,0
20836,4,3,72738,72738,72741,0,3,1
20837,1,2,72739,72741,72743,2,4,0
20838,2,2,72741,72743,72745,2,4,0
20839,6,3,72747,72747,72750,0,3,2
20840,5,1,72752,72752,72753,0,1,2
20841,6,2,72758,72758,72760,0,2,5
20842,1,1,72759,72760,72761,1,2,0
20843,3,3,72762,72762,72765,0,3,1
20844,6,1,72768,72768,72769,0,1,3
20845,2,1,72770,72770,72771,0,1,1
20846,2,1,72772,72772,72773,0,1,1
20847,5,1,72777,72777,72778,0,1,4
20848,6,2,72783,72783,72785,0,2,5
20849,4,2,72787,72787,72789,0,2,2
20850,6,3,72793,72793,72796,0,3,4
20851,4,3,72797,72797,72800,0,3,1
20852,2,3,72799,72800,72803,1,4,0
20853,2,2,72801,72803,72805,2,4,0
20854,5,2,72806,72806,72808,0,2,1
20855,5,1,72811,72811,72812,0,1,3
20856,1,2,72812,72812,72814,0,2,0
20857,2,3,72814,72814,72817,0,3,0
20858,2,3,72816,72817,72820,1,4,0
20859,2,3,72818,72820,72823,2,5,0
20860,6,1,72824,72824,72825,0,1,1
20861,3,2,72827,72827,72829,0,2,2
20862,1,3,72828,72829,72832,1,4,0
20863,4,2,72832,72832,72834,0,2,0
20864,4,3,72836,72836,72839,0,3,2
20865,1,1,72837,72839,72840,2,3,0
20866,6,3,72843,72843,72846,0,3,3
20867,5,3,72848,72848,72851,0,3,2
20868,2,1,72850,72851,72852,1,2,0
20869,6,2,72856,72856,72858,0,2,4
20870,3,3,72859,72859,72862,0,3,1
20871,1,1,72860,72862,72863,2,3,0
20872,2,3,72862,72863,72866,1,4,0
20873,1,3,72863,72866,72869,3,6,0
20874,5,1,72868,72869,72870,1,2,0
20875,1,1,72869,72870,72871,1,2,0
20876,2,1,72871,72871,72872,0,1,0
20877,2,3,72873,72873,72876,0,3,1
20878,4,2,72877,72877,72879,0,2,1
20879,3,2,72880,72880,72882,0,2,1
20880,4,1,72884,72884,72885,0,1,2
20881,6,1,72890,72890,72891,0,1,5
20882,4,1,72894,72894,72895,0,1,3
20883,1,2,72895,72895,72897,0,2,0
20884,6,3,72901,72901,72904,0,3,4
20885,6,2,72907,72907,72909,0,2,3
20886,5,1,72912,72912,72913,0,1,3
20887,1,1,72913,72913,72914,0,1,0
20888,1,2,72914,72914,72916,0,2,0
20889,4,2,72918,72918,72920,0,2,2
20890,3,1,72921,72921,72922,0,1,1
20891,5,1,72926,72926,72927,0,1,4
20892,2,2,72928,72928,72930,0,2,1
20893,4,2,72932,72932,72934,0,2,2
20894,4,2,72936,72936,72938,0,2,2
20895,5,2,72941,72941,72943,0,2,3
20896,3,3,72944,72944,72947,0,3,1
20897,1,3,72945,72947,72950,2,5,0
20898,1,1,72946,72950,72951,4,5,0
20899,6,3,72952,72952,72955,0,3,1
20900,3,3,72955,72955,72958,0,3,0
20901,1,1,72956,72958,72959,2,3,0
20902,6,1,72962,72962,72963,0,1,3
20903,5,2,72967,72967,72969,0,2,4
20904,1,2,72968,72969,72971,1,3,0
20905,3,3,72971,72971,72974,0,3,0
20906,2,2,72973,72974,72976,1,3,0
20907,4,3,72977,72977,72980,0,3,1
20908,6,2,72983,72983,72985,0,2,3
20909,3,3,72986,72986,72989,0,3,1
20910,4,3,72990,72990,72993,0,3,1
20911,2,1,72992,72993,72994,1,2,0
20912,4,2,72996,72996,72998,0,2,2
20913,3,2,72999,72999,73001,0,2,1
20914,2,1,73001,73001,73002,0,1,0
20915,2,1,73003,73003,73004,0,1,1
20916,1,2,73004,73004,73006,0,2,0
20917,6,2,73010,73010,73012,0,2,4
20918,3,1,73013,73013,73014,0,1,1
20919,3,2,73016,73016,73018,0,2,2
20920,5,1,73021,73021,73022,0,1,3
20921,4,2,73025,73025,73027,0,2,3
20922,5,3,73030,73030,73033,0,3,3
20923,3,1,73033,73033,73034,0,1,0
20924,3,3,73036,73036,73039,0,3,2
20925,3,2,73039,73039,73041,0,2,0
20926,2,3,73041,73041,73044,0,3,0
20927,2,1,73043,73044,73045,1,2,0
20928,6,3,73049,73049,73052,0,3,4
20929,2,2,73051,73052,73054,1,3,0
20930,1,3,73052,73054,73057,2,5,0
20931,4,2,73056,73057,73059,1,3,0
20932,1,3,73057,73059,73062,2,5,0
20933,4,1,73061,73062,73063,1,2,0
20934,1,2,73062,73063,73065,1,3,0
20935,5,2,73067,73067,73069,0,2,2
20936,6,3,73073,73073,73076,0,3,4
20937,2,1,73075,73076,73077,1,2,0
20938,5,3,73080,73080,73083,0,3,3
20939,3,3,73083,73083,73086,0,3,0
20940,1,1,73084,73086,73087,2,3,0
20941,5,3,73089,73089,73092,0,3,2
20942,1,2,73090,73092,73094,2,4,0
20943,1,2,73091,73094,73096,3,5,0
20944,3,3,73094,73096,73099,2,5,0
20945,5,1,73099,73099,73100,0,1,0
20946,4,2,73103,73103,73105,0,2,3
20947,5,3,73108,73108,73111,0,3,3
20948,5,2,73113,73113,73115,0,2,2
20949,3,1,73116,73116,73117,0,1,1
20950,5,3,73121,73121,73124,0,3,4
20951,5,1,73126,73126,73127,0,1,2
20952,4,2,73130,73130,73132,0,2,3
20953,3,3,73133,73133,73136,0,3,1
20954,5,1,73138,73138,73139,0,1,2
20955,2,3,73140,73140,73143,0,3,1
20956,3,2,73143,73143,73145,0,2,0
20957,3,1,73146,73146,73147,0,1,1
20958,2,1,73148,73148,73149,0,1,1
20959,6,1,73154,73154,73155,0,1,5
20960,1,1,73155,73155,73156,0,1,0
20961,2,2,73157,73157,73159,0,2,1
20962,5,2,73162,73162,73164,0,2,3
20963,6,1,73168,73168,73169,0,1,4
20964,2,2,73170,73170,73172,0,2,1
20965,1,1,73171,73172,73173,1,2,0
20966,4,1,73175,73175,73176,0,1,2
20967,4,2,73179,73179,73181,0,2,3
20968,1,1,73180,73181,73182,1,2,0
20969,1,3,73181,73182,73185,1,4,0
20970,3,1,73184,73185,73186,1,2,0
20971,4,2,73188,73188,73190,0,2,2
20972,2,1,73190,73190,73191,0,1,0
20973,1,3,73191,73191,73194,0,3,0
20974,2,2,73193,73194,73196,1,3,0
20975,3,3,73196,73196,73199,0,3,0
20976,1,1,73197,73199,73200,2,3,0
20977,5,3,73202,73202,73205,0,3,2
20978,4,3,73206,73206,73209,0,3,1
20979,3,1,73209,73209,73210,0,1,0
20980,1,3,73210,73210,73213,0,3,0
20981,4,2,73214,73214,73216,0,2,1
20982,6,2,73220,73220,73222,0,2,4
20983,4,3,73224,73224,73227,0,3,2
20984,1,3,73225,73227,73230,2,5,0
20985,2,2,73227,73230,73232,3,5,0
20986,1,1,73228,73232,73233,4,5,0
20987,5,1,73233,73233,73234,0,1,0
20988,1,1,73234,73234,73235,0,1,0
20989,4,1,73238,73238,73239,0,1,3
20990,6,2,73244,73244,73246,0,2,5
20991,2,1,73246,73246,73247,0,1,0
20992,3,3,73249,73249,73252,0,3,2
20993,5,3,73254,73254,73257,0,3,2
20994,2,1,73256,73257,73258,1,2,0
20995,5,2,73261,73261,73263,0,2,3
20996,1,3,73262,73263,73266,1,4,0
20997,2,1,73264,73266,73267,2,3,0
20998,2,3,73266,73267,73270,1,4,0
20999,6,3,73272,73272,73275,0,3,2
21000,1,3,73273,73275,73278,2,5,0
21001,2,1,73275,73278,73279,3,4,0
21002,1,1,73276,73279,73280,3,4,0
21003,1,3,73277,73280,73283,3,6,0
21004,5,3,73282,73283,73286,1,4,0
21005,4,2,73286,73286,73288,0,2,0
21006,6,3,73292,73292,73295,0,3,4
21007,6,2,73298,73298,73300,0,2,3
21008,5,3,73303,73303,73306,0,3,3
21009,5,2,73308,73308,73310,0,2,2
21010,4,2,73312,73312,73314,0,2,2
21011,1,3,73313,73314,73317,1,4,0
21012,1,3,73314,73317,73320,3,6,0
21013,4,1,73318,73320,73321,2,3,0
21014,4,3,73322,73322,73325,0,3,1
21015,5,3,73327,73327,73330,0,3,2
21016,5,3,73332,73332,73335,0,3,2
21017,6,2,73338,73338,73340,0,2,3
21018,4,2,73342,73342,73344,0,2,2
21019,4,2,73346,73346,73348,0,2,2
21020,5,2,73351,73351,73353,0,2,3
21021,5,1,73356,73356,73357,0,1,3
21022,4,1,73360,73360,73361,0,1,3
21023,4,3,73364,73364,73367,0,3,3
21024,1,3,73365,73367,73370,2,5,0
21025,1,2,73366,73370,73372,4,6,0
21026,1,1,73367,73372,73373,5,6,0
21027,1,1,73368,73373,73374,5,6,0
21028,3,3,73371,73374,73377,3,6,0
21029,5,3,73376,73377,73380,1,4,0
21030,5,1,73381,73381,73382,0,1,1
21031,2,1,73383,73383,73384,0,1,1
21032,5,3,73388,73388,73391,0,3,4
21033,4,3,73392,73392,73395,0,3,1
21034,5,1,73397,73397,73398,0,1,2
21035,6,1,73403,73403,73404,0,1,5
21036,4,2,73407,73407,73409,0,2,3
21037,6,2,73413,73413,73415,0,2,4
21038,1,2,73414,73415,73417,1,3,0
21039,2,2,73416,73417,73419,1,3,0
21040,3,1,73419,73419,73420,0,1,0
21041,2,3,73421,73421,73424,0,3,1
21042,6,1,73427,73427,73428,0,1,3
21043,2,2,73429,73429,73431,0,2,1
21044,1,3,73430,73431,73434,1,4,0
21045,4,3,73434,73434,73437,0,3,0
21046,4,2,73438,73438,73440,0,2,1
21047,5,3,73443,73443,73446,0,3,3
21048,2,3,73445,73446,73449,1,4,0
21049,4,2,73449,73449,73451,0,2,0
21050,3,1,73452,73452,73453,0,1,1
21051,3,2,73455,73455,73457,0,2,2
21052,3,1,73458,73458,73459,0,1,1
21053,3,1,73461,73461,73462,0,1,2
21054,3,2,73464,73464,73466,0,2,2
21055,2,2,73466,73466,73468,0,2,0
21056,6,1,73472,73472,73473,0,1,4
21057,2,2,73474,73474,73476,0,2,1
21058,2,1,73476,73476,73477,0,1,0
21059,2,3,73478,73478,73481,0,3,1
21060,2,3,73480,73481,73484,1,4,0
21061,1,2,73481,73484,73486,3,5,0
21062,5,2,73486,73486,73488,0,2,0
21063,3,2,73489,73489,73491,0,2,1
21064,1,3,73490,73491,73494,1,4,0
21065,4,3,73494,73494,73497,0,3,0
21066,4,3,73498,73498,73501,0,3,1
21067,4,2,73502,73502,73504,0,2,1
21068,2,3,73504,73504,73507,0,3,0
21069,3,1,73507,73507,73508,0,1,0
21070,2,2,73509,73509,73511,0,2,1
21071,2,3,73511,73511,73514,0,3,0
21072,6,3,73517,73517,73520,0,3,3
21073,1,3,73518,73520,73523,2,5,0
21074,6,2,73524,73524,73526,0,2,1
21075,4,3,73528,73528,73531,0,3,2
21076,1,3,73529,73531,73534,2,5,0
21077,2,2,73531,73534,73536,3,5,0
21078,1,3,73532,73536,73539,4,7,0
21079,5,2,73537,73539,73541,2,4,0
21080,3,2,73540,73541,73543,1,3,0
21081,2,3,73542,73543,73546,1,4,0
21082,4,3,73546,73546,73549,0,3,0
21083,3,2,73549,73549,73551,0,2,0
21084,5,1,73554,73554,73555,0,1,3
21085,3,1,73557,73557,73558,0,1,2
21086,1,1,73558,73558,73559,0,1,0
21087,5,2,73563,73563,73565,0,2,4
21088,6,1,73569,73569,73570,0,1,4
21089,1,2,73570,73570,73572,0,2,0
21090,1,1,73571,73572,73573,1,2,0
21091,2,1,73573,73573,73574,0,1,0
21092,5,1,73578,73578,73579,0,1,4
21093,3,3,73581,73581,73584,0,3,2
21094,2,1,73583,73584,73585,1,2,0
21095,5,3,73588,73588,73591,0,3,3
21096,1,2,73589,73591,73593,2,4,0
21097,2,3,73591,73593,73596,2,5,0
21098,6,1,73597,73597,73598,0,1,1
21099,1,2,73598,73598,73600,0,2,0
21100,6,3,73604,73604,73607,0,3,4
21101,5,1,73609,73609,73610,0,1,2
21102,3,2,73612,73612,73614,0,2,2
21103,2,2,73614,73614,73616,0,2,0
21104,3,2,73617,73617,73619,0,2,1
21105,6,2,73623,73623,73625,0,2,4
21106,2,1,73625,73625,73626,0,1,0
21107,5,1,73630,73630,73631,0,1,4
21108,4,2,73634,73634,73636,0,2,3
21109,1,3,73635,73636,73639,1,4,0
21110,3,2,73638,73639,73641,1,3,0
21111,1,1,73639,73641,73642,2,3,0
21112,5,1,73644,73644,73645,0,1,2
21113,5,2,73649,73649,73651,0,2,4
21114,1,2,73650,73651,73653,1,3,0
21115,5,3,73655,73655,73658,0,3,2
21116,2,3,73657,73658,73661,1,4,0
21117,3,1,73660,73661,73662,1,2,0
21118,4,1,73664,73664,73665,0,1,2
21119,3,1,73667,73667,73668,0,1,2
21120,3,1,73670,73670,73671,0,1,2
21121,1,2,73671,73671,73673,0,2,0
21122,4,1,73675,73675,73676,0,1,2
21123,2,2,73677,73677,73679,0,2,1
21124,5,2,73682,73682,73684,0,2,3
21125,6,2,73688,73688,73690,0,2,4
21126,4,1,73692,73692,73693,0,1,2
21127,5,2,73697,73697,73699,0,2,4
21128,3,2,73700,73700,73702,0,2,1
21129,4,2,73704,73704,73706,0,2,2
21130,6,3,73710,73710,73713,0,3,4
21131,5,3,73715,73715,73718,0,3,2
21132,2,1,73717,73718,73719,1,2,0
21133,5,2,73722,73722,73724,0,2,3
21134,3,3,73725,73725,73728,0,3,1
21135,5,3,73730,73730,73733,0,3,2
21136,2,3,73732,73733,73736,1,4,0
21137,3,1,73735,73736,73737,1,2,0
21138,1,1,73736,73737,73738,1,2,0
21139,5,2,73741,73741,73743,0,2,3
21140,4,2,73745,73745,73747,0,2,2
21141,2,1,73747,73747,73748,0,1,0
21142,4,3,73751,73751,73754,0,3,3
21143,3,1,73754,73754,73755,0,1,0
21144,2,2,73756,73756,73758,0,2,1
21145,2,3,73758,73758,73761,0,3,0
21146,6,2,73764,73764,73766,0,2,3
21147,1,3,73765,73766,73769,1,4,0
21148,2,3,73767,73769,73772,2,5,0
21149,5,2,73772,73772,73774,0,2,0
21150,6,3,73778,73778,73781,0,3,4
21151,4,1,73782,73782,73783,0,1,1
21152,6,3,73788,73788,73791,0,3,5
21153,4,2,73792,73792,73794,0,2,1
21154,5,2,73797,73797,73799,0,2,3
21155,2,3,73799,73799,73802,0,3,0
21156,2,3,73801,73802,73805,1,4,0
21157,4,2,73805,73805,73807,0,2,0
21158,1,1,73806,73807,73808,1,2,0
21159,4,3,73810,73810,73813,0,3,2
21160,3,2,73813,73813,73815,0,2,0
21161,3,2,73816,73816,73818,0,2,1
21162,5,2,73821,73821,73823,0,2,3
21163,6,3,73827,73827,73830,0,3,4
21164,6,3,73833,73833,73836,0,3,3
21165,3,2,73836,73836,73838,0,2,0
21166,4,1,73840,73840,73841,0,1,2
21167,5,2,73845,73845,73847,0,2,4
21168,6,3,73851,73851,73854,0,3,4
21169,6,1,73857,73857,73858,0,1,3
21170,2,3,73859,73859,73862,0,3,1
21171,4,2,73863,73863,73865,0,2,1
21172,4,3,73867,73867,73870,0,3,2
21173,3,2,73870,73870,73872,0,2,0
21174,5,2,73875,73875,73877,0,2,3
21175,1,3,73876,73877,73880,1,4,0
21176,2,2,73878,73880,73882,2,4,0
21177,6,3,73884,73884,73887,0,3,2
21178,5,2,73889,73889,73891,0,2,2
21179,5,1,73894,73894,73895,0,1,3
21180,2,3,73896,73896,73899,0,3,1
21181,6,1,73902,73902,73903,0,1,3
21182,6,3,73908,73908,73911,0,3,5
21183,3,1,73911,73911,73912,0,1,0
21184,5,2,73916,73916,73918,0,2,4
21185,5,3,73921,73921,73924,0,3,3
21186,4,3,73925,73925,73928,0,3,1
21187,2,1,73927,73928,73929,1,2,0
21188,6,3,73933,73933,73936,0,3,4
21189,5,3,73938,73938,73941,0,3,2
21190,5,3,73943,73943,73946,0,3,2
21191,6,1,73949,73949,73950,0,1,3
21192,5,3,73954,73954,73957,0,3,4
21193,6,1,73960,73960,73961,0,1,3
21194,5,1,73965,73965,73966,0,1,4
21195,3,2,73968,73968,73970,0,2,2
21196,2,2,73970,73970,73972,0,2,0
21197,5,3,73975,73975,73978,0,3,3
21198,6,3,73981,73981,73984,0,3,3
21199,3,1,73984,73984,73985,0,1,0
21200,1,1,73985,73985,73986,0,1,0
21201,5,1,73990,73990,73991,0,1,4
21202,5,1,73995,73995,73996,0,1,4
21203,6,1,74001,74001,74002,0,1,5
21204,3,3,74004,74004,74007,0,3,2
21205,5,2,74009,74009,74011,0,2,2
21206,3,1,74012,74012,74013,0,1,1
21207,6,1,74018,74018,74019,0,1,5
21208,6,2,74024,74024,74026,0,2,5
21209,6,2,74030,74030,74032,0,2,4
21210,5,1,74035,74035,74036,0,1,3
21211,3,3,74038,74038,74041,0,3,2
21212,2,1,74040,74041,74042,1,2,0
21213,3,2,74043,74043,74045,0,2,1
21214,1,3,74044,74045,74048,1,4,0
21215,2,3,74046,74048,74051,2,5,0
21216,4,2,74050,74051,74053,1,3,0
21217,5,2,74055,74055,74057,0,2,2
21218,1,3,74056,74057,74060,1,4,0
21219,5,1,74061,74061,74062,0,1,1
21220,2,1,74063,74063,74064,0,1,1
21221,4,2,74067,74067,74069,0,2,3
21222,6,2,74073,74073,74075,0,2,4
21223,3,1,74076,74076,74077,0,1,1
21224,5,1,74081,74081,74082,0,1,4
21225,3,1,74084,74084,74085,0,1,2
21226,6,1,74090,74090,74091,0,1,5
21227,2,3,74092,74092,74095,0,3,1
21228,5,2,74097,74097,74099,0,2,2
21229,4,1,74101,74101,74102,0,1,2
21230,6,3,74107,74107,74110,0,3,5
21231,2,1,74109,74110,74111,1,2,0
21232,6,2,74115,74115,74117,0,2,4
21233,2,2,74117,74117,74119,0,2,0
21234,1,2,74118,74119,74121,1,3,0
21235,6,3,74124,74124,74127,0,3,3
21236,5,3,74129,74129,74132,0,3,2
21237,5,1,74134,74134,74135,0,1,2
21238,4,1,74138,74138,74139,0,1,3
21239,5,1,74143,74143,74144,0,1,4
21240,4,2,74147,74147,74149,0,2,3
21241,4,2,74151,74151,74153,0,2,2
21242,6,3,74157,74157,74160,0,3,4
21243,3,2,74160,74160,74162,0,2,0
21244,2,1,74162,74162,74163,0,1,0
21245,1,3,74163,74163,74166,0,3,0
21246,5,3,74168,74168,74171,0,3,2
21247,1,1,74169,74171,74172,2,3,0
21248,4,3,74173,74173,74176,0,3,1
21249,1,2,74174,74176,74178,2,4,0
21250,6,3,74180,74180,74183,0,3,2
21251,6,1,74186,74186,74187,0,1,3
21252,1,2,74187,74187,74189,0,2,0
21253,5,3,74192,74192,74195,0,3,3
21254,3,3,74195,74195,74198,0,3,0
21255,6,3,74201,74201,74204,0,3,3
21256,2,2,74203,74204,74206,1,3,0
21257,2,3,74205,74206,74209,1,4,0
21258,1,2,74206,74209,74211,3,5,0
21259,6,1,74212,74212,74213,0,1,1
21260,3,2,74215,74215,74217,0,2,2
21261,5,1,74220,74220,74221,0,1,3
21262,6,3,74226,74226,74229,0,3,5
21263,1,2,74227,74229,74231,2,4,0
21264,3,3,74230,74231,74234,1,4,0
21265,4,3,74234,74234,74237,0,3,0
21266,1,1,74235,74237,74238,2,3,0
21267,3,2,74238,74238,74240,0,2,0
21268,4,3,74242,74242,74245,0,3,2
21269,6,3,74248,74248,74251,0,3,3
21270,1,2,74249,74251,74253,2,4,0
21271,4,1,74253,74253,74254,0,1,0
21272,2,1,74255,74255,74256,0,1,1
21273,3,1,74258,74258,74259,0,1,2
21274,4,1,74262,74262,74263,0,1,3
21275,1,1,74263,74263,74264,0,1,0
21276,2,1,74265,74265,74266,0,1,1
21277,2,2,74267,74267,74269,0,2,1
21278,4,2,74271,74271,74273,0,2,2
21279,2,1,74273,74273,74274,0,1,0
21280,1,3,74274,74274,74277,0,3,0
21281,2,3,74276,74277,74280,1,4,0
21282,5,1,74281,74281,74282,0,1,1
21283,1,1,74282,74282,74283,0,1,0
21284,4,2,74286,74286,74288,0,2,3
21285,6,3,74292,74292,74295,0,3,4
21286,2,1,74294,74295,74296,1,2,0
21287,5,2,74299,74299,74301,0,2,3
21288,6,1,74305,74305,74306,0,1,4
21289,3,1,74308,74308,74309,0,1,2
21290,5,1,74313,74313,74314,0,1,4
21291,5,1,74318,74318,74319,0,1,4
21292,6,1,74324,74324,74325,0,1,5
21293,4,3,74328,74328,74331,0,3,3
21294,3,1,74331,74331,74332,0,1,0
21295,1,3,74332,74332,74335,0,3,0
21296,6,3,74338,74338,74341,0,3,3
21297,2,3,74340,74341,74344,1,4,0
21298,6,2,74346,74346,74348,0,2,2
21299,4,1,74350,74350,74351,0,1,2
21300,5,1,74355,74355,74356,0,1,4
21301,5,3,74360,74360,74363,0,3,4
21302,4,1,74364,74364,74365,0,1,1
21303,5,3,74369,74369,74372,0,3,4
21304,3,2,74372,74372,74374,0,2,0
21305,1,1,74373,74374,74375,1,2,0
21306,3,1,74376,74376,74377,0,1,1
21307,2,3,74378,74378,74381,0,3,1
21308,6,3,74384,74384,74387,0,3,3
21309,6,1,74390,74390,74391,0,1,3
21310,4,1,74394,74394,74395,0,1,3
21311,1,3,74395,74395,74398,0,3,0
21312,6,3,74401,74401,74404,0,3,3
21313,3,1,74404,74404,74405,0,1,0
21314,3,1,74407,74407,74408,0,1,2
21315,1,1,74408,74408,74409,0,1,0
21316,1,2,74409,74409,74411,0,2,0
21317,4,2,74413,74413,74415,0,2,2
21318,5,3,74418,74418,74421,0,3,3
21319,3,2,74421,74421,74423,0,2,0
21320,2,3,74423,74423,74426,0,3,0
21321,5,2,74428,74428,74430,0,2,2
21322,6,3,74434,74434,74437,0,3,4
21323,5,2,74439,74439,74441,0,2,2
21324,6,1,74445,74445,74446,0,1,4
21325,2,2,74447,74447,74449,0,2,1
21326,5,3,74452,74452,74455,0,3,3
21327,4,1,74456,74456,74457,0,1,1
21328,6,2,74462,74462,74464,0,2,5
21329,3,3,74465,74465,74468,0,3,1
21330,2,1,74467,74468,74469,1,2,0
21331,5,2,74472,74472,74474,0,2,3
21332,6,3,74478,74478,74481,0,3,4
21333,2,2,74480,74481,74483,1,3,0
21334,5,2,74485,74485,74487,0,2,2
21335,3,2,74488,74488,74490,0,2,1
21336,1,2,74489,74490,74492,1,3,0
21337,4,3,74493,74493,74496,0,3,1
21338,6,1,74499,74499,74500,0,1,3
21339,6,1,74505,74505,74506,0,1,5
21340,5,1,74510,74510,74511,0,1,4
21341,4,1,74514,74514,74515,0,1,3
21342,4,3,74518,74518,74521,0,3,3
21343,4,1,74522,74522,74523,0,1,1
21344,2,2,74524,74524,74526,0,2,1
21345,3,2,74527,74527,74529,0,2,1
21346,5,2,74532,74532,74534,0,2,3
21347,5,3,74537,74537,74540,0,3,3
21348,2,3,74539,74540,74543,1,4,0
21349,4,1,74543,74543,74544,0,1,0
21350,5,3,74548,74548,74551,0,3,4
21351,6,2,74554,74554,74556,0,2,3
21352,6,3,74560,74560,74563,0,3,4
21353,4,3,74564,74564,74567,0,3,1
21354,4,1,74568,74568,74569,0,1,1
21355,3,2,74571,74571,74573,0,2,2
21356,3,2,74574,74574,74576,0,2,1
21357,2,1,74576,74576,74577,0,1,0
21358,1,2,74577,74577,74579,0,2,0
21359,3,3,74580,74580,74583,0,3,1
21360,1,2,74581,74583,74585,2,4,0
21361,6,2,74587,74587,74589,0,2,2
21362,5,1,74592,74592,74593,0,1,3
21363,2,3,74594,74594,74597,0,3,1
21364,3,2,74597,74597,74599,0,2,0
21365,5,2,74602,74602,74604,0,2,3
21366,2,1,74604,74604,74605,0,1,0
21367,6,3,74610,74610,74613,0,3,5
21368,3,1,74613,74613,74614,0,1,0
21369,2,2,74615,74615,74617,0,2,1
21370,4,2,74619,74619,74621,0,2,2
21371,5,3,74624,74624,74627,0,3,3
21372,5,2,74629,74629,74631,0,2,2
21373,3,3,74632,74632,74635,0,3,1
21374,3,3,74635,74635,74638,0,3,0
21375,6,2,74641,74641,74643,0,2,3
21376,2,3,74643,74643,74646,0,3,0
21377,4,3,74647,74647,74650,0,3,1
21378,1,3,74648,74650,74653,2,5,0
21379,6,1,74654,74654,74655,0,1,1
21380,1,3,74655,74655,74658,0,3,0
21381,3,1,74658,74658,74659,0,1,0
21382,2,2,74660,74660,74662,0,2,1
21383,3,3,74663,74663,74666,0,3,1
21384,3,3,74666,74666,74669,0,3,0
21385,3,2,74669,74669,74671,0,2,0
21386,6,2,74675,74675,74677,0,2,4
21387,2,1,74677,74677,74678,0,1,0
21388,4,2,74681,74681,74683,0,2,3
21389,2,3,74683,74683,74686,0,3,0
21390,1,2,74684,74686,74688,2,4,0
21391,6,3,74690,74690,74693,0,3,2
21392,2,3,74692,74693,74696,1,4,0
21393,4,2,74696,74696,74698,0,2,0
21394,3,3,74699,74699,74702,0,3,1
21395,4,1,74703,74703,74704,0,1,1
21396,6,2,74709,74709,74711,0,2,5
21397,3,2,74712,74712,74714,0,2,1
21398,1,2,74713,74714,74716,1,3,0
21399,2,2,74715,74716,74718,1,3,0
21400,5,2,74720,74720,74722,0,2,2
21401,4,3,74724,74724,74727,0,3,2
21402,3,3,74727,74727,74730,0,3,0
21403,6,3,74733,74733,74736,0,3,3
21404,1,2,74734,74736,74738,2,4,0
21405,6,2,74740,74740,74742,0,2,2
21406,6,3,74746,74746,74749,0,3,4
21407,1,1,74747,74749,74750,2,3,0
21408,4,1,74751,74751,74752,0,1,1
21409,6,1,74757,74757,74758,0,1,5
21410,5,1,74762,74762,74763,0,1,4
21411,6,3,74768,74768,74771,0,3,5
21412,3,3,74771,74771,74774,0,3,0
21413,1,3,74772,74774,74777,2,5,0
21414,4,3,74776,74777,74780,1,4,0
21415,6,3,74782,74782,74785,0,3,2
21416,3,1,74785,74785,74786,0,1,0
21417,1,1,74786,74786,74787,0,1,0
21418,2,1,74788,74788,74789,0,1,1
21419,2,2,74790,74790,74792,0,2,1
21420,6,1,74796,74796,74797,0,1,4
21421,5,1,74801,74801,74802,0,1,4
21422,6,3,74807,74807,74810,0,3,5
21423,5,3,74812,74812,74815,0,3,2
21424,5,1,74817,74817,74818,0,1,2
21425,6,3,74823,74823,74826,0,3,5
21426,3,3,74826,74826,74829,0,3,0
21427,5,2,74831,74831,74833,0,2,2
21428,4,2,74835,74835,74837,0,2,2
21429,6,2,74841,74841,74843,0,2,4
21430,4,2,74845,74845,74847,0,2,2
21431,4,2,74849,74849,74851,0,2,2
21432,3,2,74852,74852,74854,0,2,1
21433,3,1,74855,74855,74856,0,1,1
21434,1,2,74856,74856,74858,0,2,0
21435,6,1,74862,74862,74863,0,1,4
21436,2,3,74864,74864,74867,0,3,1
21437,5,2,74869,74869,74871,0,2,2
21438,4,2,74873,74873,74875,0,2,2
21439,4,2,74877,74877,74879,0,2,2
21440,2,2,74879,74879,74881,0,2,0
21441,4,1,74883,74883,74884,0,1,2
21442,4,3,74887,74887,74890,0,3,3
21443,1,1,74888,74890,74891,2,3,0
21444,6,3,74894,74894,74897,0,3,3
21445,3,3,74897,74897,74900,0,3,0
21446,3,3,74900,74900,74903,0,3,0
21447,6,2,74906,74906,74908,0,2,3
21448,1,2,74907,74908,74910,1,3,0
21449,5,2,74912,74912,74914,0,2,2
21450,6,3,74918,74918,74921,0,3,4
21451,6,3,74924,74924,74927,0,3,3
21452,3,2,74927,74927,74929,0,2,0
21453,5,3,74932,74932,74935,0,3,3
21454,3,3,74935,74935,74938,0,3,0
21455,4,2,74939,74939,74941,0,2,1
21456,2,2,74941,74941,74943,0,2,0
21457,6,2,74947,74947,74949,0,2,4
21458,5,1,74952,74952,74953,0,1,3
21459,4,2,74956,74956,74958,0,2,3
21460,6,1,74962,74962,74963,0,1,4
21461,2,1,74964,74964,74965,0,1,1
21462,1,2,74965,74965,74967,0,2,0
21463,4,2,74969,74969,74971,0,2,2
21464,2,2,74971,74971,74973,0,2,0
21465,3,2,74974,74974,74976,0,2,1
21466,6,3,74980,74980,74983,0,3,4
21467,4,3,74984,74984,74987,0,3,1
21468,4,3,74988,74988,74991,0,3,1
21469,4,3,74992,74992,74995,0,3,1
21470,2,1,74994,74995,74996,1,2,0
21471,5,1,74999,74999,75000,0,1,3
21472,1,3,75000,75000,75003,0,3,0
21473,5,3,75005,75005,75008,0,3,2
21474,2,2,75007,75008,75010,1,3,0
21475,6,2,75013,75013,75015,0,2,3
21476,1,1,75014,75015,75016,1,2,0
21477,5,2,75019,75019,75021,0,2,3
21478,1,3,75020,75021,75024,1,4,0
21479,1,2,75021,75024,75026,3,5,0
21480,5,3,75026,75026,75029,0,3,0
21481,5,3,75031,75031,75034,0,3,2
21482,1,3,75032,75034,75037,2,5,0
21483,1,2,75033,75037,75039,4,6,0
21484,5,1,75038,75039,75040,1,2,0
21485,6,2,75044,75044,75046,0,2,4
21486,4,2,75048,75048,75050,0,2,2
21487,2,3,75050,75050,75053,0,3,0
21488,3,1,75053,75053,75054,0,1,0
21489,5,3,75058,75058,75061,0,3,4
21490,5,3,75063,75063,75066,0,3,2
21491,4,2,75067,75067,75069,0,2,1
21492,4,3,75071,75071,75074,0,3,2
21493,6,3,75077,75077,75080,0,3,3
21494,5,1,75082,75082,75083,0,1,2
21495,4,3,75086,75086,75089,0,3,3
21496,4,2,75090,75090,75092,0,2,1
21497,4,2,75094,75094,75096,0,2,2
21498,5,1,75099,75099,75100,0,1,3
21499,1,3,75100,75100,75103,0,3,0
21500,3,2,75103,75103,75105,0,2,0
21501,4,2,75107,75107,75109,0,2,2
21502,2,2,75109,75109,75111,0,2,0
21503,2,2,75111,75111,75113,0,2,0
21504,5,2,75116,75116,75118,0,2,3
21505,5,1,75121,75121,75122,0,1,3
21506,3,3,75124,75124,75127,0,3,2
21507,4,1,75128,75128,75129,0,1,1
21508,6,1,75134,75134,75135,0,1,5
21509,3,3,75137,75137,75140,0,3,2
21510,3,2,75140,75140,75142,0,2,0
21511,1,2,75141,75142,75144,1,3,0
21512,1,1,75142,75144,75145,2,3,0
21513,1,3,75143,75145,75148,2,5,0
21514,5,1,75148,75148,75149,0,1,0
21515,3,1,75151,75151,75152,0,1,2
21516,5,2,75156,75156,75158,0,2,4
21517,4,1,75160,75160,75161,0,1,2
21518,4,2,75164,75164,75166,0,2,3
21519,4,1,75168,75168,75169,0,1,2
21520,6,3,75174,75174,75177,0,3,5
21521,4,1,75178,75178,75179,0,1,1
21522,1,1,75179,75179,75180,0,1,0
21523,5,2,75184,75184,75186,0,2,4
21524,4,1,75188,75188,75189,0,1,2
21525,3,3,75191,75191,75194,0,3,2
21526,6,3,75197,75197,75200,0,3,3
21527,5,2,75202,75202,75204,0,2,2
21528,1,3,75203,75204,75207,1,4,0
21529,2,3,75205,75207,75210,2,5,0
21530,3,1,75208,75210,75211,2,3,0
21531,5,1,75213,75213,75214,0,1,2
21532,4,2,75217,75217,75219,0,2,3
21533,5,1,75222,75222,75223,0,1,3
21534,5,1,75227,75227,75228,0,1,4
21535,1,2,75228,75228,75230,0,2,0
21536,1,1,75229,75230,75231,1,2,0
21537,2,1,75231,75231,75232,0,1,0
21538,2,3,75233,75233,75236,0,3,1
21539,5,3,75238,75238,75241,0,3,2
21540,6,3,75244,75244,75247,0,3,3
21541,4,1,75248,75248,75249,0,1,1
21542,5,1,75253,75253,75254,0,1,4
21543,6,2,75259,75259,75261,0,2,5
21544,3,3,75262,75262,75265,0,3,1
21545,3,2,75265,75265,75267,0,2,0
21546,3,3,75268,75268,75271,0,3,1
21547,5,2,75273,75273,75275,0,2,2
21548,3,1,75276,75276,75277,0,1,1
21549,3,1,75279,75279,75280,0,1,2
21550,4,2,75283,75283,75285,0,2,3
21551,2,2,75285,75285,75287,0,2,0
21552,1,1,75286,75287,75288,1,2,0
21553,1,3,75287,75288,75291,1,4,0
21554,1,3,75288,75291,75294,3,6,0
21555,1,2,75289,75294,75296,5,7,0
21556,5,3,75294,75296,75299,2,5,0
21557,2,2,75296,75299,75301,3,5,0
21558,4,3,75300,75301,75304,1,4,0
21559,5,2,75305,75305,75307,0,2,1
21560,3,3,75308,75308,75311,0,3,1
21561,4,1,75312,75312,75313,0,1,1
21562,4,2,75316,75316,75318,0,2,3
21563,6,2,75322,75322,75324,0,2,4
21564,1,3,75323,75324,75327,1,4,0
21565,6,1,75329,75329,75330,0,1,2
21566,6,1,75335,75335,75336,0,1,5
21567,6,1,75341,75341,75342,0,1,5
21568,1,3,75342,75342,75345,0,3,0
21569,5,3,75347,75347,75350,0,3,2
21570,4,1,75351,75351,75352,0,1,1
21571,6,1,75357,75357,75358,0,1,5
21572,4,3,75361,75361,75364,0,3,3
21573,1,3,75362,75364,75367,2,5,0
21574,4,2,75366,75367,75369,1,3,0
21575,4,2,75370,75370,75372,0,2,1
21576,5,1,75375,75375,75376,0,1,3
21577,4,1,75379,75379,75380,0,1,3
21578,3,3,75382,75382,75385,0,3,2
21579,4,2,75386,75386,75388,0,2,1
21580,4,1,75390,75390,75391,0,1,2
21581,3,3,75393,75393,75396,0,3,2
21582,2,2,75395,75396,75398,1,3,0
21583,3,2,75398,75398,75400,0,2,0
21584,1,1,75399,75400,75401,1,2,0
21585,5,1,75404,75404,75405,0,1,3
21586,3,1,75407,75407,75408,0,1,2
21587,2,3,75409,75409,75412,0,3,1
21588,4,2,75413,75413,75415,0,2,1
21589,2,2,75415,75415,75417,0,2,0
21590,4,1,75419,75419,75420,0,1,2
21591,6,3,75425,75425,75428,0,3,5
21592,3,2,75428,75428,75430,0,2,0
21593,3,1,75431,75431,75432,0,1,1
21594,4,3,75435,75435,75438,0,3,3
21595,6,2,75441,75441,75443,0,2,3
21596,5,1,75446,75446,75447,0,1,3
21597,1,1,75447,75447,75448,0,1,0
21598,4,3,75451,75451,75454,0,3,3
21599,2,1,75453,75454,75455,1,2,0
21600,2,3,75455,75455,75458,0,3,0
21601,6,3,75461,75461,75464,0,3,3
21602,4,3,75465,75465,75468,0,3,1
21603,4,2,75469,75469,75471,0,2,1
21604,2,2,75471,75471,75473,0,2,0
21605,6,2,75477,75477,75479,0,2,4
21606,2,2,75479,75479,75481,0,2,0
21607,4,3,75483,75483,75486,0,3,2
21608,1,3,75484,75486,75489,2,5,0
21609,6,1,75490,75490,75491,0,1,1
21610,1,2,75491,75491,75493,0,2,0
21611,6,1,75497,75497,75498,0,1,4
21612,4,2,75501,75501,75503,0,2,3
21613,3,1,75504,75504,75505,0,1,1
21614,2,2,75506,75506,75508,0,2,1
21615,1,1,75507,75508,75509,1,2,0
21616,5,3,75512,75512,75515,0,3,3
21617,2,1,75514,75515,75516,1,2,0
21618,4,3,75518,75518,75521,0,3,2
21619,5,3,75523,75523,75526,0,3,2
21620,5,3,75528,75528,75531,0,3,2
21621,4,3,75532,75532,75535,0,3,1
21622,4,1,75536,75536,75537,0,1,1
21623,6,1,75542,75542,75543,0,1,5
21624,3,2,75545,75545,75547,0,2,2
21625,2,1,75547,75547,75548,0,1,0
21626,2,1,75549,75549,75550,0,1,1
21627,2,1,75551,75551,75552,0,1,1
21628,4,3,75555,75555,75558,0,3,3
21629,3,2,75558,75558,75560,0,2,0
21630,5,3,75563,75563,75566,0,3,3
21631,6,2,75569,75569,75571,0,2,3
21632,4,1,75573,75573,75574,0,1,2
21633,2,3,75575,75575,75578,0,3,1
21634,5,3,75580,75580,75583,0,3,2
21635,5,3,75585,75585,75588,0,3,2
21636,4,3,75589,75589,75592,0,3,1
21637,5,1,75594,75594,75595,0,1,2
21638,3,1,75597,75597,75598,0,1,2
21639,3,3,75600,75600,75603,0,3,2
21640,5,1,75605,75605,75606,0,1,2
21641,6,1,75611,75611,75612,0,1,5
21642,1,1,75612,75612,75613,0,1,0
21643,2,3,75614,75614,75617,0,3,1
21644,1,1,75615,75617,75618,2,3,0
21645,6,2,75621,75621,75623,0,2,3
21646,4,1,75625,75625,75626,0,1,2
21647,5,2,75630,75630,75632,0,2,4
21648,6,3,75636,75636,75639,0,3,4
21649,3,3,75639,75639,75642,0,3,0
21650,5,3,75644,75644,75647,0,3,2
21651,5,1,75649,75649,75650,0,1,2
21652,3,1,75652,75652,75653,0,1,2
21653,2,1,75654,75654,75655,0,1,1
21654,3,1,75657,75657,75658,0,1,2
21655,4,1,75661,75661,75662,0,1,3
21656,3,3,75664,75664,75667,0,3,2
21657,4,1,75668,75668,75669,0,1,1
21658,5,3,75673,75673,75676,0,3,4
21659,6,3,75679,75679,75682,0,3,3
21660,1,2,75680,75682,75684,2,4,0
21661,2,3,75682,75684,75687,2,5,0
21662,4,2,75686,75687,75689,1,3,0
21663,6,1,75692,75692,75693,0,1,3
21664,1,2,75693,75693,75695,0,2,0
21665,6,2,75699,75699,75701,0,2,4
21666,3,3,75702,75702,75705,0,3,1
21667,2,3,75704,75705,75708,1,4,0
21668,5,2,75709,75709,75711,0,2,1
21669,2,1,75711,75711,75712,0,1,0
21670,2,2,75713,75713,75715,0,2,1
21671,2,3,75715,75715,75718,0,3,0
21672,4,3,75719,75719,75722,0,3,1
21673,5,1,75724,75724,75725,0,1,2
21674,3,1,75727,75727,75728,0,1,2
21675,3,1,75730,75730,75731,0,1,2
21676,3,1,75733,75733,75734,0,1,2
21677,4,3,75737,75737,75740,0,3,3
21678,2,2,75739,75740,75742,1,3,0
21679,4,1,75743,75743,75744,0,1,1
21680,2,2,75745,75745,75747,0,2,1
21681,3,1,75748,75748,75749,0,1,1
21682,4,3,75752,75752,75755,0,3,3
21683,4,3,75756,75756,75759,0,3,1
21684,5,3,75761,75761,75764,0,3,2
21685,2,1,75763,75764,75765,1,2,0
21686,3,3,75766,75766,75769,0,3,1
21687,3,3,75769,75769,75772,0,3,0
21688,6,1,75775,75775,75776,0,1,3
21689,3,1,75778,75778,75779,0,1,2
21690,5,2,75783,75783,75785,0,2,4
21691,4,3,75787,75787,75790,0,3,2
21692,3,2,75790,75790,75792,0,2,0
21693,5,3,75795,75795,75798,0,3,3
21694,5,1,75800,75800,75801,0,1,2
21695,4,3,75804,75804,75807,0,3,3
21696,2,3,75806,75807,75810,1,4,0
21697,5,2,75811,75811,75813,0,2,1
21698,2,3,75813,75813,75816,0,3,0
21699,4,3,75817,75817,75820,0,3,1
21700,6,3,75823,75823,75826,0,3,3
21701,5,1,75828,75828,75829,0,1,2
21702,3,2,75831,75831,75833,0,2,2
21703,3,1,75834,75834,75835,0,1,1
21704,1,2,75835,75835,75837,0,2,0
21705,5,2,75840,75840,75842,0,2,3
21706,1,1,75841,75842,75843,1,2,0
21707,4,1,75845,75845,75846,0,1,2
21708,4,2,75849,75849,75851,0,2,3
21709,2,3,75851,75851,75854,0,3,0
21710,1,3,75852,75854,75857,2,5,0
21711,5,1,75857,75857,75858,0,1,0
21712,1,2,75858,75858,75860,0,2,0
21713,4,1,75862,75862,75863,0,1,2
21714,4,2,75866,75866,75868,0,2,3
21715,6,2,75872,75872,75874,0,2,4
21716,5,2,75877,75877,75879,0,2,3
21717,1,2,75878,75879,75881,1,3,0
21718,2,2,75880,75881,75883,1,3,0
21719,2,2,75882,75883,75885,1,3,0
21720,3,2,75885,75885,75887,0,2,0
21721,6,1,75891,75891,75892,0,1,4
21722,3,3,75894,75894,75897,0,3,2
21723,2,1,75896,75897,75898,1,2,0
21724,6,1,75902,75902,75903,0,1,4
21725,1,1,75903,75903,75904,0,1,0
21726,2,3,75905,75905,75908,0,3,1
21727,6,1,75911,75911,75912,0,1,3
21728,3,1,75914,75914,75915,0,1,2
21729,3,2,75917,75917,75919,0,2,2
21730,1,1,75918,75919,75920,1,2,0
21731,1,2,75919,75920,75922,1,3,0
21732,1,1,75920,75922,75923,2,3,0
21733,4,2,75924,75924,75926,0,2,1
21734,3,3,75927,75927,75930,0,3,1
21735,6,1,75933,75933,75934,0,1,3
21736,5,3,75938,75938,75941,0,3,4
21737,3,3,75941,75941,75944,0,3,0
21738,3,2,75944,75944,75946,0,2,0
21739,2,3,75946,75946,75949,0,3,0
21740,4,2,75950,75950,75952,0,2,1
21741,6,2,75956,75956,75958,0,2,4
21742,5,2,75961,75961,75963,0,2,3
21743,3,2,75964,75964,75966,0,2,1
21744,5,1,75969,75969,75970,0,1,3
21745,1,1,75970,75970,75971,0,1,0
21746,6,2,75976,75976,75978,0,2,5
21747,6,1,75982,75982,75983,0,1,4
21748,6,3,75988,75988,75991,0,3,5
21749,4,1,75992,75992,75993,0,1,1
21750,6,1,75998,75998,75999,0,1,5
21751,4,1,76002,76002,76003,0,1,3
21752,6,1,76008,76008,76009,0,1,5
21753,2,2,76010,76010,76012,0,2,1
21754,5,3,76015,76015,76018,0,3,3
21755,1,2,76016,76018,76020,2,4,0
21756,2,2,76018,76020,76022,2,4,0
21757,6,3,76024,76024,76027,0,3,2
21758,4,3,76028,76028,76031,0,3,1
21759,3,3,76031,76031,76034,0,3,0
21760,6,2,76037,76037,76039,0,2,3
21761,2,1,76039,76039,76040,0,1,0
21762,5,1,76044,76044,76045,0,1,4
21763,4,1,76048,76048,76049,0,1,3
21764,6,3,76054,76054,76057,0,3,5
21765,6,3,76060,76060,76063,0,3,3
21766,6,3,76066,76066,76069,0,3,3
21767,4,3,76070,76070,76073,0,3,1
21768,4,3,76074,76074,76077,0,3,1
21769,3,3,76077,76077,76080,0,3,0
21770,4,3,76081,76081,76084,0,3,1
21771,5,3,76086,76086,76089,0,3,2
21772,1,1,76087,76089,76090,2,3,0
21773,1,1,76088,76090,76091,2,3,0
21774,2,1,76090,76091,76092,1,2,0
21775,4,3,76094,76094,76097,0,3,2
21776,4,2,76098,76098,76100,0,2,1
21777,6,2,76104,76104,76106,0,2,4
21778,6,2,76110,76110,76112,0,2,4
21779,4,3,76114,76114,76117,0,3,2
21780,2,1,76116,76117,76118,1,2,0
21781,3,3,76119,76119,76122,0,3,1
21782,3,1,76122,76122,76123,0,1,0
21783,5,3,76127,76127,76130,0,3,4
21784,2,2,76129,76130,76132,1,3,0
21785,1,1,76130,76132,76133,2,3,0
21786,3,1,76133,76133,76134,0,1,0
21787,2,1,76135,76135,76136,0,1,1
21788,1,2,76136,76136,76138,0,2,0
21789,6,1,76142,76142,76143,0,1,4
21790,1,1,76143,76143,76144,0,1,0
21791,5,1,76148,76148,76149,0,1,4
21792,6,2,76154,76154,76156,0,2,5
21793,5,1,76159,76159,76160,0,1,3
21794,2,1,76161,76161,76162,0,1,1
21795,6,2,76167,76167,76169,0,2,5
21796,1,3,76168,76169,76172,1,4,0
21797,2,2,76170,76172,76174,2,4,0
21798,5,3,76175,76175,76178,0,3,1
21799,2,1,76177,76178,76179,1,2,0
21800,2,1,76179,76179,76180,0,1,0
21801,6,3,76185,76185,76188,0,3,5
21802,6,3,76191,76191,76194,0,3,3
21803,2,1,76193,76194,76195,1,2,0
21804,6,2,76199,76199,76201,0,2,4
21805,4,2,76203,76203,76205,0,2,2
21806,2,3,76205,76205,76208,0,3,0
21807,5,1,76210,76210,76211,0,1,2
21808,6,2,76216,76216,76218,0,2,5
21809,6,3,76222,76222,76225,0,3,4
21810,3,3,76225,76225,76228,0,3,0
21811,5,3,76230,76230,76233,0,3,2
21812,6,3,76236,76236,76239,0,3,3
21813,3,2,76239,76239,76241,0,2,0
21814,3,2,76242,76242,76244,0,2,1
21815,3,2,76245,76245,76247,0,2,1
21816,5,1,76250,76250,76251,0,1,3
21817,5,1,76255,76255,76256,0,1,4
21818,1,2,76256,76256,76258,0,2,0
21819,6,3,76262,76262,76265,0,3,4
21820,6,2,76268,76268,76270,0,2,3
21821,2,3,76270,76270,76273,0,3,0
21822,5,3,76275,76275,76278,0,3,2
21823,3,3,76278,76278,76281,0,3,0
21824,3,1,76281,76281,76282,0,1,0
21825,4,1,76285,76285,76286,0,1,3
21826,4,1,76289,76289,76290,0,1,3
21827,1,1,76290,76290,76291,0,1,0
21828,1,3,76291,76291,76294,0,3,0
21829,3,1,76294,76294,76295,0,1,0
21830,4,2,76298,76298,76300,0,2,3
21831,6,2,76304,76304,76306,0,2,4
21832,1,2,76305,76306,76308,1,3,0
21833,4,2,76309,76309,76311,0,2,1
21834,3,2,76312,76312,76314,0,2,1
21835,4,1,76316,76316,76317,0,1,2
21836,2,1,76318,76318,76319,0,1,1
21837,3,3,76321,76321,76324,0,3,2
21838,2,3,76323,76324,76327,1,4,0
21839,6,2,76329,76329,76331,0,2,2
21840,2,1,76331,76331,76332,0,1,0
21841,5,1,76336,76336,76337,0,1,4
21842,5,1,76341,76341,76342,0,1,4
21843,6,2,76347,76347,76349,0,2,5
21844,2,2,76349,76349,76351,0,2,0
21845,5,1,76354,76354,76355,0,1,3
21846,3,1,76357,76357,76358,0,1,2
21847,6,1,76363,76363,76364,0,1,5
21848,4,2,76367,76367,76369,0,2,3
21849,1,2,76368,76369,76371,1,3,0
21850,1,1,76369,76371,76372,2,3,0
21851,2,1,76371,76372,76373,1,2,0
21852,1,1,76372,76373,76374,1,2,0
21853,6,2,76378,76378,76380,0,2,4
21854,5,2,76383,76383,76385,0,2,3
21855,1,2,76384,76385,76387,1,3,0
21856,3,1,76387,76387,76388,0,1,0
21857,1,3,76388,76388,76391,0,3,0
21858,1,2,76389,76391,76393,2,4,0
21859,1,1,76390,76393,76394,3,4,0
21860,5,3,76395,76395,76398,0,3,1
21861,6,3,76401,76401,76404,0,3,3
21862,4,1,76405,76405,76406,0,1,1
21863,2,3,76407,76407,76410,0,3,1
21864,6,3,76413,76413,76416,0,3,3
21865,4,3,76417,76417,76420,0,3,1
21866,6,1,76423,76423,76424,0,1,3
21867,3,2,76426,76426,76428,0,2,2
21868,2,3,76428,76428,76431,0,3,0
21869,3,3,76431,76431,76434,0,3,0
21870,4,1,76435,76435,76436,0,1,1
21871,6,3,76441,76441,76444,0,3,5
21872,6,2,76447,76447,76449,0,2,3
21873,5,3,76452,76452,76455,0,3,3
21874,4,2,76456,76456,76458,0,2,1
21875,5,3,76461,76461,76464,0,3,3
21876,6,3,76467,76467,76470,0,3,3
21877,6,3,76473,76473,76476,0,3,3
21878,1,3,76474,76476,76479,2,5,0
21879,3,2,76477,76479,76481,2,4,0
21880,2,1,76479,76481,76482,2,3,0
21881,4,2,76483,76483,76485,0,2,1
21882,1,2,76484,76485,76487,1,3,0
21883,6,1,76490,76490,76491,0,1,3
21884,3,2,76493,76493,76495,0,2,2
21885,3,1,76496,76496,76497,0,1,1
21886,2,1,76498,76498,76499,0,1,1
21887,1,2,76499,76499,76501,0,2,0
21888,6,2,76505,76505,76507,0,2,4
21889,2,1,76507,76507,76508,0,1,0
21890,2,3,76509,76509,76512,0,3,1
21891,5,2,76514,76514,76516,0,2,2
21892,6,1,76520,76520,76521,0,1,4
21893,2,1,76522,76522,76523,0,1,1
21894,3,2,76525,76525,76527,0,2,2
21895,1,3,76526,76527,76530,1,4,0
21896,5,2,76531,76531,76533,0,2,1
21897,3,3,76534,76534,76537,0,3,1
21898,3,3,76537,76537,76540,0,3,0
21899,3,2,76540,76540,76542,0,2,0
21900,1,2,76541,76542,76544,1,3,0
21901,1,2,76542,76544,76546,2,4,0
21902,2,1,76544,76546,76547,2,3,0
21903,4,1,76548,76548,76549,0,1,1
21904,4,1,76552,76552,76553,0,1,3
21905,3,2,76555,76555,76557,0,2,2
21906,3,2,76558,76558,76560,0,2,1
21907,1,3,76559,76560,76563,1,4,0
21908,6,2,76565,76565,76567,0,2,2
21909,2,1,76567,76567,76568,0,1,0
21910,5,1,76572,76572,76573,0,1,4
21911,6,3,76578,76578,76581,0,3,5
21912,3,1,76581,76581,76582,0,1,0
21913,6,3,76587,76587,76590,0,3,5
21914,1,2,76588,76590,76592,2,4,0
21915,6,2,76594,76594,76596,0,2,2
21916,2,2,76596,76596,76598,0,2,0
21917,4,3,76600,76600,76603,0,3,2
21918,6,1,76606,76606,76607,0,1,3
21919,6,3,76612,76612,76615,0,3,5
21920,1,1,76613,76615,76616,2,3,0
21921,2,2,76615,76616,76618,1,3,0
21922,5,3,76620,76620,76623,0,3,2
21923,3,1,76623,76623,76624,0,1,0
21924,2,1,76625,76625,76626,0,1,1
21925,4,3,76629,76629,76632,0,3,3
21926,1,3,76630,76632,76635,2,5,0
21927,6,1,76636,76636,76637,0,1,1
21928,6,3,76642,76642,76645,0,3,5
21929,2,2,76644,76645,76647,1,3,0
21930,2,2,76646,76647,76649,1,3,0
21931,1,2,76647,76649,76651,2,4,0
21932,6,2,76653,76653,76655,0,2,2
21933,5,3,76658,76658,76661,0,3,3
21934,6,1,76664,76664,76665,0,1,3
21935,6,3,76670,76670,76673,0,3,5
21936,5,3,76675,76675,76678,0,3,2
21937,5,1,76680,76680,76681,0,1,2
21938,2,1,76682,76682,76683,0,1,1
21939,5,1,76687,76687,76688,0,1,4
21940,1,3,76688,76688,76691,0,3,0
21941,6,2,76694,76694,76696,0,2,3
21942,6,1,76700,76700,76701,0,1,4
21943,5,2,76705,76705,76707,0,2,4
21944,4,1,76709,76709,76710,0,1,2
21945,6,1,76715,76715,76716,0,1,5
21946,5,2,76720,76720,76722,0,2,4
21947,3,1,76723,76723,76724,0,1,1
21948,4,3,76727,76727,76730,0,3,3
21949,1,3,76728,76730,76733,2,5,0
21950,3,2,76731,76733,76735,2,4,0
21951,1,2,76732,76735,76737,3,5,0
21952,2,2,76734,76737,76739,3,5,0
21953,1,3,76735,76739,76742,4,7,0
21954,4,2,76739,76742,76744,3,5,0
21955,5,3,76744,76744,76747,0,3,0
21956,5,2,76749,76749,76751,0,2,2
21957,6,3,76755,76755,76758,0,3,4
21958,5,1,76760,76760,76761,0,1,2
21959,5,1,76765,76765,76766,0,1,4
21960,4,1,76769,76769,76770,0,1,3
21961,3,3,76772,76772,76775,0,3,2
21962,3,2,76775,76775,76777,0,2,0
21963,1,3,76776,76777,76780,1,4,0
21964,5,2,76781,76781,76783,0,2,1
21965,3,2,76784,76784,76786,0,2,1
21966,6,1,76790,76790,76791,0,1,4
21967,6,1,76796,76796,76797,0,1,5
21968,4,2,76800,76800,76802,0,2,3
21969,1,3,76801,76802,76805,1,4,0
21970,6,2,76807,76807,76809,0,2,2
21971,6,1,76813,76813,76814,0,1,4
21972,3,1,76816,76816,76817,0,1,2
21973,6,1,76822,76822,76823,0,1,5
21974,4,2,76826,76826,76828,0,2,3
21975,5,2,76831,76831,76833,0,2,3
21976,3,1,76834,76834,76835,0,1,1
21977,2,1,76836,76836,76837,0,1,1
21978,5,1,76841,76841,76842,0,1,4
21979,1,3,76842,76842,76845,0,3,0
21980,1,1,76843,76845,76846,2,3,0
21981,3,1,76846,76846,76847,0,1,0
21982,4,1,76850,76850,76851,0,1,3
21983,5,1,76855,76855,76856,0,1,4
21984,3,3,76858,76858,76861,0,3,2
21985,6,2,76864,76864,76866,0,2,3
21986,1,2,76865,76866,76868,1,3,0
21987,6,2,76871,76871,76873,0,2,3
21988,1,1,76872,76873,76874,1,2,0
21989,2,1,76874,76874,76875,0,1,0
21990,6,2,76880,76880,76882,0,2,5
21991,4,2,76884,76884,76886,0,2,2
21992,5,1,76889,76889,76890,0,1,3
21993,2,2,76891,76891,76893,0,2,1
21994,6,2,76897,76897,76899,0,2,4
21995,1,3,76898,76899,76902,1,4,0
21996,4,3,76902,76902,76905,0,3,0
21997,2,2,76904,76905,76907,1,3,0
21998,2,3,76906,76907,76910,1,4,0
21999,4,2,76910,76910,76912,0,2,0
22000,3,2,76913,76913,76915,0,2,1
22001,3,1,76916,76916,76917,0,1,1
22002,5,3,76921,76921,76924,0,3,4
22003,4,3,76925,76925,76928,0,3,1
22004,6,3,76931,76931,76934,0,3,3
22005,6,1,76937,76937,76938,0,1,3
22006,3,1,76940,76940,76941,0,1,2
22007,5,3,76945,76945,76948,0,3,4
22008,1,3,76946,76948,76951,2,5,0
22009,4,1,76950,76951,76952,1,2,0
22010,4,2,76954,76954,76956,0,2,2
22011,6,3,76960,76960,76963,0,3,4
22012,3,1,76963,76963,76964,0,1,0
22013,1,2,76964,76964,76966,0,2,0
22014,6,1,76970,76970,76971,0,1,4
22015,1,3,76971,76971,76974,0,3,0
22016,5,1,76976,76976,76977,0,1,2
22017,5,3,76981,76981,76984,0,3,4
22018,5,3,76986,76986,76989,0,3,2
22019,3,3,76989,76989,76992,0,3,0
22020,6,2,76995,76995,76997,0,2,3
22021,4,1,76999,76999,77000,0,1,2
22022,4,3,77003,77003,77006,0,3,3
22023,2,3,77005,77006,77009,1,4,0
22024,6,3,77011,77011,77014,0,3,2
22025,3,2,77014,77014,77016,0,2,0
22026,3,1,77017,77017,77018,0,1,1
22027,2,1,77019,77019,77020,0,1,1
22028,6,2,77025,77025,77027,0,2,5
22029,3,2,77028,77028,77030,0,2,1
22030,2,2,77030,77030,77032,0,2,0
22031,5,1,77035,77035,77036,0,1,3
22032,1,3,77036,77036,77039,0,3,0
22033,6,3,77042,77042,77045,0,3,3
22034,1,1,77043,77045,77046,2,3,0
22035,4,3,77047,77047,77050,0,3,1
22036,1,1,77048,77050,77051,2,3,0
22037,1,1,77049,77051,77052,2,3,0
22038,1,3,77050,77052,77055,2,5,0
22039,4,3,77054,77055,77058,1,4,0
22040,4,1,77058,77058,77059,0,1,0
22041,6,3,77064,77064,77067,0,3,5
22042,3,1,77067,77067,77068,0,1,0
22043,4,2,77071,77071,77073,0,2,3
22044,3,3,77074,77074,77077,0,3,1
22045,6,1,77080,77080,77081,0,1,3
22046,4,1,77084,77084,77085,0,1,3
22047,2,2,77086,77086,77088,0,2,1
22048,4,1,77090,77090,77091,0,1,2
22049,5,3,77095,77095,77098,0,3,4
22050,5,1,77100,77100,77101,0,1,2
22051,4,1,77104,77104,77105,0,1,3
22052,4,2,77108,77108,77110,0,2,3
22053,4,2,77112,77112,77114,0,2,2
22054,2,3,77114,77114,77117,0,3,0
22055,1,2,77115,77117,77119,2,4,0
22056,4,3,77119,77119,77122,0,3,0
22057,5,2,77124,77124,77126,0,2,2
22058,5,1,77129,77129,77130,0,1,3
22059,3,2,77132,77132,77134,0,2,2
22060,5,2,77137,77137,77139,0,2,3
22061,3,3,77140,77140,77143,0,3,1
22062,5,1,77145,77145,77146,0,1,2
22063,5,3,77150,77150,77153,0,3,4
22064,1,1,77151,77153,77154,2,3,0
22065,1,3,77152,77154,77157,2,5,0
22066,5,3,77157,77157,77160,0,3,0
22067,6,2,77163,77163,77165,0,2,3
22068,5,1,77168,77168,77169,0,1,3
22069,3,3,77171,77171,77174,0,3,2
22070,1,1,77172,77174,77175,2,3,0
22071,5,3,77177,77177,77180,0,3,2
22072,5,1,77182,77182,77183,0,1,2
22073,6,3,77188,77188,77191,0,3,5
22074,5,3,77193,77193,77196,0,3,2
22075,3,1,77196,77196,77197,0,1,0
22076,5,1,77201,77201,77202,0,1,4
22077,2,1,77203,77203,77204,0,1,1
22078,3,1,77206,77206,77207,0,1,2
22079,1,2,77207,77207,77209,0,2,0
22080,3,1,77210,77210,77211,0,1,1
22081,2,1,77212,77212,77213,0,1,1
22082,2,1,77214,77214,77215,0,1,1
22083,1,1,77215,77215,77216,0,1,0
22084,6,2,77221,77221,77223,0,2,5
22085,3,1,77224,77224,77225,0,1,1
22086,3,1,77227,77227,77228,0,1,2
22087,5,3,77232,77232,77235,0,3,4
22088,1,3,77233,77235,77238,2,5,0
22089,5,1,77238,77238,77239,0,1,0
22090,2,1,77240,77240,77241,0,1,1
22091,1,1,77241,77241,77242,0,1,0
22092,2,3,77243,77243,77246,0,3,1
22093,6,3,77249,77249,77252,0,3,3
22094,5,1,77254,77254,77255,0,1,2
22095,1,2,77255,77255,77257,0,2,0
22096,2,3,77257,77257,77260,0,3,0
22097,2,3,77259,77260,77263,1,4,0
22098,3,3,77262,77263,77266,1,4,0
22099,2,3,77264,77266,77269,2,5,0
22100,1,1,77265,77269,77270,4,5,0
22101,1,3,77266,77270,77273,4,7,0
22102,2,2,77268,77273,77275,5,7,0
22103,6,2,77274,77275,77277,1,3,0
22104,2,1,77276,77277,77278,1,2,0
22105,1,1,77277,77278,77279,1,2,0
22106,3,1,77280,77280,77281,0,1,1
22107,3,3,77283,77283,77286,0,3,2
22108,4,1,77287,77287,77288,0,1,1
22109,1,1,77288,77288,77289,0,1,0
22110,6,1,77294,77294,77295,0,1,5
22111,4,3,77298,77298,77301,0,3,3
22112,1,2,77299,77301,77303,2,4,0
22113,4,3,77303,77303,77306,0,3,0
22114,3,2,77306,77306,77308,0,2,0
22115,2,1,77308,77308,77309,0,1,0
22116,5,1,77313,77313,77314,0,1,4
22117,6,3,77319,77319,77322,0,3,5
22118,6,1,77325,77325,77326,0,1,3
22119,1,1,77326,77326,77327,0,1,0
22120,6,1,77332,77332,77333,0,1,5
22121,6,2,77338,77338,77340,0,2,5
22122,6,1,77344,77344,77345,0,1,4
22123,6,3,77350,77350,77353,0,3,5
22124,6,2,77356,77356,77358,0,2,3
22125,6,1,77362,77362,77363,0,1,4
22126,5,1,77367,77367,77368,0,1,4
22127,4,1,77371,77371,77372,0,1,3
22128,5,2,77376,77376,77378,0,2,4
22129,4,3,77380,77380,77383,0,3,2
22130,5,3,77385,77385,77388,0,3,2
22131,5,3,77390,77390,77393,0,3,2
22132,3,1,77393,77393,77394,0,1,0
22133,6,2,77399,77399,77401,0,2,5
22134,6,2,77405,77405,77407,0,2,4
22135,5,3,77410,77410,77413,0,3,3
22136,2,1,77412,77413,77414,1,2,0
22137,3,2,77415,77415,77417,0,2,1
22138,1,1,77416,77417,77418,1,2,0
22139,4,2,77420,77420,77422,0,2,2
22140,1,1,77421,77422,77423,1,2,0
22141,6,3,77427,77427,77430,0,3,4
22142,5,2,77432,77432,77434,0,2,2
22143,1,3,77433,77434,77437,1,4,0
22144,6,2,77439,77439,77441,0,2,2
22145,6,1,77445,77445,77446,0,1,4
22146,5,2,77450,77450,77452,0,2,4
22147,2,2,77452,77452,77454,0,2,0
22148,2,3,77454,77454,77457,0,3,0
22149,6,1,77460,77460,77461,0,1,3
22150,4,1,77464,77464,77465,0,1,3
22151,5,3,77469,77469,77472,0,3,4
22152,1,3,77470,77472,77475,2,5,0
22153,3,3,77473,77475,77478,2,5,0
22154,3,1,77476,77478,77479,2,3,0
22155,6,2,77482,77482,77484,0,2,3
22156,1,1,77483,77484,77485,1,2,0
22157,2,1,77485,77485,77486,0,1,0
22158,2,2,77487,77487,77489,0,2,1
22159,1,3,77488,77489,77492,1,4,0
22160,5,3,77493,77493,77496,0,3,1
22161,1,2,77494,77496,77498,2,4,0
22162,3,2,77497,77498,77500,1,3,0
22163,1,3,77498,77500,77503,2,5,0
22164,1,2,77499,77503,77505,4,6,0
22165,5,3,77504,77505,77508,1,4,0
22166,6,2,77510,77510,77512,0,2,2
22167,4,3,77514,77514,77517,0,3,2
22168,1,3,77515,77517,77520,2,5,0
22169,6,2,77521,77521,77523,0,2,1
22170,2,3,77523,77523,77526,0,3,0
22171,4,2,77527,77527,77529,0,2,1
22172,6,3,77533,77533,77536,0,3,4
22173,5,1,77538,77538,77539,0,1,2
22174,6,2,77544,77544,77546,0,2,5
22175,3,3,77547,77547,77550,0,3,1
22176,6,2,77553,77553,77555,0,2,3
22177,2,2,77555,77555,77557,0,2,0
22178,3,1,77558,77558,77559,0,1,1
22179,3,1,77561,77561,77562,0,1,2
22180,4,2,77565,77565,77567,0,2,3
22181,3,3,77568,77568,77571,0,3,1
22182,6,1,77574,77574,77575,0,1,3
22183,4,3,77578,77578,77581,0,3,3
22184,6,3,77584,77584,77587,0,3,3
22185,1,2,77585,77587,77589,2,4,0
22186,4,2,77589,77589,77591,0,2,0
22187,6,1,77595,77595,77596,0,1,4
22188,3,3,77598,77598,77601,0,3,2
22189,4,1,77602,77602,77603,0,1,1
22190,5,1,77607,77607,77608,0,1,4
22191,4,2,77611,77611,77613,0,2,3
22192,3,3,77614,77614,77617,0,3,1
22193,3,1,77617,77617,77618,0,1,0
22194,3,3,77620,77620,77623,0,3,2
22195,5,1,77625,77625,77626,0,1,2
22196,2,3,77627,77627,77630,0,3,1
22197,5,3,77632,77632,77635,0,3,2
22198,2,3,77634,77635,77638,1,4,0
22199,2,3,77636,77638,77641,2,5,0
22200,5,1,77641,77641,77642,0,1,0
22201,5,2,77646,77646,77648,0,2,4
22202,2,1,77648,77648,77649,0,1,0
22203,3,1,77651,77651,77652,0,1,2
22204,4,2,77655,77655,77657,0,2,3
22205,5,1,77660,77660,77661,0,1,3
22206,2,2,77662,77662,77664,0,2,1
22207,6,1,77668,77668,77669,0,1,4
22208,6,1,77674,77674,77675,0,1,5
22209,3,1,77677,77677,77678,0,1,2
22210,3,1,77680,77680,77681,0,1,2
22211,3,1,77683,77683,77684,0,1,2
22212,6,2,77689,77689,77691,0,2,5
22213,1,1,77690,77691,77692,1,2,0
22214,5,1,77695,77695,77696,0,1,3
22215,5,1,77700,77700,77701,0,1,4
22216,4,1,77704,77704,77705,0,1,3
22217,6,2,77710,77710,77712,0,2,5
22218,3,2,77713,77713,77715,0,2,1
22219,3,3,77716,77716,77719,0,3,1
22220,1,2,77717,77719,77721,2,4,0
22221,5,1,77722,77722,77723,0,1,1
22222,4,2,77726,77726,77728,0,2,3
22223,6,1,77732,77732,77733,0,1,4
22224,3,1,77735,77735,77736,0,1,2
22225,1,2,77736,77736,77738,0,2,0
22226,5,1,77741,77741,77742,0,1,3
22227,3,1,77744,77744,77745,0,1,2
22228,4,2,77748,77748,77750,0,2,3
22229,3,3,77751,77751,77754,0,3,1
22230,6,3,77757,77757,77760,0,3,3
22231,3,3,77760,77760,77763,0,3,0
22232,4,2,77764,77764,77766,0,2,1
22233,2,3,77766,77766,77769,0,3,0
22234,6,3,77772,77772,77775,0,3,3
22235,1,1,77773,77775,77776,2,3,0
22236,3,3,77776,77776,77779,0,3,0
22237,5,1,77781,77781,77782,0,1,2
22238,6,2,77787,77787,77789,0,2,5
22239,1,1,77788,77789,77790,1,2,0
22240,6,3,77794,77794,77797,0,3,4
22241,4,2,77798,77798,77800,0,2,1
22242,6,2,77804,77804,77806,0,2,4
22243,1,1,77805,77806,77807,1,2,0
22244,4,2,77809,77809,77811,0,2,2
22245,1,3,77810,77811,77814,1,4,0
22246,5,2,77815,77815,77817,0,2,1
22247,3,2,77818,77818,77820,0,2,1
22248,4,2,77822,77822,77824,0,2,2
22249,3,1,77825,77825,77826,0,1,1
22250,4,3,77829,77829,77832,0,3,3
22251,6,2,77835,77835,77837,0,2,3
22252,2,2,77837,77837,77839,0,2,0
22253,4,1,77841,77841,77842,0,1,2
22254,1,2,77842,77842,77844,0,2,0
22255,5,2,77847,77847,77849,0,2,3
22256,6,3,77853,77853,77856,0,3,4
22257,6,3,77859,77859,77862,0,3,3
22258,4,3,77863,77863,77866,0,3,1
22259,1,3,77864,77866,77869,2,5,0
22260,1,2,77865,77869,77871,4,6,0
22261,2,2,77867,77871,77873,4,6,0
22262,1,1,77868,77873,77874,5,6,0
22263,3,1,77871,77874,77875,3,4,0
22264,2,2,77873,77875,77877,2,4,0
22265,4,2,77877,77877,77879,0,2,0
22266,3,3,77880,77880,77883,0,3,1
22267,3,2,77883,77883,77885,0,2,0
22268,2,3,77885,77885,77888,0,3,0
22269,3,2,77888,77888,77890,0,2,0
22270,5,2,77893,77893,77895,0,2,3
22271,2,3,77895,77895,77898,0,3,0
22272,1,3,77896,77898,77901,2,5,0
22273,3,1,77899,77901,77902,2,3,0
22274,4,1,77903,77903,77904,0,1,1
22275,5,2,77908,77908,77910,0,2,4
22276,2,3,77910,77910,77913,0,3,0
22277,2,1,77912,77913,77914,1,2,0
22278,6,2,77918,77918,77920,0,2,4
22279,3,2,77921,77921,77923,0,2,1
22280,4,3,77925,77925,77928,0,3,2
22281,2,2,77927,77928,77930,1,3,0
22282,2,1,77929,77930,77931,1,2,0
22283,3,2,77932,77932,77934,0,2,1
22284,5,1,77937,77937,77938,0,1,3
22285,4,3,77941,77941,77944,0,3,3
22286,3,2,77944,77944,77946,0,2,0
22287,3,2,77947,77947,77949,0,2,1
22288,2,1,77949,77949,77950,0,1,0
22289,5,2,77954,77954,77956,0,2,4
22290,4,3,77958,77958,77961,0,3,2
22291,2,1,77960,77961,77962,1,2,0
22292,2,2,77962,77962,77964,0,2,0
22293,1,3,77963,77964,77967,1,4,0
22294,4,2,77967,77967,77969,0,2,0
22295,6,1,77973,77973,77974,0,1,4
22296,5,1,77978,77978,77979,0,1,4
22297,4,2,77982,77982,77984,0,2,3
22298,1,1,77983,77984,77985,1,2,0
22299,2,2,77985,77985,77987,0,2,0
22300,4,2,77989,77989,77991,0,2,2
22301,5,1,77994,77994,77995,0,1,3
22302,5,1,77999,77999,78000,0,1,4
22303,1,1,78000,78000,78001,0,1,0
22304,1,3,78001,78001,78004,0,3,0
22305,5,3,78006,78006,78009,0,3,2
22306,1,3,78007,78009,78012,2,5,0
22307,4,3,78011,78012,78015,1,4,0
22308,4,1,78015,78015,78016,0,1,0
22309,3,2,78018,78018,78020,0,2,2
22310,4,3,78022,78022,78025,0,3,2
22311,6,2,78028,78028,78030,0,2,3
22312,2,1,78030,78030,78031,0,1,0
22313,4,3,78034,78034,78037,0,3,3
22314,1,3,78035,78037,78040,2,5,0
22315,5,1,78040,78040,78041,0,1,0
22316,5,1,78045,78045,78046,0,1,4
22317,4,2,78049,78049,78051,0,2,3
22318,5,1,78054,78054,78055,0,1,3
22319,1,1,78055,78055,78056,0,1,0
22320,5,1,78060,78060,78061,0,1,4
22321,6,2,78066,78066,78068,0,2,5
22322,5,2,78071,78071,78073,0,2,3
22323,5,1,78076,78076,78077,0,1,3
22324,4,3,78080,78080,78083,0,3,3
22325,2,3,78082,78083,78086,1,4,0
22326,3,2,78085,78086,78088,1,3,0
22327,5,3,78090,78090,78093,0,3,2
22328,3,3,78093,78093,78096,0,3,0
22329,1,2,78094,78096,78098,2,4,0
22330,5,3,78099,78099,78102,0,3,1
22331,5,2,78104,78104,78106,0,2,2
22332,3,1,78107,78107,78108,0,1,1
22333,5,2,78112,78112,78114,0,2,4
22334,2,1,78114,78114,78115,0,1,0
22335,2,1,78116,78116,78117,0,1,1
22336,1,1,78117,78117,78118,0,1,0
22337,6,2,78123,78123,78125,0,2,5
22338,4,2,78127,78127,78129,0,2,2
22339,4,3,78131,78131,78134,0,3,2
22340,5,1,78136,78136,78137,0,1,2
22341,4,1,78140,78140,78141,0,1,3
22342,6,1,78146,78146,78147,0,1,5
22343,4,3,78150,78150,78153,0,3,3
22344,6,1,78156,78156,78157,0,1,3
22345,1,3,78157,78157,78160,0,3,0
22346,6,2,78163,78163,78165,0,2,3
22347,5,1,78168,78168,78169,0,1,3
22348,1,2,78169,78169,78171,0,2,0
22349,6,2,78175,78175,78177,0,2,4
22350,2,2,78177,78177,78179,0,2,0
22351,2,2,78179,78179,78181,0,2,0
22352,2,1,78181,78181,78182,0,1,0
22353,1,3,78182,78182,78185,0,3,0
22354,1,2,78183,78185,78187,2,4,0
22355,1,1,78184,78187,78188,3,4,0
22356,6,3,78190,78190,78193,0,3,2
22357,6,3,78196,78196,78199,0,3,3
22358,3,3,78199,78199,78202,0,3,0
22359,5,3,78204,78204,78207,0,3,2
22360,3,3,78207,78207,78210,0,3,0
22361,1,2,78208,78210,78212,2,4,0
22362,1,3,78209,78212,78215,3,6,0
22363,5,2,78214,78215,78217,1,3,0
22364,3,3,78217,78217,78220,0,3,0
22365,1,1,78218,78220,78221,2,3,0
22366,2,3,78220,78221,78224,1,4,0
22367,1,3,78221,78224,78227,3,6,0
22368,1,3,78222,78227,78230,5,8,0
22369,1,1,78223,78230,78231,7,8,0
22370,2,3,78225,78231,78234,6,9,0
22371,3,3,78228,78234,78237,6,9,0
22372,5,1,78233,78237,78238,4,5,0
22373,2,1,78235,78238,78239,3,4,0
22374,1,2,78236,78239,78241,3,5,0
22375,2,1,78238,78241,78242,3,4,0
22376,6,3,78244,78244,78247,0,3,2
22377,4,1,78248,78248,78249,0,1,1
22378,1,1,78249,78249,78250,0,1,0
22379,2,2,78251,78251,78253,0,2,1
22380,1,1,78252,78253,78254,1,2,0
22381,5,1,78257,78257,78258,0,1,3
22382,6,3,78263,78263,78266,0,3,5
22383,2,2,78265,78266,78268,1,3,0
22384,3,2,78268,78268,78270,0,2,0
22385,4,1,78272,78272,78273,0,1,2
22386,5,3,78277,78277,78280,0,3,4
22387,1,1,78278,78280,78281,2,3,0
22388,3,1,78281,78281,78282,0,1,0
22389,2,2,78283,78283,78285,0,2,1
22390,1,3,78284,78285,78288,1,4,0
22391,3,1,78287,78288,78289,1,2,0
22392,5,3,78292,78292,78295,0,3,3
22393,4,2,78296,78296,78298,0,2,1
22394,5,1,78301,78301,78302,0,1,3
22395,6,1,78307,78307,78308,0,1,5
22396,5,2,78312,78312,78314,0,2,4
22397,5,3,78317,78317,78320,0,3,3
22398,6,2,78323,78323,78325,0,2,3
22399,4,2,78327,78327,78329,0,2,2
22400,1,2,78328,78329,78331,1,3,0
22401,4,3,78332,78332,78335,0,3,1
22402,2,3,78334,78335,78338,1,4,0
22403,4,1,78338,78338,78339,0,1,0
22404,4,1,78342,78342,78343,0,1,3
22405,3,1,78345,78345,78346,0,1,2
22406,5,1,78350,78350,78351,0,1,4
22407,5,3,78355,78355,78358,0,3,4
22408,2,2,78357,78358,78360,1,3,0
22409,1,3,78358,78360,78363,2,5,0
22410,5,1,78363,78363,78364,0,1,0
22411,4,3,78367,78367,78370,0,3,3
22412,3,1,78370,78370,78371,0,1,0
22413,3,2,78373,78373,78375,0,2,2
22414,4,3,78377,78377,78380,0,3,2
22415,1,1,78378,78380,78381,2,3,0
22416,1,2,78379,78381,78383,2,4,0
22417,5,3,78384,78384,78387,0,3,1
22418,5,3,78389,78389,78392,0,3,2
22419,2,2,78391,78392,78394,1,3,0
22420,1,2,78392,78394,78396,2,4,0
22421,5,2,78397,78397,78399,0,2,1
22422,4,3,78401,78401,78404,0,3,2
22423,1,2,78402,78404,78406,2,4,0
22424,4,2,78406,78406,78408,0,2,0
22425,6,3,78412,78412,78415,0,3,4
22426,4,3,78416,78416,78419,0,3,1
22427,1,2,78417,78419,78421,2,4,0
22428,2,3,78419,78421,78424,2,5,0
22429,6,3,78425,78425,78428,0,3,1
22430,5,3,78430,78430,78433,0,3,2
22431,2,3,78432,78433,78436,1,4,0
22432,1,2,78433,78436,78438,3,5,0
22433,2,3,78435,78438,78441,3,6,0
22434,2,3,78437,78441,78444,4,7,0
22435,4,2,78441,78444,78446,3,5,0
22436,6,1,78447,78447,78448,0,1,1
22437,5,1,78452,78452,78453,0,1,4
22438,4,3,78456,78456,78459,0,3,3
22439,6,2,78462,78462,78464,0,2,3
22440,2,1,78464,78464,78465,0,1,0
22441,4,2,78468,78468,78470,0,2,3
22442,3,3,78471,78471,78474,0,3,1
22443,4,1,78475,78475,78476,0,1,1
22444,3,2,78478,78478,78480,0,2,2
22445,3,3,78481,78481,78484,0,3,1
22446,2,2,78483,78484,78486,1,3,0
22447,2,1,78485,78486,78487,1,2,0
22448,6,2,78491,78491,78493,0,2,4
22449,1,1,78492,78493,78494,1,2,0
22450,6,3,78498,78498,78501,0,3,4
22451,2,2,78500,78501,78503,1,3,0
22452,4,1,78504,78504,78505,0,1,1
22453,3,1,78507,78507,78508,0,1,2
22454,2,1,78509,78509,78510,0,1,1
22455,3,1,78512,78512,78513,0,1,2
22456,3,1,78515,78515,78516,0,1,2
22457,1,3,78516,78516,78519,0,3,0
22458,4,2,78520,78520,78522,0,2,1
22459,2,1,78522,78522,78523,0,1,0
22460,1,3,78523,78523,78526,0,3,0
22461,4,3,78527,78527,78530,0,3,1
22462,2,3,78529,78530,78533,1,4,0
22463,1,1,78530,78533,78534,3,4,0
22464,3,1,78533,78534,78535,1,2,0
22465,2,3,78535,78535,78538,0,3,0
22466,3,1,78538,78538,78539,0,1,0
22467,6,3,78544,78544,78547,0,3,5
22468,5,2,78549,78549,78551,0,2,2
22469,4,1,78553,78553,78554,0,1,2
22470,5,1,78558,78558,78559,0,1,4
22471,4,2,78562,78562,78564,0,2,3
22472,3,1,78565,78565,78566,0,1,1
22473,1,2,78566,78566,78568,0,2,0
22474,3,1,78569,78569,78570,0,1,1
22475,5,3,78574,78574,78577,0,3,4
22476,5,3,78579,78579,78582,0,3,2
22477,5,2,78584,78584,78586,0,2,2
22478,3,3,78587,78587,78590,0,3,1
22479,5,1,78592,78592,78593,0,1,2
22480,5,3,78597,78597,78600,0,3,4
22481,4,2,78601,78601,78603,0,2,1
22482,6,1,78607,78607,78608,0,1,4
22483,1,2,78608,78608,78610,0,2,0
22484,1,2,78609,78610,78612,1,3,0
22485,6,1,78615,78615,78616,0,1,3
22486,5,2,78620,78620,78622,0,2,4
22487,6,3,78626,78626,78629,0,3,4
22488,4,2,78630,78630,78632,0,2,1
22489,6,2,78636,78636,78638,0,2,4
22490,1,1,78637,78638,78639,1,2,0
22491,6,1,78643,78643,78644,0,1,4
22492,4,2,78647,78647,78649,0,2,3
22493,3,1,78650,78650,78651,0,1,1
22494,6,1,78656,78656,78657,0,1,5
22495,3,3,78659,78659,78662,0,3,2
22496,5,1,78664,78664,78665,0,1,2
22497,4,2,78668,78668,78670,0,2,3
22498,2,2,78670,78670,78672,0,2,0
22499,2,3,78672,78672,78675,0,3,0
22500,2,1,78674,78675,78676,1,2,0
22501,5,1,78679,78679,78680,0,1,3
22502,2,3,78681,78681,78684,0,3,1
22503,5,1,78686,78686,78687,0,1,2
22504,3,1,78689,78689,78690,0,1,2
22505,4,3,78693,78693,78696,0,3,3
22506,3,1,78696,78696,78697,0,1,0
22507,2,1,78698,78698,78699,0,1,1
22508,5,1,78703,78703,78704,0,1,4
22509,6,2,78709,78709,78711,0,2,5
22510,2,3,78711,78711,78714,0,3,0
22511,4,1,78715,78715,78716,0,1,1
22512,3,2,78718,78718,78720,0,2,2
22513,1,1,78719,78720,78721,1,2,0
22514,2,2,78721,78721,78723,0,2,0
22515,3,3,78724,78724,78727,0,3,1
22516,1,1,78725,78727,78728,2,3,0
22517,5,1,78730,78730,78731,0,1,2
22518,6,3,78736,78736,78739,0,3,5
22519,4,1,78740,78740,78741,0,1,1
22520,4,3,78744,78744,78747,0,3,3
22521,2,3,78746,78747,78750,1,4,0
22522,6,3,78752,78752,78755,0,3,2
22523,1,3,78753,78755,78758,2,5,0
22524,1,2,78754,78758,78760,4,6,0
22525,3,1,78757,78760,78761,3,4,0
22526,2,3,78759,78761,78764,2,5,0
22527,6,2,78765,78765,78767,0,2,1
22528,2,2,78767,78767,78769,0,2,0
22529,5,2,78772,78772,78774,0,2,3
22530,4,3,78776,78776,78779,0,3,2
22531,6,3,78782,78782,78785,0,3,3
22532,3,2,78785,78785,78787,0,2,0
22533,4,3,78789,78789,78792,0,3,2
22534,6,2,78795,78795,78797,0,2,3
22535,3,3,78798,78798,78801,0,3,1
22536,1,3,78799,78801,78804,2,5,0
22537,1,1,78800,78804,78805,4,5,0
22538,1,3,78801,78805,78808,4,7,0
22539,1,2,78802,78808,78810,6,8,0
22540,2,3,78804,78810,78813,6,9,0
22541,3,2,78807,78813,78815,6,8,0
22542,4,1,78811,78815,78816,4,5,0
22543,3,3,78814,78816,78819,2,5,0
22544,4,2,78818,78819,78821,1,3,0
22545,6,1,78824,78824,78825,0,1,3
22546,6,3,78830,78830,78833,0,3,5
22547,5,3,78835,78835,78838,0,3,2
22548,6,1,78841,78841,78842,0,1,3
22549,6,3,78847,78847,78850,0,3,5
22550,2,2,78849,78850,78852,1,3,0
22551,6,1,78855,78855,78856,0,1,3
22552,6,1,78861,78861,78862,0,1,5
22553,1,3,78862,78862,78865,0,3,0
22554,5,3,78867,78867,78870,0,3,2
22555,3,3,78870,78870,78873,0,3,0
22556,1,3,78871,78873,78876,2,5,0
22557,2,3,78873,78876,78879,3,6,0
22558,2,2,78875,78879,78881,4,6,0
22559,2,2,78877,78881,78883,4,6,0
22560,3,2,78880,78883,78885,3,5,0
22561,4,2,78884,78885,78887,1,3,0
22562,6,2,78890,78890,78892,0,2,3
22563,6,3,78896,78896,78899,0,3,4
22564,2,2,78898,78899,78901,1,3,0
22565,4,3,78902,78902,78905,0,3,1
22566,4,1,78906,78906,78907,0,1,1
22567,3,1,78909,78909,78910,0,1,2
22568,3,3,78912,78912,78915,0,3,2
22569,4,2,78916,78916,78918,0,2,1
22570,1,3,78917,78918,78921,1,4,0
22571,6,1,78923,78923,78924,0,1,2
22572,5,1,78928,78928,78929,0,1,4
22573,2,1,78930,78930,78931,0,1,1
22574,4,3,78934,78934,78937,0,3,3
22575,4,2,78938,78938,78940,0,2,1
22576,3,2,78941,78941,78943,0,2,1
22577,3,2,78944,78944,78946,0,2,1
22578,6,2,78950,78950,78952,0,2,4
22579,3,1,78953,78953,78954,0,1,1
22580,2,3,78955,78955,78958,0,3,1
22581,6,3,78961,78961,78964,0,3,3
22582,2,1,78963,78964,78965,1,2,0
22583,3,3,78966,78966,78969,0,3,1
22584,4,3,78970,78970,78973,0,3,1
22585,4,1,78974,78974,78975,0,1,1
22586,3,1,78977,78977,78978,0,1,2
22587,2,3,78979,78979,78982,0,3,1
22588,5,3,78984,78984,78987,0,3,2
22589,2,2,78986,78987,78989,1,3,0
22590,3,1,78989,78989,78990,0,1,0
22591,1,3,78990,78990,78993,0,3,0
22592,6,2,78996,78996,78998,0,2,3
22593,2,3,78998,78998,79001,0,3,0
22594,5,3,79003,79003,79006,0,3,2
22595,4,3,79007,79007,79010,0,3,1
22596,4,2,79011,79011,79013,0,2,1
22597,1,2,79012,79013,79015,1,3,0
22598,6,1,79018,79018,79019,0,1,3
22599,1,1,79019,79019,79020,0,1,0
22600,5,1,79024,79024,79025,0,1,4
22601,1,3,79025,79025,79028,0,3,0
22602,5,1,79030,79030,79031,0,1,2
22603,3,1,79033,79033,79034,0,1,2
22604,4,1,79037,79037,79038,0,1,3
22605,5,3,79042,79042,79045,0,3,4
22606,4,3,79046,79046,79049,0,3,1
22607,5,2,79051,79051,79053,0,2,2
22608,6,2,79057,79057,79059,0,2,4
22609,5,3,79062,79062,79065,0,3,3
22610,5,2,79067,79067,79069,0,2,2
22611,2,1,79069,79069,79070,0,1,0
22612,4,1,79073,79073,79074,0,1,3
22613,3,1,79076,79076,79077,0,1,2
22614,3,2,79079,79079,79081,0,2,2
22615,6,2,79085,79085,79087,0,2,4
22616,3,3,79088,79088,79091,0,3,1
22617,6,1,79094,79094,79095,0,1,3
22618,2,3,79096,79096,79099,0,3,1
22619,1,1,79097,79099,79100,2,3,0
22620,2,2,79099,79100,79102,1,3,0
22621,2,2,79101,79102,79104,1,3,0
22622,2,1,79103,79104,79105,1,2,0
22623,6,3,79109,79109,79112,0,3,4
22624,2,1,79111,79112,79113,1,2,0
22625,4,3,79115,79115,79118,0,3,2
22626,5,1,79120,79120,79121,0,1,2
22627,3,1,79123,79123,79124,0,1,2
22628,5,2,79128,79128,79130,0,2,4
22629,5,3,79133,79133,79136,0,3,3
22630,5,2,79138,79138,79140,0,2,2
22631,5,1,79143,79143,79144,0,1,3
22632,1,2,79144,79144,79146,0,2,0
22633,3,2,79147,79147,79149,0,2,1
22634,2,2,79149,79149,79151,0,2,0
22635,4,3,79153,79153,79156,0,3,2
22636,6,2,79159,79159,79161,0,2,3
22637,4,2,79163,79163,79165,0,2,2
22638,4,3,79167,79167,79170,0,3,2
22639,6,1,79173,79173,79174,0,1,3
22640,1,1,79174,79174,79175,0,1,0
22641,1,1,79175,79175,79176,0,1,0
22642,2,3,79177,79177,79180,0,3,1
22643,5,1,79182,79182,79183,0,1,2
22644,6,2,79188,79188,79190,0,2,5
22645,5,3,79193,79193,79196,0,3,3
22646,1,3,79194,79196,79199,2,5,0
22647,6,3,79200,79200,79203,0,3,1
22648,2,1,79202,79203,79204,1,2,0
22649,3,1,79205,79205,79206,0,1,1
22650,5,1,79210,79210,79211,0,1,4
22651,1,2,79211,79211,79213,0,2,0
22652,6,2,79217,79217,79219,0,2,4
22653,3,2,79220,79220,79222,0,2,1
22654,4,1,79224,79224,79225,0,1,2
22655,4,1,79228,79228,79229,0,1,3
22656,3,1,79231,79231,79232,0,1,2
22657,2,1,79233,79233,79234,0,1,1
22658,1,1,79234,79234,79235,0,1,0
22659,2,1,79236,79236,79237,0,1,1
22660,5,3,79241,79241,79244,0,3,4
22661,2,1,79243,79244,79245,1,2,0
22662,5,1,79248,79248,79249,0,1,3
22663,3,2,79251,79251,79253,0,2,2
22664,5,3,79256,79256,79259,0,3,3
22665,4,3,79260,79260,79263,0,3,1
22666,5,2,79265,79265,79267,0,2,2
22667,4,1,79269,79269,79270,0,1,2
22668,2,2,79271,79271,79273,0,2,1
22669,3,1,79274,79274,79275,0,1,1
22670,3,3,79277,79277,79280,0,3,2
22671,2,3,79279,79280,79283,1,4,0
22672,3,3,79282,79283,79286,1,4,0
22673,5,1,79287,79287,79288,0,1,1
22674,6,2,79293,79293,79295,0,2,5
22675,4,1,79297,79297,79298,0,1,2
22676,4,3,79301,79301,79304,0,3,3
22677,4,1,79305,79305,79306,0,1,1
22678,5,3,79310,79310,79313,0,3,4
22679,3,2,79313,79313,79315,0,2,0
22680,5,1,79318,79318,79319,0,1,3
22681,3,2,79321,79321,79323,0,2,2
22682,2,1,79323,79323,79324,0,1,0
22683,2,3,79325,79325,79328,0,3,1
22684,5,2,79330,79330,79332,0,2,2
22685,1,3,79331,79332,79335,1,4,0
22686,4,1,79335,79335,79336,0,1,0
22687,6,2,79341,79341,79343,0,2,5
22688,1,1,79342,79343,79344,1,2,0
22689,3,2,79345,79345,79347,0,2,1
22690,4,3,79349,79349,79352,0,3,2
22691,5,1,79354,79354,79355,0,1,2
22692,5,2,79359,79359,79361,0,2,4
22693,6,1,79365,79365,79366,0,1,4
22694,4,3,79369,79369,79372,0,3,3
22695,1,2,79370,79372,79374,2,4,0
22696,2,2,79372,79374,79376,2,4,0
22697,2,3,79374,79376,79379,2,5,0
22698,4,1,79378,79379,79380,1,2,0
22699,1,3,79379,79380,79383,1,4,0
22700,5,2,79384,79384,79386,0,2,1
22701,1,1,79385,79386,79387,1,2,0
22702,2,1,79387,79387,79388,0,1,0
22703,6,2,79393,79393,79395,0,2,5
22704,1,2,79394,79395,79397,1,3,0
22705,2,1,79396,79397,79398,1,2,0
22706,6,2,79402,79402,79404,0,2,4
22707,2,1,79404,79404,79405,0,1,0
22708,2,1,79406,79406,79407,0,1,1
22709,4,3,79410,79410,79413,0,3,3
22710,6,1,79416,79416,79417,0,1,3
22711,5,2,79421,79421,79423,0,2,4
22712,4,2,79425,79425,79427,0,2,2
22713,3,2,79428,79428,79430,0,2,1
22714,6,1,79434,79434,79435,0,1,4
22715,1,1,79435,79435,79436,0,1,0
22716,2,2,79437,79437,79439,0,2,1
22717,1,2,79438,79439,79441,1,3,0
22718,6,2,79444,79444,79446,0,2,3
22719,5,3,79449,79449,79452,0,3,3
22720,1,1,79450,79452,79453,2,3,0
22721,4,2,79454,79454,79456,0,2,1
22722,6,1,79460,79460,79461,0,1,4
22723,3,1,79463,79463,79464,0,1,2
22724,6,3,79469,79469,79472,0,3,5
22725,5,3,79474,79474,79477,0,3,2
22726,6,3,79480,79480,79483,0,3,3
22727,3,1,79483,79483,79484,0,1,0
22728,1,3,79484,79484,79487,0,3,0
22729,4,1,79488,79488,79489,0,1,1
22730,2,2,79490,79490,79492,0,2,1
22731,2,3,79492,79492,79495,0,3,0
22732,1,3,79493,79495,79498,2,5,0
22733,1,3,79494,79498,79501,4,7,0
22734,5,2,79499,79501,79503,2,4,0
22735,5,2,79504,79504,79506,0,2,1
22736,5,3,79509,79509,79512,0,3,3
22737,5,3,79514,79514,79517,0,3,2
22738,6,2,79520,79520,79522,0,2,3
22739,1,1,79521,79522,79523,1,2,0
22740,5,3,79526,79526,79529,0,3,3
22741,1,1,79527,79529,79530,2,3,0
22742,1,2,79528,79530,79532,2,4,0
22743,1,1,79529,79532,79533,3,4,0
22744,5,1,79534,79534,79535,0,1,1
22745,3,3,79537,79537,79540,0,3,2
22746,1,2,79538,79540,79542,2,4,0
22747,4,3,79542,79542,79545,0,3,0
22748,4,1,79546,79546,79547,0,1,1
22749,2,1,79548,79548,79549,0,1,1
22750,4,1,79552,79552,79553,0,1,3
22751,1,2,79553,79553,79555,0,2,0
22752,1,3,79554,79555,79558,1,4,0
22753,1,1,79555,79558,79559,3,4,0
22754,6,3,79561,79561,79564,0,3,2
22755,6,3,79567,79567,79570,0,3,3
22756,3,2,79570,79570,79572,0,2,0
22757,3,1,79573,79573,79574,0,1,1
22758,6,2,79579,79579,79581,0,2,5
22759,2,2,79581,79581,79583,0,2,0
22760,4,2,79585,79585,79587,0,2,2
22761,3,3,79588,79588,79591,0,3,1
22762,6,3,79594,79594,79597,0,3,3
22763,6,1,79600,79600,79601,0,1,3
22764,2,3,79602,79602,79605,0,3,1
22765,1,2,79603,79605,79607,2,4,0
22766,6,3,79609,79609,79612,0,3,2
22767,4,2,79613,79613,79615,0,2,1
22768,2,2,79615,79615,79617,0,2,0
22769,2,2,79617,79617,79619,0,2,0
22770,4,3,79621,79621,79624,0,3,2
22771,3,2,79624,79624,79626,0,2,0
22772,4,1,79628,79628,79629,0,1,2
22773,6,3,79634,79634,79637,0,3,5
22774,5,3,79639,79639,79642,0,3,2
22775,6,3,79645,79645,79648,0,3,3
22776,1,1,79646,79648,79649,2,3,0
22777,1,1,79647,79649,79650,2,3,0
22778,5,1,79652,79652,79653,0,1,2
22779,4,2,79656,79656,79658,0,2,3
22780,5,2,79661,79661,79663,0,2,3
22781,1,2,79662,79663,79665,1,3,0
22782,6,2,79668,79668,79670,0,2,3
22783,4,3,79672,79672,79675,0,3,2
22784,4,2,79676,79676,79678,0,2,1
22785,2,1,79678,79678,79679,0,1,0
22786,1,1,79679,79679,79680,0,1,0
22787,2,1,79681,79681,79682,0,1,1
22788,1,3,79682,79682,79685,0,3,0
22789,5,2,79687,79687,79689,0,2,2
22790,3,2,79690,79690,79692,0,2,1
22791,1,3,79691,79692,79695,1,4,0
22792,5,3,79696,79696,79699,0,3,1
22793,6,2,79702,79702,79704,0,2,3
22794,1,2,79703,79704,79706,1,3,0
22795,1,1,79704,79706,79707,2,3,0
22796,3,2,79707,79707,79709,0,2,0
22797,3,1,79710,79710,79711,0,1,1
22798,6,3,79716,79716,79719,0,3,5
22799,2,2,79718,79719,79721,1,3,0
22800,5,1,79723,79723,79724,0,1,2
22801,3,1,79726,79726,79727,0,1,2
22802,4,3,79730,79730,79733,0,3,3
22803,5,2,79735,79735,79737,0,2,2
22804,3,2,79738,79738,79740,0,2,1
22805,1,2,79739,79740,79742,1,3,0
22806,5,3,79744,79744,79747,0,3,2
22807,3,1,79747,79747,79748,0,1,0
22808,2,3,79749,79749,79752,0,3,1
22809,5,1,79754,79754,79755,0,1,2
22810,1,3,79755,79755,79758,0,3,0
22811,6,1,79761,79761,79762,0,1,3
22812,4,3,79765,79765,79768,0,3,3
22813,6,3,79771,79771,79774,0,3,3
22814,2,3,79773,79774,79777,1,4,0
22815,5,3,79778,79778,79781,0,3,1
22816,4,3,79782,79782,79785,0,3,1
22817,1,1,79783,79785,79786,2,3,0
22818,5,3,79788,79788,79791,0,3,2
22819,4,3,79792,79792,79795,0,3,1
22820,1,2,79793,79795,79797,2,4,0
22821,1,1,79794,79797,79798,3,4,0
22822,3,3,79797,79798,79801,1,4,0
22823,4,3,79801,79801,79804,0,3,0
22824,1,2,79802,79804,79806,2,4,0
22825,1,3,79803,79806,79809,3,6,0
22826,6,2,79809,79809,79811,0,2,0
22827,3,3,79812,79812,79815,0,3,1
22828,3,1,79815,79815,79816,0,1,0
22829,6,2,79821,79821,79823,0,2,5
22830,4,2,79825,79825,79827,0,2,2
22831,1,2,79826,79827,79829,1,3,0
22832,3,3,79829,79829,79832,0,3,0
22833,1,3,79830,79832,79835,2,5,0
22834,6,2,79836,79836,79838,0,2,1
22835,4,1,79840,79840,79841,0,1,2
22836,2,1,79842,79842,79843,0,1,1
22837,3,1,79845,79845,79846,0,1,2
22838,2,3,79847,79847,79850,0,3,1
22839,3,2,79850,79850,79852,0,2,0
22840,1,3,79851,79852,79855,1,4,0
22841,5,3,79856,79856,79859,0,3,1
22842,4,3,79860,79860,79863,0,3,1
22843,1,1,79861,79863,79864,2,3,0
22844,2,1,79863,79864,79865,1,2,0
22845,2,2,79865,79865,79867,0,2,0
22846,6,3,79871,79871,79874,0,3,4
22847,1,3,79872,79874,79877,2,5,0
22848,3,2,79875,79877,79879,2,4,0
22849,3,2,79878,79879,79881,1,3,0
22850,6,1,79884,79884,79885,0,1,3
22851,5,3,79889,79889,79892,0,3,4
22852,4,2,79893,79893,79895,0,2,1
22853,1,1,79894,79895,79896,1,2,0
22854,4,3,79898,79898,79901,0,3,2
22855,1,2,79899,79901,79903,2,4,0
22856,6,1,79905,79905,79906,0,1,2
22857,1,1,79906,79906,79907,0,1,0
22858,2,2,79908,79908,79910,0,2,1
22859,2,2,79910,79910,79912,0,2,0
22860,5,1,79915,79915,79916,0,1,3
22861,2,3,79917,79917,79920,0,3,1
22862,6,3,79923,79923,79926,0,3,3
22863,6,1,79929,79929,79930,0,1,3
22864,5,2,79934,79934,79936,0,2,4
22865,5,3,79939,79939,79942,0,3,3
22866,6,1,79945,79945,79946,0,1,3
22867,1,2,79946,79946,79948,0,2,0
22868,5,1,79951,79951,79952,0,1,3
22869,2,3,79953,79953,79956,0,3,1
22870,5,3,79958,79958,79961,0,3,2
22871,2,3,79960,79961,79964,1,4,0
22872,2,2,79962,79964,79966,2,4,0
22873,1,1,79963,79966,79967,3,4,0
22874,1,1,79964,79967,79968,3,4,0
22875,3,1,79967,79968,79969,1,2,0
22876,3,1,79970,79970,79971,0,1,1
22877,5,2,79975,79975,79977,0,2,4
22878,6,3,79981,79981,79984,0,3,4
22879,3,3,79984,79984,79987,0,3,0
22880,6,2,79990,79990,79992,0,2,3
22881,4,1,79994,79994,79995,0,1,2
22882,4,3,79998,79998,80001,0,3,3
22883,6,2,80004,80004,80006,0,2,3
22884,2,3,80006,80006,80009,0,3,0
22885,6,2,80012,80012,80014,0,2,3
22886,6,3,80018,80018,80021,0,3,4
22887,6,1,80024,80024,80025,0,1,3
22888,2,3,80026,80026,80029,0,3,1
22889,2,1,80028,80029,80030,1,2,0
22890,6,3,80034,80034,80037,0,3,4
22891,1,1,80035,80037,80038,2,3,0
22892,1,2,80036,80038,80040,2,4,0
22893,3,1,80039,80040,80041,1,2,0
22894,6,2,80045,80045,80047,0,2,4
22895,6,3,80051,80051,80054,0,3,4
22896,1,1,80052,80054,80055,2,3,0
22897,4,1,80056,80056,80057,0,1,1
22898,5,1,80061,80061,80062,0,1,4
22899,1,2,80062,80062,80064,0,2,0
22900,1,3,80063,80064,80067,1,4,0
22901,4,2,80067,80067,80069,0,2,0
22902,5,3,80072,80072,80075,0,3,3
22903,1,3,80073,80075,80078,2,5,0
22904,4,3,80077,80078,80081,1,4,0
22905,5,1,80082,80082,80083,0,1,1
22906,5,3,80087,80087,80090,0,3,4
22907,6,1,80093,80093,80094,0,1,3
22908,2,2,80095,80095,80097,0,2,1
22909,2,2,80097,80097,80099,0,2,0
22910,4,1,80101,80101,80102,0,1,2
22911,6,1,80107,80107,80108,0,1,5
22912,6,2,80113,80113,80115,0,2,5
22913,1,3,80114,80115,80118,1,4,0
22914,2,1,80116,80118,80119,2,3,0
22915,1,3,80117,80119,80122,2,5,0
22916,5,3,80122,80122,80125,0,3,0
22917,1,2,80123,80125,80127,2,4,0
22918,4,3,80127,80127,80130,0,3,0
22919,1,2,80128,80130,80132,2,4,0
22920,2,2,80130,80132,80134,2,4,0
22921,1,1,80131,80134,80135,3,4,0
22922,3,3,80134,80135,80138,1,4,0
22923,3,2,80137,80138,80140,1,3,0
22924,6,1,80143,80143,80144,0,1,3
22925,2,3,80145,80145,80148,0,3,1
22926,3,1,80148,80148,80149,0,1,0
22927,6,1,80154,80154,80155,0,1,5
22928,1,3,80155,80155,80158,0,3,0
22929,1,1,80156,80158,80159,2,3,0
22930,3,1,80159,80159,80160,0,1,0
22931,3,1,80162,80162,80163,0,1,2
22932,6,1,80168,80168,80169,0,1,5
22933,4,1,80172,80172,80173,0,1,3
22934,4,1,80176,80176,80177,0,1,3
22935,4,3,80180,80180,80183,0,3,3
22936,2,2,80182,80183,80185,1,3,0
22937,2,2,80184,80185,80187,1,3,0
22938,6,3,80190,80190,80193,0,3,3
22939,6,2,80196,80196,80198,0,2,3
22940,5,2,80201,80201,80203,0,2,3
22941,3,1,80204,80204,80205,0,1,1
22942,5,3,80209,80209,80212,0,3,4
22943,2,1,80211,80212,80213,1,2,0
22944,4,3,80215,80215,80218,0,3,2
22945,6,3,80221,80221,80224,0,3,3
22946,1,3,80222,80224,80227,2,5,0
22947,5,1,80227,80227,80228,0,1,0
22948,4,3,80231,80231,80234,0,3,3
22949,5,3,80236,80236,80239,0,3,2
22950,4,3,80240,80240,80243,0,3,1
22951,4,2,80244,80244,80246,0,2,1
22952,2,1,80246,80246,80247,0,1,0
22953,2,1,80248,80248,80249,0,1,1
22954,6,2,80254,80254,80256,0,2,5
22955,6,2,80260,80260,80262,0,2,4
22956,3,1,80263,80263,80264,0,1,1
22957,6,3,80269,80269,80272,0,3,5
22958,5,1,80274,80274,80275,0,1,2
22959,6,1,80280,80280,80281,0,1,5
22960,1,2,80281,80281,80283,0,2,0
22961,2,1,80283,80283,80284,0,1,0
22962,1,1,80284,80284,80285,0,1,0
22963,2,3,80286,80286,80289,0,3,1
22964,6,1,80292,80292,80293,0,1,3
22965,6,3,80298,80298,80301,0,3,5
22966,5,1,80303,80303,80304,0,1,2
22967,6,2,80309,80309,80311,0,2,5
22968,2,2,80311,80311,80313,0,2,0
22969,6,3,80317,80317,80320,0,3,4
22970,2,3,80319,80320,80323,1,4,0
22971,5,3,80324,80324,80327,0,3,1
22972,6,2,80330,80330,80332,0,2,3
22973,2,1,80332,80332,80333,0,1,0
22974,1,3,80333,80333,80336,0,3,0
22975,3,1,80336,80336,80337,0,1,0
22976,3,2,80339,80339,80341,0,2,2
22977,3,3,80342,80342,80345,0,3,1
22978,6,1,80348,80348,80349,0,1,3
22979,6,3,80354,80354,80357,0,3,5
22980,6,2,80360,80360,80362,0,2,3
22981,6,3,80366,80366,80369,0,3,4
22982,4,3,80370,80370,80373,0,3,1
22983,3,3,80373,80373,80376,0,3,0
22984,6,2,80379,80379,80381,0,2,3
22985,5,2,80384,80384,80386,0,2,3
22986,2,3,80386,80386,80389,0,3,0
22987,1,1,80387,80389,80390,2,3,0
22988,3,3,80390,80390,80393,0,3,0
22989,2,2,80392,80393,80395,1,3,0
22990,6,1,80398,80398,80399,0,1,3
22991,1,2,80399,80399,80401,0,2,0
22992,2,3,80401,80401,80404,0,3,0
22993,3,1,80404,80404,80405,0,1,0
22994,4,1,80408,80408,80409,0,1,3
22995,5,2,80413,80413,80415,0,2,4
22996,2,2,80415,80415,80417,0,2,0
22997,5,3,80420,80420,80423,0,3,3
22998,3,3,80423,80423,80426,0,3,0
22999,1,3,80424,80426,80429,2,5,0
23000,6,1,80430,80430,80431,0,1,1
23001,4,3,80434,80434,80437,0,3,3
23002,2,1,80436,80437,80438,1,2,0
23003,6,1,80442,80442,80443,0,1,4
23004,4,1,80446,80446,80447,0,1,3
23005,6,1,80452,80452,80453,0,1,5
23006,3,3,80455,80455,80458,0,3,2
23007,2,2,80457,80458,80460,1,3,0
23008,4,2,80461,80461,80463,0,2,1
23009,6,2,80467,80467,80469,0,2,4
23010,4,1,80471,80471,80472,0,1,2
23011,4,3,80475,80475,80478,0,3,3
23012,3,1,80478,80478,80479,0,1,0
23013,4,1,80482,80482,80483,0,1,3
23014,4,2,80486,80486,80488,0,2,3
23015,4,1,80490,80490,80491,0,1,2
23016,1,2,80491,80491,80493,0,2,0
23017,6,2,80497,80497,80499,0,2,4
23018,2,1,80499,80499,80500,0,1,0
23019,4,3,80503,80503,80506,0,3,3
23020,1,2,80504,80506,80508,2,4,0
23021,4,3,80508,80508,80511,0,3,0
23022,1,3,80509,80511,80514,2,5,0
23023,6,2,80515,80515,80517,0,2,1
23024,3,1,80518,80518,80519,0,1,1
23025,6,1,80524,80524,80525,0,1,5
23026,5,3,80529,80529,80532,0,3,4
23027,2,1,80531,80532,80533,1,2,0
23028,1,1,80532,80533,80534,1,2,0
23029,1,1,80533,80534,80535,1,2,0
23030,5,3,80538,80538,80541,0,3,3
23031,1,3,80539,80541,80544,2,5,0
23032,5,3,80544,80544,80547,0,3,0
23033,2,1,80546,80547,80548,1,2,0
23034,2,2,80548,80548,80550,0,2,0
23035,4,1,80552,80552,80553,0,1,2
23036,2,1,80554,80554,80555,0,1,1
23037,6,1,80560,80560,80561,0,1,5
23038,2,1,80562,80562,80563,0,1,1
23039,1,3,80563,80563,80566,0,3,0
23040,6,1,80569,80569,80570,0,1,3
23041,3,1,80572,80572,80573,0,1,2
23042,4,1,80576,80576,80577,0,1,3
23043,1,2,80577,80577,80579,0,2,0
23044,3,3,80580,80580,80583,0,3,1
23045,2,1,80582,80583,80584,1,2,0
23046,1,3,80583,80584,80587,1,4,0
23047,2,3,80585,80587,80590,2,5,0
23048,6,2,80591,80591,80593,0,2,1
23049,2,2,80593,80593,80595,0,2,0
23050,5,2,80598,80598,80600,0,2,3
23051,6,2,80604,80604,80606,0,2,4
23052,5,2,80609,80609,80611,0,2,3
23053,6,1,80615,80615,80616,0,1,4
23054,1,1,80616,80616,80617,0,1,0
23055,4,3,80620,80620,80623,0,3,3
23056,3,3,80623,80623,80626,0,3,0
23057,6,2,80629,80629,80631,0,2,3
23058,2,1,80631,80631,80632,0,1,0
23059,3,3,80634,80634,80637,0,3,2
23060,6,1,80640,80640,80641,0,1,3
23061,2,3,80642,80642,80645,0,3,1
23062,3,3,80645,80645,80648,0,3,0
23063,1,3,80646,80648,80651,2,5,0
23064,5,1,80651,80651,80652,0,1,0
23065,3,3,80654,80654,80657,0,3,2
23066,6,2,80660,80660,80662,0,2,3
23067,5,2,80665,80665,80667,0,2,3
23068,3,3,80668,80668,80671,0,3,1
23069,6,2,80674,80674,80676,0,2,3
23070,5,1,80679,80679,80680,0,1,3
23071,4,2,80683,80683,80685,0,2,3
23072,6,3,80689,80689,80692,0,3,4
23073,1,2,80690,80692,80694,2,4,0
23074,5,2,80695,80695,80697,0,2,1
23075,1,3,80696,80697,80700,1,4,0
23076,6,2,80702,80702,80704,0,2,2
23077,6,3,80708,80708,80711,0,3,4
23078,2,1,80710,80711,80712,1,2,0
23079,2,3,80712,80712,80715,0,3,0
23080,1,3,80713,80715,80718,2,5,0
23081,6,2,80719,80719,80721,0,2,1
23082,6,3,80725,80725,80728,0,3,4
23083,1,1,80726,80728,80729,2,3,0
23084,6,3,80732,80732,80735,0,3,3
23085,6,2,80738,80738,80740,0,2,3
23086,3,1,80741,80741,80742,0,1,1
23087,1,3,80742,80742,80745,0,3,0
23088,3,2,80745,80745,80747,0,2,0
23089,6,1,80751,80751,80752,0,1,4
23090,5,1,80756,80756,80757,0,1,4
23091,3,1,80759,80759,80760,0,1,2
23092,4,2,80763,80763,80765,0,2,3
23093,5,3,80768,80768,80771,0,3,3
23094,1,1,80769,80771,80772,2,3,0
23095,6,1,80775,80775,80776,0,1,3
23096,2,3,80777,80777,80780,0,3,1
23097,3,1,80780,80780,80781,0,1,0
23098,1,1,80781,80781,80782,0,1,0
23099,4,2,80785,80785,80787,0,2,3
23100,3,2,80788,80788,80790,0,2,1
23101,5,2,80793,80793,80795,0,2,3
23102,2,3,80795,80795,80798,0,3,0
23103,5,1,80800,80800,80801,0,1,2
23104,3,3,80803,80803,80806,0,3,2
23105,5,1,80808,80808,80809,0,1,2
23106,6,3,80814,80814,80817,0,3,5
23107,5,2,80819,80819,80821,0,2,2
23108,6,3,80825,80825,80828,0,3,4
23109,4,1,80829,80829,80830,0,1,1
23110,2,1,80831,80831,80832,0,1,1
23111,1,2,80832,80832,80834,0,2,0
23112,2,3,80834,80834,80837,0,3,0
23113,2,1,80836,80837,80838,1,2,0
23114,1,2,80837,80838,80840,1,3,0
23115,6,2,80843,80843,80845,0,2,3
23116,6,2,80849,80849,80851,0,2,4
23117,2,2,80851,80851,80853,0,2,0
23118,3,2,80854,80854,80856,0,2,1
23119,1,1,80855,80856,80857,1,2,0
23120,5,3,80860,80860,80863,0,3,3
23121,6,1,80866,80866,80867,0,1,3
23122,2,2,80868,80868,80870,0,2,1
23123,2,3,80870,80870,80873,0,3,0
23124,1,2,80871,80873,80875,2,4,0
23125,2,2,80873,80875,80877,2,4,0
23126,1,1,80874,80877,80878,3,4,0
23127,6,2,80880,80880,80882,0,2,2
23128,2,3,80882,80882,80885,0,3,0
23129,3,3,80885,80885,80888,0,3,0
23130,1,2,80886,80888,80890,2,4,0
23131,5,2,80891,80891,80893,0,2,1
23132,5,2,80896,80896,80898,0,2,3
23133,2,1,80898,80898,80899,0,1,0
23134,2,3,80900,80900,80903,0,3,1
23135,1,2,80901,80903,80905,2,4,0
23136,1,2,80902,80905,80907,3,5,0
23137,6,2,80908,80908,80910,0,2,1
23138,1,2,80909,80910,80912,1,3,0
23139,3,2,80912,80912,80914,0,2,0
23140,1,3,80913,80914,80917,1,4,0
23141,2,1,80915,80917,80918,2,3,0
23142,2,2,80917,80918,80920,1,3,0
23143,4,3,80921,80921,80924,0,3,1
23144,5,3,80926,80926,80929,0,3,2
23145,5,1,80931,80931,80932,0,1,2
23146,1,1,80932,80932,80933,0,1,0
23147,3,2,80935,80935,80937,0,2,2
23148,5,3,80940,80940,80943,0,3,3
23149,4,1,80944,80944,80945,0,1,1
23150,6,2,80950,80950,80952,0,2,5
23151,2,1,80952,80952,80953,0,1,0
23152,1,2,80953,80953,80955,0,2,0
23153,6,3,80959,80959,80962,0,3,4
23154,5,2,80964,80964,80966,0,2,2
23155,3,1,80967,80967,80968,0,1,1
23156,3,1,80970,80970,80971,0,1,2
23157,4,1,80974,80974,80975,0,1,3
23158,4,2,80978,80978,80980,0,2,3
23159,4,1,80982,80982,80983,0,1,2
23160,1,3,80983,80983,80986,0,3,0
23161,5,1,80988,80988,80989,0,1,2
23162,5,2,80993,80993,80995,0,2,4
23163,5,2,80998,80998,81000,0,2,3
23164,6,2,81004,81004,81006,0,2,4
23165,5,2,81009,81009,81011,0,2,3
23166,1,2,81010,81011,81013,1,3,0
23167,5,3,81015,81015,81018,0,3,2
23168,6,1,81021,81021,81022,0,1,3
23169,3,2,81024,81024,81026,0,2,2
23170,1,1,81025,81026,81027,1,2,0
23171,4,1,81029,81029,81030,0,1,2
23172,4,2,81033,81033,81035,0,2,3
23173,3,2,81036,81036,81038,0,2,1
23174,2,2,81038,81038,81040,0,2,0
23175,1,3,81039,81040,81043,1,4,0
23176,6,1,81045,81045,81046,0,1,2
23177,1,3,81046,81046,81049,0,3,0
23178,1,1,81047,81049,81050,2,3,0
23179,5,1,81052,81052,81053,0,1,2
23180,3,1,81055,81055,81056,0,1,2
23181,2,3,81057,81057,81060,0,3,1
23182,4,1,81061,81061,81062,0,1,1
23183,4,3,81065,81065,81068,0,3,3
23184,1,2,81066,81068,81070,2,4,0
23185,1,3,81067,81070,81073,3,6,0
23186,4,3,81071,81073,81076,2,5,0
23187,3,2,81074,81076,81078,2,4,0
23188,4,1,81078,81078,81079,0,1,0
23189,4,2,81082,81082,81084,0,2,3
23190,1,1,81083,81084,81085,1,2,0
23191,2,3,81085,81085,81088,0,3,0
23192,1,1,81086,81088,81089,2,3,0
23193,4,3,81090,81090,81093,0,3,1
23194,5,3,81095,81095,81098,0,3,2
23195,1,3,81096,81098,81101,2,5,0
23196,4,2,81100,81101,81103,1,3,0
23197,1,1,81101,81103,81104,2,3,0
23198,6,2,81107,81107,81109,0,2,3
23199,6,2,81113,81113,81115,0,2,4
23200,5,1,81118,81118,81119,0,1,3
23201,2,1,81120,81120,81121,0,1,1
23202,2,1,81122,81122,81123,0,1,1
23203,6,2,81128,81128,81130,0,2,5
23204,2,2,81130,81130,81132,0,2,0
23205,1,1,81131,81132,81133,1,2,0
23206,2,2,81133,81133,81135,0,2,0
23207,5,3,81138,81138,81141,0,3,3
23208,1,2,81139,81141,81143,2,4,0
23209,4,1,81143,81143,81144,0,1,0
23210,5,3,81148,81148,81151,0,3,4
23211,1,1,81149,81151,81152,2,3,0
23212,4,1,81153,81153,81154,0,1,1
23213,5,2,81158,81158,81160,0,2,4
23214,2,2,81160,81160,81162,0,2,0
23215,6,2,81166,81166,81168,0,2,4
23216,3,1,81169,81169,81170,0,1,1
23217,6,3,81175,81175,81178,0,3,5
23218,3,1,81178,81178,81179,0,1,0
23219,5,2,81183,81183,81185,0,2,4
23220,4,1,81187,81187,81188,0,1,2
23221,1,2,81188,81188,81190,0,2,0
23222,4,1,81192,81192,81193,0,1,2
23223,6,2,81198,81198,81200,0,2,5
23224,1,2,81199,81200,81202,1,3,0
23225,3,3,81202,81202,81205,0,3,0
23226,6,2,81208,81208,81210,0,2,3
23227,6,3,81214,81214,81217,0,3,4
23228,6,2,81220,81220,81222,0,2,3
23229,6,1,81226,81226,81227,0,1,4
23230,6,3,81232,81232,81235,0,3,5
23231,5,2,81237,81237,81239,0,2,2
23232,5,3,81242,81242,81245,0,3,3
23233,1,3,81243,81245,81248,2,5,0
23234,5,3,81248,81248,81251,0,3,0
23235,3,1,81251,81251,81252,0,1,0
23236,3,2,81254,81254,81256,0,2,2
23237,3,2,81257,81257,81259,0,2,1
23238,2,2,81259,81259,81261,0,2,0
23239,1,2,81260,81261,81263,1,3,0
23240,6,1,81266,81266,81267,0,1,3
23241,4,2,81270,81270,81272,0,2,3
23242,6,1,81276,81276,81277,0,1,4
23243,5,1,81281,81281,81282,0,1,4
23244,2,1,81283,81283,81284,0,1,1
23245,2,2,81285,81285,81287,0,2,1
23246,5,3,81290,81290,81293,0,3,3
23247,2,3,81292,81293,81296,1,4,0
23248,2,3,81294,81296,81299,2,5,0
23249,6,1,81300,81300,81301,0,1,1
23250,4,2,81304,81304,81306,0,2,3
23251,1,3,81305,81306,81309,1,4,0
23252,3,2,81308,81309,81311,1,3,0
23253,5,2,81313,81313,81315,0,2,2
23254,4,1,81317,81317,81318,0,1,2
23255,2,1,81319,81319,81320,0,1,1
23256,1,3,81320,81320,81323,0,3,0
23257,5,1,81325,81325,81326,0,1,2
23258,2,2,81327,81327,81329,0,2,1
23259,6,3,81333,81333,81336,0,3,4
23260,2,3,81335,81336,81339,1,4,0
23261,4,1,81339,81339,81340,0,1,0
23262,3,1,81342,81342,81343,0,1,2
23263,2,3,81344,81344,81347,0,3,1
23264,2,2,81346,81347,81349,1,3,0
23265,2,2,81348,81349,81351,1,3,0
23266,5,3,81353,81353,81356,0,3,2
23267,3,2,81356,81356,81358,0,2,0
23268,1,2,81357,81358,81360,1,3,0
23269,2,1,81359,81360,81361,1,2,0
23270,3,2,81362,81362,81364,0,2,1
23271,5,3,81367,81367,81370,0,3,3
23272,4,2,81371,81371,81373,0,2,1
23273,2,1,81373,81373,81374,0,1,0
23274,3,3,81376,81376,81379,0,3,2
23275,6,2,81382,81382,81384,0,2,3
23276,1,3,81383,81384,81387,1,4,0
23277,4,1,81387,81387,81388,0,1,0
23278,4,1,81391,81391,81392,0,1,3
23279,3,1,81394,81394,81395,0,1,2
23280,3,2,81397,81397,81399,0,2,2
23281,4,3,81401,81401,81404,0,3,2
23282,6,1,81407,81407,81408,0,1,3
23283,6,3,81413,81413,81416,0,3,5
23284,4,1,81417,81417,81418,0,1,1
23285,1,2,81418,81418,81420,0,2,0
23286,2,1,81420,81420,81421,0,1,0
23287,2,1,81422,81422,81423,0,1,1
23288,2,3,81424,81424,81427,0,3,1
23289,6,2,81430,81430,81432,0,2,3
23290,3,3,81433,81433,81436,0,3,1
23291,2,3,81435,81436,81439,1,4,0
23292,3,1,81438,81439,81440,1,2,0
23293,1,1,81439,81440,81441,1,2,0
23294,4,1,81443,81443,81444,0,1,2
23295,4,1,81447,81447,81448,0,1,3
23296,1,2,81448,81448,81450,0,2,0
23297,5,3,81453,81453,81456,0,3,3
23298,3,2,81456,81456,81458,0,2,0
23299,5,2,81461,81461,81463,0,2,3
23300,5,1,81466,81466,81467,0,1,3
23301,4,2,81470,81470,81472,0,2,3
23302,6,2,81476,81476,81478,0,2,4
23303,4,2,81480,81480,81482,0,2,2
23304,3,3,81483,81483,81486,0,3,1
23305,4,3,81487,81487,81490,0,3,1
23306,3,3,81490,81490,81493,0,3,0
23307,1,3,81491,81493,81496,2,5,0
23308,4,3,81495,81496,81499,1,4,0
23309,4,2,81499,81499,81501,0,2,0
23310,5,2,81504,81504,81506,0,2,3
23311,4,1,81508,81508,81509,0,1,2
23312,3,2,81511,81511,81513,0,2,2
23313,6,1,81517,81517,81518,0,1,4
23314,5,1,81522,81522,81523,0,1,4
23315,5,1,81527,81527,81528,0,1,4
23316,4,1,81531,81531,81532,0,1,3
23317,2,2,81533,81533,81535,0,2,1
23318,5,3,81538,81538,81541,0,3,3
23319,5,3,81543,81543,81546,0,3,2
23320,2,1,81545,81546,81547,1,2,0
23321,1,1,81546,81547,81548,1,2,0
23322,1,1,81547,81548,81549,1,2,0
23323,6,2,81553,81553,81555,0,2,4
23324,4,2,81557,81557,81559,0,2,2
23325,3,3,81560,81560,81563,0,3,1
23326,5,2,81565,81565,81567,0,2,2
23327,3,1,81568,81568,81569,0,1,1
23328,4,2,81572,81572,81574,0,2,3
23329,2,2,81574,81574,81576,0,2,0
23330,1,3,81575,81576,81579,1,4,0
23331,5,3,81580,81580,81583,0,3,1
23332,2,2,81582,81583,81585,1,3,0
23333,3,1,81585,81585,81586,0,1,0
23334,6,1,81591,81591,81592,0,1,5
23335,3,1,81594,81594,81595,0,1,2
23336,4,3,81598,81598,81601,0,3,3
23337,4,2,81602,81602,81604,0,2,1
23338,1,3,81603,81604,81607,1,4,0
23339,5,1,81608,81608,81609,0,1,1
23340,1,3,81609,81609,81612,0,3,0
23341,5,1,81614,81614,81615,0,1,2
23342,6,3,81620,81620,81623,0,3,5
23343,4,1,81624,81624,81625,0,1,1
23344,3,1,81627,81627,81628,0,1,2
23345,3,3,81630,81630,81633,0,3,2
23346,5,1,81635,81635,81636,0,1,2
23347,5,2,81640,81640,81642,0,2,4
23348,1,1,81641,81642,81643,1,2,0
23349,2,1,81643,81643,81644,0,1,0
23350,6,1,81649,81649,81650,0,1,5
23351,6,3,81655,81655,81658,0,3,5
23352,2,1,81657,81658,81659,1,2,0
23353,3,1,81660,81660,81661,0,1,1
23354,1,3,81661,81661,81664,0,3,0
23355,2,2,81663,81664,81666,1,3,0
23356,6,1,81669,81669,81670,0,1,3
23357,5,2,81674,81674,81676,0,2,4
23358,1,2,81675,81676,81678,1,3,0
23359,2,2,81677,81678,81680,1,3,0
23360,6,3,81683,81683,81686,0,3,3
23361,6,1,81689,81689,81690,0,1,3
23362,2,3,81691,81691,81694,0,3,1
23363,1,1,81692,81694,81695,2,3,0
23364,5,1,81697,81697,81698,0,1,2
23365,4,3,81701,81701,81704,0,3,3
23366,4,1,81705,81705,81706,0,1,1
23367,4,3,81709,81709,81712,0,3,3
23368,3,2,81712,81712,81714,0,2,0
23369,1,2,81713,81714,81716,1,3,0
23370,2,2,81715,81716,81718,1,3,0
23371,3,3,81718,81718,81721,0,3,0
23372,2,3,81720,81721,81724,1,4,0
23373,3,1,81723,81724,81725,1,2,0
23374,6,1,81729,81729,81730,0,1,4
23375,3,2,81732,81732,81734,0,2,2
23376,6,3,81738,81738,81741,0,3,4
23377,4,3,81742,81742,81745,0,3,1
23378,6,2,81748,81748,81750,0,2,3
23379,1,1,81749,81750,81751,1,2,0
23380,1,1,81750,81751,81752,1,2,0
23381,3,1,81753,81753,81754,0,1,1
23382,5,1,81758,81758,81759,0,1,4
23383,3,3,81761,81761,81764,0,3,2
23384,6,3,81767,81767,81770,0,3,3
23385,1,2,81768,81770,81772,2,4,0
23386,4,1,81772,81772,81773,0,1,0
23387,5,3,81777,81777,81780,0,3,4
23388,1,2,81778,81780,81782,2,4,0
23389,1,3,81779,81782,81785,3,6,0
23390,1,3,81780,81785,81788,5,8,0
23391,6,2,81786,81788,81790,2,4,0
23392,3,3,81789,81790,81793,1,4,0
23393,6,3,81795,81795,81798,0,3,2
23394,4,2,81799,81799,81801,0,2,1
23395,4,1,81803,81803,81804,0,1,2
23396,5,3,81808,81808,81811,0,3,4
23397,3,3,81811,81811,81814,0,3,0
23398,6,1,81817,81817,81818,0,1,3
23399,1,1,81818,81818,81819,0,1,0
23400,4,2,81822,81822,81824,0,2,3
23401,6,2,81828,81828,81830,0,2,4
23402,2,2,81830,81830,81832,0,2,0
23403,4,3,81834,81834,81837,0,3,2
23404,1,1,81835,81837,81838,2,3,0
23405,3,3,81838,81838,81841,0,3,0
23406,3,2,81841,81841,81843,0,2,0
23407,3,3,81844,81844,81847,0,3,1
23408,2,2,81846,81847,81849,1,3,0
23409,5,2,81851,81851,81853,0,2,2
23410,6,3,81857,81857,81860,0,3,4
23411,1,2,81858,81860,81862,2,4,0
23412,4,2,81862,81862,81864,0,2,0
23413,5,3,81867,81867,81870,0,3,3
23414,4,1,81871,81871,81872,0,1,1
23415,1,2,81872,81872,81874,0,2,0
23416,2,1,81874,81874,81875,0,1,0
23417,3,3,81877,81877,81880,0,3,2
23418,3,1,81880,81880,81881,0,1,0
23419,1,1,81881,81881,81882,0,1,0
23420,5,1,81886,81886,81887,0,1,4
23421,3,3,81889,81889,81892,0,3,2
23422,6,1,81895,81895,81896,0,1,3
23423,5,2,81900,81900,81902,0,2,4
23424,5,2,81905,81905,81907,0,2,3
23425,1,1,81906,81907,81908,1,2,0
23426,6,2,81912,81912,81914,0,2,4
23427,3,1,81915,81915,81916,0,1,1
23428,6,3,81921,81921,81924,0,3,5
23429,4,1,81925,81925,81926,0,1,1
23430,4,2,81929,81929,81931,0,2,3
23431,3,1,81932,81932,81933,0,1,1
23432,3,2,81935,81935,81937,0,2,2
23433,1,1,81936,81937,81938,1,2,0
23434,5,1,81941,81941,81942,0,1,3
23435,2,2,81943,81943,81945,0,2,1
23436,4,3,81947,81947,81950,0,3,2
23437,1,2,81948,81950,81952,2,4,0
23438,4,3,81952,81952,81955,0,3,0
23439,1,3,81953,81955,81958,2,5,0
23440,6,1,81959,81959,81960,0,1,1
23441,1,2,81960,81960,81962,0,2,0
23442,6,2,81966,81966,81968,0,2,4
23443,4,1,81970,81970,81971,0,1,2
23444,4,1,81974,81974,81975,0,1,3
23445,1,3,81975,81975,81978,0,3,0
23446,1,2,81976,81978,81980,2,4,0
23447,6,2,81982,81982,81984,0,2,2
23448,3,3,81985,81985,81988,0,3,1
23449,6,3,81991,81991,81994,0,3,3
23450,5,1,81996,81996,81997,0,1,2
23451,3,2,81999,81999,82001,0,2,2
23452,4,2,82003,82003,82005,0,2,2
23453,5,3,82008,82008,82011,0,3,3
23454,5,2,82013,82013,82015,0,2,2
23455,4,3,82017,82017,82020,0,3,2
23456,4,2,82021,82021,82023,0,2,1
23457,6,3,82027,82027,82030,0,3,4
23458,2,3,82029,82030,82033,1,4,0
23459,2,2,82031,82033,82035,2,4,0
23460,3,2,82034,82035,82037,1,3,0
23461,6,2,82040,82040,82042,0,2,3
23462,2,3,82042,82042,82045,0,3,0
23463,4,1,82046,82046,82047,0,1,1
23464,6,1,82052,82052,82053,0,1,5
23465,6,3,82058,82058,82061,0,3,5
23466,5,3,82063,82063,82066,0,3,2
23467,4,1,82067,82067,82068,0,1,1
23468,5,2,82072,82072,82074,0,2,4
23469,1,3,82073,82074,82077,1,4,0
23470,5,1,82078,82078,82079,0,1,1
23471,5,3,82083,82083,82086,0,3,4
23472,6,2,82089,82089,82091,0,2,3
23473,2,3,82091,82091,82094,0,3,0
23474,5,1,82096,82096,82097,0,1,2
23475,6,3,82102,82102,82105,0,3,5
23476,1,3,82103,82105,82108,2,5,0
23477,4,2,82107,82108,82110,1,3,0
23478,2,2,82109,82110,82112,1,3,0
23479,1,1,82110,82112,82113,2,3,0
23480,3,1,82113,82113,82114,0,1,0
23481,4,3,82117,82117,82120,0,3,3
23482,3,1,82120,82120,82121,0,1,0
23483,3,2,82123,82123,82125,0,2,2
23484,4,2,82127,82127,82129,0,2,2
23485,2,1,82129,82129,82130,0,1,0
23486,6,1,82135,82135,82136,0,1,5
23487,2,1,82137,82137,82138,0,1,1
23488,1,1,82138,82138,82139,0,1,0
23489,6,1,82144,82144,82145,0,1,5
23490,3,3,82147,82147,82150,0,3,2
23491,4,2,82151,82151,82153,0,2,1
23492,3,1,82154,82154,82155,0,1,1
23493,3,2,82157,82157,82159,0,2,2
23494,4,1,82161,82161,82162,0,1,2
23495,5,1,82166,82166,82167,0,1,4
23496,3,2,82169,82169,82171,0,2,2
23497,4,3,82173,82173,82176,0,3,2
23498,1,1,82174,82176,82177,2,3,0
23499,6,3,82180,82180,82183,0,3,3
23500,3,2,82183,82183,82185,0,2,0
23501,2,3,82185,82185,82188,0,3,0
23502,4,1,82189,82189,82190,0,1,1
23503,5,3,82194,82194,82197,0,3,4
23504,2,2,82196,82197,82199,1,3,0
23505,5,1,82201,82201,82202,0,1,2
23506,3,2,82204,82204,82206,0,2,2
23507,5,3,82209,82209,82212,0,3,3
23508,1,2,82210,82212,82214,2,4,0
23509,5,3,82215,82215,82218,0,3,1
23510,6,3,82221,82221,82224,0,3,3
23511,6,1,82227,82227,82228,0,1,3
23512,3,3,82230,82230,82233,0,3,2
23513,4,2,82234,82234,82236,0,2,1
23514,6,2,82240,82240,82242,0,2,4
23515,3,1,82243,82243,82244,0,1,1
23516,5,2,82248,82248,82250,0,2,4
23517,1,1,82249,82250,82251,1,2,0
23518,5,2,82254,82254,82256,0,2,3
23519,4,3,82258,82258,82261,0,3,2
23520,4,1,82262,82262,82263,0,1,1
23521,3,2,82265,82265,82267,0,2,2
23522,4,1,82269,82269,82270,0,1,2
23523,6,3,82275,82275,82278,0,3,5
23524,4,1,82279,82279,82280,0,1,1
23525,5,2,82284,82284,82286,0,2,4
23526,6,1,82290,82290,82291,0,1,4
23527,5,3,82295,82295,82298,0,3,4
23528,2,3,82297,82298,82301,1,4,0
23529,5,3,82302,82302,82305,0,3,1
23530,4,1,82306,82306,82307,0,1,1
23531,6,3,82312,82312,82315,0,3,5
23532,4,2,82316,82316,82318,0,2,1
23533,4,3,82320,82320,82323,0,3,2
23534,3,2,82323,82323,82325,0,2,0
23535,4,2,82327,82327,82329,0,2,2
23536,4,1,82331,82331,82332,0,1,2
23537,4,2,82335,82335,82337,0,2,3
23538,3,2,82338,82338,82340,0,2,1
23539,6,3,82344,82344,82347,0,3,4
23540,1,1,82345,82347,82348,2,3,0
23541,1,1,82346,82348,82349,2,3,0
23542,1,3,82347,82349,82352,2,5,0
23543,3,3,82350,82352,82355,2,5,0
23544,2,2,82352,82355,82357,3,5,0
23545,3,2,82355,82357,82359,2,4,0
23546,1,1,82356,82359,82360,3,4,0
23547,4,1,82360,82360,82361,0,1,0
23548,6,3,82366,82366,82369,0,3,5
23549,2,1,82368,82369,82370,1,2,0
23550,4,1,82372,82372,82373,0,1,2
23551,4,2,82376,82376,82378,0,2,3
23552,5,3,82381,82381,82384,0,3,3
23553,3,1,82384,82384,82385,0,1,0
23554,1,2,82385,82385,82387,0,2,0
23555,6,3,82391,82391,82394,0,3,4
23556,1,1,82392,82394,82395,2,3,0
23557,2,1,82394,82395,82396,1,2,0
23558,3,1,82397,82397,82398,0,1,1
23559,3,2,82400,82400,82402,0,2,2
23560,6,1,82406,82406,82407,0,1,4
23561,4,2,82410,82410,82412,0,2,3
23562,2,1,82412,82412,82413,0,1,0
23563,5,2,82417,82417,82419,0,2,4
23564,3,3,82420,82420,82423,0,3,1
23565,1,1,82421,82423,82424,2,3,0
23566,4,3,82425,82425,82428,0,3,1
23567,3,2,82428,82428,82430,0,2,0
23568,4,3,82432,82432,82435,0,3,2
23569,3,2,82435,82435,82437,0,2,0
23570,6,3,82441,82441,82444,0,3,4
23571,3,3,82444,82444,82447,0,3,0
23572,4,3,82448,82448,82451,0,3,1
23573,3,1,82451,82451,82452,0,1,0
23574,1,3,82452,82452,82455,0,3,0
23575,4,1,82456,82456,82457,0,1,1
23576,6,1,82462,82462,82463,0,1,5
23577,3,3,82465,82465,82468,0,3,2
23578,5,2,82470,82470,82472,0,2,2
23579,1,3,82471,82472,82475,1,4,0
23580,1,3,82472,82475,82478,3,6,0
23581,1,2,82473,82478,82480,5,7,0
23582,6,1,82479,82480,82481,1,2,0
23583,6,1,82485,82485,82486,0,1,4
23584,1,2,82486,82486,82488,0,2,0
23585,3,2,82489,82489,82491,0,2,1
23586,4,3,82493,82493,82496,0,3,2
23587,1,2,82494,82496,82498,2,4,0
23588,5,2,82499,82499,82501,0,2,1
23589,3,3,82502,82502,82505,0,3,1
23590,4,1,82506,82506,82507,0,1,1
23591,1,1,82507,82507,82508,0,1,0
23592,6,1,82513,82513,82514,0,1,5
23593,4,2,82517,82517,82519,0,2,3
23594,4,1,82521,82521,82522,0,1,2
23595,2,2,82523,82523,82525,0,2,1
23596,1,2,82524,82525,82527,1,3,0
23597,5,3,82529,82529,82532,0,3,2
23598,2,3,82531,82532,82535,1,4,0
23599,4,1,82535,82535,82536,0,1,0
23600,6,2,82541,82541,82543,0,2,5
23601,5,1,82546,82546,82547,0,1,3
23602,2,1,82548,82548,82549,0,1,1
23603,6,3,82554,82554,82557,0,3,5
23604,6,2,82560,82560,82562,0,2,3
23605,3,3,82563,82563,82566,0,3,1
23606,3,3,82566,82566,82569,0,3,0
23607,5,2,82571,82571,82573,0,2,2
23608,4,2,82575,82575,82577,0,2,2
23609,5,1,82580,82580,82581,0,1,3
23610,4,1,82584,82584,82585,0,1,3
23611,2,2,82586,82586,82588,0,2,1
23612,6,1,82592,82592,82593,0,1,4
23613,3,3,82595,82595,82598,0,3,2
23614,2,2,82597,82598,82600,1,3,0
23615,5,2,82602,82602,82604,0,2,2
23616,5,1,82607,82607,82608,0,1,3
23617,5,2,82612,82612,82614,0,2,4
23618,5,1,82617,82617,82618,0,1,3
23619,5,3,82622,82622,82625,0,3,4
23620,6,2,82628,82628,82630,0,2,3
23621,4,2,82632,82632,82634,0,2,2
23622,3,3,82635,82635,82638,0,3,1
23623,1,3,82636,82638,82641,2,5,0
23624,3,1,82639,82641,82642,2,3,0
23625,5,3,82644,82644,82647,0,3,2
23626,5,2,82649,82649,82651,0,2,2
23627,6,3,82655,82655,82658,0,3,4
23628,4,2,82659,82659,82661,0,2,1
23629,3,1,82662,82662,82663,0,1,1
23630,4,3,82666,82666,82669,0,3,3
23631,3,1,82669,82669,82670,0,1,0
23632,2,2,82671,82671,82673,0,2,1
23633,6,1,82677,82677,82678,0,1,4
23634,3,2,82680,82680,82682,0,2,2
23635,2,3,82682,82682,82685,0,3,0
23636,2,3,82684,82685,82688,1,4,0
23637,6,2,82690,82690,82692,0,2,2
23638,3,3,82693,82693,82696,0,3,1
23639,6,3,82699,82699,82702,0,3,3
23640,5,3,82704,82704,82707,0,3,2
23641,3,2,82707,82707,82709,0,2,0
23642,4,1,82711,82711,82712,0,1,2
23643,1,3,82712,82712,82715,0,3,0
23644,1,3,82713,82715,82718,2,5,0
23645,4,2,82717,82718,82720,1,3,0
23646,6,1,82723,82723,82724,0,1,3
23647,5,1,82728,82728,82729,0,1,4
23648,4,3,82732,82732,82735,0,3,3
23649,2,3,82734,82735,82738,1,4,0
23650,5,1,82739,82739,82740,0,1,1
23651,3,2,82742,82742,82744,0,2,2
23652,4,2,82746,82746,82748,0,2,2
23653,6,1,82752,82752,82753,0,1,4
23654,1,1,82753,82753,82754,0,1,0
23655,1,2,82754,82754,82756,0,2,0
23656,2,1,82756,82756,82757,0,1,0
23657,1,3,82757,82757,82760,0,3,0
23658,6,2,82763,82763,82765,0,2,3
23659,6,3,82769,82769,82772,0,3,4
23660,2,3,82771,82772,82775,1,4,0
23661,4,1,82775,82775,82776,0,1,0
23662,4,3,82779,82779,82782,0,3,3
23663,4,3,82783,82783,82786,0,3,1
23664,5,2,82788,82788,82790,0,2,2
23665,6,3,82794,82794,82797,0,3,4
23666,3,1,82797,82797,82798,0,1,0
23667,4,1,82801,82801,82802,0,1,3
23668,5,3,82806,82806,82809,0,3,4
23669,1,3,82807,82809,82812,2,5,0
23670,1,3,82808,82812,82815,4,7,0
23671,1,3,82809,82815,82818,6,9,0
23672,5,1,82814,82818,82819,4,5,0
23673,6,2,82820,82820,82822,0,2,1
23674,6,2,82826,82826,82828,0,2,4
23675,1,2,82827,82828,82830,1,3,0
23676,2,1,82829,82830,82831,1,2,0
23677,1,2,82830,82831,82833,1,3,0
23678,5,1,82835,82835,82836,0,1,2
23679,6,3,82841,82841,82844,0,3,5
23680,4,3,82845,82845,82848,0,3,1
23681,2,1,82847,82848,82849,1,2,0
23682,6,3,82853,82853,82856,0,3,4
23683,3,2,82856,82856,82858,0,2,0
23684,2,3,82858,82858,82861,0,3,0
23685,5,2,82863,82863,82865,0,2,2
23686,4,2,82867,82867,82869,0,2,2
23687,6,1,82873,82873,82874,0,1,4
23688,4,3,82877,82877,82880,0,3,3
23689,5,2,82882,82882,82884,0,2,2
23690,2,3,82884,82884,82887,0,3,0
23691,5,3,82889,82889,82892,0,3,2
23692,3,3,82892,82892,82895,0,3,0
23693,6,3,82898,82898,82901,0,3,3
23694,5,3,82903,82903,82906,0,3,2
23695,5,2,82908,82908,82910,0,2,2
23696,3,2,82911,82911,82913,0,2,1
23697,2,1,82913,82913,82914,0,1,0
23698,5,3,82918,82918,82921,0,3,4
23699,6,2,82924,82924,82926,0,2,3
23700,5,1,82929,82929,82930,0,1,3
23701,1,1,82930,82930,82931,0,1,0
23702,3,2,82933,82933,82935,0,2,2
23703,4,3,82937,82937,82940,0,3,2
23704,5,1,82942,82942,82943,0,1,2
23705,3,2,82945,82945,82947,0,2,2
23706,4,2,82949,82949,82951,0,2,2
23707,1,2,82950,82951,82953,1,3,0
23708,6,1,82956,82956,82957,0,1,3
23709,1,3,82957,82957,82960,0,3,0
23710,4,2,82961,82961,82963,0,2,1
23711,1,1,82962,82963,82964,1,2,0
23712,6,3,82968,82968,82971,0,3,4
23713,4,2,82972,82972,82974,0,2,1
23714,3,1,82975,82975,82976,0,1,1
23715,6,1,82981,82981,82982,0,1,5
23716,5,1,82986,82986,82987,0,1,4
23717,3,2,82989,82989,82991,0,2,2
23718,1,1,82990,82991,82992,1,2,0
23719,2,3,82992,82992,82995,0,3,0
23720,2,1,82994,82995,82996,1,2,0
23721,3,3,82997,82997,83000,0,3,1
23722,6,1,83003,83003,83004,0,1,3
23723,3,3,83006,83006,83009,0,3,2
23724,4,1,83010,83010,83011,0,1,1
23725,6,1,83016,83016,83017,0,1,5
23726,4,2,83020,83020,83022,0,2,3
23727,5,2,83025,83025,83027,0,2,3
23728,6,3,83031,83031,83034,0,3,4
23729,3,1,83034,83034,83035,0,1,0
23730,5,2,83039,83039,83041,0,2,4
23731,2,3,83041,83041,83044,0,3,0
23732,1,1,83042,83044,83045,2,3,0
23733,6,2,83048,83048,83050,0,2,3
23734,1,2,83049,83050,83052,1,3,0
23735,6,3,83055,83055,83058,0,3,3
23736,2,3,83057,83058,83061,1,4,0
23737,1,2,83058,83061,83063,3,5,0
23738,1,3,83059,83063,83066,4,7,0
23739,6,1,83065,83066,83067,1,2,0
23740,6,1,83071,83071,83072,0,1,4
23741,1,3,83072,83072,83075,0,3,0
23742,5,3,83077,83077,83080,0,3,2
23743,1,3,83078,83080,83083,2,5,0
23744,2,3,83080,83083,83086,3,6,0
23745,5,2,83085,83086,83088,1,3,0
23746,1,1,83086,83088,83089,2,3,0
23747,5,2,83091,83091,83093,0,2,2
23748,1,3,83092,83093,83096,1,4,0
23749,1,1,83093,83096,83097,3,4,0
23750,1,3,83094,83097,83100,3,6,0
23751,3,2,83097,83100,83102,3,5,0
23752,2,2,83099,83102,83104,3,5,0
23753,5,1,83104,83104,83105,0,1,0
23754,6,3,83110,83110,83113,0,3,5
23755,1,3,83111,83113,83116,2,5,0
23756,2,3,83113,83116,83119,3,6,0
23757,4,3,83117,83119,83122,2,5,0
23758,5,2,83122,83122,83124,0,2,0
23759,2,1,83124,83124,83125,0,1,0
23760,5,1,83129,83129,83130,0,1,4
23761,4,2,83133,83133,83135,0,2,3
23762,2,2,83135,83135,83137,0,2,0
23763,2,1,83137,83137,83138,0,1,0
23764,6,1,83143,83143,83144,0,1,5
23765,6,1,83149,83149,83150,0,1,5
23766,5,3,83154,83154,83157,0,3,4
23767,3,3,83157,83157,83160,0,3,0
23768,3,2,83160,83160,83162,0,2,0
23769,6,1,83166,83166,83167,0,1,4
23770,3,1,83169,83169,83170,0,1,2
23771,2,1,83171,83171,83172,0,1,1
23772,3,2,83174,83174,83176,0,2,2
23773,2,1,83176,83176,83177,0,1,0
23774,1,1,83177,83177,83178,0,1,0
23775,1,1,83178,83178,83179,0,1,0
23776,4,2,83182,83182,83184,0,2,3
23777,4,2,83186,83186,83188,0,2,2
23778,6,1,83192,83192,83193,0,1,4
23779,4,3,83196,83196,83199,0,3,3
23780,6,3,83202,83202,83205,0,3,3
23781,2,1,83204,83205,83206,1,2,0
23782,5,2,83209,83209,83211,0,2,3
23783,1,3,83210,83211,83214,1,4,0
23784,4,2,83214,83214,83216,0,2,0
23785,1,2,83215,83216,83218,1,3,0
23786,3,1,83218,83218,83219,0,1,0
23787,6,3,83224,83224,83227,0,3,5
23788,1,2,83225,83227,83229,2,4,0
23789,6,1,83231,83231,83232,0,1,2
23790,1,2,83232,83232,83234,0,2,0
23791,6,1,83238,83238,83239,0,1,4
23792,1,3,83239,83239,83242,0,3,0
23793,3,1,83242,83242,83243,0,1,0
23794,6,1,83248,83248,83249,0,1,5
23795,4,1,83252,83252,83253,0,1,3
23796,5,3,83257,83257,83260,0,3,4
23797,3,2,83260,83260,83262,0,2,0
23798,4,3,83264,83264,83267,0,3,2
23799,6,1,83270,83270,83271,0,1,3
23800,1,3,83271,83271,83274,0,3,0
23801,3,2,83274,83274,83276,0,2,0
23802,2,1,83276,83276,83277,0,1,0
23803,4,2,83280,83280,83282,0,2,3
23804,1,2,83281,83282,83284,1,3,0
23805,4,2,83285,83285,83287,0,2,1
23806,3,3,83288,83288,83291,0,3,1
23807,3,3,83291,83291,83294,0,3,0
23808,6,1,83297,83297,83298,0,1,3
23809,5,1,83302,83302,83303,0,1,4
23810,4,3,83306,83306,83309,0,3,3
23811,6,3,83312,83312,83315,0,3,3
23812,1,1,83313,83315,83316,2,3,0
23813,3,3,83316,83316,83319,0,3,0
23814,3,1,83319,83319,83320,0,1,0
23815,6,3,83325,83325,83328,0,3,5
23816,1,2,83326,83328,83330,2,4,0
23817,5,2,83331,83331,83333,0,2,1
23818,3,3,83334,83334,83337,0,3,1
23819,6,1,83340,83340,83341,0,1,3
23820,6,2,83346,83346,83348,0,2,5
23821,2,3,83348,83348,83351,0,3,0
23822,2,1,83350,83351,83352,1,2,0
23823,2,2,83352,83352,83354,0,2,0
23824,5,3,83357,83357,83360,0,3,3
23825,3,3,83360,83360,83363,0,3,0
23826,2,3,83362,83363,83366,1,4,0
23827,1,1,83363,83366,83367,3,4,0
23828,5,3,83368,83368,83371,0,3,1
23829,3,1,83371,83371,83372,0,1,0
23830,3,2,83374,83374,83376,0,2,2
23831,4,3,83378,83378,83381,0,3,2
23832,5,1,83383,83383,83384,0,1,2
23833,5,1,83388,83388,83389,0,1,4
23834,4,1,83392,83392,83393,0,1,3
23835,4,3,83396,83396,83399,0,3,3
23836,1,1,83397,83399,83400,2,3,0
23837,3,1,83400,83400,83401,0,1,0
23838,1,3,83401,83401,83404,0,3,0
23839,3,3,83404,83404,83407,0,3,0
23840,2,2,83406,83407,83409,1,3,0
23841,3,3,83409,83409,83412,0,3,0
23842,3,3,83412,83412,83415,0,3,0
23843,5,2,83417,83417,83419,0,2,2
23844,4,2,83421,83421,83423,0,2,2
23845,6,1,83427,83427,83428,0,1,4
23846,3,1,83430,83430,83431,0,1,2
23847,4,1,83434,83434,83435,0,1,3
23848,5,3,83439,83439,83442,0,3,4
23849,2,2,83441,83442,83444,1,3,0
23850,1,2,83442,83444,83446,2,4,0
23851,6,2,83448,83448,83450,0,2,2
23852,2,1,83450,83450,83451,0,1,0
23853,6,2,83456,83456,83458,0,2,5
23854,3,3,83459,83459,83462,0,3,1
23855,4,3,83463,83463,83466,0,3,1
23856,1,2,83464,83466,83468,2,4,0
23857,5,3,83469,83469,83472,0,3,1
23858,3,2,83472,83472,83474,0,2,0
23859,2,2,83474,83474,83476,0,2,0
23860,1,2,83475,83476,83478,1,3,0
23861,4,3,83479,83479,83482,0,3,1
23862,6,1,83485,83485,83486,0,1,3
23863,5,3,83490,83490,83493,0,3,4
23864,3,2,83493,83493,83495,0,2,0
23865,6,1,83499,83499,83500,0,1,4
23866,1,3,83500,83500,83503,0,3,0
23867,1,1,83501,83503,83504,2,3,0
23868,4,2,83505,83505,83507,0,2,1
23869,3,1,83508,83508,83509,0,1,1
23870,6,2,83514,83514,83516,0,2,5
23871,1,2,83515,83516,83518,1,3,0
23872,5,1,83520,83520,83521,0,1,2
23873,5,2,83525,83525,83527,0,2,4
23874,2,1,83527,83527,83528,0,1,0
23875,5,2,83532,83532,83534,0,2,4
23876,1,3,83533,83534,83537,1,4,0
23877,2,3,83535,83537,83540,2,5,0
23878,1,2,83536,83540,83542,4,6,0
23879,4,2,83540,83542,83544,2,4,0
23880,4,1,83544,83544,83545,0,1,0
23881,1,3,83545,83545,83548,0,3,0
23882,2,2,83547,83548,83550,1,3,0
23883,6,3,83553,83553,83556,0,3,3
23884,2,3,83555,83556,83559,1,4,0
23885,1,1,83556,83559,83560,3,4,0
23886,6,1,83562,83562,83563,0,1,2
23887,6,2,83568,83568,83570,0,2,5
23888,1,1,83569,83570,83571,1,2,0
23889,5,2,83574,83574,83576,0,2,3
23890,2,3,83576,83576,83579,0,3,0
23891,6,3,83582,83582,83585,0,3,3
23892,3,3,83585,83585,83588,0,3,0
23893,5,2,83590,83590,83592,0,2,2
23894,1,2,83591,83592,83594,1,3,0
23895,3,2,83594,83594,83596,0,2,0
23896,2,3,83596,83596,83599,0,3,0
23897,2,2,83598,83599,83601,1,3,0
23898,4,3,83602,83602,83605,0,3,1
23899,3,3,83605,83605,83608,0,3,0
23900,2,3,83607,83608,83611,1,4,0
23901,4,2,83611,83611,83613,0,2,0
23902,6,1,83617,83617,83618,0,1,4
23903,6,1,83623,83623,83624,0,1,5
23904,5,3,83628,83628,83631,0,3,4
23905,1,1,83629,83631,83632,2,3,0
23906,4,1,83633,83633,83634,0,1,1
23907,6,3,83639,83639,83642,0,3,5
23908,2,2,83641,83642,83644,1,3,0
23909,1,1,83642,83644,83645,2,3,0
23910,1,1,83643,83645,83646,2,3,0
23911,4,2,83647,83647,83649,0,2,1
23912,4,2,83651,83651,83653,0,2,2
23913,4,1,83655,83655,83656,0,1,2
23914,5,1,83660,83660,83661,0,1,4
23915,5,3,83665,83665,83668,0,3,4
23916,6,2,83671,83671,83673,0,2,3
23917,6,3,83677,83677,83680,0,3,4
23918,5,3,83682,83682,83685,0,3,2
23919,5,1,83687,83687,83688,0,1,2
23920,1,1,83688,83688,83689,0,1,0
23921,6,3,83694,83694,83697,0,3,5
23922,1,2,83695,83697,83699,2,4,0
23923,4,2,83699,83699,83701,0,2,0
23924,6,2,83705,83705,83707,0,2,4
23925,3,1,83708,83708,83709,0,1,1
23926,5,3,83713,83713,83716,0,3,4
23927,4,2,83717,83717,83719,0,2,1
23928,3,3,83720,83720,83723,0,3,1
23929,1,1,83721,83723,83724,2,3,0
23930,6,2,83727,83727,83729,0,2,3
23931,3,2,83730,83730,83732,0,2,1
23932,5,3,83735,83735,83738,0,3,3
23933,1,3,83736,83738,83741,2,5,0
23934,6,3,83742,83742,83745,0,3,1
23935,4,2,83746,83746,83748,0,2,1
23936,1,1,83747,83748,83749,1,2,0
23937,3,2,83750,83750,83752,0,2,1
23938,6,3,83756,83756,83759,0,3,4
23939,2,3,83758,83759,83762,1,4,0
23940,1,3,83759,83762,83765,3,6,0
23941,1,3,83760,83765,83768,5,8,0
23942,4,1,83764,83768,83769,4,5,0
23943,6,2,83770,83770,83772,0,2,1
23944,3,2,83773,83773,83775,0,2,1
23945,3,1,83776,83776,83777,0,1,1
23946,4,2,83780,83780,83782,0,2,3
23947,5,3,83785,83785,83788,0,3,3
23948,5,1,83790,83790,83791,0,1,2
23949,5,2,83795,83795,83797,0,2,4
23950,6,1,83801,83801,83802,0,1,4
23951,5,3,83806,83806,83809,0,3,4
23952,2,1,83808,83809,83810,1,2,0
23953,6,3,83814,83814,83817,0,3,4
23954,1,1,83815,83817,83818,2,3,0
23955,4,3,83819,83819,83822,0,3,1
23956,2,2,83821,83822,83824,1,3,0
23957,1,2,83822,83824,83826,2,4,0
23958,6,2,83828,83828,83830,0,2,2
23959,2,1,83830,83830,83831,0,1,0
23960,5,1,83835,83835,83836,0,1,4
23961,5,1,83840,83840,83841,0,1,4
23962,6,3,83846,83846,83849,0,3,5
23963,2,1,83848,83849,83850,1,2,0
23964,1,2,83849,83850,83852,1,3,0
23965,1,2,83850,83852,83854,2,4,0
23966,4,3,83854,83854,83857,0,3,0
23967,1,2,83855,83857,83859,2,4,0
23968,3,3,83858,83859,83862,1,4,0
23969,6,3,83864,83864,83867,0,3,2
23970,5,3,83869,83869,83872,0,3,2
23971,6,2,83875,83875,83877,0,2,3
23972,6,2,83881,83881,83883,0,2,4
23973,6,3,83887,83887,83890,0,3,4
23974,4,2,83891,83891,83893,0,2,1
23975,1,1,83892,83893,83894,1,2,0
23976,6,3,83898,83898,83901,0,3,4
23977,6,2,83904,83904,83906,0,2,3
23978,4,2,83908,83908,83910,0,2,2
23979,1,3,83909,83910,83913,1,4,0
23980,1,1,83910,83913,83914,3,4,0
23981,2,2,83912,83914,83916,2,4,0
23982,2,2,83914,83916,83918,2,4,0
23983,1,1,83915,83918,83919,3,4,0
23984,2,3,83917,83919,83922,2,5,0
23985,2,3,83919,83922,83925,3,6,0
23986,6,1,83925,83925,83926,0,1,0
23987,6,1,83931,83931,83932,0,1,5
23988,6,1,83937,83937,83938,0,1,5
23989,4,2,83941,83941,83943,0,2,3
23990,6,3,83947,83947,83950,0,3,4
23991,4,2,83951,83951,83953,0,2,1
23992,4,2,83955,83955,83957,0,2,2
23993,1,1,83956,83957,83958,1,2,0
23994,6,2,83962,83962,83964,0,2,4
23995,4,3,83966,83966,83969,0,3,2
23996,5,2,83971,83971,83973,0,2,2
23997,2,1,83973,83973,83974,0,1,0
23998,4,3,83977,83977,83980,0,3,3
23999,3,3,83980,83980,83983,0,3,0
24000,4,1,83984,83984,83985,0,1,1
24001,3,2,83987,83987,83989,0,2,2
24002,3,3,83990,83990,83993,0,3,1
24003,4,2,83994,83994,83996,0,2,1
24004,4,1,83998,83998,83999,0,1,2
24005,1,1,83999,83999,84000,0,1,0
24006,2,2,84001,84001,84003,0,2,1
24007,6,1,84007,84007,84008,0,1,4
24008,6,2,84013,84013,84015,0,2,5
24009,4,3,84017,84017,84020,0,3,2
24010,5,1,84022,84022,84023,0,1,2
24011,6,3,84028,84028,84031,0,3,5
24012,4,1,84032,84032,84033,0,1,1
24013,4,2,84036,84036,84038,0,2,3
24014,5,3,84041,84041,84044,0,3,3
24015,4,1,84045,84045,84046,0,1,1
24016,5,1,84050,84050,84051,0,1,4
24017,2,3,84052,84052,84055,0,3,1
24018,1,2,84053,84055,84057,2,4,0
24019,5,2,84058,84058,84060,0,2,1
24020,5,2,84063,84063,84065,0,2,3
24021,6,1,84069,84069,84070,0,1,4
24022,3,3,84072,84072,84075,0,3,2
24023,6,1,84078,84078,84079,0,1,3
24024,6,1,84084,84084,84085,0,1,5
24025,6,2,84090,84090,84092,0,2,5
24026,2,3,84092,84092,84095,0,3,0
24027,4,2,84096,84096,84098,0,2,1
24028,1,1,84097,84098,84099,1,2,0
24029,3,1,84100,84100,84101,0,1,1
24030,6,2,84106,84106,84108,0,2,5
24031,4,3,84110,84110,84113,0,3,2
24032,5,1,84115,84115,84116,0,1,2
24033,4,3,84119,84119,84122,0,3,3
24034,1,3,84120,84122,84125,2,5,0
24035,3,3,84123,84125,84128,2,5,0
24036,1,1,84124,84128,84129,4,5,0
24037,1,2,84125,84129,84131,4,6,0
24038,6,1,84131,84131,84132,0,1,0
24039,5,1,84136,84136,84137,0,1,4
24040,1,1,84137,84137,84138,0,1,0
24041,6,1,84143,84143,84144,0,1,5
24042,3,1,84146,84146,84147,0,1,2
24043,3,3,84149,84149,84152,0,3,2
24044,6,2,84155,84155,84157,0,2,3
24045,1,3,84156,84157,84160,1,4,0
24046,3,1,84159,84160,84161,1,2,0
24047,2,2,84161,84161,84163,0,2,0
24048,1,2,84162,84163,84165,1,3,0
24049,1,2,84163,84165,84167,2,4,0
24050,2,3,84165,84167,84170,2,5,0
24051,6,1,84171,84171,84172,0,1,1
24052,6,3,84177,84177,84180,0,3,5
24053,2,2,84179,84180,84182,1,3,0
24054,1,3,84180,84182,84185,2,5,0
24055,4,2,84184,84185,84187,1,3,0
24056,5,1,84189,84189,84190,0,1,2
24057,1,2,84190,84190,84192,0,2,0
24058,2,1,84192,84192,84193,0,1,0
24059,3,3,84195,84195,84198,0,3,2
24060,4,1,84199,84199,84200,0,1,1
24061,1,1,84200,84200,84201,0,1,0
24062,1,3,84201,84201,84204,0,3,0
24063,1,2,84202,84204,84206,2,4,0
24064,3,1,84205,84206,84207,1,2,0
24065,5,1,84210,84210,84211,0,1,3
24066,3,3,84213,84213,84216,0,3,2
24067,2,2,84215,84216,84218,1,3,0
24068,5,3,84220,84220,84223,0,3,2
24069,3,3,84223,84223,84226,0,3,0
24070,3,1,84226,84226,84227,0,1,0
24071,2,1,84228,84228,84229,0,1,1
24072,5,1,84233,84233,84234,0,1,4
24073,6,3,84239,84239,84242,0,3,5
24074,4,1,84243,84243,84244,0,1,1
24075,4,2,84247,84247,84249,0,2,3
24076,3,1,84250,84250,84251,0,1,1
24077,4,3,84254,84254,84257,0,3,3
24078,4,2,84258,84258,84260,0,2,1
24079,2,2,84260,84260,84262,0,2,0
24080,3,2,84263,84263,84265,0,2,1
24081,6,1,84269,84269,84270,0,1,4
24082,6,3,84275,84275,84278,0,3,5
24083,2,2,84277,84278,84280,1,3,0
24084,1,2,84278,84280,84282,2,4,0
24085,4,1,84282,84282,84283,0,1,0
24086,3,1,84285,84285,84286,0,1,2
24087,6,2,84291,84291,84293,0,2,5
24088,2,3,84293,84293,84296,0,3,0
24089,2,3,84295,84296,84299,1,4,0
24090,4,2,84299,84299,84301,0,2,0
24091,5,1,84304,84304,84305,0,1,3
24092,3,1,84307,84307,84308,0,1,2
24093,3,2,84310,84310,84312,0,2,2
24094,1,3,84311,84312,84315,1,4,0
24095,1,3,84312,84315,84318,3,6,0
24096,4,2,84316,84318,84320,2,4,0
24097,2,1,84318,84320,84321,2,3,0
24098,1,1,84319,84321,84322,2,3,0
24099,2,3,84321,84322,84325,1,4,0
24100,3,1,84324,84325,84326,1,2,0
24101,2,3,84326,84326,84329,0,3,0
24102,4,2,84330,84330,84332,0,2,1
24103,4,3,84334,84334,84337,0,3,2
24104,6,2,84340,84340,84342,0,2,3
24105,4,2,84344,84344,84346,0,2,2
24106,6,1,84350,84350,84351,0,1,4
24107,3,1,84353,84353,84354,0,1,2
24108,3,3,84356,84356,84359,0,3,2
24109,2,2,84358,84359,84361,1,3,0
24110,1,2,84359,84361,84363,2,4,0
24111,4,3,84363,84363,84366,0,3,0
24112,5,2,84368,84368,84370,0,2,2
24113,6,2,84374,84374,84376,0,2,4
24114,3,2,84377,84377,84379,0,2,1
24115,2,1,84379,84379,84380,0,1,0
24116,2,1,84381,84381,84382,0,1,1
24117,2,2,84383,84383,84385,0,2,1
24118,1,1,84384,84385,84386,1,2,0
24119,5,1,84389,84389,84390,0,1,3
24120,2,3,84391,84391,84394,0,3,1
24121,4,2,84395,84395,84397,0,2,1
24122,6,2,84401,84401,84403,0,2,4
24123,2,3,84403,84403,84406,0,3,0
24124,4,3,84407,84407,84410,0,3,1
24125,4,2,84411,84411,84413,0,2,1
24126,2,1,84413,84413,84414,0,1,0
24127,6,3,84419,84419,84422,0,3,5
24128,6,1,84425,84425,84426,0,1,3
24129,4,3,84429,84429,84432,0,3,3
24130,2,2,84431,84432,84434,1,3,0
24131,5,3,84436,84436,84439,0,3,2
24132,6,1,84442,84442,84443,0,1,3
24133,3,3,84445,84445,84448,0,3,2
24134,3,1,84448,84448,84449,0,1,0
24135,5,3,84453,84453,84456,0,3,4
24136,6,3,84459,84459,84462,0,3,3
24137,4,1,84463,84463,84464,0,1,1
24138,4,1,84467,84467,84468,0,1,3
24139,4,3,84471,84471,84474,0,3,3
24140,5,1,84476,84476,84477,0,1,2
24141,6,3,84482,84482,84485,0,3,5
24142,4,3,84486,84486,84489,0,3,1
24143,3,2,84489,84489,84491,0,2,0
24144,5,1,84494,84494,84495,0,1,3
24145,2,1,84496,84496,84497,0,1,1
24146,2,3,84498,84498,84501,0,3,1
24147,3,1,84501,84501,84502,0,1,0
24148,1,1,84502,84502,84503,0,1,0
24149,4,3,84506,84506,84509,0,3,3
24150,4,1,84510,84510,84511,0,1,1
24151,4,1,84514,84514,84515,0,1,3
24152,2,3,84516,84516,84519,0,3,1
24153,5,1,84521,84521,84522,0,1,2
24154,2,2,84523,84523,84525,0,2,1
24155,2,2,84525,84525,84527,0,2,0
24156,6,2,84531,84531,84533,0,2,4
24157,3,1,84534,84534,84535,0,1,1
24158,1,3,84535,84535,84538,0,3,0
24159,1,3,84536,84538,84541,2,5,0
24160,5,2,84541,84541,84543,0,2,0
24161,5,2,84546,84546,84548,0,2,3
24162,5,1,84551,84551,84552,0,1,3
24163,3,1,84554,84554,84555,0,1,2
24164,4,2,84558,84558,84560,0,2,3
24165,5,2,84563,84563,84565,0,2,3
24166,6,3,84569,84569,84572,0,3,4
24167,3,3,84572,84572,84575,0,3,0
24168,1,1,84573,84575,84576,2,3,0
24169,5,2,84578,84578,84580,0,2,2
24170,6,2,84584,84584,84586,0,2,4
24171,2,3,84586,84586,84589,0,3,0
24172,1,1,84587,84589,84590,2,3,0
24173,3,2,84590,84590,84592,0,2,0
24174,2,1,84592,84592,84593,0,1,0
24175,2,1,84594,84594,84595,0,1,1
24176,2,2,84596,84596,84598,0,2,1
24177,3,3,84599,84599,84602,0,3,1
24178,6,1,84605,84605,84606,0,1,3
24179,6,1,84611,84611,84612,0,1,5
24180,1,2,84612,84612,84614,0,2,0
24181,2,3,84614,84614,84617,0,3,0
24182,4,2,84618,84618,84620,0,2,1
24183,5,3,84623,84623,84626,0,3,3
24184,5,1,84628,84628,84629,0,1,2
24185,3,1,84631,84631,84632,0,1,2
24186,4,2,84635,84635,84637,0,2,3
24187,6,1,84641,84641,84642,0,1,4
24188,5,3,84646,84646,84649,0,3,4
24189,4,2,84650,84650,84652,0,2,1
24190,1,1,84651,84652,84653,1,2,0
24191,4,1,84655,84655,84656,0,1,2
24192,5,1,84660,84660,84661,0,1,4
24193,2,3,84662,84662,84665,0,3,1
24194,1,2,84663,84665,84667,2,4,0
24195,6,1,84669,84669,84670,0,1,2
24196,2,2,84671,84671,84673,0,2,1
24197,6,3,84677,84677,84680,0,3,4
24198,6,2,84683,84683,84685,0,2,3
24199,1,1,84684,84685,84686,1,2,0
24200,2,1,84686,84686,84687,0,1,0
24201,3,3,84689,84689,84692,0,3,2
24202,5,3,84694,84694,84697,0,3,2
24203,4,3,84698,84698,84701,0,3,1
24204,5,3,84703,84703,84706,0,3,2
24205,3,2,84706,84706,84708,0,2,0
24206,1,3,84707,84708,84711,1,4,0
24207,5,3,84712,84712,84715,0,3,1
24208,6,3,84718,84718,84721,0,3,3
24209,2,1,84720,84721,84722,1,2,0
24210,5,3,84725,84725,84728,0,3,3
24211,1,2,84726,84728,84730,2,4,0
24212,1,3,84727,84730,84733,3,6,0
24213,5,1,84732,84733,84734,1,2,0
24214,1,3,84733,84734,84737,1,4,0
24215,5,2,84738,84738,84740,0,2,1
24216,5,3,84743,84743,84746,0,3,3
24217,6,3,84749,84749,84752,0,3,3
24218,5,3,84754,84754,84757,0,3,2
24219,3,3,84757,84757,84760,0,3,0
24220,2,1,84759,84760,84761,1,2,0
24221,2,2,84761,84761,84763,0,2,0
24222,5,1,84766,84766,84767,0,1,3
24223,6,3,84772,84772,84775,0,3,5
24224,3,2,84775,84775,84777,0,2,0
24225,6,2,84781,84781,84783,0,2,4
24226,1,1,84782,84783,84784,1,2,0
24227,2,3,84784,84784,84787,0,3,0
24228,4,2,84788,84788,84790,0,2,1
24229,6,2,84794,84794,84796,0,2,4
24230,5,3,84799,84799,84802,0,3,3
24231,4,2,84803,84803,84805,0,2,1
24232,5,3,84808,84808,84811,0,3,3
24233,2,2,84810,84811,84813,1,3,0
24234,6,2,84816,84816,84818,0,2,3
24235,4,1,84820,84820,84821,0,1,2
24236,4,3,84824,84824,84827,0,3,3
24237,3,2,84827,84827,84829,0,2,0
24238,1,3,84828,84829,84832,1,4,0
24239,6,2,84834,84834,84836,0,2,2
24240,5,2,84839,84839,84841,0,2,3
24241,6,3,84845,84845,84848,0,3,4
24242,6,1,84851,84851,84852,0,1,3
24243,1,1,84852,84852,84853,0,1,0
24244,6,2,84858,84858,84860,0,2,5
24245,6,1,84864,84864,84865,0,1,4
24246,4,3,84868,84868,84871,0,3,3
24247,6,2,84874,84874,84876,0,2,3
24248,5,2,84879,84879,84881,0,2,3
24249,2,1,84881,84881,84882,0,1,0
24250,1,1,84882,84882,84883,0,1,0
24251,6,2,84888,84888,84890,0,2,5
24252,2,1,84890,84890,84891,0,1,0
24253,2,3,84892,84892,84895,0,3,1
24254,5,1,84897,84897,84898,0,1,2
24255,3,1,84900,84900,84901,0,1,2
24256,3,1,84903,84903,84904,0,1,2
24257,3,1,84906,84906,84907,0,1,2
24258,6,2,84912,84912,84914,0,2,5
24259,6,3,84918,84918,84921,0,3,4
24260,5,3,84923,84923,84926,0,3,2
24261,4,1,84927,84927,84928,0,1,1
24262,4,1,84931,84931,84932,0,1,3
24263,5,1,84936,84936,84937,0,1,4
24264,4,1,84940,84940,84941,0,1,3
24265,6,2,84946,84946,84948,0,2,5
24266,5,2,84951,84951,84953,0,2,3
24267,4,3,84955,84955,84958,0,3,2
24268,4,2,84959,84959,84961,0,2,1
24269,6,2,84965,84965,84967,0,2,4
24270,4,3,84969,84969,84972,0,3,2
24271,6,3,84975,84975,84978,0,3,3
24272,5,3,84980,84980,84983,0,3,2
24273,1,2,84981,84983,84985,2,4,0
24274,4,2,84985,84985,84987,0,2,0
24275,1,2,84986,84987,84989,1,3,0
24276,6,3,84992,84992,84995,0,3,3
24277,2,1,84994,84995,84996,1,2,0
24278,6,3,85000,85000,85003,0,3,4
24279,2,2,85002,85003,85005,1,3,0
24280,5,2,85007,85007,85009,0,2,2
24281,1,2,85008,85009,85011,1,3,0
24282,4,1,85012,85012,85013,0,1,1
24283,2,2,85014,85014,85016,0,2,1
24284,1,1,85015,85016,85017,1,2,0
24285,3,1,85018,85018,85019,0,1,1
24286,4,1,85022,85022,85023,0,1,3
24287,1,3,85023,85023,85026,0,3,0
24288,3,1,85026,85026,85027,0,1,0
24289,3,3,85029,85029,85032,0,3,2
24290,4,3,85033,85033,85036,0,3,1
24291,2,2,85035,85036,85038,1,3,0
24292,3,1,85038,85038,85039,0,1,0
24293,6,2,85044,85044,85046,0,2,5
24294,3,2,85047,85047,85049,0,2,1
24295,1,2,85048,85049,85051,1,3,0
24296,1,2,85049,85051,85053,2,4,0
24297,4,2,85053,85053,85055,0,2,0
24298,1,2,85054,85055,85057,1,3,0
24299,6,3,85060,85060,85063,0,3,3
24300,2,3,85062,85063,85066,1,4,0
24301,1,2,85063,85066,85068,3,5,0
24302,2,3,85065,85068,85071,3,6,0
24303,2,2,85067,85071,85073,4,6,0
24304,5,2,85072,85073,85075,1,3,0
24305,1,1,85073,85075,85076,2,3,0
24306,5,1,85078,85078,85079,0,1,2
24307,6,2,85084,85084,85086,0,2,5
24308,5,1,85089,85089,85090,0,1,3
24309,5,3,85094,85094,85097,0,3,4
24310,1,3,85095,85097,85100,2,5,0
24311,4,1,85099,85100,85101,1,2,0
24312,1,2,85100,85101,85103,1,3,0
24313,1,2,85101,85103,85105,2,4,0
24314,3,3,85104,85105,85108,1,4,0
24315,5,2,85109,85109,85111,0,2,1
24316,3,1,85112,85112,85113,0,1,1
24317,5,1,85117,85117,85118,0,1,4
24318,3,1,85120,85120,85121,0,1,2
24319,5,2,85125,85125,85127,0,2,4
24320,2,1,85127,85127,85128,0,1,0
24321,3,3,85130,85130,85133,0,3,2
24322,1,2,85131,85133,85135,2,4,0
24323,2,2,85133,85135,85137,2,4,0
24324,5,2,85138,85138,85140,0,2,1
24325,2,3,85140,85140,85143,0,3,0
24326,4,2,85144,85144,85146,0,2,1
24327,6,1,85150,85150,85151,0,1,4
24328,4,2,85154,85154,85156,0,2,3
24329,4,1,85158,85158,85159,0,1,2
24330,6,2,85164,85164,85166,0,2,5
24331,1,2,85165,85166,85168,1,3,0
24332,4,2,85169,85169,85171,0,2,1
24333,1,3,85170,85171,85174,1,4,0
24334,4,1,85174,85174,85175,0,1,0
24335,6,1,85180,85180,85181,0,1,5
24336,1,2,85181,85181,85183,0,2,0
24337,6,2,85187,85187,85189,0,2,4
24338,1,3,85188,85189,85192,1,4,0
24339,2,3,85190,85192,85195,2,5,0
24340,5,2,85195,85195,85197,0,2,0
24341,3,2,85198,85198,85200,0,2,1
24342,5,2,85203,85203,85205,0,2,3
24343,2,2,85205,85205,85207,0,2,0
24344,4,3,85209,85209,85212,0,3,2
24345,3,1,85212,85212,85213,0,1,0
24346,3,2,85215,85215,85217,0,2,2
24347,2,2,85217,85217,85219,0,2,0
24348,2,1,85219,85219,85220,0,1,0
24349,3,2,85222,85222,85224,0,2,2
24350,4,2,85226,85226,85228,0,2,2
24351,4,3,85230,85230,85233,0,3,2
24352,6,3,85236,85236,85239,0,3,3
24353,5,3,85241,85241,85244,0,3,2
24354,4,1,85245,85245,85246,0,1,1
24355,4,2,85249,85249,85251,0,2,3
24356,6,1,85255,85255,85256,0,1,4
24357,5,3,85260,85260,85263,0,3,4
24358,6,3,85266,85266,85269,0,3,3
24359,2,2,85268,85269,85271,1,3,0
24360,5,2,85273,85273,85275,0,2,2
24361,2,1,85275,85275,85276,0,1,0
24362,3,3,85278,85278,85281,0,3,2
24363,5,1,85283,85283,85284,0,1,2
24364,3,2,85286,85286,85288,0,2,2
24365,2,3,85288,85288,85291,0,3,0
24366,6,1,85294,85294,85295,0,1,3
24367,2,3,85296,85296,85299,0,3,1
24368,4,3,85300,85300,85303,0,3,1
24369,6,2,85306,85306,85308,0,2,3
24370,4,2,85310,85310,85312,0,2,2
24371,4,3,85314,85314,85317,0,3,2
24372,5,1,85319,85319,85320,0,1,2
24373,3,3,85322,85322,85325,0,3,2
24374,4,3,85326,85326,85329,0,3,1
24375,2,2,85328,85329,85331,1,3,0
24376,1,1,85329,85331,85332,2,3,0
24377,5,1,85334,85334,85335,0,1,2
24378,4,2,85338,85338,85340,0,2,3
24379,1,3,85339,85340,85343,1,4,0
24380,1,2,85340,85343,85345,3,5,0
24381,3,3,85343,85345,85348,2,5,0
24382,5,3,85348,85348,85351,0,3,0
24383,5,1,85353,85353,85354,0,1,2
24384,6,1,85359,85359,85360,0,1,5
24385,4,2,85363,85363,85365,0,2,3
24386,1,3,85364,85365,85368,1,4,0
24387,2,2,85366,85368,85370,2,4,0
24388,5,1,85371,85371,85372,0,1,1
24389,6,3,85377,85377,85380,0,3,5
24390,3,1,85380,85380,85381,0,1,0
24391,3,2,85383,85383,85385,0,2,2
24392,3,3,85386,85386,85389,0,3,1
24393,1,2,85387,85389,85391,2,4,0
24394,3,1,85390,85391,85392,1,2,0
24395,2,3,85392,85392,85395,0,3,0
24396,3,1,85395,85395,85396,0,1,0
24397,5,3,85400,85400,85403,0,3,4
24398,4,2,85404,85404,85406,0,2,1
24399,5,1,85409,85409,85410,0,1,3
24400,6,1,85415,85415,85416,0,1,5
24401,6,1,85421,85421,85422,0,1,5
24402,5,3,85426,85426,85429,0,3,4
24403,6,3,85432,85432,85435,0,3,3
24404,1,2,85433,85435,85437,2,4,0
24405,3,2,85436,85437,85439,1,3,0
24406,1,1,85437,85439,85440,2,3,0
24407,6,3,85443,85443,85446,0,3,3
24408,4,3,85447,85447,85450,0,3,1
24409,6,2,85453,85453,85455,0,2,3
24410,5,3,85458,85458,85461,0,3,3
24411,6,2,85464,85464,85466,0,2,3
24412,2,3,85466,85466,85469,0,3,0
24413,1,1,85467,85469,85470,2,3,0
24414,6,3,85473,85473,85476,0,3,3
24415,2,1,85475,85476,85477,1,2,0
24416,4,3,85479,85479,85482,0,3,2
24417,5,1,85484,85484,85485,0,1,2
24418,2,1,85486,85486,85487,0,1,1
24419,4,3,85490,85490,85493,0,3,3
24420,1,2,85491,85493,85495,2,4,0
24421,1,2,85492,85495,85497,3,5,0
24422,1,2,85493,85497,85499,4,6,0
24423,5,3,85498,85499,85502,1,4,0
24424,3,3,85501,85502,85505,1,4,0
24425,4,3,85505,85505,85508,0,3,0
24426,5,1,85510,85510,85511,0,1,2
24427,2,3,85512,85512,85515,0,3,1
24428,4,1,85516,85516,85517,0,1,1
24429,6,2,85522,85522,85524,0,2,5
24430,6,1,85528,85528,85529,0,1,4
24431,6,2,85534,85534,85536,0,2,5
24432,5,3,85539,85539,85542,0,3,3
24433,4,1,85543,85543,85544,0,1,1
24434,3,3,85546,85546,85549,0,3,2
24435,6,3,85552,85552,85555,0,3,3
24436,3,3,85555,85555,85558,0,3,0
24437,4,1,85559,85559,85560,0,1,1
24438,4,3,85563,85563,85566,0,3,3
24439,3,3,85566,85566,85569,0,3,0
24440,5,3,85571,85571,85574,0,3,2
24441,6,3,85577,85577,85580,0,3,3
24442,5,1,85582,85582,85583,0,1,2
24443,4,3,85586,85586,85589,0,3,3
24444,5,3,85591,85591,85594,0,3,2
24445,3,2,85594,85594,85596,0,2,0
24446,3,2,85597,85597,85599,0,2,1
24447,2,3,85599,85599,85602,0,3,0
24448,6,3,85605,85605,85608,0,3,3
24449,3,1,85608,85608,85609,0,1,0
24450,4,3,85612,85612,85615,0,3,3
24451,3,1,85615,85615,85616,0,1,0
24452,1,1,85616,85616,85617,0,1,0
24453,3,2,85619,85619,85621,0,2,2
24454,4,2,85623,85623,85625,0,2,2
24455,6,3,85629,85629,85632,0,3,4
24456,4,2,85633,85633,85635,0,2,1
24457,5,1,85638,85638,85639,0,1,3
24458,4,2,85642,85642,85644,0,2,3
24459,3,3,85645,85645,85648,0,3,1
24460,3,3,85648,85648,85651,0,3,0
24461,2,3,85650,85651,85654,1,4,0
24462,5,2,85655,85655,85657,0,2,1
24463,1,1,85656,85657,85658,1,2,0
24464,3,1,85659,85659,85660,0,1,1
24465,6,2,85665,85665,85667,0,2,5
24466,1,1,85666,85667,85668,1,2,0
24467,4,2,85670,85670,85672,0,2,2
24468,4,2,85674,85674,85676,0,2,2
24469,6,1,85680,85680,85681,0,1,4
24470,5,1,85685,85685,85686,0,1,4
24471,6,1,85691,85691,85692,0,1,5
24472,2,3,85693,85693,85696,0,3,1
24473,6,1,85699,85699,85700,0,1,3
24474,5,3,85704,85704,85707,0,3,4
24475,6,1,85710,85710,85711,0,1,3
24476,6,2,85716,85716,85718,0,2,5
24477,2,2,85718,85718,85720,0,2,0
24478,1,3,85719,85720,85723,1,4,0
24479,4,2,85723,85723,85725,0,2,0
24480,2,3,85725,85725,85728,0,3,0
24481,2,1,85727,85728,85729,1,2,0
24482,4,2,85731,85731,85733,0,2,2
24483,2,1,85733,85733,85734,0,1,0
24484,3,2,85736,85736,85738,0,2,2
24485,4,3,85740,85740,85743,0,3,2
24486,2,3,85742,85743,85746,1,4,0
24487,3,2,85745,85746,85748,1,3,0
24488,3,2,85748,85748,85750,0,2,0
24489,3,3,85751,85751,85754,0,3,1
24490,2,1,85753,85754,85755,1,2,0
24491,2,2,85755,85755,85757,0,2,0
24492,5,3,85760,85760,85763,0,3,3
24493,6,3,85766,85766,85769,0,3,3
24494,4,3,85770,85770,85773,0,3,1
24495,1,3,85771,85773,85776,2,5,0
24496,3,1,85774,85776,85777,2,3,0
24497,4,1,85778,85778,85779,0,1,1
24498,3,1,85781,85781,85782,0,1,2
24499,3,2,85784,85784,85786,0,2,2
24500,2,3,85786,85786,85789,0,3,0
24501,2,2,85788,85789,85791,1,3,0
24502,4,1,85792,85792,85793,0,1,1
24503,4,1,85796,85796,85797,0,1,3
24504,3,3,85799,85799,85802,0,3,2
24505,4,1,85803,85803,85804,0,1,1
24506,5,1,85808,85808,85809,0,1,4
24507,1,3,85809,85809,85812,0,3,0
24508,5,1,85814,85814,85815,0,1,2
24509,3,1,85817,85817,85818,0,1,2
24510,2,1,85819,85819,85820,0,1,1
24511,4,1,85823,85823,85824,0,1,3
24512,3,2,85826,85826,85828,0,2,2
24513,2,2,85828,85828,85830,0,2,0
24514,5,3,85833,85833,85836,0,3,3
24515,1,2,85834,85836,85838,2,4,0
24516,4,3,85838,85838,85841,0,3,0
24517,4,1,85842,85842,85843,0,1,1
24518,3,3,85845,85845,85848,0,3,2
24519,1,2,85846,85848,85850,2,4,0
24520,3,3,85849,85850,85853,1,4,0
24521,3,2,85852,85853,85855,1,3,0
24522,3,3,85855,85855,85858,0,3,0
24523,5,1,85860,85860,85861,0,1,2
24524,3,3,85863,85863,85866,0,3,2
24525,3,1,85866,85866,85867,0,1,0
24526,6,3,85872,85872,85875,0,3,5
24527,6,3,85878,85878,85881,0,3,3
24528,6,2,85884,85884,85886,0,2,3
24529,3,1,85887,85887,85888,0,1,1
24530,4,2,85891,85891,85893,0,2,3
24531,6,1,85897,85897,85898,0,1,4
24532,4,2,85901,85901,85903,0,2,3
24533,3,2,85904,85904,85906,0,2,1
24534,6,1,85910,85910,85911,0,1,4
24535,5,2,85915,85915,85917,0,2,4
24536,4,3,85919,85919,85922,0,3,2
24537,3,1,85922,85922,85923,0,1,0
24538,4,2,85926,85926,85928,0,2,3
24539,6,3,85932,85932,85935,0,3,4
24540,6,1,85938,85938,85939,0,1,3
24541,1,1,85939,85939,85940,0,1,0
24542,4,3,85943,85943,85946,0,3,3
24543,6,1,85949,85949,85950,0,1,3
24544,1,2,85950,85950,85952,0,2,0
24545,5,1,85955,85955,85956,0,1,3
24546,1,3,85956,85956,85959,0,3,0
24547,5,2,85961,85961,85963,0,2,2
24548,3,3,85964,85964,85967,0,3,1
24549,6,3,85970,85970,85973,0,3,3
24550,6,2,85976,85976,85978,0,2,3
24551,5,3,85981,85981,85984,0,3,3
24552,4,2,85985,85985,85987,0,2,1
24553,5,2,85990,85990,85992,0,2,3
24554,2,3,85992,85992,85995,0,3,0
24555,5,3,85997,85997,86000,0,3,2
24556,3,3,86000,86000,86003,0,3,0
24557,1,1,86001,86003,86004,2,3,0
24558,2,2,86003,86004,86006,1,3,0
24559,6,2,86009,86009,86011,0,2,3
24560,3,1,86012,86012,86013,0,1,1
24561,5,2,86017,86017,86019,0,2,4
24562,2,1,86019,86019,86020,0,1,0
24563,2,2,86021,86021,86023,0,2,1
24564,1,3,86022,86023,86026,1,4,0
24565,3,2,86025,86026,86028,1,3,0
24566,5,3,86030,86030,86033,0,3,2
24567,5,1,86035,86035,86036,0,1,2
24568,3,1,86038,86038,86039,0,1,2
24569,3,3,86041,86041,86044,0,3,2
24570,4,3,86045,86045,86048,0,3,1
24571,1,1,86046,86048,86049,2,3,0
24572,6,3,86052,86052,86055,0,3,3
24573,2,2,86054,86055,86057,1,3,0
24574,4,2,86058,86058,86060,0,2,1
24575,2,1,86060,86060,86061,0,1,0
24576,5,3,86065,86065,86068,0,3,4
24577,3,3,86068,86068,86071,0,3,0
24578,5,3,86073,86073,86076,0,3,2
24579,1,3,86074,86076,86079,2,5,0
24580,3,2,86077,86079,86081,2,4,0
24581,4,1,86081,86081,86082,0,1,0
24582,1,1,86082,86082,86083,0,1,0
24583,6,3,86088,86088,86091,0,3,5
24584,3,1,86091,86091,86092,0,1,0
24585,4,3,86095,86095,86098,0,3,3
24586,2,3,86097,86098,86101,1,4,0
24587,5,1,86102,86102,86103,0,1,1
24588,4,1,86106,86106,86107,0,1,3
24589,4,1,86110,86110,86111,0,1,3
24590,4,2,86114,86114,86116,0,2,3
24591,4,3,86118,86118,86121,0,3,2
24592,3,2,86121,86121,86123,0,2,0
24593,3,1,86124,86124,86125,0,1,1
24594,5,1,86129,86129,86130,0,1,4
24595,6,1,86135,86135,86136,0,1,5
24596,5,3,86140,86140,86143,0,3,4
24597,5,1,86145,86145,86146,0,1,2
24598,2,3,86147,86147,86150,0,3,1
24599,6,3,86153,86153,86156,0,3,3
24600,4,2,86157,86157,86159,0,2,1
24601,1,1,86158,86159,86160,1,2,0
24602,3,3,86161,86161,86164,0,3,1
24603,4,1,86165,86165,86166,0,1,1
24604,1,1,86166,86166,86167,0,1,0
24605,1,2,86167,86167,86169,0,2,0
24606,3,1,86170,86170,86171,0,1,1
24607,4,3,86174,86174,86177,0,3,3
24608,3,2,86177,86177,86179,0,2,0
24609,3,3,86180,86180,86183,0,3,1
24610,4,3,86184,86184,86187,0,3,1
24611,2,3,86186,86187,86190,1,4,0
24612,5,2,86191,86191,86193,0,2,1
24613,5,3,86196,86196,86199,0,3,3
24614,2,2,86198,86199,86201,1,3,0
24615,5,2,86203,86203,86205,0,2,2
24616,1,3,86204,86205,86208,1,4,0
24617,1,1,86205,86208,86209,3,4,0
24618,4,3,86209,86209,86212,0,3,0
24619,4,3,86213,86213,86216,0,3,1
24620,2,1,86215,86216,86217,1,2,0
24621,3,1,86218,86218,86219,0,1,1
24622,2,1,86220,86220,86221,0,1,1
24623,4,2,86224,86224,86226,0,2,3
24624,3,1,86227,86227,86228,0,1,1
24625,2,3,86229,86229,86232,0,3,1
24626,3,1,86232,86232,86233,0,1,0
24627,1,3,86233,86233,86236,0,3,0
24628,6,2,86239,86239,86241,0,2,3
24629,6,3,86245,86245,86248,0,3,4
24630,4,3,86249,86249,86252,0,3,1
24631,4,1,86253,86253,86254,0,1,1
24632,4,2,86257,86257,86259,0,2,3
24633,5,1,86262,86262,86263,0,1,3
24634,3,3,86265,86265,86268,0,3,2
24635,2,3,86267,86268,86271,1,4,0
24636,3,2,86270,86271,86273,1,3,0
24637,4,1,86274,86274,86275,0,1,1
24638,4,2,86278,86278,86280,0,2,3
24639,3,3,86281,86281,86284,0,3,1
24640,4,1,86285,86285,86286,0,1,1
24641,3,3,86288,86288,86291,0,3,2
24642,3,1,86291,86291,86292,0,1,0
24643,1,1,86292,86292,86293,0,1,0
24644,1,2,86293,86293,86295,0,2,0
24645,4,2,86297,86297,86299,0,2,2
24646,2,3,86299,86299,86302,0,3,0
24647,1,2,86300,86302,86304,2,4,0
24648,5,3,86305,86305,86308,0,3,1
24649,6,3,86311,86311,86314,0,3,3
24650,5,1,86316,86316,86317,0,1,2
24651,2,2,86318,86318,86320,0,2,1
24652,4,3,86322,86322,86325,0,3,2
24653,4,2,86326,86326,86328,0,2,1
24654,5,3,86331,86331,86334,0,3,3
24655,3,2,86334,86334,86336,0,2,0
24656,2,3,86336,86336,86339,0,3,0
24657,1,3,86337,86339,86342,2,5,0
24658,2,2,86339,86342,86344,3,5,0
24659,1,3,86340,86344,86347,4,7,0
24660,3,1,86343,86347,86348,4,5,0
24661,6,2,86349,86349,86351,0,2,1
24662,2,3,86351,86351,86354,0,3,0
24663,3,2,86354,86354,86356,0,2,0
24664,6,1,86360,86360,86361,0,1,4
24665,1,2,86361,86361,86363,0,2,0
24666,4,1,86365,86365,86366,0,1,2
24667,4,2,86369,86369,86371,0,2,3
24668,4,1,86373,86373,86374,0,1,2
24669,3,1,86376,86376,86377,0,1,2
24670,4,1,86380,86380,86381,0,1,3
24671,1,2,86381,86381,86383,0,2,0
24672,6,1,86387,86387,86388,0,1,4
24673,5,1,86392,86392,86393,0,1,4
24674,5,1,86397,86397,86398,0,1,4
24675,4,3,86401,86401,86404,0,3,3
24676,3,2,86404,86404,86406,0,2,0
24677,1,2,86405,86406,86408,1,3,0
24678,6,3,86411,86411,86414,0,3,3
24679,6,2,86417,86417,86419,0,2,3
24680,4,3,86421,86421,86424,0,3,2
24681,2,3,86423,86424,86427,1,4,0
24682,5,3,86428,86428,86431,0,3,1
24683,2,3,86430,86431,86434,1,4,0
24684,1,3,86431,86434,86437,3,6,0
24685,6,3,86437,86437,86440,0,3,0
24686,3,3,86440,86440,86443,0,3,0
24687,1,1,86441,86443,86444,2,3,0
24688,6,1,86447,86447,86448,0,1,3
24689,5,1,86452,86452,86453,0,1,4
24690,5,3,86457,86457,86460,0,3,4
24691,6,2,86463,86463,86465,0,2,3
24692,2,3,86465,86465,86468,0,3,0
24693,6,3,86471,86471,86474,0,3,3
24694,2,1,86473,86474,86475,1,2,0
24695,3,1,86476,86476,86477,0,1,1
24696,3,3,86479,86479,86482,0,3,2
24697,3,1,86482,86482,86483,0,1,0
24698,1,1,86483,86483,86484,0,1,0
24699,6,3,86489,86489,86492,0,3,5
24700,6,3,86495,86495,86498,0,3,3
24701,2,1,86497,86498,86499,1,2,0
24702,1,2,86498,86499,86501,1,3,0
24703,5,2,86503,86503,86505,0,2,2
24704,4,3,86507,86507,86510,0,3,2
24705,1,1,86508,86510,86511,2,3,0
24706,3,3,86511,86511,86514,0,3,0
24707,3,2,86514,86514,86516,0,2,0
24708,2,2,86516,86516,86518,0,2,0
24709,4,3,86520,86520,86523,0,3,2
24710,4,2,86524,86524,86526,0,2,1
24711,1,2,86525,86526,86528,1,3,0
24712,2,1,86527,86528,86529,1,2,0
24713,5,3,86532,86532,86535,0,3,3
24714,4,2,86536,86536,86538,0,2,1
24715,1,1,86537,86538,86539,1,2,0
24716,1,2,86538,86539,86541,1,3,0
24717,2,1,86540,86541,86542,1,2,0
24718,6,3,86546,86546,86549,0,3,4
24719,4,2,86550,86550,86552,0,2,1
24720,4,1,86554,86554,86555,0,1,2
24721,4,2,86558,86558,86560,0,2,3
24722,6,2,86564,86564,86566,0,2,4
24723,3,3,86567,86567,86570,0,3,1
24724,2,3,86569,86570,86573,1,4,0
24725,2,3,86571,86573,86576,2,5,0
24726,2,2,86573,86576,86578,3,5,0
24727,2,3,86575,86578,86581,3,6,0
24728,3,1,86578,86581,86582,3,4,0
24729,1,1,86579,86582,86583,3,4,0
24730,2,3,86581,86583,86586,2,5,0
24731,6,1,86587,86587,86588,0,1,1
24732,6,2,86593,86593,86595,0,2,5
24733,6,1,86599,86599,86600,0,1,4
24734,6,1,86605,86605,86606,0,1,5
24735,1,2,86606,86606,86608,0,2,0
24736,3,2,86609,86609,86611,0,2,1
24737,5,3,86614,86614,86617,0,3,3
24738,6,1,86620,86620,86621,0,1,3
24739,6,3,86626,86626,86629,0,3,5
24740,2,3,86628,86629,86632,1,4,0
24741,6,2,86634,86634,86636,0,2,2
24742,3,3,86637,86637,86640,0,3,1
24743,3,3,86640,86640,86643,0,3,0
24744,6,2,86646,86646,86648,0,2,3
24745,6,1,86652,86652,86653,0,1,4
24746,5,3,86657,86657,86660,0,3,4
24747,2,2,86659,86660,86662,1,3,0
24748,3,1,86662,86662,86663,0,1,0
24749,4,2,86666,86666,86668,0,2,3
24750,3,1,86669,86669,86670,0,1,1
24751,3,1,86672,86672,86673,0,1,2
24752,5,1,86677,86677,86678,0,1,4
24753,2,3,86679,86679,86682,0,3,1
24754,2,1,86681,86682,86683,1,2,0
24755,6,2,86687,86687,86689,0,2,4
24756,2,1,86689,86689,86690,0,1,0
24757,5,3,86694,86694,86697,0,3,4
24758,1,1,86695,86697,86698,2,3,0
24759,4,1,86699,86699,86700,0,1,1
24760,3,3,86702,86702,86705,0,3,2
24761,4,3,86706,86706,86709,0,3,1
24762,3,1,86709,86709,86710,0,1,0
24763,5,1,86714,86714,86715,0,1,4
24764,3,2,86717,86717,86719,0,2,2
24765,5,2,86722,86722,86724,0,2,3
24766,5,2,86727,86727,86729,0,2,3
24767,4,1,86731,86731,86732,0,1,2
24768,2,2,86733,86733,86735,0,2,1
24769,1,3,86734,86735,86738,1,4,0
24770,4,2,86738,86738,86740,0,2,0
24771,5,1,86743,86743,86744,0,1,3
24772,1,1,86744,86744,86745,0,1,0
24773,2,1,86746,86746,86747,0,1,1
24774,5,2,86751,86751,86753,0,2,4
24775,6,2,86757,86757,86759,0,2,4
24776,3,2,86760,86760,86762,0,2,1
24777,6,3,86766,86766,86769,0,3,4
24778,4,3,86770,86770,86773,0,3,1
24779,3,2,86773,86773,86775,0,2,0
24780,5,1,86778,86778,86779,0,1,3
24781,6,1,86784,86784,86785,0,1,5
24782,4,3,86788,86788,86791,0,3,3
24783,5,1,86793,86793,86794,0,1,2
24784,1,2,86794,86794,86796,0,2,0
24785,5,3,86799,86799,86802,0,3,3
24786,3,1,86802,86802,86803,0,1,0
24787,1,2,86803,86803,86805,0,2,0
24788,4,3,86807,86807,86810,0,3,2
24789,1,2,86808,86810,86812,2,4,0
24790,2,2,86810,86812,86814,2,4,0
24791,6,1,86816,86816,86817,0,1,2
24792,2,1,86818,86818,86819,0,1,1
24793,2,1,86820,86820,86821,0,1,1
24794,2,2,86822,86822,86824,0,2,1
24795,5,1,86827,86827,86828,0,1,3
24796,4,2,86831,86831,86833,0,2,3
24797,3,2,86834,86834,86836,0,2,1
24798,2,1,86836,86836,86837,0,1,0
24799,5,1,86841,86841,86842,0,1,4
24800,2,1,86843,86843,86844,0,1,1
24801,5,1,86848,86848,86849,0,1,4
24802,5,3,86853,86853,86856,0,3,4
24803,1,3,86854,86856,86859,2,5,0
24804,3,3,86857,86859,86862,2,5,0
24805,5,2,86862,86862,86864,0,2,0
24806,4,2,86866,86866,86868,0,2,2
24807,5,3,86871,86871,86874,0,3,3
24808,1,3,86872,86874,86877,2,5,0
24809,5,2,86877,86877,86879,0,2,0
24810,4,1,86881,86881,86882,0,1,2
24811,2,2,86883,86883,86885,0,2,1
24812,2,2,86885,86885,86887,0,2,0
24813,1,1,86886,86887,86888,1,2,0
24814,2,3,86888,86888,86891,0,3,0
24815,6,2,86894,86894,86896,0,2,3
24816,3,3,86897,86897,86900,0,3,1
24817,1,3,86898,86900,86903,2,5,0
24818,2,3,86900,86903,86906,3,6,0
24819,4,2,86904,86906,86908,2,4,0
24820,4,2,86908,86908,86910,0,2,0
24821,5,2,86913,86913,86915,0,2,3
24822,6,2,86919,86919,86921,0,2,4
24823,4,2,86923,86923,86925,0,2,2
24824,5,3,86928,86928,86931,0,3,3
24825,5,2,86933,86933,86935,0,2,2
24826,6,1,86939,86939,86940,0,1,4
24827,1,2,86940,86940,86942,0,2,0
24828,4,2,86944,86944,86946,0,2,2
24829,4,1,86948,86948,86949,0,1,2
24830,5,3,86953,86953,86956,0,3,4
24831,2,2,86955,86956,86958,1,3,0
24832,3,1,86958,86958,86959,0,1,0
24833,5,1,86963,86963,86964,0,1,4
24834,6,2,86969,86969,86971,0,2,5
24835,5,2,86974,86974,86976,0,2,3
24836,1,3,86975,86976,86979,1,4,0
24837,6,3,86981,86981,86984,0,3,2
24838,2,3,86983,86984,86987,1,4,0
24839,4,2,86987,86987,86989,0,2,0
24840,1,3,86988,86989,86992,1,4,0
24841,4,2,86992,86992,86994,0,2,0
24842,2,2,86994,86994,86996,0,2,0
24843,1,1,86995,86996,86997,1,2,0
24844,3,1,86998,86998,86999,0,1,1
24845,4,3,87002,87002,87005,0,3,3
24846,6,1,87008,87008,87009,0,1,3
24847,1,1,87009,87009,87010,0,1,0
24848,1,3,87010,87010,87013,0,3,0
24849,6,2,87016,87016,87018,0,2,3
24850,5,2,87021,87021,87023,0,2,3
24851,5,2,87026,87026,87028,0,2,3
24852,2,1,87028,87028,87029,0,1,0
24853,5,2,87033,87033,87035,0,2,4
24854,2,3,87035,87035,87038,0,3,0
24855,2,3,87037,87038,87041,1,4,0
24856,2,3,87039,87041,87044,2,5,0
24857,6,2,87045,87045,87047,0,2,1
24858,3,2,87048,87048,87050,0,2,1
24859,4,1,87052,87052,87053,0,1,2
24860,2,1,87054,87054,87055,0,1,1
24861,1,2,87055,87055,87057,0,2,0
24862,5,2,87060,87060,87062,0,2,3
24863,4,3,87064,87064,87067,0,3,2
24864,5,2,87069,87069,87071,0,2,2
24865,3,3,87072,87072,87075,0,3,1
24866,6,2,87078,87078,87080,0,2,3
24867,3,1,87081,87081,87082,0,1,1
24868,5,2,87086,87086,87088,0,2,4
24869,4,1,87090,87090,87091,0,1,2
24870,1,2,87091,87091,87093,0,2,0
24871,6,1,87097,87097,87098,0,1,4
24872,2,3,87099,87099,87102,0,3,1
24873,1,1,87100,87102,87103,2,3,0
24874,4,2,87104,87104,87106,0,2,1
24875,3,2,87107,87107,87109,0,2,1
24876,4,2,87111,87111,87113,0,2,2
24877,1,3,87112,87113,87116,1,4,0
24878,5,3,87117,87117,87120,0,3,1
24879,1,3,87118,87120,87123,2,5,0
24880,3,2,87121,87123,87125,2,4,0
24881,3,1,87124,87125,87126,1,2,0
24882,4,2,87128,87128,87130,0,2,2
24883,3,2,87131,87131,87133,0,2,1
24884,1,1,87132,87133,87134,1,2,0
24885,5,3,87137,87137,87140,0,3,3
24886,3,3,87140,87140,87143,0,3,0
24887,3,2,87143,87143,87145,0,2,0
24888,4,3,87147,87147,87150,0,3,2
24889,5,3,87152,87152,87155,0,3,2
24890,2,1,87154,87155,87156,1,2,0
24891,6,2,87160,87160,87162,0,2,4
24892,1,1,87161,87162,87163,1,2,0
24893,3,3,87164,87164,87167,0,3,1
24894,6,2,87170,87170,87172,0,2,3
24895,4,1,87174,87174,87175,0,1,2
24896,4,3,87178,87178,87181,0,3,3
24897,6,3,87184,87184,87187,0,3,3
24898,5,2,87189,87189,87191,0,2,2
24899,3,1,87192,87192,87193,0,1,1
24900,2,1,87194,87194,87195,0,1,1
24901,2,2,87196,87196,87198,0,2,1
24902,1,3,87197,87198,87201,1,4,0
24903,4,3,87201,87201,87204,0,3,0
24904,5,3,87206,87206,87209,0,3,2
24905,5,3,87211,87211,87214,0,3,2
24906,4,2,87215,87215,87217,0,2,1
24907,5,2,87220,87220,87222,0,2,3
24908,2,2,87222,87222,87224,0,2,0
24909,6,3,87228,87228,87231,0,3,4
24910,3,1,87231,87231,87232,0,1,0
24911,1,3,87232,87232,87235,0,3,0
24912,6,1,87238,87238,87239,0,1,3
24913,3,3,87241,87241,87244,0,3,2
24914,1,2,87242,87244,87246,2,4,0
24915,6,3,87248,87248,87251,0,3,2
24916,3,2,87251,87251,87253,0,2,0
24917,2,3,87253,87253,87256,0,3,0
24918,6,3,87259,87259,87262,0,3,3
24919,3,3,87262,87262,87265,0,3,0
24920,4,2,87266,87266,87268,0,2,1
24921,5,1,87271,87271,87272,0,1,3
24922,4,3,87275,87275,87278,0,3,3
24923,4,1,87279,87279,87280,0,1,1
24924,2,3,87281,87281,87284,0,3,1
24925,5,1,87286,87286,87287,0,1,2
24926,1,1,87287,87287,87288,0,1,0
24927,5,1,87292,87292,87293,0,1,4
24928,4,3,87296,87296,87299,0,3,3
24929,6,2,87302,87302,87304,0,2,3
24930,5,3,87307,87307,87310,0,3,3
24931,4,2,87311,87311,87313,0,2,1
24932,6,1,87317,87317,87318,0,1,4
24933,6,1,87323,87323,87324,0,1,5
24934,4,3,87327,87327,87330,0,3,3
24935,6,1,87333,87333,87334,0,1,3
24936,6,2,87339,87339,87341,0,2,5
24937,6,1,87345,87345,87346,0,1,4
24938,3,1,87348,87348,87349,0,1,2
24939,3,2,87351,87351,87353,0,2,2
24940,5,1,87356,87356,87357,0,1,3
24941,5,1,87361,87361,87362,0,1,4
24942,6,1,87367,87367,87368,0,1,5
24943,2,1,87369,87369,87370,0,1,1
24944,6,2,87375,87375,87377,0,2,5
24945,5,1,87380,87380,87381,0,1,3
24946,5,3,87385,87385,87388,0,3,4
24947,6,2,87391,87391,87393,0,2,3
24948,6,2,87397,87397,87399,0,2,4
24949,6,1,87403,87403,87404,0,1,4
24950,6,1,87409,87409,87410,0,1,5
24951,1,3,87410,87410,87413,0,3,0
24952,6,2,87416,87416,87418,0,2,3
24953,5,2,87421,87421,87423,0,2,3
24954,5,3,87426,87426,87429,0,3,3
24955,6,2,87432,87432,87434,0,2,3
24956,2,3,87434,87434,87437,0,3,0
24957,3,3,87437,87437,87440,0,3,0
24958,3,1,87440,87440,87441,0,1,0
24959,4,3,87444,87444,87447,0,3,3
24960,4,2,87448,87448,87450,0,2,1
24961,4,3,87452,87452,87455,0,3,2
24962,4,3,87456,87456,87459,0,3,1
24963,4,2,87460,87460,87462,0,2,1
24964,2,2,87462,87462,87464,0,2,0
24965,6,3,87468,87468,87471,0,3,4
24966,1,1,87469,87471,87472,2,3,0
24967,6,1,87475,87475,87476,0,1,3
24968,1,2,87476,87476,87478,0,2,0
24969,6,2,87482,87482,87484,0,2,4
24970,3,2,87485,87485,87487,0,2,1
24971,3,3,87488,87488,87491,0,3,1
24972,1,3,87489,87491,87494,2,5,0
24973,2,2,87491,87494,87496,3,5,0
24974,4,2,87495,87496,87498,1,3,0
24975,3,2,87498,87498,87500,0,2,0
24976,2,1,87500,87500,87501,0,1,0
24977,3,2,87503,87503,87505,0,2,2
24978,2,1,87505,87505,87506,0,1,0
24979,4,1,87509,87509,87510,0,1,3
24980,2,2,87511,87511,87513,0,2,1
24981,5,2,87516,87516,87518,0,2,3
24982,1,2,87517,87518,87520,1,3,0
24983,5,1,87522,87522,87523,0,1,2
24984,5,1,87527,87527,87528,0,1,4
24985,1,2,87528,87528,87530,0,2,0
24986,6,3,87534,87534,87537,0,3,4
24987,6,1,87540,87540,87541,0,1,3
24988,1,1,87541,87541,87542,0,1,0
24989,3,2,87544,87544,87546,0,2,2
24990,3,1,87547,87547,87548,0,1,1
24991,3,2,87550,87550,87552,0,2,2
24992,2,2,87552,87552,87554,0,2,0
24993,6,2,87558,87558,87560,0,2,4
24994,6,3,87564,87564,87567,0,3,4
24995,4,3,87568,87568,87571,0,3,1
24996,2,1,87570,87571,87572,1,2,0
24997,1,2,87571,87572,87574,1,3,0
24998,4,1,87575,87575,87576,0,1,1
24999,5,2,87580,87580,87582,0,2,4
25000,5,3,87585,87585,87588,0,3,3
25001,2,1,87587,87588,87589,1,2,0
25002,1,1,87588,87589,87590,1,2,0
25003,4,2,87592,87592,87594,0,2,2
25004,1,1,87593,87594,87595,1,2,0
25005,3,1,87596,87596,87597,0,1,1
25006,5,2,87601,87601,87603,0,2,4
25007,5,3,87606,87606,87609,0,3,3
25008,5,3,87611,87611,87614,0,3,2
25009,2,2,87613,87614,87616,1,3,0
25010,1,2,87614,87616,87618,2,4,0
25011,4,2,87618,87618,87620,0,2,0
25012,1,2,87619,87620,87622,1,3,0
25013,1,2,87620,87622,87624,2,4,0
25014,3,3,87623,87624,87627,1,4,0
25015,5,1,87628,87628,87629,0,1,1
25016,4,1,87632,87632,87633,0,1,3
25017,1,3,87633,87633,87636,0,3,0
25018,6,2,87639,87639,87641,0,2,3
25019,3,2,87642,87642,87644,0,2,1
25020,5,3,87647,87647,87650,0,3,3
25021,1,3,87648,87650,87653,2,5,0
25022,2,2,87650,87653,87655,3,5,0
25023,3,1,87653,87655,87656,2,3,0
25024,6,2,87659,87659,87661,0,2,3
25025,2,3,87661,87661,87664,0,3,0
25026,1,1,87662,87664,87665,2,3,0
25027,6,1,87668,87668,87669,0,1,3
25028,4,3,87672,87672,87675,0,3,3
25029,3,3,87675,87675,87678,0,3,0
25030,6,1,87681,87681,87682,0,1,3
25031,3,1,87684,87684,87685,0,1,2
25032,3,2,87687,87687,87689,0,2,2
25033,1,1,87688,87689,87690,1,2,0
25034,2,1,87690,87690,87691,0,1,0
25035,6,3,87696,87696,87699,0,3,5
25036,3,1,87699,87699,87700,0,1,0
25037,1,1,87700,87700,87701,0,1,0
25038,1,2,87701,87701,87703,0,2,0
25039,1,3,87702,87703,87706,1,4,0
25040,4,3,87706,87706,87709,0,3,0
25041,2,3,87708,87709,87712,1,4,0
25042,6,1,87714,87714,87715,0,1,2
25043,3,1,87717,87717,87718,0,1,2
25044,5,3,87722,87722,87725,0,3,4
25045,4,1,87726,87726,87727,0,1,1
25046,1,1,87727,87727,87728,0,1,0
25047,6,2,87733,87733,87735,0,2,5
25048,5,1,87738,87738,87739,0,1,3
25049,2,2,87740,87740,87742,0,2,1
25050,2,1,87742,87742,87743,0,1,0
25051,1,2,87743,87743,87745,0,2,0
25052,4,1,87747,87747,87748,0,1,2
25053,2,1,87749,87749,87750,0,1,1
25054,4,2,87753,87753,87755,0,2,3
25055,3,2,87756,87756,87758,0,2,1
25056,2,3,87758,87758,87761,0,3,0
25057,6,2,87764,87764,87766,0,2,3
25058,4,1,87768,87768,87769,0,1,2
25059,2,1,87770,87770,87771,0,1,1
25060,3,1,87773,87773,87774,0,1,2
25061,6,3,87779,87779,87782,0,3,5
25062,6,3,87785,87785,87788,0,3,3
25063,6,2,87791,87791,87793,0,2,3
25064,3,1,87794,87794,87795,0,1,1
25065,5,1,87799,87799,87800,0,1,4
25066,4,2,87803,87803,87805,0,2,3
25067,2,2,87805,87805,87807,0,2,0
25068,5,2,87810,87810,87812,0,2,3
25069,5,2,87815,87815,87817,0,2,3
25070,5,3,87820,87820,87823,0,3,3
25071,3,3,87823,87823,87826,0,3,0
25072,6,2,87829,87829,87831,0,2,3
25073,1,2,87830,87831,87833,1,3,0
25074,3,1,87833,87833,87834,0,1,0
25075,6,2,87839,87839,87841,0,2,5
25076,3,2,87842,87842,87844,0,2,1
25077,2,2,87844,87844,87846,0,2,0
25078,1,1,87845,87846,87847,1,2,0
25079,2,2,87847,87847,87849,0,2,0
25080,6,2,87853,87853,87855,0,2,4
25081,4,1,87857,87857,87858,0,1,2
25082,2,3,87859,87859,87862,0,3,1
25083,2,3,87861,87862,87865,1,4,0
25084,2,2,87863,87865,87867,2,4,0
25085,2,1,87865,87867,87868,2,3,0
25086,6,2,87871,87871,87873,0,2,3
25087,2,2,87873,87873,87875,0,2,0
25088,2,2,87875,87875,87877,0,2,0
25089,5,2,87880,87880,87882,0,2,3
25090,2,3,87882,87882,87885,0,3,0
25091,3,2,87885,87885,87887,0,2,0
25092,3,2,87888,87888,87890,0,2,1
25093,6,3,87894,87894,87897,0,3,4
25094,4,1,87898,87898,87899,0,1,1
25095,5,2,87903,87903,87905,0,2,4
25096,3,3,87906,87906,87909,0,3,1
25097,2,1,87908,87909,87910,1,2,0
25098,1,3,87909,87910,87913,1,4,0
25099,6,1,87915,87915,87916,0,1,2
25100,4,2,87919,87919,87921,0,2,3
25101,6,1,87925,87925,87926,0,1,4
25102,3,1,87928,87928,87929,0,1,2
25103,1,3,87929,87929,87932,0,3,0
25104,3,2,87932,87932,87934,0,2,0
25105,3,1,87935,87935,87936,0,1,1
25106,1,3,87936,87936,87939,0,3,0
25107,5,1,87941,87941,87942,0,1,2
25108,1,2,87942,87942,87944,0,2,0
25109,6,3,87948,87948,87951,0,3,4
25110,1,1,87949,87951,87952,2,3,0
25111,2,3,87951,87952,87955,1,4,0
25112,5,3,87956,87956,87959,0,3,1
25113,5,3,87961,87961,87964,0,3,2
25114,2,3,87963,87964,87967,1,4,0
25115,3,1,87966,87967,87968,1,2,0
25116,4,1,87970,87970,87971,0,1,2
25117,1,3,87971,87971,87974,0,3,0
25118,3,1,87974,87974,87975,0,1,0
25119,3,1,87977,87977,87978,0,1,2
25120,3,2,87980,87980,87982,0,2,2
25121,3,2,87983,87983,87985,0,2,1
25122,4,2,87987,87987,87989,0,2,2
25123,4,3,87991,87991,87994,0,3,2
25124,4,1,87995,87995,87996,0,1,1
25125,6,3,88001,88001,88004,0,3,5
25126,2,2,88003,88004,88006,1,3,0
25127,3,1,88006,88006,88007,0,1,0
25128,6,3,88012,88012,88015,0,3,5
25129,2,1,88014,88015,88016,1,2,0
25130,2,2,88016,88016,88018,0,2,0
25131,3,2,88019,88019,88021,0,2,1
25132,6,3,88025,88025,88028,0,3,4
25133,2,1,88027,88028,88029,1,2,0
25134,4,1,88031,88031,88032,0,1,2
25135,6,2,88037,88037,88039,0,2,5
25136,5,2,88042,88042,88044,0,2,3
25137,6,3,88048,88048,88051,0,3,4
25138,6,3,88054,88054,88057,0,3,3
25139,3,2,88057,88057,88059,0,2,0
25140,5,1,88062,88062,88063,0,1,3
25141,5,1,88067,88067,88068,0,1,4
25142,6,2,88073,88073,88075,0,2,5
25143,2,1,88075,88075,88076,0,1,0
25144,5,2,88080,88080,88082,0,2,4
25145,6,2,88086,88086,88088,0,2,4
25146,4,3,88090,88090,88093,0,3,2
25147,4,3,88094,88094,88097,0,3,1
25148,3,3,88097,88097,88100,0,3,0
25149,2,1,88099,88100,88101,1,2,0
25150,6,1,88105,88105,88106,0,1,4
25151,6,2,88111,88111,88113,0,2,5
25152,2,2,88113,88113,88115,0,2,0
25153,3,2,88116,88116,88118,0,2,1
25154,4,1,88120,88120,88121,0,1,2
25155,6,2,88126,88126,88128,0,2,5
25156,5,2,88131,88131,88133,0,2,3
25157,1,1,88132,88133,88134,1,2,0
25158,4,2,88136,88136,88138,0,2,2
25159,4,3,88140,88140,88143,0,3,2
25160,6,2,88146,88146,88148,0,2,3
25161,2,2,88148,88148,88150,0,2,0
25162,2,1,88150,88150,88151,0,1,0
25163,4,2,88154,88154,88156,0,2,3
25164,6,2,88160,88160,88162,0,2,4
25165,5,1,88165,88165,88166,0,1,3
25166,2,1,88167,88167,88168,0,1,1
25167,5,3,88172,88172,88175,0,3,4
25168,2,3,88174,88175,88178,1,4,0
25169,4,2,88178,88178,88180,0,2,0
25170,6,2,88184,88184,88186,0,2,4
25171,6,2,88190,88190,88192,0,2,4
25172,6,1,88196,88196,88197,0,1,4
25173,1,2,88197,88197,88199,0,2,0
25174,6,2,88203,88203,88205,0,2,4
25175,3,2,88206,88206,88208,0,2,1
25176,2,3,88208,88208,88211,0,3,0
25177,3,3,88211,88211,88214,0,3,0
25178,3,1,88214,88214,88215,0,1,0
25179,1,2,88215,88215,88217,0,2,0
25180,2,3,88217,88217,88220,0,3,0
25181,4,1,88221,88221,88222,0,1,1
25182,1,2,88222,88222,88224,0,2,0
25183,5,3,88227,88227,88230,0,3,3
25184,6,1,88233,88233,88234,0,1,3
25185,5,2,88238,88238,88240,0,2,4
25186,2,1,88240,88240,88241,0,1,0
25187,6,2,88246,88246,88248,0,2,5
25188,2,1,88248,88248,88249,0,1,0
25189,3,2,88251,88251,88253,0,2,2
25190,3,1,88254,88254,88255,0,1,1
25191,5,2,88259,88259,88261,0,2,4
25192,1,2,88260,88261,88263,1,3,0
25193,3,2,88263,88263,88265,0,2,0
25194,2,3,88265,88265,88268,0,3,0
25195,2,3,88267,88268,88271,1,4,0
25196,4,2,88271,88271,88273,0,2,0
25197,4,1,88275,88275,88276,0,1,2
25198,6,3,88281,88281,88284,0,3,5
25199,5,3,88286,88286,88289,0,3,2
25200,6,3,88292,88292,88295,0,3,3
25201,6,1,88298,88298,88299,0,1,3
25202,3,2,88301,88301,88303,0,2,2
25203,4,2,88305,88305,88307,0,2,2
25204,5,1,88310,88310,88311,0,1,3
25205,4,2,88314,88314,88316,0,2,3
25206,2,3,88316,88316,88319,0,3,0
25207,6,2,88322,88322,88324,0,2,3
25208,3,1,88325,88325,88326,0,1,1
25209,3,1,88328,88328,88329,0,1,2
25210,1,1,88329,88329,88330,0,1,0
25211,2,3,88331,88331,88334,0,3,1
25212,5,3,88336,88336,88339,0,3,2
25213,2,1,88338,88339,88340,1,2,0
25214,1,1,88339,88340,88341,1,2,0
25215,2,1,88341,88341,88342,0,1,0
25216,2,2,88343,88343,88345,0,2,1
25217,6,2,88349,88349,88351,0,2,4
25218,6,1,88355,88355,88356,0,1,4
25219,6,2,88361,88361,88363,0,2,5
25220,4,3,88365,88365,88368,0,3,2
25221,6,2,88371,88371,88373,0,2,3
25222,3,1,88374,88374,88375,0,1,1
25223,2,1,88376,88376,88377,0,1,1
25224,6,3,88382,88382,88385,0,3,5
25225,6,1,88388,88388,88389,0,1,3
25226,5,1,88393,88393,88394,0,1,4
25227,3,2,88396,88396,88398,0,2,2
25228,3,3,88399,88399,88402,0,3,1
25229,6,3,88405,88405,88408,0,3,3
25230,3,1,88408,88408,88409,0,1,0
25231,1,1,88409,88409,88410,0,1,0
25232,6,1,88415,88415,88416,0,1,5
25233,1,2,88416,88416,88418,0,2,0
25234,3,1,88419,88419,88420,0,1,1
25235,4,1,88423,88423,88424,0,1,3
25236,5,2,88428,88428,88430,0,2,4
25237,3,1,88431,88431,88432,0,1,1
25238,5,2,88436,88436,88438,0,2,4
25239,5,1,88441,88441,88442,0,1,3
25240,4,2,88445,88445,88447,0,2,3
25241,1,2,88446,88447,88449,1,3,0
25242,2,1,88448,88449,88450,1,2,0
25243,2,1,88450,88450,88451,0,1,0
25244,4,3,88454,88454,88457,0,3,3
25245,4,1,88458,88458,88459,0,1,1
25246,3,3,88461,88461,88464,0,3,2
25247,6,3,88467,88467,88470,0,3,3
25248,4,1,88471,88471,88472,0,1,1
25249,5,3,88476,88476,88479,0,3,4
25250,1,1,88477,88479,88480,2,3,0
25251,1,3,88478,88480,88483,2,5,0
25252,6,1,88484,88484,88485,0,1,1
25253,6,2,88490,88490,88492,0,2,5
25254,4,1,88494,88494,88495,0,1,2
25255,3,2,88497,88497,88499,0,2,2
25256,2,2,88499,88499,88501,0,2,0
25257,5,3,88504,88504,88507,0,3,3
25258,6,3,88510,88510,88513,0,3,3
25259,5,3,88515,88515,88518,0,3,2
25260,1,1,88516,88518,88519,2,3,0
25261,5,3,88521,88521,88524,0,3,2
25262,6,3,88527,88527,88530,0,3,3
25263,3,1,88530,88530,88531,0,1,0
25264,5,2,88535,88535,88537,0,2,4
25265,2,1,88537,88537,88538,0,1,0
25266,2,3,88539,88539,88542,0,3,1
25267,1,3,88540,88542,88545,2,5,0
25268,4,1,88544,88545,88546,1,2,0
25269,6,3,88550,88550,88553,0,3,4
25270,5,1,88555,88555,88556,0,1,2
25271,6,3,88561,88561,88564,0,3,5
25272,1,1,88562,88564,88565,2,3,0
25273,3,3,88565,88565,88568,0,3,0
25274,4,3,88569,88569,88572,0,3,1
25275,5,3,88574,88574,88577,0,3,2
25276,3,2,88577,88577,88579,0,2,0
25277,1,1,88578,88579,88580,1,2,0
25278,6,2,88584,88584,88586,0,2,4
25279,4,1,88588,88588,88589,0,1,2
25280,5,3,88593,88593,88596,0,3,4
25281,2,3,88595,88596,88599,1,4,0
25282,3,1,88598,88599,88600,1,2,0
25283,1,3,88599,88600,88603,1,4,0
25284,5,1,88604,88604,88605,0,1,1
25285,6,3,88610,88610,88613,0,3,5
25286,4,2,88614,88614,88616,0,2,1
25287,4,1,88618,88618,88619,0,1,2
25288,6,1,88624,88624,88625,0,1,5
25289,6,3,88630,88630,88633,0,3,5
25290,4,2,88634,88634,88636,0,2,1
25291,2,2,88636,88636,88638,0,2,0
25292,5,1,88641,88641,88642,0,1,3
25293,2,2,88643,88643,88645,0,2,1
25294,5,3,88648,88648,88651,0,3,3
25295,3,3,88651,88651,88654,0,3,0
25296,3,3,88654,88654,88657,0,3,0
25297,5,3,88659,88659,88662,0,3,2
25298,2,3,88661,88662,88665,1,4,0
25299,5,1,88666,88666,88667,0,1,1
25300,2,3,88668,88668,88671,0,3,1
25301,2,2,88670,88671,88673,1,3,0
25302,6,3,88676,88676,88679,0,3,3
25303,4,3,88680,88680,88683,0,3,1
25304,5,2,88685,88685,88687,0,2,2
25305,5,1,88690,88690,88691,0,1,3
25306,4,1,88694,88694,88695,0,1,3
25307,1,2,88695,88695,88697,0,2,0
25308,2,2,88697,88697,88699,0,2,0
25309,1,3,88698,88699,88702,1,4,0
25310,4,3,88702,88702,88705,0,3,0
25311,2,2,88704,88705,88707,1,3,0
25312,5,3,88709,88709,88712,0,3,2
25313,5,3,88714,88714,88717,0,3,2
25314,4,1,88718,88718,88719,0,1,1
25315,2,2,88720,88720,88722,0,2,1
25316,4,1,88724,88724,88725,0,1,2
25317,3,3,88727,88727,88730,0,3,2
25318,6,1,88733,88733,88734,0,1,3
25319,5,2,88738,88738,88740,0,2,4
25320,6,1,88744,88744,88745,0,1,4
25321,1,1,88745,88745,88746,0,1,0
25322,1,1,88746,88746,88747,0,1,0
25323,6,3,88752,88752,88755,0,3,5
25324,2,2,88754,88755,88757,1,3,0
25325,4,1,88758,88758,88759,0,1,1
25326,3,1,88761,88761,88762,0,1,2
25327,4,2,88765,88765,88767,0,2,3
25328,3,2,88768,88768,88770,0,2,1
25329,1,1,88769,88770,88771,1,2,0
25330,6,1,88775,88775,88776,0,1,4
25331,3,3,88778,88778,88781,0,3,2
25332,6,1,88784,88784,88785,0,1,3
25333,1,3,88785,88785,88788,0,3,0
25334,3,2,88788,88788,88790,0,2,0
25335,2,3,88790,88790,88793,0,3,0
25336,4,2,88794,88794,88796,0,2,1
25337,3,2,88797,88797,88799,0,2,1
25338,3,2,88800,88800,88802,0,2,1
25339,5,3,88805,88805,88808,0,3,3
25340,4,1,88809,88809,88810,0,1,1
25341,3,2,88812,88812,88814,0,2,2
25342,6,1,88818,88818,88819,0,1,4
25343,6,1,88824,88824,88825,0,1,5
25344,4,2,88828,88828,88830,0,2,3
25345,1,3,88829,88830,88833,1,4,0
25346,3,2,88832,88833,88835,1,3,0
25347,6,1,88838,88838,88839,0,1,3
25348,5,1,88843,88843,88844,0,1,4
25349,2,3,88845,88845,88848,0,3,1
25350,2,1,88847,88848,88849,1,2,0
25351,1,1,88848,88849,88850,1,2,0
25352,1,2,88849,88850,88852,1,3,0
25353,2,1,88851,88852,88853,1,2,0
25354,1,2,88852,88853,88855,1,3,0
25355,1,2,88853,88855,88857,2,4,0
25356,4,3,88857,88857,88860,0,3,0
25357,6,3,88863,88863,88866,0,3,3
25358,3,2,88866,88866,88868,0,2,0
25359,6,3,88872,88872,88875,0,3,4
25360,1,2,88873,88875,88877,2,4,0
25361,5,1,88878,88878,88879,0,1,1
25362,5,3,88883,88883,88886,0,3,4
25363,3,2,88886,88886,88888,0,2,0
25364,3,3,88889,88889,88892,0,3,1
25365,4,3,88893,88893,88896,0,3,1
25366,3,1,88896,88896,88897,0,1,0
25367,3,1,88899,88899,88900,0,1,2
25368,5,3,88904,88904,88907,0,3,4
25369,1,3,88905,88907,88910,2,5,0
25370,3,2,88908,88910,88912,2,4,0
25371,4,2,88912,88912,88914,0,2,0
25372,5,3,88917,88917,88920,0,3,3
25373,3,2,88920,88920,88922,0,2,0
25374,3,2,88923,88923,88925,0,2,1
25375,6,3,88929,88929,88932,0,3,4
25376,1,3,88930,88932,88935,2,5,0
25377,2,1,88932,88935,88936,3,4,0
25378,1,2,88933,88936,88938,3,5,0
25379,3,2,88936,88938,88940,2,4,0
25380,4,2,88940,88940,88942,0,2,0
25381,1,2,88941,88942,88944,1,3,0
25382,1,3,88942,88944,88947,2,5,0
25383,1,2,88943,88947,88949,4,6,0
25384,3,1,88946,88949,88950,3,4,0
25385,6,3,88952,88952,88955,0,3,2
25386,5,2,88957,88957,88959,0,2,2
25387,5,2,88962,88962,88964,0,2,3
25388,5,1,88967,88967,88968,0,1,3
25389,6,1,88973,88973,88974,0,1,5
25390,1,3,88974,88974,88977,0,3,0
25391,5,1,88979,88979,88980,0,1,2
25392,1,3,88980,88980,88983,0,3,0
25393,3,2,88983,88983,88985,0,2,0
25394,2,3,88985,88985,88988,0,3,0
25395,3,3,88988,88988,88991,0,3,0
25396,4,1,88992,88992,88993,0,1,1
25397,2,1,88994,88994,88995,0,1,1
25398,2,3,88996,88996,88999,0,3,1
25399,4,3,89000,89000,89003,0,3,1
25400,1,1,89001,89003,89004,2,3,0
25401,4,3,89005,89005,89008,0,3,1
25402,4,1,89009,89009,89010,0,1,1
25403,4,3,89013,89013,89016,0,3,3
25404,5,1,89018,89018,89019,0,1,2
25405,6,1,89024,89024,89025,0,1,5
25406,6,1,89030,89030,89031,0,1,5
25407,2,2,89032,89032,89034,0,2,1
25408,6,2,89038,89038,89040,0,2,4
25409,3,1,89041,89041,89042,0,1,1
25410,1,3,89042,89042,89045,0,3,0
25411,2,3,89044,89045,89048,1,4,0
25412,3,1,89047,89048,89049,1,2,0
25413,1,2,89048,89049,89051,1,3,0
25414,3,3,89051,89051,89054,0,3,0
25415,2,1,89053,89054,89055,1,2,0
25416,6,1,89059,89059,89060,0,1,4
25417,1,3,89060,89060,89063,0,3,0
25418,2,2,89062,89063,89065,1,3,0
25419,1,3,89063,89065,89068,2,5,0
25420,4,2,89067,89068,89070,1,3,0
25421,5,3,89072,89072,89075,0,3,2
25422,1,3,89073,89075,89078,2,5,0
25423,3,3,89076,89078,89081,2,5,0
25424,3,1,89079,89081,89082,2,3,0
25425,1,2,89080,89082,89084,2,4,0
25426,5,2,89085,89085,89087,0,2,1
25427,2,2,89087,89087,89089,0,2,0
25428,6,2,89093,89093,89095,0,2,4
25429,2,2,89095,89095,89097,0,2,0
25430,3,3,89098,89098,89101,0,3,1
25431,1,1,89099,89101,89102,2,3,0
25432,6,2,89105,89105,89107,0,2,3
25433,5,3,89110,89110,89113,0,3,3
25434,3,3,89113,89113,89116,0,3,0
25435,2,2,89115,89116,89118,1,3,0
25436,5,1,89120,89120,89121,0,1,2
25437,3,3,89123,89123,89126,0,3,2
25438,4,3,89127,89127,89130,0,3,1
25439,2,2,89129,89130,89132,1,3,0
25440,4,3,89133,89133,89136,0,3,1
25441,2,3,89135,89136,89139,1,4,0
25442,6,2,89141,89141,89143,0,2,2
25443,1,3,89142,89143,89146,1,4,0
25444,6,1,89148,89148,89149,0,1,2
25445,5,3,89153,89153,89156,0,3,4
25446,5,3,89158,89158,89161,0,3,2
25447,4,1,89162,89162,89163,0,1,1
25448,2,3,89164,89164,89167,0,3,1
25449,1,3,89165,89167,89170,2,5,0
25450,3,2,89168,89170,89172,2,4,0
25451,1,2,89169,89172,89174,3,5,0
25452,3,3,89172,89174,89177,2,5,0
25453,6,1,89178,89178,89179,0,1,1
25454,2,1,89180,89180,89181,0,1,1
25455,6,3,89186,89186,89189,0,3,5
25456,3,1,89189,89189,89190,0,1,0
25457,3,3,89192,89192,89195,0,3,2
25458,6,1,89198,89198,89199,0,1,3
25459,1,2,89199,89199,89201,0,2,0
25460,4,3,89203,89203,89206,0,3,2
25461,2,1,89205,89206,89207,1,2,0
25462,1,3,89206,89207,89210,1,4,0
25463,3,3,89209,89210,89213,1,4,0
25464,1,3,89210,89213,89216,3,6,0
25465,4,2,89214,89216,89218,2,4,0
25466,4,1,89218,89218,89219,0,1,0
25467,3,3,89221,89221,89224,0,3,2
25468,1,3,89222,89224,89227,2,5,0
25469,2,2,89224,89227,89229,3,5,0
25470,5,1,89229,89229,89230,0,1,0
25471,5,3,89234,89234,89237,0,3,4
25472,4,2,89238,89238,89240,0,2,1
25473,4,2,89242,89242,89244,0,2,2
25474,6,3,89248,89248,89251,0,3,4
25475,5,3,89253,89253,89256,0,3,2
25476,4,3,89257,89257,89260,0,3,1
25477,6,2,89263,89263,89265,0,2,3
25478,3,1,89266,89266,89267,0,1,1
25479,1,1,89267,89267,89268,0,1,0
25480,1,1,89268,89268,89269,0,1,0
25481,1,3,89269,89269,89272,0,3,0
25482,6,2,89275,89275,89277,0,2,3
25483,3,3,89278,89278,89281,0,3,1
25484,6,1,89284,89284,89285,0,1,3
25485,5,2,89289,89289,89291,0,2,4
25486,5,3,89294,89294,89297,0,3,3
25487,2,1,89296,89297,89298,1,2,0
25488,3,3,89299,89299,89302,0,3,1
25489,1,2,89300,89302,89304,2,4,0
25490,2,1,89302,89304,89305,2,3,0
25491,2,3,89304,89305,89308,1,4,0
25492,4,3,89308,89308,89311,0,3,0
25493,2,1,89310,89311,89312,1,2,0
25494,6,1,89316,89316,89317,0,1,4
25495,1,3,89317,89317,89320,0,3,0
25496,1,2,89318,89320,89322,2,4,0
25497,4,1,89322,89322,89323,0,1,0
25498,5,2,89327,89327,89329,0,2,4
25499,6,3,89333,89333,89336,0,3,4
25500,5,1,89338,89338,89339,0,1,2
25501,2,1,89340,89340,89341,0,1,1
25502,5,1,89345,89345,89346,0,1,4
25503,2,1,89347,89347,89348,0,1,1
25504,2,3,89349,89349,89352,0,3,1
25505,3,1,89352,89352,89353,0,1,0
25506,4,2,89356,89356,89358,0,2,3
25507,5,2,89361,89361,89363,0,2,3
25508,1,1,89362,89363,89364,1,2,0
25509,2,3,89364,89364,89367,0,3,0
25510,3,2,89367,89367,89369,0,2,0
25511,4,1,89371,89371,89372,0,1,2
25512,6,1,89377,89377,89378,0,1,5
25513,3,3,89380,89380,89383,0,3,2
25514,6,3,89386,89386,89389,0,3,3
25515,3,1,89389,89389,89390,0,1,0
25516,6,1,89395,89395,89396,0,1,5
25517,1,3,89396,89396,89399,0,3,0
25518,6,1,89402,89402,89403,0,1,3
25519,5,1,89407,89407,89408,0,1,4
25520,6,3,89413,89413,89416,0,3,5
25521,6,2,89419,89419,89421,0,2,3
25522,5,2,89424,89424,89426,0,2,3
25523,3,2,89427,89427,89429,0,2,1
25524,6,2,89433,89433,89435,0,2,4
25525,6,2,89439,89439,89441,0,2,4
25526,2,2,89441,89441,89443,0,2,0
25527,2,3,89443,89443,89446,0,3,0
25528,2,3,89445,89446,89449,1,4,0
25529,2,2,89447,89449,89451,2,4,0
25530,6,2,89453,89453,89455,0,2,2
25531,4,3,89457,89457,89460,0,3,2
25532,4,2,89461,89461,89463,0,2,1
25533,2,2,89463,89463,89465,0,2,0
25534,1,3,89464,89465,89468,1,4,0
25535,3,1,89467,89468,89469,1,2,0
25536,4,2,89471,89471,89473,0,2,2
25537,5,3,89476,89476,89479,0,3,3
25538,3,1,89479,89479,89480,0,1,0
25539,1,3,89480,89480,89483,0,3,0
25540,2,2,89482,89483,89485,1,3,0
25541,6,2,89488,89488,89490,0,2,3
25542,4,2,89492,89492,89494,0,2,2
25543,5,3,89497,89497,89500,0,3,3
25544,3,1,89500,89500,89501,0,1,0
25545,1,3,89501,89501,89504,0,3,0
25546,2,3,89503,89504,89507,1,4,0
25547,1,1,89504,89507,89508,3,4,0
25548,4,1,89508,89508,89509,0,1,0
25549,4,3,89512,89512,89515,0,3,3
25550,1,1,89513,89515,89516,2,3,0
25551,3,2,89516,89516,89518,0,2,0
25552,6,1,89522,89522,89523,0,1,4
25553,2,1,89524,89524,89525,0,1,1
25554,3,3,89527,89527,89530,0,3,2
25555,1,3,89528,89530,89533,2,5,0
25556,1,2,89529,89533,89535,4,6,0
25557,2,2,89531,89535,89537,4,6,0
25558,1,1,89532,89537,89538,5,6,0
25559,4,2,89536,89538,89540,2,4,0
25560,6,3,89542,89542,89545,0,3,2
25561,2,2,89544,89545,89547,1,3,0
25562,3,1,89547,89547,89548,0,1,0
25563,5,3,89552,89552,89555,0,3,4
25564,1,2,89553,89555,89557,2,4,0
25565,1,2,89554,89557,89559,3,5,0
25566,2,2,89556,89559,89561,3,5,0
25567,3,2,89559,89561,89563,2,4,0
25568,3,1,89562,89563,89564,1,2,0
25569,3,3,89565,89565,89568,0,3,1
25570,1,2,89566,89568,89570,2,4,0
25571,1,2,89567,89570,89572,3,5,0
25572,3,1,89570,89572,89573,2,3,0
25573,2,2,89572,89573,89575,1,3,0
25574,5,1,89577,89577,89578,0,1,2
25575,3,2,89580,89580,89582,0,2,2
25576,5,2,89585,89585,89587,0,2,3
25577,4,2,89589,89589,89591,0,2,2
25578,3,1,89592,89592,89593,0,1,1
25579,3,3,89595,89595,89598,0,3,2
25580,6,2,89601,89601,89603,0,2,3
25581,5,1,89606,89606,89607,0,1,3
25582,5,1,89611,89611,89612,0,1,4
25583,3,2,89614,89614,89616,0,2,2
25584,4,2,89618,89618,89620,0,2,2
25585,1,2,89619,89620,89622,1,3,0
25586,4,2,89623,89623,89625,0,2,1
25587,6,3,89629,89629,89632,0,3,4
25588,1,1,89630,89632,89633,2,3,0
25589,3,2,89633,89633,89635,0,2,0
25590,4,3,89637,89637,89640,0,3,2
25591,1,3,89638,89640,89643,2,5,0
25592,2,1,89640,89643,89644,3,4,0
25593,3,3,89643,89644,89647,1,4,0
25594,5,1,89648,89648,89649,0,1,1
25595,5,3,89653,89653,89656,0,3,4
25596,3,3,89656,89656,89659,0,3,0
25597,4,1,89660,89660,89661,0,1,1
25598,4,1,89664,89664,89665,0,1,3
25599,6,2,89670,89670,89672,0,2,5
25600,5,3,89675,89675,89678,0,3,3
25601,5,1,89680,89680,89681,0,1,2
25602,4,3,89684,89684,89687,0,3,3
25603,3,2,89687,89687,89689,0,2,0
25604,3,3,89690,89690,89693,0,3,1
25605,4,3,89694,89694,89697,0,3,1
25606,6,2,89700,89700,89702,0,2,3
25607,2,1,89702,89702,89703,0,1,0
25608,6,2,89708,89708,89710,0,2,5
25609,3,1,89711,89711,89712,0,1,1
25610,6,3,89717,89717,89720,0,3,5
25611,2,2,89719,89720,89722,1,3,0
25612,2,1,89721,89722,89723,1,2,0
25613,2,2,89723,89723,89725,0,2,0
25614,6,2,89729,89729,89731,0,2,4
25615,3,3,89732,89732,89735,0,3,1
25616,3,2,89735,89735,89737,0,2,0
25617,2,2,89737,89737,89739,0,2,0
25618,4,1,89741,89741,89742,0,1,2
25619,5,1,89746,89746,89747,0,1,4
25620,4,3,89750,89750,89753,0,3,3
25621,6,3,89756,89756,89759,0,3,3
25622,5,3,89761,89761,89764,0,3,2
25623,5,1,89766,89766,89767,0,1,2
25624,4,1,89770,89770,89771,0,1,3
25625,3,2,89773,89773,89775,0,2,2
25626,5,3,89778,89778,89781,0,3,3
25627,6,1,89784,89784,89785,0,1,3
25628,2,1,89786,89786,89787,0,1,1
25629,4,1,89790,89790,89791,0,1,3
25630,2,1,89792,89792,89793,0,1,1
25631,2,3,89794,89794,89797,0,3,1
25632,2,1,89796,89797,89798,1,2,0
25633,4,1,89800,89800,89801,0,1,2
25634,3,3,89803,89803,89806,0,3,2
25635,4,3,89807,89807,89810,0,3,1
25636,6,1,89813,89813,89814,0,1,3
25637,3,1,89816,89816,89817,0,1,2
25638,6,1,89822,89822,89823,0,1,5
25639,3,1,89825,89825,89826,0,1,2
25640,4,3,89829,89829,89832,0,3,3
25641,1,2,89830,89832,89834,2,4,0
25642,6,2,89836,89836,89838,0,2,2
25643,3,2,89839,89839,89841,0,2,1
25644,6,1,89845,89845,89846,0,1,4
25645,2,1,89847,89847,89848,0,1,1
25646,1,3,89848,89848,89851,0,3,0
25647,2,1,89850,89851,89852,1,2,0
25648,4,2,89854,89854,89856,0,2,2
25649,6,3,89860,89860,89863,0,3,4
25650,3,1,89863,89863,89864,0,1,0
25651,1,1,89864,89864,89865,0,1,0
25652,3,1,89867,89867,89868,0,1,2
25653,5,1,89872,89872,89873,0,1,4
25654,3,3,89875,89875,89878,0,3,2
25655,2,3,89877,89878,89881,1,4,0
25656,2,2,89879,89881,89883,2,4,0
25657,5,2,89884,89884,89886,0,2,1
25658,5,3,89889,89889,89892,0,3,3
25659,6,2,89895,89895,89897,0,2,3
25660,4,3,89899,89899,89902,0,3,2
25661,5,3,89904,89904,89907,0,3,2
25662,5,1,89909,89909,89910,0,1,2
25663,6,1,89915,89915,89916,0,1,5
25664,3,1,89918,89918,89919,0,1,2
25665,3,1,89921,89921,89922,0,1,2
25666,2,3,89923,89923,89926,0,3,1
25667,5,3,89928,89928,89931,0,3,2
25668,6,3,89934,89934,89937,0,3,3
25669,3,3,89937,89937,89940,0,3,0
25670,6,3,89943,89943,89946,0,3,3
25671,1,1,89944,89946,89947,2,3,0
25672,3,1,89947,89947,89948,0,1,0
25673,3,2,89950,89950,89952,0,2,2
25674,2,2,89952,89952,89954,0,2,0
25675,5,3,89957,89957,89960,0,3,3
25676,1,3,89958,89960,89963,2,5,0
25677,3,1,89961,89963,89964,2,3,0
25678,1,2,89962,89964,89966,2,4,0
25679,2,3,89964,89966,89969,2,5,0
25680,1,2,89965,89969,89971,4,6,0
25681,6,2,89971,89971,89973,0,2,0
25682,1,2,89972,89973,89975,1,3,0
25683,1,1,89973,89975,89976,2,3,0
25684,5,2,89978,89978,89980,0,2,2
25685,5,1,89983,89983,89984,0,1,3
25686,5,1,89988,89988,89989,0,1,4
25687,5,2,89993,89993,89995,0,2,4
25688,1,3,89994,89995,89998,1,4,0
25689,2,2,89996,89998,90000,2,4,0
25690,4,2,90000,90000,90002,0,2,0
25691,5,3,90005,90005,90008,0,3,3
25692,6,3,90011,90011,90014,0,3,3
25693,3,2,90014,90014,90016,0,2,0
25694,4,2,90018,90018,90020,0,2,2
25695,6,2,90024,90024,90026,0,2,4
25696,5,3,90029,90029,90032,0,3,3
25697,3,3,90032,90032,90035,0,3,0
25698,5,1,90037,90037,90038,0,1,2
25699,3,2,90040,90040,90042,0,2,2
25700,2,3,90042,90042,90045,0,3,0
25701,6,1,90048,90048,90049,0,1,3
25702,6,2,90054,90054,90056,0,2,5
25703,5,1,90059,90059,90060,0,1,3
25704,2,2,90061,90061,90063,0,2,1
25705,1,1,90062,90063,90064,1,2,0
25706,4,2,90066,90066,90068,0,2,2
25707,1,2,90067,90068,90070,1,3,0
25708,1,2,90068,90070,90072,2,4,0
25709,5,1,90073,90073,90074,0,1,1
25710,1,1,90074,90074,90075,0,1,0
25711,4,1,90078,90078,90079,0,1,3
25712,1,2,90079,90079,90081,0,2,0
25713,5,3,90084,90084,90087,0,3,3
25714,6,3,90090,90090,90093,0,3,3
25715,3,1,90093,90093,90094,0,1,0
25716,5,1,90098,90098,90099,0,1,4
25717,6,2,90104,90104,90106,0,2,5
25718,2,3,90106,90106,90109,0,3,0
25719,6,1,90112,90112,90113,0,1,3
25720,1,3,90113,90113,90116,0,3,0
25721,6,2,90119,90119,90121,0,2,3
25722,2,2,90121,90121,90123,0,2,0
25723,1,3,90122,90123,90126,1,4,0
25724,2,1,90124,90126,90127,2,3,0
25725,4,2,90128,90128,90130,0,2,1
25726,6,3,90134,90134,90137,0,3,4
25727,1,1,90135,90137,90138,2,3,0
25728,3,2,90138,90138,90140,0,2,0
25729,5,3,90143,90143,90146,0,3,3
25730,2,3,90145,90146,90149,1,4,0
25731,3,3,90148,90149,90152,1,4,0
25732,4,3,90152,90152,90155,0,3,0
25733,2,3,90154,90155,90158,1,4,0
25734,3,3,90157,90158,90161,1,4,0
25735,1,1,90158,90161,90162,3,4,0
25736,3,3,90161,90162,90165,1,4,0
25737,5,3,90166,90166,90169,0,3,1
25738,1,2,90167,90169,90171,2,4,0
25739,5,2,90172,90172,90174,0,2,1
25740,3,3,90175,90175,90178,0,3,1
25741,4,2,90179,90179,90181,0,2,1
25742,1,1,90180,90181,90182,1,2,0
25743,6,2,90186,90186,90188,0,2,4
25744,5,2,90191,90191,90193,0,2,3
25745,6,2,90197,90197,90199,0,2,4
25746,4,3,90201,90201,90204,0,3,2
25747,4,1,90205,90205,90206,0,1,1
25748,1,2,90206,90206,90208,0,2,0
25749,2,2,90208,90208,90210,0,2,0
25750,1,2,90209,90210,90212,1,3,0
25751,5,1,90214,90214,90215,0,1,2
25752,4,3,90218,90218,90221,0,3,3
25753,1,1,90219,90221,90222,2,3,0
25754,6,3,90225,90225,90228,0,3,3
25755,3,3,90228,90228,90231,0,3,0
25756,3,3,90231,90231,90234,0,3,0
25757,6,3,90237,90237,90240,0,3,3
25758,5,2,90242,90242,90244,0,2,2
25759,3,1,90245,90245,90246,0,1,1
25760,3,3,90248,90248,90251,0,3,2
25761,1,1,90249,90251,90252,2,3,0
25762,5,1,90254,90254,90255,0,1,2
25763,5,1,90259,90259,90260,0,1,4
25764,1,1,90260,90260,90261,0,1,0
25765,2,3,90262,90262,90265,0,3,1
25766,4,2,90266,90266,90268,0,2,1
25767,5,1,90271,90271,90272,0,1,3
25768,2,2,90273,90273,90275,0,2,1
25769,2,3,90275,90275,90278,0,3,0
25770,3,1,90278,90278,90279,0,1,0
25771,1,1,90279,90279,90280,0,1,0
25772,4,3,90283,90283,90286,0,3,3
25773,4,2,90287,90287,90289,0,2,1
25774,5,3,90292,90292,90295,0,3,3
25775,5,1,90297,90297,90298,0,1,2
25776,6,3,90303,90303,90306,0,3,5
25777,2,1,90305,90306,90307,1,2,0
25778,6,2,90311,90311,90313,0,2,4
25779,6,2,90317,90317,90319,0,2,4
25780,2,2,90319,90319,90321,0,2,0
25781,3,2,90322,90322,90324,0,2,1
25782,6,2,90328,90328,90330,0,2,4
25783,4,2,90332,90332,90334,0,2,2
25784,4,1,90336,90336,90337,0,1,2
25785,2,1,90338,90338,90339,0,1,1
25786,5,3,90343,90343,90346,0,3,4
25787,3,2,90346,90346,90348,0,2,0
25788,5,1,90351,90351,90352,0,1,3
25789,3,3,90354,90354,90357,0,3,2
25790,4,1,90358,90358,90359,0,1,1
25791,5,2,90363,90363,90365,0,2,4
25792,4,1,90367,90367,90368,0,1,2
25793,1,3,90368,90368,90371,0,3,0
25794,5,2,90373,90373,90375,0,2,2
25795,3,2,90376,90376,90378,0,2,1
25796,4,1,90380,90380,90381,0,1,2
25797,4,2,90384,90384,90386,0,2,3
25798,5,1,90389,90389,90390,0,1,3
25799,3,3,90392,90392,90395,0,3,2
25800,6,1,90398,90398,90399,0,1,3
25801,4,3,90402,90402,90405,0,3,3
25802,6,2,90408,90408,90410,0,2,3
25803,4,2,90412,90412,90414,0,2,2
25804,1,3,90413,90414,90417,1,4,0
25805,4,3,90417,90417,90420,0,3,0
25806,2,2,90419,90420,90422,1,3,0
25807,5,2,90424,90424,90426,0,2,2
25808,1,2,90425,90426,90428,1,3,0
25809,4,1,90429,90429,90430,0,1,1
25810,5,2,90434,90434,90436,0,2,4
25811,4,1,90438,90438,90439,0,1,2
25812,4,1,90442,90442,90443,0,1,3
25813,3,3,90445,90445,90448,0,3,2
25814,1,3,90446,90448,90451,2,5,0
25815,1,3,90447,90451,90454,4,7,0
25816,4,1,90451,90454,90455,3,4,0
25817,1,2,90452,90455,90457,3,5,0
25818,5,1,90457,90457,90458,0,1,0
25819,3,2,90460,90460,90462,0,2,2
25820,4,3,90464,90464,90467,0,3,2
25821,4,3,90468,90468,90471,0,3,1
25822,1,2,90469,90471,90473,2,4,0
25823,6,3,90475,90475,90478,0,3,2
25824,3,3,90478,90478,90481,0,3,0
25825,2,1,90480,90481,90482,1,2,0
25826,3,2,90483,90483,90485,0,2,1
25827,5,1,90488,90488,90489,0,1,3
25828,6,3,90494,90494,90497,0,3,5
25829,2,1,90496,90497,90498,1,2,0
25830,2,2,90498,90498,90500,0,2,0
25831,6,1,90504,90504,90505,0,1,4
25832,4,2,90508,90508,90510,0,2,3
25833,1,2,90509,90510,90512,1,3,0
25834,6,2,90515,90515,90517,0,2,3
25835,2,1,90517,90517,90518,0,1,0
25836,2,2,90519,90519,90521,0,2,1
25837,6,3,90525,90525,90528,0,3,4
25838,6,3,90531,90531,90534,0,3,3
25839,3,3,90534,90534,90537,0,3,0
25840,4,3,90538,90538,90541,0,3,1
25841,3,3,90541,90541,90544,0,3,0
25842,2,3,90543,90544,90547,1,4,0
25843,6,3,90549,90549,90552,0,3,2
25844,1,2,90550,90552,90554,2,4,0
25845,6,1,90556,90556,90557,0,1,2
25846,3,3,90559,90559,90562,0,3,2
25847,4,3,90563,90563,90566,0,3,1
25848,6,2,90569,90569,90571,0,2,3
25849,4,3,90573,90573,90576,0,3,2
25850,1,2,90574,90576,90578,2,4,0
25851,2,1,90576,90578,90579,2,3,0
25852,2,3,90578,90579,90582,1,4,0
25853,3,3,90581,90582,90585,1,4,0
25854,1,3,90582,90585,90588,3,6,0
25855,2,1,90584,90588,90589,4,5,0
25856,4,1,90588,90589,90590,1,2,0
25857,6,3,90594,90594,90597,0,3,4
25858,2,1,90596,90597,90598,1,2,0
25859,6,1,90602,90602,90603,0,1,4
25860,4,2,90606,90606,90608,0,2,3
25861,6,2,90612,90612,90614,0,2,4
25862,6,1,90618,90618,90619,0,1,4
25863,6,2,90624,90624,90626,0,2,5
25864,6,2,90630,90630,90632,0,2,4
25865,1,1,90631,90632,90633,1,2,0
25866,4,2,90635,90635,90637,0,2,2
25867,6,2,90641,90641,90643,0,2,4
25868,3,3,90644,90644,90647,0,3,1
25869,5,3,90649,90649,90652,0,3,2
25870,4,3,90653,90653,90656,0,3,1
25871,3,3,90656,90656,90659,0,3,0
25872,5,3,90661,90661,90664,0,3,2
25873,2,2,90663,90664,90666,1,3,0
25874,1,3,90664,90666,90669,2,5,0
25875,3,2,90667,90669,90671,2,4,0
25876,2,3,90669,90671,90674,2,5,0
25877,5,2,90674,90674,90676,0,2,0
25878,2,1,90676,90676,90677,0,1,0
25879,1,3,90677,90677,90680,0,3,0
25880,5,3,90682,90682,90685,0,3,2
25881,4,2,90686,90686,90688,0,2,1
25882,3,3,90689,90689,90692,0,3,1
25883,1,1,90690,90692,90693,2,3,0
25884,4,1,90694,90694,90695,0,1,1
25885,6,1,90700,90700,90701,0,1,5
25886,3,2,90703,90703,90705,0,2,2
25887,4,1,90707,90707,90708,0,1,2
25888,3,3,90710,90710,90713,0,3,2
25889,1,2,90711,90713,90715,2,4,0
25890,6,1,90717,90717,90718,0,1,2
25891,6,3,90723,90723,90726,0,3,5
25892,4,3,90727,90727,90730,0,3,1
25893,4,1,90731,90731,90732,0,1,1
25894,5,3,90736,90736,90739,0,3,4
25895,6,2,90742,90742,90744,0,2,3
25896,1,1,90743,90744,90745,1,2,0
25897,1,3,90744,90745,90748,1,4,0
25898,2,3,90746,90748,90751,2,5,0
25899,1,2,90747,90751,90753,4,6,0
25900,4,1,90751,90753,90754,2,3,0
25901,1,2,90752,90754,90756,2,4,0
25902,1,3,90753,90756,90759,3,6,0
25903,1,3,90754,90759,90762,5,8,0
25904,1,3,90755,90762,90765,7,10,0
25905,2,3,90757,90765,90768,8,11,0
25906,4,1,90761,90768,90769,7,8,0
25907,4,3,90765,90769,90772,4,7,0
25908,1,2,90766,90772,90774,6,8,0
25909,1,3,90767,90774,90777,7,10,0
25910,5,2,90772,90777,90779,5,7,0
25911,3,1,90775,90779,90780,4,5,0
25912,3,2,90778,90780,90782,2,4,0
25913,3,1,90781,90782,90783,1,2,0
25914,3,2,90784,90784,90786,0,2,1
25915,3,2,90787,90787,90789,0,2,1
25916,5,2,90792,90792,90794,0,2,3
25917,5,1,90797,90797,90798,0,1,3
25918,6,2,90803,90803,90805,0,2,5
25919,4,2,90807,90807,90809,0,2,2
25920,4,1,90811,90811,90812,0,1,2
25921,1,1,90812,90812,90813,0,1,0
25922,1,2,90813,90813,90815,0,2,0
25923,3,3,90816,90816,90819,0,3,1
25924,3,1,90819,90819,90820,0,1,0
25925,2,3,90821,90821,90824,0,3,1
25926,2,1,90823,90824,90825,1,2,0
25927,4,2,90827,90827,90829,0,2,2
25928,1,2,90828,90829,90831,1,3,0
25929,1,1,90829,90831,90832,2,3,0
25930,4,2,90833,90833,90835,0,2,1
25931,4,3,90837,90837,90840,0,3,2
25932,3,2,90840,90840,90842,0,2,0
25933,5,3,90845,90845,90848,0,3,3
25934,6,2,90851,90851,90853,0,2,3
25935,6,1,90857,90857,90858,0,1,4
25936,5,2,90862,90862,90864,0,2,4
25937,5,2,90867,90867,90869,0,2,3
25938,5,3,90872,90872,90875,0,3,3
25939,3,1,90875,90875,90876,0,1,0
25940,1,3,90876,90876,90879,0,3,0
25941,2,1,90878,90879,90880,1,2,0
25942,5,2,90883,90883,90885,0,2,3
25943,6,1,90889,90889,90890,0,1,4
25944,6,1,90895,90895,90896,0,1,5
25945,3,1,90898,90898,90899,0,1,2
25946,3,1,90901,90901,90902,0,1,2
25947,4,1,90905,90905,90906,0,1,3
25948,2,3,90907,90907,90910,0,3,1
25949,4,3,90911,90911,90914,0,3,1
25950,3,3,90914,90914,90917,0,3,0
25951,1,2,90915,90917,90919,2,4,0
25952,3,3,90918,90919,90922,1,4,0
25953,4,2,90922,90922,90924,0,2,0
25954,6,3,90928,90928,90931,0,3,4
25955,6,2,90934,90934,90936,0,2,3
25956,3,1,90937,90937,90938,0,1,1
25957,1,3,90938,90938,90941,0,3,0
25958,5,2,90943,90943,90945,0,2,2
25959,4,1,90947,90947,90948,0,1,2
25960,6,2,90953,90953,90955,0,2,5
25961,1,3,90954,90955,90958,1,4,0
25962,2,2,90956,90958,90960,2,4,0
25963,5,1,90961,90961,90962,0,1,1
25964,1,3,90962,90962,90965,0,3,0
25965,1,3,90963,90965,90968,2,5,0
25966,6,3,90969,90969,90972,0,3,1
25967,2,3,90971,90972,90975,1,4,0
25968,3,3,90974,90975,90978,1,4,0
25969,6,2,90980,90980,90982,0,2,2
25970,1,1,90981,90982,90983,1,2,0
25971,5,3,90986,90986,90989,0,3,3
25972,6,3,90992,90992,90995,0,3,3
25973,3,1,90995,90995,90996,0,1,0
25974,4,2,90999,90999,91001,0,2,3
25975,4,3,91003,91003,91006,0,3,2
25976,5,1,91008,91008,91009,0,1,2
25977,1,2,91009,91009,91011,0,2,0
25978,6,3,91015,91015,91018,0,3,4
25979,2,3,91017,91018,91021,1,4,0
25980,5,1,91022,91022,91023,0,1,1
25981,4,2,91026,91026,91028,0,2,3
25982,1,3,91027,91028,91031,1,4,0
25983,1,3,91028,91031,91034,3,6,0
25984,1,1,91029,91034,91035,5,6,0
25985,3,3,91032,91035,91038,3,6,0
25986,1,3,91033,91038,91041,5,8,0
25987,6,2,91039,91041,91043,2,4,0
25988,6,1,91045,91045,91046,0,1,2
25989,2,1,91047,91047,91048,0,1,1
25990,6,1,91053,91053,91054,0,1,5
25991,5,2,91058,91058,91060,0,2,4
25992,1,2,91059,91060,91062,1,3,0
25993,3,3,91062,91062,91065,0,3,0
25994,1,2,91063,91065,91067,2,4,0
25995,2,1,91065,91067,91068,2,3,0
25996,5,1,91070,91070,91071,0,1,2
25997,6,2,91076,91076,91078,0,2,5
25998,2,2,91078,91078,91080,0,2,0
25999,5,3,91083,91083,91086,0,3,3
26000,5,2,91088,91088,91090,0,2,2
26001,4,1,91092,91092,91093,0,1,2
26002,4,1,91096,91096,91097,0,1,3
26003,4,2,91100,91100,91102,0,2,3
26004,4,2,91104,91104,91106,0,2,2
26005,2,3,91106,91106,91109,0,3,0
26006,1,2,91107,91109,91111,2,4,0
26007,5,2,91112,91112,91114,0,2,1
26008,4,2,91116,91116,91118,0,2,2
26009,4,3,91120,91120,91123,0,3,2
26010,5,1,91125,91125,91126,0,1,2
26011,3,2,91128,91128,91130,0,2,2
26012,5,1,91133,91133,91134,0,1,3
26013,6,3,91139,91139,91142,0,3,5
26014,3,1,91142,91142,91143,0,1,0
26015,2,3,91144,91144,91147,0,3,1
26016,2,2,91146,91147,91149,1,3,0
26017,5,3,91151,91151,91154,0,3,2
26018,3,2,91154,91154,91156,0,2,0
26019,5,3,91159,91159,91162,0,3,3
26020,2,2,91161,91162,91164,1,3,0
26021,3,1,91164,91164,91165,0,1,0
26022,2,3,91166,91166,91169,0,3,1
26023,3,2,91169,91169,91171,0,2,0
26024,2,1,91171,91171,91172,0,1,0
26025,6,1,91177,91177,91178,0,1,5
26026,1,1,91178,91178,91179,0,1,0
26027,6,1,91184,91184,91185,0,1,5
26028,1,3,91185,91185,91188,0,3,0
26029,3,1,91188,91188,91189,0,1,0
26030,6,2,91194,91194,91196,0,2,5
26031,6,1,91200,91200,91201,0,1,4
26032,5,2,91205,91205,91207,0,2,4
26033,2,2,91207,91207,91209,0,2,0
26034,1,1,91208,91209,91210,1,2,0
26035,5,3,91213,91213,91216,0,3,3
26036,3,1,91216,91216,91217,0,1,0
26037,1,3,91217,91217,91220,0,3,0
26038,1,1,91218,91220,91221,2,3,0
26039,4,1,91222,91222,91223,0,1,1
26040,1,3,91223,91223,91226,0,3,0
26041,1,3,91224,91226,91229,2,5,0
26042,2,3,91226,91229,91232,3,6,0
26043,6,3,91232,91232,91235,0,3,0
26044,2,1,91234,91235,91236,1,2,0
26045,5,3,91239,91239,91242,0,3,3
26046,5,1,91244,91244,91245,0,1,2
26047,5,2,91249,91249,91251,0,2,4
26048,2,3,91251,91251,91254,0,3,0
26049,3,1,91254,91254,91255,0,1,0
26050,2,2,91256,91256,91258,0,2,1
26051,4,1,91260,91260,91261,0,1,2
26052,5,2,91265,91265,91267,0,2,4
26053,1,2,91266,91267,91269,1,3,0
26054,5,1,91271,91271,91272,0,1,2
26055,3,1,91274,91274,91275,0,1,2
26056,6,3,91280,91280,91283,0,3,5
26057,5,3,91285,91285,91288,0,3,2
26058,5,3,91290,91290,91293,0,3,2
26059,4,3,91294,91294,91297,0,3,1
26060,6,2,91300,91300,91302,0,2,3
26061,5,1,91305,91305,91306,0,1,3
26062,6,1,91311,91311,91312,0,1,5
26063,1,2,91312,91312,91314,0,2,0
26064,2,2,91314,91314,91316,0,2,0
26065,6,1,91320,91320,91321,0,1,4
26066,6,2,91326,91326,91328,0,2,5
26067,2,1,91328,91328,91329,0,1,0
26068,2,3,91330,91330,91333,0,3,1
26069,3,1,91333,91333,91334,0,1,0
26070,4,1,91337,91337,91338,0,1,3
26071,4,1,91341,91341,91342,0,1,3
26072,2,3,91343,91343,91346,0,3,1
26073,4,2,91347,91347,91349,0,2,1
26074,3,1,91350,91350,91351,0,1,1
26075,2,2,91352,91352,91354,0,2,1
26076,6,3,91358,91358,91361,0,3,4
26077,1,3,91359,91361,91364,2,5,0
26078,1,1,91360,91364,91365,4,5,0
26079,3,3,91363,91365,91368,2,5,0
26080,2,2,91365,91368,91370,3,5,0
26081,2,1,91367,91370,91371,3,4,0
26082,3,1,91370,91371,91372,1,2,0
26083,2,1,91372,91372,91373,0,1,0
26084,6,3,91378,91378,91381,0,3,5
26085,4,2,91382,91382,91384,0,2,1
26086,1,2,91383,91384,91386,1,3,0
26087,6,1,91389,91389,91390,0,1,3
26088,2,2,91391,91391,91393,0,2,1
26089,1,3,91392,91393,91396,1,4,0
26090,4,1,91396,91396,91397,0,1,0
26091,5,3,91401,91401,91404,0,3,4
26092,3,2,91404,91404,91406,0,2,0
26093,6,1,91410,91410,91411,0,1,4
26094,1,1,91411,91411,91412,0,1,0
26095,1,3,91412,91412,91415,0,3,0
26096,4,3,91416,91416,91419,0,3,1
26097,6,2,91422,91422,91424,0,2,3
26098,6,2,91428,91428,91430,0,2,4
26099,4,1,91432,91432,91433,0,1,2
26100,5,3,91437,91437,91440,0,3,4
26101,4,3,91441,91441,91444,0,3,1
26102,4,3,91445,91445,91448,0,3,1
26103,4,1,91449,91449,91450,0,1,1
26104,3,1,91452,91452,91453,0,1,2
26105,4,1,91456,91456,91457,0,1,3
26106,2,2,91458,91458,91460,0,2,1
26107,3,2,91461,91461,91463,0,2,1
26108,1,3,91462,91463,91466,1,4,0
26109,4,3,91466,91466,91469,0,3,0
26110,6,1,91472,91472,91473,0,1,3
26111,5,3,91477,91477,91480,0,3,4
26112,4,2,91481,91481,91483,0,2,1
26113,3,3,91484,91484,91487,0,3,1
26114,6,2,91490,91490,91492,0,2,3
26115,4,1,91494,91494,91495,0,1,2
26116,2,1,91496,91496,91497,0,1,1
26117,6,1,91502,91502,91503,0,1,5
26118,3,3,91505,91505,91508,0,3,2
26119,5,2,91510,91510,91512,0,2,2
26120,3,2,91513,91513,91515,0,2,1
26121,2,1,91515,91515,91516,0,1,0
26122,6,3,91521,91521,91524,0,3,5
26123,1,2,91522,91524,91526,2,4,0
26124,3,2,91525,91526,91528,1,3,0
26125,3,3,91528,91528,91531,0,3,0
26126,3,1,91531,91531,91532,0,1,0
26127,5,3,91536,91536,91539,0,3,4
26128,1,1,91537,91539,91540,2,3,0
26129,3,2,91540,91540,91542,0,2,0
26130,6,2,91546,91546,91548,0,2,4
26131,3,3,91549,91549,91552,0,3,1
26132,2,3,91551,91552,91555,1,4,0
26133,2,1,91553,91555,91556,2,3,0
26134,4,1,91557,91557,91558,0,1,1
26135,1,3,91558,91558,91561,0,3,0
26136,4,3,91562,91562,91565,0,3,1
26137,5,3,91567,91567,91570,0,3,2
26138,4,2,91571,91571,91573,0,2,1
26139,4,1,91575,91575,91576,0,1,2
26140,4,1,91579,91579,91580,0,1,3
26141,2,1,91581,91581,91582,0,1,1
26142,4,3,91585,91585,91588,0,3,3
26143,5,2,91590,91590,91592,0,2,2
26144,4,2,91594,91594,91596,0,2,2
26145,3,2,91597,91597,91599,0,2,1
26146,5,3,91602,91602,91605,0,3,3
26147,5,1,91607,91607,91608,0,1,2
26148,3,1,91610,91610,91611,0,1,2
26149,6,1,91616,91616,91617,0,1,5
26150,3,1,91619,91619,91620,0,1,2
26151,4,2,91623,91623,91625,0,2,3
26152,4,1,91627,91627,91628,0,1,2
26153,5,3,91632,91632,91635,0,3,4
26154,6,2,91638,91638,91640,0,2,3
26155,5,2,91643,91643,91645,0,2,3
26156,6,1,91649,91649,91650,0,1,4
26157,2,3,91651,91651,91654,0,3,1
26158,4,1,91655,91655,91656,0,1,1
26159,6,2,91661,91661,91663,0,2,5
26160,4,2,91665,91665,91667,0,2,2
26161,5,3,91670,91670,91673,0,3,3
26162,4,1,91674,91674,91675,0,1,1
26163,2,3,91676,91676,91679,0,3,1
26164,4,1,91680,91680,91681,0,1,1
26165,5,2,91685,91685,91687,0,2,4
26166,1,2,91686,91687,91689,1,3,0
26167,6,1,91692,91692,91693,0,1,3
26168,3,2,91695,91695,91697,0,2,2
26169,4,1,91699,91699,91700,0,1,2
26170,1,1,91700,91700,91701,0,1,0
26171,6,1,91706,91706,91707,0,1,5
26172,5,2,91711,91711,91713,0,2,4
26173,3,1,91714,91714,91715,0,1,1
26174,2,1,91716,91716,91717,0,1,1
26175,2,3,91718,91718,91721,0,3,1
26176,3,1,91721,91721,91722,0,1,0
26177,1,1,91722,91722,91723,0,1,0
26178,4,2,91726,91726,91728,0,2,3
26179,1,1,91727,91728,91729,1,2,0
26180,5,2,91732,91732,91734,0,2,3
26181,2,1,91734,91734,91735,0,1,0
26182,5,1,91739,91739,91740,0,1,4
26183,2,1,91741,91741,91742,0,1,1
26184,5,2,91746,91746,91748,0,2,4
26185,2,2,91748,91748,91750,0,2,0
26186,6,3,91754,91754,91757,0,3,4
26187,5,2,91759,91759,91761,0,2,2
26188,5,1,91764,91764,91765,0,1,3
26189,1,2,91765,91765,91767,0,2,0
26190,5,1,91770,91770,91771,0,1,3
26191,4,2,91774,91774,91776,0,2,3
26192,3,3,91777,91777,91780,0,3,1
26193,2,2,91779,91780,91782,1,3,0
26194,5,3,91784,91784,91787,0,3,2
26195,3,3,91787,91787,91790,0,3,0
26196,6,2,91793,91793,91795,0,2,3
26197,6,3,91799,91799,91802,0,3,4
26198,2,1,91801,91802,91803,1,2,0
26199,1,2,91802,91803,91805,1,3,0
26200,1,2,91803,91805,91807,2,4,0
26201,1,3,91804,91807,91810,3,6,0
26202,1,1,91805,91810,91811,5,6,0
26203,4,1,91809,91811,91812,2,3,0
26204,1,2,91810,91812,91814,2,4,0
26205,1,2,91811,91814,91816,3,5,0
26206,4,3,91815,91816,91819,1,4,0
26207,1,1,91816,91819,91820,3,4,0
26208,2,2,91818,91820,91822,2,4,0
26209,3,2,91821,91822,91824,1,3,0
26210,3,2,91824,91824,91826,0,2,0
26211,5,1,91829,91829,91830,0,1,3
26212,1,1,91830,91830,91831,0,1,0
26213,2,3,91832,91832,91835,0,3,1
26214,2,1,91834,91835,91836,1,2,0
26215,3,1,91837,91837,91838,0,1,1
26216,5,1,91842,91842,91843,0,1,4
26217,1,1,91843,91843,91844,0,1,0
26218,1,3,91844,91844,91847,0,3,0
26219,3,2,91847,91847,91849,0,2,0
26220,6,1,91853,91853,91854,0,1,4
26221,6,3,91859,91859,91862,0,3,5
26222,5,2,91864,91864,91866,0,2,2
26223,2,3,91866,91866,91869,0,3,0
26224,4,1,91870,91870,91871,0,1,1
26225,6,3,91876,91876,91879,0,3,5
26226,1,2,91877,91879,91881,2,4,0
26227,4,2,91881,91881,91883,0,2,0
26228,5,3,91886,91886,91889,0,3,3
26229,6,1,91892,91892,91893,0,1,3
26230,4,1,91896,91896,91897,0,1,3
26231,6,2,91902,91902,91904,0,2,5
26232,3,1,91905,91905,91906,0,1,1
26233,4,3,91909,91909,91912,0,3,3
26234,6,1,91915,91915,91916,0,1,3
26235,4,2,91919,91919,91921,0,2,3
26236,2,3,91921,91921,91924,0,3,0
26237,6,1,91927,91927,91928,0,1,3
26238,5,1,91932,91932,91933,0,1,4
26239,6,2,91938,91938,91940,0,2,5
26240,1,2,91939,91940,91942,1,3,0
26241,2,3,91941,91942,91945,1,4,0
26242,4,2,91945,91945,91947,0,2,0
26243,5,2,91950,91950,91952,0,2,3
26244,5,3,91955,91955,91958,0,3,3
26245,4,1,91959,91959,91960,0,1,1
26246,6,2,91965,91965,91967,0,2,5
26247,1,2,91966,91967,91969,1,3,0
26248,2,3,91968,91969,91972,1,4,0
26249,2,1,91970,91972,91973,2,3,0
26250,4,2,91974,91974,91976,0,2,1
26251,2,3,91976,91976,91979,0,3,0
26252,4,1,91980,91980,91981,0,1,1
26253,5,1,91985,91985,91986,0,1,4
26254,2,2,91987,91987,91989,0,2,1
26255,1,3,91988,91989,91992,1,4,0
26256,6,3,91994,91994,91997,0,3,2
26257,3,3,91997,91997,92000,0,3,0
26258,4,3,92001,92001,92004,0,3,1
26259,5,2,92006,92006,92008,0,2,2
26260,4,3,92010,92010,92013,0,3,2
26261,1,3,92011,92013,92016,2,5,0
26262,6,2,92017,92017,92019,0,2,1
26263,5,1,92022,92022,92023,0,1,3
26264,1,1,92023,92023,92024,0,1,0
26265,3,1,92026,92026,92027,0,1,2
26266,2,1,92028,92028,92029,0,1,1
26267,1,3,92029,92029,92032,0,3,0
26268,5,1,92034,92034,92035,0,1,2
26269,5,2,92039,92039,92041,0,2,4
26270,3,3,92042,92042,92045,0,3,1
26271,3,1,92045,92045,92046,0,1,0
26272,4,3,92049,92049,92052,0,3,3
26273,6,2,92055,92055,92057,0,2,3
26274,1,3,92056,92057,92060,1,4,0
26275,5,1,92061,92061,92062,0,1,1
26276,6,3,92067,92067,92070,0,3,5
26277,2,2,92069,92070,92072,1,3,0
26278,5,2,92074,92074,92076,0,2,2
26279,2,3,92076,92076,92079,0,3,0
26280,3,1,92079,92079,92080,0,1,0
26281,2,1,92081,92081,92082,0,1,1
26282,3,3,92084,92084,92087,0,3,2
26283,4,3,92088,92088,92091,0,3,1
26284,1,2,92089,92091,92093,2,4,0
26285,2,3,92091,92093,92096,2,5,0
26286,5,1,92096,92096,92097,0,1,0
26287,1,1,92097,92097,92098,0,1,0
26288,4,1,92101,92101,92102,0,1,3
26289,6,2,92107,92107,92109,0,2,5
26290,5,1,92112,92112,92113,0,1,3
26291,2,3,92114,92114,92117,0,3,1
26292,2,3,92116,92117,92120,1,4,0
26293,3,2,92119,92120,92122,1,3,0
26294,1,1,92120,92122,92123,2,3,0
26295,2,2,92122,92123,92125,1,3,0
26296,4,1,92126,92126,92127,0,1,1
26297,5,2,92131,92131,92133,0,2,4
26298,3,1,92134,92134,92135,0,1,1
26299,6,2,92140,92140,92142,0,2,5
26300,3,1,92143,92143,92144,0,1,1
26301,6,1,92149,92149,92150,0,1,5
26302,6,3,92155,92155,92158,0,3,5
26303,3,1,92158,92158,92159,0,1,0
26304,3,1,92161,92161,92162,0,1,2
26305,3,1,92164,92164,92165,0,1,2
26306,4,2,92168,92168,92170,0,2,3
26307,6,3,92174,92174,92177,0,3,4
26308,6,1,92180,92180,92181,0,1,3
26309,5,2,92185,92185,92187,0,2,4
26310,2,2,92187,92187,92189,0,2,0
26311,2,1,92189,92189,92190,0,1,0
26312,6,1,92195,92195,92196,0,1,5
26313,6,1,92201,92201,92202,0,1,5
26314,1,1,92202,92202,92203,0,1,0
26315,6,1,92208,92208,92209,0,1,5
26316,2,2,92210,92210,92212,0,2,1
26317,4,2,92214,92214,92216,0,2,2
26318,2,2,92216,92216,92218,0,2,0
26319,3,1,92219,92219,92220,0,1,1
26320,5,1,92224,92224,92225,0,1,4
26321,2,3,92226,92226,92229,0,3,1
26322,6,3,92232,92232,92235,0,3,3
26323,3,3,92235,92235,92238,0,3,0
26324,5,3,92240,92240,92243,0,3,2
26325,4,2,92244,92244,92246,0,2,1
26326,6,2,92250,92250,92252,0,2,4
26327,4,1,92254,92254,92255,0,1,2
26328,6,3,92260,92260,92263,0,3,5
26329,5,3,92265,92265,92268,0,3,2
26330,6,3,92271,92271,92274,0,3,3
26331,3,2,92274,92274,92276,0,2,0
26332,1,2,92275,92276,92278,1,3,0
26333,4,3,92279,92279,92282,0,3,1
26334,3,3,92282,92282,92285,0,3,0
26335,1,2,92283,92285,92287,2,4,0
26336,1,2,92284,92287,92289,3,5,0
26337,2,1,92286,92289,92290,3,4,0
26338,6,3,92292,92292,92295,0,3,2
26339,3,3,92295,92295,92298,0,3,0
26340,6,1,92301,92301,92302,0,1,3
26341,5,1,92306,92306,92307,0,1,4
26342,3,1,92309,92309,92310,0,1,2
26343,4,2,92313,92313,92315,0,2,3
26344,6,1,92319,92319,92320,0,1,4
26345,3,3,92322,92322,92325,0,3,2
26346,5,1,92327,92327,92328,0,1,2
26347,6,1,92333,92333,92334,0,1,5
26348,5,3,92338,92338,92341,0,3,4
26349,1,3,92339,92341,92344,2,5,0
26350,3,2,92342,92344,92346,2,4,0
26351,4,2,92346,92346,92348,0,2,0
26352,6,3,92352,92352,92355,0,3,4
26353,4,3,92356,92356,92359,0,3,1
26354,1,2,92357,92359,92361,2,4,0
26355,5,3,92362,92362,92365,0,3,1
26356,5,1,92367,92367,92368,0,1,2
26357,3,2,92370,92370,92372,0,2,2
26358,6,3,92376,92376,92379,0,3,4
26359,5,3,92381,92381,92384,0,3,2
26360,2,1,92383,92384,92385,1,2,0
26361,4,2,92387,92387,92389,0,2,2
26362,1,3,92388,92389,92392,1,4,0
26363,4,1,92392,92392,92393,0,1,0
26364,3,2,92395,92395,92397,0,2,2
26365,4,2,92399,92399,92401,0,2,2
26366,6,3,92405,92405,92408,0,3,4
26367,4,1,92409,92409,92410,0,1,1
26368,5,1,92414,92414,92415,0,1,4
26369,6,2,92420,92420,92422,0,2,5
26370,4,3,92424,92424,92427,0,3,2
26371,3,2,92427,92427,92429,0,2,0
26372,3,1,92430,92430,92431,0,1,1
26373,3,2,92433,92433,92435,0,2,2
26374,4,1,92437,92437,92438,0,1,2
26375,3,2,92440,92440,92442,0,2,2
26376,4,3,92444,92444,92447,0,3,2
26377,4,1,92448,92448,92449,0,1,1
26378,4,2,92452,92452,92454,0,2,3
26379,3,2,92455,92455,92457,0,2,1
26380,2,2,92457,92457,92459,0,2,0
26381,1,3,92458,92459,92462,1,4,0
26382,2,1,92460,92462,92463,2,3,0
26383,1,1,92461,92463,92464,2,3,0
26384,1,3,92462,92464,92467,2,5,0
26385,6,3,92468,92468,92471,0,3,1
26386,5,2,92473,92473,92475,0,2,2
26387,4,3,92477,92477,92480,0,3,2
26388,3,1,92480,92480,92481,0,1,0
26389,5,3,92485,92485,92488,0,3,4
26390,4,2,92489,92489,92491,0,2,1
26391,4,3,92493,92493,92496,0,3,2
26392,6,2,92499,92499,92501,0,2,3
26393,3,3,92502,92502,92505,0,3,1
26394,6,1,92508,92508,92509,0,1,3
26395,4,2,92512,92512,92514,0,2,3
26396,3,1,92515,92515,92516,0,1,1
26397,5,1,92520,92520,92521,0,1,4
26398,6,1,92526,92526,92527,0,1,5
26399,2,3,92528,92528,92531,0,3,1
26400,1,2,92529,92531,92533,2,4,0
26401,1,2,92530,92533,92535,3,5,0
26402,3,3,92533,92535,92538,2,5,0
26403,4,2,92537,92538,92540,1,3,0
26404,2,3,92539,92540,92543,1,4,0
26405,2,3,92541,92543,92546,2,5,0
26406,4,3,92545,92546,92549,1,4,0
26407,4,3,92549,92549,92552,0,3,0
26408,2,3,92551,92552,92555,1,4,0
26409,3,3,92554,92555,92558,1,4,0
26410,6,3,92560,92560,92563,0,3,2
26411,3,3,92563,92563,92566,0,3,0
26412,5,3,92568,92568,92571,0,3,2
26413,2,1,92570,92571,92572,1,2,0
26414,2,2,92572,92572,92574,0,2,0
26415,1,3,92573,92574,92577,1,4,0
26416,3,1,92576,92577,92578,1,2,0
26417,1,2,92577,92578,92580,1,3,0
26418,4,2,92581,92581,92583,0,2,1
26419,6,2,92587,92587,92589,0,2,4
26420,5,1,92592,92592,92593,0,1,3
26421,1,2,92593,92593,92595,0,2,0
26422,3,1,92596,92596,92597,0,1,1
26423,1,2,92597,92597,92599,0,2,0
26424,1,3,92598,92599,92602,1,4,0
26425,1,1,92599,92602,92603,3,4,0
26426,6,1,92605,92605,92606,0,1,2
26427,4,3,92609,92609,92612,0,3,3
26428,3,3,92612,92612,92615,0,3,0
26429,2,2,92614,92615,92617,1,3,0
26430,3,3,92617,92617,92620,0,3,0
26431,1,1,92618,92620,92621,2,3,0
26432,1,2,92619,92621,92623,2,4,0
26433,3,1,92622,92623,92624,1,2,0
26434,6,3,92628,92628,92631,0,3,4
26435,2,1,92630,92631,92632,1,2,0
26436,2,2,92632,92632,92634,0,2,0
26437,5,1,92637,92637,92638,0,1,3
26438,6,3,92643,92643,92646,0,3,5
26439,4,3,92647,92647,92650,0,3,1
26440,2,3,92649,92650,92653,1,4,0
26441,6,3,92655,92655,92658,0,3,2
26442,4,1,92659,92659,92660,0,1,1
26443,3,1,92662,92662,92663,0,1,2
26444,3,3,92665,92665,92668,0,3,2
26445,4,2,92669,92669,92671,0,2,1
26446,4,2,92673,92673,92675,0,2,2
26447,3,1,92676,92676,92677,0,1,1
26448,6,1,92682,92682,92683,0,1,5
26449,1,3,92683,92683,92686,0,3,0
26450,1,2,92684,92686,92688,2,4,0
26451,6,3,92690,92690,92693,0,3,2
26452,3,3,92693,92693,92696,0,3,0
26453,3,1,92696,92696,92697,0,1,0
26454,6,2,92702,92702,92704,0,2,5
26455,1,1,92703,92704,92705,1,2,0
26456,2,3,92705,92705,92708,0,3,0
26457,3,1,92708,92708,92709,0,1,0
26458,5,1,92713,92713,92714,0,1,4
26459,3,1,92716,92716,92717,0,1,2
26460,1,1,92717,92717,92718,0,1,0
26461,5,3,92722,92722,92725,0,3,4
26462,5,2,92727,92727,92729,0,2,2
26463,1,1,92728,92729,92730,1,2,0
26464,1,2,92729,92730,92732,1,3,0
26465,3,1,92732,92732,92733,0,1,0
26466,4,1,92736,92736,92737,0,1,3
26467,5,3,92741,92741,92744,0,3,4
26468,4,3,92745,92745,92748,0,3,1
26469,5,1,92750,92750,92751,0,1,2
26470,2,2,92752,92752,92754,0,2,1
26471,3,2,92755,92755,92757,0,2,1
26472,4,3,92759,92759,92762,0,3,2
26473,3,2,92762,92762,92764,0,2,0
26474,3,1,92765,92765,92766,0,1,1
26475,2,2,92767,92767,92769,0,2,1
26476,3,2,92770,92770,92772,0,2,1
26477,2,1,92772,92772,92773,0,1,0
26478,6,2,92778,92778,92780,0,2,5
26479,6,3,92784,92784,92787,0,3,4
26480,6,3,92790,92790,92793,0,3,3
26481,5,1,92795,92795,92796,0,1,2
26482,2,1,92797,92797,92798,0,1,1
26483,1,2,92798,92798,92800,0,2,0
26484,1,1,92799,92800,92801,1,2,0
26485,2,2,92801,92801,92803,0,2,0
26486,1,2,92802,92803,92805,1,3,0
26487,5,1,92807,92807,92808,0,1,2
26488,6,2,92813,92813,92815,0,2,5
26489,3,1,92816,92816,92817,0,1,1
26490,2,3,92818,92818,92821,0,3,1
26491,1,1,92819,92821,92822,2,3,0
26492,1,3,92820,92822,92825,2,5,0
26493,5,3,92825,92825,92828,0,3,0
26494,1,3,92826,92828,92831,2,5,0
26495,4,3,92830,92831,92834,1,4,0
26496,3,3,92833,92834,92837,1,4,0
26497,2,1,92835,92837,92838,2,3,0
26498,3,3,92838,92838,92841,0,3,0
26499,1,1,92839,92841,92842,2,3,0
26500,1,2,92840,92842,92844,2,4,0
26501,3,1,92843,92844,92845,1,2,0
26502,5,2,92848,92848,92850,0,2,3
26503,3,1,92851,92851,92852,0,1,1
26504,4,3,92855,92855,92858,0,3,3
26505,2,2,92857,92858,92860,1,3,0
26506,4,1,92861,92861,92862,0,1,1
26507,1,2,92862,92862,92864,0,2,0
26508,5,2,92867,92867,92869,0,2,3
26509,2,2,92869,92869,92871,0,2,0
26510,3,2,92872,92872,92874,0,2,1
26511,6,3,92878,92878,92881,0,3,4
26512,2,1,92880,92881,92882,1,2,0
26513,6,2,92886,92886,92888,0,2,4
26514,6,1,92892,92892,92893,0,1,4
26515,5,3,92897,92897,92900,0,3,4
26516,5,3,92902,92902,92905,0,3,2
26517,5,3,92907,92907,92910,0,3,2
26518,1,2,92908,92910,92912,2,4,0
26519,5,2,92913,92913,92915,0,2,1
26520,4,3,92917,92917,92920,0,3,2
26521,2,2,92919,92920,92922,1,3,0
26522,3,3,92922,92922,92925,0,3,0
26523,3,2,92925,92925,92927,0,2,0
26524,6,2,92931,92931,92933,0,2,4
26525,6,3,92937,92937,92940,0,3,4
26526,2,3,92939,92940,92943,1,4,0
26527,1,3,92940,92943,92946,3,6,0
26528,2,2,92942,92946,92948,4,6,0
26529,2,1,92944,92948,92949,4,5,0
26530,3,3,92947,92949,92952,2,5,0
26531,6,1,92953,92953,92954,0,1,1
26532,5,2,92958,92958,92960,0,2,4
26533,5,3,92963,92963,92966,0,3,3
26534,6,2,92969,92969,92971,0,2,3
26535,4,3,92973,92973,92976,0,3,2
26536,1,3,92974,92976,92979,2,5,0
26537,3,3,92977,92979,92982,2,5,0
26538,2,3,92979,92982,92985,3,6,0
26539,5,2,92984,92985,92987,1,3,0
26540,3,3,92987,92987,92990,0,3,0
26541,5,2,92992,92992,92994,0,2,2
26542,4,2,92996,92996,92998,0,2,2
26543,1,2,92997,92998,93000,1,3,0
26544,6,3,93003,93003,93006,0,3,3
26545,3,2,93006,93006,93008,0,2,0
26546,6,2,93012,93012,93014,0,2,4
26547,5,1,93017,93017,93018,0,1,3
26548,5,2,93022,93022,93024,0,2,4
26549,3,1,93025,93025,93026,0,1,1
26550,3,1,93028,93028,93029,0,1,2
26551,2,3,93030,93030,93033,0,3,1
26552,5,3,93035,93035,93038,0,3,2
26553,1,1,93036,93038,93039,2,3,0
26554,3,3,93039,93039,93042,0,3,0
26555,5,1,93044,93044,93045,0,1,2
26556,4,3,93048,93048,93051,0,3,3
26557,4,2,93052,93052,93054,0,2,1
26558,5,3,93057,93057,93060,0,3,3
26559,2,1,93059,93060,93061,1,2,0
26560,2,1,93061,93061,93062,0,1,0
26561,1,3,93062,93062,93065,0,3,0
26562,5,3,93067,93067,93070,0,3,2
26563,3,2,93070,93070,93072,0,2,0
26564,6,3,93076,93076,93079,0,3,4
26565,2,2,93078,93079,93081,1,3,0
26566,2,1,93080,93081,93082,1,2,0
26567,6,3,93086,93086,93089,0,3,4
26568,1,3,93087,93089,93092,2,5,0
26569,6,1,93093,93093,93094,0,1,1
26570,4,1,93097,93097,93098,0,1,3
26571,1,3,93098,93098,93101,0,3,0
26572,2,2,93100,93101,93103,1,3,0
26573,6,1,93106,93106,93107,0,1,3
26574,2,3,93108,93108,93111,0,3,1
26575,4,3,93112,93112,93115,0,3,1
26576,5,2,93117,93117,93119,0,2,2
26577,1,1,93118,93119,93120,1,2,0
26578,5,3,93123,93123,93126,0,3,3
26579,1,2,93124,93126,93128,2,4,0
26580,2,3,93126,93128,93131,2,5,0
26581,6,3,93132,93132,93135,0,3,1
26582,5,2,93137,93137,93139,0,2,2
26583,3,1,93140,93140,93141,0,1,1
26584,6,2,93146,93146,93148,0,2,5
26585,2,3,93148,93148,93151,0,3,0
26586,6,1,93154,93154,93155,0,1,3
26587,1,2,93155,93155,93157,0,2,0
26588,3,3,93158,93158,93161,0,3,1
26589,5,3,93163,93163,93166,0,3,2
26590,6,2,93169,93169,93171,0,2,3
26591,1,2,93170,93171,93173,1,3,0
26592,6,2,93176,93176,93178,0,2,3
26593,2,1,93178,93178,93179,0,1,0
26594,1,3,93179,93179,93182,0,3,0
26595,5,1,93184,93184,93185,0,1,2
26596,3,3,93187,93187,93190,0,3,2
26597,1,3,93188,93190,93193,2,5,0
26598,3,2,93191,93193,93195,2,4,0
26599,3,2,93194,93195,93197,1,3,0
26600,6,2,93200,93200,93202,0,2,3
26601,6,2,93206,93206,93208,0,2,4
26602,1,3,93207,93208,93211,1,4,0
26603,6,2,93213,93213,93215,0,2,2
26604,1,3,93214,93215,93218,1,4,0
26605,3,1,93217,93218,93219,1,2,0
26606,4,1,93221,93221,93222,0,1,2
26607,6,2,93227,93227,93229,0,2,5
26608,4,2,93231,93231,93233,0,2,2
26609,3,3,93234,93234,93237,0,3,1
26610,4,3,93238,93238,93241,0,3,1
26611,3,2,93241,93241,93243,0,2,0
26612,4,1,93245,93245,93246,0,1,2
26613,1,1,93246,93246,93247,0,1,0
26614,2,2,93248,93248,93250,0,2,1
26615,6,2,93254,93254,93256,0,2,4
26616,2,3,93256,93256,93259,0,3,0
26617,5,2,93261,93261,93263,0,2,2
26618,5,1,93266,93266,93267,0,1,3
26619,6,2,93272,93272,93274,0,2,5
26620,4,3,93276,93276,93279,0,3,2
26621,2,3,93278,93279,93282,1,4,0
26622,3,3,93281,93282,93285,1,4,0
26623,3,2,93284,93285,93287,1,3,0
26624,2,3,93286,93287,93290,1,4,0
26625,3,2,93289,93290,93292,1,3,0
26626,4,1,93293,93293,93294,0,1,1
26627,5,1,93298,93298,93299,0,1,4
26628,6,1,93304,93304,93305,0,1,5
26629,1,1,93305,93305,93306,0,1,0
26630,6,2,93311,93311,93313,0,2,5
26631,3,1,93314,93314,93315,0,1,1
26632,5,2,93319,93319,93321,0,2,4
26633,4,3,93323,93323,93326,0,3,2
26634,6,2,93329,93329,93331,0,2,3
26635,4,2,93333,93333,93335,0,2,2
26636,5,2,93338,93338,93340,0,2,3
26637,5,3,93343,93343,93346,0,3,3
26638,5,1,93348,93348,93349,0,1,2
26639,4,2,93352,93352,93354,0,2,3
26640,3,2,93355,93355,93357,0,2,1
26641,4,2,93359,93359,93361,0,2,2
26642,4,3,93363,93363,93366,0,3,2
26643,4,3,93367,93367,93370,0,3,1
26644,3,2,93370,93370,93372,0,2,0
26645,4,3,93374,93374,93377,0,3,2
26646,5,2,93379,93379,93381,0,2,2
26647,3,1,93382,93382,93383,0,1,1
26648,4,1,93386,93386,93387,0,1,3
26649,5,2,93391,93391,93393,0,2,4
26650,1,2,93392,93393,93395,1,3,0
26651,1,3,93393,93395,93398,2,5,0
26652,6,3,93399,93399,93402,0,3,1
26653,4,1,93403,93403,93404,0,1,1
26654,4,3,93407,93407,93410,0,3,3
26655,2,3,93409,93410,93413,1,4,0
26656,2,2,93411,93413,93415,2,4,0
26657,6,2,93417,93417,93419,0,2,2
26658,6,3,93423,93423,93426,0,3,4
26659,1,1,93424,93426,93427,2,3,0
26660,5,1,93429,93429,93430,0,1,2
26661,6,1,93435,93435,93436,0,1,5
26662,3,3,93438,93438,93441,0,3,2
26663,1,3,93439,93441,93444,2,5,0
26664,4,1,93443,93444,93445,1,2,0
26665,4,3,93447,93447,93450,0,3,2
26666,3,1,93450,93450,93451,0,1,0
26667,4,1,93454,93454,93455,0,1,3
26668,1,3,93455,93455,93458,0,3,0
26669,5,2,93460,93460,93462,0,2,2
26670,1,1,93461,93462,93463,1,2,0
26671,6,3,93467,93467,93470,0,3,4
26672,3,2,93470,93470,93472,0,2,0
26673,1,2,93471,93472,93474,1,3,0
26674,3,1,93474,93474,93475,0,1,0
26675,6,2,93480,93480,93482,0,2,5
26676,1,2,93481,93482,93484,1,3,0
26677,3,3,93484,93484,93487,0,3,0
26678,4,1,93488,93488,93489,0,1,1
26679,1,3,93489,93489,93492,0,3,0
26680,6,2,93495,93495,93497,0,2,3
26681,3,2,93498,93498,93500,0,2,1
26682,4,2,93502,93502,93504,0,2,2
26683,1,2,93503,93504,93506,1,3,0
26684,4,3,93507,93507,93510,0,3,1
26685,4,3,93511,93511,93514,0,3,1
26686,6,1,93517,93517,93518,0,1,3
26687,2,2,93519,93519,93521,0,2,1
26688,3,1,93522,93522,93523,0,1,1
26689,3,1,93525,93525,93526,0,1,2
26690,1,1,93526,93526,93527,0,1,0
26691,4,1,93530,93530,93531,0,1,3
26692,5,2,93535,93535,93537,0,2,4
26693,2,1,93537,93537,93538,0,1,0
26694,1,1,93538,93538,93539,0,1,0
26695,2,2,93540,93540,93542,0,2,1
26696,3,2,93543,93543,93545,0,2,1
26697,4,2,93547,93547,93549,0,2,2
26698,5,1,93552,93552,93553,0,1,3
26699,1,1,93553,93553,93554,0,1,0
26700,4,2,93557,93557,93559,0,2,3
26701,1,1,93558,93559,93560,1,2,0
26702,1,2,93559,93560,93562,1,3,0
26703,2,2,93561,93562,93564,1,3,0
26704,5,2,93566,93566,93568,0,2,2
26705,4,1,93570,93570,93571,0,1,2
26706,4,3,93574,93574,93577,0,3,3
26707,4,3,93578,93578,93581,0,3,1
26708,5,1,93583,93583,93584,0,1,2
26709,2,2,93585,93585,93587,0,2,1
26710,5,1,93590,93590,93591,0,1,3
26711,5,3,93595,93595,93598,0,3,4
26712,3,1,93598,93598,93599,0,1,0
26713,5,1,93603,93603,93604,0,1,4
26714,4,3,93607,93607,93610,0,3,3
26715,1,2,93608,93610,93612,2,4,0
26716,2,1,93610,93612,93613,2,3,0
26717,5,3,93615,93615,93618,0,3,2
26718,1,2,93616,93618,93620,2,4,0
26719,6,3,93622,93622,93625,0,3,2
26720,5,1,93627,93627,93628,0,1,2
26721,3,3,93630,93630,93633,0,3,2
26722,6,1,93636,93636,93637,0,1,3
26723,1,2,93637,93637,93639,0,2,0
26724,1,3,93638,93639,93642,1,4,0
26725,3,1,93641,93642,93643,1,2,0
26726,6,1,93647,93647,93648,0,1,4
26727,1,2,93648,93648,93650,0,2,0
26728,4,1,93652,93652,93653,0,1,2
26729,3,1,93655,93655,93656,0,1,2
26730,6,3,93661,93661,93664,0,3,5
26731,1,2,93662,93664,93666,2,4,0
26732,5,2,93667,93667,93669,0,2,1
26733,1,1,93668,93669,93670,1,2,0
26734,3,3,93671,93671,93674,0,3,1
26735,6,2,93677,93677,93679,0,2,3
26736,4,3,93681,93681,93684,0,3,2
26737,6,1,93687,93687,93688,0,1,3
26738,4,1,93691,93691,93692,0,1,3
26739,4,2,93695,93695,93697,0,2,3
26740,4,2,93699,93699,93701,0,2,2
26741,6,1,93705,93705,93706,0,1,4
26742,1,1,93706,93706,93707,0,1,0
26743,1,1,93707,93707,93708,0,1,0
26744,4,3,93711,93711,93714,0,3,3
26745,4,2,93715,93715,93717,0,2,1
26746,2,1,93717,93717,93718,0,1,0
26747,4,2,93721,93721,93723,0,2,3
26748,1,1,93722,93723,93724,1,2,0
26749,1,2,93723,93724,93726,1,3,0
26750,4,3,93727,93727,93730,0,3,1
26751,6,1,93733,93733,93734,0,1,3
26752,5,1,93738,93738,93739,0,1,4
26753,6,2,93744,93744,93746,0,2,5
26754,4,1,93748,93748,93749,0,1,2
26755,2,2,93750,93750,93752,0,2,1
26756,3,2,93753,93753,93755,0,2,1
26757,6,1,93759,93759,93760,0,1,4
26758,5,2,93764,93764,93766,0,2,4
26759,6,3,93770,93770,93773,0,3,4
26760,4,2,93774,93774,93776,0,2,1
26761,6,1,93780,93780,93781,0,1,4
26762,5,3,93785,93785,93788,0,3,4
26763,4,3,93789,93789,93792,0,3,1
26764,3,2,93792,93792,93794,0,2,0
26765,6,3,93798,93798,93801,0,3,4
26766,4,2,93802,93802,93804,0,2,1
26767,4,1,93806,93806,93807,0,1,2
26768,2,1,93808,93808,93809,0,1,1
26769,1,1,93809,93809,93810,0,1,0
26770,2,3,93811,93811,93814,0,3,1
26771,1,1,93812,93814,93815,2,3,0
26772,1,3,93813,93815,93818,2,5,0
26773,2,1,93815,93818,93819,3,4,0
26774,6,3,93821,93821,93824,0,3,2
26775,2,1,93823,93824,93825,1,2,0
26776,6,2,93829,93829,93831,0,2,4
26777,6,2,93835,93835,93837,0,2,4
26778,6,2,93841,93841,93843,0,2,4
26779,2,1,93843,93843,93844,0,1,0
26780,6,1,93849,93849,93850,0,1,5
26781,1,3,93850,93850,93853,0,3,0
26782,1,2,93851,93853,93855,2,4,0
26783,5,3,93856,93856,93859,0,3,1
26784,6,1,93862,93862,93863,0,1,3
26785,4,3,93866,93866,93869,0,3,3
26786,4,3,93870,93870,93873,0,3,1
26787,3,2,93873,93873,93875,0,2,0
26788,5,2,93878,93878,93880,0,2,3
26789,1,3,93879,93880,93883,1,4,0
26790,1,3,93880,93883,93886,3,6,0
26791,6,1,93886,93886,93887,0,1,0
26792,1,2,93887,93887,93889,0,2,0
26793,5,3,93892,93892,93895,0,3,3
26794,6,2,93898,93898,93900,0,2,3
26795,4,2,93902,93902,93904,0,2,2
26796,1,3,93903,93904,93907,1,4,0
26797,1,3,93904,93907,93910,3,6,0
26798,4,2,93908,93910,93912,2,4,0
26799,5,3,93913,93913,93916,0,3,1
26800,1,2,93914,93916,93918,2,4,0
26801,6,2,93920,93920,93922,0,2,2
26802,2,2,93922,93922,93924,0,2,0
26803,4,1,93926,93926,93927,0,1,2
26804,5,3,93931,93931,93934,0,3,4
26805,2,2,93933,93934,93936,1,3,0
26806,5,2,93938,93938,93940,0,2,2
26807,2,2,93940,93940,93942,0,2,0
26808,1,2,93941,93942,93944,1,3,0
26809,4,3,93945,93945,93948,0,3,1
26810,5,2,93950,93950,93952,0,2,2
26811,6,1,93956,93956,93957,0,1,4
26812,4,3,93960,93960,93963,0,3,3
26813,3,1,93963,93963,93964,0,1,0
26814,5,3,93968,93968,93971,0,3,4
26815,1,2,93969,93971,93973,2,4,0
26816,1,3,93970,93973,93976,3,6,0
26817,2,3,93972,93976,93979,4,7,0
26818,4,1,93976,93979,93980,3,4,0
26819,6,2,93982,93982,93984,0,2,2
26820,2,3,93984,93984,93987,0,3,0
26821,3,2,93987,93987,93989,0,2,0
26822,5,3,93992,93992,93995,0,3,3
26823,1,3,93993,93995,93998,2,5,0
26824,5,1,93998,93998,93999,0,1,0
26825,2,1,94000,94000,94001,0,1,1
26826,5,3,94005,94005,94008,0,3,4
26827,4,3,94009,94009,94012,0,3,1
26828,2,3,94011,94012,94015,1,4,0
26829,5,2,94016,94016,94018,0,2,1
26830,6,3,94022,94022,94025,0,3,4
26831,1,1,94023,94025,94026,2,3,0
26832,6,2,94029,94029,94031,0,2,3
26833,3,1,94032,94032,94033,0,1,1
26834,6,3,94038,94038,94041,0,3,5
26835,5,3,94043,94043,94046,0,3,2
26836,1,2,94044,94046,94048,2,4,0
26837,6,2,94050,94050,94052,0,2,2
26838,6,1,94056,94056,94057,0,1,4
26839,3,2,94059,94059,94061,0,2,2
26840,2,2,94061,94061,94063,0,2,0
26841,6,3,94067,94067,94070,0,3,4
26842,3,3,94070,94070,94073,0,3,0
26843,4,2,94074,94074,94076,0,2,1
26844,3,3,94077,94077,94080,0,3,1
26845,2,1,94079,94080,94081,1,2,0
26846,2,1,94081,94081,94082,0,1,0
26847,4,3,94085,94085,94088,0,3,3
26848,2,1,94087,94088,94089,1,2,0
26849,5,3,94092,94092,94095,0,3,3
26850,6,2,94098,94098,94100,0,2,3
26851,2,3,94100,94100,94103,0,3,0
26852,3,1,94103,94103,94104,0,1,0
26853,2,3,94105,94105,94108,0,3,1
26854,6,2,94111,94111,94113,0,2,3
26855,5,1,94116,94116,94117,0,1,3
26856,6,1,94122,94122,94123,0,1,5
26857,1,2,94123,94123,94125,0,2,0
26858,2,2,94125,94125,94127,0,2,0
26859,5,3,94130,94130,94133,0,3,3
26860,2,2,94132,94133,94135,1,3,0
26861,5,1,94137,94137,94138,0,1,2
26862,2,1,94139,94139,94140,0,1,1
26863,6,1,94145,94145,94146,0,1,5
26864,5,3,94150,94150,94153,0,3,4
26865,6,1,94156,94156,94157,0,1,3
26866,5,1,94161,94161,94162,0,1,4
26867,5,3,94166,94166,94169,0,3,4
26868,1,1,94167,94169,94170,2,3,0
26869,1,1,94168,94170,94171,2,3,0
26870,4,2,94172,94172,94174,0,2,1
26871,6,1,94178,94178,94179,0,1,4
26872,2,1,94180,94180,94181,0,1,1
26873,5,1,94185,94185,94186,0,1,4
26874,3,1,94188,94188,94189,0,1,2
26875,2,3,94190,94190,94193,0,3,1
26876,5,1,94195,94195,94196,0,1,2
26877,6,2,94201,94201,94203,0,2,5
26878,6,1,94207,94207,94208,0,1,4
26879,6,1,94213,94213,94214,0,1,5
26880,5,2,94218,94218,94220,0,2,4
26881,6,3,94224,94224,94227,0,3,4
26882,1,1,94225,94227,94228,2,3,0
26883,1,2,94226,94228,94230,2,4,0
26884,5,1,94231,94231,94232,0,1,1
26885,2,2,94233,94233,94235,0,2,1
26886,3,1,94236,94236,94237,0,1,1
26887,4,1,94240,94240,94241,0,1,3
26888,6,1,94246,94246,94247,0,1,5
26889,3,2,94249,94249,94251,0,2,2
26890,3,2,94252,94252,94254,0,2,1
26891,5,2,94257,94257,94259,0,2,3
26892,1,1,94258,94259,94260,1,2,0
26893,5,1,94263,94263,94264,0,1,3
26894,5,1,94268,94268,94269,0,1,4
26895,5,3,94273,94273,94276,0,3,4
26896,2,2,94275,94276,94278,1,3,0
26897,4,1,94279,94279,94280,0,1,1
26898,6,3,94285,94285,94288,0,3,5
26899,5,3,94290,94290,94293,0,3,2
26900,1,2,94291,94293,94295,2,4,0
26901,1,3,94292,94295,94298,3,6,0
26902,4,2,94296,94298,94300,2,4,0
26903,1,2,94297,94300,94302,3,5,0
26904,2,2,94299,94302,94304,3,5,0
26905,1,3,94300,94304,94307,4,7,0
26906,6,3,94306,94307,94310,1,4,0
26907,6,3,94312,94312,94315,0,3,2
26908,5,3,94317,94317,94320,0,3,2
26909,3,2,94320,94320,94322,0,2,0
26910,6,3,94326,94326,94329,0,3,4
26911,1,3,94327,94329,94332,2,5,0
26912,5,2,94332,94332,94334,0,2,0
26913,5,3,94337,94337,94340,0,3,3
26914,3,1,94340,94340,94341,0,1,0
26915,5,1,94345,94345,94346,0,1,4
26916,5,1,94350,94350,94351,0,1,4
26917,3,2,94353,94353,94355,0,2,2
26918,4,3,94357,94357,94360,0,3,2
26919,5,2,94362,94362,94364,0,2,2
26920,4,1,94366,94366,94367,0,1,2
26921,5,3,94371,94371,94374,0,3,4
26922,1,3,94372,94374,94377,2,5,0
26923,5,1,94377,94377,94378,0,1,0
26924,4,2,94381,94381,94383,0,2,3
26925,3,1,94384,94384,94385,0,1,1
26926,6,3,94390,94390,94393,0,3,5
26927,2,2,94392,94393,94395,1,3,0
26928,4,3,94396,94396,94399,0,3,1
26929,6,2,94402,94402,94404,0,2,3
26930,5,2,94407,94407,94409,0,2,3
26931,5,2,94412,94412,94414,0,2,3
26932,2,1,94414,94414,94415,0,1,0
26933,5,3,94419,94419,94422,0,3,4
26934,6,3,94425,94425,94428,0,3,3
26935,3,2,94428,94428,94430,0,2,0
26936,1,3,94429,94430,94433,1,4,0
26937,5,2,94434,94434,94436,0,2,1
26938,3,2,94437,94437,94439,0,2,1
26939,2,3,94439,94439,94442,0,3,0
26940,3,1,94442,94442,94443,0,1,0
26941,3,2,94445,94445,94447,0,2,2
26942,4,1,94449,94449,94450,0,1,2
26943,5,2,94454,94454,94456,0,2,4
26944,6,1,94460,94460,94461,0,1,4
26945,5,1,94465,94465,94466,0,1,4
26946,1,3,94466,94466,94469,0,3,0
26947,5,2,94471,94471,94473,0,2,2
26948,1,1,94472,94473,94474,1,2,0
26949,4,3,94476,94476,94479,0,3,2
26950,3,1,94479,94479,94480,0,1,0
26951,6,3,94485,94485,94488,0,3,5
26952,4,2,94489,94489,94491,0,2,1
26953,4,3,94493,94493,94496,0,3,2
26954,6,1,94499,94499,94500,0,1,3
26955,1,1,94500,94500,94501,0,1,0
26956,2,2,94502,94502,94504,0,2,1
26957,4,1,94506,94506,94507,0,1,2
26958,4,1,94510,94510,94511,0,1,3
26959,6,1,94516,94516,94517,0,1,5
26960,2,1,94518,94518,94519,0,1,1
26961,2,2,94520,94520,94522,0,2,1
26962,6,2,94526,94526,94528,0,2,4
26963,4,2,94530,94530,94532,0,2,2
26964,1,3,94531,94532,94535,1,4,0
26965,6,2,94537,94537,94539,0,2,2
26966,6,2,94543,94543,94545,0,2,4
26967,4,2,94547,94547,94549,0,2,2
26968,5,2,94552,94552,94554,0,2,3
26969,2,2,94554,94554,94556,0,2,0
26970,5,3,94559,94559,94562,0,3,3
26971,3,2,94562,94562,94564,0,2,0
26972,6,1,94568,94568,94569,0,1,4
26973,5,1,94573,94573,94574,0,1,4
26974,6,2,94579,94579,94581,0,2,5
26975,2,3,94581,94581,94584,0,3,0
26976,2,2,94583,94584,94586,1,3,0
26977,2,1,94585,94586,94587,1,2,0
26978,3,2,94588,94588,94590,0,2,1
26979,3,2,94591,94591,94593,0,2,1
26980,2,1,94593,94593,94594,0,1,0
26981,6,2,94599,94599,94601,0,2,5
26982,1,2,94600,94601,94603,1,3,0
26983,3,2,94603,94603,94605,0,2,0
26984,1,1,94604,94605,94606,1,2,0
26985,2,3,94606,94606,94609,0,3,0
26986,3,3,94609,94609,94612,0,3,0
26987,1,3,94610,94612,94615,2,5,0
26988,3,3,94613,94615,94618,2,5,0
26989,1,2,94614,94618,94620,4,6,0
26990,2,1,94616,94620,94621,4,5,0
26991,3,1,94619,94621,94622,2,3,0
26992,4,1,94623,94623,94624,0,1,1
26993,2,2,94625,94625,94627,0,2,1
26994,3,3,94628,94628,94631,0,3,1
26995,1,1,94629,94631,94632,2,3,0
26996,6,3,94635,94635,94638,0,3,3
26997,2,1,94637,94638,94639,1,2,0
26998,2,2,94639,94639,94641,0,2,0
26999,4,3,94643,94643,94646,0,3,2
27000,3,1,94646,94646,94647,0,1,0
27001,2,2,94648,94648,94650,0,2,1
27002,6,2,94654,94654,94656,0,2,4
27003,3,3,94657,94657,94660,0,3,1
27004,6,3,94663,94663,94666,0,3,3
27005,2,1,94665,94666,94667,1,2,0
27006,2,2,94667,94667,94669,0,2,0
27007,3,3,94670,94670,94673,0,3,1
27008,1,1,94671,94673,94674,2,3,0
27009,2,1,94673,94674,94675,1,2,0
27010,4,1,94677,94677,94678,0,1,2
27011,3,2,94680,94680,94682,0,2,2
27012,2,1,94682,94682,94683,0,1,0
27013,3,2,94685,94685,94687,0,2,2
27014,6,1,94691,94691,94692,0,1,4
27015,1,1,94692,94692,94693,0,1,0
27016,2,1,94694,94694,94695,0,1,1
27017,2,3,94696,94696,94699,0,3,1
27018,6,2,94702,94702,94704,0,2,3
27019,6,3,94708,94708,94711,0,3,4
27020,3,1,94711,94711,94712,0,1,0
27021,3,2,94714,94714,94716,0,2,2
27022,4,1,94718,94718,94719,0,1,2
27023,3,3,94721,94721,94724,0,3,2
27024,5,1,94726,94726,94727,0,1,2
27025,6,1,94732,94732,94733,0,1,5
27026,3,2,94735,94735,94737,0,2,2
27027,1,3,94736,94737,94740,1,4,0
27028,1,2,94737,94740,94742,3,5,0
27029,1,1,94738,94742,94743,4,5,0
27030,3,3,94741,94743,94746,2,5,0
27031,5,2,94746,94746,94748,0,2,0
27032,1,3,94747,94748,94751,1,4,0
27033,2,1,94749,94751,94752,2,3,0
27034,2,2,94751,94752,94754,1,3,0
27035,1,2,94752,94754,94756,2,4,0
27036,6,2,94758,94758,94760,0,2,2
27037,4,1,94762,94762,94763,0,1,2
27038,2,1,94764,94764,94765,0,1,1
27039,5,2,94769,94769,94771,0,2,4
27040,4,2,94773,94773,94775,0,2,2
27041,3,2,94776,94776,94778,0,2,1
27042,1,3,94777,94778,94781,1,4,0
27043,3,1,94780,94781,94782,1,2,0
27044,4,1,94784,94784,94785,0,1,2
27045,1,3,94785,94785,94788,0,3,0
27046,2,2,94787,94788,94790,1,3,0
27047,5,1,94792,94792,94793,0,1,2
27048,2,3,94794,94794,94797,0,3,1
27049,5,1,94799,94799,94800,0,1,2
27050,1,3,94800,94800,94803,0,3,0
27051,2,2,94802,94803,94805,1,3,0
27052,1,2,94803,94805,94807,2,4,0
27053,6,1,94809,94809,94810,0,1,2
27054,6,3,94815,94815,94818,0,3,5
27055,5,2,94820,94820,94822,0,2,2
27056,4,1,94824,94824,94825,0,1,2
27057,2,1,94826,94826,94827,0,1,1
27058,6,1,94832,94832,94833,0,1,5
27059,3,2,94835,94835,94837,0,2,2
27060,6,2,94841,94841,94843,0,2,4
27061,2,1,94843,94843,94844,0,1,0
27062,4,3,94847,94847,94850,0,3,3
27063,2,3,94849,94850,94853,1,4,0
27064,1,2,94850,94853,94855,3,5,0
27065,4,3,94854,94855,94858,1,4,0
27066,4,1,94858,94858,94859,0,1,0
27067,4,2,94862,94862,94864,0,2,3
27068,3,2,94865,94865,94867,0,2,1
27069,6,1,94871,94871,94872,0,1,4
27070,1,3,94872,94872,94875,0,3,0
27071,1,1,94873,94875,94876,2,3,0
27072,4,2,94877,94877,94879,0,2,1
27073,3,2,94880,94880,94882,0,2,1
27074,2,1,94882,94882,94883,0,1,0
27075,3,3,94885,94885,94888,0,3,2
27076,5,2,94890,94890,94892,0,2,2
27077,5,3,94895,94895,94898,0,3,3
27078,3,1,94898,94898,94899,0,1,0
27079,5,3,94903,94903,94906,0,3,4
27080,1,1,94904,94906,94907,2,3,0
27081,4,1,94908,94908,94909,0,1,1
27082,1,1,94909,94909,94910,0,1,0
27083,2,2,94911,94911,94913,0,2,1
27084,1,1,94912,94913,94914,1,2,0
27085,1,2,94913,94914,94916,1,3,0
27086,6,1,94919,94919,94920,0,1,3
27087,4,1,94923,94923,94924,0,1,3
27088,2,1,94925,94925,94926,0,1,1
27089,3,1,94928,94928,94929,0,1,2
27090,2,1,94930,94930,94931,0,1,1
27091,4,1,94934,94934,94935,0,1,3
27092,4,2,94938,94938,94940,0,2,3
27093,6,3,94944,94944,94947,0,3,4
27094,2,2,94946,94947,94949,1,3,0
27095,3,2,94949,94949,94951,0,2,0
27096,3,3,94952,94952,94955,0,3,1
27097,4,3,94956,94956,94959,0,3,1
27098,4,1,94960,94960,94961,0,1,1
27099,4,2,94964,94964,94966,0,2,3
27100,6,1,94970,94970,94971,0,1,4
27101,1,3,94971,94971,94974,0,3,0
27102,5,1,94976,94976,94977,0,1,2
27103,5,3,94981,94981,94984,0,3,4
27104,2,1,94983,94984,94985,1,2,0
27105,3,1,94986,94986,94987,0,1,1
27106,6,2,94992,94992,94994,0,2,5
27107,1,2,94993,94994,94996,1,3,0
27108,1,2,94994,94996,94998,2,4,0
27109,4,3,94998,94998,95001,0,3,0
27110,6,2,95004,95004,95006,0,2,3
27111,3,1,95007,95007,95008,0,1,1
27112,2,2,95009,95009,95011,0,2,1
27113,5,1,95014,95014,95015,0,1,3
27114,1,2,95015,95015,95017,0,2,0
27115,3,2,95018,95018,95020,0,2,1
27116,3,1,95021,95021,95022,0,1,1
27117,2,1,95023,95023,95024,0,1,1
27118,3,2,95026,95026,95028,0,2,2
27119,1,3,95027,95028,95031,1,4,0
27120,3,3,95030,95031,95034,1,4,0
27121,5,3,95035,95035,95038,0,3,1
27122,4,2,95039,95039,95041,0,2,1
27123,2,1,95041,95041,95042,0,1,0
27124,4,3,95045,95045,95048,0,3,3
27125,1,3,95046,95048,95051,2,5,0
27126,6,2,95052,95052,95054,0,2,1
27127,5,3,95057,95057,95060,0,3,3
27128,4,1,95061,95061,95062,0,1,1
27129,1,2,95062,95062,95064,0,2,0
27130,3,2,95065,95065,95067,0,2,1
27131,6,3,95071,95071,95074,0,3,4
27132,4,3,95075,95075,95078,0,3,1
27133,2,1,95077,95078,95079,1,2,0
27134,1,3,95078,95079,95082,1,4,0
27135,1,1,95079,95082,95083,3,4,0
27136,2,3,95081,95083,95086,2,5,0
27137,4,3,95085,95086,95089,1,4,0
27138,2,1,95087,95089,95090,2,3,0
27139,2,3,95089,95090,95093,1,4,0
27140,6,2,95095,95095,95097,0,2,2
27141,6,1,95101,95101,95102,0,1,4
27142,3,1,95104,95104,95105,0,1,2
27143,6,1,95110,95110,95111,0,1,5
27144,6,2,95116,95116,95118,0,2,5
27145,6,3,95122,95122,95125,0,3,4
27146,4,3,95126,95126,95129,0,3,1
27147,6,2,95132,95132,95134,0,2,3
27148,4,2,95136,95136,95138,0,2,2
27149,3,1,95139,95139,95140,0,1,1
27150,4,1,95143,95143,95144,0,1,3
27151,3,2,95146,95146,95148,0,2,2
27152,2,1,95148,95148,95149,0,1,0
27153,1,2,95149,95149,95151,0,2,0
27154,3,1,95152,95152,95153,0,1,1
27155,1,2,95153,95153,95155,0,2,0
27156,5,2,95158,95158,95160,0,2,3
27157,2,2,95160,95160,95162,0,2,0
27158,2,3,95162,95162,95165,0,3,0
27159,3,1,95165,95165,95166,0,1,0
27160,2,2,95167,95167,95169,0,2,1
27161,2,2,95169,95169,95171,0,2,0
27162,4,3,95173,95173,95176,0,3,2
27163,6,1,95179,95179,95180,0,1,3
27164,5,2,95184,95184,95186,0,2,4
27165,5,3,95189,95189,95192,0,3,3
27166,4,2,95193,95193,95195,0,2,1
27167,2,1,95195,95195,95196,0,1,0
27168,5,3,95200,95200,95203,0,3,4
27169,2,1,95202,95203,95204,1,2,0
27170,5,3,95207,95207,95210,0,3,3
27171,4,1,95211,95211,95212,0,1,1
27172,5,1,95216,95216,95217,0,1,4
27173,1,2,95217,95217,95219,0,2,0
27174,6,2,95223,95223,95225,0,2,4
27175,3,3,95226,95226,95229,0,3,1
27176,6,1,95232,95232,95233,0,1,3
27177,2,1,95234,95234,95235,0,1,1
27178,1,1,95235,95235,95236,0,1,0
27179,3,2,95238,95238,95240,0,2,2
27180,3,2,95241,95241,95243,0,2,1
27181,6,2,95247,95247,95249,0,2,4
27182,2,1,95249,95249,95250,0,1,0
27183,2,1,95251,95251,95252,0,1,1
27184,4,1,95255,95255,95256,0,1,3
27185,3,2,95258,95258,95260,0,2,2
27186,3,1,95261,95261,95262,0,1,1
27187,4,3,95265,95265,95268,0,3,3
27188,1,2,95266,95268,95270,2,4,0
27189,6,2,95272,95272,95274,0,2,2
27190,1,2,95273,95274,95276,1,3,0
27191,6,1,95279,95279,95280,0,1,3
27192,5,1,95284,95284,95285,0,1,4
27193,5,2,95289,95289,95291,0,2,4
27194,6,1,95295,95295,95296,0,1,4
27195,3,2,95298,95298,95300,0,2,2
27196,5,2,95303,95303,95305,0,2,3
27197,5,1,95308,95308,95309,0,1,3
27198,1,3,95309,95309,95312,0,3,0
27199,3,2,95312,95312,95314,0,2,0
27200,1,2,95313,95314,95316,1,3,0
27201,4,1,95317,95317,95318,0,1,1
27202,4,1,95321,95321,95322,0,1,3
27203,2,1,95323,95323,95324,0,1,1
27204,4,3,95327,95327,95330,0,3,3
27205,1,1,95328,95330,95331,2,3,0
27206,6,3,95334,95334,95337,0,3,3
27207,3,2,95337,95337,95339,0,2,0
27208,2,3,95339,95339,95342,0,3,0
27209,5,2,95344,95344,95346,0,2,2
27210,2,3,95346,95346,95349,0,3,0
27211,6,1,95352,95352,95353,0,1,3
27212,6,3,95358,95358,95361,0,3,5
27213,4,2,95362,95362,95364,0,2,1
27214,3,3,95365,95365,95368,0,3,1
27215,1,2,95366,95368,95370,2,4,0
27216,3,3,95369,95370,95373,1,4,0
27217,1,1,95370,95373,95374,3,4,0
27218,5,2,95375,95375,95377,0,2,1
27219,1,3,95376,95377,95380,1,4,0
27220,2,2,95378,95380,95382,2,4,0
27221,6,3,95384,95384,95387,0,3,2
27222,1,1,95385,95387,95388,2,3,0
27223,4,3,95389,95389,95392,0,3,1
27224,3,1,95392,95392,95393,0,1,0
27225,6,2,95398,95398,95400,0,2,5
27226,1,2,95399,95400,95402,1,3,0
27227,5,1,95404,95404,95405,0,1,2
27228,4,1,95408,95408,95409,0,1,3
27229,1,3,95409,95409,95412,0,3,0
27230,5,2,95414,95414,95416,0,2,2
27231,6,3,95420,95420,95423,0,3,4
27232,2,2,95422,95423,95425,1,3,0
27233,1,3,95423,95425,95428,2,5,0
27234,3,3,95426,95428,95431,2,5,0
27235,4,2,95430,95431,95433,1,3,0
27236,1,3,95431,95433,95436,2,5,0
27237,1,3,95432,95436,95439,4,7,0
27238,3,2,95435,95439,95441,4,6,0
27239,2,3,95437,95441,95444,4,7,0
27240,4,3,95441,95444,95447,3,6,0
27241,2,2,95443,95447,95449,4,6,0
27242,3,3,95446,95449,95452,3,6,0
27243,3,3,95449,95452,95455,3,6,0
27244,1,1,95450,95455,95456,5,6,0
27245,6,2,95456,95456,95458,0,2,0
27246,2,3,95458,95458,95461,0,3,0
27247,5,3,95463,95463,95466,0,3,2
27248,6,3,95469,95469,95472,0,3,3
27249,3,2,95472,95472,95474,0,2,0
27250,6,3,95478,95478,95481,0,3,4
27251,4,2,95482,95482,95484,0,2,1
27252,4,1,95486,95486,95487,0,1,2
27253,6,3,95492,95492,95495,0,3,5
27254,2,2,95494,95495,95497,1,3,0
27255,2,2,95496,95497,95499,1,3,0
27256,4,1,95500,95500,95501,0,1,1
27257,3,1,95503,95503,95504,0,1,2
27258,2,2,95505,95505,95507,0,2,1
27259,6,1,95511,95511,95512,0,1,4
27260,4,1,95515,95515,95516,0,1,3
27261,5,2,95520,95520,95522,0,2,4
27262,2,2,95522,95522,95524,0,2,0
27263,2,3,95524,95524,95527,0,3,0
27264,1,1,95525,95527,95528,2,3,0
27265,6,3,95531,95531,95534,0,3,3
27266,2,1,95533,95534,95535,1,2,0
27267,3,1,95536,95536,95537,0,1,1
27268,5,2,95541,95541,95543,0,2,4
27269,3,2,95544,95544,95546,0,2,1
27270,3,2,95547,95547,95549,0,2,1
27271,5,1,95552,95552,95553,0,1,3
27272,6,1,95558,95558,95559,0,1,5
27273,2,2,95560,95560,95562,0,2,1
27274,2,1,95562,95562,95563,0,1,0
27275,3,1,95565,95565,95566,0,1,2
27276,4,3,95569,95569,95572,0,3,3
27277,3,2,95572,95572,95574,0,2,0
27278,6,2,95578,95578,95580,0,2,4
27279,5,1,95583,95583,95584,0,1,3
27280,2,1,95585,95585,95586,0,1,1
27281,1,1,95586,95586,95587,0,1,0
27282,5,1,95591,95591,95592,0,1,4
27283,1,2,95592,95592,95594,0,2,0
27284,5,2,95597,95597,95599,0,2,3
27285,6,2,95603,95603,95605,0,2,4
27286,4,1,95607,95607,95608,0,1,2
27287,2,2,95609,95609,95611,0,2,1
27288,5,1,95614,95614,95615,0,1,3
27289,6,3,95620,95620,95623,0,3,5
27290,1,2,95621,95623,95625,2,4,0
27291,2,2,95623,95625,95627,2,4,0
27292,5,1,95628,95628,95629,0,1,1
27293,2,2,95630,95630,95632,0,2,1
27294,4,2,95634,95634,95636,0,2,2
27295,2,1,95636,95636,95637,0,1,0
27296,6,3,95642,95642,95645,0,3,5
27297,2,2,95644,95645,95647,1,3,0
27298,2,1,95646,95647,95648,1,2,0
27299,1,1,95647,95648,95649,1,2,0
27300,3,3,95650,95650,95653,0,3,1
27301,5,3,95655,95655,95658,0,3,2
27302,3,2,95658,95658,95660,0,2,0
27303,2,3,95660,95660,95663,0,3,0
27304,1,1,95661,95663,95664,2,3,0
27305,6,3,95667,95667,95670,0,3,3
27306,6,3,95673,95673,95676,0,3,3
27307,4,2,95677,95677,95679,0,2,1
27308,5,1,95682,95682,95683,0,1,3
27309,4,2,95686,95686,95688,0,2,3
27310,6,1,95692,95692,95693,0,1,4
27311,5,2,95697,95697,95699,0,2,4
27312,5,3,95702,95702,95705,0,3,3
27313,5,3,95707,95707,95710,0,3,2
27314,6,3,95713,95713,95716,0,3,3
27315,2,2,95715,95716,95718,1,3,0
27316,5,3,95720,95720,95723,0,3,2
27317,2,1,95722,95723,95724,1,2,0
27318,5,3,95727,95727,95730,0,3,3
27319,4,2,95731,95731,95733,0,2,1
27320,5,1,95736,95736,95737,0,1,3
27321,4,1,95740,95740,95741,0,1,3
27322,1,3,95741,95741,95744,0,3,0
27323,1,3,95742,95744,95747,2,5,0
27324,5,2,95747,95747,95749,0,2,0
27325,2,2,95749,95749,95751,0,2,0
27326,1,3,95750,95751,95754,1,4,0
27327,2,2,95752,95754,95756,2,4,0
27328,2,1,95754,95756,95757,2,3,0
27329,5,3,95759,95759,95762,0,3,2
27330,1,3,95760,95762,95765,2,5,0
27331,6,3,95766,95766,95769,0,3,1
27332,4,3,95770,95770,95773,0,3,1
27333,6,2,95776,95776,95778,0,2,3
27334,5,3,95781,95781,95784,0,3,3
27335,2,2,95783,95784,95786,1,3,0
27336,3,1,95786,95786,95787,0,1,0
27337,5,1,95791,95791,95792,0,1,4
27338,3,1,95794,95794,95795,0,1,2
27339,1,3,95795,95795,95798,0,3,0
27340,1,2,95796,95798,95800,2,4,0
27341,6,3,95802,95802,95805,0,3,2
27342,4,2,95806,95806,95808,0,2,1
27343,2,2,95808,95808,95810,0,2,0
27344,4,3,95812,95812,95815,0,3,2
27345,6,1,95818,95818,95819,0,1,3
27346,4,1,95822,95822,95823,0,1,3
27347,6,1,95828,95828,95829,0,1,5
27348,2,3,95830,95830,95833,0,3,1
27349,4,1,95834,95834,95835,0,1,1
27350,4,3,95838,95838,95841,0,3,3
27351,4,3,95842,95842,95845,0,3,1
27352,3,2,95845,95845,95847,0,2,0
27353,4,3,95849,95849,95852,0,3,2
27354,2,2,95851,95852,95854,1,3,0
27355,5,2,95856,95856,95858,0,2,2
27356,3,3,95859,95859,95862,0,3,1
27357,5,2,95864,95864,95866,0,2,2
27358,2,2,95866,95866,95868,0,2,0
27359,2,3,95868,95868,95871,0,3,0
27360,5,2,95873,95873,95875,0,2,2
27361,3,2,95876,95876,95878,0,2,1
27362,4,1,95880,95880,95881,0,1,2
27363,1,2,95881,95881,95883,0,2,0
27364,2,1,95883,95883,95884,0,1,0
27365,2,2,95885,95885,95887,0,2,1
27366,3,2,95888,95888,95890,0,2,1
27367,2,2,95890,95890,95892,0,2,0
27368,1,1,95891,95892,95893,1,2,0
27369,1,3,95892,95893,95896,1,4,0
27370,2,1,95894,95896,95897,2,3,0
27371,3,1,95897,95897,95898,0,1,0
27372,1,3,95898,95898,95901,0,3,0
27373,3,1,95901,95901,95902,0,1,0
27374,4,2,95905,95905,95907,0,2,3
27375,3,3,95908,95908,95911,0,3,1
27376,1,1,95909,95911,95912,2,3,0
27377,4,3,95913,95913,95916,0,3,1
27378,3,3,95916,95916,95919,0,3,0
27379,5,3,95921,95921,95924,0,3,2
27380,2,1,95923,95924,95925,1,2,0
27381,3,2,95926,95926,95928,0,2,1
27382,2,3,95928,95928,95931,0,3,0
27383,5,3,95933,95933,95936,0,3,2
27384,2,3,95935,95936,95939,1,4,0
27385,4,3,95939,95939,95942,0,3,0
27386,1,3,95940,95942,95945,2,5,0
27387,4,2,95944,95945,95947,1,3,0
27388,2,2,95946,95947,95949,1,3,0
27389,1,1,95947,95949,95950,2,3,0
27390,4,1,95951,95951,95952,0,1,1
27391,5,1,95956,95956,95957,0,1,4
27392,6,2,95962,95962,95964,0,2,5
27393,1,2,95963,95964,95966,1,3,0
27394,5,2,95968,95968,95970,0,2,2
27395,4,3,95972,95972,95975,0,3,2
27396,2,2,95974,95975,95977,1,3,0
27397,3,3,95977,95977,95980,0,3,0
27398,4,1,95981,95981,95982,0,1,1
27399,3,2,95984,95984,95986,0,2,2
27400,3,3,95987,95987,95990,0,3,1
27401,1,1,95988,95990,95991,2,3,0
27402,3,3,95991,95991,95994,0,3,0
27403,6,1,95997,95997,95998,0,1,3
27404,2,2,95999,95999,96001,0,2,1
27405,3,2,96002,96002,96004,0,2,1
27406,6,3,96008,96008,96011,0,3,4
27407,5,1,96013,96013,96014,0,1,2
27408,1,1,96014,96014,96015,0,1,0
27409,3,2,96017,96017,96019,0,2,2
27410,2,3,96019,96019,96022,0,3,0
27411,2,2,96021,96022,96024,1,3,0
27412,4,2,96025,96025,96027,0,2,1
27413,5,1,96030,96030,96031,0,1,3
27414,1,3,96031,96031,96034,0,3,0
27415,6,3,96037,96037,96040,0,3,3
27416,6,2,96043,96043,96045,0,2,3
27417,5,1,96048,96048,96049,0,1,3
27418,1,3,96049,96049,96052,0,3,0
27419,6,1,96055,96055,96056,0,1,3
27420,3,2,96058,96058,96060,0,2,2
27421,6,2,96064,96064,96066,0,2,4
27422,3,1,96067,96067,96068,0,1,1
27423,4,3,96071,96071,96074,0,3,3
27424,3,3,96074,96074,96077,0,3,0
27425,6,1,96080,96080,96081,0,1,3
27426,6,3,96086,96086,96089,0,3,5
27427,6,1,96092,96092,96093,0,1,3
27428,2,1,96094,96094,96095,0,1,1
27429,3,1,96097,96097,96098,0,1,2
27430,3,2,96100,96100,96102,0,2,2
27431,1,2,96101,96102,96104,1,3,0
27432,2,1,96103,96104,96105,1,2,0
27433,6,2,96109,96109,96111,0,2,4
27434,1,1,96110,96111,96112,1,2,0
27435,1,1,96111,96112,96113,1,2,0
27436,2,3,96113,96113,96116,0,3,0
27437,3,2,96116,96116,96118,0,2,0
27438,5,2,96121,96121,96123,0,2,3
27439,4,1,96125,96125,96126,0,1,2
27440,3,1,96128,96128,96129,0,1,2
27441,4,1,96132,96132,96133,0,1,3
27442,3,2,96135,96135,96137,0,2,2
27443,2,1,96137,96137,96138,0,1,0
27444,2,1,96139,96139,96140,0,1,1
27445,5,1,96144,96144,96145,0,1,4
27446,5,2,96149,96149,96151,0,2,4
27447,6,1,96155,96155,96156,0,1,4
27448,1,2,96156,96156,96158,0,2,0
27449,2,3,96158,96158,96161,0,3,0
27450,6,2,96164,96164,96166,0,2,3
27451,4,2,96168,96168,96170,0,2,2
27452,2,1,96170,96170,96171,0,1,0
27453,4,1,96174,96174,96175,0,1,3
27454,3,1,96177,96177,96178,0,1,2
27455,6,1,96183,96183,96184,0,1,5
27456,4,3,96187,96187,96190,0,3,3
27457,3,2,96190,96190,96192,0,2,0
27458,2,2,96192,96192,96194,0,2,0
27459,1,3,96193,96194,96197,1,4,0
27460,1,1,96194,96197,96198,3,4,0
27461,5,2,96199,96199,96201,0,2,1
27462,2,1,96201,96201,96202,0,1,0
27463,1,2,96202,96202,96204,0,2,0
27464,2,2,96204,96204,96206,0,2,0
27465,4,3,96208,96208,96211,0,3,2
27466,1,3,96209,96211,96214,2,5,0
27467,5,3,96214,96214,96217,0,3,0
27468,3,2,96217,96217,96219,0,2,0
27469,1,1,96218,96219,96220,1,2,0
27470,4,2,96222,96222,96224,0,2,2
27471,4,1,96226,96226,96227,0,1,2
27472,5,2,96231,96231,96233,0,2,4
27473,2,2,96233,96233,96235,0,2,0
27474,6,3,96239,96239,96242,0,3,4
27475,6,3,96245,96245,96248,0,3,3
27476,5,3,96250,96250,96253,0,3,2
27477,1,1,96251,96253,96254,2,3,0
27478,4,2,96255,96255,96257,0,2,1
27479,3,1,96258,96258,96259,0,1,1
27480,2,3,96260,96260,96263,0,3,1
27481,2,1,96262,96263,96264,1,2,0
27482,5,1,96267,96267,96268,0,1,3
27483,4,3,96271,96271,96274,0,3,3
27484,6,2,96277,96277,96279,0,2,3
27485,6,2,96283,96283,96285,0,2,4
27486,3,3,96286,96286,96289,0,3,1
27487,1,2,96287,96289,96291,2,4,0
27488,6,3,96293,96293,96296,0,3,2
27489,5,2,96298,96298,96300,0,2,2
27490,5,3,96303,96303,96306,0,3,3
27491,4,3,96307,96307,96310,0,3,1
27492,1,1,96308,96310,96311,2,3,0
27493,5,2,96313,96313,96315,0,2,2
27494,4,3,96317,96317,96320,0,3,2
27495,2,2,96319,96320,96322,1,3,0
27496,3,1,96322,96322,96323,0,1,0
27497,6,1,96328,96328,96329,0,1,5
27498,2,2,96330,96330,96332,0,2,1
27499,5,2,96335,96335,96337,0,2,3
27500,2,1,96337,96337,96338,0,1,0
27501,3,3,96340,96340,96343,0,3,2
27502,6,2,96346,96346,96348,0,2,3
27503,6,3,96352,96352,96355,0,3,4
27504,3,3,96355,96355,96358,0,3,0
27505,4,3,96359,96359,96362,0,3,1
27506,3,1,96362,96362,96363,0,1,0
27507,5,1,96367,96367,96368,0,1,4
27508,1,1,96368,96368,96369,0,1,0
27509,1,2,96369,96369,96371,0,2,0
27510,6,1,96375,96375,96376,0,1,4
27511,6,2,96381,96381,96383,0,2,5
27512,5,3,96386,96386,96389,0,3,3
27513,1,3,96387,96389,96392,2,5,0
27514,5,3,96392,96392,96395,0,3,0
27515,2,1,96394,96395,96396,1,2,0
27516,5,3,96399,96399,96402,0,3,3
27517,4,3,96403,96403,96406,0,3,1
27518,1,1,96404,96406,96407,2,3,0
27519,6,1,96410,96410,96411,0,1,3
27520,1,2,96411,96411,96413,0,2,0
27521,3,2,96414,96414,96416,0,2,1
27522,4,3,96418,96418,96421,0,3,2
27523,3,3,96421,96421,96424,0,3,0
27524,6,2,96427,96427,96429,0,2,3
27525,3,2,96430,96430,96432,0,2,1
27526,1,3,96431,96432,96435,1,4,0
27527,1,3,96432,96435,96438,3,6,0
27528,4,2,96436,96438,96440,2,4,0
27529,6,3,96442,96442,96445,0,3,2
27530,2,2,96444,96445,96447,1,3,0
27531,6,2,96450,96450,96452,0,2,3
27532,3,3,96453,96453,96456,0,3,1
27533,1,1,96454,96456,96457,2,3,0
27534,5,3,96459,96459,96462,0,3,2
27535,1,1,96460,96462,96463,2,3,0
27536,3,3,96463,96463,96466,0,3,0
27537,6,1,96469,96469,96470,0,1,3
27538,2,1,96471,96471,96472,0,1,1
27539,5,3,96476,96476,96479,0,3,4
27540,3,3,96479,96479,96482,0,3,0
27541,6,3,96485,96485,96488,0,3,3
27542,1,3,96486,96488,96491,2,5,0
27543,1,3,96487,96491,96494,4,7,0
27544,1,3,96488,96494,96497,6,9,0
27545,2,2,96490,96497,96499,7,9,0
27546,4,3,96494,96499,96502,5,8,0
27547,5,2,96499,96502,96504,3,5,0
27548,5,1,96504,96504,96505,0,1,0
27549,5,3,96509,96509,96512,0,3,4
27550,4,2,96513,96513,96515,0,2,1
27551,5,2,96518,96518,96520,0,2,3
27552,5,1,96523,96523,96524,0,1,3
27553,1,1,96524,96524,96525,0,1,0
27554,4,3,96528,96528,96531,0,3,3
27555,6,2,96534,96534,96536,0,2,3
27556,6,2,96540,96540,96542,0,2,4
27557,2,3,96542,96542,96545,0,3,0
27558,4,2,96546,96546,96548,0,2,1
27559,4,3,96550,96550,96553,0,3,2
27560,2,3,96552,96553,96556,1,4,0
27561,6,2,96558,96558,96560,0,2,2
27562,5,2,96563,96563,96565,0,2,3
27563,6,2,96569,96569,96571,0,2,4
27564,2,1,96571,96571,96572,0,1,0
27565,3,2,96574,96574,96576,0,2,2
27566,2,2,96576,96576,96578,0,2,0
27567,3,3,96579,96579,96582,0,3,1
27568,2,3,96581,96582,96585,1,4,0
27569,4,3,96585,96585,96588,0,3,0
27570,6,2,96591,96591,96593,0,2,3
27571,4,3,96595,96595,96598,0,3,2
27572,3,3,96598,96598,96601,0,3,0
27573,1,3,96599,96601,96604,2,5,0
27574,2,3,96601,96604,96607,3,6,0
27575,2,1,96603,96607,96608,4,5,0
27576,2,1,96605,96608,96609,3,4,0
27577,6,1,96611,96611,96612,0,1,2
27578,3,1,96614,96614,96615,0,1,2
27579,4,3,96618,96618,96621,0,3,3
27580,1,3,96619,96621,96624,2,5,0
27581,4,1,96623,96624,96625,1,2,0
27582,2,3,96625,96625,96628,0,3,0
27583,3,1,96628,96628,96629,0,1,0
27584,6,1,96634,96634,96635,0,1,5
27585,4,1,96638,96638,96639,0,1,3
27586,1,1,96639,96639,96640,0,1,0
27587,3,3,96642,96642,96645,0,3,2
27588,6,2,96648,96648,96650,0,2,3
27589,6,1,96654,96654,96655,0,1,4
27590,3,1,96657,96657,96658,0,1,2
27591,5,2,96662,96662,96664,0,2,4
27592,5,2,96667,96667,96669,0,2,3
27593,4,1,96671,96671,96672,0,1,2
27594,3,2,96674,96674,96676,0,2,2
27595,2,3,96676,96676,96679,0,3,0
27596,5,2,96681,96681,96683,0,2,2
27597,2,1,96683,96683,96684,0,1,0
27598,5,3,96688,96688,96691,0,3,4
27599,1,3,96689,96691,96694,2,5,0
27600,4,3,96693,96694,96697,1,4,0
27601,6,2,96699,96699,96701,0,2,2
27602,3,3,96702,96702,96705,0,3,1
27603,6,3,96708,96708,96711,0,3,3
27604,4,2,96712,96712,96714,0,2,1
27605,5,3,96717,96717,96720,0,3,3
27606,4,3,96721,96721,96724,0,3,1
27607,2,1,96723,96724,96725,1,2,0
27608,4,1,96727,96727,96728,0,1,2
27609,2,2,96729,96729,96731,0,2,1
27610,3,3,96732,96732,96735,0,3,1
27611,4,1,96736,96736,96737,0,1,1
27612,2,3,96738,96738,96741,0,3,1
27613,3,1,96741,96741,96742,0,1,0
27614,3,1,96744,96744,96745,0,1,2
27615,6,3,96750,96750,96753,0,3,5
27616,2,2,96752,96753,96755,1,3,0
27617,1,1,96753,96755,96756,2,3,0
27618,4,3,96757,96757,96760,0,3,1
27619,4,2,96761,96761,96763,0,2,1
27620,6,2,96767,96767,96769,0,2,4
27621,3,3,96770,96770,96773,0,3,1
27622,2,2,96772,96773,96775,1,3,0
27623,6,2,96778,96778,96780,0,2,3
27624,5,3,96783,96783,96786,0,3,3
27625,1,2,96784,96786,96788,2,4,0
27626,2,2,96786,96788,96790,2,4,0
27627,3,3,96789,96790,96793,1,4,0
27628,6,1,96795,96795,96796,0,1,2
27629,6,3,96801,96801,96804,0,3,5
27630,2,1,96803,96804,96805,1,2,0
27631,6,2,96809,96809,96811,0,2,4
27632,3,2,96812,96812,96814,0,2,1
27633,5,1,96817,96817,96818,0,1,3
27634,1,2,96818,96818,96820,0,2,0
27635,2,1,96820,96820,96821,0,1,0
27636,6,1,96826,96826,96827,0,1,5
27637,4,1,96830,96830,96831,0,1,3
27638,2,1,96832,96832,96833,0,1,1
27639,6,3,96838,96838,96841,0,3,5
27640,1,3,96839,96841,96844,2,5,0
27641,5,2,96844,96844,96846,0,2,0
27642,4,2,96848,96848,96850,0,2,2
27643,4,1,96852,96852,96853,0,1,2
27644,1,2,96853,96853,96855,0,2,0
27645,4,2,96857,96857,96859,0,2,2
27646,1,3,96858,96859,96862,1,4,0
27647,2,1,96860,96862,96863,2,3,0
27648,2,3,96862,96863,96866,1,4,0
27649,2,2,96864,96866,96868,2,4,0
27650,1,3,96865,96868,96871,3,6,0
27651,1,3,96866,96871,96874,5,8,0
27652,6,3,96872,96874,96877,2,5,0
27653,5,2,96877,96877,96879,0,2,0
27654,5,1,96882,96882,96883,0,1,3
27655,2,2,96884,96884,96886,0,2,1
27656,4,1,96888,96888,96889,0,1,2
27657,3,2,96891,96891,96893,0,2,2
27658,4,1,96895,96895,96896,0,1,2
27659,2,3,96897,96897,96900,0,3,1
27660,1,1,96898,96900,96901,2,3,0
27661,6,3,96904,96904,96907,0,3,3
27662,1,1,96905,96907,96908,2,3,0
27663,3,2,96908,96908,96910,0,2,0
27664,3,1,96911,96911,96912,0,1,1
27665,1,1,96912,96912,96913,0,1,0
27666,1,1,96913,96913,96914,0,1,0
27667,3,2,96916,96916,96918,0,2,2
27668,4,3,96920,96920,96923,0,3,2
27669,4,2,96924,96924,96926,0,2,1
27670,4,1,96928,96928,96929,0,1,2
27671,2,2,96930,96930,96932,0,2,1
27672,4,1,96934,96934,96935,0,1,2
27673,6,2,96940,96940,96942,0,2,5
27674,4,2,96944,96944,96946,0,2,2
27675,3,3,96947,96947,96950,0,3,1
27676,3,2,96950,96950,96952,0,2,0
27677,2,3,96952,96952,96955,0,3,0
27678,4,1,96956,96956,96957,0,1,1
27679,6,2,96962,96962,96964,0,2,5
27680,2,2,96964,96964,96966,0,2,0
27681,3,3,96967,96967,96970,0,3,1
27682,2,2,96969,96970,96972,1,3,0
27683,2,1,96971,96972,96973,1,2,0
27684,5,2,96976,96976,96978,0,2,3
27685,3,2,96979,96979,96981,0,2,1
27686,2,2,96981,96981,96983,0,2,0
27687,3,3,96984,96984,96987,0,3,1
27688,1,2,96985,96987,96989,2,4,0
27689,3,1,96988,96989,96990,1,2,0
27690,6,3,96994,96994,96997,0,3,4
27691,2,2,96996,96997,96999,1,3,0
27692,4,1,97000,97000,97001,0,1,1
27693,5,2,97005,97005,97007,0,2,4
27694,5,3,97010,97010,97013,0,3,3
27695,1,1,97011,97013,97014,2,3,0
27696,4,1,97015,97015,97016,0,1,1
27697,5,1,97020,97020,97021,0,1,4
27698,3,3,97023,97023,97026,0,3,2
27699,4,3,97027,97027,97030,0,3,1
27700,1,1,97028,97030,97031,2,3,0
27701,4,1,97032,97032,97033,0,1,1
27702,5,1,97037,97037,97038,0,1,4
27703,6,2,97043,97043,97045,0,2,5
27704,3,1,97046,97046,97047,0,1,1
27705,2,1,97048,97048,97049,0,1,1
27706,1,3,97049,97049,97052,0,3,0
27707,4,1,97053,97053,97054,0,1,1
27708,3,3,97056,97056,97059,0,3,2
27709,2,3,97058,97059,97062,1,4,0
27710,5,2,97063,97063,97065,0,2,1
27711,1,3,97064,97065,97068,1,4,0
27712,1,1,97065,97068,97069,3,4,0
27713,4,1,97069,97069,97070,0,1,0
27714,6,3,97075,97075,97078,0,3,5
27715,4,2,97079,97079,97081,0,2,1
27716,5,2,97084,97084,97086,0,2,3
27717,5,2,97089,97089,97091,0,2,3
27718,3,3,97092,97092,97095,0,3,1
27719,1,1,97093,97095,97096,2,3,0
27720,4,3,97097,97097,97100,0,3,1
27721,5,3,97102,97102,97105,0,3,2
27722,5,3,97107,97107,97110,0,3,2
27723,6,2,97113,97113,97115,0,2,3
27724,5,1,97118,97118,97119,0,1,3
27725,5,3,97123,97123,97126,0,3,4
27726,5,3,97128,97128,97131,0,3,2
27727,2,1,97130,97131,97132,1,2,0
27728,6,2,97136,97136,97138,0,2,4
27729,4,1,97140,97140,97141,0,1,2
27730,1,2,97141,97141,97143,0,2,0
27731,4,2,97145,97145,97147,0,2,2
27732,3,1,97148,97148,97149,0,1,1
27733,5,1,97153,97153,97154,0,1,4
27734,2,2,97155,97155,97157,0,2,1
27735,3,1,97158,97158,97159,0,1,1
27736,2,2,97160,97160,97162,0,2,1
27737,1,1,97161,97162,97163,1,2,0
27738,1,3,97162,97163,97166,1,4,0
27739,4,2,97166,97166,97168,0,2,0
27740,5,2,97171,97171,97173,0,2,3
27741,3,2,97174,97174,97176,0,2,1
27742,6,1,97180,97180,97181,0,1,4
27743,5,3,97185,97185,97188,0,3,4
27744,3,1,97188,97188,97189,0,1,0
27745,3,3,97191,97191,97194,0,3,2
27746,2,3,97193,97194,97197,1,4,0
27747,2,3,97195,97197,97200,2,5,0
27748,5,1,97200,97200,97201,0,1,0
27749,6,1,97206,97206,97207,0,1,5
27750,5,1,97211,97211,97212,0,1,4
27751,4,1,97215,97215,97216,0,1,3
27752,4,1,97219,97219,97220,0,1,3
27753,2,1,97221,97221,97222,0,1,1
27754,6,3,97227,97227,97230,0,3,5
27755,6,3,97233,97233,97236,0,3,3
27756,4,2,97237,97237,97239,0,2,1
27757,4,1,97241,97241,97242,0,1,2
27758,4,1,97245,97245,97246,0,1,3
27759,4,3,97249,97249,97252,0,3,3
27760,3,3,97252,97252,97255,0,3,0
27761,2,2,97254,97255,97257,1,3,0
27762,5,1,97259,97259,97260,0,1,2
27763,3,2,97262,97262,97264,0,2,2
27764,2,2,97264,97264,97266,0,2,0
27765,6,2,97270,97270,97272,0,2,4
27766,6,1,97276,97276,97277,0,1,4
27767,3,2,97279,97279,97281,0,2,2
27768,1,3,97280,97281,97284,1,4,0
27769,3,2,97283,97284,97286,1,3,0
27770,2,3,97285,97286,97289,1,4,0
27771,4,2,97289,97289,97291,0,2,0
27772,6,2,97295,97295,97297,0,2,4
27773,3,3,97298,97298,97301,0,3,1
27774,3,2,97301,97301,97303,0,2,0
27775,4,3,97305,97305,97308,0,3,2
27776,4,1,97309,97309,97310,0,1,1
27777,3,3,97312,97312,97315,0,3,2
27778,3,1,97315,97315,97316,0,1,0
27779,1,2,97316,97316,97318,0,2,0
27780,1,3,97317,97318,97321,1,4,0
27781,4,2,97321,97321,97323,0,2,0
27782,2,3,97323,97323,97326,0,3,0
27783,1,3,97324,97326,97329,2,5,0
27784,5,1,97329,97329,97330,0,1,0
27785,6,3,97335,97335,97338,0,3,5
27786,1,2,97336,97338,97340,2,4,0
27787,6,1,97342,97342,97343,0,1,2
27788,3,1,97345,97345,97346,0,1,2
27789,5,1,97350,97350,97351,0,1,4
27790,5,3,97355,97355,97358,0,3,4
27791,2,1,97357,97358,97359,1,2,0
27792,6,3,97363,97363,97366,0,3,4
27793,5,3,97368,97368,97371,0,3,2
27794,1,2,97369,97371,97373,2,4,0
27795,1,1,97370,97373,97374,3,4,0
27796,4,1,97374,97374,97375,0,1,0
27797,6,3,97380,97380,97383,0,3,5
27798,3,1,97383,97383,97384,0,1,0
27799,6,2,97389,97389,97391,0,2,5
27800,1,1,97390,97391,97392,1,2,0
27801,1,1,97391,97392,97393,1,2,0
27802,6,3,97397,97397,97400,0,3,4
27803,4,3,97401,97401,97404,0,3,1
27804,2,2,97403,97404,97406,1,3,0
27805,3,1,97406,97406,97407,0,1,0
27806,2,1,97408,97408,97409,0,1,1
27807,4,1,97412,97412,97413,0,1,3
27808,1,2,97413,97413,97415,0,2,0
27809,2,3,97415,97415,97418,0,3,0
27810,4,1,97419,97419,97420,0,1,1
27811,3,3,97422,97422,97425,0,3,2
27812,3,2,97425,97425,97427,0,2,0
27813,6,2,97431,97431,97433,0,2,4
27814,1,1,97432,97433,97434,1,2,0
27815,2,1,97434,97434,97435,0,1,0
27816,2,3,97436,97436,97439,0,3,1
27817,2,2,97438,97439,97441,1,3,0
27818,2,3,97440,97441,97444,1,4,0
27819,4,3,97444,97444,97447,0,3,0
27820,4,1,97448,97448,97449,0,1,1
27821,1,3,97449,97449,97452,0,3,0
27822,6,3,97455,97455,97458,0,3,3
27823,6,3,97461,97461,97464,0,3,3
27824,1,1,97462,97464,97465,2,3,0
27825,6,2,97468,97468,97470,0,2,3
27826,1,2,97469,97470,97472,1,3,0
27827,3,1,97472,97472,97473,0,1,0
27828,3,3,97475,97475,97478,0,3,2
27829,1,3,97476,97478,97481,2,5,0
27830,6,3,97482,97482,97485,0,3,1
27831,3,3,97485,97485,97488,0,3,0
27832,4,1,97489,97489,97490,0,1,1
27833,5,1,97494,97494,97495,0,1,4
27834,1,3,97495,97495,97498,0,3,0
27835,4,1,97499,97499,97500,0,1,1
27836,2,2,97501,97501,97503,0,2,1
27837,6,2,97507,97507,97509,0,2,4
27838,6,1,97513,97513,97514,0,1,4
27839,3,1,97516,97516,97517,0,1,2
27840,1,1,97517,97517,97518,0,1,0
27841,4,1,97521,97521,97522,0,1,3
27842,4,2,97525,97525,97527,0,2,3
27843,5,2,97530,97530,97532,0,2,3
27844,3,1,97533,97533,97534,0,1,1
27845,1,3,97534,97534,97537,0,3,0
27846,1,3,97535,97537,97540,2,5,0
27847,6,3,97541,97541,97544,0,3,1
27848,2,2,97543,97544,97546,1,3,0
27849,5,1,97548,97548,97549,0,1,2
27850,6,3,97554,97554,97557,0,3,5
27851,4,2,97558,97558,97560,0,2,1
27852,4,2,97562,97562,97564,0,2,2
27853,4,3,97566,97566,97569,0,3,2
27854,5,3,97571,97571,97574,0,3,2
27855,6,3,97577,97577,97580,0,3,3
27856,5,2,97582,97582,97584,0,2,2
27857,1,1,97583,97584,97585,1,2,0
27858,6,1,97589,97589,97590,0,1,4
27859,2,2,97591,97591,97593,0,2,1
27860,3,2,97594,97594,97596,0,2,1
27861,6,3,97600,97600,97603,0,3,4
27862,6,1,97606,97606,97607,0,1,3
27863,2,1,97608,97608,97609,0,1,1
27864,5,2,97613,97613,97615,0,2,4
27865,4,1,97617,97617,97618,0,1,2
27866,2,1,97619,97619,97620,0,1,1
27867,4,1,97623,97623,97624,0,1,3
27868,4,3,97627,97627,97630,0,3,3
27869,5,2,97632,97632,97634,0,2,2
27870,3,3,97635,97635,97638,0,3,1
27871,2,1,97637,97638,97639,1,2,0
27872,1,1,97638,97639,97640,1,2,0
27873,4,3,97642,97642,97645,0,3,2
27874,2,2,97644,97645,97647,1,3,0
27875,4,3,97648,97648,97651,0,3,1
27876,6,1,97654,97654,97655,0,1,3
27877,5,2,97659,97659,97661,0,2,4
27878,6,3,97665,97665,97668,0,3,4
27879,6,2,97671,97671,97673,0,2,3
27880,3,2,97674,97674,97676,0,2,1
27881,3,3,97677,97677,97680,0,3,1
27882,2,1,97679,97680,97681,1,2,0
27883,3,2,97682,97682,97684,0,2,1
27884,2,1,97684,97684,97685,0,1,0
27885,1,2,97685,97685,97687,0,2,0
27886,6,1,97691,97691,97692,0,1,4
27887,5,3,97696,97696,97699,0,3,4
27888,5,1,97701,97701,97702,0,1,2
27889,6,2,97707,97707,97709,0,2,5
27890,2,3,97709,97709,97712,0,3,0
27891,2,2,97711,97712,97714,1,3,0
27892,6,3,97717,97717,97720,0,3,3
27893,6,2,97723,97723,97725,0,2,3
27894,4,2,97727,97727,97729,0,2,2
27895,6,3,97733,97733,97736,0,3,4
27896,5,2,97738,97738,97740,0,2,2
27897,2,3,97740,97740,97743,0,3,0
27898,1,1,97741,97743,97744,2,3,0
27899,1,3,97742,97744,97747,2,5,0
27900,5,3,97747,97747,97750,0,3,0
27901,5,1,97752,97752,97753,0,1,2
27902,6,1,97758,97758,97759,0,1,5
27903,3,3,97761,97761,97764,0,3,2
27904,6,1,97767,97767,97768,0,1,3
27905,5,3,97772,97772,97775,0,3,4
27906,3,2,97775,97775,97777,0,2,0
27907,5,2,97780,97780,97782,0,2,3
27908,2,3,97782,97782,97785,0,3,0
27909,2,1,97784,97785,97786,1,2,0
27910,4,3,97788,97788,97791,0,3,2
27911,4,3,97792,97792,97795,0,3,1
27912,2,2,97794,97795,97797,1,3,0
27913,4,1,97798,97798,97799,0,1,1
27914,4,3,97802,97802,97805,0,3,3
27915,4,2,97806,97806,97808,0,2,1
27916,5,3,97811,97811,97814,0,3,3
27917,1,1,97812,97814,97815,2,3,0
27918,4,2,97816,97816,97818,0,2,1
27919,5,3,97821,97821,97824,0,3,3
27920,4,1,97825,97825,97826,0,1,1
27921,6,1,97831,97831,97832,0,1,5
27922,2,3,97833,97833,97836,0,3,1
27923,6,2,97839,97839,97841,0,2,3
27924,3,1,97842,97842,97843,0,1,1
27925,3,1,97845,97845,97846,0,1,2
27926,1,1,97846,97846,97847,0,1,0
27927,6,1,97852,97852,97853,0,1,5
27928,6,3,97858,97858,97861,0,3,5
27929,4,3,97862,97862,97865,0,3,1
27930,5,3,97867,97867,97870,0,3,2
27931,3,3,97870,97870,97873,0,3,0
27932,2,1,97872,97873,97874,1,2,0
27933,1,3,97873,97874,97877,1,4,0
27934,2,2,97875,97877,97879,2,4,0
27935,5,1,97880,97880,97881,0,1,1
27936,3,3,97883,97883,97886,0,3,2
27937,2,2,97885,97886,97888,1,3,0
27938,3,1,97888,97888,97889,0,1,0
27939,4,3,97892,97892,97895,0,3,3
27940,5,1,97897,97897,97898,0,1,2
27941,1,1,97898,97898,97899,0,1,0
27942,6,3,97904,97904,97907,0,3,5
27943,6,2,97910,97910,97912,0,2,3
27944,3,2,97913,97913,97915,0,2,1
27945,4,3,97917,97917,97920,0,3,2
27946,2,3,97919,97920,97923,1,4,0
27947,4,2,97923,97923,97925,0,2,0
27948,3,3,97926,97926,97929,0,3,1
27949,6,1,97932,97932,97933,0,1,3
27950,6,2,97938,97938,97940,0,2,5
27951,1,3,97939,97940,97943,1,4,0
27952,4,1,97943,97943,97944,0,1,0
27953,5,1,97948,97948,97949,0,1,4
27954,1,3,97949,97949,97952,0,3,0
27955,4,3,97953,97953,97956,0,3,1
27956,1,2,97954,97956,97958,2,4,0
27957,2,2,97956,97958,97960,2,4,0
27958,1,1,97957,97960,97961,3,4,0
27959,3,2,97960,97961,97963,1,3,0
27960,5,2,97965,97965,97967,0,2,2
27961,6,3,97971,97971,97974,0,3,4
27962,3,1,97974,97974,97975,0,1,0
27963,5,1,97979,97979,97980,0,1,4
27964,3,3,97982,97982,97985,0,3,2
27965,5,3,97987,97987,97990,0,3,2
27966,4,1,97991,97991,97992,0,1,1
27967,6,3,97997,97997,98000,0,3,5
27968,4,1,98001,98001,98002,0,1,1
27969,2,2,98003,98003,98005,0,2,1
27970,1,2,98004,98005,98007,1,3,0
27971,6,3,98010,98010,98013,0,3,3
27972,6,1,98016,98016,98017,0,1,3
27973,1,2,98017,98017,98019,0,2,0
27974,6,3,98023,98023,98026,0,3,4
27975,3,2,98026,98026,98028,0,2,0
27976,4,2,98030,98030,98032,0,2,2
27977,5,3,98035,98035,98038,0,3,3
27978,2,3,98037,98038,98041,1,4,0
27979,4,3,98041,98041,98044,0,3,0
27980,5,2,98046,98046,98048,0,2,2
27981,2,2,98048,98048,98050,0,2,0
27982,1,2,98049,98050,98052,1,3,0
27983,3,1,98052,98052,98053,0,1,0
27984,1,3,98053,98053,98056,0,3,0
27985,5,1,98058,98058,98059,0,1,2
27986,5,1,98063,98063,98064,0,1,4
27987,2,3,98065,98065,98068,0,3,1
27988,2,3,98067,98068,98071,1,4,0
27989,1,2,98068,98071,98073,3,5,0
27990,3,3,98071,98073,98076,2,5,0
27991,5,2,98076,98076,98078,0,2,0
27992,4,1,98080,98080,98081,0,1,2
27993,5,2,98085,98085,98087,0,2,4
27994,5,3,98090,98090,98093,0,3,3
27995,3,3,98093,98093,98096,0,3,0
27996,4,3,98097,98097,98100,0,3,1
27997,5,2,98102,98102,98104,0,2,2
27998,5,3,98107,98107,98110,0,3,3
27999,2,3,98109,98110,98113,1,4,0
28000,6,3,98115,98115,98118,0,3,2
28001,6,3,98121,98121,98124,0,3,3
28002,1,3,98122,98124,98127,2,5,0
28003,4,3,98126,98127,98130,1,4,0
28004,1,2,98127,98130,98132,3,5,0
28005,4,1,98131,98132,98133,1,2,0
28006,6,2,98137,98137,98139,0,2,4
28007,1,3,98138,98139,98142,1,4,0
28008,6,3,98144,98144,98147,0,3,2
28009,5,3,98149,98149,98152,0,3,2
28010,5,2,98154,98154,98156,0,2,2
28011,6,3,98160,98160,98163,0,3,4
28012,3,3,98163,98163,98166,0,3,0
28013,1,1,98164,98166,98167,2,3,0
28014,6,2,98170,98170,98172,0,2,3
28015,3,2,98173,98173,98175,0,2,1
28016,3,3,98176,98176,98179,0,3,1
28017,1,3,98177,98179,98182,2,5,0
28018,5,1,98182,98182,98183,0,1,0
28019,2,2,98184,98184,98186,0,2,1
28020,3,3,98187,98187,98190,0,3,1
28021,2,1,98189,98190,98191,1,2,0
28022,4,3,98193,98193,98196,0,3,2
28023,2,2,98195,98196,98198,1,3,0
28024,2,2,98197,98198,98200,1,3,0
28025,2,1,98199,98200,98201,1,2,0
28026,4,2,98203,98203,98205,0,2,2
28027,3,3,98206,98206,98209,0,3,1
28028,5,3,98211,98211,98214,0,3,2
28029,4,1,98215,98215,98216,0,1,1
28030,3,3,98218,98218,98221,0,3,2
28031,5,3,98223,98223,98226,0,3,2
28032,2,1,98225,98226,98227,1,2,0
28033,3,1,98228,98228,98229,0,1,1
28034,4,2,98232,98232,98234,0,2,3
28035,4,2,98236,98236,98238,0,2,2
28036,6,2,98242,98242,98244,0,2,4
28037,5,1,98247,98247,98248,0,1,3
28038,2,3,98249,98249,98252,0,3,1
28039,2,1,98251,98252,98253,1,2,0
28040,4,3,98255,98255,98258,0,3,2
28041,6,1,98261,98261,98262,0,1,3
28042,4,3,98265,98265,98268,0,3,3
28043,4,2,98269,98269,98271,0,2,1
28044,5,3,98274,98274,98277,0,3,3
28045,2,1,98276,98277,98278,1,2,0
28046,4,3,98280,98280,98283,0,3,2
28047,6,3,98286,98286,98289,0,3,3
28048,1,3,98287,98289,98292,2,5,0
28049,5,2,98292,98292,98294,0,2,0
28050,4,2,98296,98296,98298,0,2,2
28051,3,2,98299,98299,98301,0,2,1
28052,5,3,98304,98304,98307,0,3,3
28053,4,2,98308,98308,98310,0,2,1
28054,1,1,98309,98310,98311,1,2,0
28055,6,1,98315,98315,98316,0,1,4
28056,2,3,98317,98317,98320,0,3,1
28057,6,3,98323,98323,98326,0,3,3
28058,6,1,98329,98329,98330,0,1,3
28059,3,1,98332,98332,98333,0,1,2
28060,2,1,98334,98334,98335,0,1,1
28061,5,3,98339,98339,98342,0,3,4
28062,4,2,98343,98343,98345,0,2,1
28063,3,3,98346,98346,98349,0,3,1
28064,5,3,98351,98351,98354,0,3,2
28065,3,1,98354,98354,98355,0,1,0
28066,4,3,98358,98358,98361,0,3,3
28067,3,3,98361,98361,98364,0,3,0
28068,6,2,98367,98367,98369,0,2,3
28069,3,2,98370,98370,98372,0,2,1
28070,3,3,98373,98373,98376,0,3,1
28071,1,3,98374,98376,98379,2,5,0
28072,2,1,98376,98379,98380,3,4,0
28073,1,1,98377,98380,98381,3,4,0
28074,5,3,98382,98382,98385,0,3,1
28075,6,1,98388,98388,98389,0,1,3
28076,6,2,98394,98394,98396,0,2,5
28077,1,2,98395,98396,98398,1,3,0
28078,3,1,98398,98398,98399,0,1,0
28079,1,2,98399,98399,98401,0,2,0
28080,3,3,98402,98402,98405,0,3,1
28081,6,3,98408,98408,98411,0,3,3
28082,5,1,98413,98413,98414,0,1,2
28083,2,3,98415,98415,98418,0,3,1
28084,5,3,98420,98420,98423,0,3,2
28085,3,3,98423,98423,98426,0,3,0
28086,2,1,98425,98426,98427,1,2,0
28087,2,1,98427,98427,98428,0,1,0
28088,3,2,98430,98430,98432,0,2,2
28089,3,2,98433,98433,98435,0,2,1
28090,5,1,98438,98438,98439,0,1,3
28091,1,3,98439,98439,98442,0,3,0
28092,1,2,98440,98442,98444,2,4,0
28093,6,2,98446,98446,98448,0,2,2
28094,5,2,98451,98451,98453,0,2,3
28095,6,1,98457,98457,98458,0,1,4
28096,2,1,98459,98459,98460,0,1,1
28097,1,3,98460,98460,98463,0,3,0
28098,3,1,98463,98463,98464,0,1,0
28099,5,2,98468,98468,98470,0,2,4
28100,4,1,98472,98472,98473,0,1,2
28101,2,3,98474,98474,98477,0,3,1
28102,1,2,98475,98477,98479,2,4,0
28103,4,3,98479,98479,98482,0,3,0
28104,5,3,98484,98484,98487,0,3,2
28105,6,3,98490,98490,98493,0,3,3
28106,6,1,98496,98496,98497,0,1,3
28107,4,1,98500,98500,98501,0,1,3
28108,4,3,98504,98504,98507,0,3,3
28109,2,1,98506,98507,98508,1,2,0
28110,3,3,98509,98509,98512,0,3,1
28111,5,3,98514,98514,98517,0,3,2
28112,6,2,98520,98520,98522,0,2,3
28113,3,3,98523,98523,98526,0,3,1
28114,6,1,98529,98529,98530,0,1,3
28115,2,3,98531,98531,98534,0,3,1
28116,6,1,98537,98537,98538,0,1,3
28117,1,1,98538,98538,98539,0,1,0
28118,5,2,98543,98543,98545,0,2,4
28119,2,3,98545,98545,98548,0,3,0
28120,2,1,98547,98548,98549,1,2,0
28121,3,3,98550,98550,98553,0,3,1
28122,2,3,98552,98553,98556,1,4,0
28123,5,2,98557,98557,98559,0,2,1
28124,2,2,98559,98559,98561,0,2,0
28125,2,2,98561,98561,98563,0,2,0
28126,3,3,98564,98564,98567,0,3,1
28127,3,2,98567,98567,98569,0,2,0
28128,4,3,98571,98571,98574,0,3,2
28129,5,1,98576,98576,98577,0,1,2
28130,5,1,98581,98581,98582,0,1,4
28131,3,2,98584,98584,98586,0,2,2
28132,5,3,98589,98589,98592,0,3,3
28133,4,1,98593,98593,98594,0,1,1
28134,2,1,98595,98595,98596,0,1,1
28135,5,2,98600,98600,98602,0,2,4
28136,5,2,98605,98605,98607,0,2,3
28137,6,3,98611,98611,98614,0,3,4
28138,3,3,98614,98614,98617,0,3,0
28139,1,2,98615,98617,98619,2,4,0
28140,5,1,98620,98620,98621,0,1,1
28141,2,1,98622,98622,98623,0,1,1
28142,2,2,98624,98624,98626,0,2,1
28143,5,3,98629,98629,98632,0,3,3
28144,2,1,98631,98632,98633,1,2,0
28145,2,2,98633,98633,98635,0,2,0
28146,4,1,98637,98637,98638,0,1,2
28147,6,2,98643,98643,98645,0,2,5
28148,1,1,98644,98645,98646,1,2,0
28149,5,3,98649,98649,98652,0,3,3
28150,5,2,98654,98654,98656,0,2,2
28151,6,1,98660,98660,98661,0,1,4
28152,3,2,98663,98663,98665,0,2,2
28153,4,2,98667,98667,98669,0,2,2
28154,4,1,98671,98671,98672,0,1,2
28155,5,1,98676,98676,98677,0,1,4
28156,6,1,98682,98682,98683,0,1,5
28157,4,2,98686,98686,98688,0,2,3
28158,2,2,98688,98688,98690,0,2,0
28159,3,3,98691,98691,98694,0,3,1
28160,4,1,98695,98695,98696,0,1,1
28161,1,2,98696,98696,98698,0,2,0
28162,1,3,98697,98698,98701,1,4,0
28163,5,3,98702,98702,98705,0,3,1
28164,1,3,98703,98705,98708,2,5,0
28165,2,2,98705,98708,98710,3,5,0
28166,6,2,98711,98711,98713,0,2,1
28167,4,1,98715,98715,98716,0,1,2
28168,4,2,98719,98719,98721,0,2,3
28169,1,1,98720,98721,98722,1,2,0
28170,3,2,98723,98723,98725,0,2,1
28171,3,3,98726,98726,98729,0,3,1
28172,4,3,98730,98730,98733,0,3,1
28173,3,1,98733,98733,98734,0,1,0
28174,6,2,98739,98739,98741,0,2,5
28175,4,1,98743,98743,98744,0,1,2
28176,5,1,98748,98748,98749,0,1,4
28177,5,3,98753,98753,98756,0,3,4
28178,6,2,98759,98759,98761,0,2,3
28179,2,2,98761,98761,98763,0,2,0
28180,4,1,98765,98765,98766,0,1,2
28181,6,1,98771,98771,98772,0,1,5
28182,2,2,98773,98773,98775,0,2,1
28183,6,2,98779,98779,98781,0,2,4
28184,6,2,98785,98785,98787,0,2,4
28185,1,3,98786,98787,98790,1,4,0
28186,5,2,98791,98791,98793,0,2,1
28187,2,1,98793,98793,98794,0,1,0
28188,4,2,98797,98797,98799,0,2,3
28189,5,1,98802,98802,98803,0,1,3
28190,3,3,98805,98805,98808,0,3,2
28191,2,3,98807,98808,98811,1,4,0
28192,3,2,98810,98811,98813,1,3,0
28193,6,3,98816,98816,98819,0,3,3
28194,3,2,98819,98819,98821,0,2,0
28195,1,1,98820,98821,98822,1,2,0
28196,2,1,98822,98822,98823,0,1,0
28197,2,3,98824,98824,98827,0,3,1
28198,6,2,98830,98830,98832,0,2,3
28199,1,2,98831,98832,98834,1,3,0
28200,2,1,98833,98834,98835,1,2,0
28201,6,1,98839,98839,98840,0,1,4
28202,5,1,98844,98844,98845,0,1,4
28203,1,3,98845,98845,98848,0,3,0
28204,1,1,98846,98848,98849,2,3,0
28205,2,1,98848,98849,98850,1,2,0
28206,3,3,98851,98851,98854,0,3,1
28207,5,2,98856,98856,98858,0,2,2
28208,1,1,98857,98858,98859,1,2,0
28209,5,3,98862,98862,98865,0,3,3
28210,4,2,98866,98866,98868,0,2,1
28211,3,1,98869,98869,98870,0,1,1
28212,5,3,98874,98874,98877,0,3,4
28213,6,3,98880,98880,98883,0,3,3
28214,4,1,98884,98884,98885,0,1,1
28215,1,2,98885,98885,98887,0,2,0
28216,5,3,98890,98890,98893,0,3,3
28217,3,2,98893,98893,98895,0,2,0
28218,5,2,98898,98898,98900,0,2,3
28219,1,1,98899,98900,98901,1,2,0
28220,3,3,98902,98902,98905,0,3,1
28221,6,2,98908,98908,98910,0,2,3
28222,1,2,98909,98910,98912,1,3,0
28223,3,3,98912,98912,98915,0,3,0
28224,6,1,98918,98918,98919,0,1,3
28225,1,3,98919,98919,98922,0,3,0
28226,6,2,98925,98925,98927,0,2,3
28227,3,1,98928,98928,98929,0,1,1
28228,2,2,98930,98930,98932,0,2,1
28229,6,3,98936,98936,98939,0,3,4
28230,4,3,98940,98940,98943,0,3,1
28231,1,1,98941,98943,98944,2,3,0
28232,5,3,98946,98946,98949,0,3,2
28233,2,2,98948,98949,98951,1,3,0
28234,4,1,98952,98952,98953,0,1,1
28235,4,1,98956,98956,98957,0,1,3
28236,5,3,98961,98961,98964,0,3,4
28237,2,3,98963,98964,98967,1,4,0
28238,1,1,98964,98967,98968,3,4,0
28239,4,1,98968,98968,98969,0,1,0
28240,3,1,98971,98971,98972,0,1,2
28241,6,2,98977,98977,98979,0,2,5
28242,2,3,98979,98979,98982,0,3,0
28243,2,1,98981,98982,98983,1,2,0
28244,6,1,98987,98987,98988,0,1,4
28245,2,3,98989,98989,98992,0,3,1
28246,4,2,98993,98993,98995,0,2,1
28247,4,1,98997,98997,98998,0,1,2
28248,6,2,99003,99003,99005,0,2,5
28249,3,2,99006,99006,99008,0,2,1
28250,4,3,99010,99010,99013,0,3,2
28251,3,3,99013,99013,99016,0,3,0
28252,3,2,99016,99016,99018,0,2,0
28253,4,3,99020,99020,99023,0,3,2
28254,6,1,99026,99026,99027,0,1,3
28255,6,3,99032,99032,99035,0,3,5
28256,2,2,99034,99035,99037,1,3,0
28257,2,1,99036,99037,99038,1,2,0
28258,5,3,99041,99041,99044,0,3,3
28259,6,1,99047,99047,99048,0,1,3
28260,5,1,99052,99052,99053,0,1,4
28261,6,1,99058,99058,99059,0,1,5
28262,2,2,99060,99060,99062,0,2,1
28263,1,3,99061,99062,99065,1,4,0
28264,5,3,99066,99066,99069,0,3,1
28265,6,2,99072,99072,99074,0,2,3
28266,2,3,99074,99074,99077,0,3,0
28267,1,3,99075,99077,99080,2,5,0
28268,1,2,99076,99080,99082,4,6,0
28269,1,2,99077,99082,99084,5,7,0
28270,1,3,99078,99084,99087,6,9,0
28271,1,2,99079,99087,99089,8,10,0
28272,4,3,99083,99089,99092,6,9,0
28273,5,3,99088,99092,99095,4,7,0
28274,1,3,99089,99095,99098,6,9,0
28275,5,1,99094,99098,99099,4,5,0
28276,5,3,99099,99099,99102,0,3,0
28277,4,3,99103,99103,99106,0,3,1
28278,1,3,99104,99106,99109,2,5,0
28279,3,2,99107,99109,99111,2,4,0
28280,4,1,99111,99111,99112,0,1,0
28281,1,3,99112,99112,99115,0,3,0
28282,6,1,99118,99118,99119,0,1,3
28283,3,3,99121,99121,99124,0,3,2
28284,5,2,99126,99126,99128,0,2,2
28285,6,3,99132,99132,99135,0,3,4
28286,6,2,99138,99138,99140,0,2,3
28287,1,3,99139,99140,99143,1,4,0
28288,3,3,99142,99143,99146,1,4,0
28289,5,1,99147,99147,99148,0,1,1
28290,3,3,99150,99150,99153,0,3,2
28291,4,2,99154,99154,99156,0,2,1
28292,4,2,99158,99158,99160,0,2,2
28293,1,2,99159,99160,99162,1,3,0
28294,3,2,99162,99162,99164,0,2,0
28295,2,2,99164,99164,99166,0,2,0
28296,1,1,99165,99166,99167,1,2,0
28297,6,3,99171,99171,99174,0,3,4
28298,1,1,99172,99174,99175,2,3,0
28299,5,2,99177,99177,99179,0,2,2
28300,1,3,99178,99179,99182,1,4,0
28301,5,1,99183,99183,99184,0,1,1
28302,5,2,99188,99188,99190,0,2,4
28303,3,1,99191,99191,99192,0,1,1
28304,5,2,99196,99196,99198,0,2,4
28305,3,3,99199,99199,99202,0,3,1
28306,3,1,99202,99202,99203,0,1,0
28307,5,3,99207,99207,99210,0,3,4
28308,4,2,99211,99211,99213,0,2,1
28309,4,2,99215,99215,99217,0,2,2
28310,1,1,99216,99217,99218,1,2,0
28311,5,1,99221,99221,99222,0,1,3
28312,3,3,99224,99224,99227,0,3,2
28313,6,1,99230,99230,99231,0,1,3
28314,5,1,99235,99235,99236,0,1,4
28315,4,3,99239,99239,99242,0,3,3
28316,5,3,99244,99244,99247,0,3,2
28317,2,3,99246,99247,99250,1,4,0
28318,5,2,99251,99251,99253,0,2,1
28319,5,3,99256,99256,99259,0,3,3
28320,2,1,99258,99259,99260,1,2,0
28321,5,1,99263,99263,99264,0,1,3
28322,6,2,99269,99269,99271,0,2,5
28323,3,1,99272,99272,99273,0,1,1
28324,5,1,99277,99277,99278,0,1,4
28325,1,2,99278,99278,99280,0,2,0
28326,1,2,99279,99280,99282,1,3,0
28327,6,1,99285,99285,99286,0,1,3
28328,5,1,99290,99290,99291,0,1,4
28329,4,1,99294,99294,99295,0,1,3
28330,4,3,99298,99298,99301,0,3,3
28331,3,1,99301,99301,99302,0,1,0
28332,2,2,99303,99303,99305,0,2,1
28333,1,2,99304,99305,99307,1,3,0
28334,1,3,99305,99307,99310,2,5,0
28335,3,2,99308,99310,99312,2,4,0
28336,6,1,99314,99314,99315,0,1,2
28337,4,3,99318,99318,99321,0,3,3
28338,5,3,99323,99323,99326,0,3,2
28339,6,2,99329,99329,99331,0,2,3
28340,4,2,99333,99333,99335,0,2,2
28341,3,3,99336,99336,99339,0,3,1
28342,3,1,99339,99339,99340,0,1,0
28343,5,2,99344,99344,99346,0,2,4
28344,1,2,99345,99346,99348,1,3,0
28345,4,2,99349,99349,99351,0,2,1
28346,1,3,99350,99351,99354,1,4,0
28347,4,1,99354,99354,99355,0,1,0
28348,5,1,99359,99359,99360,0,1,4
28349,6,2,99365,99365,99367,0,2,5
28350,3,1,99368,99368,99369,0,1,1
28351,5,2,99373,99373,99375,0,2,4
28352,1,2,99374,99375,99377,1,3,0
28353,5,1,99379,99379,99380,0,1,2
28354,3,3,99382,99382,99385,0,3,2
28355,4,3,99386,99386,99389,0,3,1
28356,1,1,99387,99389,99390,2,3,0
28357,3,1,99390,99390,99391,0,1,0
28358,1,2,99391,99391,99393,0,2,0
28359,6,2,99397,99397,99399,0,2,4
28360,1,3,99398,99399,99402,1,4,0
28361,4,2,99402,99402,99404,0,2,0
28362,1,2,99403,99404,99406,1,3,0
28363,2,3,99405,99406,99409,1,4,0
28364,3,1,99408,99409,99410,1,2,0
28365,5,2,99413,99413,99415,0,2,3
28366,3,2,99416,99416,99418,0,2,1
28367,1,2,99417,99418,99420,1,3,0
28368,4,3,99421,99421,99424,0,3,1
28369,1,2,99422,99424,99426,2,4,0
28370,2,3,99424,99426,99429,2,5,0
28371,3,2,99427,99429,99431,2,4,0
28372,6,2,99433,99433,99435,0,2,2
28373,5,2,99438,99438,99440,0,2,3
28374,4,3,99442,99442,99445,0,3,2
28375,3,2,99445,99445,99447,0,2,0
28376,1,1,99446,99447,99448,1,2,0
28377,2,1,99448,99448,99449,0,1,0
28378,3,2,99451,99451,99453,0,2,2
28379,6,1,99457,99457,99458,0,1,4
28380,2,3,99459,99459,99462,0,3,1
28381,5,1,99464,99464,99465,0,1,2
28382,6,1,99470,99470,99471,0,1,5
28383,2,1,99472,99472,99473,0,1,1
28384,2,1,99474,99474,99475,0,1,1
28385,2,1,99476,99476,99477,0,1,1
28386,1,3,99477,99477,99480,0,3,0
28387,4,3,99481,99481,99484,0,3,1
28388,1,2,99482,99484,99486,2,4,0
28389,5,3,99487,99487,99490,0,3,1
28390,3,2,99490,99490,99492,0,2,0
28391,4,3,99494,99494,99497,0,3,2
28392,5,2,99499,99499,99501,0,2,2
28393,2,2,99501,99501,99503,0,2,0
28394,3,2,99504,99504,99506,0,2,1
28395,1,2,99505,99506,99508,1,3,0
28396,1,2,99506,99508,99510,2,4,0
28397,5,3,99511,99511,99514,0,3,1
28398,3,3,99514,99514,99517,0,3,0
28399,2,3,99516,99517,99520,1,4,0
28400,4,2,99520,99520,99522,0,2,0
28401,5,3,99525,99525,99528,0,3,3
28402,4,1,99529,99529,99530,0,1,1
28403,5,3,99534,99534,99537,0,3,4
28404,3,3,99537,99537,99540,0,3,0
28405,1,2,99538,99540,99542,2,4,0
28406,5,1,99543,99543,99544,0,1,1
28407,1,3,99544,99544,99547,0,3,0
28408,4,1,99548,99548,99549,0,1,1
28409,2,1,99550,99550,99551,0,1,1
28410,4,2,99554,99554,99556,0,2,3
28411,3,1,99557,99557,99558,0,1,1
28412,6,2,99563,99563,99565,0,2,5
28413,6,3,99569,99569,99572,0,3,4
28414,5,3,99574,99574,99577,0,3,2
28415,3,3,99577,99577,99580,0,3,0
28416,5,2,99582,99582,99584,0,2,2
28417,2,2,99584,99584,99586,0,2,0
28418,3,3,99587,99587,99590,0,3,1
28419,2,2,99589,99590,99592,1,3,0
28420,1,1,99590,99592,99593,2,3,0
28421,1,1,99591,99593,99594,2,3,0
28422,6,3,99597,99597,99600,0,3,3
28423,6,1,99603,99603,99604,0,1,3
28424,5,3,99608,99608,99611,0,3,4
28425,4,1,99612,99612,99613,0,1,1
28426,6,3,99618,99618,99621,0,3,5
28427,5,2,99623,99623,99625,0,2,2
28428,5,2,99628,99628,99630,0,2,3
28429,5,3,99633,99633,99636,0,3,3
28430,3,3,99636,99636,99639,0,3,0
28431,1,3,99637,99639,99642,2,5,0
28432,5,2,99642,99642,99644,0,2,0
28433,4,3,99646,99646,99649,0,3,2
28434,1,1,99647,99649,99650,2,3,0
28435,5,2,99652,99652,99654,0,2,2
28436,1,3,99653,99654,99657,1,4,0
28437,3,3,99656,99657,99660,1,4,0
28438,3,1,99659,99660,99661,1,2,0
28439,6,1,99665,99665,99666,0,1,4
28440,2,3,99667,99667,99670,0,3,1
28441,3,3,99670,99670,99673,0,3,0
28442,4,3,99674,99674,99677,0,3,1
28443,5,2,99679,99679,99681,0,2,2
28444,6,1,99685,99685,99686,0,1,4
28445,6,1,99691,99691,99692,0,1,5
28446,4,3,99695,99695,99698,0,3,3
28447,4,2,99699,99699,99701,0,2,1
28448,5,2,99704,99704,99706,0,2,3
28449,3,1,99707,99707,99708,0,1,1
28450,6,2,99713,99713,99715,0,2,5
28451,6,3,99719,99719,99722,0,3,4
28452,5,3,99724,99724,99727,0,3,2
28453,2,2,99726,99727,99729,1,3,0
28454,4,2,99730,99730,99732,0,2,1
28455,3,1,99733,99733,99734,0,1,1
28456,1,2,99734,99734,99736,0,2,0
28457,2,2,99736,99736,99738,0,2,0
28458,3,3,99739,99739,99742,0,3,1
28459,5,2,99744,99744,99746,0,2,2
28460,5,1,99749,99749,99750,0,1,3
28461,3,2,99752,99752,99754,0,2,2
28462,3,3,99755,99755,99758,0,3,1
28463,2,1,99757,99758,99759,1,2,0
28464,1,2,99758,99759,99761,1,3,0
28465,4,2,99762,99762,99764,0,2,1
28466,5,3,99767,99767,99770,0,3,3
28467,2,2,99769,99770,99772,1,3,0
28468,2,2,99771,99772,99774,1,3,0
28469,5,3,99776,99776,99779,0,3,2
28470,3,2,99779,99779,99781,0,2,0
28471,1,3,99780,99781,99784,1,4,0
28472,5,2,99785,99785,99787,0,2,1
28473,4,3,99789,99789,99792,0,3,2
28474,6,2,99795,99795,99797,0,2,3
28475,2,2,99797,99797,99799,0,2,0
28476,1,2,99798,99799,99801,1,3,0
28477,5,2,99803,99803,99805,0,2,2
28478,5,3,99808,99808,99811,0,3,3
28479,5,3,99813,99813,99816,0,3,2
28480,4,3,99817,99817,99820,0,3,1
28481,3,1,99820,99820,99821,0,1,0
28482,4,2,99824,99824,99826,0,2,3
28483,3,2,99827,99827,99829,0,2,1
28484,6,2,99833,99833,99835,0,2,4
28485,5,2,99838,99838,99840,0,2,3
28486,2,2,99840,99840,99842,0,2,0
28487,2,2,99842,99842,99844,0,2,0
28488,2,3,99844,99844,99847,0,3,0
28489,3,2,99847,99847,99849,0,2,0
28490,5,1,99852,99852,99853,0,1,3
28491,6,1,99858,99858,99859,0,1,5
28492,4,1,99862,99862,99863,0,1,3
28493,1,3,99863,99863,99866,0,3,0
28494,2,1,99865,99866,99867,1,2,0
28495,6,2,99871,99871,99873,0,2,4
28496,4,2,99875,99875,99877,0,2,2
28497,1,3,99876,99877,99880,1,4,0
28498,1,2,99877,99880,99882,3,5,0
28499,4,3,99881,99882,99885,1,4,0
28500,5,3,99886,99886,99889,0,3,1
28501,2,2,99888,99889,99891,1,3,0
28502,5,3,99893,99893,99896,0,3,2
28503,1,1,99894,99896,99897,2,3,0
28504,1,2,99895,99897,99899,2,4,0
28505,4,2,99899,99899,99901,0,2,0
28506,2,2,99901,99901,99903,0,2,0
28507,1,1,99902,99903,99904,1,2,0
28508,3,2,99905,99905,99907,0,2,1
28509,5,2,99910,99910,99912,0,2,3
28510,6,2,99916,99916,99918,0,2,4
28511,2,2,99918,99918,99920,0,2,0
28512,5,3,99923,99923,99926,0,3,3
28513,4,2,99927,99927,99929,0,2,1
28514,4,3,99931,99931,99934,0,3,2
28515,6,1,99937,99937,99938,0,1,3
28516,5,2,99942,99942,99944,0,2,4
28517,1,3,99943,99944,99947,1,4,0
28518,5,2,99948,99948,99950,0,2,1
28519,5,1,99953,99953,99954,0,1,3
28520,5,1,99958,99958,99959,0,1,4
28521,4,3,99962,99962,99965,0,3,3
28522,4,1,99966,99966,99967,0,1,1
28523,5,1,99971,99971,99972,0,1,4
28524,2,1,99973,99973,99974,0,1,1
28525,3,2,99976,99976,99978,0,2,2
28526,4,2,99980,99980,99982,0,2,2
28527,1,3,99981,99982,99985,1,4,0
28528,3,2,99984,99985,99987,1,3,0
28529,4,2,99988,99988,99990,0,2,1
28530,6,2,99994,99994,99996,0,2,4
28531,3,1,99997,99997,99998,0,1,1
28532,3,1,100000,100000,100001,0,1,2
28533,3,3,100003,100003,100006,0,3,2
28534,5,3,100008,100008,100011,0,3,2
28535,1,3,100009,100011,100014,2,5,0
28536,4,3,100013,100014,100017,1,4,0
28537,3,3,100016,100017,100020,1,4,0
28538,2,1,100018,100020,100021,2,3,0
28539,1,2,100019,100021,100023,2,4,0
28540,2,1,100021,100023,100024,2,3,0
28541,5,1,100026,100026,100027,0,1,2
28542,6,2,100032,100032,100034,0,2,5
28543,2,3,100034,100034,100037,0,3,0
28544,6,1,100040,100040,100041,0,1,3
28545,1,2,100041,100041,100043,0,2,0
28546,6,2,100047,100047,100049,0,2,4
28547,4,3,100051,100051,100054,0,3,2
28548,2,3,100053,100054,100057,1,4,0
28549,4,1,100057,100057,100058,0,1,0
28550,5,3,100062,100062,100065,0,3,4
28551,2,1,100064,100065,100066,1,2,0
28552,2,3,100066,100066,100069,0,3,0
28553,4,1,100070,100070,100071,0,1,1
28554,2,1,100072,100072,100073,0,1,1
28555,6,1,100078,100078,100079,0,1,5
28556,6,2,100084,100084,100086,0,2,5
28557,2,3,100086,100086,100089,0,3,0
28558,5,2,100091,100091,100093,0,2,2
28559,1,2,100092,100093,100095,1,3,0
28560,3,2,100095,100095,100097,0,2,0
28561,2,1,100097,100097,100098,0,1,0
28562,5,1,100102,100102,100103,0,1,4
28563,4,2,100106,100106,100108,0,2,3
28564,6,1,100112,100112,100113,0,1,4
28565,4,2,100116,100116,100118,0,2,3
28566,6,2,100122,100122,100124,0,2,4
28567,5,1,100127,100127,100128,0,1,3
28568,5,1,100132,100132,100133,0,1,4
28569,1,3,100133,100133,100136,0,3,0
28570,3,1,100136,100136,100137,0,1,0
28571,1,2,100137,100137,100139,0,2,0
28572,5,3,100142,100142,100145,0,3,3
28573,2,2,100144,100145,100147,1,3,0
28574,6,1,100150,100150,100151,0,1,3
28575,2,2,100152,100152,100154,0,2,1
28576,4,2,100156,100156,100158,0,2,2
28577,6,1,100162,100162,100163,0,1,4
28578,2,3,100164,100164,100167,0,3,1
28579,1,2,100165,100167,100169,2,4,0
28580,6,2,100171,100171,100173,0,2,2
28581,4,3,100175,100175,100178,0,3,2
28582,4,1,100179,100179,100180,0,1,1
28583,2,3,100181,100181,100184,0,3,1
28584,5,1,100186,100186,100187,0,1,2
28585,5,2,100191,100191,100193,0,2,4
28586,1,3,100192,100193,100196,1,4,0
28587,6,1,100198,100198,100199,0,1,2
28588,5,1,100203,100203,100204,0,1,4
28589,2,3,100205,100205,100208,0,3,1
28590,5,3,100210,100210,100213,0,3,2
28591,4,2,100214,100214,100216,0,2,1
28592,3,1,100217,100217,100218,0,1,1
28593,5,1,100222,100222,100223,0,1,4
28594,2,2,100224,100224,100226,0,2,1
28595,2,2,100226,100226,100228,0,2,0
28596,2,2,100228,100228,100230,0,2,0
28597,3,3,100231,100231,100234,0,3,1
28598,2,2,100233,100234,100236,1,3,0
28599,4,1,100237,100237,100238,0,1,1
28600,4,2,100241,100241,100243,0,2,3
28601,3,2,100244,100244,100246,0,2,1
28602,3,3,100247,100247,100250,0,3,1
28603,1,3,100248,100250,100253,2,5,0
28604,4,2,100252,100253,100255,1,3,0
28605,2,1,100254,100255,100256,1,2,0
28606,2,1,100256,100256,100257,0,1,0
28607,6,1,100262,100262,100263,0,1,5
28608,1,1,100263,100263,100264,0,1,0
28609,3,1,100266,100266,100267,0,1,2
28610,6,1,100272,100272,100273,0,1,5
28611,2,2,100274,100274,100276,0,2,1
28612,4,2,100278,100278,100280,0,2,2
28613,6,1,100284,100284,100285,0,1,4
28614,5,1,100289,100289,100290,0,1,4
28615,1,3,100290,100290,100293,0,3,0
28616,4,2,100294,100294,100296,0,2,1
28617,4,1,100298,100298,100299,0,1,2
28618,3,3,100301,100301,100304,0,3,2
28619,3,2,100304,100304,100306,0,2,0
28620,2,1,100306,100306,100307,0,1,0
28621,2,1,100308,100308,100309,0,1,1
28622,6,3,100314,100314,100317,0,3,5
28623,5,1,100319,100319,100320,0,1,2
28624,5,1,100324,100324,100325,0,1,4
28625,4,2,100328,100328,100330,0,2,3
28626,3,2,100331,100331,100333,0,2,1
28627,1,2,100332,100333,100335,1,3,0
28628,6,3,100338,100338,100341,0,3,3
28629,4,1,100342,100342,100343,0,1,1
28630,1,1,100343,100343,100344,0,1,0
28631,4,2,100347,100347,100349,0,2,3
28632,4,1,100351,100351,100352,0,1,2
28633,3,2,100354,100354,100356,0,2,2
28634,2,2,100356,100356,100358,0,2,0
28635,3,1,100359,100359,100360,0,1,1
28636,6,3,100365,100365,100368,0,3,5
28637,4,1,100369,100369,100370,0,1,1
28638,5,1,100374,100374,100375,0,1,4
28639,3,1,100377,100377,100378,0,1,2
28640,4,1,100381,100381,100382,0,1,3
28641,2,1,100383,100383,100384,0,1,1
28642,1,2,100384,100384,100386,0,2,0
28643,2,1,100386,100386,100387,0,1,0
28644,3,2,100389,100389,100391,0,2,2
28645,1,1,100390,100391,100392,1,2,0
28646,3,1,100393,100393,100394,0,1,1
28647,1,2,100394,100394,100396,0,2,0
28648,6,2,100400,100400,100402,0,2,4
28649,6,2,100406,100406,100408,0,2,4
28650,3,1,100409,100409,100410,0,1,1
28651,1,2,100410,100410,100412,0,2,0
28652,1,1,100411,100412,100413,1,2,0
28653,4,2,100415,100415,100417,0,2,2
28654,6,1,100421,100421,100422,0,1,4
28655,4,2,100425,100425,100427,0,2,3
28656,3,1,100428,100428,100429,0,1,1
28657,1,1,100429,100429,100430,0,1,0
28658,5,2,100434,100434,100436,0,2,4
28659,2,1,100436,100436,100437,0,1,0
28660,6,3,100442,100442,100445,0,3,5
28661,1,2,100443,100445,100447,2,4,0
28662,4,3,100447,100447,100450,0,3,0
28663,1,2,100448,100450,100452,2,4,0
28664,2,2,100450,100452,100454,2,4,0
28665,4,3,100454,100454,100457,0,3,0
28666,3,3,100457,100457,100460,0,3,0
28667,6,3,100463,100463,100466,0,3,3
28668,4,1,100467,100467,100468,0,1,1
28669,1,2,100468,100468,100470,0,2,0
28670,5,1,100473,100473,100474,0,1,3
28671,6,3,100479,100479,100482,0,3,5
28672,2,3,100481,100482,100485,1,4,0
28673,3,1,100484,100485,100486,1,2,0
28674,6,2,100490,100490,100492,0,2,4
28675,5,1,100495,100495,100496,0,1,3
28676,4,3,100499,100499,100502,0,3,3
28677,6,3,100505,100505,100508,0,3,3
28678,3,3,100508,100508,100511,0,3,0
28679,6,3,100514,100514,100517,0,3,3
28680,2,1,100516,100517,100518,1,2,0
28681,3,3,100519,100519,100522,0,3,1
28682,1,3,100520,100522,100525,2,5,0
28683,4,3,100524,100525,100528,1,4,0
28684,2,3,100526,100528,100531,2,5,0
28685,4,1,100530,100531,100532,1,2,0
28686,3,3,100533,100533,100536,0,3,1
28687,3,1,100536,100536,100537,0,1,0
28688,3,2,100539,100539,100541,0,2,2
28689,1,2,100540,100541,100543,1,3,0
28690,4,2,100544,100544,100546,0,2,1
28691,1,2,100545,100546,100548,1,3,0
28692,4,1,100549,100549,100550,0,1,1
28693,6,1,100555,100555,100556,0,1,5
28694,6,3,100561,100561,100564,0,3,5
28695,6,2,100567,100567,100569,0,2,3
28696,1,3,100568,100569,100572,1,4,0
28697,3,2,100571,100572,100574,1,3,0
28698,2,3,100573,100574,100577,1,4,0
28699,5,1,100578,100578,100579,0,1,1
28700,6,3,100584,100584,100587,0,3,5
28701,5,1,100589,100589,100590,0,1,2
28702,3,1,100592,100592,100593,0,1,2
28703,4,2,100596,100596,100598,0,2,3
28704,3,2,100599,100599,100601,0,2,1
28705,1,1,100600,100601,100602,1,2,0
28706,2,1,100602,100602,100603,0,1,0
28707,2,1,100604,100604,100605,0,1,1
28708,1,2,100605,100605,100607,0,2,0
28709,5,2,100610,100610,100612,0,2,3
28710,2,2,100612,100612,100614,0,2,0
28711,1,1,100613,100614,100615,1,2,0
28712,4,2,100617,100617,100619,0,2,2
28713,6,3,100623,100623,100626,0,3,4
28714,2,2,100625,100626,100628,1,3,0
28715,3,3,100628,100628,100631,0,3,0
28716,4,1,100632,100632,100633,0,1,1
28717,5,2,100637,100637,100639,0,2,4
28718,1,1,100638,100639,100640,1,2,0
28719,3,2,100641,100641,100643,0,2,1
28720,1,2,100642,100643,100645,1,3,0
28721,6,2,100648,100648,100650,0,2,3
28722,6,3,100654,100654,100657,0,3,4
28723,3,1,100657,100657,100658,0,1,0
28724,6,2,100663,100663,100665,0,2,5
28725,5,2,100668,100668,100670,0,2,3
28726,3,2,100671,100671,100673,0,2,1
28727,1,3,100672,100673,100676,1,4,0
28728,6,3,100678,100678,100681,0,3,2
28729,6,1,100684,100684,100685,0,1,3
28730,2,3,100686,100686,100689,0,3,1
28731,1,1,100687,100689,100690,2,3,0
28732,6,1,100693,100693,100694,0,1,3
28733,2,1,100695,100695,100696,0,1,1
28734,3,1,100698,100698,100699,0,1,2
28735,4,2,100702,100702,100704,0,2,3
28736,3,1,100705,100705,100706,0,1,1
28737,4,2,100709,100709,100711,0,2,3
28738,4,2,100713,100713,100715,0,2,2
28739,4,1,100717,100717,100718,0,1,2
28740,5,1,100722,100722,100723,0,1,4
28741,1,3,100723,100723,100726,0,3,0
28742,6,1,100729,100729,100730,0,1,3
28743,5,3,100734,100734,100737,0,3,4
28744,3,3,100737,100737,100740,0,3,0
28745,2,1,100739,100740,100741,1,2,0
28746,6,3,100745,100745,100748,0,3,4
28747,3,1,100748,100748,100749,0,1,0
28748,3,2,100751,100751,100753,0,2,2
28749,2,2,100753,100753,100755,0,2,0
28750,3,2,100756,100756,100758,0,2,1
28751,4,3,100760,100760,100763,0,3,2
28752,5,1,100765,100765,100766,0,1,2
28753,3,2,100768,100768,100770,0,2,2
28754,2,1,100770,100770,100771,0,1,0
28755,2,2,100772,100772,100774,0,2,1
28756,5,1,100777,100777,100778,0,1,3
28757,5,2,100782,100782,100784,0,2,4
28758,3,2,100785,100785,100787,0,2,1
28759,5,3,100790,100790,100793,0,3,3
28760,3,2,100793,100793,100795,0,2,0
28761,6,1,100799,100799,100800,0,1,4
28762,5,1,100804,100804,100805,0,1,4
28763,3,1,100807,100807,100808,0,1,2
28764,6,2,100813,100813,100815,0,2,5
28765,5,1,100818,100818,100819,0,1,3
28766,2,1,100820,100820,100821,0,1,1
28767,4,2,100824,100824,100826,0,2,3
28768,5,1,100829,100829,100830,0,1,3
28769,3,1,100832,100832,100833,0,1,2
28770,3,3,100835,100835,100838,0,3,2
28771,4,2,100839,100839,100841,0,2,1
28772,1,1,100840,100841,100842,1,2,0
28773,3,2,100843,100843,100845,0,2,1
28774,5,1,100848,100848,100849,0,1,3
28775,4,3,100852,100852,100855,0,3,3
28776,2,2,100854,100855,100857,1,3,0
28777,3,3,100857,100857,100860,0,3,0
28778,2,1,100859,100860,100861,1,2,0
28779,5,2,100864,100864,100866,0,2,3
28780,1,1,100865,100866,100867,1,2,0
28781,5,3,100870,100870,100873,0,3,3
28782,1,1,100871,100873,100874,2,3,0
28783,1,2,100872,100874,100876,2,4,0
28784,1,1,100873,100876,100877,3,4,0
28785,5,2,100878,100878,100880,0,2,1
28786,3,2,100881,100881,100883,0,2,1
28787,4,3,100885,100885,100888,0,3,2
28788,3,2,100888,100888,100890,0,2,0
28789,3,3,100891,100891,100894,0,3,1
28790,6,1,100897,100897,100898,0,1,3
28791,4,1,100901,100901,100902,0,1,3
28792,4,1,100905,100905,100906,0,1,3
28793,6,1,100911,100911,100912,0,1,5
28794,2,1,100913,100913,100914,0,1,1
28795,2,1,100915,100915,100916,0,1,1
28796,6,3,100921,100921,100924,0,3,5
28797,4,1,100925,100925,100926,0,1,1
28798,3,1,100928,100928,100929,0,1,2
28799,1,2,100929,100929,100931,0,2,0
28800,3,2,100932,100932,100934,0,2,1
28801,5,2,100937,100937,100939,0,2,3
28802,3,1,100940,100940,100941,0,1,1
28803,6,1,100946,100946,100947,0,1,5
28804,6,3,100952,100952,100955,0,3,5
28805,1,3,100953,100955,100958,2,5,0
28806,5,3,100958,100958,100961,0,3,0
28807,2,1,100960,100961,100962,1,2,0
28808,5,1,100965,100965,100966,0,1,3
28809,6,1,100971,100971,100972,0,1,5
28810,1,3,100972,100972,100975,0,3,0
28811,6,1,100978,100978,100979,0,1,3
28812,4,1,100982,100982,100983,0,1,3
28813,1,1,100983,100983,100984,0,1,0
28814,3,2,100986,100986,100988,0,2,2
28815,1,2,100987,100988,100990,1,3,0
28816,4,2,100991,100991,100993,0,2,1
28817,5,3,100996,100996,100999,0,3,3
28818,5,3,101001,101001,101004,0,3,2
28819,5,2,101006,101006,101008,0,2,2
28820,1,1,101007,101008,101009,1,2,0
28821,5,1,101012,101012,101013,0,1,3
28822,3,1,101015,101015,101016,0,1,2
28823,6,2,101021,101021,101023,0,2,5
28824,1,1,101022,101023,101024,1,2,0
28825,1,3,101023,101024,101027,1,4,0
28826,5,3,101028,101028,101031,0,3,1
28827,5,1,101033,101033,101034,0,1,2
28828,1,3,101034,101034,101037,0,3,0
28829,6,1,101040,101040,101041,0,1,3
28830,5,1,101045,101045,101046,0,1,4
28831,3,2,101048,101048,101050,0,2,2
28832,5,2,101053,101053,101055,0,2,3
28833,2,2,101055,101055,101057,0,2,0
28834,1,1,101056,101057,101058,1,2,0
28835,1,1,101057,101058,101059,1,2,0
28836,2,2,101059,101059,101061,0,2,0
28837,4,2,101063,101063,101065,0,2,2
28838,1,2,101064,101065,101067,1,3,0
28839,6,1,101070,101070,101071,0,1,3
28840,1,2,101071,101071,101073,0,2,0
28841,1,2,101072,101073,101075,1,3,0
28842,3,2,101075,101075,101077,0,2,0
28843,3,3,101078,101078,101081,0,3,1
28844,3,3,101081,101081,101084,0,3,0
28845,4,2,101085,101085,101087,0,2,1
28846,6,2,101091,101091,101093,0,2,4
28847,3,1,101094,101094,101095,0,1,1
28848,1,2,101095,101095,101097,0,2,0
28849,1,3,101096,101097,101100,1,4,0
28850,2,1,101098,101100,101101,2,3,0
28851,3,1,101101,101101,101102,0,1,0
28852,5,3,101106,101106,101109,0,3,4
28853,4,2,101110,101110,101112,0,2,1
28854,3,1,101113,101113,101114,0,1,1
28855,2,2,101115,101115,101117,0,2,1
28856,3,1,101118,101118,101119,0,1,1
28857,3,3,101121,101121,101124,0,3,2
28858,1,3,101122,101124,101127,2,5,0
28859,1,1,101123,101127,101128,4,5,0
28860,5,1,101128,101128,101129,0,1,0
28861,4,2,101132,101132,101134,0,2,3
28862,1,1,101133,101134,101135,1,2,0
28863,2,2,101135,101135,101137,0,2,0
28864,3,1,101138,101138,101139,0,1,1
28865,2,3,101140,101140,101143,0,3,1
28866,5,2,101145,101145,101147,0,2,2
28867,6,2,101151,101151,101153,0,2,4
28868,4,3,101155,101155,101158,0,3,2
28869,5,1,101160,101160,101161,0,1,2
28870,1,3,101161,101161,101164,0,3,0
28871,5,2,101166,101166,101168,0,2,2
28872,5,3,101171,101171,101174,0,3,3
28873,6,1,101177,101177,101178,0,1,3
28874,6,1,101183,101183,101184,0,1,5
28875,4,2,101187,101187,101189,0,2,3
28876,4,1,101191,101191,101192,0,1,2
28877,6,1,101197,101197,101198,0,1,5
28878,5,1,101202,101202,101203,0,1,4
28879,6,3,101208,101208,101211,0,3,5
28880,3,2,101211,101211,101213,0,2,0
28881,3,3,101214,101214,101217,0,3,1
28882,6,2,101220,101220,101222,0,2,3
28883,4,2,101224,101224,101226,0,2,2
28884,3,3,101227,101227,101230,0,3,1
28885,5,2,101232,101232,101234,0,2,2
28886,2,3,101234,101234,101237,0,3,0
28887,4,2,101238,101238,101240,0,2,1
28888,4,3,101242,101242,101245,0,3,2
28889,4,2,101246,101246,101248,0,2,1
28890,6,2,101252,101252,101254,0,2,4
28891,1,1,101253,101254,101255,1,2,0
28892,6,2,101259,101259,101261,0,2,4
28893,2,3,101261,101261,101264,0,3,0
28894,5,2,101266,101266,101268,0,2,2
28895,2,2,101268,101268,101270,0,2,0
28896,6,1,101274,101274,101275,0,1,4
28897,4,2,101278,101278,101280,0,2,3
28898,2,3,101280,101280,101283,0,3,0
28899,1,1,101281,101283,101284,2,3,0
28900,6,3,101287,101287,101290,0,3,3
28901,1,1,101288,101290,101291,2,3,0
28902,1,3,101289,101291,101294,2,5,0
28903,6,3,101295,101295,101298,0,3,1
28904,6,2,101301,101301,101303,0,2,3
28905,5,2,101306,101306,101308,0,2,3
28906,4,1,101310,101310,101311,0,1,2
28907,1,2,101311,101311,101313,0,2,0
28908,6,1,101317,101317,101318,0,1,4
28909,5,3,101322,101322,101325,0,3,4
28910,3,3,101325,101325,101328,0,3,0
28911,3,1,101328,101328,101329,0,1,0
28912,5,1,101333,101333,101334,0,1,4
28913,1,1,101334,101334,101335,0,1,0
28914,1,2,101335,101335,101337,0,2,0
28915,3,2,101338,101338,101340,0,2,1
28916,3,2,101341,101341,101343,0,2,1
28917,2,2,101343,101343,101345,0,2,0
28918,3,3,101346,101346,101349,0,3,1
28919,6,1,101352,101352,101353,0,1,3
28920,6,1,101358,101358,101359,0,1,5
28921,5,2,101363,101363,101365,0,2,4
28922,3,2,101366,101366,101368,0,2,1
28923,2,1,101368,101368,101369,0,1,0
28924,3,3,101371,101371,101374,0,3,2
28925,4,2,101375,101375,101377,0,2,1
28926,3,2,101378,101378,101380,0,2,1
28927,5,2,101383,101383,101385,0,2,3
28928,1,3,101384,101385,101388,1,4,0
28929,3,3,101387,101388,101391,1,4,0
28930,2,3,101389,101391,101394,2,5,0
28931,1,3,101390,101394,101397,4,7,0
28932,5,3,101395,101397,101400,2,5,0
28933,1,3,101396,101400,101403,4,7,0
28934,6,3,101402,101403,101406,1,4,0
28935,2,1,101404,101406,101407,2,3,0
28936,3,3,101407,101407,101410,0,3,0
28937,5,3,101412,101412,101415,0,3,2
28938,5,1,101417,101417,101418,0,1,2
28939,6,3,101423,101423,101426,0,3,5
28940,6,2,101429,101429,101431,0,2,3
28941,6,1,101435,101435,101436,0,1,4
28942,5,1,101440,101440,101441,0,1,4
28943,1,3,101441,101441,101444,0,3,0
28944,6,2,101447,101447,101449,0,2,3
28945,2,2,101449,101449,101451,0,2,0
28946,4,3,101453,101453,101456,0,3,2
28947,4,1,101457,101457,101458,0,1,1
28948,4,3,101461,101461,101464,0,3,3
28949,4,1,101465,101465,101466,0,1,1
28950,3,3,101468,101468,101471,0,3,2
28951,1,2,101469,101471,101473,2,4,0
28952,6,2,101475,101475,101477,0,2,2
28953,1,2,101476,101477,101479,1,3,0
28954,4,1,101480,101480,101481,0,1,1
28955,1,3,101481,101481,101484,0,3,0
28956,6,1,101487,101487,101488,0,1,3
28957,1,3,101488,101488,101491,0,3,0
28958,1,3,101489,101491,101494,2,5,0
28959,6,1,101495,101495,101496,0,1,1
28960,6,3,101501,101501,101504,0,3,5
28961,3,1,101504,101504,101505,0,1,0
28962,2,2,101506,101506,101508,0,2,1
28963,5,1,101511,101511,101512,0,1,3
28964,4,2,101515,101515,101517,0,2,3
28965,3,2,101518,101518,101520,0,2,1
28966,6,1,101524,101524,101525,0,1,4
28967,5,1,101529,101529,101530,0,1,4
28968,3,3,101532,101532,101535,0,3,2
28969,4,1,101536,101536,101537,0,1,1
28970,6,3,101542,101542,101545,0,3,5
28971,4,2,101546,101546,101548,0,2,1
28972,2,1,101548,101548,101549,0,1,0
28973,5,3,101553,101553,101556,0,3,4
28974,1,2,101554,101556,101558,2,4,0
28975,1,3,101555,101558,101561,3,6,0
28976,5,3,101560,101561,101564,1,4,0
28977,1,1,101561,101564,101565,3,4,0
28978,1,1,101562,101565,101566,3,4,0
28979,5,1,101567,101567,101568,0,1,1
28980,6,2,101573,101573,101575,0,2,5
28981,6,3,101579,101579,101582,0,3,4
28982,5,3,101584,101584,101587,0,3,2
28983,5,3,101589,101589,101592,0,3,2
28984,4,1,101593,101593,101594,0,1,1
28985,5,1,101598,101598,101599,0,1,4
28986,2,2,101600,101600,101602,0,2,1
28987,3,1,101603,101603,101604,0,1,1
28988,2,2,101605,101605,101607,0,2,1
28989,6,3,101611,101611,101614,0,3,4
28990,3,1,101614,101614,101615,0,1,0
28991,1,3,101615,101615,101618,0,3,0
28992,1,1,101616,101618,101619,2,3,0
28993,2,1,101618,101619,101620,1,2,0
28994,5,3,101623,101623,101626,0,3,3
28995,1,1,101624,101626,101627,2,3,0
28996,1,1,101625,101627,101628,2,3,0
28997,1,2,101626,101628,101630,2,4,0
28998,1,1,101627,101630,101631,3,4,0
28999,4,1,101631,101631,101632,0,1,0
29000,5,2,101636,101636,101638,0,2,4
29001,5,3,101641,101641,101644,0,3,3
29002,3,2,101644,101644,101646,0,2,0
29003,5,3,101649,101649,101652,0,3,3
29004,6,1,101655,101655,101656,0,1,3
29005,3,1,101658,101658,101659,0,1,2
29006,4,2,101662,101662,101664,0,2,3
29007,5,3,101667,101667,101670,0,3,3
29008,1,1,101668,101670,101671,2,3,0
29009,3,2,101671,101671,101673,0,2,0
29010,5,3,101676,101676,101679,0,3,3
29011,5,3,101681,101681,101684,0,3,2
29012,2,1,101683,101684,101685,1,2,0
29013,3,1,101686,101686,101687,0,1,1
29014,1,2,101687,101687,101689,0,2,0
29015,5,3,101692,101692,101695,0,3,3
29016,4,1,101696,101696,101697,0,1,1
29017,5,3,101701,101701,101704,0,3,4
29018,3,2,101704,101704,101706,0,2,0
29019,3,2,101707,101707,101709,0,2,1
29020,1,3,101708,101709,101712,1,4,0
29021,5,3,101713,101713,101716,0,3,1
29022,2,1,101715,101716,101717,1,2,0
29023,3,2,101718,101718,101720,0,2,1
29024,3,2,101721,101721,101723,0,2,1
29025,6,3,101727,101727,101730,0,3,4
29026,4,1,101731,101731,101732,0,1,1
29027,6,1,101737,101737,101738,0,1,5
29028,4,2,101741,101741,101743,0,2,3
29029,3,2,101744,101744,101746,0,2,1
29030,4,3,101748,101748,101751,0,3,2
29031,6,3,101754,101754,101757,0,3,3
29032,5,3,101759,101759,101762,0,3,2
29033,4,3,101763,101763,101766,0,3,1
29034,2,2,101765,101766,101768,1,3,0
29035,4,2,101769,101769,101771,0,2,1
29036,6,1,101775,101775,101776,0,1,4
29037,4,1,101779,101779,101780,0,1,3
29038,6,2,101785,101785,101787,0,2,5
29039,2,3,101787,101787,101790,0,3,0
29040,5,2,101792,101792,101794,0,2,2
29041,3,1,101795,101795,101796,0,1,1
29042,4,1,101799,101799,101800,0,1,3
29043,4,3,101803,101803,101806,0,3,3
29044,2,2,101805,101806,101808,1,3,0
29045,5,1,101810,101810,101811,0,1,2
29046,4,3,101814,101814,101817,0,3,3
29047,3,3,101817,101817,101820,0,3,0
29048,3,3,101820,101820,101823,0,3,0
29049,1,2,101821,101823,101825,2,4,0
29050,3,1,101824,101825,101826,1,2,0
29051,2,3,101826,101826,101829,0,3,0
29052,2,2,101828,101829,101831,1,3,0
29053,1,1,101829,101831,101832,2,3,0
29054,2,1,101831,101832,101833,1,2,0
29055,5,1,101836,101836,101837,0,1,3
29056,5,3,101841,101841,101844,0,3,4
29057,3,1,101844,101844,101845,0,1,0
29058,3,2,101847,101847,101849,0,2,2
29059,2,2,101849,101849,101851,0,2,0
29060,5,1,101854,101854,101855,0,1,3
29061,2,2,101856,101856,101858,0,2,1
29062,1,2,101857,101858,101860,1,3,0
29063,6,2,101863,101863,101865,0,2,3
29064,3,1,101866,101866,101867,0,1,1
29065,2,1,101868,101868,101869,0,1,1
29066,5,2,101873,101873,101875,0,2,4
29067,6,3,101879,101879,101882,0,3,4
29068,5,3,101884,101884,101887,0,3,2
29069,6,3,101890,101890,101893,0,3,3
29070,5,2,101895,101895,101897,0,2,2
29071,1,3,101896,101897,101900,1,4,0
29072,1,1,101897,101900,101901,3,4,0
29073,2,3,101899,101901,101904,2,5,0
29074,4,1,101903,101904,101905,1,2,0
29075,3,1,101906,101906,101907,0,1,1
29076,5,3,101911,101911,101914,0,3,4
29077,2,3,101913,101914,101917,1,4,0
29078,2,2,101915,101917,101919,2,4,0
29079,5,3,101920,101920,101923,0,3,1
29080,3,1,101923,101923,101924,0,1,0
29081,6,2,101929,101929,101931,0,2,5
29082,3,2,101932,101932,101934,0,2,1
29083,5,3,101937,101937,101940,0,3,3
29084,4,3,101941,101941,101944,0,3,1
29085,5,3,101946,101946,101949,0,3,2
29086,5,3,101951,101951,101954,0,3,2
29087,3,1,101954,101954,101955,0,1,0
29088,1,3,101955,101955,101958,0,3,0
29089,2,1,101957,101958,101959,1,2,0
29090,3,3,101960,101960,101963,0,3,1
29091,1,2,101961,101963,101965,2,4,0
29092,4,2,101965,101965,101967,0,2,0
29093,2,1,101967,101967,101968,0,1,0
29094,3,3,101970,101970,101973,0,3,2
29095,4,1,101974,101974,101975,0,1,1
29096,1,1,101975,101975,101976,0,1,0
29097,4,1,101979,101979,101980,0,1,3
29098,1,2,101980,101980,101982,0,2,0
29099,3,1,101983,101983,101984,0,1,1
29100,5,1,101988,101988,101989,0,1,4
29101,2,3,101990,101990,101993,0,3,1
29102,4,1,101994,101994,101995,0,1,1
29103,5,3,101999,101999,102002,0,3,4
29104,3,1,102002,102002,102003,0,1,0
29105,6,2,102008,102008,102010,0,2,5
29106,3,2,102011,102011,102013,0,2,1
29107,2,1,102013,102013,102014,0,1,0
29108,5,1,102018,102018,102019,0,1,4
29109,6,2,102024,102024,102026,0,2,5
29110,1,2,102025,102026,102028,1,3,0
29111,2,1,102027,102028,102029,1,2,0
29112,6,3,102033,102033,102036,0,3,4
29113,6,2,102039,102039,102041,0,2,3
29114,6,3,102045,102045,102048,0,3,4
29115,1,2,102046,102048,102050,2,4,0
29116,6,2,102052,102052,102054,0,2,2
29117,4,3,102056,102056,102059,0,3,2
29118,4,3,102060,102060,102063,0,3,1
29119,1,1,102061,102063,102064,2,3,0
29120,6,1,102067,102067,102068,0,1,3
29121,4,2,102071,102071,102073,0,2,3
29122,3,2,102074,102074,102076,0,2,1
29123,2,2,102076,102076,102078,0,2,0
29124,5,2,102081,102081,102083,0,2,3
29125,6,2,102087,102087,102089,0,2,4
29126,5,3,102092,102092,102095,0,3,3
29127,6,2,102098,102098,102100,0,2,3
29128,6,1,102104,102104,102105,0,1,4
29129,6,2,102110,102110,102112,0,2,5
29130,4,2,102114,102114,102116,0,2,2
29131,3,3,102117,102117,102120,0,3,1
29132,2,1,102119,102120,102121,1,2,0
29133,5,3,102124,102124,102127,0,3,3
29134,5,1,102129,102129,102130,0,1,2
29135,1,1,102130,102130,102131,0,1,0
29136,5,2,102135,102135,102137,0,2,4
29137,4,3,102139,102139,102142,0,3,2
29138,2,1,102141,102142,102143,1,2,0
29139,2,3,102143,102143,102146,0,3,0
29140,6,3,102149,102149,102152,0,3,3
29141,2,1,102151,102152,102153,1,2,0
29142,6,1,102157,102157,102158,0,1,4
29143,2,2,102159,102159,102161,0,2,1
29144,1,3,102160,102161,102164,1,4,0
29145,4,3,102164,102164,102167,0,3,0
29146,1,1,102165,102167,102168,2,3,0
29147,1,2,102166,102168,102170,2,4,0
29148,2,1,102168,102170,102171,2,3,0
29149,5,2,102173,102173,102175,0,2,2
29150,5,2,102178,102178,102180,0,2,3
29151,1,2,102179,102180,102182,1,3,0
29152,1,1,102180,102182,102183,2,3,0
29153,6,1,102186,102186,102187,0,1,3
29154,5,3,102191,102191,102194,0,3,4
29155,1,1,102192,102194,102195,2,3,0
29156,3,2,102195,102195,102197,0,2,0
29157,2,3,102197,102197,102200,0,3,0
29158,3,1,102200,102200,102201,0,1,0
29159,5,2,102205,102205,102207,0,2,4
29160,6,2,102211,102211,102213,0,2,4
29161,2,1,102213,102213,102214,0,1,0
29162,6,3,102219,102219,102222,0,3,5
29163,1,3,102220,102222,102225,2,5,0
29164,3,3,102223,102225,102228,2,5,0
29165,1,1,102224,102228,102229,4,5,0
29166,1,3,102225,102229,102232,4,7,0
29167,2,3,102227,102232,102235,5,8,0
29168,4,1,102231,102235,102236,4,5,0
29169,6,2,102237,102237,102239,0,2,1
29170,5,1,102242,102242,102243,0,1,3
29171,4,2,102246,102246,102248,0,2,3
29172,6,3,102252,102252,102255,0,3,4
29173,2,2,102254,102255,102257,1,3,0
29174,4,3,102258,102258,102261,0,3,1
29175,3,1,102261,102261,102262,0,1,0
29176,2,2,102263,102263,102265,0,2,1
29177,5,1,102268,102268,102269,0,1,3
29178,2,1,102270,102270,102271,0,1,1
29179,4,1,102274,102274,102275,0,1,3
29180,1,1,102275,102275,102276,0,1,0
29181,2,2,102277,102277,102279,0,2,1
29182,6,3,102283,102283,102286,0,3,4
29183,1,3,102284,102286,102289,2,5,0
29184,5,3,102289,102289,102292,0,3,0
29185,1,3,102290,102292,102295,2,5,0
29186,6,1,102296,102296,102297,0,1,1
29187,5,3,102301,102301,102304,0,3,4
29188,3,3,102304,102304,102307,0,3,0
29189,3,1,102307,102307,102308,0,1,0
29190,3,2,102310,102310,102312,0,2,2
29191,3,3,102313,102313,102316,0,3,1
29192,6,3,102319,102319,102322,0,3,3
29193,5,1,102324,102324,102325,0,1,2
29194,4,3,102328,102328,102331,0,3,3
29195,2,2,102330,102331,102333,1,3,0
29196,4,3,102334,102334,102337,0,3,1
29197,3,3,102337,102337,102340,0,3,0
29198,5,1,102342,102342,102343,0,1,2
29199,5,3,102347,102347,102350,0,3,4
29200,4,3,102351,102351,102354,0,3,1
29201,2,3,102353,102354,102357,1,4,0
29202,1,2,102354,102357,102359,3,5,0
29203,5,1,102359,102359,102360,0,1,0
29204,5,3,102364,102364,102367,0,3,4
29205,4,3,102368,102368,102371,0,3,1
29206,3,1,102371,102371,102372,0,1,0
29207,6,1,102377,102377,102378,0,1,5
29208,6,3,102383,102383,102386,0,3,5
29209,3,2,102386,102386,102388,0,2,0
29210,6,3,102392,102392,102395,0,3,4
29211,4,2,102396,102396,102398,0,2,1
29212,3,3,102399,102399,102402,0,3,1
29213,5,2,102404,102404,102406,0,2,2
29214,6,1,102410,102410,102411,0,1,4
29215,2,2,102412,102412,102414,0,2,1
29216,4,1,102416,102416,102417,0,1,2
29217,2,1,102418,102418,102419,0,1,1
29218,2,3,102420,102420,102423,0,3,1
29219,4,1,102424,102424,102425,0,1,1
29220,2,2,102426,102426,102428,0,2,1
29221,3,3,102429,102429,102432,0,3,1
29222,4,3,102433,102433,102436,0,3,1
29223,2,2,102435,102436,102438,1,3,0
29224,3,2,102438,102438,102440,0,2,0
29225,3,2,102441,102441,102443,0,2,1
29226,6,3,102447,102447,102450,0,3,4
29227,4,3,102451,102451,102454,0,3,1
29228,6,3,102457,102457,102460,0,3,3
29229,5,3,102462,102462,102465,0,3,2
29230,6,2,102468,102468,102470,0,2,3
29231,3,3,102471,102471,102474,0,3,1
29232,6,1,102477,102477,102478,0,1,3
29233,1,1,102478,102478,102479,0,1,0
29234,5,2,102483,102483,102485,0,2,4
29235,4,1,102487,102487,102488,0,1,2
29236,2,1,102489,102489,102490,0,1,1
29237,5,3,102494,102494,102497,0,3,4
29238,2,2,102496,102497,102499,1,3,0
29239,1,2,102497,102499,102501,2,4,0
29240,4,1,102501,102501,102502,0,1,0
29241,5,3,102506,102506,102509,0,3,4
29242,1,2,102507,102509,102511,2,4,0
29243,2,2,102509,102511,102513,2,4,0
29244,2,1,102511,102513,102514,2,3,0
29245,3,2,102514,102514,102516,0,2,0
29246,5,1,102519,102519,102520,0,1,3
29247,3,1,102522,102522,102523,0,1,2
29248,5,3,102527,102527,102530,0,3,4
29249,3,2,102530,102530,102532,0,2,0
29250,5,1,102535,102535,102536,0,1,3
29251,2,3,102537,102537,102540,0,3,1
29252,6,2,102543,102543,102545,0,2,3
29253,4,1,102547,102547,102548,0,1,2
29254,3,3,102550,102550,102553,0,3,2
29255,6,2,102556,102556,102558,0,2,3
29256,5,3,102561,102561,102564,0,3,3
29257,2,2,102563,102564,102566,1,3,0
29258,5,2,102568,102568,102570,0,2,2
29259,4,2,102572,102572,102574,0,2,2
29260,3,1,102575,102575,102576,0,1,1
29261,4,3,102579,102579,102582,0,3,3
29262,4,3,102583,102583,102586,0,3,1
29263,5,1,102588,102588,102589,0,1,2
29264,3,2,102591,102591,102593,0,2,2
29265,3,2,102594,102594,102596,0,2,1
29266,4,3,102598,102598,102601,0,3,2
29267,4,2,102602,102602,102604,0,2,1
29268,6,1,102608,102608,102609,0,1,4
29269,3,2,102611,102611,102613,0,2,2
29270,3,3,102614,102614,102617,0,3,1
29271,6,1,102620,102620,102621,0,1,3
29272,4,3,102624,102624,102627,0,3,3
29273,6,2,102630,102630,102632,0,2,3
29274,5,2,102635,102635,102637,0,2,3
29275,4,3,102639,102639,102642,0,3,2
29276,6,3,102645,102645,102648,0,3,3
29277,3,1,102648,102648,102649,0,1,0
29278,4,1,102652,102652,102653,0,1,3
29279,1,2,102653,102653,102655,0,2,0
29280,5,1,102658,102658,102659,0,1,3
29281,2,3,102660,102660,102663,0,3,1
29282,3,2,102663,102663,102665,0,2,0
29283,2,2,102665,102665,102667,0,2,0
29284,5,2,102670,102670,102672,0,2,3
29285,1,2,102671,102672,102674,1,3,0
29286,4,1,102675,102675,102676,0,1,1
29287,4,2,102679,102679,102681,0,2,3
29288,3,1,102682,102682,102683,0,1,1
29289,5,1,102687,102687,102688,0,1,4
29290,6,1,102693,102693,102694,0,1,5
29291,5,2,102698,102698,102700,0,2,4
29292,1,3,102699,102700,102703,1,4,0
29293,4,2,102703,102703,102705,0,2,0
29294,1,3,102704,102705,102708,1,4,0
29295,4,2,102708,102708,102710,0,2,0
29296,2,3,102710,102710,102713,0,3,0
29297,5,1,102715,102715,102716,0,1,2
29298,4,1,102719,102719,102720,0,1,3
29299,2,2,102721,102721,102723,0,2,1
29300,6,2,102727,102727,102729,0,2,4
29301,1,1,102728,102729,102730,1,2,0
29302,4,3,102732,102732,102735,0,3,2
29303,2,1,102734,102735,102736,1,2,0
29304,6,3,102740,102740,102743,0,3,4
29305,1,1,102741,102743,102744,2,3,0
29306,6,2,102747,102747,102749,0,2,3
29307,4,2,102751,102751,102753,0,2,2
29308,3,3,102754,102754,102757,0,3,1
29309,4,2,102758,102758,102760,0,2,1
29310,1,2,102759,102760,102762,1,3,0
29311,4,3,102763,102763,102766,0,3,1
29312,1,1,102764,102766,102767,2,3,0
29313,2,1,102766,102767,102768,1,2,0
29314,3,3,102769,102769,102772,0,3,1
29315,1,3,102770,102772,102775,2,5,0
29316,6,2,102776,102776,102778,0,2,1
29317,2,1,102778,102778,102779,0,1,0
29318,6,3,102784,102784,102787,0,3,5
29319,3,2,102787,102787,102789,0,2,0
29320,3,2,102790,102790,102792,0,2,1
29321,5,1,102795,102795,102796,0,1,3
29322,3,2,102798,102798,102800,0,2,2
29323,6,3,102804,102804,102807,0,3,4
29324,6,1,102810,102810,102811,0,1,3
29325,1,2,102811,102811,102813,0,2,0
29326,6,2,102817,102817,102819,0,2,4
29327,5,2,102822,102822,102824,0,2,3
29328,2,3,102824,102824,102827,0,3,0
29329,5,2,102829,102829,102831,0,2,2
29330,4,2,102833,102833,102835,0,2,2
29331,2,2,102835,102835,102837,0,2,0
29332,6,1,102841,102841,102842,0,1,4
29333,1,1,102842,102842,102843,0,1,0
29334,2,2,102844,102844,102846,0,2,1
29335,2,1,102846,102846,102847,0,1,0
29336,4,2,102850,102850,102852,0,2,3
29337,1,1,102851,102852,102853,1,2,0
29338,6,2,102857,102857,102859,0,2,4
29339,4,2,102861,102861,102863,0,2,2
29340,5,1,102866,102866,102867,0,1,3
29341,3,3,102869,102869,102872,0,3,2
29342,6,1,102875,102875,102876,0,1,3
29343,6,2,102881,102881,102883,0,2,5
29344,5,3,102886,102886,102889,0,3,3
29345,6,1,102892,102892,102893,0,1,3
29346,5,2,102897,102897,102899,0,2,4
29347,1,3,102898,102899,102902,1,4,0
29348,4,1,102902,102902,102903,0,1,0
29349,3,1,102905,102905,102906,0,1,2
29350,4,1,102909,102909,102910,0,1,3
29351,2,3,102911,102911,102914,0,3,1
29352,3,1,102914,102914,102915,0,1,0
29353,1,2,102915,102915,102917,0,2,0
29354,3,1,102918,102918,102919,0,1,1
29355,3,1,102921,102921,102922,0,1,2
29356,2,3,102923,102923,102926,0,3,1
29357,5,3,102928,102928,102931,0,3,2
29358,4,3,102932,102932,102935,0,3,1
29359,2,3,102934,102935,102938,1,4,0
29360,1,1,102935,102938,102939,3,4,0
29361,5,3,102940,102940,102943,0,3,1
29362,1,1,102941,102943,102944,2,3,0
29363,3,2,102944,102944,102946,0,2,0
29364,6,1,102950,102950,102951,0,1,4
29365,1,1,102951,102951,102952,0,1,0
29366,3,1,102954,102954,102955,0,1,2
29367,5,3,102959,102959,102962,0,3,4
29368,2,2,102961,102962,102964,1,3,0
29369,3,3,102964,102964,102967,0,3,0
29370,3,2,102967,102967,102969,0,2,0
29371,4,3,102971,102971,102974,0,3,2
29372,6,3,102977,102977,102980,0,3,3
29373,4,2,102981,102981,102983,0,2,1
29374,5,1,102986,102986,102987,0,1,3
29375,6,1,102992,102992,102993,0,1,5
29376,3,2,102995,102995,102997,0,2,2
29377,6,3,103001,103001,103004,0,3,4
29378,3,3,103004,103004,103007,0,3,0
29379,6,1,103010,103010,103011,0,1,3
29380,4,1,103014,103014,103015,0,1,3
29381,5,2,103019,103019,103021,0,2,4
29382,4,1,103023,103023,103024,0,1,2
29383,4,3,103027,103027,103030,0,3,3
29384,4,1,103031,103031,103032,0,1,1
29385,3,3,103034,103034,103037,0,3,2
29386,6,1,103040,103040,103041,0,1,3
29387,4,1,103044,103044,103045,0,1,3
29388,1,3,103045,103045,103048,0,3,0
29389,5,2,103050,103050,103052,0,2,2
29390,1,3,103051,103052,103055,1,4,0
29391,5,2,103056,103056,103058,0,2,1
29392,2,3,103058,103058,103061,0,3,0
29393,1,3,103059,103061,103064,2,5,0
29394,6,3,103065,103065,103068,0,3,1
29395,1,3,103066,103068,103071,2,5,0
29396,1,1,103067,103071,103072,4,5,0
29397,4,1,103071,103072,103073,1,2,0
29398,4,3,103075,103075,103078,0,3,2
29399,1,1,103076,103078,103079,2,3,0
29400,4,2,103080,103080,103082,0,2,1
29401,5,1,103085,103085,103086,0,1,3
29402,3,2,103088,103088,103090,0,2,2
29403,6,1,103094,103094,103095,0,1,4
29404,6,3,103100,103100,103103,0,3,5
29405,3,2,103103,103103,103105,0,2,0
29406,2,3,103105,103105,103108,0,3,0
29407,3,1,103108,103108,103109,0,1,0
29408,2,1,103110,103110,103111,0,1,1
29409,5,2,103115,103115,103117,0,2,4
29410,2,1,103117,103117,103118,0,1,0
29411,1,2,103118,103118,103120,0,2,0
29412,3,3,103121,103121,103124,0,3,1
29413,4,1,103125,103125,103126,0,1,1
29414,4,3,103129,103129,103132,0,3,3
29415,4,1,103133,103133,103134,0,1,1
29416,1,3,103134,103134,103137,0,3,0
29417,4,1,103138,103138,103139,0,1,1
29418,1,2,103139,103139,103141,0,2,0
29419,6,1,103145,103145,103146,0,1,4
29420,1,2,103146,103146,103148,0,2,0
29421,2,1,103148,103148,103149,0,1,0
29422,1,3,103149,103149,103152,0,3,0
29423,5,3,103154,103154,103157,0,3,2
29424,6,2,103160,103160,103162,0,2,3
29425,5,3,103165,103165,103168,0,3,3
29426,2,1,103167,103168,103169,1,2,0
29427,3,2,103170,103170,103172,0,2,1
29428,4,1,103174,103174,103175,0,1,2
29429,5,1,103179,103179,103180,0,1,4
29430,4,3,103183,103183,103186,0,3,3
29431,6,3,103189,103189,103192,0,3,3
29432,4,2,103193,103193,103195,0,2,1
29433,3,3,103196,103196,103199,0,3,1
29434,4,1,103200,103200,103201,0,1,1
29435,1,3,103201,103201,103204,0,3,0
29436,1,2,103202,103204,103206,2,4,0
29437,4,3,103206,103206,103209,0,3,0
29438,4,2,103210,103210,103212,0,2,1
29439,1,3,103211,103212,103215,1,4,0
29440,3,1,103214,103215,103216,1,2,0
29441,4,3,103218,103218,103221,0,3,2
29442,4,1,103222,103222,103223,0,1,1
29443,5,1,103227,103227,103228,0,1,4
29444,5,3,103232,103232,103235,0,3,4
29445,6,2,103238,103238,103240,0,2,3
29446,2,3,103240,103240,103243,0,3,0
29447,5,3,103245,103245,103248,0,3,2
29448,1,2,103246,103248,103250,2,4,0
29449,3,1,103249,103250,103251,1,2,0
29450,6,1,103255,103255,103256,0,1,4
29451,2,2,103257,103257,103259,0,2,1
29452,4,1,103261,103261,103262,0,1,2
29453,1,1,103262,103262,103263,0,1,0
29454,6,2,103268,103268,103270,0,2,5
29455,1,3,103269,103270,103273,1,4,0
29456,4,2,103273,103273,103275,0,2,0
29457,1,1,103274,103275,103276,1,2,0
29458,6,1,103280,103280,103281,0,1,4
29459,2,3,103282,103282,103285,0,3,1
29460,1,3,103283,103285,103288,2,5,0
29461,3,2,103286,103288,103290,2,4,0
29462,6,3,103292,103292,103295,0,3,2
29463,2,2,103294,103295,103297,1,3,0
29464,3,2,103297,103297,103299,0,2,0
29465,4,2,103301,103301,103303,0,2,2
29466,2,2,103303,103303,103305,0,2,0
29467,1,2,103304,103305,103307,1,3,0
29468,6,1,103310,103310,103311,0,1,3
29469,3,2,103313,103313,103315,0,2,2
29470,4,1,103317,103317,103318,0,1,2
29471,6,3,103323,103323,103326,0,3,5
29472,6,1,103329,103329,103330,0,1,3
29473,5,3,103334,103334,103337,0,3,4
29474,2,2,103336,103337,103339,1,3,0
29475,3,3,103339,103339,103342,0,3,0
29476,6,1,103345,103345,103346,0,1,3
29477,1,3,103346,103346,103349,0,3,0
29478,4,2,103350,103350,103352,0,2,1
29479,1,1,103351,103352,103353,1,2,0
29480,5,2,103356,103356,103358,0,2,3
29481,5,3,103361,103361,103364,0,3,3
29482,5,3,103366,103366,103369,0,3,2
29483,2,1,103368,103369,103370,1,2,0
29484,3,2,103371,103371,103373,0,2,1
29485,4,3,103375,103375,103378,0,3,2
29486,5,1,103380,103380,103381,0,1,2
29487,4,3,103384,103384,103387,0,3,3
29488,3,3,103387,103387,103390,0,3,0
29489,3,1,103390,103390,103391,0,1,0
29490,6,3,103396,103396,103399,0,3,5
29491,2,1,103398,103399,103400,1,2,0
29492,1,2,103399,103400,103402,1,3,0
29493,5,2,103404,103404,103406,0,2,2
29494,1,3,103405,103406,103409,1,4,0
29495,6,3,103411,103411,103414,0,3,2
29496,3,1,103414,103414,103415,0,1,0
29497,5,2,103419,103419,103421,0,2,4
29498,6,1,103425,103425,103426,0,1,4
29499,3,2,103428,103428,103430,0,2,2
29500,2,2,103430,103430,103432,0,2,0
29501,1,2,103431,103432,103434,1,3,0
29502,2,1,103433,103434,103435,1,2,0
29503,5,3,103438,103438,103441,0,3,3
29504,2,2,103440,103441,103443,1,3,0
29505,2,1,103442,103443,103444,1,2,0
29506,2,3,103444,103444,103447,0,3,0
29507,4,1,103448,103448,103449,0,1,1
29508,1,2,103449,103449,103451,0,2,0
29509,1,1,103450,103451,103452,1,2,0
29510,4,1,103454,103454,103455,0,1,2
29511,2,1,103456,103456,103457,0,1,1
29512,5,1,103461,103461,103462,0,1,4
29513,4,3,103465,103465,103468,0,3,3
29514,6,3,103471,103471,103474,0,3,3
29515,3,2,103474,103474,103476,0,2,0
29516,6,1,103480,103480,103481,0,1,4
29517,1,3,103481,103481,103484,0,3,0
29518,4,3,103485,103485,103488,0,3,1
29519,1,3,103486,103488,103491,2,5,0
29520,2,1,103488,103491,103492,3,4,0
29521,5,1,103493,103493,103494,0,1,1
29522,3,3,103496,103496,103499,0,3,2
29523,4,3,103500,103500,103503,0,3,1
29524,6,2,103506,103506,103508,0,2,3
29525,1,2,103507,103508,103510,1,3,0
29526,1,3,103508,103510,103513,2,5,0
29527,1,3,103509,103513,103516,4,7,0
29528,6,2,103515,103516,103518,1,3,0
29529,6,3,103521,103521,103524,0,3,3
29530,3,1,103524,103524,103525,0,1,0
29531,6,3,103530,103530,103533,0,3,5
29532,5,3,103535,103535,103538,0,3,2
29533,2,3,103537,103538,103541,1,4,0
29534,5,2,103542,103542,103544,0,2,1
29535,5,1,103547,103547,103548,0,1,3
29536,2,1,103549,103549,103550,0,1,1
29537,1,3,103550,103550,103553,0,3,0
29538,3,1,103553,103553,103554,0,1,0
29539,5,2,103558,103558,103560,0,2,4
29540,3,1,103561,103561,103562,0,1,1
29541,4,3,103565,103565,103568,0,3,3
29542,5,2,103570,103570,103572,0,2,2
29543,3,2,103573,103573,103575,0,2,1
29544,6,3,103579,103579,103582,0,3,4
29545,3,1,103582,103582,103583,0,1,0
29546,1,1,103583,103583,103584,0,1,0
29547,4,3,103587,103587,103590,0,3,3
29548,1,3,103588,103590,103593,2,5,0
29549,4,3,103592,103593,103596,1,4,0
29550,1,2,103593,103596,103598,3,5,0
29551,3,3,103596,103598,103601,2,5,0
29552,1,3,103597,103601,103604,4,7,0
29553,1,2,103598,103604,103606,6,8,0
29554,4,1,103602,103606,103607,4,5,0
29555,4,1,103606,103607,103608,1,2,0
29556,4,3,103610,103610,103613,0,3,2
29557,6,3,103616,103616,103619,0,3,3
29558,6,2,103622,103622,103624,0,2,3
29559,1,3,103623,103624,103627,1,4,0
29560,1,2,103624,103627,103629,3,5,0
29561,6,1,103630,103630,103631,0,1,1
29562,1,1,103631,103631,103632,0,1,0
29563,4,3,103635,103635,103638,0,3,3
29564,6,2,103641,103641,103643,0,2,3
29565,5,2,103646,103646,103648,0,2,3
29566,2,1,103648,103648,103649,0,1,0
29567,5,3,103653,103653,103656,0,3,4
29568,1,1,103654,103656,103657,2,3,0
29569,1,3,103655,103657,103660,2,5,0
29570,4,2,103659,103660,103662,1,3,0
29571,2,2,103661,103662,103664,1,3,0
29572,2,1,103663,103664,103665,1,2,0
29573,5,1,103668,103668,103669,0,1,3
29574,1,1,103669,103669,103670,0,1,0
29575,4,3,103673,103673,103676,0,3,3
29576,4,3,103677,103677,103680,0,3,1
29577,2,3,103679,103680,103683,1,4,0
29578,3,2,103682,103683,103685,1,3,0
29579,4,3,103686,103686,103689,0,3,1
29580,3,1,103689,103689,103690,0,1,0
29581,3,1,103692,103692,103693,0,1,2
29582,3,3,103695,103695,103698,0,3,2
29583,4,3,103699,103699,103702,0,3,1
29584,6,1,103705,103705,103706,0,1,3
29585,3,2,103708,103708,103710,0,2,2
29586,4,2,103712,103712,103714,0,2,2
29587,6,2,103718,103718,103720,0,2,4
29588,1,1,103719,103720,103721,1,2,0
29589,1,2,103720,103721,103723,1,3,0
29590,1,1,103721,103723,103724,2,3,0
29591,3,2,103724,103724,103726,0,2,0
29592,1,3,103725,103726,103729,1,4,0
29593,6,2,103731,103731,103733,0,2,2
29594,4,2,103735,103735,103737,0,2,2
29595,1,2,103736,103737,103739,1,3,0
29596,4,1,103740,103740,103741,0,1,1
29597,3,3,103743,103743,103746,0,3,2
29598,6,2,103749,103749,103751,0,2,3
29599,5,1,103754,103754,103755,0,1,3
29600,6,3,103760,103760,103763,0,3,5
29601,2,2,103762,103763,103765,1,3,0
29602,4,2,103766,103766,103768,0,2,1
29603,1,2,103767,103768,103770,1,3,0
29604,3,1,103770,103770,103771,0,1,0
29605,2,2,103772,103772,103774,0,2,1
29606,2,1,103774,103774,103775,0,1,0
29607,3,2,103777,103777,103779,0,2,2
29608,3,1,103780,103780,103781,0,1,1
29609,6,3,103786,103786,103789,0,3,5
29610,1,3,103787,103789,103792,2,5,0
29611,1,2,103788,103792,103794,4,6,0
29612,4,1,103792,103794,103795,2,3,0
29613,4,2,103796,103796,103798,0,2,1
29614,2,2,103798,103798,103800,0,2,0
29615,6,1,103804,103804,103805,0,1,4
29616,4,1,103808,103808,103809,0,1,3
29617,6,2,103814,103814,103816,0,2,5
29618,3,3,103817,103817,103820,0,3,1
29619,4,2,103821,103821,103823,0,2,1
29620,1,2,103822,103823,103825,1,3,0
29621,3,2,103825,103825,103827,0,2,0
29622,6,1,103831,103831,103832,0,1,4
29623,3,2,103834,103834,103836,0,2,2
29624,2,1,103836,103836,103837,0,1,0
29625,5,3,103841,103841,103844,0,3,4
29626,2,1,103843,103844,103845,1,2,0
29627,5,2,103848,103848,103850,0,2,3
29628,2,2,103850,103850,103852,0,2,0
29629,2,2,103852,103852,103854,0,2,0
29630,2,3,103854,103854,103857,0,3,0
29631,6,1,103860,103860,103861,0,1,3
29632,6,3,103866,103866,103869,0,3,5
29633,1,2,103867,103869,103871,2,4,0
29634,2,2,103869,103871,103873,2,4,0
29635,3,2,103872,103873,103875,1,3,0
29636,2,2,103874,103875,103877,1,3,0
29637,1,1,103875,103877,103878,2,3,0
29638,3,3,103878,103878,103881,0,3,0
29639,3,1,103881,103881,103882,0,1,0
29640,4,1,103885,103885,103886,0,1,3
29641,4,3,103889,103889,103892,0,3,3
29642,3,2,103892,103892,103894,0,2,0
29643,5,1,103897,103897,103898,0,1,3
29644,2,2,103899,103899,103901,0,2,1
29645,6,2,103905,103905,103907,0,2,4
29646,6,2,103911,103911,103913,0,2,4
29647,6,3,103917,103917,103920,0,3,4
29648,5,3,103922,103922,103925,0,3,2
29649,6,2,103928,103928,103930,0,2,3
29650,3,3,103931,103931,103934,0,3,1
29651,3,1,103934,103934,103935,0,1,0
29652,1,2,103935,103935,103937,0,2,0
29653,3,3,103938,103938,103941,0,3,1
29654,4,3,103942,103942,103945,0,3,1
29655,5,3,103947,103947,103950,0,3,2
29656,6,2,103953,103953,103955,0,2,3
29657,5,1,103958,103958,103959,0,1,3
29658,2,3,103960,103960,103963,0,3,1
29659,5,2,103965,103965,103967,0,2,2
29660,1,2,103966,103967,103969,1,3,0
29661,4,2,103970,103970,103972,0,2,1
29662,1,3,103971,103972,103975,1,4,0
29663,2,3,103973,103975,103978,2,5,0
29664,1,1,103974,103978,103979,4,5,0
29665,3,3,103977,103979,103982,2,5,0
29666,4,2,103981,103982,103984,1,3,0
29667,6,2,103987,103987,103989,0,2,3
29668,2,3,103989,103989,103992,0,3,0
29669,4,2,103993,103993,103995,0,2,1
29670,2,3,103995,103995,103998,0,3,0
29671,3,2,103998,103998,104000,0,2,0
29672,4,1,104002,104002,104003,0,1,2
29673,4,1,104006,104006,104007,0,1,3
29674,2,3,104008,104008,104011,0,3,1
29675,3,3,104011,104011,104014,0,3,0
29676,4,3,104015,104015,104018,0,3,1
29677,2,1,104017,104018,104019,1,2,0
29678,1,2,104018,104019,104021,1,3,0
29679,3,3,104021,104021,104024,0,3,0
29680,2,1,104023,104024,104025,1,2,0
29681,1,3,104024,104025,104028,1,4,0
29682,5,3,104029,104029,104032,0,3,1
29683,1,2,104030,104032,104034,2,4,0
29684,1,2,104031,104034,104036,3,5,0
29685,3,2,104034,104036,104038,2,4,0
29686,6,2,104040,104040,104042,0,2,2
29687,1,3,104041,104042,104045,1,4,0
29688,5,1,104046,104046,104047,0,1,1
29689,4,2,104050,104050,104052,0,2,3
29690,4,1,104054,104054,104055,0,1,2
29691,3,3,104057,104057,104060,0,3,2
29692,1,1,104058,104060,104061,2,3,0
29693,2,1,104060,104061,104062,1,2,0
29694,6,1,104066,104066,104067,0,1,4
29695,3,3,104069,104069,104072,0,3,2
29696,1,2,104070,104072,104074,2,4,0
29697,6,3,104076,104076,104079,0,3,2
29698,1,1,104077,104079,104080,2,3,0
29699,5,2,104082,104082,104084,0,2,2
29700,1,2,104083,104084,104086,1,3,0
29701,4,1,104087,104087,104088,0,1,1
29702,6,3,104093,104093,104096,0,3,5
29703,4,1,104097,104097,104098,0,1,1
29704,1,2,104098,104098,104100,0,2,0
29705,4,1,104102,104102,104103,0,1,2
29706,2,3,104104,104104,104107,0,3,1
29707,2,2,104106,104107,104109,1,3,0
29708,3,1,104109,104109,104110,0,1,0
29709,3,3,104112,104112,104115,0,3,2
29710,2,1,104114,104115,104116,1,2,0
29711,6,3,104120,104120,104123,0,3,4
29712,1,3,104121,104123,104126,2,5,0
29713,1,2,104122,104126,104128,4,6,0
29714,1,3,104123,104128,104131,5,8,0
29715,5,3,104128,104131,104134,3,6,0
29716,4,2,104132,104134,104136,2,4,0
29717,5,1,104137,104137,104138,0,1,1
29718,1,1,104138,104138,104139,0,1,0
29719,4,3,104142,104142,104145,0,3,3
29720,4,2,104146,104146,104148,0,2,1
29721,5,1,104151,104151,104152,0,1,3
29722,5,3,104156,104156,104159,0,3,4
29723,1,2,104157,104159,104161,2,4,0
29724,6,1,104163,104163,104164,0,1,2
29725,2,1,104165,104165,104166,0,1,1
29726,3,2,104168,104168,104170,0,2,2
29727,6,2,104174,104174,104176,0,2,4
29728,1,3,104175,104176,104179,1,4,0
29729,2,3,104177,104179,104182,2,5,0
29730,5,2,104182,104182,104184,0,2,0
29731,3,1,104185,104185,104186,0,1,1
29732,3,3,104188,104188,104191,0,3,2
29733,3,2,104191,104191,104193,0,2,0
29734,2,1,104193,104193,104194,0,1,0
29735,5,2,104198,104198,104200,0,2,4
29736,5,1,104203,104203,104204,0,1,3
29737,5,2,104208,104208,104210,0,2,4
29738,1,3,104209,104210,104213,1,4,0
29739,5,3,104214,104214,104217,0,3,1
29740,6,3,104220,104220,104223,0,3,3
29741,2,1,104222,104223,104224,1,2,0
29742,2,2,104224,104224,104226,0,2,0
29743,1,2,104225,104226,104228,1,3,0
29744,3,2,104228,104228,104230,0,2,0
29745,3,2,104231,104231,104233,0,2,1
29746,4,3,104235,104235,104238,0,3,2
29747,4,1,104239,104239,104240,0,1,1
29748,4,2,104243,104243,104245,0,2,3
29749,6,2,104249,104249,104251,0,2,4
29750,4,2,104253,104253,104255,0,2,2
29751,4,1,104257,104257,104258,0,1,2
29752,5,2,104262,104262,104264,0,2,4
29753,3,2,104265,104265,104267,0,2,1
29754,4,2,104269,104269,104271,0,2,2
29755,4,2,104273,104273,104275,0,2,2
29756,2,3,104275,104275,104278,0,3,0
29757,5,1,104280,104280,104281,0,1,2
29758,4,1,104284,104284,104285,0,1,3
29759,3,3,104287,104287,104290,0,3,2
29760,1,2,104288,104290,104292,2,4,0
29761,6,2,104294,104294,104296,0,2,2
29762,1,1,104295,104296,104297,1,2,0
29763,5,3,104300,104300,104303,0,3,3
29764,4,2,104304,104304,104306,0,2,1
29765,3,3,104307,104307,104310,0,3,1
29766,3,1,104310,104310,104311,0,1,0
29767,1,3,104311,104311,104314,0,3,0
29768,6,2,104317,104317,104319,0,2,3
29769,2,3,104319,104319,104322,0,3,0
29770,3,3,104322,104322,104325,0,3,0
29771,6,2,104328,104328,104330,0,2,3
29772,5,2,104333,104333,104335,0,2,3
29773,5,1,104338,104338,104339,0,1,3
29774,1,1,104339,104339,104340,0,1,0
29775,5,2,104344,104344,104346,0,2,4
29776,2,3,104346,104346,104349,0,3,0
29777,3,1,104349,104349,104350,0,1,0
29778,1,1,104350,104350,104351,0,1,0
29779,2,1,104352,104352,104353,0,1,1
29780,4,3,104356,104356,104359,0,3,3
29781,1,3,104357,104359,104362,2,5,0
29782,6,3,104363,104363,104366,0,3,1
29783,3,3,104366,104366,104369,0,3,0
29784,4,1,104370,104370,104371,0,1,1
29785,4,1,104374,104374,104375,0,1,3
29786,2,1,104376,104376,104377,0,1,1
29787,6,1,104382,104382,104383,0,1,5
29788,3,1,104385,104385,104386,0,1,2
29789,6,2,104391,104391,104393,0,2,5
29790,5,1,104396,104396,104397,0,1,3
29791,2,3,104398,104398,104401,0,3,1
29792,4,1,104402,104402,104403,0,1,1
29793,2,1,104404,104404,104405,0,1,1
29794,1,1,104405,104405,104406,0,1,0
29795,4,2,104409,104409,104411,0,2,3
29796,6,2,104415,104415,104417,0,2,4
29797,4,1,104419,104419,104420,0,1,2
29798,1,3,104420,104420,104423,0,3,0
29799,6,2,104426,104426,104428,0,2,3
29800,1,2,104427,104428,104430,1,3,0
29801,3,2,104430,104430,104432,0,2,0
29802,1,3,104431,104432,104435,1,4,0
29803,3,1,104434,104435,104436,1,2,0
29804,5,1,104439,104439,104440,0,1,3
29805,2,1,104441,104441,104442,0,1,1
29806,6,1,104447,104447,104448,0,1,5
29807,3,2,104450,104450,104452,0,2,2
29808,5,3,104455,104455,104458,0,3,3
29809,4,2,104459,104459,104461,0,2,1
29810,4,2,104463,104463,104465,0,2,2
29811,5,1,104468,104468,104469,0,1,3
29812,4,1,104472,104472,104473,0,1,3
29813,3,2,104475,104475,104477,0,2,2
29814,1,2,104476,104477,104479,1,3,0
29815,5,2,104481,104481,104483,0,2,2
29816,6,2,104487,104487,104489,0,2,4
29817,5,1,104492,104492,104493,0,1,3
29818,1,3,104493,104493,104496,0,3,0
29819,4,1,104497,104497,104498,0,1,1
29820,6,2,104503,104503,104505,0,2,5
29821,1,1,104504,104505,104506,1,2,0
29822,1,3,104505,104506,104509,1,4,0
29823,1,1,104506,104509,104510,3,4,0
29824,5,2,104511,104511,104513,0,2,1
29825,5,3,104516,104516,104519,0,3,3
29826,3,1,104519,104519,104520,0,1,0
29827,4,1,104523,104523,104524,0,1,3
29828,3,2,104526,104526,104528,0,2,2
29829,6,2,104532,104532,104534,0,2,4
29830,6,3,104538,104538,104541,0,3,4
29831,5,3,104543,104543,104546,0,3,2
29832,2,2,104545,104546,104548,1,3,0
29833,6,3,104551,104551,104554,0,3,3
29834,2,2,104553,104554,104556,1,3,0
29835,4,3,104557,104557,104560,0,3,1
29836,2,3,104559,104560,104563,1,4,0
29837,4,1,104563,104563,104564,0,1,0
29838,5,3,104568,104568,104571,0,3,4
29839,3,2,104571,104571,104573,0,2,0
29840,4,1,104575,104575,104576,0,1,2
29841,4,2,104579,104579,104581,0,2,3
29842,2,3,104581,104581,104584,0,3,0
29843,2,2,104583,104584,104586,1,3,0
29844,4,1,104587,104587,104588,0,1,1
29845,2,1,104589,104589,104590,0,1,1
29846,5,2,104594,104594,104596,0,2,4
29847,2,2,104596,104596,104598,0,2,0
29848,1,1,104597,104598,104599,1,2,0
29849,1,1,104598,104599,104600,1,2,0
29850,6,3,104604,104604,104607,0,3,4
29851,3,3,104607,104607,104610,0,3,0
29852,5,1,104612,104612,104613,0,1,2
29853,6,3,104618,104618,104621,0,3,5
29854,3,3,104621,104621,104624,0,3,0
29855,4,1,104625,104625,104626,0,1,1
29856,1,2,104626,104626,104628,0,2,0
29857,5,3,104631,104631,104634,0,3,3
29858,4,1,104635,104635,104636,0,1,1
29859,4,3,104639,104639,104642,0,3,3
29860,5,2,104644,104644,104646,0,2,2
29861,2,1,104646,104646,104647,0,1,0
29862,1,1,104647,104647,104648,0,1,0
29863,5,1,104652,104652,104653,0,1,4
29864,4,2,104656,104656,104658,0,2,3
29865,2,1,104658,104658,104659,0,1,0
29866,4,3,104662,104662,104665,0,3,3
29867,5,3,104667,104667,104670,0,3,2
29868,4,3,104671,104671,104674,0,3,1
29869,4,1,104675,104675,104676,0,1,1
29870,2,3,104677,104677,104680,0,3,1
29871,2,1,104679,104680,104681,1,2,0
29872,2,2,104681,104681,104683,0,2,0
29873,2,2,104683,104683,104685,0,2,0
29874,5,3,104688,104688,104691,0,3,3
29875,2,1,104690,104691,104692,1,2,0
29876,4,3,104694,104694,104697,0,3,2
29877,4,1,104698,104698,104699,0,1,1
29878,5,1,104703,104703,104704,0,1,4
29879,1,2,104704,104704,104706,0,2,0
29880,1,1,104705,104706,104707,1,2,0
29881,5,3,104710,104710,104713,0,3,3
29882,1,2,104711,104713,104715,2,4,0
29883,1,1,104712,104715,104716,3,4,0
29884,2,2,104714,104716,104718,2,4,0
29885,4,1,104718,104718,104719,0,1,0
29886,4,2,104722,104722,104724,0,2,3
29887,2,1,104724,104724,104725,0,1,0
29888,6,2,104730,104730,104732,0,2,5
29889,5,3,104735,104735,104738,0,3,3
29890,6,1,104741,104741,104742,0,1,3
29891,1,3,104742,104742,104745,0,3,0
29892,1,1,104743,104745,104746,2,3,0
29893,5,1,104748,104748,104749,0,1,2
29894,1,3,104749,104749,104752,0,3,0
29895,2,2,104751,104752,104754,1,3,0
29896,1,3,104752,104754,104757,2,5,0
29897,5,3,104757,104757,104760,0,3,0
29898,2,1,104759,104760,104761,1,2,0
29899,3,3,104762,104762,104765,0,3,1
29900,3,1,104765,104765,104766,0,1,0
29901,2,3,104767,104767,104770,0,3,1
29902,5,2,104772,104772,104774,0,2,2
29903,3,1,104775,104775,104776,0,1,1
29904,2,3,104777,104777,104780,0,3,1
29905,1,3,104778,104780,104783,2,5,0
29906,2,2,104780,104783,104785,3,5,0
29907,4,3,104784,104785,104788,1,4,0
29908,3,3,104787,104788,104791,1,4,0
29909,2,2,104789,104791,104793,2,4,0
29910,2,1,104791,104793,104794,2,3,0
29911,6,2,104797,104797,104799,0,2,3
29912,5,1,104802,104802,104803,0,1,3
29913,1,3,104803,104803,104806,0,3,0
29914,3,2,104806,104806,104808,0,2,0
29915,4,1,104810,104810,104811,0,1,2
29916,5,3,104815,104815,104818,0,3,4
29917,4,2,104819,104819,104821,0,2,1
29918,5,1,104824,104824,104825,0,1,3
29919,1,1,104825,104825,104826,0,1,0
29920,5,3,104830,104830,104833,0,3,4
29921,5,1,104835,104835,104836,0,1,2
29922,6,3,104841,104841,104844,0,3,5
29923,1,2,104842,104844,104846,2,4,0
29924,1,3,104843,104846,104849,3,6,0
29925,5,1,104848,104849,104850,1,2,0
29926,2,3,104850,104850,104853,0,3,0
29927,4,1,104854,104854,104855,0,1,1
29928,6,2,104860,104860,104862,0,2,5
29929,2,2,104862,104862,104864,0,2,0
29930,3,3,104865,104865,104868,0,3,1
29931,1,3,104866,104868,104871,2,5,0
29932,6,2,104872,104872,104874,0,2,1
29933,3,3,104875,104875,104878,0,3,1
29934,2,1,104877,104878,104879,1,2,0
29935,5,1,104882,104882,104883,0,1,3
29936,2,3,104884,104884,104887,0,3,1
29937,3,3,104887,104887,104890,0,3,0
29938,6,3,104893,104893,104896,0,3,3
29939,6,1,104899,104899,104900,0,1,3
29940,5,1,104904,104904,104905,0,1,4
29941,4,2,104908,104908,104910,0,2,3
29942,1,3,104909,104910,104913,1,4,0
29943,3,3,104912,104913,104916,1,4,0
29944,6,2,104918,104918,104920,0,2,2
29945,4,3,104922,104922,104925,0,3,2
29946,1,2,104923,104925,104927,2,4,0
29947,4,2,104927,104927,104929,0,2,0
29948,5,2,104932,104932,104934,0,2,3
29949,5,2,104937,104937,104939,0,2,3
29950,6,1,104943,104943,104944,0,1,4
29951,1,1,104944,104944,104945,0,1,0
29952,2,3,104946,104946,104949,0,3,1
29953,2,2,104948,104949,104951,1,3,0
29954,1,3,104949,104951,104954,2,5,0
29955,1,3,104950,104954,104957,4,7,0
29956,2,3,104952,104957,104960,5,8,0
29957,5,3,104957,104960,104963,3,6,0
29958,1,2,104958,104963,104965,5,7,0
29959,4,1,104962,104965,104966,3,4,0
29960,2,3,104964,104966,104969,2,5,0
29961,6,1,104970,104970,104971,0,1,1
29962,4,1,104974,104974,104975,0,1,3
29963,6,2,104980,104980,104982,0,2,5
29964,2,1,104982,104982,104983,0,1,0
29965,3,3,104985,104985,104988,0,3,2
29966,5,3,104990,104990,104993,0,3,2
29967,3,3,104993,104993,104996,0,3,0
29968,2,2,104995,104996,104998,1,3,0
29969,6,3,105001,105001,105004,0,3,3
29970,6,3,105007,105007,105010,0,3,3
29971,6,3,105013,105013,105016,0,3,3
29972,3,2,105016,105016,105018,0,2,0
29973,2,2,105018,105018,105020,0,2,0
29974,3,3,105021,105021,105024,0,3,1
29975,6,1,105027,105027,105028,0,1,3
29976,3,3,105030,105030,105033,0,3,2
29977,2,2,105032,105033,105035,1,3,0
29978,3,2,105035,105035,105037,0,2,0
29979,2,3,105037,105037,105040,0,3,0
29980,1,1,105038,105040,105041,2,3,0
29981,4,3,105042,105042,105045,0,3,1
29982,6,1,105048,105048,105049,0,1,3
29983,1,1,105049,105049,105050,0,1,0
29984,5,3,105054,105054,105057,0,3,4
29985,3,3,105057,105057,105060,0,3,0
29986,4,1,105061,105061,105062,0,1,1
29987,5,3,105066,105066,105069,0,3,4
29988,2,2,105068,105069,105071,1,3,0
29989,5,3,105073,105073,105076,0,3,2
29990,4,1,105077,105077,105078,0,1,1
29991,3,1,105080,105080,105081,0,1,2
29992,6,3,105086,105086,105089,0,3,5
29993,1,3,105087,105089,105092,2,5,0
29994,5,2,105092,105092,105094,0,2,0
29995,5,2,105097,105097,105099,0,2,3
29996,2,3,105099,105099,105102,0,3,0
29997,2,2,105101,105102,105104,1,3,0
29998,1,1,105102,105104,105105,2,3,0
29999,3,2,105105,105105,105107,0,2,0
30000,6,3,105111,105111,105114,0,3,4
30001,6,3,105117,105117,105120,0,3,3
30002,3,1,105120,105120,105121,0,1,0
30003,1,3,105121,105121,105124,0,3,0
30004,1,2,105122,105124,105126,2,4,0
30005,3,1,105125,105126,105127,1,2,0
30006,1,2,105126,105127,105129,1,3,0
30007,3,1,105129,105129,105130,0,1,0
30008,4,3,105133,105133,105136,0,3,3
30009,1,1,105134,105136,105137,2,3,0
30010,1,2,105135,105137,105139,2,4,0
30011,2,1,105137,105139,105140,2,3,0
30012,3,3,105140,105140,105143,0,3,0
30013,2,3,105142,105143,105146,1,4,0
30014,3,3,105145,105146,105149,1,4,0
30015,5,1,105150,105150,105151,0,1,1
30016,6,2,105156,105156,105158,0,2,5
30017,6,3,105162,105162,105165,0,3,4
30018,1,1,105163,105165,105166,2,3,0
30019,2,2,105165,105166,105168,1,3,0
30020,6,2,105171,105171,105173,0,2,3
30021,5,2,105176,105176,105178,0,2,3
30022,1,2,105177,105178,105180,1,3,0
30023,4,3,105181,105181,105184,0,3,1
30024,2,2,105183,105184,105186,1,3,0
30025,6,2,105189,105189,105191,0,2,3
30026,5,2,105194,105194,105196,0,2,3
30027,1,2,105195,105196,105198,1,3,0
30028,3,3,105198,105198,105201,0,3,0
30029,2,1,105200,105201,105202,1,2,0
30030,2,1,105202,105202,105203,0,1,0
30031,6,3,105208,105208,105211,0,3,5
30032,3,2,105211,105211,105213,0,2,0
30033,3,2,105214,105214,105216,0,2,1
30034,1,3,105215,105216,105219,1,4,0
30035,4,1,105219,105219,105220,0,1,0
30036,2,1,105221,105221,105222,0,1,1
30037,4,2,105225,105225,105227,0,2,3
30038,4,1,105229,105229,105230,0,1,2
30039,4,2,105233,105233,105235,0,2,3
30040,5,2,105238,105238,105240,0,2,3
30041,4,3,105242,105242,105245,0,3,2
30042,3,3,105245,105245,105248,0,3,0
30043,1,3,105246,105248,105251,2,5,0
30044,4,1,105250,105251,105252,1,2,0
30045,2,1,105252,105252,105253,0,1,0
30046,2,3,105254,105254,105257,0,3,1
30047,6,1,105260,105260,105261,0,1,3
30048,6,2,105266,105266,105268,0,2,5
30049,5,3,105271,105271,105274,0,3,3
30050,4,3,105275,105275,105278,0,3,1
30051,2,3,105277,105278,105281,1,4,0
30052,2,1,105279,105281,105282,2,3,0
30053,1,1,105280,105282,105283,2,3,0
30054,4,2,105284,105284,105286,0,2,1
30055,4,2,105288,105288,105290,0,2,2
30056,3,2,105291,105291,105293,0,2,1
30057,6,1,105297,105297,105298,0,1,4
30058,5,2,105302,105302,105304,0,2,4
30059,5,2,105307,105307,105309,0,2,3
30060,1,2,105308,105309,105311,1,3,0
30061,5,3,105313,105313,105316,0,3,2
30062,2,3,105315,105316,105319,1,4,0
30063,6,1,105321,105321,105322,0,1,2
30064,1,3,105322,105322,105325,0,3,0
30065,5,2,105327,105327,105329,0,2,2
30066,4,3,105331,105331,105334,0,3,2
30067,3,2,105334,105334,105336,0,2,0
30068,6,1,105340,105340,105341,0,1,4
30069,4,2,105344,105344,105346,0,2,3
30070,4,2,105348,105348,105350,0,2,2
30071,4,1,105352,105352,105353,0,1,2
30072,1,3,105353,105353,105356,0,3,0
30073,3,3,105356,105356,105359,0,3,0
30074,6,2,105362,105362,105364,0,2,3
30075,3,3,105365,105365,105368,0,3,1
30076,6,1,105371,105371,105372,0,1,3
30077,4,2,105375,105375,105377,0,2,3
30078,5,1,105380,105380,105381,0,1,3
30079,2,3,105382,105382,105385,0,3,1
30080,2,1,105384,105385,105386,1,2,0
30081,5,2,105389,105389,105391,0,2,3
30082,1,3,105390,105391,105394,1,4,0
30083,1,1,105391,105394,105395,3,4,0
30084,4,2,105395,105395,105397,0,2,0
30085,1,3,105396,105397,105400,1,4,0
30086,5,2,105401,105401,105403,0,2,1
30087,4,1,105405,105405,105406,0,1,2
30088,5,2,105410,105410,105412,0,2,4
30089,4,1,105414,105414,105415,0,1,2
30090,5,1,105419,105419,105420,0,1,4
30091,2,2,105421,105421,105423,0,2,1
30092,1,3,105422,105423,105426,1,4,0
30093,4,3,105426,105426,105429,0,3,0
30094,3,3,105429,105429,105432,0,3,0
30095,1,2,105430,105432,105434,2,4,0
30096,2,3,105432,105434,105437,2,5,0
30097,2,2,105434,105437,105439,3,5,0
30098,2,2,105436,105439,105441,3,5,0
30099,3,1,105439,105441,105442,2,3,0
30100,2,2,105441,105442,105444,1,3,0
30101,6,3,105447,105447,105450,0,3,3
30102,1,3,105448,105450,105453,2,5,0
30103,1,2,105449,105453,105455,4,6,0
30104,1,2,105450,105455,105457,5,7,0
30105,3,3,105453,105457,105460,4,7,0
30106,5,1,105458,105460,105461,2,3,0
30107,3,2,105461,105461,105463,0,2,0
30108,2,1,105463,105463,105464,0,1,0
30109,4,1,105467,105467,105468,0,1,3
30110,3,1,105470,105470,105471,0,1,2
30111,5,1,105475,105475,105476,0,1,4
30112,4,1,105479,105479,105480,0,1,3
30113,6,1,105485,105485,105486,0,1,5
30114,3,2,105488,105488,105490,0,2,2
30115,4,3,105492,105492,105495,0,3,2
30116,6,2,105498,105498,105500,0,2,3
30117,3,1,105501,105501,105502,0,1,1
30118,1,2,105502,105502,105504,0,2,0
30119,2,3,105504,105504,105507,0,3,0
30120,6,3,105510,105510,105513,0,3,3
30121,3,2,105513,105513,105515,0,2,0
30122,3,2,105516,105516,105518,0,2,1
30123,2,2,105518,105518,105520,0,2,0
30124,4,3,105522,105522,105525,0,3,2
30125,6,3,105528,105528,105531,0,3,3
30126,1,3,105529,105531,105534,2,5,0
30127,5,1,105534,105534,105535,0,1,0
30128,1,3,105535,105535,105538,0,3,0
30129,6,1,105541,105541,105542,0,1,3
30130,1,1,105542,105542,105543,0,1,0
30131,3,1,105545,105545,105546,0,1,2
30132,4,1,105549,105549,105550,0,1,3
30133,3,2,105552,105552,105554,0,2,2
30134,5,3,105557,105557,105560,0,3,3
30135,5,1,105562,105562,105563,0,1,2
30136,4,3,105566,105566,105569,0,3,3
30137,3,3,105569,105569,105572,0,3,0
30138,1,2,105570,105572,105574,2,4,0
30139,1,3,105571,105574,105577,3,6,0
30140,3,1,105574,105577,105578,3,4,0
30141,4,3,105578,105578,105581,0,3,0
30142,2,2,105580,105581,105583,1,3,0
30143,4,1,105584,105584,105585,0,1,1
30144,3,3,105587,105587,105590,0,3,2
30145,2,2,105589,105590,105592,1,3,0
30146,6,2,105595,105595,105597,0,2,3
30147,6,2,105601,105601,105603,0,2,4
30148,4,2,105605,105605,105607,0,2,2
30149,3,3,105608,105608,105611,0,3,1
30150,2,3,105610,105611,105614,1,4,0
30151,2,1,105612,105614,105615,2,3,0
30152,2,1,105614,105615,105616,1,2,0
30153,1,2,105615,105616,105618,1,3,0
30154,6,1,105621,105621,105622,0,1,3
30155,3,2,105624,105624,105626,0,2,2
30156,1,3,105625,105626,105629,1,4,0
30157,4,3,105629,105629,105632,0,3,0
30158,1,2,105630,105632,105634,2,4,0
30159,3,3,105633,105634,105637,1,4,0
30160,3,1,105636,105637,105638,1,2,0
30161,1,2,105637,105638,105640,1,3,0
30162,4,1,105641,105641,105642,0,1,1
30163,4,3,105645,105645,105648,0,3,3
30164,2,3,105647,105648,105651,1,4,0
30165,3,2,105650,105651,105653,1,3,0
30166,6,2,105656,105656,105658,0,2,3
30167,1,3,105657,105658,105661,1,4,0
30168,2,3,105659,105661,105664,2,5,0
30169,6,3,105665,105665,105668,0,3,1
30170,4,3,105669,105669,105672,0,3,1
30171,5,3,105674,105674,105677,0,3,2
30172,5,2,105679,105679,105681,0,2,2
30173,3,2,105682,105682,105684,0,2,1
30174,6,3,105688,105688,105691,0,3,4
30175,6,2,105694,105694,105696,0,2,3
30176,3,3,105697,105697,105700,0,3,1
30177,2,3,105699,105700,105703,1,4,0
30178,1,3,105700,105703,105706,3,6,0
30179,5,2,105705,105706,105708,1,3,0
30180,1,2,105706,105708,105710,2,4,0
30181,1,2,105707,105710,105712,3,5,0
30182,2,1,105709,105712,105713,3,4,0
30183,5,2,105714,105714,105716,0,2,1
30184,3,1,105717,105717,105718,0,1,1
30185,3,3,105720,105720,105723,0,3,2
30186,4,1,105724,105724,105725,0,1,1
30187,3,3,105727,105727,105730,0,3,2
30188,5,3,105732,105732,105735,0,3,2
30189,1,2,105733,105735,105737,2,4,0
30190,1,3,105734,105737,105740,3,6,0
30191,2,2,105736,105740,105742,4,6,0
30192,6,1,105742,105742,105743,0,1,0
30193,3,2,105745,105745,105747,0,2,2
30194,4,1,105749,105749,105750,0,1,2
30195,4,2,105753,105753,105755,0,2,3
30196,4,2,105757,105757,105759,0,2,2
30197,3,1,105760,105760,105761,0,1,1
30198,6,1,105766,105766,105767,0,1,5
30199,2,1,105768,105768,105769,0,1,1
30200,2,2,105770,105770,105772,0,2,1
30201,1,3,105771,105772,105775,1,4,0
30202,6,2,105777,105777,105779,0,2,2
30203,2,2,105779,105779,105781,0,2,0
30204,3,2,105782,105782,105784,0,2,1
30205,3,2,105785,105785,105787,0,2,1
30206,3,1,105788,105788,105789,0,1,1
30207,4,2,105792,105792,105794,0,2,3
30208,6,2,105798,105798,105800,0,2,4
30209,6,2,105804,105804,105806,0,2,4
30210,6,3,105810,105810,105813,0,3,4
30211,3,3,105813,105813,105816,0,3,0
30212,2,2,105815,105816,105818,1,3,0
30213,2,3,105817,105818,105821,1,4,0
30214,2,2,105819,105821,105823,2,4,0
30215,4,3,105823,105823,105826,0,3,0
30216,4,3,105827,105827,105830,0,3,1
30217,1,2,105828,105830,105832,2,4,0
30218,1,1,105829,105832,105833,3,4,0
30219,1,1,105830,105833,105834,3,4,0
30220,2,3,105832,105834,105837,2,5,0
30221,5,3,105837,105837,105840,0,3,0
30222,6,1,105843,105843,105844,0,1,3
30223,5,2,105848,105848,105850,0,2,4
30224,6,3,105854,105854,105857,0,3,4
30225,1,1,105855,105857,105858,2,3,0
30226,4,3,105859,105859,105862,0,3,1
30227,5,2,105864,105864,105866,0,2,2
30228,4,3,105868,105868,105871,0,3,2
30229,6,1,105874,105874,105875,0,1,3
30230,6,2,105880,105880,105882,0,2,5
30231,2,1,105882,105882,105883,0,1,0
30232,2,1,105884,105884,105885,0,1,1
30233,2,3,105886,105886,105889,0,3,1
30234,5,1,105891,105891,105892,0,1,2
30235,5,1,105896,105896,105897,0,1,4
30236,2,2,105898,105898,105900,0,2,1
30237,3,2,105901,105901,105903,0,2,1
30238,5,2,105906,105906,105908,0,2,3
30239,6,3,105912,105912,105915,0,3,4
30240,5,1,105917,105917,105918,0,1,2
30241,2,3,105919,105919,105922,0,3,1
30242,4,2,105923,105923,105925,0,2,1
30243,2,3,105925,105925,105928,0,3,0
30244,2,1,105927,105928,105929,1,2,0
30245,2,2,105929,105929,105931,0,2,0
30246,1,3,105930,105931,105934,1,4,0
30247,6,3,105936,105936,105939,0,3,2
30248,4,2,105940,105940,105942,0,2,1
30249,5,2,105945,105945,105947,0,2,3
30250,3,2,105948,105948,105950,0,2,1
30251,4,3,105952,105952,105955,0,3,2
30252,6,2,105958,105958,105960,0,2,3
30253,6,3,105964,105964,105967,0,3,4
30254,6,3,105970,105970,105973,0,3,3
30255,3,1,105973,105973,105974,0,1,0
30256,5,1,105978,105978,105979,0,1,4
30257,4,1,105982,105982,105983,0,1,3
30258,2,2,105984,105984,105986,0,2,1
30259,4,3,105988,105988,105991,0,3,2
30260,1,1,105989,105991,105992,2,3,0
30261,5,3,105994,105994,105997,0,3,2
30262,4,3,105998,105998,106001,0,3,1
30263,4,1,106002,106002,106003,0,1,1
30264,6,3,106008,106008,106011,0,3,5
30265,4,2,106012,106012,106014,0,2,1
30266,6,3,106018,106018,106021,0,3,4
30267,1,1,106019,106021,106022,2,3,0
30268,6,1,106025,106025,106026,0,1,3
30269,4,1,106029,106029,106030,0,1,3
30270,3,1,106032,106032,106033,0,1,2
30271,5,2,106037,106037,106039,0,2,4
30272,3,2,106040,106040,106042,0,2,1
30273,6,3,106046,106046,106049,0,3,4
30274,4,3,106050,106050,106053,0,3,1
30275,6,3,106056,106056,106059,0,3,3
30276,4,2,106060,106060,106062,0,2,1
30277,1,1,106061,106062,106063,1,2,0
30278,1,2,106062,106063,106065,1,3,0
30279,1,3,106063,106065,106068,2,5,0
30280,3,1,106066,106068,106069,2,3,0
30281,5,3,106071,106071,106074,0,3,2
30282,1,1,106072,106074,106075,2,3,0
30283,6,1,106078,106078,106079,0,1,3
30284,5,1,106083,106083,106084,0,1,4
30285,5,2,106088,106088,106090,0,2,4
30286,5,1,106093,106093,106094,0,1,3
30287,5,2,106098,106098,106100,0,2,4
30288,3,2,106101,106101,106103,0,2,1
30289,4,1,106105,106105,106106,0,1,2
30290,2,3,106107,106107,106110,0,3,1
30291,6,1,106113,106113,106114,0,1,3
30292,1,2,106114,106114,106116,0,2,0
30293,5,3,106119,106119,106122,0,3,3
30294,5,1,106124,106124,106125,0,1,2
30295,5,3,106129,106129,106132,0,3,4
30296,5,3,106134,106134,106137,0,3,2
30297,3,1,106137,106137,106138,0,1,0
30298,3,2,106140,106140,106142,0,2,2
30299,1,1,106141,106142,106143,1,2,0
30300,3,1,106144,106144,106145,0,1,1
30301,4,1,106148,106148,106149,0,1,3
30302,4,2,106152,106152,106154,0,2,3
30303,4,1,106156,106156,106157,0,1,2
30304,5,2,106161,106161,106163,0,2,4
30305,3,2,106164,106164,106166,0,2,1
30306,6,2,106170,106170,106172,0,2,4
30307,6,1,106176,106176,106177,0,1,4
30308,2,2,106178,106178,106180,0,2,1
30309,6,3,106184,106184,106187,0,3,4
30310,3,2,106187,106187,106189,0,2,0
30311,6,3,106193,106193,106196,0,3,4
30312,4,3,106197,106197,106200,0,3,1
30313,3,1,106200,106200,106201,0,1,0
30314,4,1,106204,106204,106205,0,1,3
30315,5,1,106209,106209,106210,0,1,4
30316,4,1,106213,106213,106214,0,1,3
30317,5,1,106218,106218,106219,0,1,4
30318,2,1,106220,106220,106221,0,1,1
30319,1,1,106221,106221,106222,0,1,0
30320,5,2,106226,106226,106228,0,2,4
30321,1,3,106227,106228,106231,1,4,0
30322,5,2,106232,106232,106234,0,2,1
30323,2,2,106234,106234,106236,0,2,0
30324,2,3,106236,106236,106239,0,3,0
30325,1,3,106237,106239,106242,2,5,0
30326,6,1,106243,106243,106244,0,1,1
30327,4,3,106247,106247,106250,0,3,3
30328,2,1,106249,106250,106251,1,2,0
30329,4,3,106253,106253,106256,0,3,2
30330,2,2,106255,106256,106258,1,3,0
30331,5,3,106260,106260,106263,0,3,2
30332,5,1,106265,106265,106266,0,1,2
30333,1,3,106266,106266,106269,0,3,0
30334,3,3,106269,106269,106272,0,3,0
30335,5,2,106274,106274,106276,0,2,2
30336,6,2,106280,106280,106282,0,2,4
30337,6,1,106286,106286,106287,0,1,4
30338,3,2,106289,106289,106291,0,2,2
30339,6,3,106295,106295,106298,0,3,4
30340,1,3,106296,106298,106301,2,5,0
30341,4,1,106300,106301,106302,1,2,0
30342,4,3,106304,106304,106307,0,3,2
30343,6,2,106310,106310,106312,0,2,3
30344,5,3,106315,106315,106318,0,3,3
30345,3,1,106318,106318,106319,0,1,0
30346,4,1,106322,106322,106323,0,1,3
30347,3,1,106325,106325,106326,0,1,2
30348,5,2,106330,106330,106332,0,2,4
30349,2,3,106332,106332,106335,0,3,0
30350,2,1,106334,106335,106336,1,2,0
30351,1,3,106335,106336,106339,1,4,0
30352,3,3,106338,106339,106342,1,4,0
30353,4,3,106342,106342,106345,0,3,0
30354,6,1,106348,106348,106349,0,1,3
30355,4,2,106352,106352,106354,0,2,3
30356,2,1,106354,106354,106355,0,1,0
30357,4,1,106358,106358,106359,0,1,3
30358,4,1,106362,106362,106363,0,1,3
30359,5,1,106367,106367,106368,0,1,4
30360,6,1,106373,106373,106374,0,1,5
30361,2,3,106375,106375,106378,0,3,1
30362,4,2,106379,106379,106381,0,2,1
30363,2,1,106381,106381,106382,0,1,0
30364,5,3,106386,106386,106389,0,3,4
30365,6,1,106392,106392,106393,0,1,3
30366,6,2,106398,106398,106400,0,2,5
30367,1,3,106399,106400,106403,1,4,0
30368,4,1,106403,106403,106404,0,1,0
30369,2,3,106405,106405,106408,0,3,1
30370,4,3,106409,106409,106412,0,3,1
30371,1,1,106410,106412,106413,2,3,0
30372,4,3,106414,106414,106417,0,3,1
30373,4,3,106418,106418,106421,0,3,1
30374,1,1,106419,106421,106422,2,3,0
30375,6,2,106425,106425,106427,0,2,3
30376,2,2,106427,106427,106429,0,2,0
30377,6,2,106433,106433,106435,0,2,4
30378,3,3,106436,106436,106439,0,3,1
30379,4,1,106440,106440,106441,0,1,1
30380,1,3,106441,106441,106444,0,3,0
30381,4,3,106445,106445,106448,0,3,1
30382,2,2,106447,106448,106450,1,3,0
30383,6,3,106453,106453,106456,0,3,3
30384,2,3,106455,106456,106459,1,4,0
30385,3,2,106458,106459,106461,1,3,0
30386,1,3,106459,106461,106464,2,5,0
30387,5,1,106464,106464,106465,0,1,0
30388,5,3,106469,106469,106472,0,3,4
30389,1,3,106470,106472,106475,2,5,0
30390,2,2,106472,106475,106477,3,5,0
30391,2,1,106474,106477,106478,3,4,0
30392,5,1,106479,106479,106480,0,1,1
30393,3,2,106482,106482,106484,0,2,2
30394,4,2,106486,106486,106488,0,2,2
30395,6,2,106492,106492,106494,0,2,4
30396,2,2,106494,106494,106496,0,2,0
30397,3,3,106497,106497,106500,0,3,1
30398,1,3,106498,106500,106503,2,5,0
30399,3,1,106501,106503,106504,2,3,0
30400,6,1,106507,106507,106508,0,1,3
30401,4,2,106511,106511,106513,0,2,3
30402,3,2,106514,106514,106516,0,2,1
30403,3,1,106517,106517,106518,0,1,1
30404,4,2,106521,106521,106523,0,2,3
30405,4,1,106525,106525,106526,0,1,2
30406,1,3,106526,106526,106529,0,3,0
30407,4,2,106530,106530,106532,0,2,1
30408,4,2,106534,106534,106536,0,2,2
30409,4,1,106538,106538,106539,0,1,2
30410,1,1,106539,106539,106540,0,1,0
30411,3,2,106542,106542,106544,0,2,2
30412,3,2,106545,106545,106547,0,2,1
30413,6,3,106551,106551,106554,0,3,4
30414,1,2,106552,106554,106556,2,4,0
30415,1,2,106553,106556,106558,3,5,0
30416,5,2,106558,106558,106560,0,2,0
30417,6,3,106564,106564,106567,0,3,4
30418,3,2,106567,106567,106569,0,2,0
30419,6,2,106573,106573,106575,0,2,4
30420,2,1,106575,106575,106576,0,1,0
30421,2,1,106577,106577,106578,0,1,1
30422,3,2,106580,106580,106582,0,2,2
30423,3,3,106583,106583,106586,0,3,1
30424,3,2,106586,106586,106588,0,2,0
30425,6,1,106592,106592,106593,0,1,4
30426,6,3,106598,106598,106601,0,3,5
30427,1,2,106599,106601,106603,2,4,0
30428,1,2,106600,106603,106605,3,5,0
30429,2,3,106602,106605,106608,3,6,0
30430,2,2,106604,106608,106610,4,6,0
30431,1,3,106605,106610,106613,5,8,0
30432,2,2,106607,106613,106615,6,8,0
30433,3,1,106610,106615,106616,5,6,0
30434,6,2,106616,106616,106618,0,2,0
30435,6,3,106622,106622,106625,0,3,4
30436,4,2,106626,106626,106628,0,2,1
30437,1,1,106627,106628,106629,1,2,0
30438,1,2,106628,106629,106631,1,3,0
30439,4,1,106632,106632,106633,0,1,1
30440,4,3,106636,106636,106639,0,3,3
30441,2,3,106638,106639,106642,1,4,0
30442,1,3,106639,106642,106645,3,6,0
30443,2,1,106641,106645,106646,4,5,0
30444,2,3,106643,106646,106649,3,6,0
30445,1,1,106644,106649,106650,5,6,0
30446,6,3,106650,106650,106653,0,3,0
30447,1,1,106651,106653,106654,2,3,0
30448,4,2,106655,106655,106657,0,2,1
30449,4,2,106659,106659,106661,0,2,2
30450,4,1,106663,106663,106664,0,1,2
30451,3,1,106666,106666,106667,0,1,2
30452,2,2,106668,106668,106670,0,2,1
30453,1,1,106669,106670,106671,1,2,0
30454,6,3,106675,106675,106678,0,3,4
30455,5,2,106680,106680,106682,0,2,2
30456,4,3,106684,106684,106687,0,3,2
30457,5,1,106689,106689,106690,0,1,2
30458,4,1,106693,106693,106694,0,1,3
30459,3,1,106696,106696,106697,0,1,2
30460,3,3,106699,106699,106702,0,3,2
30461,2,2,106701,106702,106704,1,3,0
30462,1,3,106702,106704,106707,2,5,0
30463,6,2,106708,106708,106710,0,2,1
30464,6,2,106714,106714,106716,0,2,4
30465,5,3,106719,106719,106722,0,3,3
30466,3,2,106722,106722,106724,0,2,0
30467,6,2,106728,106728,106730,0,2,4
30468,2,2,106730,106730,106732,0,2,0
30469,3,1,106733,106733,106734,0,1,1
30470,5,2,106738,106738,106740,0,2,4
30471,6,3,106744,106744,106747,0,3,4
30472,1,1,106745,106747,106748,2,3,0
30473,5,2,106750,106750,106752,0,2,2
30474,4,3,106754,106754,106757,0,3,2
30475,4,2,106758,106758,106760,0,2,1
30476,6,1,106764,106764,106765,0,1,4
30477,6,1,106770,106770,106771,0,1,5
30478,2,2,106772,106772,106774,0,2,1
30479,4,2,106776,106776,106778,0,2,2
30480,4,1,106780,106780,106781,0,1,2
30481,2,1,106782,106782,106783,0,1,1
30482,1,1,106783,106783,106784,0,1,0
30483,2,1,106785,106785,106786,0,1,1
30484,3,3,106788,106788,106791,0,3,2
30485,6,1,106794,106794,106795,0,1,3
30486,6,2,106800,106800,106802,0,2,5
30487,2,3,106802,106802,106805,0,3,0
30488,3,3,106805,106805,106808,0,3,0
30489,4,2,106809,106809,106811,0,2,1
30490,3,3,106812,106812,106815,0,3,1
30491,1,1,106813,106815,106816,2,3,0
30492,2,2,106815,106816,106818,1,3,0
30493,4,1,106819,106819,106820,0,1,1
30494,5,3,106824,106824,106827,0,3,4
30495,1,3,106825,106827,106830,2,5,0
30496,4,1,106829,106830,106831,1,2,0
30497,1,1,106830,106831,106832,1,2,0
30498,5,1,106835,106835,106836,0,1,3
30499,2,2,106837,106837,106839,0,2,1
30500,1,3,106838,106839,106842,1,4,0
30501,5,2,106843,106843,106845,0,2,1
30502,6,3,106849,106849,106852,0,3,4
30503,5,1,106854,106854,106855,0,1,2
30504,3,3,106857,106857,106860,0,3,2
30505,4,2,106861,106861,106863,0,2,1
30506,3,1,106864,106864,106865,0,1,1
30507,2,2,106866,106866,106868,0,2,1
30508,4,3,106870,106870,106873,0,3,2
30509,6,3,106876,106876,106879,0,3,3
30510,1,2,106877,106879,106881,2,4,0
30511,6,1,106883,106883,106884,0,1,2
30512,2,2,106885,106885,106887,0,2,1
30513,5,3,106890,106890,106893,0,3,3
30514,5,1,106895,106895,106896,0,1,2
30515,3,3,106898,106898,106901,0,3,2
30516,2,2,106900,106901,106903,1,3,0
30517,1,1,106901,106903,106904,2,3,0
30518,4,2,106905,106905,106907,0,2,1
30519,2,3,106907,106907,106910,0,3,0
30520,2,3,106909,106910,106913,1,4,0
30521,3,1,106912,106913,106914,1,2,0
30522,4,1,106916,106916,106917,0,1,2
30523,3,1,106919,106919,106920,0,1,2
30524,2,1,106921,106921,106922,0,1,1
30525,4,2,106925,106925,106927,0,2,3
30526,1,1,106926,106927,106928,1,2,0
30527,5,1,106931,106931,106932,0,1,3
30528,2,1,106933,106933,106934,0,1,1
30529,5,2,106938,106938,106940,0,2,4
30530,3,1,106941,106941,106942,0,1,1
30531,3,1,106944,106944,106945,0,1,2
30532,4,2,106948,106948,106950,0,2,3
30533,3,1,106951,106951,106952,0,1,1
30534,1,1,106952,106952,106953,0,1,0
30535,5,3,106957,106957,106960,0,3,4
30536,4,2,106961,106961,106963,0,2,1
30537,3,3,106964,106964,106967,0,3,1
30538,3,3,106967,106967,106970,0,3,0
30539,4,2,106971,106971,106973,0,2,1
30540,3,3,106974,106974,106977,0,3,1
30541,4,1,106978,106978,106979,0,1,1
30542,3,3,106981,106981,106984,0,3,2
30543,3,3,106984,106984,106987,0,3,0
30544,2,1,106986,106987,106988,1,2,0
30545,3,3,106989,106989,106992,0,3,1
30546,4,1,106993,106993,106994,0,1,1
30547,3,1,106996,106996,106997,0,1,2
30548,6,3,107002,107002,107005,0,3,5
30549,4,3,107006,107006,107009,0,3,1
30550,1,1,107007,107009,107010,2,3,0
30551,2,3,107009,107010,107013,1,4,0
30552,2,3,107011,107013,107016,2,5,0
30553,6,3,107017,107017,107020,0,3,1
30554,5,3,107022,107022,107025,0,3,2
30555,1,2,107023,107025,107027,2,4,0
30556,3,2,107026,107027,107029,1,3,0
30557,1,1,107027,107029,107030,2,3,0
30558,3,1,107030,107030,107031,0,1,0
30559,2,2,107032,107032,107034,0,2,1
30560,4,1,107036,107036,107037,0,1,2
30561,1,1,107037,107037,107038,0,1,0
30562,2,1,107039,107039,107040,0,1,1
30563,5,3,107044,107044,107047,0,3,4
30564,5,3,107049,107049,107052,0,3,2
30565,4,1,107053,107053,107054,0,1,1
30566,2,2,107055,107055,107057,0,2,1
30567,1,1,107056,107057,107058,1,2,0
30568,1,3,107057,107058,107061,1,4,0
30569,2,1,107059,107061,107062,2,3,0
30570,4,2,107063,107063,107065,0,2,1
30571,4,3,107067,107067,107070,0,3,2
30572,4,3,107071,107071,107074,0,3,1
30573,5,1,107076,107076,107077,0,1,2
30574,4,3,107080,107080,107083,0,3,3
30575,5,1,107085,107085,107086,0,1,2
30576,3,2,107088,107088,107090,0,2,2
30577,5,2,107093,107093,107095,0,2,3
30578,6,1,107099,107099,107100,0,1,4
30579,2,2,107101,107101,107103,0,2,1
30580,5,1,107106,107106,107107,0,1,3
30581,5,1,107111,107111,107112,0,1,4
30582,5,1,107116,107116,107117,0,1,4
30583,5,2,107121,107121,107123,0,2,4
30584,4,3,107125,107125,107128,0,3,2
30585,3,2,107128,107128,107130,0,2,0
30586,5,3,107133,107133,107136,0,3,3
30587,3,3,107136,107136,107139,0,3,0
30588,6,2,107142,107142,107144,0,2,3
30589,2,1,107144,107144,107145,0,1,0
30590,2,3,107146,107146,107149,0,3,1
30591,6,1,107152,107152,107153,0,1,3
30592,3,1,107155,107155,107156,0,1,2
30593,1,1,107156,107156,107157,0,1,0
30594,4,2,107160,107160,107162,0,2,3
30595,6,1,107166,107166,107167,0,1,4
30596,2,3,107168,107168,107171,0,3,1
30597,3,3,107171,107171,107174,0,3,0
30598,1,2,107172,107174,107176,2,4,0
30599,5,3,107177,107177,107180,0,3,1
30600,5,1,107182,107182,107183,0,1,2
30601,2,1,107184,107184,107185,0,1,1
30602,2,1,107186,107186,107187,0,1,1
30603,4,1,107190,107190,107191,0,1,3
30604,3,2,107193,107193,107195,0,2,2
30605,2,2,107195,107195,107197,0,2,0
30606,5,2,107200,107200,107202,0,2,3
30607,1,2,107201,107202,107204,1,3,0
30608,5,2,107206,107206,107208,0,2,2
30609,3,2,107209,107209,107211,0,2,1
30610,1,2,107210,107211,107213,1,3,0
30611,5,3,107215,107215,107218,0,3,2
30612,1,3,107216,107218,107221,2,5,0
30613,3,3,107219,107221,107224,2,5,0
30614,5,1,107224,107224,107225,0,1,0
30615,3,1,107227,107227,107228,0,1,2
30616,6,2,107233,107233,107235,0,2,5
30617,6,1,107239,107239,107240,0,1,4
30618,2,3,107241,107241,107244,0,3,1
30619,5,3,107246,107246,107249,0,3,2
30620,4,2,107250,107250,107252,0,2,1
30621,2,2,107252,107252,107254,0,2,0
30622,1,3,107253,107254,107257,1,4,0
30623,4,3,107257,107257,107260,0,3,0
30624,3,1,107260,107260,107261,0,1,0
30625,1,1,107261,107261,107262,0,1,0
30626,3,2,107264,107264,107266,0,2,2
30627,4,1,107268,107268,107269,0,1,2
30628,3,1,107271,107271,107272,0,1,2
30629,2,1,107273,107273,107274,0,1,1
30630,1,2,107274,107274,107276,0,2,0
30631,3,3,107277,107277,107280,0,3,1
30632,4,1,107281,107281,107282,0,1,1
30633,2,1,107283,107283,107284,0,1,1
30634,6,2,107289,107289,107291,0,2,5
30635,3,1,107292,107292,107293,0,1,1
30636,2,3,107294,107294,107297,0,3,1
30637,3,3,107297,107297,107300,0,3,0
30638,5,3,107302,107302,107305,0,3,2
30639,4,2,107306,107306,107308,0,2,1
30640,1,3,107307,107308,107311,1,4,0
30641,4,1,107311,107311,107312,0,1,0
30642,6,1,107317,107317,107318,0,1,5
30643,6,2,107323,107323,107325,0,2,5
30644,2,1,107325,107325,107326,0,1,0
30645,3,2,107328,107328,107330,0,2,2
30646,6,1,107334,107334,107335,0,1,4
30647,4,2,107338,107338,107340,0,2,3
30648,5,2,107343,107343,107345,0,2,3
30649,4,2,107347,107347,107349,0,2,2
30650,1,2,107348,107349,107351,1,3,0
30651,6,3,107354,107354,107357,0,3,3
30652,2,2,107356,107357,107359,1,3,0
30653,3,1,107359,107359,107360,0,1,0
30654,6,2,107365,107365,107367,0,2,5
30655,1,2,107366,107367,107369,1,3,0
30656,2,3,107368,107369,107372,1,4,0
30657,6,2,107374,107374,107376,0,2,2
30658,6,2,107380,107380,107382,0,2,4
30659,2,3,107382,107382,107385,0,3,0
30660,5,1,107387,107387,107388,0,1,2
30661,6,1,107393,107393,107394,0,1,5
30662,3,3,107396,107396,107399,0,3,2
30663,2,2,107398,107399,107401,1,3,0
30664,3,2,107401,107401,107403,0,2,0
30665,1,3,107402,107403,107406,1,4,0
30666,6,2,107408,107408,107410,0,2,2
30667,2,1,107410,107410,107411,0,1,0
30668,4,2,107414,107414,107416,0,2,3
30669,6,3,107420,107420,107423,0,3,4
30670,2,1,107422,107423,107424,1,2,0
30671,6,2,107428,107428,107430,0,2,4
30672,3,3,107431,107431,107434,0,3,1
30673,4,2,107435,107435,107437,0,2,1
30674,2,1,107437,107437,107438,0,1,0
30675,6,3,107443,107443,107446,0,3,5
30676,2,1,107445,107446,107447,1,2,0
30677,6,2,107451,107451,107453,0,2,4
30678,1,3,107452,107453,107456,1,4,0
30679,2,1,107454,107456,107457,2,3,0
30680,5,2,107459,107459,107461,0,2,2
30681,3,1,107462,107462,107463,0,1,1
30682,4,3,107466,107466,107469,0,3,3
30683,3,2,107469,107469,107471,0,2,0
30684,2,2,107471,107471,107473,0,2,0
30685,6,2,107477,107477,107479,0,2,4
30686,2,1,107479,107479,107480,0,1,0
30687,2,3,107481,107481,107484,0,3,1
30688,2,3,107483,107484,107487,1,4,0
30689,2,3,107485,107487,107490,2,5,0
30690,5,3,107490,107490,107493,0,3,0
30691,6,2,107496,107496,107498,0,2,3
30692,3,2,107499,107499,107501,0,2,1
30693,5,2,107504,107504,107506,0,2,3
30694,1,1,107505,107506,107507,1,2,0
30695,1,2,107506,107507,107509,1,3,0
30696,1,3,107507,107509,107512,2,5,0
30697,2,3,107509,107512,107515,3,6,0
30698,3,1,107512,107515,107516,3,4,0
30699,3,2,107515,107516,107518,1,3,0
30700,5,1,107520,107520,107521,0,1,2
30701,1,1,107521,107521,107522,0,1,0
30702,5,1,107526,107526,107527,0,1,4
30703,4,2,107530,107530,107532,0,2,3
30704,4,2,107534,107534,107536,0,2,2
30705,6,2,107540,107540,107542,0,2,4
30706,4,1,107544,107544,107545,0,1,2
30707,1,2,107545,107545,107547,0,2,0
30708,2,2,107547,107547,107549,0,2,0
30709,6,1,107553,107553,107554,0,1,4
30710,3,2,107556,107556,107558,0,2,2
30711,5,2,107561,107561,107563,0,2,3
30712,3,2,107564,107564,107566,0,2,1
30713,6,2,107570,107570,107572,0,2,4
30714,1,1,107571,107572,107573,1,2,0
30715,6,1,107577,107577,107578,0,1,4
30716,6,2,107583,107583,107585,0,2,5
30717,5,3,107588,107588,107591,0,3,3
30718,2,3,107590,107591,107594,1,4,0
30719,1,3,107591,107594,107597,3,6,0
30720,5,2,107596,107597,107599,1,3,0
30721,2,2,107598,107599,107601,1,3,0
30722,1,3,107599,107601,107604,2,5,0
30723,3,1,107602,107604,107605,2,3,0
30724,1,1,107603,107605,107606,2,3,0
30725,1,1,107604,107606,107607,2,3,0
30726,3,3,107607,107607,107610,0,3,0
30727,3,1,107610,107610,107611,0,1,0
30728,5,3,107615,107615,107618,0,3,4
30729,4,3,107619,107619,107622,0,3,1
30730,6,2,107625,107625,107627,0,2,3
30731,5,3,107630,107630,107633,0,3,3
30732,3,1,107633,107633,107634,0,1,0
30733,1,2,107634,107634,107636,0,2,0
30734,1,3,107635,107636,107639,1,4,0
30735,1,1,107636,107639,107640,3,4,0
30736,3,3,107639,107640,107643,1,4,0
30737,3,2,107642,107643,107645,1,3,0
30738,6,2,107648,107648,107650,0,2,3
30739,2,3,107650,107650,107653,0,3,0
30740,4,2,107654,107654,107656,0,2,1
30741,1,1,107655,107656,107657,1,2,0
30742,4,2,107659,107659,107661,0,2,2
30743,2,3,107661,107661,107664,0,3,0
30744,4,1,107665,107665,107666,0,1,1
30745,6,2,107671,107671,107673,0,2,5
30746,1,3,107672,107673,107676,1,4,0
30747,6,2,107678,107678,107680,0,2,2
30748,3,1,107681,107681,107682,0,1,1
30749,6,3,107687,107687,107690,0,3,5
30750,6,2,107693,107693,107695,0,2,3
30751,4,1,107697,107697,107698,0,1,2
30752,6,1,107703,107703,107704,0,1,5
30753,5,1,107708,107708,107709,0,1,4
30754,2,3,107710,107710,107713,0,3,1
30755,3,3,107713,107713,107716,0,3,0
30756,4,1,107717,107717,107718,0,1,1
30757,1,3,107718,107718,107721,0,3,0
30758,3,2,107721,107721,107723,0,2,0
30759,1,3,107722,107723,107726,1,4,0
30760,4,3,107726,107726,107729,0,3,0
30761,4,1,107730,107730,107731,0,1,1
30762,6,1,107736,107736,107737,0,1,5
30763,6,2,107742,107742,107744,0,2,5
30764,4,3,107746,107746,107749,0,3,2
30765,4,2,107750,107750,107752,0,2,1
30766,5,3,107755,107755,107758,0,3,3
30767,4,2,107759,107759,107761,0,2,1
30768,4,2,107763,107763,107765,0,2,2
30769,2,1,107765,107765,107766,0,1,0
30770,4,3,107769,107769,107772,0,3,3
30771,5,2,107774,107774,107776,0,2,2
30772,5,2,107779,107779,107781,0,2,3
30773,5,2,107784,107784,107786,0,2,3
30774,5,3,107789,107789,107792,0,3,3
30775,5,2,107794,107794,107796,0,2,2
30776,1,1,107795,107796,107797,1,2,0
30777,4,1,107799,107799,107800,0,1,2
30778,3,3,107802,107802,107805,0,3,2
30779,4,2,107806,107806,107808,0,2,1
30780,6,3,107812,107812,107815,0,3,4
30781,4,3,107816,107816,107819,0,3,1
30782,4,1,107820,107820,107821,0,1,1
30783,3,3,107823,107823,107826,0,3,2
30784,6,3,107829,107829,107832,0,3,3
30785,6,2,107835,107835,107837,0,2,3
30786,5,3,107840,107840,107843,0,3,3
30787,6,1,107846,107846,107847,0,1,3
30788,4,2,107850,107850,107852,0,2,3
30789,4,3,107854,107854,107857,0,3,2
30790,1,2,107855,107857,107859,2,4,0
30791,5,1,107860,107860,107861,0,1,1
30792,3,3,107863,107863,107866,0,3,2
30793,2,1,107865,107866,107867,1,2,0
30794,4,2,107869,107869,107871,0,2,2
30795,2,2,107871,107871,107873,0,2,0
30796,1,2,107872,107873,107875,1,3,0
30797,5,2,107877,107877,107879,0,2,2
30798,4,1,107881,107881,107882,0,1,2
30799,3,2,107884,107884,107886,0,2,2
30800,1,1,107885,107886,107887,1,2,0
30801,3,3,107888,107888,107891,0,3,1
30802,2,1,107890,107891,107892,1,2,0
30803,6,1,107896,107896,107897,0,1,4
30804,1,1,107897,107897,107898,0,1,0
30805,2,2,107899,107899,107901,0,2,1
30806,2,1,107901,107901,107902,0,1,0
30807,2,1,107903,107903,107904,0,1,1
30808,3,1,107906,107906,107907,0,1,2
30809,4,1,107910,107910,107911,0,1,3
30810,1,1,107911,107911,107912,0,1,0
30811,1,2,107912,107912,107914,0,2,0
30812,6,3,107918,107918,107921,0,3,4
30813,5,2,107923,107923,107925,0,2,2
30814,5,3,107928,107928,107931,0,3,3
30815,2,1,107930,107931,107932,1,2,0
30816,5,2,107935,107935,107937,0,2,3
30817,2,1,107937,107937,107938,0,1,0
30818,6,2,107943,107943,107945,0,2,5
30819,6,3,107949,107949,107952,0,3,4
30820,6,2,107955,107955,107957,0,2,3
30821,5,2,107960,107960,107962,0,2,3
30822,2,3,107962,107962,107965,0,3,0
30823,1,1,107963,107965,107966,2,3,0
30824,3,2,107966,107966,107968,0,2,0
30825,2,1,107968,107968,107969,0,1,0
30826,3,1,107971,107971,107972,0,1,2
30827,6,2,107977,107977,107979,0,2,5
30828,2,3,107979,107979,107982,0,3,0
30829,2,3,107981,107982,107985,1,4,0
30830,2,3,107983,107985,107988,2,5,0
30831,4,2,107987,107988,107990,1,3,0
30832,5,2,107992,107992,107994,0,2,2
30833,2,2,107994,107994,107996,0,2,0
30834,6,2,108000,108000,108002,0,2,4
30835,4,2,108004,108004,108006,0,2,2
30836,5,3,108009,108009,108012,0,3,3
30837,5,3,108014,108014,108017,0,3,2
30838,6,3,108020,108020,108023,0,3,3
30839,2,2,108022,108023,108025,1,3,0
30840,3,3,108025,108025,108028,0,3,0
30841,4,2,108029,108029,108031,0,2,1
30842,1,3,108030,108031,108034,1,4,0
30843,3,2,108033,108034,108036,1,3,0
30844,5,3,108038,108038,108041,0,3,2
30845,1,3,108039,108041,108044,2,5,0
30846,5,2,108044,108044,108046,0,2,0
30847,4,1,108048,108048,108049,0,1,2
30848,6,2,108054,108054,108056,0,2,5
30849,3,3,108057,108057,108060,0,3,1
30850,1,2,108058,108060,108062,2,4,0
30851,1,2,108059,108062,108064,3,5,0
30852,3,2,108062,108064,108066,2,4,0
30853,1,3,108063,108066,108069,3,6,0
30854,1,3,108064,108069,108072,5,8,0
30855,2,1,108066,108072,108073,6,7,0
30856,6,3,108072,108073,108076,1,4,0
30857,5,1,108077,108077,108078,0,1,1
30858,6,1,108083,108083,108084,0,1,5
30859,1,3,108084,108084,108087,0,3,0
30860,5,2,108089,108089,108091,0,2,2
30861,2,2,108091,108091,108093,0,2,0
30862,4,3,108095,108095,108098,0,3,2
30863,6,2,108101,108101,108103,0,2,3
30864,3,2,108104,108104,108106,0,2,1
30865,4,3,108108,108108,108111,0,3,2
30866,3,2,108111,108111,108113,0,2,0
30867,4,1,108115,108115,108116,0,1,2
30868,3,2,108118,108118,108120,0,2,2
30869,2,2,108120,108120,108122,0,2,0
30870,1,2,108121,108122,108124,1,3,0
30871,4,1,108125,108125,108126,0,1,1
30872,3,2,108128,108128,108130,0,2,2
30873,1,2,108129,108130,108132,1,3,0
30874,2,3,108131,108132,108135,1,4,0
30875,2,1,108133,108135,108136,2,3,0
30876,1,2,108134,108136,108138,2,4,0
30877,6,1,108140,108140,108141,0,1,2
30878,3,3,108143,108143,108146,0,3,2
30879,2,1,108145,108146,108147,1,2,0
30880,1,1,108146,108147,108148,1,2,0
30881,4,2,108150,108150,108152,0,2,2
30882,2,1,108152,108152,108153,0,1,0
30883,5,1,108157,108157,108158,0,1,4
30884,5,1,108162,108162,108163,0,1,4
30885,4,2,108166,108166,108168,0,2,3
30886,4,3,108170,108170,108173,0,3,2
30887,3,2,108173,108173,108175,0,2,0
30888,3,3,108176,108176,108179,0,3,1
30889,4,3,108180,108180,108183,0,3,1
30890,6,1,108186,108186,108187,0,1,3
30891,3,3,108189,108189,108192,0,3,2
30892,6,1,108195,108195,108196,0,1,3
30893,4,2,108199,108199,108201,0,2,3
30894,3,2,108202,108202,108204,0,2,1
30895,2,3,108204,108204,108207,0,3,0
30896,5,1,108209,108209,108210,0,1,2
30897,2,2,108211,108211,108213,0,2,1
30898,3,3,108214,108214,108217,0,3,1
30899,1,2,108215,108217,108219,2,4,0
30900,5,1,108220,108220,108221,0,1,1
30901,5,3,108225,108225,108228,0,3,4
30902,4,3,108229,108229,108232,0,3,1
30903,3,1,108232,108232,108233,0,1,0
30904,1,3,108233,108233,108236,0,3,0
30905,4,2,108237,108237,108239,0,2,1
30906,3,1,108240,108240,108241,0,1,1
30907,3,1,108243,108243,108244,0,1,2
30908,4,3,108247,108247,108250,0,3,3
30909,5,1,108252,108252,108253,0,1,2
30910,6,3,108258,108258,108261,0,3,5
30911,6,3,108264,108264,108267,0,3,3
30912,1,3,108265,108267,108270,2,5,0
30913,1,2,108266,108270,108272,4,6,0
30914,6,1,108272,108272,108273,0,1,0
30915,2,1,108274,108274,108275,0,1,1
30916,6,2,108280,108280,108282,0,2,5
30917,4,3,108284,108284,108287,0,3,2
30918,5,1,108289,108289,108290,0,1,2
30919,3,2,108292,108292,108294,0,2,2
30920,3,3,108295,108295,108298,0,3,1
30921,6,2,108301,108301,108303,0,2,3
30922,3,2,108304,108304,108306,0,2,1
30923,5,3,108309,108309,108312,0,3,3
30924,2,3,108311,108312,108315,1,4,0
30925,5,3,108316,108316,108319,0,3,1
30926,2,1,108318,108319,108320,1,2,0
30927,1,2,108319,108320,108322,1,3,0
30928,3,2,108322,108322,108324,0,2,0
30929,4,1,108326,108326,108327,0,1,2
30930,5,3,108331,108331,108334,0,3,4
30931,1,1,108332,108334,108335,2,3,0
30932,4,2,108336,108336,108338,0,2,1
30933,5,2,108341,108341,108343,0,2,3
30934,6,1,108347,108347,108348,0,1,4
30935,5,1,108352,108352,108353,0,1,4
30936,3,1,108355,108355,108356,0,1,2
30937,1,3,108356,108356,108359,0,3,0
30938,6,1,108362,108362,108363,0,1,3
30939,4,3,108366,108366,108369,0,3,3
30940,1,2,108367,108369,108371,2,4,0
30941,6,1,108373,108373,108374,0,1,2
30942,2,2,108375,108375,108377,0,2,1
30943,6,2,108381,108381,108383,0,2,4
30944,1,2,108382,108383,108385,1,3,0
30945,1,2,108383,108385,108387,2,4,0
30946,4,2,108387,108387,108389,0,2,0
30947,5,3,108392,108392,108395,0,3,3
30948,4,1,108396,108396,108397,0,1,1
30949,3,3,108399,108399,108402,0,3,2
30950,4,3,108403,108403,108406,0,3,1
30951,6,2,108409,108409,108411,0,2,3
30952,3,3,108412,108412,108415,0,3,1
30953,6,2,108418,108418,108420,0,2,3
30954,5,1,108423,108423,108424,0,1,3
30955,1,2,108424,108424,108426,0,2,0
30956,5,2,108429,108429,108431,0,2,3
30957,6,1,108435,108435,108436,0,1,4
30958,5,3,108440,108440,108443,0,3,4
30959,1,2,108441,108443,108445,2,4,0
30960,2,3,108443,108445,108448,2,5,0
30961,6,2,108449,108449,108451,0,2,1
30962,1,2,108450,108451,108453,1,3,0
30963,4,2,108454,108454,108456,0,2,1
30964,6,1,108460,108460,108461,0,1,4
30965,4,3,108464,108464,108467,0,3,3
30966,3,3,108467,108467,108470,0,3,0
30967,2,2,108469,108470,108472,1,3,0
30968,6,3,108475,108475,108478,0,3,3
30969,1,3,108476,108478,108481,2,5,0
30970,4,2,108480,108481,108483,1,3,0
30971,5,1,108485,108485,108486,0,1,2
30972,1,2,108486,108486,108488,0,2,0
30973,6,3,108492,108492,108495,0,3,4
30974,3,3,108495,108495,108498,0,3,0
30975,5,3,108500,108500,108503,0,3,2
30976,1,3,108501,108503,108506,2,5,0
30977,5,3,108506,108506,108509,0,3,0
30978,3,3,108509,108509,108512,0,3,0
30979,2,3,108511,108512,108515,1,4,0
30980,5,2,108516,108516,108518,0,2,1
30981,1,1,108517,108518,108519,1,2,0
30982,2,3,108519,108519,108522,0,3,0
30983,1,2,108520,108522,108524,2,4,0
30984,2,3,108522,108524,108527,2,5,0
30985,1,1,108523,108527,108528,4,5,0
30986,3,3,108526,108528,108531,2,5,0
30987,4,1,108530,108531,108532,1,2,0
30988,1,2,108531,108532,108534,1,3,0
30989,5,3,108536,108536,108539,0,3,2
30990,3,3,108539,108539,108542,0,3,0
30991,6,1,108545,108545,108546,0,1,3
30992,5,1,108550,108550,108551,0,1,4
30993,1,1,108551,108551,108552,0,1,0
30994,4,1,108555,108555,108556,0,1,3
30995,5,1,108560,108560,108561,0,1,4
30996,1,1,108561,108561,108562,0,1,0
30997,1,2,108562,108562,108564,0,2,0
30998,2,3,108564,108564,108567,0,3,0
30999,2,1,108566,108567,108568,1,2,0
31000,5,2,108571,108571,108573,0,2,3
31001,1,2,108572,108573,108575,1,3,0
31002,4,3,108576,108576,108579,0,3,1
31003,1,1,108577,108579,108580,2,3,0
31004,4,3,108581,108581,108584,0,3,1
31005,2,3,108583,108584,108587,1,4,0
31006,1,1,108584,108587,108588,3,4,0
31007,4,3,108588,108588,108591,0,3,0
31008,2,1,108590,108591,108592,1,2,0
31009,4,3,108594,108594,108597,0,3,2
31010,6,2,108600,108600,108602,0,2,3
31011,5,1,108605,108605,108606,0,1,3
31012,4,1,108609,108609,108610,0,1,3
31013,4,2,108613,108613,108615,0,2,3
31014,5,1,108618,108618,108619,0,1,3
31015,2,3,108620,108620,108623,0,3,1
31016,1,1,108621,108623,108624,2,3,0
31017,2,3,108623,108624,108627,1,4,0
31018,2,3,108625,108627,108630,2,5,0
31019,6,3,108631,108631,108634,0,3,1
31020,1,2,108632,108634,108636,2,4,0
31021,6,1,108638,108638,108639,0,1,2
31022,5,1,108643,108643,108644,0,1,4
31023,3,1,108646,108646,108647,0,1,2
31024,3,2,108649,108649,108651,0,2,2
31025,2,3,108651,108651,108654,0,3,0
31026,6,1,108657,108657,108658,0,1,3
31027,2,2,108659,108659,108661,0,2,1
31028,6,3,108665,108665,108668,0,3,4
31029,3,2,108668,108668,108670,0,2,0
31030,6,1,108674,108674,108675,0,1,4
31031,3,3,108677,108677,108680,0,3,2
31032,1,1,108678,108680,108681,2,3,0
31033,1,2,108679,108681,108683,2,4,0
31034,3,2,108682,108683,108685,1,3,0
31035,3,2,108685,108685,108687,0,2,0
31036,5,2,108690,108690,108692,0,2,3
31037,5,2,108695,108695,108697,0,2,3
31038,5,3,108700,108700,108703,0,3,3
31039,2,1,108702,108703,108704,1,2,0
31040,3,2,108705,108705,108707,0,2,1
31041,2,1,108707,108707,108708,0,1,0
31042,2,1,108709,108709,108710,0,1,1
31043,6,3,108715,108715,108718,0,3,5
31044,4,3,108719,108719,108722,0,3,1
31045,6,3,108725,108725,108728,0,3,3
31046,3,3,108728,108728,108731,0,3,0
31047,6,1,108734,108734,108735,0,1,3
31048,4,3,108738,108738,108741,0,3,3
31049,5,2,108743,108743,108745,0,2,2
31050,4,2,108747,108747,108749,0,2,2
31051,4,1,108751,108751,108752,0,1,2
31052,2,3,108753,108753,108756,0,3,1
31053,6,3,108759,108759,108762,0,3,3
31054,6,2,108765,108765,108767,0,2,3
31055,2,1,108767,108767,108768,0,1,0
31056,5,3,108772,108772,108775,0,3,4
31057,5,3,108777,108777,108780,0,3,2
31058,3,3,108780,108780,108783,0,3,0
31059,3,1,108783,108783,108784,0,1,0
31060,6,2,108789,108789,108791,0,2,5
31061,5,1,108794,108794,108795,0,1,3
31062,5,1,108799,108799,108800,0,1,4
31063,5,3,108804,108804,108807,0,3,4
31064,3,1,108807,108807,108808,0,1,0
31065,2,1,108809,108809,108810,0,1,1
31066,5,1,108814,108814,108815,0,1,4
31067,5,1,108819,108819,108820,0,1,4
31068,2,2,108821,108821,108823,0,2,1
31069,3,3,108824,108824,108827,0,3,1
31070,2,1,108826,108827,108828,1,2,0
31071,5,2,108831,108831,108833,0,2,3
31072,6,1,108837,108837,108838,0,1,4
31073,3,2,108840,108840,108842,0,2,2
31074,5,3,108845,108845,108848,0,3,3
31075,6,3,108851,108851,108854,0,3,3
31076,1,3,108852,108854,108857,2,5,0
31077,5,2,108857,108857,108859,0,2,0
31078,6,3,108863,108863,108866,0,3,4
31079,6,1,108869,108869,108870,0,1,3
31080,5,3,108874,108874,108877,0,3,4
31081,3,2,108877,108877,108879,0,2,0
31082,2,3,108879,108879,108882,0,3,0
31083,6,2,108885,108885,108887,0,2,3
31084,4,3,108889,108889,108892,0,3,2
31085,6,3,108895,108895,108898,0,3,3
31086,2,1,108897,108898,108899,1,2,0
31087,4,1,108901,108901,108902,0,1,2
31088,6,3,108907,108907,108910,0,3,5
31089,2,2,108909,108910,108912,1,3,0
31090,3,3,108912,108912,108915,0,3,0
31091,1,1,108913,108915,108916,2,3,0
31092,5,3,108918,108918,108921,0,3,2
31093,3,3,108921,108921,108924,0,3,0
31094,1,2,108922,108924,108926,2,4,0
31095,5,2,108927,108927,108929,0,2,1
31096,6,3,108933,108933,108936,0,3,4
31097,4,3,108937,108937,108940,0,3,1
31098,6,1,108943,108943,108944,0,1,3
31099,3,2,108946,108946,108948,0,2,2
31100,5,2,108951,108951,108953,0,2,3
31101,6,2,108957,108957,108959,0,2,4
31102,5,2,108962,108962,108964,0,2,3
31103,3,3,108965,108965,108968,0,3,1
31104,3,3,108968,108968,108971,0,3,0
31105,6,3,108974,108974,108977,0,3,3
31106,3,2,108977,108977,108979,0,2,0
31107,3,1,108980,108980,108981,0,1,1
31108,6,1,108986,108986,108987,0,1,5
31109,3,1,108989,108989,108990,0,1,2
31110,3,2,108992,108992,108994,0,2,2
31111,3,2,108995,108995,108997,0,2,1
31112,4,2,108999,108999,109001,0,2,2
31113,3,2,109002,109002,109004,0,2,1
31114,3,2,109005,109005,109007,0,2,1
31115,1,3,109006,109007,109010,1,4,0
31116,1,2,109007,109010,109012,3,5,0
31117,5,1,109012,109012,109013,0,1,0
31118,6,2,109018,109018,109020,0,2,5
31119,2,3,109020,109020,109023,0,3,0
31120,3,1,109023,109023,109024,0,1,0
31121,5,1,109028,109028,109029,0,1,4
31122,1,1,109029,109029,109030,0,1,0
31123,4,3,109033,109033,109036,0,3,3
31124,1,3,109034,109036,109039,2,5,0
31125,6,1,109040,109040,109041,0,1,1
31126,2,3,109042,109042,109045,0,3,1
31127,1,3,109043,109045,109048,2,5,0
31128,1,1,109044,109048,109049,4,5,0
31129,3,2,109047,109049,109051,2,4,0
31130,1,1,109048,109051,109052,3,4,0
31131,5,3,109053,109053,109056,0,3,1
31132,2,1,109055,109056,109057,1,2,0
31133,1,3,109056,109057,109060,1,4,0
31134,1,3,109057,109060,109063,3,6,0
31135,5,1,109062,109063,109064,1,2,0
31136,5,2,109067,109067,109069,0,2,3
31137,5,3,109072,109072,109075,0,3,3
31138,1,3,109073,109075,109078,2,5,0
31139,4,3,109077,109078,109081,1,4,0
31140,5,3,109082,109082,109085,0,3,1
31141,1,2,109083,109085,109087,2,4,0
31142,4,1,109087,109087,109088,0,1,0
31143,2,2,109089,109089,109091,0,2,1
31144,4,3,109093,109093,109096,0,3,2
31145,2,3,109095,109096,109099,1,4,0
31146,1,2,109096,109099,109101,3,5,0
31147,2,1,109098,109101,109102,3,4,0
31148,3,1,109101,109102,109103,1,2,0
31149,4,3,109105,109105,109108,0,3,2
31150,3,2,109108,109108,109110,0,2,0
31151,1,1,109109,109110,109111,1,2,0
31152,4,3,109113,109113,109116,0,3,2
31153,5,2,109118,109118,109120,0,2,2
31154,6,1,109124,109124,109125,0,1,4
31155,3,3,109127,109127,109130,0,3,2
31156,4,1,109131,109131,109132,0,1,1
31157,5,3,109136,109136,109139,0,3,4
31158,6,2,109142,109142,109144,0,2,3
31159,2,1,109144,109144,109145,0,1,0
31160,6,2,109150,109150,109152,0,2,5
31161,4,1,109154,109154,109155,0,1,2
31162,1,2,109155,109155,109157,0,2,0
31163,1,1,109156,109157,109158,1,2,0
31164,1,3,109157,109158,109161,1,4,0
31165,6,1,109163,109163,109164,0,1,2
31166,3,1,109166,109166,109167,0,1,2
31167,5,2,109171,109171,109173,0,2,4
31168,5,3,109176,109176,109179,0,3,3
31169,6,3,109182,109182,109185,0,3,3
31170,2,1,109184,109185,109186,1,2,0
31171,3,1,109187,109187,109188,0,1,1
31172,3,3,109190,109190,109193,0,3,2
31173,2,3,109192,109193,109196,1,4,0
31174,1,3,109193,109196,109199,3,6,0
31175,5,2,109198,109199,109201,1,3,0
31176,2,1,109200,109201,109202,1,2,0
31177,4,2,109204,109204,109206,0,2,2
31178,3,3,109207,109207,109210,0,3,1
31179,3,2,109210,109210,109212,0,2,0
31180,6,2,109216,109216,109218,0,2,4
31181,5,2,109221,109221,109223,0,2,3
31182,4,2,109225,109225,109227,0,2,2
31183,1,1,109226,109227,109228,1,2,0
31184,3,2,109229,109229,109231,0,2,1
31185,6,3,109235,109235,109238,0,3,4
31186,1,3,109236,109238,109241,2,5,0
31187,5,2,109241,109241,109243,0,2,0
31188,4,1,109245,109245,109246,0,1,2
31189,2,3,109247,109247,109250,0,3,1
31190,3,2,109250,109250,109252,0,2,0
31191,6,3,109256,109256,109259,0,3,4
31192,4,2,109260,109260,109262,0,2,1
31193,5,2,109265,109265,109267,0,2,3
31194,3,1,109268,109268,109269,0,1,1
31195,4,3,109272,109272,109275,0,3,3
31196,3,1,109275,109275,109276,0,1,0
31197,4,1,109279,109279,109280,0,1,3
31198,1,1,109280,109280,109281,0,1,0
31199,6,3,109286,109286,109289,0,3,5
31200,5,1,109291,109291,109292,0,1,2
31201,2,3,109293,109293,109296,0,3,1
31202,2,2,109295,109296,109298,1,3,0
31203,3,2,109298,109298,109300,0,2,0
31204,3,1,109301,109301,109302,0,1,1
31205,6,1,109307,109307,109308,0,1,5
31206,5,1,109312,109312,109313,0,1,4
31207,2,2,109314,109314,109316,0,2,1
31208,6,3,109320,109320,109323,0,3,4
31209,5,2,109325,109325,109327,0,2,2
31210,3,1,109328,109328,109329,0,1,1
31211,2,3,109330,109330,109333,0,3,1
31212,5,2,109335,109335,109337,0,2,2
31213,5,1,109340,109340,109341,0,1,3
31214,4,3,109344,109344,109347,0,3,3
31215,3,1,109347,109347,109348,0,1,0
31216,3,1,109350,109350,109351,0,1,2
31217,4,2,109354,109354,109356,0,2,3
31218,3,2,109357,109357,109359,0,2,1
31219,1,3,109358,109359,109362,1,4,0
31220,2,2,109360,109362,109364,2,4,0
31221,5,2,109365,109365,109367,0,2,1
31222,6,2,109371,109371,109373,0,2,4
31223,4,2,109375,109375,109377,0,2,2
31224,1,3,109376,109377,109380,1,4,0
31225,3,2,109379,109380,109382,1,3,0
31226,2,3,109381,109382,109385,1,4,0
31227,2,1,109383,109385,109386,2,3,0
31228,5,2,109388,109388,109390,0,2,2
31229,3,2,109391,109391,109393,0,2,1
31230,6,3,109397,109397,109400,0,3,4
31231,4,1,109401,109401,109402,0,1,1
31232,2,3,109403,109403,109406,0,3,1
31233,4,1,109407,109407,109408,0,1,1
31234,3,2,109410,109410,109412,0,2,2
31235,1,1,109411,109412,109413,1,2,0
31236,4,3,109415,109415,109418,0,3,2
31237,5,2,109420,109420,109422,0,2,2
31238,3,3,109423,109423,109426,0,3,1
31239,1,2,109424,109426,109428,2,4,0
31240,4,1,109428,109428,109429,0,1,0
31241,2,2,109430,109430,109432,0,2,1
31242,4,2,109434,109434,109436,0,2,2
31243,2,3,109436,109436,109439,0,3,0
31244,6,2,109442,109442,109444,0,2,3
31245,3,2,109445,109445,109447,0,2,1
31246,2,1,109447,109447,109448,0,1,0
31247,6,1,109453,109453,109454,0,1,5
31248,4,3,109457,109457,109460,0,3,3
31249,3,1,109460,109460,109461,0,1,0
31250,3,1,109463,109463,109464,0,1,2
31251,3,3,109466,109466,109469,0,3,2
31252,5,3,109471,109471,109474,0,3,2
31253,5,3,109476,109476,109479,0,3,2
31254,2,3,109478,109479,109482,1,4,0
31255,6,3,109484,109484,109487,0,3,2
31256,3,1,109487,109487,109488,0,1,0
31257,4,2,109491,109491,109493,0,2,3
31258,4,2,109495,109495,109497,0,2,2
31259,2,2,109497,109497,109499,0,2,0
31260,3,1,109500,109500,109501,0,1,1
31261,2,1,109502,109502,109503,0,1,1
31262,5,3,109507,109507,109510,0,3,4
31263,1,3,109508,109510,109513,2,5,0
31264,1,1,109509,109513,109514,4,5,0
31265,5,1,109514,109514,109515,0,1,0
31266,2,3,109516,109516,109519,0,3,1
31267,5,1,109521,109521,109522,0,1,2
31268,6,2,109527,109527,109529,0,2,5
31269,6,2,109533,109533,109535,0,2,4
31270,6,2,109539,109539,109541,0,2,4
31271,6,2,109545,109545,109547,0,2,4
31272,1,1,109546,109547,109548,1,2,0
31273,3,2,109549,109549,109551,0,2,1
31274,4,1,109553,109553,109554,0,1,2
31275,6,1,109559,109559,109560,0,1,5
31276,2,1,109561,109561,109562,0,1,1
31277,6,3,109567,109567,109570,0,3,5
31278,1,3,109568,109570,109573,2,5,0
31279,6,2,109574,109574,109576,0,2,1
31280,2,3,109576,109576,109579,0,3,0
31281,4,2,109580,109580,109582,0,2,1
31282,5,3,109585,109585,109588,0,3,3
31283,4,3,109589,109589,109592,0,3,1
31284,3,1,109592,109592,109593,0,1,0
31285,2,1,109594,109594,109595,0,1,1
31286,1,3,109595,109595,109598,0,3,0
31287,1,3,109596,109598,109601,2,5,0
31288,1,2,109597,109601,109603,4,6,0
31289,4,3,109601,109603,109606,2,5,0
31290,5,3,109606,109606,109609,0,3,0
31291,2,2,109608,109609,109611,1,3,0
31292,3,1,109611,109611,109612,0,1,0
31293,4,2,109615,109615,109617,0,2,3
31294,3,1,109618,109618,109619,0,1,1
31295,1,1,109619,109619,109620,0,1,0
31296,1,3,109620,109620,109623,0,3,0
31297,1,3,109621,109623,109626,2,5,0
31298,1,1,109622,109626,109627,4,5,0
31299,6,1,109628,109628,109629,0,1,1
31300,1,2,109629,109629,109631,0,2,0
31301,6,3,109635,109635,109638,0,3,4
31302,2,2,109637,109638,109640,1,3,0
31303,2,3,109639,109640,109643,1,4,0
31304,5,2,109644,109644,109646,0,2,1
31305,2,3,109646,109646,109649,0,3,0
31306,5,3,109651,109651,109654,0,3,2
31307,2,3,109653,109654,109657,1,4,0
31308,2,3,109655,109657,109660,2,5,0
31309,4,3,109659,109660,109663,1,4,0
31310,6,3,109665,109665,109668,0,3,2
31311,4,2,109669,109669,109671,0,2,1
31312,4,3,109673,109673,109676,0,3,2
31313,1,2,109674,109676,109678,2,4,0
31314,2,2,109676,109678,109680,2,4,0
31315,6,3,109682,109682,109685,0,3,2
31316,1,1,109683,109685,109686,2,3,0
31317,2,2,109685,109686,109688,1,3,0
31318,1,1,109686,109688,109689,2,3,0
31319,3,3,109689,109689,109692,0,3,0
31320,6,2,109695,109695,109697,0,2,3
31321,2,1,109697,109697,109698,0,1,0
31322,4,1,109701,109701,109702,0,1,3
31323,1,1,109702,109702,109703,0,1,0
31324,3,1,109705,109705,109706,0,1,2
31325,2,1,109707,109707,109708,0,1,1
31326,2,2,109709,109709,109711,0,2,1
31327,1,2,109710,109711,109713,1,3,0
31328,5,3,109715,109715,109718,0,3,2
31329,3,3,109718,109718,109721,0,3,0
31330,5,1,109723,109723,109724,0,1,2
31331,6,3,109729,109729,109732,0,3,5
31332,3,3,109732,109732,109735,0,3,0
31333,5,3,109737,109737,109740,0,3,2
31334,3,1,109740,109740,109741,0,1,0
31335,3,1,109743,109743,109744,0,1,2
31336,6,2,109749,109749,109751,0,2,5
31337,5,3,109754,109754,109757,0,3,3
31338,5,3,109759,109759,109762,0,3,2
31339,3,2,109762,109762,109764,0,2,0
31340,6,3,109768,109768,109771,0,3,4
31341,5,1,109773,109773,109774,0,1,2
31342,1,3,109774,109774,109777,0,3,0
31343,5,1,109779,109779,109780,0,1,2
31344,6,1,109785,109785,109786,0,1,5
31345,3,3,109788,109788,109791,0,3,2
31346,4,3,109792,109792,109795,0,3,1
31347,3,2,109795,109795,109797,0,2,0
31348,4,1,109799,109799,109800,0,1,2
31349,2,1,109801,109801,109802,0,1,1
31350,3,2,109804,109804,109806,0,2,2
31351,3,3,109807,109807,109810,0,3,1
31352,4,1,109811,109811,109812,0,1,1
31353,1,1,109812,109812,109813,0,1,0
31354,4,3,109816,109816,109819,0,3,3
31355,6,3,109822,109822,109825,0,3,3
31356,2,1,109824,109825,109826,1,2,0
31357,1,3,109825,109826,109829,1,4,0
31358,4,3,109829,109829,109832,0,3,0
31359,6,1,109835,109835,109836,0,1,3
31360,3,1,109838,109838,109839,0,1,2
31361,4,3,109842,109842,109845,0,3,3
31362,4,1,109846,109846,109847,0,1,1
31363,2,3,109848,109848,109851,0,3,1
31364,6,1,109854,109854,109855,0,1,3
31365,1,1,109855,109855,109856,0,1,0
31366,4,3,109859,109859,109862,0,3,3
31367,5,3,109864,109864,109867,0,3,2
31368,6,1,109870,109870,109871,0,1,3
31369,3,1,109873,109873,109874,0,1,2
31370,5,3,109878,109878,109881,0,3,4
31371,5,3,109883,109883,109886,0,3,2
31372,4,2,109887,109887,109889,0,2,1
31373,5,1,109892,109892,109893,0,1,3
31374,5,2,109897,109897,109899,0,2,4
31375,4,2,109901,109901,109903,0,2,2
31376,2,3,109903,109903,109906,0,3,0
31377,3,2,109906,109906,109908,0,2,0
31378,5,1,109911,109911,109912,0,1,3
31379,2,3,109913,109913,109916,0,3,1
31380,1,1,109914,109916,109917,2,3,0
31381,4,3,109918,109918,109921,0,3,1
31382,6,2,109924,109924,109926,0,2,3
31383,2,2,109926,109926,109928,0,2,0
31384,3,1,109929,109929,109930,0,1,1
31385,1,3,109930,109930,109933,0,3,0
31386,6,3,109936,109936,109939,0,3,3
31387,3,3,109939,109939,109942,0,3,0
31388,3,3,109942,109942,109945,0,3,0
31389,4,1,109946,109946,109947,0,1,1
31390,2,3,109948,109948,109951,0,3,1
31391,3,2,109951,109951,109953,0,2,0
31392,6,3,109957,109957,109960,0,3,4
31393,5,3,109962,109962,109965,0,3,2
31394,4,1,109966,109966,109967,0,1,1
31395,2,1,109968,109968,109969,0,1,1
31396,3,3,109971,109971,109974,0,3,2
31397,4,2,109975,109975,109977,0,2,1
31398,6,3,109981,109981,109984,0,3,4
31399,6,1,109987,109987,109988,0,1,3
31400,5,2,109992,109992,109994,0,2,4
31401,4,3,109996,109996,109999,0,3,2
31402,5,1,110001,110001,110002,0,1,2
31403,3,2,110004,110004,110006,0,2,2
31404,2,3,110006,110006,110009,0,3,0
31405,1,2,110007,110009,110011,2,4,0
31406,1,3,110008,110011,110014,3,6,0
31407,3,2,110011,110014,110016,3,5,0
31408,1,2,110012,110016,110018,4,6,0
31409,4,3,110016,110018,110021,2,5,0
31410,3,2,110019,110021,110023,2,4,0
31411,1,1,110020,110023,110024,3,4,0
31412,4,3,110024,110024,110027,0,3,0
31413,5,1,110029,110029,110030,0,1,2
31414,4,3,110033,110033,110036,0,3,3
31415,4,1,110037,110037,110038,0,1,1
31416,5,1,110042,110042,110043,0,1,4
31417,3,1,110045,110045,110046,0,1,2
31418,4,1,110049,110049,110050,0,1,3
31419,2,3,110051,110051,110054,0,3,1
31420,4,2,110055,110055,110057,0,2,1
31421,3,1,110058,110058,110059,0,1,1
31422,5,2,110063,110063,110065,0,2,4
31423,4,2,110067,110067,110069,0,2,2
31424,1,1,110068,110069,110070,1,2,0
31425,3,2,110071,110071,110073,0,2,1
31426,4,1,110075,110075,110076,0,1,2
31427,2,2,110077,110077,110079,0,2,1
31428,2,1,110079,110079,110080,0,1,0
31429,4,3,110083,110083,110086,0,3,3
31430,6,1,110089,110089,110090,0,1,3
31431,4,3,110093,110093,110096,0,3,3
31432,4,1,110097,110097,110098,0,1,1
31433,4,2,110101,110101,110103,0,2,3
31434,1,1,110102,110103,110104,1,2,0
31435,2,1,110104,110104,110105,0,1,0
31436,6,2,110110,110110,110112,0,2,5
31437,5,3,110115,110115,110118,0,3,3
31438,4,2,110119,110119,110121,0,2,1
31439,4,3,110123,110123,110126,0,3,2
31440,2,3,110125,110126,110129,1,4,0
31441,4,3,110129,110129,110132,0,3,0
31442,5,3,110134,110134,110137,0,3,2
31443,3,1,110137,110137,110138,0,1,0
31444,2,1,110139,110139,110140,0,1,1
31445,3,2,110142,110142,110144,0,2,2
31446,5,1,110147,110147,110148,0,1,3
31447,2,1,110149,110149,110150,0,1,1
31448,4,3,110153,110153,110156,0,3,3
31449,4,1,110157,110157,110158,0,1,1
31450,5,2,110162,110162,110164,0,2,4
31451,5,3,110167,110167,110170,0,3,3
31452,4,3,110171,110171,110174,0,3,1
31453,4,2,110175,110175,110177,0,2,1
31454,3,1,110178,110178,110179,0,1,1
31455,2,1,110180,110180,110181,0,1,1
31456,3,3,110183,110183,110186,0,3,2
31457,6,3,110189,110189,110192,0,3,3
31458,6,1,110195,110195,110196,0,1,3
31459,4,2,110199,110199,110201,0,2,3
31460,5,2,110204,110204,110206,0,2,3
31461,2,1,110206,110206,110207,0,1,0
31462,6,1,110212,110212,110213,0,1,5
31463,3,3,110215,110215,110218,0,3,2
31464,2,1,110217,110218,110219,1,2,0
31465,3,3,110220,110220,110223,0,3,1
31466,4,3,110224,110224,110227,0,3,1
31467,1,3,110225,110227,110230,2,5,0
31468,1,1,110226,110230,110231,4,5,0
31469,3,1,110229,110231,110232,2,3,0
31470,2,2,110231,110232,110234,1,3,0
31471,3,2,110234,110234,110236,0,2,0
31472,1,1,110235,110236,110237,1,2,0
31473,1,3,110236,110237,110240,1,4,0
31474,2,1,110238,110240,110241,2,3,0
31475,4,3,110242,110242,110245,0,3,1
31476,4,3,110246,110246,110249,0,3,1
31477,1,3,110247,110249,110252,2,5,0
31478,3,1,110250,110252,110253,2,3,0
31479,4,3,110254,110254,110257,0,3,1
31480,5,3,110259,110259,110262,0,3,2
31481,1,2,110260,110262,110264,2,4,0
31482,3,1,110263,110264,110265,1,2,0
31483,1,3,110264,110265,110268,1,4,0
31484,2,2,110266,110268,110270,2,4,0
31485,4,3,110270,110270,110273,0,3,0
31486,3,1,110273,110273,110274,0,1,0
31487,5,1,110278,110278,110279,0,1,4
31488,4,3,110282,110282,110285,0,3,3
31489,5,1,110287,110287,110288,0,1,2
31490,4,3,110291,110291,110294,0,3,3
31491,4,3,110295,110295,110298,0,3,1
31492,2,1,110297,110298,110299,1,2,0
31493,4,2,110301,110301,110303,0,2,2
31494,5,3,110306,110306,110309,0,3,3
31495,2,1,110308,110309,110310,1,2,0
31496,6,2,110314,110314,110316,0,2,4
31497,1,3,110315,110316,110319,1,4,0
31498,4,2,110319,110319,110321,0,2,0
31499,2,1,110321,110321,110322,0,1,0
31500,3,3,110324,110324,110327,0,3,2
31501,4,3,110328,110328,110331,0,3,1
31502,4,1,110332,110332,110333,0,1,1
31503,2,1,110334,110334,110335,0,1,1
31504,1,2,110335,110335,110337,0,2,0
31505,2,1,110337,110337,110338,0,1,0
31506,2,3,110339,110339,110342,0,3,1
31507,2,3,110341,110342,110345,1,4,0
31508,6,3,110347,110347,110350,0,3,2
31509,1,3,110348,110350,110353,2,5,0
31510,6,3,110354,110354,110357,0,3,1
31511,1,2,110355,110357,110359,2,4,0
31512,6,3,110361,110361,110364,0,3,2
31513,6,2,110367,110367,110369,0,2,3
31514,4,3,110371,110371,110374,0,3,2
31515,3,3,110374,110374,110377,0,3,0
31516,4,2,110378,110378,110380,0,2,1
31517,3,3,110381,110381,110384,0,3,1
31518,4,3,110385,110385,110388,0,3,1
31519,2,3,110387,110388,110391,1,4,0
31520,1,2,110388,110391,110393,3,5,0
31521,1,1,110389,110393,110394,4,5,0
31522,6,1,110395,110395,110396,0,1,1
31523,5,1,110400,110400,110401,0,1,4
31524,3,3,110403,110403,110406,0,3,2
31525,1,3,110404,110406,110409,2,5,0
31526,3,1,110407,110409,110410,2,3,0
31527,4,3,110411,110411,110414,0,3,1
31528,2,3,110413,110414,110417,1,4,0
31529,5,1,110418,110418,110419,0,1,1
31530,1,1,110419,110419,110420,0,1,0
31531,4,3,110423,110423,110426,0,3,3
31532,4,1,110427,110427,110428,0,1,1
31533,1,3,110428,110428,110431,0,3,0
31534,4,2,110432,110432,110434,0,2,1
31535,6,1,110438,110438,110439,0,1,4
31536,6,3,110444,110444,110447,0,3,5
31537,6,1,110450,110450,110451,0,1,3
31538,1,3,110451,110451,110454,0,3,0
31539,5,3,110456,110456,110459,0,3,2
31540,1,1,110457,110459,110460,2,3,0
31541,6,3,110463,110463,110466,0,3,3
31542,4,1,110467,110467,110468,0,1,1
31543,2,2,110469,110469,110471,0,2,1
31544,2,1,110471,110471,110472,0,1,0
31545,5,2,110476,110476,110478,0,2,4
31546,4,3,110480,110480,110483,0,3,2
31547,2,3,110482,110483,110486,1,4,0
31548,3,2,110485,110486,110488,1,3,0
31549,2,2,110487,110488,110490,1,3,0
31550,6,2,110493,110493,110495,0,2,3
31551,3,1,110496,110496,110497,0,1,1
31552,1,2,110497,110497,110499,0,2,0
31553,5,1,110502,110502,110503,0,1,3
31554,1,3,110503,110503,110506,0,3,0
31555,1,2,110504,110506,110508,2,4,0
31556,5,3,110509,110509,110512,0,3,1
31557,3,3,110512,110512,110515,0,3,0
31558,4,3,110516,110516,110519,0,3,1
31559,2,2,110518,110519,110521,1,3,0
31560,2,2,110520,110521,110523,1,3,0
31561,2,2,110522,110523,110525,1,3,0
31562,4,2,110526,110526,110528,0,2,1
31563,6,1,110532,110532,110533,0,1,4
31564,4,1,110536,110536,110537,0,1,3
31565,6,1,110542,110542,110543,0,1,5
31566,6,2,110548,110548,110550,0,2,5
31567,2,1,110550,110550,110551,0,1,0
31568,1,2,110551,110551,110553,0,2,0
31569,2,1,110553,110553,110554,0,1,0
31570,5,2,110558,110558,110560,0,2,4
31571,2,2,110560,110560,110562,0,2,0
31572,1,3,110561,110562,110565,1,4,0
31573,2,1,110563,110565,110566,2,3,0
31574,2,2,110565,110566,110568,1,3,0
31575,2,3,110567,110568,110571,1,4,0
31576,1,2,110568,110571,110573,3,5,0
31577,5,2,110573,110573,110575,0,2,0
31578,5,2,110578,110578,110580,0,2,3
31579,3,3,110581,110581,110584,0,3,1
31580,5,3,110586,110586,110589,0,3,2
31581,2,3,110588,110589,110592,1,4,0
31582,3,1,110591,110592,110593,1,2,0
31583,2,2,110593,110593,110595,0,2,0
31584,5,2,110598,110598,110600,0,2,3
31585,5,1,110603,110603,110604,0,1,3
31586,3,3,110606,110606,110609,0,3,2
31587,4,1,110610,110610,110611,0,1,1
31588,2,3,110612,110612,110615,0,3,1
31589,2,2,110614,110615,110617,1,3,0
31590,1,2,110615,110617,110619,2,4,0
31591,5,2,110620,110620,110622,0,2,1
31592,4,2,110624,110624,110626,0,2,2
31593,2,2,110626,110626,110628,0,2,0
31594,1,1,110627,110628,110629,1,2,0
31595,3,1,110630,110630,110631,0,1,1
31596,3,1,110633,110633,110634,0,1,2
31597,6,2,110639,110639,110641,0,2,5
31598,6,2,110645,110645,110647,0,2,4
31599,4,1,110649,110649,110650,0,1,2
31600,4,3,110653,110653,110656,0,3,3
31601,5,1,110658,110658,110659,0,1,2
31602,6,2,110664,110664,110666,0,2,5
31603,4,3,110668,110668,110671,0,3,2
31604,3,1,110671,110671,110672,0,1,0
31605,6,3,110677,110677,110680,0,3,5
31606,5,1,110682,110682,110683,0,1,2
31607,4,3,110686,110686,110689,0,3,3
31608,4,2,110690,110690,110692,0,2,1
31609,4,2,110694,110694,110696,0,2,2
31610,4,1,110698,110698,110699,0,1,2
31611,4,1,110702,110702,110703,0,1,3
31612,6,2,110708,110708,110710,0,2,5
31613,6,1,110714,110714,110715,0,1,4
31614,4,1,110718,110718,110719,0,1,3
31615,6,3,110724,110724,110727,0,3,5
31616,5,2,110729,110729,110731,0,2,2
31617,5,1,110734,110734,110735,0,1,3
31618,6,3,110740,110740,110743,0,3,5
31619,3,2,110743,110743,110745,0,2,0
31620,6,2,110749,110749,110751,0,2,4
31621,1,1,110750,110751,110752,1,2,0
31622,1,3,110751,110752,110755,1,4,0
31623,1,1,110752,110755,110756,3,4,0
31624,5,1,110757,110757,110758,0,1,1
31625,6,2,110763,110763,110765,0,2,5
31626,3,1,110766,110766,110767,0,1,1
31627,6,1,110772,110772,110773,0,1,5
31628,3,2,110775,110775,110777,0,2,2
31629,3,3,110778,110778,110781,0,3,1
31630,2,1,110780,110781,110782,1,2,0
31631,5,2,110785,110785,110787,0,2,3
31632,2,3,110787,110787,110790,0,3,0
31633,4,1,110791,110791,110792,0,1,1
31634,1,1,110792,110792,110793,0,1,0
31635,3,2,110795,110795,110797,0,2,2
31636,2,3,110797,110797,110800,0,3,0
31637,4,1,110801,110801,110802,0,1,1
31638,4,1,110805,110805,110806,0,1,3
31639,2,3,110807,110807,110810,0,3,1
31640,5,1,110812,110812,110813,0,1,2
31641,2,2,110814,110814,110816,0,2,1
31642,3,2,110817,110817,110819,0,2,1
31643,5,3,110822,110822,110825,0,3,3
31644,4,2,110826,110826,110828,0,2,1
31645,1,3,110827,110828,110831,1,4,0
31646,3,1,110830,110831,110832,1,2,0
31647,6,3,110836,110836,110839,0,3,4
31648,2,1,110838,110839,110840,1,2,0
31649,1,1,110839,110840,110841,1,2,0
31650,3,2,110842,110842,110844,0,2,1
31651,1,1,110843,110844,110845,1,2,0
31652,3,3,110846,110846,110849,0,3,1
31653,3,1,110849,110849,110850,0,1,0
31654,2,3,110851,110851,110854,0,3,1
31655,2,3,110853,110854,110857,1,4,0
31656,1,3,110854,110857,110860,3,6,0
31657,3,3,110857,110860,110863,3,6,0
31658,4,1,110861,110863,110864,2,3,0
31659,6,3,110867,110867,110870,0,3,3
31660,6,2,110873,110873,110875,0,2,3
31661,4,1,110877,110877,110878,0,1,2
31662,3,1,110880,110880,110881,0,1,2
31663,6,2,110886,110886,110888,0,2,5
31664,4,1,110890,110890,110891,0,1,2
31665,2,2,110892,110892,110894,0,2,1
31666,2,3,110894,110894,110897,0,3,0
31667,5,3,110899,110899,110902,0,3,2
31668,3,3,110902,110902,110905,0,3,0
31669,2,2,110904,110905,110907,1,3,0
31670,1,3,110905,110907,110910,2,5,0
31671,5,2,110910,110910,110912,0,2,0
31672,1,3,110911,110912,110915,1,4,0
31673,6,3,110917,110917,110920,0,3,2
31674,1,1,110918,110920,110921,2,3,0
31675,3,2,110921,110921,110923,0,2,0
31676,6,3,110927,110927,110930,0,3,4
31677,3,1,110930,110930,110931,0,1,0
31678,6,3,110936,110936,110939,0,3,5
31679,4,2,110940,110940,110942,0,2,1
31680,4,1,110944,110944,110945,0,1,2
31681,3,2,110947,110947,110949,0,2,2
31682,6,2,110953,110953,110955,0,2,4
31683,4,3,110957,110957,110960,0,3,2
31684,3,2,110960,110960,110962,0,2,0
31685,5,2,110965,110965,110967,0,2,3
31686,5,1,110970,110970,110971,0,1,3
31687,3,3,110973,110973,110976,0,3,2
31688,3,3,110976,110976,110979,0,3,0
31689,4,2,110980,110980,110982,0,2,1
31690,4,2,110984,110984,110986,0,2,2
31691,5,1,110989,110989,110990,0,1,3
31692,2,1,110991,110991,110992,0,1,1
31693,4,2,110995,110995,110997,0,2,3
31694,5,1,111000,111000,111001,0,1,3
31695,2,3,111002,111002,111005,0,3,1
31696,5,2,111007,111007,111009,0,2,2
31697,2,1,111009,111009,111010,0,1,0
31698,3,2,111012,111012,111014,0,2,2
31699,1,3,111013,111014,111017,1,4,0
31700,6,3,111019,111019,111022,0,3,2
31701,3,3,111022,111022,111025,0,3,0
31702,4,1,111026,111026,111027,0,1,1
31703,4,2,111030,111030,111032,0,2,3
31704,5,2,111035,111035,111037,0,2,3
31705,1,1,111036,111037,111038,1,2,0
31706,4,2,111040,111040,111042,0,2,2
31707,4,2,111044,111044,111046,0,2,2
31708,2,2,111046,111046,111048,0,2,0
31709,5,3,111051,111051,111054,0,3,3
31710,5,2,111056,111056,111058,0,2,2
31711,3,3,111059,111059,111062,0,3,1
31712,3,2,111062,111062,111064,0,2,0
31713,6,2,111068,111068,111070,0,2,4
31714,4,3,111072,111072,111075,0,3,2
31715,4,2,111076,111076,111078,0,2,1
31716,1,1,111077,111078,111079,1,2,0
31717,1,3,111078,111079,111082,1,4,0
31718,1,3,111079,111082,111085,3,6,0
31719,1,2,111080,111085,111087,5,7,0
31720,6,2,111086,111087,111089,1,3,0
31721,5,2,111091,111091,111093,0,2,2
31722,6,2,111097,111097,111099,0,2,4
31723,4,3,111101,111101,111104,0,3,2
31724,1,2,111102,111104,111106,2,4,0
31725,4,3,111106,111106,111109,0,3,0
31726,2,1,111108,111109,111110,1,2,0
31727,1,1,111109,111110,111111,1,2,0
31728,1,3,111110,111111,111114,1,4,0
31729,6,3,111116,111116,111119,0,3,2
31730,1,1,111117,111119,111120,2,3,0
31731,4,1,111121,111121,111122,0,1,1
31732,2,2,111123,111123,111125,0,2,1
31733,1,3,111124,111125,111128,1,4,0
31734,4,1,111128,111128,111129,0,1,0
31735,1,3,111129,111129,111132,0,3,0
31736,2,3,111131,111132,111135,1,4,0
31737,1,1,111132,111135,111136,3,4,0
31738,1,2,111133,111136,111138,3,5,0
31739,6,1,111139,111139,111140,0,1,1
31740,3,2,111142,111142,111144,0,2,2
31741,4,3,111146,111146,111149,0,3,2
31742,4,3,111150,111150,111153,0,3,1
31743,4,3,111154,111154,111157,0,3,1
31744,1,3,111155,111157,111160,2,5,0
31745,2,2,111157,111160,111162,3,5,0
31746,2,3,111159,111162,111165,3,6,0
31747,6,2,111165,111165,111167,0,2,0
31748,4,3,111169,111169,111172,0,3,2
31749,4,1,111173,111173,111174,0,1,1
31750,6,2,111179,111179,111181,0,2,5
31751,1,1,111180,111181,111182,1,2,0
31752,6,2,111186,111186,111188,0,2,4
31753,2,1,111188,111188,111189,0,1,0
31754,5,1,111193,111193,111194,0,1,4
31755,3,1,111196,111196,111197,0,1,2
31756,5,1,111201,111201,111202,0,1,4
31757,3,1,111204,111204,111205,0,1,2
31758,6,1,111210,111210,111211,0,1,5
31759,5,3,111215,111215,111218,0,3,4
31760,3,3,111218,111218,111221,0,3,0
31761,3,2,111221,111221,111223,0,2,0
31762,4,2,111225,111225,111227,0,2,2
31763,4,3,111229,111229,111232,0,3,2
31764,5,3,111234,111234,111237,0,3,2
31765,3,2,111237,111237,111239,0,2,0
31766,6,2,111243,111243,111245,0,2,4
31767,6,2,111249,111249,111251,0,2,4
31768,3,3,111252,111252,111255,0,3,1
31769,6,3,111258,111258,111261,0,3,3
31770,3,1,111261,111261,111262,0,1,0
31771,6,3,111267,111267,111270,0,3,5
31772,3,1,111270,111270,111271,0,1,0
31773,6,1,111276,111276,111277,0,1,5
31774,1,2,111277,111277,111279,0,2,0
31775,2,3,111279,111279,111282,0,3,0
31776,4,2,111283,111283,111285,0,2,1
31777,1,1,111284,111285,111286,1,2,0
31778,5,1,111289,111289,111290,0,1,3
31779,5,3,111294,111294,111297,0,3,4
31780,2,3,111296,111297,111300,1,4,0
31781,5,1,111301,111301,111302,0,1,1
31782,1,1,111302,111302,111303,0,1,0
31783,4,3,111306,111306,111309,0,3,3
31784,1,3,111307,111309,111312,2,5,0
31785,5,1,111312,111312,111313,0,1,0
31786,6,2,111318,111318,111320,0,2,5
31787,1,3,111319,111320,111323,1,4,0
31788,5,2,111324,111324,111326,0,2,1
31789,2,3,111326,111326,111329,0,3,0
31790,2,1,111328,111329,111330,1,2,0
31791,4,1,111332,111332,111333,0,1,2
31792,3,1,111335,111335,111336,0,1,2
31793,3,3,111338,111338,111341,0,3,2
31794,1,2,111339,111341,111343,2,4,0
31795,2,2,111341,111343,111345,2,4,0
31796,6,3,111347,111347,111350,0,3,2
31797,1,1,111348,111350,111351,2,3,0
31798,3,1,111351,111351,111352,0,1,0
31799,6,2,111357,111357,111359,0,2,5
31800,6,3,111363,111363,111366,0,3,4
31801,3,1,111366,111366,111367,0,1,0
31802,4,3,111370,111370,111373,0,3,3
31803,1,2,111371,111373,111375,2,4,0
31804,3,2,111374,111375,111377,1,3,0
31805,4,1,111378,111378,111379,0,1,1
31806,4,1,111382,111382,111383,0,1,3
31807,1,2,111383,111383,111385,0,2,0
31808,4,2,111387,111387,111389,0,2,2
31809,2,2,111389,111389,111391,0,2,0
31810,6,3,111395,111395,111398,0,3,4
31811,1,2,111396,111398,111400,2,4,0
31812,4,2,111400,111400,111402,0,2,0
31813,4,2,111404,111404,111406,0,2,2
31814,6,2,111410,111410,111412,0,2,4
31815,1,1,111411,111412,111413,1,2,0
31816,3,3,111414,111414,111417,0,3,1
31817,2,3,111416,111417,111420,1,4,0
31818,5,1,111421,111421,111422,0,1,1
31819,5,2,111426,111426,111428,0,2,4
31820,4,2,111430,111430,111432,0,2,2
31821,5,2,111435,111435,111437,0,2,3
31822,2,1,111437,111437,111438,0,1,0
31823,6,3,111443,111443,111446,0,3,5
31824,3,1,111446,111446,111447,0,1,0
31825,3,3,111449,111449,111452,0,3,2
31826,5,1,111454,111454,111455,0,1,2
31827,4,3,111458,111458,111461,0,3,3
31828,1,3,111459,111461,111464,2,5,0
31829,4,2,111463,111464,111466,1,3,0
31830,4,2,111467,111467,111469,0,2,1
31831,4,2,111471,111471,111473,0,2,2
31832,5,1,111476,111476,111477,0,1,3
31833,5,3,111481,111481,111484,0,3,4
31834,2,3,111483,111484,111487,1,4,0
31835,3,1,111486,111487,111488,1,2,0
31836,3,1,111489,111489,111490,0,1,1
31837,5,3,111494,111494,111497,0,3,4
31838,1,3,111495,111497,111500,2,5,0
31839,1,3,111496,111500,111503,4,7,0
31840,4,1,111500,111503,111504,3,4,0
31841,4,2,111504,111504,111506,0,2,0
31842,4,1,111508,111508,111509,0,1,2
31843,5,2,111513,111513,111515,0,2,4
31844,6,1,111519,111519,111520,0,1,4
31845,3,2,111522,111522,111524,0,2,2
31846,4,2,111526,111526,111528,0,2,2
31847,5,3,111531,111531,111534,0,3,3
31848,3,1,111534,111534,111535,0,1,0
31849,4,2,111538,111538,111540,0,2,3
31850,6,3,111544,111544,111547,0,3,4
31851,1,3,111545,111547,111550,2,5,0
31852,6,2,111551,111551,111553,0,2,1
31853,2,1,111553,111553,111554,0,1,0
31854,2,2,111555,111555,111557,0,2,1
31855,1,2,111556,111557,111559,1,3,0
31856,4,1,111560,111560,111561,0,1,1
31857,4,3,111564,111564,111567,0,3,3
31858,3,1,111567,111567,111568,0,1,0
31859,5,1,111572,111572,111573,0,1,4
31860,3,2,111575,111575,111577,0,2,2
31861,3,3,111578,111578,111581,0,3,1
31862,3,2,111581,111581,111583,0,2,0
31863,3,3,111584,111584,111587,0,3,1
31864,3,2,111587,111587,111589,0,2,0
31865,6,1,111593,111593,111594,0,1,4
31866,6,3,111599,111599,111602,0,3,5
31867,1,3,111600,111602,111605,2,5,0
31868,6,1,111606,111606,111607,0,1,1
31869,6,1,111612,111612,111613,0,1,5
31870,2,3,111614,111614,111617,0,3,1
31871,3,1,111617,111617,111618,0,1,0
31872,6,3,111623,111623,111626,0,3,5
31873,3,3,111626,111626,111629,0,3,0
31874,2,2,111628,111629,111631,1,3,0
31875,3,3,111631,111631,111634,0,3,0
31876,5,1,111636,111636,111637,0,1,2
31877,5,3,111641,111641,111644,0,3,4
31878,2,3,111643,111644,111647,1,4,0
31879,2,1,111645,111647,111648,2,3,0
31880,5,3,111650,111650,111653,0,3,2
31881,1,2,111651,111653,111655,2,4,0
31882,1,2,111652,111655,111657,3,5,0
31883,1,2,111653,111657,111659,4,6,0
31884,4,2,111657,111659,111661,2,4,0
31885,1,3,111658,111661,111664,3,6,0
31886,6,2,111664,111664,111666,0,2,0
31887,5,1,111669,111669,111670,0,1,3
31888,1,3,111670,111670,111673,0,3,0
31889,6,3,111676,111676,111679,0,3,3
31890,3,3,111679,111679,111682,0,3,0
31891,5,2,111684,111684,111686,0,2,2
31892,5,1,111689,111689,111690,0,1,3
31893,5,3,111694,111694,111697,0,3,4
31894,1,1,111695,111697,111698,2,3,0
31895,4,1,111699,111699,111700,0,1,1
31896,4,1,111703,111703,111704,0,1,3
31897,4,1,111707,111707,111708,0,1,3
31898,5,1,111712,111712,111713,0,1,4
31899,1,1,111713,111713,111714,0,1,0
31900,2,2,111715,111715,111717,0,2,1
31901,6,3,111721,111721,111724,0,3,4
31902,3,2,111724,111724,111726,0,2,0
31903,6,3,111730,111730,111733,0,3,4
31904,2,2,111732,111733,111735,1,3,0
31905,6,2,111738,111738,111740,0,2,3
31906,1,3,111739,111740,111743,1,4,0
31907,3,2,111742,111743,111745,1,3,0
31908,5,1,111747,111747,111748,0,1,2
31909,4,2,111751,111751,111753,0,2,3
31910,3,3,111754,111754,111757,0,3,1
31911,6,3,111760,111760,111763,0,3,3
31912,3,1,111763,111763,111764,0,1,0
31913,1,3,111764,111764,111767,0,3,0
31914,6,1,111770,111770,111771,0,1,3
31915,4,3,111774,111774,111777,0,3,3
31916,1,2,111775,111777,111779,2,4,0
31917,3,3,111778,111779,111782,1,4,0
31918,1,2,111779,111782,111784,3,5,0
31919,5,3,111784,111784,111787,0,3,0
31920,4,3,111788,111788,111791,0,3,1
31921,5,1,111793,111793,111794,0,1,2
31922,3,2,111796,111796,111798,0,2,2
31923,6,3,111802,111802,111805,0,3,4
31924,5,2,111807,111807,111809,0,2,2
31925,1,1,111808,111809,111810,1,2,0
31926,1,3,111809,111810,111813,1,4,0
31927,6,1,111815,111815,111816,0,1,2
31928,6,3,111821,111821,111824,0,3,5
31929,6,1,111827,111827,111828,0,1,3
31930,2,1,111829,111829,111830,0,1,1
31931,6,2,111835,111835,111837,0,2,5
31932,6,3,111841,111841,111844,0,3,4
31933,1,1,111842,111844,111845,2,3,0
31934,1,1,111843,111845,111846,2,3,0
31935,2,1,111845,111846,111847,1,2,0
31936,4,3,111849,111849,111852,0,3,2
31937,1,3,111850,111852,111855,2,5,0
31938,5,1,111855,111855,111856,0,1,0
31939,1,3,111856,111856,111859,0,3,0
31940,6,2,111862,111862,111864,0,2,3
31941,2,3,111864,111864,111867,0,3,0
31942,4,2,111868,111868,111870,0,2,1
31943,6,2,111874,111874,111876,0,2,4
31944,2,1,111876,111876,111877,0,1,0
31945,4,3,111880,111880,111883,0,3,3
31946,5,3,111885,111885,111888,0,3,2
31947,6,2,111891,111891,111893,0,2,3
31948,4,2,111895,111895,111897,0,2,2
31949,3,3,111898,111898,111901,0,3,1
31950,1,2,111899,111901,111903,2,4,0
31951,1,2,111900,111903,111905,3,5,0
31952,4,3,111904,111905,111908,1,4,0
31953,5,3,111909,111909,111912,0,3,1
31954,5,2,111914,111914,111916,0,2,2
31955,1,1,111915,111916,111917,1,2,0
31956,2,1,111917,111917,111918,0,1,0
31957,3,2,111920,111920,111922,0,2,2
31958,5,3,111925,111925,111928,0,3,3
31959,4,1,111929,111929,111930,0,1,1
31960,5,1,111934,111934,111935,0,1,4
31961,4,1,111938,111938,111939,0,1,3
31962,6,1,111944,111944,111945,0,1,5
31963,1,1,111945,111945,111946,0,1,0
31964,4,3,111949,111949,111952,0,3,3
31965,3,2,111952,111952,111954,0,2,0
31966,4,2,111956,111956,111958,0,2,2
31967,6,1,111962,111962,111963,0,1,4
31968,4,2,111966,111966,111968,0,2,3
31969,2,1,111968,111968,111969,0,1,0
31970,6,3,111974,111974,111977,0,3,5
31971,6,1,111980,111980,111981,0,1,3
31972,1,2,111981,111981,111983,0,2,0
31973,4,2,111985,111985,111987,0,2,2
31974,2,3,111987,111987,111990,0,3,0
31975,1,2,111988,111990,111992,2,4,0
31976,5,1,111993,111993,111994,0,1,1
31977,2,3,111995,111995,111998,0,3,1
31978,4,3,111999,111999,112002,0,3,1
31979,1,2,112000,112002,112004,2,4,0
31980,6,2,112006,112006,112008,0,2,2
31981,5,3,112011,112011,112014,0,3,3
31982,3,3,112014,112014,112017,0,3,0
31983,4,1,112018,112018,112019,0,1,1
31984,1,2,112019,112019,112021,0,2,0
31985,2,2,112021,112021,112023,0,2,0
31986,4,1,112025,112025,112026,0,1,2
31987,6,1,112031,112031,112032,0,1,5
31988,2,1,112033,112033,112034,0,1,1
31989,1,3,112034,112034,112037,0,3,0
31990,5,3,112039,112039,112042,0,3,2
31991,2,3,112041,112042,112045,1,4,0
31992,1,1,112042,112045,112046,3,4,0
31993,4,2,112046,112046,112048,0,2,0
31994,4,3,112050,112050,112053,0,3,2
31995,4,3,112054,112054,112057,0,3,1
31996,2,1,112056,112057,112058,1,2,0
31997,5,3,112061,112061,112064,0,3,3
31998,6,2,112067,112067,112069,0,2,3
31999,2,3,112069,112069,112072,0,3,0
32000,2,2,112071,112072,112074,1,3,0
32001,6,2,112077,112077,112079,0,2,3
32002,6,1,112083,112083,112084,0,1,4
32003,6,3,112089,112089,112092,0,3,5
32004,5,2,112094,112094,112096,0,2,2
32005,3,2,112097,112097,112099,0,2,1
32006,3,2,112100,112100,112102,0,2,1
32007,3,3,112103,112103,112106,0,3,1
32008,4,1,112107,112107,112108,0,1,1
32009,3,3,112110,112110,112113,0,3,2
32010,3,2,112113,112113,112115,0,2,0
32011,2,3,112115,112115,112118,0,3,0
32012,2,3,112117,112118,112121,1,4,0
32013,1,2,112118,112121,112123,3,5,0
32014,6,1,112124,112124,112125,0,1,1
32015,6,1,112130,112130,112131,0,1,5
32016,6,2,112136,112136,112138,0,2,5
32017,5,1,112141,112141,112142,0,1,3
32018,4,1,112145,112145,112146,0,1,3
32019,3,2,112148,112148,112150,0,2,2
32020,5,1,112153,112153,112154,0,1,3
32021,3,2,112156,112156,112158,0,2,2
32022,4,1,112160,112160,112161,0,1,2
32023,3,2,112163,112163,112165,0,2,2
32024,6,2,112169,112169,112171,0,2,4
32025,4,2,112173,112173,112175,0,2,2
32026,6,2,112179,112179,112181,0,2,4
32027,4,2,112183,112183,112185,0,2,2
32028,6,2,112189,112189,112191,0,2,4
32029,3,1,112192,112192,112193,0,1,1
32030,5,2,112197,112197,112199,0,2,4
32031,1,3,112198,112199,112202,1,4,0
32032,3,2,112201,112202,112204,1,3,0
32033,2,3,112203,112204,112207,1,4,0
32034,2,1,112205,112207,112208,2,3,0
32035,5,2,112210,112210,112212,0,2,2
32036,2,3,112212,112212,112215,0,3,0
32037,5,1,112217,112217,112218,0,1,2
32038,1,2,112218,112218,112220,0,2,0
32039,1,1,112219,112220,112221,1,2,0
32040,3,2,112222,112222,112224,0,2,1
32041,5,3,112227,112227,112230,0,3,3
32042,1,1,112228,112230,112231,2,3,0
32043,4,1,112232,112232,112233,0,1,1
32044,3,2,112235,112235,112237,0,2,2
32045,3,2,112238,112238,112240,0,2,1
32046,5,3,112243,112243,112246,0,3,3
32047,6,3,112249,112249,112252,0,3,3
32048,6,2,112255,112255,112257,0,2,3
32049,5,2,112260,112260,112262,0,2,3
32050,3,3,112263,112263,112266,0,3,1
32051,1,1,112264,112266,112267,2,3,0
32052,2,2,112266,112267,112269,1,3,0
32053,1,1,112267,112269,112270,2,3,0
32054,3,2,112270,112270,112272,0,2,0
32055,2,3,112272,112272,112275,0,3,0
32056,4,1,112276,112276,112277,0,1,1
32057,2,2,112278,112278,112280,0,2,1
32058,2,1,112280,112280,112281,0,1,0
32059,2,1,112282,112282,112283,0,1,1
32060,6,3,112288,112288,112291,0,3,5
32061,2,2,112290,112291,112293,1,3,0
32062,3,3,112293,112293,112296,0,3,0
32063,2,2,112295,112296,112298,1,3,0
32064,5,1,112300,112300,112301,0,1,2
32065,2,3,112302,112302,112305,0,3,1
32066,2,1,112304,112305,112306,1,2,0
32067,2,3,112306,112306,112309,0,3,0
32068,4,1,112310,112310,112311,0,1,1
32069,3,1,112313,112313,112314,0,1,2
32070,4,1,112317,112317,112318,0,1,3
32071,6,3,112323,112323,112326,0,3,5
32072,3,3,112326,112326,112329,0,3,0
32073,6,3,112332,112332,112335,0,3,3
32074,2,3,112334,112335,112338,1,4,0
32075,3,1,112337,112338,112339,1,2,0
32076,1,3,112338,112339,112342,1,4,0
32077,2,2,112340,112342,112344,2,4,0
32078,2,1,112342,112344,112345,2,3,0
32079,1,2,112343,112345,112347,2,4,0
32080,3,3,112346,112347,112350,1,4,0
32081,2,3,112348,112350,112353,2,5,0
32082,4,1,112352,112353,112354,1,2,0
32083,3,2,112355,112355,112357,0,2,1
32084,3,3,112358,112358,112361,0,3,1
32085,3,3,112361,112361,112364,0,3,0
32086,2,2,112363,112364,112366,1,3,0
32087,3,1,112366,112366,112367,0,1,0
32088,1,3,112367,112367,112370,0,3,0
32089,4,2,112371,112371,112373,0,2,1
32090,2,3,112373,112373,112376,0,3,0
32091,1,2,112374,112376,112378,2,4,0
32092,1,3,112375,112378,112381,3,6,0
32093,5,1,112380,112381,112382,1,2,0
32094,2,2,112382,112382,112384,0,2,0
32095,2,1,112384,112384,112385,0,1,0
32096,2,2,112386,112386,112388,0,2,1
32097,5,2,112391,112391,112393,0,2,3
32098,6,1,112397,112397,112398,0,1,4
32099,6,3,112403,112403,112406,0,3,5
32100,5,3,112408,112408,112411,0,3,2
32101,4,3,112412,112412,112415,0,3,1
32102,3,2,112415,112415,112417,0,2,0
32103,1,3,112416,112417,112420,1,4,0
32104,2,2,112418,112420,112422,2,4,0
32105,4,3,112422,112422,112425,0,3,0
32106,6,2,112428,112428,112430,0,2,3
32107,4,3,112432,112432,112435,0,3,2
32108,5,3,112437,112437,112440,0,3,2
32109,4,1,112441,112441,112442,0,1,1
32110,4,2,112445,112445,112447,0,2,3
32111,2,2,112447,112447,112449,0,2,0
32112,4,2,112451,112451,112453,0,2,2
32113,4,2,112455,112455,112457,0,2,2
32114,3,1,112458,112458,112459,0,1,1
32115,3,2,112461,112461,112463,0,2,2
32116,4,1,112465,112465,112466,0,1,2
32117,5,3,112470,112470,112473,0,3,4
32118,6,2,112476,112476,112478,0,2,3
32119,3,3,112479,112479,112482,0,3,1
32120,2,1,112481,112482,112483,1,2,0
32121,6,1,112487,112487,112488,0,1,4
32122,3,2,112490,112490,112492,0,2,2
32123,3,1,112493,112493,112494,0,1,1
32124,4,1,112497,112497,112498,0,1,3
32125,4,3,112501,112501,112504,0,3,3
32126,2,3,112503,112504,112507,1,4,0
32127,6,2,112509,112509,112511,0,2,2
32128,2,3,112511,112511,112514,0,3,0
32129,5,3,112516,112516,112519,0,3,2
32130,5,2,112521,112521,112523,0,2,2
32131,1,3,112522,112523,112526,1,4,0
32132,4,3,112526,112526,112529,0,3,0
32133,5,3,112531,112531,112534,0,3,2
32134,4,1,112535,112535,112536,0,1,1
32135,2,2,112537,112537,112539,0,2,1
32136,5,1,112542,112542,112543,0,1,3
32137,4,2,112546,112546,112548,0,2,3
32138,3,3,112549,112549,112552,0,3,1
32139,2,3,112551,112552,112555,1,4,0
32140,2,1,112553,112555,112556,2,3,0
32141,1,2,112554,112556,112558,2,4,0
32142,5,1,112559,112559,112560,0,1,1
32143,5,1,112564,112564,112565,0,1,4
32144,1,1,112565,112565,112566,0,1,0
32145,3,2,112568,112568,112570,0,2,2
32146,2,1,112570,112570,112571,0,1,0
32147,1,2,112571,112571,112573,0,2,0
32148,4,2,112575,112575,112577,0,2,2
32149,5,1,112580,112580,112581,0,1,3
32150,6,2,112586,112586,112588,0,2,5
32151,1,3,112587,112588,112591,1,4,0
32152,1,1,112588,112591,112592,3,4,0
32153,1,1,112589,112592,112593,3,4,0
32154,3,2,112592,112593,112595,1,3,0
32155,3,2,112595,112595,112597,0,2,0
32156,3,2,112598,112598,112600,0,2,1
32157,5,1,112603,112603,112604,0,1,3
32158,6,1,112609,112609,112610,0,1,5
32159,2,2,112611,112611,112613,0,2,1
32160,1,3,112612,112613,112616,1,4,0
32161,5,2,112617,112617,112619,0,2,1
32162,3,1,112620,112620,112621,0,1,1
32163,6,2,112626,112626,112628,0,2,5
32164,4,1,112630,112630,112631,0,1,2
32165,2,3,112632,112632,112635,0,3,1
32166,2,1,112634,112635,112636,1,2,0
32167,6,1,112640,112640,112641,0,1,4
32168,2,1,112642,112642,112643,0,1,1
32169,3,2,112645,112645,112647,0,2,2
32170,1,1,112646,112647,112648,1,2,0
32171,4,3,112650,112650,112653,0,3,2
32172,5,2,112655,112655,112657,0,2,2
32173,3,1,112658,112658,112659,0,1,1
32174,1,2,112659,112659,112661,0,2,0
32175,6,3,112665,112665,112668,0,3,4
32176,5,2,112670,112670,112672,0,2,2
32177,5,3,112675,112675,112678,0,3,3
32178,3,2,112678,112678,112680,0,2,0
32179,1,3,112679,112680,112683,1,4,0
32180,1,3,112680,112683,112686,3,6,0
32181,6,2,112686,112686,112688,0,2,0
32182,4,3,112690,112690,112693,0,3,2
32183,4,1,112694,112694,112695,0,1,1
32184,1,2,112695,112695,112697,0,2,0
32185,6,2,112701,112701,112703,0,2,4
32186,1,1,112702,112703,112704,1,2,0
32187,3,3,112705,112705,112708,0,3,1
32188,5,3,112710,112710,112713,0,3,2
32189,6,1,112716,112716,112717,0,1,3
32190,5,1,112721,112721,112722,0,1,4
32191,1,1,112722,112722,112723,0,1,0
32192,2,1,112724,112724,112725,0,1,1
32193,1,2,112725,112725,112727,0,2,0
32194,3,3,112728,112728,112731,0,3,1
32195,2,2,112730,112731,112733,1,3,0
32196,6,1,112736,112736,112737,0,1,3
32197,3,3,112739,112739,112742,0,3,2
32198,2,3,112741,112742,112745,1,4,0
32199,6,2,112747,112747,112749,0,2,2
32200,2,3,112749,112749,112752,0,3,0
32201,2,3,112751,112752,112755,1,4,0
32202,3,2,112754,112755,112757,1,3,0
32203,4,2,112758,112758,112760,0,2,1
32204,2,1,112760,112760,112761,0,1,0
32205,1,3,112761,112761,112764,0,3,0
32206,3,2,112764,112764,112766,0,2,0
32207,3,2,112767,112767,112769,0,2,1
32208,1,1,112768,112769,112770,1,2,0
32209,5,1,112773,112773,112774,0,1,3
32210,1,3,112774,112774,112777,0,3,0
32211,5,3,112779,112779,112782,0,3,2
32212,5,3,112784,112784,112787,0,3,2
32213,3,3,112787,112787,112790,0,3,0
32214,6,1,112793,112793,112794,0,1,3
32215,2,1,112795,112795,112796,0,1,1
32216,1,1,112796,112796,112797,0,1,0
32217,6,3,112802,112802,112805,0,3,5
32218,6,3,112808,112808,112811,0,3,3
32219,6,3,112814,112814,112817,0,3,3
32220,5,3,112819,112819,112822,0,3,2
32221,1,1,112820,112822,112823,2,3,0
32222,3,1,112823,112823,112824,0,1,0
32223,5,3,112828,112828,112831,0,3,4
32224,6,1,112834,112834,112835,0,1,3
32225,5,1,112839,112839,112840,0,1,4
32226,4,1,112843,112843,112844,0,1,3
32227,4,3,112847,112847,112850,0,3,3
32228,1,3,112848,112850,112853,2,5,0
32229,2,1,112850,112853,112854,3,4,0
32230,2,3,112852,112854,112857,2,5,0
32231,2,3,112854,112857,112860,3,6,0
32232,3,3,112857,112860,112863,3,6,0
32233,3,1,112860,112863,112864,3,4,0
32234,6,2,112866,112866,112868,0,2,2
32235,6,1,112872,112872,112873,0,1,4
32236,3,2,112875,112875,112877,0,2,2
32237,6,1,112881,112881,112882,0,1,4
32238,4,1,112885,112885,112886,0,1,3
32239,1,1,112886,112886,112887,0,1,0
32240,3,3,112889,112889,112892,0,3,2
32241,4,1,112893,112893,112894,0,1,1
32242,1,1,112894,112894,112895,0,1,0
32243,1,1,112895,112895,112896,0,1,0
32244,5,2,112900,112900,112902,0,2,4
32245,3,1,112903,112903,112904,0,1,1
32246,1,2,112904,112904,112906,0,2,0
32247,5,1,112909,112909,112910,0,1,3
32248,2,1,112911,112911,112912,0,1,1
32249,3,2,112914,112914,112916,0,2,2
32250,4,2,112918,112918,112920,0,2,2
32251,2,2,112920,112920,112922,0,2,0
32252,3,1,112923,112923,112924,0,1,1
32253,4,2,112927,112927,112929,0,2,3
32254,5,1,112932,112932,112933,0,1,3
32255,6,3,112938,112938,112941,0,3,5
32256,5,3,112943,112943,112946,0,3,2
32257,2,2,112945,112946,112948,1,3,0
32258,1,3,112946,112948,112951,2,5,0
32259,4,1,112950,112951,112952,1,2,0
32260,5,2,112955,112955,112957,0,2,3
32261,1,2,112956,112957,112959,1,3,0
32262,1,1,112957,112959,112960,2,3,0
32263,1,1,112958,112960,112961,2,3,0
32264,4,3,112962,112962,112965,0,3,1
32265,5,3,112967,112967,112970,0,3,2
32266,2,2,112969,112970,112972,1,3,0
32267,2,1,112971,112972,112973,1,2,0
32268,5,1,112976,112976,112977,0,1,3
32269,4,2,112980,112980,112982,0,2,3
32270,1,2,112981,112982,112984,1,3,0
32271,2,2,112983,112984,112986,1,3,0
32272,4,2,112987,112987,112989,0,2,1
32273,6,1,112993,112993,112994,0,1,4
32274,4,1,112997,112997,112998,0,1,3
32275,5,3,113002,113002,113005,0,3,4
32276,4,2,113006,113006,113008,0,2,1
32277,1,2,113007,113008,113010,1,3,0
32278,5,3,113012,113012,113015,0,3,2
32279,6,1,113018,113018,113019,0,1,3
32280,2,2,113020,113020,113022,0,2,1
32281,6,3,113026,113026,113029,0,3,4
32282,6,2,113032,113032,113034,0,2,3
32283,6,1,113038,113038,113039,0,1,4
32284,3,1,113041,113041,113042,0,1,2
32285,2,1,113043,113043,113044,0,1,1
32286,5,2,113048,113048,113050,0,2,4
32287,1,2,113049,113050,113052,1,3,0
32288,4,2,113053,113053,113055,0,2,1
32289,6,3,113059,113059,113062,0,3,4
32290,5,1,113064,113064,113065,0,1,2
32291,4,3,113068,113068,113071,0,3,3
32292,6,2,113074,113074,113076,0,2,3
32293,4,2,113078,113078,113080,0,2,2
32294,6,1,113084,113084,113085,0,1,4
32295,3,1,113087,113087,113088,0,1,2
32296,5,1,113092,113092,113093,0,1,4
32297,2,3,113094,113094,113097,0,3,1
32298,3,1,113097,113097,113098,0,1,0
32299,2,1,113099,113099,113100,0,1,1
32300,1,1,113100,113100,113101,0,1,0
32301,2,1,113102,113102,113103,0,1,1
32302,6,2,113108,113108,113110,0,2,5
32303,5,3,113113,113113,113116,0,3,3
32304,1,2,113114,113116,113118,2,4,0
32305,6,1,113120,113120,113121,0,1,2
32306,1,2,113121,113121,113123,0,2,0
32307,2,2,113123,113123,113125,0,2,0
32308,3,1,113126,113126,113127,0,1,1
32309,5,3,113131,113131,113134,0,3,4
32310,6,2,113137,113137,113139,0,2,3
32311,1,3,113138,113139,113142,1,4,0
32312,6,3,113144,113144,113147,0,3,2
32313,6,3,113150,113150,113153,0,3,3
32314,1,2,113151,113153,113155,2,4,0
32315,6,3,113157,113157,113160,0,3,2
32316,1,1,113158,113160,113161,2,3,0
32317,1,2,113159,113161,113163,2,4,0
32318,3,2,113162,113163,113165,1,3,0
32319,6,3,113168,113168,113171,0,3,3
32320,5,3,113173,113173,113176,0,3,2
32321,6,2,113179,113179,113181,0,2,3
32322,1,1,113180,113181,113182,1,2,0
32323,6,2,113186,113186,113188,0,2,4
32324,1,3,113187,113188,113191,1,4,0
32325,3,1,113190,113191,113192,1,2,0
32326,3,1,113193,113193,113194,0,1,1
32327,4,1,113197,113197,113198,0,1,3
32328,5,2,113202,113202,113204,0,2,4
32329,4,3,113206,113206,113209,0,3,2
32330,5,2,113211,113211,113213,0,2,2
32331,4,2,113215,113215,113217,0,2,2
32332,6,1,113221,113221,113222,0,1,4
32333,4,3,113225,113225,113228,0,3,3
32334,4,1,113229,113229,113230,0,1,1
32335,4,1,113233,113233,113234,0,1,3
32336,6,1,113239,113239,113240,0,1,5
32337,1,1,113240,113240,113241,0,1,0
32338,3,1,113243,113243,113244,0,1,2
32339,2,2,113245,113245,113247,0,2,1
32340,3,3,113248,113248,113251,0,3,1
32341,4,1,113252,113252,113253,0,1,1
32342,4,1,113256,113256,113257,0,1,3
32343,4,1,113260,113260,113261,0,1,3
32344,2,1,113262,113262,113263,0,1,1
32345,1,2,113263,113263,113265,0,2,0
32346,2,1,113265,113265,113266,0,1,0
32347,5,3,113270,113270,113273,0,3,4
32348,2,1,113272,113273,113274,1,2,0
32349,6,2,113278,113278,113280,0,2,4
32350,4,2,113282,113282,113284,0,2,2
32351,6,3,113288,113288,113291,0,3,4
32352,5,2,113293,113293,113295,0,2,2
32353,4,2,113297,113297,113299,0,2,2
32354,3,3,113300,113300,113303,0,3,1
32355,6,2,113306,113306,113308,0,2,3
32356,1,3,113307,113308,113311,1,4,0
32357,1,1,113308,113311,113312,3,4,0
32358,6,2,113314,113314,113316,0,2,2
32359,3,3,113317,113317,113320,0,3,1
32360,3,1,113320,113320,113321,0,1,0
32361,4,3,113324,113324,113327,0,3,3
32362,6,3,113330,113330,113333,0,3,3
32363,3,3,113333,113333,113336,0,3,0
32364,6,1,113339,113339,113340,0,1,3
32365,1,1,113340,113340,113341,0,1,0
32366,4,1,113344,113344,113345,0,1,3
32367,4,2,113348,113348,113350,0,2,3
32368,1,1,113349,113350,113351,1,2,0
32369,1,2,113350,113351,113353,1,3,0
32370,5,2,113355,113355,113357,0,2,2
32371,1,3,113356,113357,113360,1,4,0
32372,2,1,113358,113360,113361,2,3,0
32373,4,1,113362,113362,113363,0,1,1
32374,3,3,113365,113365,113368,0,3,2
32375,5,1,113370,113370,113371,0,1,2
32376,4,2,113374,113374,113376,0,2,3
32377,5,3,113379,113379,113382,0,3,3
32378,6,3,113385,113385,113388,0,3,3
32379,4,1,113389,113389,113390,0,1,1
32380,5,2,113394,113394,113396,0,2,4
32381,3,3,113397,113397,113400,0,3,1
32382,6,2,113403,113403,113405,0,2,3
32383,1,1,113404,113405,113406,1,2,0
32384,4,3,113408,113408,113411,0,3,2
32385,5,2,113413,113413,113415,0,2,2
32386,2,1,113415,113415,113416,0,1,0
32387,3,2,113418,113418,113420,0,2,2
32388,5,1,113423,113423,113424,0,1,3
32389,4,1,113427,113427,113428,0,1,3
32390,6,2,113433,113433,113435,0,2,5
32391,5,2,113438,113438,113440,0,2,3
32392,3,2,113441,113441,113443,0,2,1
32393,1,1,113442,113443,113444,1,2,0
32394,3,1,113445,113445,113446,0,1,1
32395,1,3,113446,113446,113449,0,3,0
32396,1,3,113447,113449,113452,2,5,0
32397,4,3,113451,113452,113455,1,4,0
32398,4,3,113455,113455,113458,0,3,0
32399,3,3,113458,113458,113461,0,3,0
32400,1,1,113459,113461,113462,2,3,0
32401,2,2,113461,113462,113464,1,3,0
32402,6,3,113467,113467,113470,0,3,3
32403,1,3,113468,113470,113473,2,5,0
32404,4,3,113472,113473,113476,1,4,0
32405,2,1,113474,113476,113477,2,3,0
32406,3,1,113477,113477,113478,0,1,0
32407,6,3,113483,113483,113486,0,3,5
32408,4,1,113487,113487,113488,0,1,1
32409,2,2,113489,113489,113491,0,2,1
32410,5,1,113494,113494,113495,0,1,3
32411,1,1,113495,113495,113496,0,1,0
32412,6,2,113501,113501,113503,0,2,5
32413,1,2,113502,113503,113505,1,3,0
32414,2,1,113504,113505,113506,1,2,0
32415,1,1,113505,113506,113507,1,2,0
32416,2,1,113507,113507,113508,0,1,0
32417,6,2,113513,113513,113515,0,2,5
32418,3,2,113516,113516,113518,0,2,1
32419,5,3,113521,113521,113524,0,3,3
32420,1,1,113522,113524,113525,2,3,0
32421,2,2,113524,113525,113527,1,3,0
32422,5,2,113529,113529,113531,0,2,2
32423,2,1,113531,113531,113532,0,1,0
32424,5,3,113536,113536,113539,0,3,4
32425,3,2,113539,113539,113541,0,2,0
32426,6,1,113545,113545,113546,0,1,4
32427,1,2,113546,113546,113548,0,2,0
32428,1,3,113547,113548,113551,1,4,0
32429,4,3,113551,113551,113554,0,3,0
32430,4,1,113555,113555,113556,0,1,1
32431,5,2,113560,113560,113562,0,2,4
32432,1,2,113561,113562,113564,1,3,0
32433,5,1,113566,113566,113567,0,1,2
32434,2,1,113568,113568,113569,0,1,1
32435,6,3,113574,113574,113577,0,3,5
32436,3,2,113577,113577,113579,0,2,0
32437,1,3,113578,113579,113582,1,4,0
32438,4,1,113582,113582,113583,0,1,0
32439,2,3,113584,113584,113587,0,3,1
32440,5,3,113589,113589,113592,0,3,2
32441,6,3,113595,113595,113598,0,3,3
32442,5,1,113600,113600,113601,0,1,2
32443,1,1,113601,113601,113602,0,1,0
32444,4,2,113605,113605,113607,0,2,3
32445,3,3,113608,113608,113611,0,3,1
32446,5,1,113613,113613,113614,0,1,2
32447,1,2,113614,113614,113616,0,2,0
32448,6,3,113620,113620,113623,0,3,4
32449,1,3,113621,113623,113626,2,5,0
32450,3,1,113624,113626,113627,2,3,0
32451,3,1,113627,113627,113628,0,1,0
32452,6,3,113633,113633,113636,0,3,5
32453,3,3,113636,113636,113639,0,3,0
32454,5,3,113641,113641,113644,0,3,2
32455,3,1,113644,113644,113645,0,1,0
32456,3,3,113647,113647,113650,0,3,2
32457,2,1,113649,113650,113651,1,2,0
32458,3,2,113652,113652,113654,0,2,1
32459,2,1,113654,113654,113655,0,1,0
32460,5,3,113659,113659,113662,0,3,4
32461,4,2,113663,113663,113665,0,2,1
32462,2,3,113665,113665,113668,0,3,0
32463,6,3,113671,113671,113674,0,3,3
32464,5,2,113676,113676,113678,0,2,2
32465,6,3,113682,113682,113685,0,3,4
32466,1,1,113683,113685,113686,2,3,0
32467,6,1,113689,113689,113690,0,1,3
32468,1,2,113690,113690,113692,0,2,0
32469,4,3,113694,113694,113697,0,3,2
32470,5,1,113699,113699,113700,0,1,2
32471,4,2,113703,113703,113705,0,2,3
32472,2,2,113705,113705,113707,0,2,0
32473,4,1,113709,113709,113710,0,1,2
32474,2,1,113711,113711,113712,0,1,1
32475,4,3,113715,113715,113718,0,3,3
32476,5,3,113720,113720,113723,0,3,2
32477,5,1,113725,113725,113726,0,1,2
32478,1,3,113726,113726,113729,0,3,0
32479,6,3,113732,113732,113735,0,3,3
32480,2,2,113734,113735,113737,1,3,0
32481,1,1,113735,113737,113738,2,3,0
32482,5,2,113740,113740,113742,0,2,2
32483,2,3,113742,113742,113745,0,3,0
32484,1,3,113743,113745,113748,2,5,0
32485,3,1,113746,113748,113749,2,3,0
32486,1,1,113747,113749,113750,2,3,0
32487,1,3,113748,113750,113753,2,5,0
32488,5,2,113753,113753,113755,0,2,0
32489,2,3,113755,113755,113758,0,3,0
32490,2,3,113757,113758,113761,1,4,0
32491,6,3,113763,113763,113766,0,3,2
32492,6,1,113769,113769,113770,0,1,3
32493,4,3,113773,113773,113776,0,3,3
32494,6,2,113779,113779,113781,0,2,3
32495,4,2,113783,113783,113785,0,2,2
32496,5,2,113788,113788,113790,0,2,3
32497,2,1,113790,113790,113791,0,1,0
32498,4,3,113794,113794,113797,0,3,3
32499,5,3,113799,113799,113802,0,3,2
32500,6,3,113805,113805,113808,0,3,3
32501,6,3,113811,113811,113814,0,3,3
32502,4,3,113815,113815,113818,0,3,1
32503,6,2,113821,113821,113823,0,2,3
32504,2,3,113823,113823,113826,0,3,0
32505,6,1,113829,113829,113830,0,1,3
32506,3,1,113832,113832,113833,0,1,2
32507,1,1,113833,113833,113834,0,1,0
32508,3,3,113836,113836,113839,0,3,2
32509,3,1,113839,113839,113840,0,1,0
32510,3,1,113842,113842,113843,0,1,2
32511,5,2,113847,113847,113849,0,2,4
32512,1,1,113848,113849,113850,1,2,0
32513,2,2,113850,113850,113852,0,2,0
32514,4,3,113854,113854,113857,0,3,2
32515,4,2,113858,113858,113860,0,2,1
32516,2,2,113860,113860,113862,0,2,0
32517,6,2,113866,113866,113868,0,2,4
32518,5,3,113871,113871,113874,0,3,3
32519,5,2,113876,113876,113878,0,2,2
32520,4,1,113880,113880,113881,0,1,2
32521,2,2,113882,113882,113884,0,2,1
32522,2,1,113884,113884,113885,0,1,0
32523,6,1,113890,113890,113891,0,1,5
32524,6,1,113896,113896,113897,0,1,5
32525,4,2,113900,113900,113902,0,2,3
32526,5,2,113905,113905,113907,0,2,3
32527,5,3,113910,113910,113913,0,3,3
32528,1,2,113911,113913,113915,2,4,0
32529,6,3,113917,113917,113920,0,3,2
32530,2,2,113919,113920,113922,1,3,0
32531,4,2,113923,113923,113925,0,2,1
32532,6,3,113929,113929,113932,0,3,4
32533,6,2,113935,113935,113937,0,2,3
32534,5,2,113940,113940,113942,0,2,3
32535,6,2,113946,113946,113948,0,2,4
32536,2,2,113948,113948,113950,0,2,0
32537,3,3,113951,113951,113954,0,3,1
32538,1,2,113952,113954,113956,2,4,0
32539,4,2,113956,113956,113958,0,2,0
32540,2,3,113958,113958,113961,0,3,0
32541,4,1,113962,113962,113963,0,1,1
32542,2,3,113964,113964,113967,0,3,1
32543,1,3,113965,113967,113970,2,5,0
32544,1,1,113966,113970,113971,4,5,0
32545,3,3,113969,113971,113974,2,5,0
32546,5,3,113974,113974,113977,0,3,0
32547,4,1,113978,113978,113979,0,1,1
32548,4,2,113982,113982,113984,0,2,3
32549,6,3,113988,113988,113991,0,3,4
32550,4,2,113992,113992,113994,0,2,1
32551,3,1,113995,113995,113996,0,1,1
32552,1,3,113996,113996,113999,0,3,0
32553,6,2,114002,114002,114004,0,2,3
32554,6,3,114008,114008,114011,0,3,4
32555,3,1,114011,114011,114012,0,1,0
32556,5,3,114016,114016,114019,0,3,4
32557,6,2,114022,114022,114024,0,2,3
32558,1,1,114023,114024,114025,1,2,0
32559,6,1,114029,114029,114030,0,1,4
32560,5,3,114034,114034,114037,0,3,4
32561,3,1,114037,114037,114038,0,1,0
32562,2,2,114039,114039,114041,0,2,1
32563,6,2,114045,114045,114047,0,2,4
32564,4,1,114049,114049,114050,0,1,2
32565,1,3,114050,114050,114053,0,3,0
32566,1,2,114051,114053,114055,2,4,0
32567,4,3,114055,114055,114058,0,3,0
32568,4,1,114059,114059,114060,0,1,1
32569,6,3,114065,114065,114068,0,3,5
32570,3,2,114068,114068,114070,0,2,0
32571,3,3,114071,114071,114074,0,3,1
32572,5,3,114076,114076,114079,0,3,2
32573,6,2,114082,114082,114084,0,2,3
32574,3,2,114085,114085,114087,0,2,1
32575,3,3,114088,114088,114091,0,3,1
32576,5,1,114093,114093,114094,0,1,2
32577,2,1,114095,114095,114096,0,1,1
32578,2,3,114097,114097,114100,0,3,1
32579,2,3,114099,114100,114103,1,4,0
32580,3,2,114102,114103,114105,1,3,0
32581,2,1,114104,114105,114106,1,2,0
32582,4,2,114108,114108,114110,0,2,2
32583,6,3,114114,114114,114117,0,3,4
32584,4,3,114118,114118,114121,0,3,1
32585,4,1,114122,114122,114123,0,1,1
32586,2,3,114124,114124,114127,0,3,1
32587,5,2,114129,114129,114131,0,2,2
32588,1,2,114130,114131,114133,1,3,0
32589,2,2,114132,114133,114135,1,3,0
32590,4,1,114136,114136,114137,0,1,1
32591,3,3,114139,114139,114142,0,3,2
32592,3,2,114142,114142,114144,0,2,0
32593,5,1,114147,114147,114148,0,1,3
32594,2,2,114149,114149,114151,0,2,1
32595,3,3,114152,114152,114155,0,3,1
32596,2,3,114154,114155,114158,1,4,0
32597,1,1,114155,114158,114159,3,4,0
32598,3,3,114158,114159,114162,1,4,0
32599,1,3,114159,114162,114165,3,6,0
32600,3,3,114162,114165,114168,3,6,0
32601,2,3,114164,114168,114171,4,7,0
32602,1,2,114165,114171,114173,6,8,0
32603,6,3,114171,114173,114176,2,5,0
32604,5,1,114176,114176,114177,0,1,0
32605,1,3,114177,114177,114180,0,3,0
32606,5,2,114182,114182,114184,0,2,2
32607,2,3,114184,114184,114187,0,3,0
32608,5,1,114189,114189,114190,0,1,2
32609,4,1,114193,114193,114194,0,1,3
32610,6,1,114199,114199,114200,0,1,5
32611,2,1,114201,114201,114202,0,1,1
32612,3,3,114204,114204,114207,0,3,2
32613,3,3,114207,114207,114210,0,3,0
32614,5,3,114212,114212,114215,0,3,2
32615,1,1,114213,114215,114216,2,3,0
32616,5,3,114218,114218,114221,0,3,2
32617,6,2,114224,114224,114226,0,2,3
32618,2,1,114226,114226,114227,0,1,0
32619,3,1,114229,114229,114230,0,1,2
32620,2,1,114231,114231,114232,0,1,1
32621,5,2,114236,114236,114238,0,2,4
32622,3,1,114239,114239,114240,0,1,1
32623,1,1,114240,114240,114241,0,1,0
32624,1,1,114241,114241,114242,0,1,0
32625,6,1,114247,114247,114248,0,1,5
32626,1,2,114248,114248,114250,0,2,0
32627,4,2,114252,114252,114254,0,2,2
32628,2,2,114254,114254,114256,0,2,0
32629,2,1,114256,114256,114257,0,1,0
32630,4,1,114260,114260,114261,0,1,3
32631,4,3,114264,114264,114267,0,3,3
32632,5,3,114269,114269,114272,0,3,2
32633,4,2,114273,114273,114275,0,2,1
32634,3,1,114276,114276,114277,0,1,1
32635,4,1,114280,114280,114281,0,1,3
32636,3,3,114283,114283,114286,0,3,2
32637,1,2,114284,114286,114288,2,4,0
32638,1,1,114285,114288,114289,3,4,0
32639,3,3,114288,114289,114292,1,4,0
32640,1,3,114289,114292,114295,3,6,0
32641,3,2,114292,114295,114297,3,5,0
32642,5,2,114297,114297,114299,0,2,0
32643,4,3,114301,114301,114304,0,3,2
32644,1,2,114302,114304,114306,2,4,0
32645,4,1,114306,114306,114307,0,1,0
32646,1,1,114307,114307,114308,0,1,0
32647,5,1,114312,114312,114313,0,1,4
32648,1,2,114313,114313,114315,0,2,0
32649,5,2,114318,114318,114320,0,2,3
32650,5,3,114323,114323,114326,0,3,3
32651,3,1,114326,114326,114327,0,1,0
32652,1,2,114327,114327,114329,0,2,0
32653,1,1,114328,114329,114330,1,2,0
32654,1,2,114329,114330,114332,1,3,0
32655,6,2,114335,114335,114337,0,2,3
32656,2,1,114337,114337,114338,0,1,0
32657,3,3,114340,114340,114343,0,3,2
32658,5,3,114345,114345,114348,0,3,2
32659,4,2,114349,114349,114351,0,2,1
32660,5,1,114354,114354,114355,0,1,3
32661,5,1,114359,114359,114360,0,1,4
32662,3,1,114362,114362,114363,0,1,2
32663,5,2,114367,114367,114369,0,2,4
32664,1,1,114368,114369,114370,1,2,0
32665,4,3,114372,114372,114375,0,3,2
32666,1,3,114373,114375,114378,2,5,0
32667,1,2,114374,114378,114380,4,6,0
32668,6,2,114380,114380,114382,0,2,0
32669,6,2,114386,114386,114388,0,2,4
32670,5,3,114391,114391,114394,0,3,3
32671,5,2,114396,114396,114398,0,2,2
32672,4,2,114400,114400,114402,0,2,2
32673,3,2,114403,114403,114405,0,2,1
32674,2,2,114405,114405,114407,0,2,0
32675,3,1,114408,114408,114409,0,1,1
32676,2,3,114410,114410,114413,0,3,1
32677,4,1,114414,114414,114415,0,1,1
32678,5,2,114419,114419,114421,0,2,4
32679,2,3,114421,114421,114424,0,3,0
32680,5,2,114426,114426,114428,0,2,2
32681,3,2,114429,114429,114431,0,2,1
32682,3,1,114432,114432,114433,0,1,1
32683,1,2,114433,114433,114435,0,2,0
32684,6,2,114439,114439,114441,0,2,4
32685,6,1,114445,114445,114446,0,1,4
32686,3,3,114448,114448,114451,0,3,2
32687,3,1,114451,114451,114452,0,1,0
32688,1,2,114452,114452,114454,0,2,0
32689,5,3,114457,114457,114460,0,3,3
32690,2,3,114459,114460,114463,1,4,0
32691,6,1,114465,114465,114466,0,1,2
32692,5,2,114470,114470,114472,0,2,4
32693,3,3,114473,114473,114476,0,3,1
32694,1,3,114474,114476,114479,2,5,0
32695,2,3,114476,114479,114482,3,6,0
32696,5,3,114481,114482,114485,1,4,0
32697,2,2,114483,114485,114487,2,4,0
32698,3,1,114486,114487,114488,1,2,0
32699,3,3,114489,114489,114492,0,3,1
32700,4,3,114493,114493,114496,0,3,1
32701,6,1,114499,114499,114500,0,1,3
32702,2,3,114501,114501,114504,0,3,1
32703,6,2,114507,114507,114509,0,2,3
32704,4,1,114511,114511,114512,0,1,2
32705,6,2,114517,114517,114519,0,2,5
32706,3,2,114520,114520,114522,0,2,1
32707,1,1,114521,114522,114523,1,2,0
32708,4,1,114525,114525,114526,0,1,2
32709,5,1,114530,114530,114531,0,1,4
32710,2,2,114532,114532,114534,0,2,1
32711,6,2,114538,114538,114540,0,2,4
32712,3,3,114541,114541,114544,0,3,1
32713,3,1,114544,114544,114545,0,1,0
32714,5,2,114549,114549,114551,0,2,4
32715,1,2,114550,114551,114553,1,3,0
32716,4,2,114554,114554,114556,0,2,1
32717,5,3,114559,114559,114562,0,3,3
32718,1,3,114560,114562,114565,2,5,0
32719,5,2,114565,114565,114567,0,2,0
32720,3,1,114568,114568,114569,0,1,1
32721,5,3,114573,114573,114576,0,3,4
32722,1,2,114574,114576,114578,2,4,0
32723,6,2,114580,114580,114582,0,2,2
32724,1,1,114581,114582,114583,1,2,0
32725,1,3,114582,114583,114586,1,4,0
32726,4,2,114586,114586,114588,0,2,0
32727,6,1,114592,114592,114593,0,1,4
32728,4,1,114596,114596,114597,0,1,3
32729,3,1,114599,114599,114600,0,1,2
32730,3,2,114602,114602,114604,0,2,2
32731,5,3,114607,114607,114610,0,3,3
32732,3,1,114610,114610,114611,0,1,0
32733,5,3,114615,114615,114618,0,3,4
32734,1,3,114616,114618,114621,2,5,0
32735,5,3,114621,114621,114624,0,3,0
32736,2,1,114623,114624,114625,1,2,0
32737,5,1,114628,114628,114629,0,1,3
32738,1,3,114629,114629,114632,0,3,0
32739,6,1,114635,114635,114636,0,1,3
32740,2,2,114637,114637,114639,0,2,1
32741,4,3,114641,114641,114644,0,3,2
32742,2,1,114643,114644,114645,1,2,0
32743,5,2,114648,114648,114650,0,2,3
32744,6,3,114654,114654,114657,0,3,4
32745,3,2,114657,114657,114659,0,2,0
32746,2,3,114659,114659,114662,0,3,0
32747,3,2,114662,114662,114664,0,2,0
32748,4,2,114666,114666,114668,0,2,2
32749,2,2,114668,114668,114670,0,2,0
32750,6,1,114674,114674,114675,0,1,4
32751,5,2,114679,114679,114681,0,2,4
32752,1,2,114680,114681,114683,1,3,0
32753,3,2,114683,114683,114685,0,2,0
32754,4,2,114687,114687,114689,0,2,2
32755,5,3,114692,114692,114695,0,3,3
32756,1,1,114693,114695,114696,2,3,0
32757,6,3,114699,114699,114702,0,3,3
32758,1,3,114700,114702,114705,2,5,0
32759,4,2,114704,114705,114707,1,3,0
32760,1,1,114705,114707,114708,2,3,0
32761,1,3,114706,114708,114711,2,5,0
32762,1,2,114707,114711,114713,4,6,0
32763,3,1,114710,114713,114714,3,4,0
32764,2,2,114712,114714,114716,2,4,0
32765,4,2,114716,114716,114718,0,2,0
32766,5,3,114721,114721,114724,0,3,3
32767,4,2,114725,114725,114727,0,2,1
32768,4,1,114729,114729,114730,0,1,2
32769,3,2,114732,114732,114734,0,2,2
32770,4,1,114736,114736,114737,0,1,2
32771,3,1,114739,114739,114740,0,1,2
32772,4,3,114743,114743,114746,0,3,3
32773,2,3,114745,114746,114749,1,4,0
32774,5,3,114750,114750,114753,0,3,1
32775,3,2,114753,114753,114755,0,2,0
32776,1,1,114754,114755,114756,1,2,0
32777,6,2,114760,114760,114762,0,2,4
32778,5,3,114765,114765,114768,0,3,3
32779,2,2,114767,114768,114770,1,3,0
32780,4,3,114771,114771,114774,0,3,1
32781,6,1,114777,114777,114778,0,1,3
32782,1,2,114778,114778,114780,0,2,0
32783,6,1,114784,114784,114785,0,1,4
32784,6,2,114790,114790,114792,0,2,5
32785,4,1,114794,114794,114795,0,1,2
32786,4,2,114798,114798,114800,0,2,3
32787,2,1,114800,114800,114801,0,1,0
32788,6,3,114806,114806,114809,0,3,5
32789,4,2,114810,114810,114812,0,2,1
32790,3,3,114813,114813,114816,0,3,1
32791,1,3,114814,114816,114819,2,5,0
32792,6,1,114820,114820,114821,0,1,1
32793,2,2,114822,114822,114824,0,2,1
32794,6,2,114828,114828,114830,0,2,4
32795,4,1,114832,114832,114833,0,1,2
32796,3,2,114835,114835,114837,0,2,2
32797,5,1,114840,114840,114841,0,1,3
32798,2,3,114842,114842,114845,0,3,1
32799,1,3,114843,114845,114848,2,5,0
32800,2,3,114845,114848,114851,3,6,0
32801,1,3,114846,114851,114854,5,8,0
32802,1,1,114847,114854,114855,7,8,0
32803,6,3,114853,114855,114858,2,5,0
32804,4,1,114857,114858,114859,1,2,0
32805,3,3,114860,114860,114863,0,3,1
32806,6,3,114866,114866,114869,0,3,3
32807,6,2,114872,114872,114874,0,2,3
32808,6,2,114878,114878,114880,0,2,4
32809,5,3,114883,114883,114886,0,3,3
32810,1,2,114884,114886,114888,2,4,0
32811,3,1,114887,114888,114889,1,2,0
32812,6,2,114893,114893,114895,0,2,4
32813,6,2,114899,114899,114901,0,2,4
32814,3,2,114902,114902,114904,0,2,1
32815,6,1,114908,114908,114909,0,1,4
32816,3,3,114911,114911,114914,0,3,2
32817,6,2,114917,114917,114919,0,2,3
32818,3,3,114920,114920,114923,0,3,1
32819,3,3,114923,114923,114926,0,3,0
32820,2,1,114925,114926,114927,1,2,0
32821,6,3,114931,114931,114934,0,3,4
32822,1,3,114932,114934,114937,2,5,0
32823,5,2,114937,114937,114939,0,2,0
32824,2,1,114939,114939,114940,0,1,0
32825,1,2,114940,114940,114942,0,2,0
32826,4,1,114944,114944,114945,0,1,2
32827,2,2,114946,114946,114948,0,2,1
32828,2,3,114948,114948,114951,0,3,0
32829,4,1,114952,114952,114953,0,1,1
32830,1,1,114953,114953,114954,0,1,0
32831,1,3,114954,114954,114957,0,3,0
32832,4,2,114958,114958,114960,0,2,1
32833,2,1,114960,114960,114961,0,1,0
32834,5,2,114965,114965,114967,0,2,4
32835,5,1,114970,114970,114971,0,1,3
32836,5,2,114975,114975,114977,0,2,4
32837,2,1,114977,114977,114978,0,1,0
32838,1,1,114978,114978,114979,0,1,0
32839,3,1,114981,114981,114982,0,1,2
32840,6,2,114987,114987,114989,0,2,5
32841,5,2,114992,114992,114994,0,2,3
32842,5,2,114997,114997,114999,0,2,3
32843,3,2,115000,115000,115002,0,2,1
32844,4,3,115004,115004,115007,0,3,2
32845,2,2,115006,115007,115009,1,3,0
32846,4,3,115010,115010,115013,0,3,1
32847,2,2,115012,115013,115015,1,3,0
32848,3,3,115015,115015,115018,0,3,0
32849,4,3,115019,115019,115022,0,3,1
32850,3,1,115022,115022,115023,0,1,0
32851,4,2,115026,115026,115028,0,2,3
32852,6,2,115032,115032,115034,0,2,4
32853,5,3,115037,115037,115040,0,3,3
32854,6,1,115043,115043,115044,0,1,3
32855,2,1,115045,115045,115046,0,1,1
32856,5,2,115050,115050,115052,0,2,4
32857,3,2,115053,115053,115055,0,2,1
32858,2,3,115055,115055,115058,0,3,0
32859,4,1,115059,115059,115060,0,1,1
32860,1,3,115060,115060,115063,0,3,0
32861,6,1,115066,115066,115067,0,1,3
32862,5,2,115071,115071,115073,0,2,4
32863,5,1,115076,115076,115077,0,1,3
32864,3,2,115079,115079,115081,0,2,2
32865,4,2,115083,115083,115085,0,2,2
32866,4,2,115087,115087,115089,0,2,2
32867,6,3,115093,115093,115096,0,3,4
32868,2,3,115095,115096,115099,1,4,0
32869,6,3,115101,115101,115104,0,3,2
32870,4,2,115105,115105,115107,0,2,1
32871,6,1,115111,115111,115112,0,1,4
32872,5,1,115116,115116,115117,0,1,4
32873,1,2,115117,115117,115119,0,2,0
32874,1,2,115118,115119,115121,1,3,0
32875,6,3,115124,115124,115127,0,3,3
32876,6,2,115130,115130,115132,0,2,3
32877,2,1,115132,115132,115133,0,1,0
32878,1,2,115133,115133,115135,0,2,0
32879,6,2,115139,115139,115141,0,2,4
32880,4,2,115143,115143,115145,0,2,2
32881,6,1,115149,115149,115150,0,1,4
32882,5,2,115154,115154,115156,0,2,4
32883,4,3,115158,115158,115161,0,3,2
32884,5,1,115163,115163,115164,0,1,2
32885,1,3,115164,115164,115167,0,3,0
32886,6,1,115170,115170,115171,0,1,3
32887,6,1,115176,115176,115177,0,1,5
32888,2,3,115178,115178,115181,0,3,1
32889,5,3,115183,115183,115186,0,3,2
32890,1,1,115184,115186,115187,2,3,0
32891,5,2,115189,115189,115191,0,2,2
32892,3,3,115192,115192,115195,0,3,1
32893,2,2,115194,115195,115197,1,3,0
32894,4,3,115198,115198,115201,0,3,1
32895,6,2,115204,115204,115206,0,2,3
32896,6,3,115210,115210,115213,0,3,4
32897,5,2,115215,115215,115217,0,2,2
32898,2,1,115217,115217,115218,0,1,0
32899,4,3,115221,115221,115224,0,3,3
32900,2,1,115223,115224,115225,1,2,0
32901,3,2,115226,115226,115228,0,2,1
32902,3,1,115229,115229,115230,0,1,1
32903,3,1,115232,115232,115233,0,1,2
32904,4,2,115236,115236,115238,0,2,3
32905,2,1,115238,115238,115239,0,1,0
32906,3,3,115241,115241,115244,0,3,2
32907,5,3,115246,115246,115249,0,3,2
32908,3,2,115249,115249,115251,0,2,0
32909,5,1,115254,115254,115255,0,1,3
32910,6,3,115260,115260,115263,0,3,5
32911,4,1,115264,115264,115265,0,1,1
32912,2,2,115266,115266,115268,0,2,1
32913,1,2,115267,115268,115270,1,3,0
32914,1,3,115268,115270,115273,2,5,0
32915,1,2,115269,115273,115275,4,6,0
32916,2,2,115271,115275,115277,4,6,0
32917,6,2,115277,115277,115279,0,2,0
32918,3,3,115280,115280,115283,0,3,1
32919,5,2,115285,115285,115287,0,2,2
32920,4,1,115289,115289,115290,0,1,2
32921,4,3,115293,115293,115296,0,3,3
32922,5,2,115298,115298,115300,0,2,2
32923,3,1,115301,115301,115302,0,1,1
32924,3,1,115304,115304,115305,0,1,2
32925,5,2,115309,115309,115311,0,2,4
32926,3,2,115312,115312,115314,0,2,1
32927,2,3,115314,115314,115317,0,3,0
32928,3,1,115317,115317,115318,0,1,0
32929,1,1,115318,115318,115319,0,1,0
32930,4,1,115322,115322,115323,0,1,3
32931,3,2,115325,115325,115327,0,2,2
32932,2,2,115327,115327,115329,0,2,0
32933,5,1,115332,115332,115333,0,1,3
32934,2,2,115334,115334,115336,0,2,1
32935,3,1,115337,115337,115338,0,1,1
32936,3,2,115340,115340,115342,0,2,2
32937,5,2,115345,115345,115347,0,2,3
32938,3,3,115348,115348,115351,0,3,1
32939,5,3,115353,115353,115356,0,3,2
32940,6,3,115359,115359,115362,0,3,3
32941,2,2,115361,115362,115364,1,3,0
32942,6,1,115367,115367,115368,0,1,3
32943,6,3,115373,115373,115376,0,3,5
32944,6,1,115379,115379,115380,0,1,3
32945,5,1,115384,115384,115385,0,1,4
32946,4,1,115388,115388,115389,0,1,3
32947,5,3,115393,115393,115396,0,3,4
32948,1,2,115394,115396,115398,2,4,0
32949,4,2,115398,115398,115400,0,2,0
32950,4,2,115402,115402,115404,0,2,2
32951,4,1,115406,115406,115407,0,1,2
32952,3,2,115409,115409,115411,0,2,2
32953,4,1,115413,115413,115414,0,1,2
32954,5,2,115418,115418,115420,0,2,4
32955,1,2,115419,115420,115422,1,3,0
32956,6,1,115425,115425,115426,0,1,3
32957,5,2,115430,115430,115432,0,2,4
32958,4,1,115434,115434,115435,0,1,2
32959,6,2,115440,115440,115442,0,2,5
32960,6,3,115446,115446,115449,0,3,4
32961,5,1,115451,115451,115452,0,1,2
32962,2,2,115453,115453,115455,0,2,1
32963,2,2,115455,115455,115457,0,2,0
32964,6,3,115461,115461,115464,0,3,4
32965,5,2,115466,115466,115468,0,2,2
32966,3,2,115469,115469,115471,0,2,1
32967,6,3,115475,115475,115478,0,3,4
32968,2,1,115477,115478,115479,1,2,0
32969,4,3,115481,115481,115484,0,3,2
32970,4,1,115485,115485,115486,0,1,1
32971,4,1,115489,115489,115490,0,1,3
32972,6,3,115495,115495,115498,0,3,5
32973,3,3,115498,115498,115501,0,3,0
32974,5,3,115503,115503,115506,0,3,2
32975,2,2,115505,115506,115508,1,3,0
32976,3,3,115508,115508,115511,0,3,0
32977,6,3,115514,115514,115517,0,3,3
32978,1,3,115515,115517,115520,2,5,0
32979,5,3,115520,115520,115523,0,3,0
32980,5,3,115525,115525,115528,0,3,2
32981,6,2,115531,115531,115533,0,2,3
32982,3,2,115534,115534,115536,0,2,1
32983,4,2,115538,115538,115540,0,2,2
32984,4,1,115542,115542,115543,0,1,2
32985,5,3,115547,115547,115550,0,3,4
32986,3,2,115550,115550,115552,0,2,0
32987,4,3,115554,115554,115557,0,3,2
32988,2,3,115556,115557,115560,1,4,0
32989,5,3,115561,115561,115564,0,3,1
32990,5,2,115566,115566,115568,0,2,2
32991,3,1,115569,115569,115570,0,1,1
32992,3,2,115572,115572,115574,0,2,2
32993,5,2,115577,115577,115579,0,2,3
32994,2,3,115579,115579,115582,0,3,0
32995,2,3,115581,115582,115585,1,4,0
32996,2,1,115583,115585,115586,2,3,0
32997,3,1,115586,115586,115587,0,1,0
32998,2,3,115588,115588,115591,0,3,1
32999,6,1,115594,115594,115595,0,1,3
33000,4,1,115598,115598,115599,0,1,3
33001,6,1,115604,115604,115605,0,1,5
33002,6,1,115610,115610,115611,0,1,5
33003,4,3,115614,115614,115617,0,3,3
33004,5,3,115619,115619,115622,0,3,2
33005,5,2,115624,115624,115626,0,2,2
33006,2,1,115626,115626,115627,0,1,0
33007,2,3,115628,115628,115631,0,3,1
33008,6,1,115634,115634,115635,0,1,3
33009,3,1,115637,115637,115638,0,1,2
33010,1,2,115638,115638,115640,0,2,0
33011,6,3,115644,115644,115647,0,3,4
33012,5,1,115649,115649,115650,0,1,2
33013,1,2,115650,115650,115652,0,2,0
33014,4,3,115654,115654,115657,0,3,2
33015,1,1,115655,115657,115658,2,3,0
33016,1,3,115656,115658,115661,2,5,0
33017,2,3,115658,115661,115664,3,6,0
33018,6,3,115664,115664,115667,0,3,0
33019,6,1,115670,115670,115671,0,1,3
33020,6,1,115676,115676,115677,0,1,5
33021,2,1,115678,115678,115679,0,1,1
33022,4,2,115682,115682,115684,0,2,3
33023,5,2,115687,115687,115689,0,2,3
33024,6,2,115693,115693,115695,0,2,4
33025,5,1,115698,115698,115699,0,1,3
33026,4,1,115702,115702,115703,0,1,3
33027,5,1,115707,115707,115708,0,1,4
33028,4,2,115711,115711,115713,0,2,3
33029,6,1,115717,115717,115718,0,1,4
33030,2,2,115719,115719,115721,0,2,1
33031,5,3,115724,115724,115727,0,3,3
33032,4,2,115728,115728,115730,0,2,1
33033,5,3,115733,115733,115736,0,3,3
33034,4,3,115737,115737,115740,0,3,1
33035,4,1,115741,115741,115742,0,1,1
33036,2,1,115743,115743,115744,0,1,1
33037,4,1,115747,115747,115748,0,1,3
33038,1,2,115748,115748,115750,0,2,0
33039,2,1,115750,115750,115751,0,1,0
33040,2,3,115752,115752,115755,0,3,1
33041,2,3,115754,115755,115758,1,4,0
33042,3,2,115757,115758,115760,1,3,0
33043,1,3,115758,115760,115763,2,5,0
33044,5,3,115763,115763,115766,0,3,0
33045,4,1,115767,115767,115768,0,1,1
33046,3,1,115770,115770,115771,0,1,2
33047,4,3,115774,115774,115777,0,3,3
33048,1,1,115775,115777,115778,2,3,0
33049,3,1,115778,115778,115779,0,1,0
33050,3,3,115781,115781,115784,0,3,2
33051,6,1,115787,115787,115788,0,1,3
33052,5,2,115792,115792,115794,0,2,4
33053,1,1,115793,115794,115795,1,2,0
33054,3,2,115796,115796,115798,0,2,1
33055,4,3,115800,115800,115803,0,3,2
33056,3,1,115803,115803,115804,0,1,0
33057,5,2,115808,115808,115810,0,2,4
33058,5,1,115813,115813,115814,0,1,3
33059,4,3,115817,115817,115820,0,3,3
33060,6,3,115823,115823,115826,0,3,3
33061,3,2,115826,115826,115828,0,2,0
33062,3,2,115829,115829,115831,0,2,1
33063,3,2,115832,115832,115834,0,2,1
33064,2,3,115834,115834,115837,0,3,0
33065,6,1,115840,115840,115841,0,1,3
33066,6,2,115846,115846,115848,0,2,5
33067,2,3,115848,115848,115851,0,3,0
33068,3,1,115851,115851,115852,0,1,0
33069,5,2,115856,115856,115858,0,2,4
33070,3,1,115859,115859,115860,0,1,1
33071,3,2,115862,115862,115864,0,2,2
33072,4,1,115866,115866,115867,0,1,2
33073,1,1,115867,115867,115868,0,1,0
33074,5,3,115872,115872,115875,0,3,4
33075,5,1,115877,115877,115878,0,1,2
33076,1,2,115878,115878,115880,0,2,0
33077,1,2,115879,115880,115882,1,3,0
33078,5,3,115884,115884,115887,0,3,2
33079,2,2,115886,115887,115889,1,3,0
33080,1,2,115887,115889,115891,2,4,0
33081,4,1,115891,115891,115892,0,1,0
33082,6,3,115897,115897,115900,0,3,5
33083,4,1,115901,115901,115902,0,1,1
33084,2,3,115903,115903,115906,0,3,1
33085,2,2,115905,115906,115908,1,3,0
33086,6,1,115911,115911,115912,0,1,3
33087,1,3,115912,115912,115915,0,3,0
33088,4,3,115916,115916,115919,0,3,1
33089,3,1,115919,115919,115920,0,1,0
33090,3,2,115922,115922,115924,0,2,2
33091,6,1,115928,115928,115929,0,1,4
33092,4,2,115932,115932,115934,0,2,3
33093,4,2,115936,115936,115938,0,2,2
33094,3,1,115939,115939,115940,0,1,1
33095,2,3,115941,115941,115944,0,3,1
33096,4,2,115945,115945,115947,0,2,1
33097,6,1,115951,115951,115952,0,1,4
33098,3,1,115954,115954,115955,0,1,2
33099,2,1,115956,115956,115957,0,1,1
33100,5,1,115961,115961,115962,0,1,4
33101,5,1,115966,115966,115967,0,1,4
33102,2,3,115968,115968,115971,0,3,1
33103,1,3,115969,115971,115974,2,5,0
33104,2,3,115971,115974,115977,3,6,0
33105,5,2,115976,115977,115979,1,3,0
33106,5,1,115981,115981,115982,0,1,2
33107,1,1,115982,115982,115983,0,1,0
33108,5,3,115987,115987,115990,0,3,4
33109,4,3,115991,115991,115994,0,3,1
33110,3,1,115994,115994,115995,0,1,0
33111,5,3,115999,115999,116002,0,3,4
33112,2,3,116001,116002,116005,1,4,0
33113,3,2,116004,116005,116007,1,3,0
33114,6,2,116010,116010,116012,0,2,3
33115,6,2,116016,116016,116018,0,2,4
33116,1,2,116017,116018,116020,1,3,0
33117,2,3,116019,116020,116023,1,4,0
33118,5,1,116024,116024,116025,0,1,1
33119,1,2,116025,116025,116027,0,2,0
33120,2,1,116027,116027,116028,0,1,0
33121,4,1,116031,116031,116032,0,1,3
33122,1,1,116032,116032,116033,0,1,0
33123,1,2,116033,116033,116035,0,2,0
33124,2,1,116035,116035,116036,0,1,0
33125,2,3,116037,116037,116040,0,3,1
33126,3,2,116040,116040,116042,0,2,0
33127,3,1,116043,116043,116044,0,1,1
33128,3,3,116046,116046,116049,0,3,2
33129,3,2,116049,116049,116051,0,2,0
33130,1,1,116050,116051,116052,1,2,0
33131,3,3,116053,116053,116056,0,3,1
33132,4,2,116057,116057,116059,0,2,1
33133,2,1,116059,116059,116060,0,1,0
33134,5,3,116064,116064,116067,0,3,4
33135,3,1,116067,116067,116068,0,1,0
33136,3,3,116070,116070,116073,0,3,2
33137,5,2,116075,116075,116077,0,2,2
33138,5,2,116080,116080,116082,0,2,3
33139,5,2,116085,116085,116087,0,2,3
33140,1,3,116086,116087,116090,1,4,0
33141,2,3,116088,116090,116093,2,5,0
33142,4,2,116092,116093,116095,1,3,0
33143,6,1,116098,116098,116099,0,1,3
33144,1,2,116099,116099,116101,0,2,0
33145,3,2,116102,116102,116104,0,2,1
33146,4,2,116106,116106,116108,0,2,2
33147,2,2,116108,116108,116110,0,2,0
33148,3,3,116111,116111,116114,0,3,1
33149,4,1,116115,116115,116116,0,1,1
33150,6,3,116121,116121,116124,0,3,5
33151,1,1,116122,116124,116125,2,3,0
33152,3,2,116125,116125,116127,0,2,0
33153,5,1,116130,116130,116131,0,1,3
33154,3,1,116133,116133,116134,0,1,2
33155,1,2,116134,116134,116136,0,2,0
33156,4,2,116138,116138,116140,0,2,2
33157,5,2,116143,116143,116145,0,2,3
33158,1,1,116144,116145,116146,1,2,0
33159,5,1,116149,116149,116150,0,1,3
33160,3,3,116152,116152,116155,0,3,2
33161,5,2,116157,116157,116159,0,2,2
33162,5,1,116162,116162,116163,0,1,3
33163,5,2,116167,116167,116169,0,2,4
33164,3,2,116170,116170,116172,0,2,1
33165,1,1,116171,116172,116173,1,2,0
33166,5,2,116176,116176,116178,0,2,3
33167,1,1,116177,116178,116179,1,2,0
33168,1,3,116178,116179,116182,1,4,0
33169,2,2,116180,116182,116184,2,4,0
33170,2,1,116182,116184,116185,2,3,0
33171,2,2,116184,116185,116187,1,3,0
33172,2,2,116186,116187,116189,1,3,0
33173,6,3,116192,116192,116195,0,3,3
33174,3,1,116195,116195,116196,0,1,0
33175,1,2,116196,116196,116198,0,2,0
33176,3,1,116199,116199,116200,0,1,1
33177,4,3,116203,116203,116206,0,3,3
33178,6,2,116209,116209,116211,0,2,3
33179,6,2,116215,116215,116217,0,2,4
33180,6,1,116221,116221,116222,0,1,4
33181,6,1,116227,116227,116228,0,1,5
33182,4,1,116231,116231,116232,0,1,3
33183,4,3,116235,116235,116238,0,3,3
33184,5,3,116240,116240,116243,0,3,2
33185,5,3,116245,116245,116248,0,3,2
33186,1,1,116246,116248,116249,2,3,0
33187,2,2,116248,116249,116251,1,3,0
33188,1,2,116249,116251,116253,2,4,0
33189,5,2,116254,116254,116256,0,2,1
33190,6,3,116260,116260,116263,0,3,4
33191,6,2,116266,116266,116268,0,2,3
33192,6,2,116272,116272,116274,0,2,4
33193,6,1,116278,116278,116279,0,1,4
33194,4,2,116282,116282,116284,0,2,3
33195,5,1,116287,116287,116288,0,1,3
33196,4,2,116291,116291,116293,0,2,3
33197,5,1,116296,116296,116297,0,1,3
33198,6,1,116302,116302,116303,0,1,5
33199,1,2,116303,116303,116305,0,2,0
33200,1,3,116304,116305,116308,1,4,0
33201,2,2,116306,116308,116310,2,4,0
33202,1,3,116307,116310,116313,3,6,0
33203,5,1,116312,116313,116314,1,2,0
33204,6,3,116318,116318,116321,0,3,4
33205,4,3,116322,116322,116325,0,3,1
33206,6,1,116328,116328,116329,0,1,3
33207,4,3,116332,116332,116335,0,3,3
33208,1,2,116333,116335,116337,2,4,0
33209,4,3,116337,116337,116340,0,3,0
33210,2,3,116339,116340,116343,1,4,0
33211,1,3,116340,116343,116346,3,6,0
33212,5,1,116345,116346,116347,1,2,0
33213,5,3,116350,116350,116353,0,3,3
33214,3,1,116353,116353,116354,0,1,0
33215,1,3,116354,116354,116357,0,3,0
33216,3,3,116357,116357,116360,0,3,0
33217,4,1,116361,116361,116362,0,1,1
33218,3,2,116364,116364,116366,0,2,2
33219,2,2,116366,116366,116368,0,2,0
33220,4,1,116370,116370,116371,0,1,2
33221,1,3,116371,116371,116374,0,3,0
33222,3,1,116374,116374,116375,0,1,0
33223,3,1,116377,116377,116378,0,1,2
33224,6,2,116383,116383,116385,0,2,5
33225,3,2,116386,116386,116388,0,2,1
33226,3,1,116389,116389,116390,0,1,1
33227,3,1,116392,116392,116393,0,1,2
33228,3,3,116395,116395,116398,0,3,2
33229,3,1,116398,116398,116399,0,1,0
33230,6,1,116404,116404,116405,0,1,5
33231,1,1,116405,116405,116406,0,1,0
33232,5,2,116410,116410,116412,0,2,4
33233,3,2,116413,116413,116415,0,2,1
33234,3,1,116416,116416,116417,0,1,1
33235,3,2,116419,116419,116421,0,2,2
33236,4,3,116423,116423,116426,0,3,2
33237,5,3,116428,116428,116431,0,3,2
33238,5,2,116433,116433,116435,0,2,2
33239,3,1,116436,116436,116437,0,1,1
33240,1,1,116437,116437,116438,0,1,0
33241,3,2,116440,116440,116442,0,2,2
33242,1,3,116441,116442,116445,1,4,0
33243,2,1,116443,116445,116446,2,3,0
33244,4,2,116447,116447,116449,0,2,1
33245,4,2,116451,116451,116453,0,2,2
33246,1,2,116452,116453,116455,1,3,0
33247,4,1,116456,116456,116457,0,1,1
33248,2,3,116458,116458,116461,0,3,1
33249,1,1,116459,116461,116462,2,3,0
33250,1,1,116460,116462,116463,2,3,0
33251,6,1,116466,116466,116467,0,1,3
33252,6,2,116472,116472,116474,0,2,5
33253,4,2,116476,116476,116478,0,2,2
33254,3,2,116479,116479,116481,0,2,1
33255,4,2,116483,116483,116485,0,2,2
33256,5,1,116488,116488,116489,0,1,3
33257,4,2,116492,116492,116494,0,2,3
33258,2,3,116494,116494,116497,0,3,0
33259,1,3,116495,116497,116500,2,5,0
33260,1,3,116496,116500,116503,4,7,0
33261,5,1,116501,116503,116504,2,3,0
33262,3,1,116504,116504,116505,0,1,0
33263,1,2,116505,116505,116507,0,2,0
33264,4,3,116509,116509,116512,0,3,2
33265,5,3,116514,116514,116517,0,3,2
33266,4,3,116518,116518,116521,0,3,1
33267,5,1,116523,116523,116524,0,1,2
33268,3,2,116526,116526,116528,0,2,2
33269,1,3,116527,116528,116531,1,4,0
33270,2,2,116529,116531,116533,2,4,0
33271,5,2,116534,116534,116536,0,2,1
33272,5,1,116539,116539,116540,0,1,3
33273,3,2,116542,116542,116544,0,2,2
33274,2,1,116544,116544,116545,0,1,0
33275,5,2,116549,116549,116551,0,2,4
33276,6,1,116555,116555,116556,0,1,4
33277,3,3,116558,116558,116561,0,3,2
33278,5,2,116563,116563,116565,0,2,2
33279,4,1,116567,116567,116568,0,1,2
33280,4,2,116571,116571,116573,0,2,3
33281,2,2,116573,116573,116575,0,2,0
33282,6,2,116579,116579,116581,0,2,4
33283,4,2,116583,116583,116585,0,2,2
33284,4,1,116587,116587,116588,0,1,2
33285,6,3,116593,116593,116596,0,3,5
33286,5,2,116598,116598,116600,0,2,2
33287,5,3,116603,116603,116606,0,3,3
33288,5,3,116608,116608,116611,0,3,2
33289,5,2,116613,116613,116615,0,2,2
33290,5,2,116618,116618,116620,0,2,3
33291,2,1,116620,116620,116621,0,1,0
33292,2,3,116622,116622,116625,0,3,1
33293,2,1,116624,116625,116626,1,2,0
33294,1,2,116625,116626,116628,1,3,0
33295,6,1,116631,116631,116632,0,1,3
33296,2,2,116633,116633,116635,0,2,1
33297,6,1,116639,116639,116640,0,1,4
33298,5,1,116644,116644,116645,0,1,4
33299,2,2,116646,116646,116648,0,2,1
33300,2,1,116648,116648,116649,0,1,0
33301,6,2,116654,116654,116656,0,2,5
33302,6,2,116660,116660,116662,0,2,4
33303,1,1,116661,116662,116663,1,2,0
33304,4,1,116665,116665,116666,0,1,2
33305,2,1,116667,116667,116668,0,1,1
33306,5,3,116672,116672,116675,0,3,4
33307,3,3,116675,116675,116678,0,3,0
33308,2,1,116677,116678,116679,1,2,0
33309,5,2,116682,116682,116684,0,2,3
33310,1,3,116683,116684,116687,1,4,0
33311,6,1,116689,116689,116690,0,1,2
33312,1,2,116690,116690,116692,0,2,0
33313,2,1,116692,116692,116693,0,1,0
33314,4,3,116696,116696,116699,0,3,3
33315,5,2,116701,116701,116703,0,2,2
33316,4,3,116705,116705,116708,0,3,2
33317,3,3,116708,116708,116711,0,3,0
33318,2,2,116710,116711,116713,1,3,0
33319,4,2,116714,116714,116716,0,2,1
33320,6,1,116720,116720,116721,0,1,4
33321,5,3,116725,116725,116728,0,3,4
33322,4,1,116729,116729,116730,0,1,1
33323,4,1,116733,116733,116734,0,1,3
33324,1,2,116734,116734,116736,0,2,0
33325,6,2,116740,116740,116742,0,2,4
33326,1,1,116741,116742,116743,1,2,0
33327,5,1,116746,116746,116747,0,1,3
33328,5,2,116751,116751,116753,0,2,4
33329,4,3,116755,116755,116758,0,3,2
33330,4,2,116759,116759,116761,0,2,1
33331,1,2,116760,116761,116763,1,3,0
33332,1,1,116761,116763,116764,2,3,0
33333,3,1,116764,116764,116765,0,1,0
33334,6,1,116770,116770,116771,0,1,5
33335,2,1,116772,116772,116773,0,1,1
33336,5,1,116777,116777,116778,0,1,4
33337,6,1,116783,116783,116784,0,1,5
33338,1,3,116784,116784,116787,0,3,0
33339,5,1,116789,116789,116790,0,1,2
33340,6,2,116795,116795,116797,0,2,5
33341,5,1,116800,116800,116801,0,1,3
33342,5,1,116805,116805,116806,0,1,4
33343,6,2,116811,116811,116813,0,2,5
33344,5,1,116816,116816,116817,0,1,3
33345,3,3,116819,116819,116822,0,3,2
33346,2,3,116821,116822,116825,1,4,0
33347,4,1,116825,116825,116826,0,1,0
33348,2,3,116827,116827,116830,0,3,1
33349,5,2,116832,116832,116834,0,2,2
33350,2,1,116834,116834,116835,0,1,0
33351,4,1,116838,116838,116839,0,1,3
33352,4,1,116842,116842,116843,0,1,3
33353,1,1,116843,116843,116844,0,1,0
33354,4,1,116847,116847,116848,0,1,3
33355,2,1,116849,116849,116850,0,1,1
33356,3,3,116852,116852,116855,0,3,2
33357,6,1,116858,116858,116859,0,1,3
33358,6,1,116864,116864,116865,0,1,5
33359,3,2,116867,116867,116869,0,2,2
33360,6,2,116873,116873,116875,0,2,4
33361,3,1,116876,116876,116877,0,1,1
33362,2,2,116878,116878,116880,0,2,1
33363,2,2,116880,116880,116882,0,2,0
33364,3,3,116883,116883,116886,0,3,1
33365,4,2,116887,116887,116889,0,2,1
33366,2,2,116889,116889,116891,0,2,0
33367,5,1,116894,116894,116895,0,1,3
33368,2,1,116896,116896,116897,0,1,1
33369,2,1,116898,116898,116899,0,1,1
33370,1,2,116899,116899,116901,0,2,0
33371,5,1,116904,116904,116905,0,1,3
33372,4,3,116908,116908,116911,0,3,3
33373,3,2,116911,116911,116913,0,2,0
33374,5,3,116916,116916,116919,0,3,3
33375,4,3,116920,116920,116923,0,3,1
33376,6,3,116926,116926,116929,0,3,3
33377,3,1,116929,116929,116930,0,1,0
33378,2,3,116931,116931,116934,0,3,1
33379,6,3,116937,116937,116940,0,3,3
33380,2,1,116939,116940,116941,1,2,0
33381,2,3,116941,116941,116944,0,3,0
33382,2,2,116943,116944,116946,1,3,0
33383,5,3,116948,116948,116951,0,3,2
33384,3,2,116951,116951,116953,0,2,0
33385,3,2,116954,116954,116956,0,2,1
33386,4,3,116958,116958,116961,0,3,2
33387,1,1,116959,116961,116962,2,3,0
33388,4,2,116963,116963,116965,0,2,1
33389,3,2,116966,116966,116968,0,2,1
33390,4,3,116970,116970,116973,0,3,2
33391,5,3,116975,116975,116978,0,3,2
33392,2,2,116977,116978,116980,1,3,0
33393,4,3,116981,116981,116984,0,3,1
33394,4,1,116985,116985,116986,0,1,1
33395,3,3,116988,116988,116991,0,3,2
33396,2,3,116990,116991,116994,1,4,0
33397,1,1,116991,116994,116995,3,4,0
33398,3,3,116994,116995,116998,1,4,0
33399,3,1,116997,116998,116999,1,2,0
33400,5,1,117002,117002,117003,0,1,3
33401,5,3,117007,117007,117010,0,3,4
33402,5,1,117012,117012,117013,0,1,2
33403,4,1,117016,117016,117017,0,1,3
33404,1,3,117017,117017,117020,0,3,0
33405,4,3,117021,117021,117024,0,3,1
33406,5,2,117026,117026,117028,0,2,2
33407,3,1,117029,117029,117030,0,1,1
33408,4,2,117033,117033,117035,0,2,3
33409,1,2,117034,117035,117037,1,3,0
33410,4,2,117038,117038,117040,0,2,1
33411,5,3,117043,117043,117046,0,3,3
33412,3,2,117046,117046,117048,0,2,0
33413,6,3,117052,117052,117055,0,3,4
33414,4,2,117056,117056,117058,0,2,1
33415,2,2,117058,117058,117060,0,2,0
33416,3,2,117061,117061,117063,0,2,1
33417,1,1,117062,117063,117064,1,2,0
33418,3,2,117065,117065,117067,0,2,1
33419,4,3,117069,117069,117072,0,3,2
33420,3,1,117072,117072,117073,0,1,0
33421,1,1,117073,117073,117074,0,1,0
33422,3,3,117076,117076,117079,0,3,2
33423,5,2,117081,117081,117083,0,2,2
33424,5,3,117086,117086,117089,0,3,3
33425,2,1,117088,117089,117090,1,2,0
33426,4,3,117092,117092,117095,0,3,2
33427,3,2,117095,117095,117097,0,2,0
33428,6,3,117101,117101,117104,0,3,4
33429,5,3,117106,117106,117109,0,3,2
33430,4,1,117110,117110,117111,0,1,1
33431,1,1,117111,117111,117112,0,1,0
33432,2,1,117113,117113,117114,0,1,1
33433,4,3,117117,117117,117120,0,3,3
33434,5,1,117122,117122,117123,0,1,2
33435,5,3,117127,117127,117130,0,3,4
33436,6,2,117133,117133,117135,0,2,3
33437,6,1,117139,117139,117140,0,1,4
33438,2,3,117141,117141,117144,0,3,1
33439,2,2,117143,117144,117146,1,3,0
33440,1,1,117144,117146,117147,2,3,0
33441,2,2,117146,117147,117149,1,3,0
33442,5,2,117151,117151,117153,0,2,2
33443,3,2,117154,117154,117156,0,2,1
33444,1,2,117155,117156,117158,1,3,0
33445,4,1,117159,117159,117160,0,1,1
33446,2,3,117161,117161,117164,0,3,1
33447,4,1,117165,117165,117166,0,1,1
33448,4,1,117169,117169,117170,0,1,3
33449,1,1,117170,117170,117171,0,1,0
33450,5,3,117175,117175,117178,0,3,4
33451,4,3,117179,117179,117182,0,3,1
33452,2,2,117181,117182,117184,1,3,0
33453,5,1,117186,117186,117187,0,1,2
33454,1,2,117187,117187,117189,0,2,0
33455,5,2,117192,117192,117194,0,2,3
33456,4,3,117196,117196,117199,0,3,2
33457,3,3,117199,117199,117202,0,3,0
33458,2,3,117201,117202,117205,1,4,0
33459,3,1,117204,117205,117206,1,2,0
33460,4,1,117208,117208,117209,0,1,2
33461,5,1,117213,117213,117214,0,1,4
33462,6,2,117219,117219,117221,0,2,5
33463,2,1,117221,117221,117222,0,1,0
33464,1,2,117222,117222,117224,0,2,0
33465,2,2,117224,117224,117226,0,2,0
33466,4,3,117228,117228,117231,0,3,2
33467,2,1,117230,117231,117232,1,2,0
33468,5,3,117235,117235,117238,0,3,3
33469,4,3,117239,117239,117242,0,3,1
33470,6,2,117245,117245,117247,0,2,3
33471,1,1,117246,117247,117248,1,2,0
33472,5,3,117251,117251,117254,0,3,3
33473,6,1,117257,117257,117258,0,1,3
33474,4,3,117261,117261,117264,0,3,3
33475,4,2,117265,117265,117267,0,2,1
33476,2,1,117267,117267,117268,0,1,0
33477,1,1,117268,117268,117269,0,1,0
33478,3,2,117271,117271,117273,0,2,2
33479,2,3,117273,117273,117276,0,3,0
33480,2,1,117275,117276,117277,1,2,0
33481,5,3,117280,117280,117283,0,3,3
33482,6,3,117286,117286,117289,0,3,3
33483,1,1,117287,117289,117290,2,3,0
33484,3,2,117290,117290,117292,0,2,0
33485,1,3,117291,117292,117295,1,4,0
33486,6,3,117297,117297,117300,0,3,2
33487,4,1,117301,117301,117302,0,1,1
33488,6,3,117307,117307,117310,0,3,5
33489,2,2,117309,117310,117312,1,3,0
33490,2,1,117311,117312,117313,1,2,0
33491,4,2,117315,117315,117317,0,2,2
33492,4,3,117319,117319,117322,0,3,2
33493,3,1,117322,117322,117323,0,1,0
33494,3,3,117325,117325,117328,0,3,2
33495,4,1,117329,117329,117330,0,1,1
33496,2,1,117331,117331,117332,0,1,1
33497,3,2,117334,117334,117336,0,2,2
33498,2,3,117336,117336,117339,0,3,0
33499,2,2,117338,117339,117341,1,3,0
33500,4,2,117342,117342,117344,0,2,1
33501,1,2,117343,117344,117346,1,3,0
33502,2,3,117345,117346,117349,1,4,0
33503,2,1,117347,117349,117350,2,3,0
33504,4,3,117351,117351,117354,0,3,1
33505,4,2,117355,117355,117357,0,2,1
33506,1,3,117356,117357,117360,1,4,0
33507,5,1,117361,117361,117362,0,1,1
33508,4,2,117365,117365,117367,0,2,3
33509,6,2,117371,117371,117373,0,2,4
33510,3,1,117374,117374,117375,0,1,1
33511,1,3,117375,117375,117378,0,3,0
33512,4,2,117379,117379,117381,0,2,1
33513,1,1,117380,117381,117382,1,2,0
33514,6,3,117386,117386,117389,0,3,4
33515,5,1,117391,117391,117392,0,1,2
33516,1,2,117392,117392,117394,0,2,0
33517,5,1,117397,117397,117398,0,1,3
33518,3,3,117400,117400,117403,0,3,2
33519,3,2,117403,117403,117405,0,2,0
33520,6,1,117409,117409,117410,0,1,4
33521,4,1,117413,117413,117414,0,1,3
33522,4,1,117417,117417,117418,0,1,3
33523,2,3,117419,117419,117422,0,3,1
33524,4,2,117423,117423,117425,0,2,1
33525,4,3,117427,117427,117430,0,3,2
33526,6,1,117433,117433,117434,0,1,3
33527,3,2,117436,117436,117438,0,2,2
33528,5,2,117441,117441,117443,0,2,3
33529,6,3,117447,117447,117450,0,3,4
33530,1,3,117448,117450,117453,2,5,0
33531,1,3,117449,117453,117456,4,7,0
33532,5,3,117454,117456,117459,2,5,0
33533,5,1,117459,117459,117460,0,1,0
33534,2,2,117461,117461,117463,0,2,1
33535,5,1,117466,117466,117467,0,1,3
33536,5,2,117471,117471,117473,0,2,4
33537,1,2,117472,117473,117475,1,3,0
33538,6,3,117478,117478,117481,0,3,3
33539,1,2,117479,117481,117483,2,4,0
33540,3,3,117482,117483,117486,1,4,0
33541,3,1,117485,117486,117487,1,2,0
33542,3,1,117488,117488,117489,0,1,1
33543,4,1,117492,117492,117493,0,1,3
33544,6,2,117498,117498,117500,0,2,5
33545,5,3,117503,117503,117506,0,3,3
33546,4,1,117507,117507,117508,0,1,1
33547,5,3,117512,117512,117515,0,3,4
33548,5,1,117517,117517,117518,0,1,2
33549,4,3,117521,117521,117524,0,3,3
33550,6,3,117527,117527,117530,0,3,3
33551,4,1,117531,117531,117532,0,1,1
33552,4,1,117535,117535,117536,0,1,3
33553,5,3,117540,117540,117543,0,3,4
33554,4,3,117544,117544,117547,0,3,1
33555,6,3,117550,117550,117553,0,3,3
33556,3,3,117553,117553,117556,0,3,0
33557,1,3,117554,117556,117559,2,5,0
33558,4,3,117558,117559,117562,1,4,0
33559,4,1,117562,117562,117563,0,1,0
33560,5,1,117567,117567,117568,0,1,4
33561,2,2,117569,117569,117571,0,2,1
33562,2,3,117571,117571,117574,0,3,0
33563,2,3,117573,117574,117577,1,4,0
33564,4,2,117577,117577,117579,0,2,0
33565,1,3,117578,117579,117582,1,4,0
33566,1,3,117579,117582,117585,3,6,0
33567,6,2,117585,117585,117587,0,2,0
33568,2,3,117587,117587,117590,0,3,0
33569,2,2,117589,117590,117592,1,3,0
33570,6,2,117595,117595,117597,0,2,3
33571,4,1,117599,117599,117600,0,1,2
33572,2,2,117601,117601,117603,0,2,1
33573,3,2,117604,117604,117606,0,2,1
33574,4,1,117608,117608,117609,0,1,2
33575,6,1,117614,117614,117615,0,1,5
33576,2,3,117616,117616,117619,0,3,1
33577,5,1,117621,117621,117622,0,1,2
33578,4,2,117625,117625,117627,0,2,3
33579,3,1,117628,117628,117629,0,1,1
33580,2,3,117630,117630,117633,0,3,1
33581,6,3,117636,117636,117639,0,3,3
33582,4,3,117640,117640,117643,0,3,1
33583,5,1,117645,117645,117646,0,1,2
33584,3,3,117648,117648,117651,0,3,2
33585,6,2,117654,117654,117656,0,2,3
33586,4,2,117658,117658,117660,0,2,2
33587,1,3,117659,117660,117663,1,4,0
33588,1,3,117660,117663,117666,3,6,0
33589,1,1,117661,117666,117667,5,6,0
33590,5,3,117666,117667,117670,1,4,0
33591,6,3,117672,117672,117675,0,3,2
33592,3,2,117675,117675,117677,0,2,0
33593,6,1,117681,117681,117682,0,1,4
33594,3,3,117684,117684,117687,0,3,2
33595,4,3,117688,117688,117691,0,3,1
33596,1,3,117689,117691,117694,2,5,0
33597,5,1,117694,117694,117695,0,1,0
33598,4,1,117698,117698,117699,0,1,3
33599,5,2,117703,117703,117705,0,2,4
33600,2,2,117705,117705,117707,0,2,0
33601,5,1,117710,117710,117711,0,1,3
33602,1,3,117711,117711,117714,0,3,0
33603,6,1,117717,117717,117718,0,1,3
33604,5,2,117722,117722,117724,0,2,4
33605,6,3,117728,117728,117731,0,3,4
33606,2,3,117730,117731,117734,1,4,0
33607,3,1,117733,117734,117735,1,2,0
33608,5,3,117738,117738,117741,0,3,3
33609,2,3,117740,117741,117744,1,4,0
33610,5,1,117745,117745,117746,0,1,1
33611,3,3,117748,117748,117751,0,3,2
33612,6,3,117754,117754,117757,0,3,3
33613,1,1,117755,117757,117758,2,3,0
33614,6,1,117761,117761,117762,0,1,3
33615,6,1,117767,117767,117768,0,1,5
33616,3,2,117770,117770,117772,0,2,2
33617,1,3,117771,117772,117775,1,4,0
33618,2,2,117773,117775,117777,2,4,0
33619,5,3,117778,117778,117781,0,3,1
33620,1,2,117779,117781,117783,2,4,0
33621,5,1,117784,117784,117785,0,1,1
33622,2,2,117786,117786,117788,0,2,1
33623,2,1,117788,117788,117789,0,1,0
33624,3,3,117791,117791,117794,0,3,2
33625,6,1,117797,117797,117798,0,1,3
33626,1,2,117798,117798,117800,0,2,0
33627,4,2,117802,117802,117804,0,2,2
33628,3,2,117805,117805,117807,0,2,1
33629,1,2,117806,117807,117809,1,3,0
33630,4,2,117810,117810,117812,0,2,1
33631,4,1,117814,117814,117815,0,1,2
33632,1,1,117815,117815,117816,0,1,0
33633,4,2,117819,117819,117821,0,2,3
33634,6,1,117825,117825,117826,0,1,4
33635,5,2,117830,117830,117832,0,2,4
33636,2,3,117832,117832,117835,0,3,0
33637,3,3,117835,117835,117838,0,3,0
33638,5,2,117840,117840,117842,0,2,2
33639,5,1,117845,117845,117846,0,1,3
33640,5,2,117850,117850,117852,0,2,4
33641,6,3,117856,117856,117859,0,3,4
33642,5,1,117861,117861,117862,0,1,2
33643,3,1,117864,117864,117865,0,1,2
33644,3,1,117867,117867,117868,0,1,2
33645,3,3,117870,117870,117873,0,3,2
33646,6,2,117876,117876,117878,0,2,3
33647,2,3,117878,117878,117881,0,3,0
33648,2,1,117880,117881,117882,1,2,0
33649,1,1,117881,117882,117883,1,2,0
33650,6,2,117887,117887,117889,0,2,4
33651,3,2,117890,117890,117892,0,2,1
33652,1,3,117891,117892,117895,1,4,0
33653,1,3,117892,117895,117898,3,6,0
33654,5,3,117897,117898,117901,1,4,0
33655,4,1,117901,117901,117902,0,1,0
33656,2,1,117903,117903,117904,0,1,1
33657,3,2,117906,117906,117908,0,2,2
33658,6,1,117912,117912,117913,0,1,4
33659,3,2,117915,117915,117917,0,2,2
33660,3,2,117918,117918,117920,0,2,1
33661,2,3,117920,117920,117923,0,3,0
33662,2,1,117922,117923,117924,1,2,0
33663,5,1,117927,117927,117928,0,1,3
33664,3,2,117930,117930,117932,0,2,2
33665,6,3,117936,117936,117939,0,3,4
33666,3,1,117939,117939,117940,0,1,0
33667,4,3,117943,117943,117946,0,3,3
33668,3,1,117946,117946,117947,0,1,0
33669,2,2,117948,117948,117950,0,2,1
33670,6,2,117954,117954,117956,0,2,4
33671,3,3,117957,117957,117960,0,3,1
33672,1,3,117958,117960,117963,2,5,0
33673,4,1,117962,117963,117964,1,2,0
33674,4,3,117966,117966,117969,0,3,2
33675,6,2,117972,117972,117974,0,2,3
33676,4,2,117976,117976,117978,0,2,2
33677,2,2,117978,117978,117980,0,2,0
33678,2,3,117980,117980,117983,0,3,0
33679,2,1,117982,117983,117984,1,2,0
33680,2,2,117984,117984,117986,0,2,0
33681,5,1,117989,117989,117990,0,1,3
33682,6,2,117995,117995,117997,0,2,5
33683,5,3,118000,118000,118003,0,3,3
33684,1,1,118001,118003,118004,2,3,0
33685,1,1,118002,118004,118005,2,3,0
33686,6,3,118008,118008,118011,0,3,3
33687,2,1,118010,118011,118012,1,2,0
33688,6,2,118016,118016,118018,0,2,4
33689,1,2,118017,118018,118020,1,3,0
33690,4,2,118021,118021,118023,0,2,1
33691,3,1,118024,118024,118025,0,1,1
33692,5,3,118029,118029,118032,0,3,4
33693,3,1,118032,118032,118033,0,1,0
33694,2,1,118034,118034,118035,0,1,1
33695,4,1,118038,118038,118039,0,1,3
33696,1,1,118039,118039,118040,0,1,0
33697,2,3,118041,118041,118044,0,3,1
33698,3,1,118044,118044,118045,0,1,0
33699,5,2,118049,118049,118051,0,2,4
33700,3,3,118052,118052,118055,0,3,1
33701,4,3,118056,118056,118059,0,3,1
33702,5,2,118061,118061,118063,0,2,2
33703,5,3,118066,118066,118069,0,3,3
33704,1,3,118067,118069,118072,2,5,0
33705,2,3,118069,118072,118075,3,6,0
33706,5,1,118074,118075,118076,1,2,0
33707,2,3,118076,118076,118079,0,3,0
33708,3,1,118079,118079,118080,0,1,0
33709,4,2,118083,118083,118085,0,2,3
33710,5,1,118088,118088,118089,0,1,3
33711,5,2,118093,118093,118095,0,2,4
33712,6,2,118099,118099,118101,0,2,4
33713,3,2,118102,118102,118104,0,2,1
33714,2,3,118104,118104,118107,0,3,0
33715,3,2,118107,118107,118109,0,2,0
33716,2,1,118109,118109,118110,0,1,0
33717,1,3,118110,118110,118113,0,3,0
33718,1,1,118111,118113,118114,2,3,0
33719,3,3,118114,118114,118117,0,3,0
33720,6,1,118120,118120,118121,0,1,3
33721,5,2,118125,118125,118127,0,2,4
33722,3,2,118128,118128,118130,0,2,1
33723,3,2,118131,118131,118133,0,2,1
33724,3,3,118134,118134,118137,0,3,1
33725,3,1,118137,118137,118138,0,1,0
33726,2,1,118139,118139,118140,0,1,1
33727,6,3,118145,118145,118148,0,3,5
33728,2,3,118147,118148,118151,1,4,0
33729,2,2,118149,118151,118153,2,4,0
33730,4,1,118153,118153,118154,0,1,0
33731,6,1,118159,118159,118160,0,1,5
33732,4,2,118163,118163,118165,0,2,3
33733,5,3,118168,118168,118171,0,3,3
33734,2,1,118170,118171,118172,1,2,0
33735,4,1,118174,118174,118175,0,1,2
33736,4,3,118178,118178,118181,0,3,3
33737,1,3,118179,118181,118184,2,5,0
33738,1,1,118180,118184,118185,4,5,0
33739,3,3,118183,118185,118188,2,5,0
33740,2,2,118185,118188,118190,3,5,0
33741,1,1,118186,118190,118191,4,5,0
33742,5,3,118191,118191,118194,0,3,0
33743,4,2,118195,118195,118197,0,2,1
33744,4,2,118199,118199,118201,0,2,2
33745,1,2,118200,118201,118203,1,3,0
33746,2,3,118202,118203,118206,1,4,0
33747,4,2,118206,118206,118208,0,2,0
33748,4,1,118210,118210,118211,0,1,2
33749,5,2,118215,118215,118217,0,2,4
33750,3,1,118218,118218,118219,0,1,1
33751,2,1,118220,118220,118221,0,1,1
33752,2,1,118222,118222,118223,0,1,1
33753,6,1,118228,118228,118229,0,1,5
33754,6,3,118234,118234,118237,0,3,5
33755,6,2,118240,118240,118242,0,2,3
33756,1,3,118241,118242,118245,1,4,0
33757,2,2,118243,118245,118247,2,4,0
33758,5,2,118248,118248,118250,0,2,1
33759,3,2,118251,118251,118253,0,2,1
33760,1,3,118252,118253,118256,1,4,0
33761,1,3,118253,118256,118259,3,6,0
33762,6,1,118259,118259,118260,0,1,0
33763,1,1,118260,118260,118261,0,1,0
33764,4,2,118264,118264,118266,0,2,3
33765,3,1,118267,118267,118268,0,1,1
33766,4,2,118271,118271,118273,0,2,3
33767,3,1,118274,118274,118275,0,1,1
33768,6,3,118280,118280,118283,0,3,5
33769,6,3,118286,118286,118289,0,3,3
33770,1,2,118287,118289,118291,2,4,0
33771,2,3,118289,118291,118294,2,5,0
33772,3,2,118292,118294,118296,2,4,0
33773,3,3,118295,118296,118299,1,4,0
33774,3,3,118298,118299,118302,1,4,0
33775,2,1,118300,118302,118303,2,3,0
33776,5,3,118305,118305,118308,0,3,2
33777,2,1,118307,118308,118309,1,2,0
33778,5,2,118312,118312,118314,0,2,3
33779,5,3,118317,118317,118320,0,3,3
33780,6,1,118323,118323,118324,0,1,3
33781,6,3,118329,118329,118332,0,3,5
33782,1,1,118330,118332,118333,2,3,0
33783,5,3,118335,118335,118338,0,3,2
33784,4,2,118339,118339,118341,0,2,1
33785,3,2,118342,118342,118344,0,2,1
33786,6,2,118348,118348,118350,0,2,4
33787,1,1,118349,118350,118351,1,2,0
33788,2,3,118351,118351,118354,0,3,0
33789,3,1,118354,118354,118355,0,1,0
33790,5,1,118359,118359,118360,0,1,4
33791,1,1,118360,118360,118361,0,1,0
33792,6,1,118366,118366,118367,0,1,5
33793,2,3,118368,118368,118371,0,3,1
33794,3,2,118371,118371,118373,0,2,0
33795,2,1,118373,118373,118374,0,1,0
33796,3,2,118376,118376,118378,0,2,2
33797,6,1,118382,118382,118383,0,1,4
33798,3,1,118385,118385,118386,0,1,2
33799,5,1,118390,118390,118391,0,1,4
33800,2,2,118392,118392,118394,0,2,1
33801,3,1,118395,118395,118396,0,1,1
33802,1,3,118396,118396,118399,0,3,0
33803,6,1,118402,118402,118403,0,1,3
33804,3,1,118405,118405,118406,0,1,2
33805,4,2,118409,118409,118411,0,2,3
33806,2,3,118411,118411,118414,0,3,0
33807,3,2,118414,118414,118416,0,2,0
33808,6,3,118420,118420,118423,0,3,4
33809,2,2,118422,118423,118425,1,3,0
33810,6,1,118428,118428,118429,0,1,3
33811,2,3,118430,118430,118433,0,3,1
33812,3,3,118433,118433,118436,0,3,0
33813,6,2,118439,118439,118441,0,2,3
33814,5,1,118444,118444,118445,0,1,3
33815,6,3,118450,118450,118453,0,3,5
33816,5,1,118455,118455,118456,0,1,2
33817,4,3,118459,118459,118462,0,3,3
33818,5,1,118464,118464,118465,0,1,2
33819,3,2,118467,118467,118469,0,2,2
33820,4,2,118471,118471,118473,0,2,2
33821,1,2,118472,118473,118475,1,3,0
33822,1,1,118473,118475,118476,2,3,0
33823,2,3,118475,118476,118479,1,4,0
33824,5,1,118480,118480,118481,0,1,1
33825,1,3,118481,118481,118484,0,3,0
33826,6,1,118487,118487,118488,0,1,3
33827,2,3,118489,118489,118492,0,3,1
33828,6,2,118495,118495,118497,0,2,3
33829,3,1,118498,118498,118499,0,1,1
33830,4,1,118502,118502,118503,0,1,3
33831,4,3,118506,118506,118509,0,3,3
33832,5,2,118511,118511,118513,0,2,2
33833,6,2,118517,118517,118519,0,2,4
33834,5,1,118522,118522,118523,0,1,3
33835,5,2,118527,118527,118529,0,2,4
33836,3,3,118530,118530,118533,0,3,1
33837,5,2,118535,118535,118537,0,2,2
33838,4,3,118539,118539,118542,0,3,2
33839,1,1,118540,118542,118543,2,3,0
33840,2,2,118542,118543,118545,1,3,0
33841,4,1,118546,118546,118547,0,1,1
33842,3,3,118549,118549,118552,0,3,2
33843,4,3,118553,118553,118556,0,3,1
33844,1,3,118554,118556,118559,2,5,0
33845,1,3,118555,118559,118562,4,7,0
33846,3,1,118558,118562,118563,4,5,0
33847,3,3,118561,118563,118566,2,5,0
33848,2,1,118563,118566,118567,3,4,0
33849,4,1,118567,118567,118568,0,1,0
33850,5,3,118572,118572,118575,0,3,4
33851,4,2,118576,118576,118578,0,2,1
33852,3,3,118579,118579,118582,0,3,1
33853,4,1,118583,118583,118584,0,1,1
33854,2,2,118585,118585,118587,0,2,1
33855,2,1,118587,118587,118588,0,1,0
33856,1,2,118588,118588,118590,0,2,0
33857,2,3,118590,118590,118593,0,3,0
33858,2,2,118592,118593,118595,1,3,0
33859,5,1,118597,118597,118598,0,1,2
33860,4,2,118601,118601,118603,0,2,3
33861,2,2,118603,118603,118605,0,2,0
33862,5,2,118608,118608,118610,0,2,3
33863,3,3,118611,118611,118614,0,3,1
33864,6,1,118617,118617,118618,0,1,3
33865,6,3,118623,118623,118626,0,3,5
33866,6,2,118629,118629,118631,0,2,3
33867,6,2,118635,118635,118637,0,2,4
33868,1,1,118636,118637,118638,1,2,0
33869,4,3,118640,118640,118643,0,3,2
33870,5,3,118645,118645,118648,0,3,2
33871,4,2,118649,118649,118651,0,2,1
33872,1,3,118650,118651,118654,1,4,0
33873,2,2,118652,118654,118656,2,4,0
33874,5,1,118657,118657,118658,0,1,1
33875,4,3,118661,118661,118664,0,3,3
33876,1,1,118662,118664,118665,2,3,0
33877,4,3,118666,118666,118669,0,3,1
33878,4,3,118670,118670,118673,0,3,1
33879,2,3,118672,118673,118676,1,4,0
33880,5,1,118677,118677,118678,0,1,1
33881,3,2,118680,118680,118682,0,2,2
33882,4,2,118684,118684,118686,0,2,2
33883,5,2,118689,118689,118691,0,2,3
33884,2,1,118691,118691,118692,0,1,0
33885,5,3,118696,118696,118699,0,3,4
33886,3,1,118699,118699,118700,0,1,0
33887,3,3,118702,118702,118705,0,3,2
33888,4,2,118706,118706,118708,0,2,1
33889,1,3,118707,118708,118711,1,4,0
33890,5,1,118712,118712,118713,0,1,1
33891,1,2,118713,118713,118715,0,2,0
33892,2,2,118715,118715,118717,0,2,0
33893,2,1,118717,118717,118718,0,1,0
33894,3,2,118720,118720,118722,0,2,2
33895,1,2,118721,118722,118724,1,3,0
33896,4,3,118725,118725,118728,0,3,1
33897,2,3,118727,118728,118731,1,4,0
33898,2,2,118729,118731,118733,2,4,0
33899,3,3,118732,118733,118736,1,4,0
33900,4,1,118736,118736,118737,0,1,0
33901,2,1,118738,118738,118739,0,1,1
33902,3,1,118741,118741,118742,0,1,2
33903,2,3,118743,118743,118746,0,3,1
33904,4,1,118747,118747,118748,0,1,1
33905,4,2,118751,118751,118753,0,2,3
33906,2,1,118753,118753,118754,0,1,0
33907,3,3,118756,118756,118759,0,3,2
33908,5,2,118761,118761,118763,0,2,2
33909,4,3,118765,118765,118768,0,3,2
33910,3,1,118768,118768,118769,0,1,0
33911,3,3,118771,118771,118774,0,3,2
33912,1,3,118772,118774,118777,2,5,0
33913,4,1,118776,118777,118778,1,2,0
33914,5,1,118781,118781,118782,0,1,3
33915,4,1,118785,118785,118786,0,1,3
33916,6,3,118791,118791,118794,0,3,5
33917,1,1,118792,118794,118795,2,3,0
33918,5,2,118797,118797,118799,0,2,2
33919,3,2,118800,118800,118802,0,2,1
33920,6,2,118806,118806,118808,0,2,4
33921,6,3,118812,118812,118815,0,3,4
33922,2,1,118814,118815,118816,1,2,0
33923,6,1,118820,118820,118821,0,1,4
33924,5,2,118825,118825,118827,0,2,4
33925,3,3,118828,118828,118831,0,3,1
33926,4,3,118832,118832,118835,0,3,1
33927,2,1,118834,118835,118836,1,2,0
33928,4,2,118838,118838,118840,0,2,2
33929,5,3,118843,118843,118846,0,3,3
33930,1,2,118844,118846,118848,2,4,0
33931,6,1,118850,118850,118851,0,1,2
33932,5,3,118855,118855,118858,0,3,4
33933,6,1,118861,118861,118862,0,1,3
33934,6,2,118867,118867,118869,0,2,5
33935,4,2,118871,118871,118873,0,2,2
33936,6,2,118877,118877,118879,0,2,4
33937,2,2,118879,118879,118881,0,2,0
33938,6,1,118885,118885,118886,0,1,4
33939,5,2,118890,118890,118892,0,2,4
33940,4,1,118894,118894,118895,0,1,2
33941,1,2,118895,118895,118897,0,2,0
33942,6,3,118901,118901,118904,0,3,4
33943,3,1,118904,118904,118905,0,1,0
33944,6,2,118910,118910,118912,0,2,5
33945,4,2,118914,118914,118916,0,2,2
33946,5,2,118919,118919,118921,0,2,3
33947,5,1,118924,118924,118925,0,1,3
33948,3,3,118927,118927,118930,0,3,2
33949,2,1,118929,118930,118931,1,2,0
33950,3,3,118932,118932,118935,0,3,1
33951,5,3,118937,118937,118940,0,3,2
33952,4,1,118941,118941,118942,0,1,1
33953,4,3,118945,118945,118948,0,3,3
33954,4,3,118949,118949,118952,0,3,1
33955,1,3,118950,118952,118955,2,5,0
33956,5,1,118955,118955,118956,0,1,0
33957,3,2,118958,118958,118960,0,2,2
33958,5,1,118963,118963,118964,0,1,3
33959,3,1,118966,118966,118967,0,1,2
33960,1,2,118967,118967,118969,0,2,0
33961,3,2,118970,118970,118972,0,2,1
33962,6,1,118976,118976,118977,0,1,4
33963,1,1,118977,118977,118978,0,1,0
33964,3,3,118980,118980,118983,0,3,2
33965,1,2,118981,118983,118985,2,4,0
33966,5,1,118986,118986,118987,0,1,1
33967,5,1,118991,118991,118992,0,1,4
33968,6,2,118997,118997,118999,0,2,5
33969,3,2,119000,119000,119002,0,2,1
33970,1,1,119001,119002,119003,1,2,0
33971,2,1,119003,119003,119004,0,1,0
33972,1,3,119004,119004,119007,0,3,0
33973,5,1,119009,119009,119010,0,1,2
33974,4,1,119013,119013,119014,0,1,3
33975,1,1,119014,119014,119015,0,1,0
33976,2,1,119016,119016,119017,0,1,1
33977,6,3,119022,119022,119025,0,3,5
33978,2,2,119024,119025,119027,1,3,0
33979,2,3,119026,119027,119030,1,4,0
33980,4,2,119030,119030,119032,0,2,0
33981,6,1,119036,119036,119037,0,1,4
33982,6,3,119042,119042,119045,0,3,5
33983,4,3,119046,119046,119049,0,3,1
33984,4,2,119050,119050,119052,0,2,1
33985,6,1,119056,119056,119057,0,1,4
33986,1,2,119057,119057,119059,0,2,0
33987,5,3,119062,119062,119065,0,3,3
33988,3,3,119065,119065,119068,0,3,0
33989,4,2,119069,119069,119071,0,2,1
33990,5,2,119074,119074,119076,0,2,3
33991,3,1,119077,119077,119078,0,1,1
33992,5,2,119082,119082,119084,0,2,4
33993,2,3,119084,119084,119087,0,3,0
33994,1,3,119085,119087,119090,2,5,0
33995,1,3,119086,119090,119093,4,7,0
33996,3,1,119089,119093,119094,4,5,0
33997,6,1,119095,119095,119096,0,1,1
33998,3,1,119098,119098,119099,0,1,2
33999,4,2,119102,119102,119104,0,2,3
34000,3,3,119105,119105,119108,0,3,1
34001,3,3,119108,119108,119111,0,3,0
34002,3,1,119111,119111,119112,0,1,0
34003,5,1,119116,119116,119117,0,1,4
34004,6,3,119122,119122,119125,0,3,5
34005,1,3,119123,119125,119128,2,5,0
34006,2,3,119125,119128,119131,3,6,0
34007,5,2,119130,119131,119133,1,3,0
34008,1,2,119131,119133,119135,2,4,0
34009,1,1,119132,119135,119136,3,4,0
34010,2,2,119134,119136,119138,2,4,0
34011,5,1,119139,119139,119140,0,1,1
34012,1,3,119140,119140,119143,0,3,0
34013,5,1,119145,119145,119146,0,1,2
34014,5,1,119150,119150,119151,0,1,4
34015,4,2,119154,119154,119156,0,2,3
34016,3,1,119157,119157,119158,0,1,1
34017,1,2,119158,119158,119160,0,2,0
34018,3,2,119161,119161,119163,0,2,1
34019,6,3,119167,119167,119170,0,3,4
34020,4,1,119171,119171,119172,0,1,1
34021,5,2,119176,119176,119178,0,2,4
34022,2,3,119178,119178,119181,0,3,0
34023,5,3,119183,119183,119186,0,3,2
34024,4,1,119187,119187,119188,0,1,1
34025,4,2,119191,119191,119193,0,2,3
34026,1,1,119192,119193,119194,1,2,0
34027,2,3,119194,119194,119197,0,3,0
34028,3,2,119197,119197,119199,0,2,0
34029,4,3,119201,119201,119204,0,3,2
34030,1,2,119202,119204,119206,2,4,0
34031,3,1,119205,119206,119207,1,2,0
34032,5,3,119210,119210,119213,0,3,3
34033,1,1,119211,119213,119214,2,3,0
34034,3,1,119214,119214,119215,0,1,0
34035,5,2,119219,119219,119221,0,2,4
34036,5,3,119224,119224,119227,0,3,3
34037,2,2,119226,119227,119229,1,3,0
34038,3,1,119229,119229,119230,0,1,0
34039,2,3,119231,119231,119234,0,3,1
34040,1,3,119232,119234,119237,2,5,0
34041,5,1,119237,119237,119238,0,1,0
34042,4,3,119241,119241,119244,0,3,3
34043,5,2,119246,119246,119248,0,2,2
34044,3,2,119249,119249,119251,0,2,1
34045,3,3,119252,119252,119255,0,3,1
34046,2,3,119254,119255,119258,1,4,0
34047,5,3,119259,119259,119262,0,3,1
34048,5,1,119264,119264,119265,0,1,2
34049,2,2,119266,119266,119268,0,2,1
34050,4,3,119270,119270,119273,0,3,2
34051,6,3,119276,119276,119279,0,3,3
34052,1,3,119277,119279,119282,2,5,0
34053,6,2,119283,119283,119285,0,2,1
34054,6,1,119289,119289,119290,0,1,4
34055,4,2,119293,119293,119295,0,2,3
34056,2,2,119295,119295,119297,0,2,0
34057,5,2,119300,119300,119302,0,2,3
34058,6,1,119306,119306,119307,0,1,4
34059,3,1,119309,119309,119310,0,1,2
34060,1,3,119310,119310,119313,0,3,0
34061,4,1,119314,119314,119315,0,1,1
34062,1,2,119315,119315,119317,0,2,0
34063,5,1,119320,119320,119321,0,1,3
34064,1,3,119321,119321,119324,0,3,0
34065,6,1,119327,119327,119328,0,1,3
34066,1,2,119328,119328,119330,0,2,0
34067,6,2,119334,119334,119336,0,2,4
34068,2,3,119336,119336,119339,0,3,0
34069,5,2,119341,119341,119343,0,2,2
34070,1,1,119342,119343,119344,1,2,0
34071,2,3,119344,119344,119347,0,3,0
34072,3,2,119347,119347,119349,0,2,0
34073,1,3,119348,119349,119352,1,4,0
34074,1,1,119349,119352,119353,3,4,0
34075,1,2,119350,119353,119355,3,5,0
34076,5,1,119355,119355,119356,0,1,0
34077,2,1,119357,119357,119358,0,1,1
34078,1,1,119358,119358,119359,0,1,0
34079,4,2,119362,119362,119364,0,2,3
34080,1,2,119363,119364,119366,1,3,0
34081,5,2,119368,119368,119370,0,2,2
34082,6,3,119374,119374,119377,0,3,4
34083,5,3,119379,119379,119382,0,3,2
34084,4,1,119383,119383,119384,0,1,1
34085,1,1,119384,119384,119385,0,1,0
34086,2,1,119386,119386,119387,0,1,1
34087,4,3,119390,119390,119393,0,3,3
34088,2,1,119392,119393,119394,1,2,0
34089,5,3,119397,119397,119400,0,3,3
34090,5,3,119402,119402,119405,0,3,2
34091,2,1,119404,119405,119406,1,2,0
34092,3,2,119407,119407,119409,0,2,1
34093,4,1,119411,119411,119412,0,1,2
34094,1,2,119412,119412,119414,0,2,0
34095,1,3,119413,119414,119417,1,4,0
34096,6,2,119419,119419,119421,0,2,2
34097,6,3,119425,119425,119428,0,3,4
34098,5,3,119430,119430,119433,0,3,2
34099,2,3,119432,119433,119436,1,4,0
34100,2,1,119434,119436,119437,2,3,0
34101,2,2,119436,119437,119439,1,3,0
34102,6,2,119442,119442,119444,0,2,3
34103,1,1,119443,119444,119445,1,2,0
34104,5,3,119448,119448,119451,0,3,3
34105,2,1,119450,119451,119452,1,2,0
34106,2,3,119452,119452,119455,0,3,0
34107,5,3,119457,119457,119460,0,3,2
34108,1,2,119458,119460,119462,2,4,0
34109,1,1,119459,119462,119463,3,4,0
34110,5,3,119464,119464,119467,0,3,1
34111,2,2,119466,119467,119469,1,3,0
34112,2,1,119468,119469,119470,1,2,0
34113,2,3,119470,119470,119473,0,3,0
34114,2,3,119472,119473,119476,1,4,0
34115,6,1,119478,119478,119479,0,1,2
34116,4,3,119482,119482,119485,0,3,3
34117,1,3,119483,119485,119488,2,5,0
34118,6,1,119489,119489,119490,0,1,1
34119,3,3,119492,119492,119495,0,3,2
34120,5,1,119497,119497,119498,0,1,2
34121,6,2,119503,119503,119505,0,2,5
34122,6,2,119509,119509,119511,0,2,4
34123,1,2,119510,119511,119513,1,3,0
34124,5,1,119515,119515,119516,0,1,2
34125,4,1,119519,119519,119520,0,1,3
34126,4,2,119523,119523,119525,0,2,3
34127,1,2,119524,119525,119527,1,3,0
34128,3,1,119527,119527,119528,0,1,0
34129,3,2,119530,119530,119532,0,2,2
34130,2,1,119532,119532,119533,0,1,0
34131,3,2,119535,119535,119537,0,2,2
34132,4,3,119539,119539,119542,0,3,2
34133,3,1,119542,119542,119543,0,1,0
34134,2,3,119544,119544,119547,0,3,1
34135,3,1,119547,119547,119548,0,1,0
34136,2,2,119549,119549,119551,0,2,1
34137,1,1,119550,119551,119552,1,2,0
34138,1,3,119551,119552,119555,1,4,0
34139,5,1,119556,119556,119557,0,1,1
34140,4,3,119560,119560,119563,0,3,3
34141,5,2,119565,119565,119567,0,2,2
34142,4,1,119569,119569,119570,0,1,2
34143,4,2,119573,119573,119575,0,2,3
34144,4,1,119577,119577,119578,0,1,2
34145,4,3,119581,119581,119584,0,3,3
34146,6,1,119587,119587,119588,0,1,3
34147,1,1,119588,119588,119589,0,1,0
34148,4,3,119592,119592,119595,0,3,3
34149,6,1,119598,119598,119599,0,1,3
34150,3,3,119601,119601,119604,0,3,2
34151,6,1,119607,119607,119608,0,1,3
34152,2,2,119609,119609,119611,0,2,1
34153,6,3,119615,119615,119618,0,3,4
34154,3,1,119618,119618,119619,0,1,0
34155,1,1,119619,119619,119620,0,1,0
34156,6,1,119625,119625,119626,0,1,5
34157,5,2,119630,119630,119632,0,2,4
34158,3,2,119633,119633,119635,0,2,1
34159,5,2,119638,119638,119640,0,2,3
34160,4,1,119642,119642,119643,0,1,2
34161,1,2,119643,119643,119645,0,2,0
34162,3,1,119646,119646,119647,0,1,1
34163,2,3,119648,119648,119651,0,3,1
34164,6,2,119654,119654,119656,0,2,3
34165,6,2,119660,119660,119662,0,2,4
34166,4,3,119664,119664,119667,0,3,2
34167,3,2,119667,119667,119669,0,2,0
34168,1,1,119668,119669,119670,1,2,0
34169,4,2,119672,119672,119674,0,2,2
34170,5,1,119677,119677,119678,0,1,3
34171,6,1,119683,119683,119684,0,1,5
34172,6,3,119689,119689,119692,0,3,5
34173,4,3,119693,119693,119696,0,3,1
34174,1,1,119694,119696,119697,2,3,0
34175,2,3,119696,119697,119700,1,4,0
34176,2,1,119698,119700,119701,2,3,0
34177,3,1,119701,119701,119702,0,1,0
34178,4,3,119705,119705,119708,0,3,3
34179,5,1,119710,119710,119711,0,1,2
34180,5,1,119715,119715,119716,0,1,4
34181,2,3,119717,119717,119720,0,3,1
34182,3,3,119720,119720,119723,0,3,0
34183,1,3,119721,119723,119726,2,5,0
34184,5,2,119726,119726,119728,0,2,0
34185,4,1,119730,119730,119731,0,1,2
34186,3,1,119733,119733,119734,0,1,2
34187,1,2,119734,119734,119736,0,2,0
34188,6,3,119740,119740,119743,0,3,4
34189,5,1,119745,119745,119746,0,1,2
34190,5,3,119750,119750,119753,0,3,4
34191,4,3,119754,119754,119757,0,3,1
34192,3,1,119757,119757,119758,0,1,0
34193,1,2,119758,119758,119760,0,2,0
34194,5,3,119763,119763,119766,0,3,3
34195,6,2,119769,119769,119771,0,2,3
34196,6,2,119775,119775,119777,0,2,4
34197,1,1,119776,119777,119778,1,2,0
34198,4,1,119780,119780,119781,0,1,2
34199,6,2,119786,119786,119788,0,2,5
34200,1,2,119787,119788,119790,1,3,0
34201,2,2,119789,119790,119792,1,3,0
34202,4,1,119793,119793,119794,0,1,1
34203,4,2,119797,119797,119799,0,2,3
34204,1,3,119798,119799,119802,1,4,0
34205,3,1,119801,119802,119803,1,2,0
34206,5,1,119806,119806,119807,0,1,3
34207,1,3,119807,119807,119810,0,3,0
34208,1,1,119808,119810,119811,2,3,0
34209,5,3,119813,119813,119816,0,3,2
34210,1,3,119814,119816,119819,2,5,0
34211,1,1,119815,119819,119820,4,5,0
34212,5,1,119820,119820,119821,0,1,0
34213,5,1,119825,119825,119826,0,1,4
34214,2,1,119827,119827,119828,0,1,1
34215,3,3,119830,119830,119833,0,3,2
34216,4,2,119834,119834,119836,0,2,1
34217,4,1,119838,119838,119839,0,1,2
34218,6,3,119844,119844,119847,0,3,5
34219,3,3,119847,119847,119850,0,3,0
34220,2,1,119849,119850,119851,1,2,0
34221,1,3,119850,119851,119854,1,4,0
34222,1,2,119851,119854,119856,3,5,0
34223,4,1,119855,119856,119857,1,2,0
34224,6,3,119861,119861,119864,0,3,4
34225,3,1,119864,119864,119865,0,1,0
34226,3,3,119867,119867,119870,0,3,2
34227,3,2,119870,119870,119872,0,2,0
34228,2,2,119872,119872,119874,0,2,0
34229,3,2,119875,119875,119877,0,2,1
34230,2,2,119877,119877,119879,0,2,0
34231,1,2,119878,119879,119881,1,3,0
34232,3,3,119881,119881,119884,0,3,0
34233,6,1,119887,119887,119888,0,1,3
34234,6,3,119893,119893,119896,0,3,5
34235,5,3,119898,119898,119901,0,3,2
34236,1,3,119899,119901,119904,2,5,0
34237,1,3,119900,119904,119907,4,7,0
34238,2,1,119902,119907,119908,5,6,0
34239,4,2,119906,119908,119910,2,4,0
34240,3,3,119909,119910,119913,1,4,0
34241,2,3,119911,119913,119916,2,5,0
34242,5,2,119916,119916,119918,0,2,0
34243,2,2,119918,119918,119920,0,2,0
34244,2,1,119920,119920,119921,0,1,0
34245,5,3,119925,119925,119928,0,3,4
34246,2,1,119927,119928,119929,1,2,0
34247,1,3,119928,119929,119932,1,4,0
34248,5,2,119933,119933,119935,0,2,1
34249,4,2,119937,119937,119939,0,2,2
34250,1,2,119938,119939,119941,1,3,0
34251,5,2,119943,119943,119945,0,2,2
34252,3,2,119946,119946,119948,0,2,1
34253,6,1,119952,119952,119953,0,1,4
34254,3,2,119955,119955,119957,0,2,2
34255,1,1,119956,119957,119958,1,2,0
34256,2,2,119958,119958,119960,0,2,0
34257,1,2,119959,119960,119962,1,3,0
34258,2,3,119961,119962,119965,1,4,0
34259,6,1,119967,119967,119968,0,1,2
34260,1,2,119968,119968,119970,0,2,0
34261,2,1,119970,119970,119971,0,1,0
34262,5,3,119975,119975,119978,0,3,4
34263,3,2,119978,119978,119980,0,2,0
34264,5,3,119983,119983,119986,0,3,3
34265,4,2,119987,119987,119989,0,2,1
34266,6,3,119993,119993,119996,0,3,4
34267,6,2,119999,119999,120001,0,2,3
34268,6,3,120005,120005,120008,0,3,4
34269,4,2,120009,120009,120011,0,2,1
34270,1,3,120010,120011,120014,1,4,0
34271,4,2,120014,120014,120016,0,2,0
34272,2,2,120016,120016,120018,0,2,0
34273,2,1,120018,120018,120019,0,1,0
34274,6,2,120024,120024,120026,0,2,5
34275,1,2,120025,120026,120028,1,3,0
34276,2,3,120027,120028,120031,1,4,0
34277,3,3,120030,120031,120034,1,4,0
34278,1,2,120031,120034,120036,3,5,0
34279,2,1,120033,120036,120037,3,4,0
34280,4,3,120037,120037,120040,0,3,0
34281,5,2,120042,120042,120044,0,2,2
34282,4,3,120046,120046,120049,0,3,2
34283,2,1,120048,120049,120050,1,2,0
34284,3,3,120051,120051,120054,0,3,1
34285,3,1,120054,120054,120055,0,1,0
34286,5,2,120059,120059,120061,0,2,4
34287,6,1,120065,120065,120066,0,1,4
34288,3,3,120068,120068,120071,0,3,2
34289,2,1,120070,120071,120072,1,2,0
34290,3,1,120073,120073,120074,0,1,1
34291,4,1,120077,120077,120078,0,1,3
34292,1,3,120078,120078,120081,0,3,0
34293,4,1,120082,120082,120083,0,1,1
34294,2,1,120084,120084,120085,0,1,1
34295,6,1,120090,120090,120091,0,1,5
34296,2,3,120092,120092,120095,0,3,1
34297,1,3,120093,120095,120098,2,5,0
34298,1,2,120094,120098,120100,4,6,0
34299,4,3,120098,120100,120103,2,5,0
34300,1,1,120099,120103,120104,4,5,0
34301,6,2,120105,120105,120107,0,2,1
34302,1,2,120106,120107,120109,1,3,0
34303,3,3,120109,120109,120112,0,3,0
34304,4,1,120113,120113,120114,0,1,1
34305,3,2,120116,120116,120118,0,2,2
34306,1,3,120117,120118,120121,1,4,0
34307,6,2,120123,120123,120125,0,2,2
34308,4,2,120127,120127,120129,0,2,2
34309,4,1,120131,120131,120132,0,1,2
34310,2,1,120133,120133,120134,0,1,1
34311,6,1,120139,120139,120140,0,1,5
34312,6,2,120145,120145,120147,0,2,5
34313,3,2,120148,120148,120150,0,2,1
34314,4,1,120152,120152,120153,0,1,2
34315,4,3,120156,120156,120159,0,3,3
34316,3,3,120159,120159,120162,0,3,0
34317,6,2,120165,120165,120167,0,2,3
34318,3,2,120168,120168,120170,0,2,1
34319,5,2,120173,120173,120175,0,2,3
34320,5,2,120178,120178,120180,0,2,3
34321,2,1,120180,120180,120181,0,1,0
34322,2,3,120182,120182,120185,0,3,1
34323,4,1,120186,120186,120187,0,1,1
34324,3,2,120189,120189,120191,0,2,2
34325,1,3,120190,120191,120194,1,4,0
34326,2,2,120192,120194,120196,2,4,0
34327,6,3,120198,120198,120201,0,3,2
34328,2,1,120200,120201,120202,1,2,0
34329,1,3,120201,120202,120205,1,4,0
34330,6,2,120207,120207,120209,0,2,2
34331,5,2,120212,120212,120214,0,2,3
34332,5,1,120217,120217,120218,0,1,3
34333,5,2,120222,120222,120224,0,2,4
34334,1,1,120223,120224,120225,1,2,0
34335,1,1,120224,120225,120226,1,2,0
34336,1,2,120225,120226,120228,1,3,0
34337,5,3,120230,120230,120233,0,3,2
34338,1,3,120231,120233,120236,2,5,0
34339,5,3,120236,120236,120239,0,3,0
34340,3,3,120239,120239,120242,0,3,0
34341,5,2,120244,120244,120246,0,2,2
34342,2,2,120246,120246,120248,0,2,0
34343,2,3,120248,120248,120251,0,3,0
34344,5,3,120253,120253,120256,0,3,2
34345,4,1,120257,120257,120258,0,1,1
34346,2,1,120259,120259,120260,0,1,1
34347,3,3,120262,120262,120265,0,3,2
34348,3,3,120265,120265,120268,0,3,0
34349,2,2,120267,120268,120270,1,3,0
34350,2,3,120269,120270,120273,1,4,0
34351,4,3,120273,120273,120276,0,3,0
34352,6,2,120279,120279,120281,0,2,3
34353,3,2,120282,120282,120284,0,2,1
34354,2,1,120284,120284,120285,0,1,0
34355,6,1,120290,120290,120291,0,1,5
34356,5,1,120295,120295,120296,0,1,4
34357,2,2,120297,120297,120299,0,2,1
34358,4,3,120301,120301,120304,0,3,2
34359,5,1,120306,120306,120307,0,1,2
34360,6,1,120312,120312,120313,0,1,5
34361,1,1,120313,120313,120314,0,1,0
34362,4,2,120317,120317,120319,0,2,3
34363,6,2,120323,120323,120325,0,2,4
34364,3,3,120326,120326,120329,0,3,1
34365,5,1,120331,120331,120332,0,1,2
34366,1,3,120332,120332,120335,0,3,0
34367,4,3,120336,120336,120339,0,3,1
34368,6,2,120342,120342,120344,0,2,3
34369,6,2,120348,120348,120350,0,2,4
34370,4,2,120352,120352,120354,0,2,2
34371,2,3,120354,120354,120357,0,3,0
34372,3,1,120357,120357,120358,0,1,0
34373,4,2,120361,120361,120363,0,2,3
34374,1,2,120362,120363,120365,1,3,0
34375,1,3,120363,120365,120368,2,5,0
34376,4,1,120367,120368,120369,1,2,0
34377,2,2,120369,120369,120371,0,2,0
34378,4,3,120373,120373,120376,0,3,2
34379,4,2,120377,120377,120379,0,2,1
34380,3,1,120380,120380,120381,0,1,1
34381,5,2,120385,120385,120387,0,2,4
34382,1,2,120386,120387,120389,1,3,0
34383,4,1,120390,120390,120391,0,1,1
34384,5,3,120395,120395,120398,0,3,4
34385,2,3,120397,120398,120401,1,4,0
34386,6,3,120403,120403,120406,0,3,2
34387,2,2,120405,120406,120408,1,3,0
34388,4,2,120409,120409,120411,0,2,1
34389,2,3,120411,120411,120414,0,3,0
34390,2,2,120413,120414,120416,1,3,0
34391,4,1,120417,120417,120418,0,1,1
34392,1,3,120418,120418,120421,0,3,0
34393,6,2,120424,120424,120426,0,2,3
34394,1,3,120425,120426,120429,1,4,0
34395,2,1,120427,120429,120430,2,3,0
34396,4,1,120431,120431,120432,0,1,1
34397,1,1,120432,120432,120433,0,1,0
34398,1,2,120433,120433,120435,0,2,0
34399,4,1,120437,120437,120438,0,1,2
34400,5,1,120442,120442,120443,0,1,4
34401,3,1,120445,120445,120446,0,1,2
34402,3,1,120448,120448,120449,0,1,2
34403,2,2,120450,120450,120452,0,2,1
34404,5,3,120455,120455,120458,0,3,3
34405,6,1,120461,120461,120462,0,1,3
34406,4,1,120465,120465,120466,0,1,3
34407,2,1,120467,120467,120468,0,1,1
34408,4,3,120471,120471,120474,0,3,3
34409,3,1,120474,120474,120475,0,1,0
34410,6,2,120480,120480,120482,0,2,5
34411,2,3,120482,120482,120485,0,3,0
34412,4,3,120486,120486,120489,0,3,1
34413,3,2,120489,120489,120491,0,2,0
34414,4,1,120493,120493,120494,0,1,2
34415,1,1,120494,120494,120495,0,1,0
34416,4,2,120498,120498,120500,0,2,3
34417,4,2,120502,120502,120504,0,2,2
34418,4,2,120506,120506,120508,0,2,2
34419,3,2,120509,120509,120511,0,2,1
34420,4,3,120513,120513,120516,0,3,2
34421,6,1,120519,120519,120520,0,1,3
34422,5,2,120524,120524,120526,0,2,4
34423,4,3,120528,120528,120531,0,3,2
34424,1,3,120529,120531,120534,2,5,0
34425,3,3,120532,120534,120537,2,5,0
34426,3,1,120535,120537,120538,2,3,0
34427,1,1,120536,120538,120539,2,3,0
34428,4,1,120540,120540,120541,0,1,1
34429,4,1,120544,120544,120545,0,1,3
34430,3,2,120547,120547,120549,0,2,2
34431,5,2,120552,120552,120554,0,2,3
34432,2,1,120554,120554,120555,0,1,0
34433,1,3,120555,120555,120558,0,3,0
34434,4,3,120559,120559,120562,0,3,1
34435,3,2,120562,120562,120564,0,2,0
34436,5,2,120567,120567,120569,0,2,3
34437,2,3,120569,120569,120572,0,3,0
34438,1,2,120570,120572,120574,2,4,0
34439,4,1,120574,120574,120575,0,1,0
34440,5,3,120579,120579,120582,0,3,4
34441,6,3,120585,120585,120588,0,3,3
34442,2,1,120587,120588,120589,1,2,0
34443,1,2,120588,120589,120591,1,3,0
34444,3,3,120591,120591,120594,0,3,0
34445,6,1,120597,120597,120598,0,1,3
34446,5,2,120602,120602,120604,0,2,4
34447,3,2,120605,120605,120607,0,2,1
34448,2,3,120607,120607,120610,0,3,0
34449,1,3,120608,120610,120613,2,5,0
34450,3,3,120611,120613,120616,2,5,0
34451,5,3,120616,120616,120619,0,3,0
34452,6,2,120622,120622,120624,0,2,3
34453,1,1,120623,120624,120625,1,2,0
34454,4,3,120627,120627,120630,0,3,2
34455,4,2,120631,120631,120633,0,2,1
34456,1,3,120632,120633,120636,1,4,0
34457,3,2,120635,120636,120638,1,3,0
34458,2,1,120637,120638,120639,1,2,0
34459,6,3,120643,120643,120646,0,3,4
34460,6,3,120649,120649,120652,0,3,3
34461,5,1,120654,120654,120655,0,1,2
34462,3,1,120657,120657,120658,0,1,2
34463,2,1,120659,120659,120660,0,1,1
34464,6,2,120665,120665,120667,0,2,5
34465,3,3,120668,120668,120671,0,3,1
34466,5,2,120673,120673,120675,0,2,2
34467,2,2,120675,120675,120677,0,2,0
34468,1,1,120676,120677,120678,1,2,0
34469,1,3,120677,120678,120681,1,4,0
34470,4,3,120681,120681,120684,0,3,0
34471,4,1,120685,120685,120686,0,1,1
34472,4,1,120689,120689,120690,0,1,3
34473,2,2,120691,120691,120693,0,2,1
34474,3,1,120694,120694,120695,0,1,1
34475,5,1,120699,120699,120700,0,1,4
34476,4,2,120703,120703,120705,0,2,3
34477,2,2,120705,120705,120707,0,2,0
34478,1,2,120706,120707,120709,1,3,0
34479,1,2,120707,120709,120711,2,4,0
34480,2,3,120709,120711,120714,2,5,0
34481,1,2,120710,120714,120716,4,6,0
34482,3,3,120713,120716,120719,3,6,0
34483,3,1,120716,120719,120720,3,4,0
34484,5,3,120721,120721,120724,0,3,1
34485,1,3,120722,120724,120727,2,5,0
34486,6,1,120728,120728,120729,0,1,1
34487,3,1,120731,120731,120732,0,1,2
34488,4,2,120735,120735,120737,0,2,3
34489,6,3,120741,120741,120744,0,3,4
34490,4,1,120745,120745,120746,0,1,1
34491,5,1,120750,120750,120751,0,1,4
34492,3,3,120753,120753,120756,0,3,2
34493,3,3,120756,120756,120759,0,3,0
34494,4,3,120760,120760,120763,0,3,1
34495,3,3,120763,120763,120766,0,3,0
34496,3,2,120766,120766,120768,0,2,0
34497,5,2,120771,120771,120773,0,2,3
34498,1,3,120772,120773,120776,1,4,0
34499,6,2,120778,120778,120780,0,2,2
34500,4,3,120782,120782,120785,0,3,2
34501,1,1,120783,120785,120786,2,3,0
34502,2,2,120785,120786,120788,1,3,0
34503,2,3,120787,120788,120791,1,4,0
34504,3,2,120790,120791,120793,1,3,0
34505,6,1,120796,120796,120797,0,1,3
34506,3,2,120799,120799,120801,0,2,2
34507,3,1,120802,120802,120803,0,1,1
34508,2,3,120804,120804,120807,0,3,1
34509,6,3,120810,120810,120813,0,3,3
34510,5,3,120815,120815,120818,0,3,2
34511,2,1,120817,120818,120819,1,2,0
34512,5,3,120822,120822,120825,0,3,3
34513,2,2,120824,120825,120827,1,3,0
34514,6,3,120830,120830,120833,0,3,3
34515,6,1,120836,120836,120837,0,1,3
34516,5,1,120841,120841,120842,0,1,4
34517,5,3,120846,120846,120849,0,3,4
34518,2,2,120848,120849,120851,1,3,0
34519,6,3,120854,120854,120857,0,3,3
34520,5,2,120859,120859,120861,0,2,2
34521,5,1,120864,120864,120865,0,1,3
34522,2,2,120866,120866,120868,0,2,1
34523,1,1,120867,120868,120869,1,2,0
34524,3,1,120870,120870,120871,0,1,1
34525,2,2,120872,120872,120874,0,2,1
34526,4,3,120876,120876,120879,0,3,2
34527,2,1,120878,120879,120880,1,2,0
34528,5,2,120883,120883,120885,0,2,3
34529,4,1,120887,120887,120888,0,1,2
34530,4,2,120891,120891,120893,0,2,3
34531,3,1,120894,120894,120895,0,1,1
34532,6,2,120900,120900,120902,0,2,5
34533,2,2,120902,120902,120904,0,2,0
34534,3,2,120905,120905,120907,0,2,1
34535,2,2,120907,120907,120909,0,2,0
34536,5,1,120912,120912,120913,0,1,3
34537,3,3,120915,120915,120918,0,3,2
34538,4,2,120919,120919,120921,0,2,1
34539,1,2,120920,120921,120923,1,3,0
34540,4,1,120924,120924,120925,0,1,1
34541,4,1,120928,120928,120929,0,1,3
34542,3,3,120931,120931,120934,0,3,2
34543,4,2,120935,120935,120937,0,2,1
34544,6,2,120941,120941,120943,0,2,4
34545,5,2,120946,120946,120948,0,2,3
34546,4,3,120950,120950,120953,0,3,2
34547,6,1,120956,120956,120957,0,1,3
34548,1,3,120957,120957,120960,0,3,0
34549,4,3,120961,120961,120964,0,3,1
34550,5,1,120966,120966,120967,0,1,2
34551,1,2,120967,120967,120969,0,2,0
34552,6,3,120973,120973,120976,0,3,4
34553,2,1,120975,120976,120977,1,2,0
34554,6,2,120981,120981,120983,0,2,4
34555,1,1,120982,120983,120984,1,2,0
34556,2,1,120984,120984,120985,0,1,0
34557,2,1,120986,120986,120987,0,1,1
34558,4,1,120990,120990,120991,0,1,3
34559,5,1,120995,120995,120996,0,1,4
34560,6,3,121001,121001,121004,0,3,5
34561,4,3,121005,121005,121008,0,3,1
34562,5,2,121010,121010,121012,0,2,2
34563,6,1,121016,121016,121017,0,1,4
34564,1,1,121017,121017,121018,0,1,0
34565,6,1,121023,121023,121024,0,1,5
34566,2,2,121025,121025,121027,0,2,1
34567,5,1,121030,121030,121031,0,1,3
34568,3,3,121033,121033,121036,0,3,2
34569,3,3,121036,121036,121039,0,3,0
34570,5,2,121041,121041,121043,0,2,2
34571,2,2,121043,121043,121045,0,2,0
34572,5,3,121048,121048,121051,0,3,3
34573,1,1,121049,121051,121052,2,3,0
34574,2,1,121051,121052,121053,1,2,0
34575,1,2,121052,121053,121055,1,3,0
34576,1,3,121053,121055,121058,2,5,0
34577,6,2,121059,121059,121061,0,2,1
34578,6,1,121065,121065,121066,0,1,4
34579,3,3,121068,121068,121071,0,3,2
34580,4,2,121072,121072,121074,0,2,1
34581,4,2,121076,121076,121078,0,2,2
34582,6,3,121082,121082,121085,0,3,4
34583,2,1,121084,121085,121086,1,2,0
34584,5,2,121089,121089,121091,0,2,3
34585,5,3,121094,121094,121097,0,3,3
34586,1,2,121095,121097,121099,2,4,0
34587,6,1,121101,121101,121102,0,1,2
34588,2,3,121103,121103,121106,0,3,1
34589,4,1,121107,121107,121108,0,1,1
34590,5,1,121112,121112,121113,0,1,4
34591,3,1,121115,121115,121116,0,1,2
34592,5,3,121120,121120,121123,0,3,4
34593,3,3,121123,121123,121126,0,3,0
34594,1,2,121124,121126,121128,2,4,0
34595,1,2,121125,121128,121130,3,5,0
34596,2,3,121127,121130,121133,3,6,0
34597,3,1,121130,121133,121134,3,4,0
34598,6,1,121136,121136,121137,0,1,2
34599,6,2,121142,121142,121144,0,2,5
34600,4,1,121146,121146,121147,0,1,2
34601,3,2,121149,121149,121151,0,2,2
34602,6,1,121155,121155,121156,0,1,4
34603,6,2,121161,121161,121163,0,2,5
34604,6,2,121167,121167,121169,0,2,4
34605,3,3,121170,121170,121173,0,3,1
34606,6,1,121176,121176,121177,0,1,3
34607,5,3,121181,121181,121184,0,3,4
34608,1,2,121182,121184,121186,2,4,0
34609,5,2,121187,121187,121189,0,2,1
34610,5,2,121192,121192,121194,0,2,3
34611,6,2,121198,121198,121200,0,2,4
34612,2,1,121200,121200,121201,0,1,0
34613,6,1,121206,121206,121207,0,1,5
34614,5,2,121211,121211,121213,0,2,4
34615,2,2,121213,121213,121215,0,2,0
34616,2,1,121215,121215,121216,0,1,0
34617,5,3,121220,121220,121223,0,3,4
34618,6,3,121226,121226,121229,0,3,3
34619,1,2,121227,121229,121231,2,4,0
34620,3,1,121230,121231,121232,1,2,0
34621,5,1,121235,121235,121236,0,1,3
34622,5,3,121240,121240,121243,0,3,4
34623,1,1,121241,121243,121244,2,3,0
34624,4,3,121245,121245,121248,0,3,1
34625,4,2,121249,121249,121251,0,2,1
34626,4,2,121253,121253,121255,0,2,2
34627,6,3,121259,121259,121262,0,3,4
34628,2,3,121261,121262,121265,1,4,0
34629,6,2,121267,121267,121269,0,2,2
34630,5,1,121272,121272,121273,0,1,3
34631,1,1,121273,121273,121274,0,1,0
34632,6,3,121279,121279,121282,0,3,5
34633,1,1,121280,121282,121283,2,3,0
34634,6,1,121286,121286,121287,0,1,3
34635,6,3,121292,121292,121295,0,3,5
34636,5,2,121297,121297,121299,0,2,2
34637,5,2,121302,121302,121304,0,2,3
34638,2,2,121304,121304,121306,0,2,0
34639,6,2,121310,121310,121312,0,2,4
34640,5,1,121315,121315,121316,0,1,3
34641,3,1,121318,121318,121319,0,1,2
34642,6,2,121324,121324,121326,0,2,5
34643,5,2,121329,121329,121331,0,2,3
34644,3,3,121332,121332,121335,0,3,1
34645,3,2,121335,121335,121337,0,2,0
34646,6,3,121341,121341,121344,0,3,4
34647,3,3,121344,121344,121347,0,3,0
34648,4,1,121348,121348,121349,0,1,1
34649,4,3,121352,121352,121355,0,3,3
34650,4,1,121356,121356,121357,0,1,1
34651,2,3,121358,121358,121361,0,3,1
34652,3,1,121361,121361,121362,0,1,0
34653,5,3,121366,121366,121369,0,3,4
34654,4,2,121370,121370,121372,0,2,1
34655,2,2,121372,121372,121374,0,2,0
34656,6,2,121378,121378,121380,0,2,4
34657,3,1,121381,121381,121382,0,1,1
34658,1,1,121382,121382,121383,0,1,0
34659,6,2,121388,121388,121390,0,2,5
34660,5,3,121393,121393,121396,0,3,3
34661,6,2,121399,121399,121401,0,2,3
34662,2,2,121401,121401,121403,0,2,0
34663,5,3,121406,121406,121409,0,3,3
34664,3,3,121409,121409,121412,0,3,0
34665,4,3,121413,121413,121416,0,3,1
34666,2,1,121415,121416,121417,1,2,0
34667,2,3,121417,121417,121420,0,3,0
34668,4,3,121421,121421,121424,0,3,1
34669,2,3,121423,121424,121427,1,4,0
34670,1,2,121424,121427,121429,3,5,0
34671,6,1,121430,121430,121431,0,1,1
34672,1,2,121431,121431,121433,0,2,0
34673,2,2,121433,121433,121435,0,2,0
34674,6,2,121439,121439,121441,0,2,4
34675,2,3,121441,121441,121444,0,3,0
34676,2,3,121443,121444,121447,1,4,0
34677,6,2,121449,121449,121451,0,2,2
34678,4,2,121453,121453,121455,0,2,2
34679,2,2,121455,121455,121457,0,2,0
34680,2,2,121457,121457,121459,0,2,0
34681,2,1,121459,121459,121460,0,1,0
34682,6,3,121465,121465,121468,0,3,5
34683,6,3,121471,121471,121474,0,3,3
34684,1,3,121472,121474,121477,2,5,0
34685,6,1,121478,121478,121479,0,1,1
34686,1,1,121479,121479,121480,0,1,0
34687,3,3,121482,121482,121485,0,3,2
34688,3,3,121485,121485,121488,0,3,0
34689,3,2,121488,121488,121490,0,2,0
34690,1,1,121489,121490,121491,1,2,0
34691,6,2,121495,121495,121497,0,2,4
34692,4,1,121499,121499,121500,0,1,2
34693,4,1,121503,121503,121504,0,1,3
34694,3,1,121506,121506,121507,0,1,2
34695,4,2,121510,121510,121512,0,2,3
34696,3,3,121513,121513,121516,0,3,1
34697,2,2,121515,121516,121518,1,3,0
34698,1,3,121516,121518,121521,2,5,0
34699,1,2,121517,121521,121523,4,6,0
34700,1,2,121518,121523,121525,5,7,0
34701,2,2,121520,121525,121527,5,7,0
34702,3,2,121523,121527,121529,4,6,0
34703,2,2,121525,121529,121531,4,6,0
34704,3,3,121528,121531,121534,3,6,0
34705,5,2,121533,121534,121536,1,3,0
34706,6,2,121539,121539,121541,0,2,3
34707,1,1,121540,121541,121542,1,2,0
34708,5,1,121545,121545,121546,0,1,3
34709,3,2,121548,121548,121550,0,2,2
34710,6,1,121554,121554,121555,0,1,4
34711,2,2,121556,121556,121558,0,2,1
34712,5,2,121561,121561,121563,0,2,3
34713,3,2,121564,121564,121566,0,2,1
34714,4,1,121568,121568,121569,0,1,2
34715,4,2,121572,121572,121574,0,2,3
34716,3,2,121575,121575,121577,0,2,1
34717,1,1,121576,121577,121578,1,2,0
34718,3,3,121579,121579,121582,0,3,1
34719,1,3,121580,121582,121585,2,5,0
34720,4,1,121584,121585,121586,1,2,0
34721,6,2,121590,121590,121592,0,2,4
34722,6,3,121596,121596,121599,0,3,4
34723,1,1,121597,121599,121600,2,3,0
34724,1,1,121598,121600,121601,2,3,0
34725,2,3,121600,121601,121604,1,4,0
34726,3,2,121603,121604,121606,1,3,0
34727,3,3,121606,121606,121609,0,3,0
34728,4,2,121610,121610,121612,0,2,1
34729,6,3,121616,121616,121619,0,3,4
34730,3,3,121619,121619,121622,0,3,0
34731,6,2,121625,121625,121627,0,2,3
34732,5,3,121630,121630,121633,0,3,3
34733,3,2,121633,121633,121635,0,2,0
34734,5,2,121638,121638,121640,0,2,3
34735,5,2,121643,121643,121645,0,2,3
34736,4,2,121647,121647,121649,0,2,2
34737,1,2,121648,121649,121651,1,3,0
34738,1,3,121649,121651,121654,2,5,0
34739,4,3,121653,121654,121657,1,4,0
34740,3,1,121656,121657,121658,1,2,0
34741,6,1,121662,121662,121663,0,1,4
34742,6,2,121668,121668,121670,0,2,5
34743,1,2,121669,121670,121672,1,3,0
34744,5,2,121674,121674,121676,0,2,2
34745,5,1,121679,121679,121680,0,1,3
34746,3,1,121682,121682,121683,0,1,2
34747,3,2,121685,121685,121687,0,2,2
34748,4,3,121689,121689,121692,0,3,2
34749,6,2,121695,121695,121697,0,2,3
34750,4,2,121699,121699,121701,0,2,2
34751,3,3,121702,121702,121705,0,3,1
34752,4,2,121706,121706,121708,0,2,1
34753,6,3,121712,121712,121715,0,3,4
34754,1,2,121713,121715,121717,2,4,0
34755,2,2,121715,121717,121719,2,4,0
34756,3,2,121718,121719,121721,1,3,0
34757,1,2,121719,121721,121723,2,4,0
34758,2,2,121721,121723,121725,2,4,0
34759,3,2,121724,121725,121727,1,3,0
34760,1,1,121725,121727,121728,2,3,0
34761,2,3,121727,121728,121731,1,4,0
34762,5,2,121732,121732,121734,0,2,1
34763,3,3,121735,121735,121738,0,3,1
34764,2,1,121737,121738,121739,1,2,0
34765,4,1,121741,121741,121742,0,1,2
34766,4,3,121745,121745,121748,0,3,3
34767,5,2,121750,121750,121752,0,2,2
34768,2,3,121752,121752,121755,0,3,0
34769,1,1,121753,121755,121756,2,3,0
34770,2,2,121755,121756,121758,1,3,0
34771,5,3,121760,121760,121763,0,3,2
34772,6,1,121766,121766,121767,0,1,3
34773,2,2,121768,121768,121770,0,2,1
34774,1,1,121769,121770,121771,1,2,0
34775,4,1,121773,121773,121774,0,1,2
34776,6,3,121779,121779,121782,0,3,5
34777,2,1,121781,121782,121783,1,2,0
34778,4,1,121785,121785,121786,0,1,2
34779,1,1,121786,121786,121787,0,1,0
34780,2,3,121788,121788,121791,0,3,1
34781,1,2,121789,121791,121793,2,4,0
34782,6,1,121795,121795,121796,0,1,2
34783,4,1,121799,121799,121800,0,1,3
34784,4,1,121803,121803,121804,0,1,3
34785,1,3,121804,121804,121807,0,3,0
34786,5,1,121809,121809,121810,0,1,2
34787,3,2,121812,121812,121814,0,2,2
34788,6,3,121818,121818,121821,0,3,4
34789,5,3,121823,121823,121826,0,3,2
34790,2,1,121825,121826,121827,1,2,0
34791,4,1,121829,121829,121830,0,1,2
34792,4,1,121833,121833,121834,0,1,3
34793,6,3,121839,121839,121842,0,3,5
34794,1,3,121840,121842,121845,2,5,0
34795,4,3,121844,121845,121848,1,4,0
34796,1,1,121845,121848,121849,3,4,0
34797,2,2,121847,121849,121851,2,4,0
34798,6,1,121853,121853,121854,0,1,2
34799,6,3,121859,121859,121862,0,3,5
34800,1,2,121860,121862,121864,2,4,0
34801,4,2,121864,121864,121866,0,2,0
34802,6,2,121870,121870,121872,0,2,4
34803,5,2,121875,121875,121877,0,2,3
34804,3,1,121878,121878,121879,0,1,1
34805,2,3,121880,121880,121883,0,3,1
34806,1,3,121881,121883,121886,2,5,0
34807,6,1,121887,121887,121888,0,1,1
34808,3,1,121890,121890,121891,0,1,2
34809,6,1,121896,121896,121897,0,1,5
34810,2,3,121898,121898,121901,0,3,1
34811,3,3,121901,121901,121904,0,3,0
34812,1,1,121902,121904,121905,2,3,0
34813,6,2,121908,121908,121910,0,2,3
34814,1,3,121909,121910,121913,1,4,0
34815,5,1,121914,121914,121915,0,1,1
34816,2,2,121916,121916,121918,0,2,1
34817,1,1,121917,121918,121919,1,2,0
34818,6,1,121923,121923,121924,0,1,4
34819,6,3,121929,121929,121932,0,3,5
34820,4,2,121933,121933,121935,0,2,1
34821,3,1,121936,121936,121937,0,1,1
34822,4,2,121940,121940,121942,0,2,3
34823,1,3,121941,121942,121945,1,4,0
34824,6,2,121947,121947,121949,0,2,2
34825,1,2,121948,121949,121951,1,3,0
34826,5,2,121953,121953,121955,0,2,2
34827,1,1,121954,121955,121956,1,2,0
34828,3,2,121957,121957,121959,0,2,1
34829,2,2,121959,121959,121961,0,2,0
34830,6,3,121965,121965,121968,0,3,4
34831,6,3,121971,121971,121974,0,3,3
34832,4,1,121975,121975,121976,0,1,1
34833,4,1,121979,121979,121980,0,1,3
34834,4,3,121983,121983,121986,0,3,3
34835,5,3,121988,121988,121991,0,3,2
34836,4,1,121992,121992,121993,0,1,1
34837,6,2,121998,121998,122000,0,2,5
34838,4,3,122002,122002,122005,0,3,2
34839,1,1,122003,122005,122006,2,3,0
34840,3,1,122006,122006,122007,0,1,0
34841,2,1,122008,122008,122009,0,1,1
34842,3,1,122011,122011,122012,0,1,2
34843,2,2,122013,122013,122015,0,2,1
34844,5,3,122018,122018,122021,0,3,3
34845,4,2,122022,122022,122024,0,2,1
34846,5,3,122027,122027,122030,0,3,3
34847,5,1,122032,122032,122033,0,1,2
34848,3,1,122035,122035,122036,0,1,2
34849,6,2,122041,122041,122043,0,2,5
34850,4,2,122045,122045,122047,0,2,2
34851,4,3,122049,122049,122052,0,3,2
34852,2,1,122051,122052,122053,1,2,0
34853,4,2,122055,122055,122057,0,2,2
34854,4,1,122059,122059,122060,0,1,2
34855,6,3,122065,122065,122068,0,3,5
34856,3,1,122068,122068,122069,0,1,0
34857,6,1,122074,122074,122075,0,1,5
34858,1,2,122075,122075,122077,0,2,0
34859,4,2,122079,122079,122081,0,2,2
34860,1,3,122080,122081,122084,1,4,0
34861,1,2,122081,122084,122086,3,5,0
34862,4,1,122085,122086,122087,1,2,0
34863,3,2,122088,122088,122090,0,2,1
34864,1,1,122089,122090,122091,1,2,0
34865,6,1,122095,122095,122096,0,1,4
34866,1,1,122096,122096,122097,0,1,0
34867,2,2,122098,122098,122100,0,2,1
34868,1,1,122099,122100,122101,1,2,0
34869,3,1,122102,122102,122103,0,1,1
34870,2,3,122104,122104,122107,0,3,1
34871,5,3,122109,122109,122112,0,3,2
34872,5,3,122114,122114,122117,0,3,2
34873,1,1,122115,122117,122118,2,3,0
34874,5,3,122120,122120,122123,0,3,2
34875,5,3,122125,122125,122128,0,3,2
34876,6,3,122131,122131,122134,0,3,3
34877,1,2,122132,122134,122136,2,4,0
34878,2,1,122134,122136,122137,2,3,0
34879,1,2,122135,122137,122139,2,4,0
34880,6,3,122141,122141,122144,0,3,2
34881,1,1,122142,122144,122145,2,3,0
34882,5,3,122147,122147,122150,0,3,2
34883,5,1,122152,122152,122153,0,1,2
34884,6,1,122158,122158,122159,0,1,5
34885,5,2,122163,122163,122165,0,2,4
34886,6,1,122169,122169,122170,0,1,4
34887,3,2,122172,122172,122174,0,2,2
34888,3,3,122175,122175,122178,0,3,1
34889,6,2,122181,122181,122183,0,2,3
34890,4,2,122185,122185,122187,0,2,2
34891,5,1,122190,122190,122191,0,1,3
34892,6,3,122196,122196,122199,0,3,5
34893,6,2,122202,122202,122204,0,2,3
34894,3,2,122205,122205,122207,0,2,1
34895,4,1,122209,122209,122210,0,1,2
34896,5,3,122214,122214,122217,0,3,4
34897,5,3,122219,122219,122222,0,3,2
34898,5,1,122224,122224,122225,0,1,2
34899,1,2,122225,122225,122227,0,2,0
34900,5,2,122230,122230,122232,0,2,3
34901,2,2,122232,122232,122234,0,2,0
34902,6,2,122238,122238,122240,0,2,4
34903,1,3,122239,122240,122243,1,4,0
34904,2,2,122241,122243,122245,2,4,0
34905,4,3,122245,122245,122248,0,3,0
34906,6,1,122251,122251,122252,0,1,3
34907,4,2,122255,122255,122257,0,2,3
34908,2,2,122257,122257,122259,0,2,0
34909,3,3,122260,122260,122263,0,3,1
34910,5,1,122265,122265,122266,0,1,2
34911,4,3,122269,122269,122272,0,3,3
34912,6,2,122275,122275,122277,0,2,3
34913,4,3,122279,122279,122282,0,3,2
34914,1,2,122280,122282,122284,2,4,0
34915,2,1,122282,122284,122285,2,3,0
34916,2,3,122284,122285,122288,1,4,0
34917,3,2,122287,122288,122290,1,3,0
34918,6,3,122293,122293,122296,0,3,3
34919,4,3,122297,122297,122300,0,3,1
34920,2,3,122299,122300,122303,1,4,0
34921,6,1,122305,122305,122306,0,1,2
34922,4,2,122309,122309,122311,0,2,3
34923,4,1,122313,122313,122314,0,1,2
34924,5,3,122318,122318,122321,0,3,4
34925,3,2,122321,122321,122323,0,2,0
34926,6,3,122327,122327,122330,0,3,4
34927,4,2,122331,122331,122333,0,2,1
34928,4,1,122335,122335,122336,0,1,2
34929,4,2,122339,122339,122341,0,2,3
34930,6,1,122345,122345,122346,0,1,4
34931,3,1,122348,122348,122349,0,1,2
34932,4,3,122352,122352,122355,0,3,3
34933,1,2,122353,122355,122357,2,4,0
34934,4,1,122357,122357,122358,0,1,0
34935,2,1,122359,122359,122360,0,1,1
34936,5,1,122364,122364,122365,0,1,4
34937,6,2,122370,122370,122372,0,2,5
34938,6,3,122376,122376,122379,0,3,4
34939,3,2,122379,122379,122381,0,2,0
34940,5,1,122384,122384,122385,0,1,3
34941,2,3,122386,122386,122389,0,3,1
34942,2,1,122388,122389,122390,1,2,0
34943,1,1,122389,122390,122391,1,2,0
34944,4,1,122393,122393,122394,0,1,2
34945,2,1,122395,122395,122396,0,1,1
34946,3,1,122398,122398,122399,0,1,2
34947,1,2,122399,122399,122401,0,2,0
34948,5,3,122404,122404,122407,0,3,3
34949,4,2,122408,122408,122410,0,2,1
34950,2,3,122410,122410,122413,0,3,0
34951,1,3,122411,122413,122416,2,5,0
34952,4,1,122415,122416,122417,1,2,0
34953,1,2,122416,122417,122419,1,3,0
34954,1,1,122417,122419,122420,2,3,0
34955,5,3,122422,122422,122425,0,3,2
34956,6,3,122428,122428,122431,0,3,3
34957,2,1,122430,122431,122432,1,2,0
34958,5,3,122435,122435,122438,0,3,3
34959,5,3,122440,122440,122443,0,3,2
34960,4,3,122444,122444,122447,0,3,1
34961,6,1,122450,122450,122451,0,1,3
34962,1,1,122451,122451,122452,0,1,0
34963,4,1,122455,122455,122456,0,1,3
34964,5,3,122460,122460,122463,0,3,4
34965,4,3,122464,122464,122467,0,3,1
34966,5,2,122469,122469,122471,0,2,2
34967,5,1,122474,122474,122475,0,1,3
34968,2,2,122476,122476,122478,0,2,1
34969,6,3,122482,122482,122485,0,3,4
34970,5,1,122487,122487,122488,0,1,2
34971,2,2,122489,122489,122491,0,2,1
34972,3,3,122492,122492,122495,0,3,1
34973,2,1,122494,122495,122496,1,2,0
34974,4,3,122498,122498,122501,0,3,2
34975,3,3,122501,122501,122504,0,3,0
34976,2,3,122503,122504,122507,1,4,0
34977,5,2,122508,122508,122510,0,2,1
34978,3,3,122511,122511,122514,0,3,1
34979,5,2,122516,122516,122518,0,2,2
34980,4,3,122520,122520,122523,0,3,2
34981,5,3,122525,122525,122528,0,3,2
34982,4,3,122529,122529,122532,0,3,1
34983,3,1,122532,122532,122533,0,1,0
34984,6,1,122538,122538,122539,0,1,5
34985,4,2,122542,122542,122544,0,2,3
34986,3,2,122545,122545,122547,0,2,1
34987,3,2,122548,122548,122550,0,2,1
34988,5,3,122553,122553,122556,0,3,3
34989,1,2,122554,122556,122558,2,4,0
34990,6,3,122560,122560,122563,0,3,2
34991,4,1,122564,122564,122565,0,1,1
34992,2,3,122566,122566,122569,0,3,1
34993,4,2,122570,122570,122572,0,2,1
34994,6,1,122576,122576,122577,0,1,4
34995,1,2,122577,122577,122579,0,2,0
34996,6,1,122583,122583,122584,0,1,4
34997,1,2,122584,122584,122586,0,2,0
34998,6,2,122590,122590,122592,0,2,4
34999,5,3,122595,122595,122598,0,3,3
35000,4,3,122599,122599,122602,0,3,1
35001,2,1,122601,122602,122603,1,2,0
35002,5,3,122606,122606,122609,0,3,3
35003,5,2,122611,122611,122613,0,2,2
35004,6,3,122617,122617,122620,0,3,4
35005,6,3,122623,122623,122626,0,3,3
35006,5,1,122628,122628,122629,0,1,2
35007,1,2,122629,122629,122631,0,2,0
35008,4,2,122633,122633,122635,0,2,2
35009,5,3,122638,122638,122641,0,3,3
35010,2,1,122640,122641,122642,1,2,0
35011,2,3,122642,122642,122645,0,3,0
35012,3,1,122645,122645,122646,0,1,0
35013,2,3,122647,122647,122650,0,3,1
35014,5,2,122652,122652,122654,0,2,2
35015,3,1,122655,122655,122656,0,1,1
35016,6,1,122661,122661,122662,0,1,5
35017,4,2,122665,122665,122667,0,2,3
35018,6,2,122671,122671,122673,0,2,4
35019,3,1,122674,122674,122675,0,1,1
35020,1,1,122675,122675,122676,0,1,0
35021,2,2,122677,122677,122679,0,2,1
35022,3,2,122680,122680,122682,0,2,1
35023,6,2,122686,122686,122688,0,2,4
35024,1,2,122687,122688,122690,1,3,0
35025,3,2,122690,122690,122692,0,2,0
35026,1,3,122691,122692,122695,1,4,0
35027,5,1,122696,122696,122697,0,1,1
35028,1,1,122697,122697,122698,0,1,0
35029,5,2,122702,122702,122704,0,2,4
35030,6,1,122708,122708,122709,0,1,4
35031,6,1,122714,122714,122715,0,1,5
35032,1,1,122715,122715,122716,0,1,0
35033,1,2,122716,122716,122718,0,2,0
35034,5,2,122721,122721,122723,0,2,3
35035,5,1,122726,122726,122727,0,1,3
35036,2,1,122728,122728,122729,0,1,1
35037,2,3,122730,122730,122733,0,3,1
35038,2,2,122732,122733,122735,1,3,0
35039,4,3,122736,122736,122739,0,3,1
35040,1,3,122737,122739,122742,2,5,0
35041,2,2,122739,122742,122744,3,5,0
35042,6,1,122745,122745,122746,0,1,1
35043,1,3,122746,122746,122749,0,3,0
35044,6,2,122752,122752,122754,0,2,3
35045,4,1,122756,122756,122757,0,1,2
35046,1,2,122757,122757,122759,0,2,0
35047,3,1,122760,122760,122761,0,1,1
35048,5,1,122765,122765,122766,0,1,4
35049,3,2,122768,122768,122770,0,2,2
35050,1,3,122769,122770,122773,1,4,0
35051,4,2,122773,122773,122775,0,2,0
35052,2,2,122775,122775,122777,0,2,0
35053,1,1,122776,122777,122778,1,2,0
35054,1,1,122777,122778,122779,1,2,0
35055,5,1,122782,122782,122783,0,1,3
35056,3,1,122785,122785,122786,0,1,2
35057,1,2,122786,122786,122788,0,2,0
35058,5,1,122791,122791,122792,0,1,3
35059,6,2,122797,122797,122799,0,2,5
35060,2,3,122799,122799,122802,0,3,0
35061,4,2,122803,122803,122805,0,2,1
35062,4,3,122807,122807,122810,0,3,2
35063,4,1,122811,122811,122812,0,1,1
35064,3,2,122814,122814,122816,0,2,2
35065,2,3,122816,122816,122819,0,3,0
35066,5,3,122821,122821,122824,0,3,2
35067,5,1,122826,122826,122827,0,1,2
35068,3,2,122829,122829,122831,0,2,2
35069,1,2,122830,122831,122833,1,3,0
35070,5,2,122835,122835,122837,0,2,2
35071,3,2,122838,122838,122840,0,2,1
35072,6,3,122844,122844,122847,0,3,4
35073,6,1,122850,122850,122851,0,1,3
35074,3,1,122853,122853,122854,0,1,2
35075,4,1,122857,122857,122858,0,1,3
35076,4,1,122861,122861,122862,0,1,3
35077,1,3,122862,122862,122865,0,3,0
35078,6,1,122868,122868,122869,0,1,3
35079,4,3,122872,122872,122875,0,3,3
35080,4,3,122876,122876,122879,0,3,1
35081,5,1,122881,122881,122882,0,1,2
35082,6,2,122887,122887,122889,0,2,5
35083,6,1,122893,122893,122894,0,1,4
35084,5,3,122898,122898,122901,0,3,4
35085,3,2,122901,122901,122903,0,2,0
35086,5,3,122906,122906,122909,0,3,3
35087,6,1,122912,122912,122913,0,1,3
35088,5,3,122917,122917,122920,0,3,4
35089,4,3,122921,122921,122924,0,3,1
35090,2,2,122923,122924,122926,1,3,0
35091,3,3,122926,122926,122929,0,3,0
35092,2,1,122928,122929,122930,1,2,0
35093,4,1,122932,122932,122933,0,1,2
35094,3,2,122935,122935,122937,0,2,2
35095,3,2,122938,122938,122940,0,2,1
35096,5,3,122943,122943,122946,0,3,3
35097,4,2,122947,122947,122949,0,2,1
35098,5,3,122952,122952,122955,0,3,3
35099,6,3,122958,122958,122961,0,3,3
35100,6,3,122964,122964,122967,0,3,3
35101,6,2,122970,122970,122972,0,2,3
35102,2,2,122972,122972,122974,0,2,0
35103,6,3,122978,122978,122981,0,3,4
35104,6,2,122984,122984,122986,0,2,3
35105,4,2,122988,122988,122990,0,2,2
35106,3,1,122991,122991,122992,0,1,1
35107,4,2,122995,122995,122997,0,2,3
35108,2,3,122997,122997,123000,0,3,0
35109,2,3,122999,123000,123003,1,4,0
35110,4,1,123003,123003,123004,0,1,0
35111,1,3,123004,123004,123007,0,3,0
35112,5,3,123009,123009,123012,0,3,2
35113,6,2,123015,123015,123017,0,2,3
35114,1,2,123016,123017,123019,1,3,0
35115,3,2,123019,123019,123021,0,2,0
35116,6,2,123025,123025,123027,0,2,4
35117,6,3,123031,123031,123034,0,3,4
35118,5,3,123036,123036,123039,0,3,2
35119,4,3,123040,123040,123043,0,3,1
35120,3,2,123043,123043,123045,0,2,0
35121,3,1,123046,123046,123047,0,1,1
35122,5,1,123051,123051,123052,0,1,4
35123,2,1,123053,123053,123054,0,1,1
35124,1,3,123054,123054,123057,0,3,0
35125,5,1,123059,123059,123060,0,1,2
35126,3,1,123062,123062,123063,0,1,2
35127,3,3,123065,123065,123068,0,3,2
35128,5,1,123070,123070,123071,0,1,2
35129,5,3,123075,123075,123078,0,3,4
35130,6,3,123081,123081,123084,0,3,3
35131,1,1,123082,123084,123085,2,3,0
35132,1,1,123083,123085,123086,2,3,0
35133,4,1,123087,123087,123088,0,1,1
35134,3,2,123090,123090,123092,0,2,2
35135,1,3,123091,123092,123095,1,4,0
35136,2,1,123093,123095,123096,2,3,0
35137,3,1,123096,123096,123097,0,1,0
35138,1,2,123097,123097,123099,0,2,0
35139,6,3,123103,123103,123106,0,3,4
35140,4,1,123107,123107,123108,0,1,1
35141,3,2,123110,123110,123112,0,2,2
35142,6,1,123116,123116,123117,0,1,4
35143,4,1,123120,123120,123121,0,1,3
35144,5,1,123125,123125,123126,0,1,4
35145,1,1,123126,123126,123127,0,1,0
35146,1,1,123127,123127,123128,0,1,0
35147,3,1,123130,123130,123131,0,1,2
35148,5,3,123135,123135,123138,0,3,4
35149,1,2,123136,123138,123140,2,4,0
35150,3,1,123139,123140,123141,1,2,0
35151,3,1,123142,123142,123143,0,1,1
35152,4,3,123146,123146,123149,0,3,3
35153,6,1,123152,123152,123153,0,1,3
35154,3,2,123155,123155,123157,0,2,2
35155,6,1,123161,123161,123162,0,1,4
35156,1,1,123162,123162,123163,0,1,0
35157,6,2,123168,123168,123170,0,2,5
35158,5,1,123173,123173,123174,0,1,3
35159,2,3,123175,123175,123178,0,3,1
35160,2,3,123177,123178,123181,1,4,0
35161,1,2,123178,123181,123183,3,5,0
35162,1,2,123179,123183,123185,4,6,0
35163,5,2,123184,123185,123187,1,3,0
35164,1,2,123185,123187,123189,2,4,0
35165,3,3,123188,123189,123192,1,4,0
35166,2,3,123190,123192,123195,2,5,0
35167,5,2,123195,123195,123197,0,2,0
35168,6,2,123201,123201,123203,0,2,4
35169,5,2,123206,123206,123208,0,2,3
35170,2,2,123208,123208,123210,0,2,0
35171,1,2,123209,123210,123212,1,3,0
35172,4,3,123213,123213,123216,0,3,1
35173,6,1,123219,123219,123220,0,1,3
35174,5,1,123224,123224,123225,0,1,4
35175,2,3,123226,123226,123229,0,3,1
35176,6,1,123232,123232,123233,0,1,3
35177,5,3,123237,123237,123240,0,3,4
35178,1,3,123238,123240,123243,2,5,0
35179,5,1,123243,123243,123244,0,1,0
35180,2,2,123245,123245,123247,0,2,1
35181,1,3,123246,123247,123250,1,4,0
35182,1,2,123247,123250,123252,3,5,0
35183,1,1,123248,123252,123253,4,5,0
35184,6,3,123254,123254,123257,0,3,1
35185,5,3,123259,123259,123262,0,3,2
35186,6,3,123265,123265,123268,0,3,3
35187,5,3,123270,123270,123273,0,3,2
35188,5,3,123275,123275,123278,0,3,2
35189,3,1,123278,123278,123279,0,1,0
35190,4,2,123282,123282,123284,0,2,3
35191,4,2,123286,123286,123288,0,2,2
35192,5,2,123291,123291,123293,0,2,3
35193,2,2,123293,123293,123295,0,2,0
35194,6,3,123299,123299,123302,0,3,4
35195,5,2,123304,123304,123306,0,2,2
35196,3,1,123307,123307,123308,0,1,1
35197,4,3,123311,123311,123314,0,3,3
35198,6,3,123317,123317,123320,0,3,3
35199,6,2,123323,123323,123325,0,2,3
35200,4,1,123327,123327,123328,0,1,2
35201,5,3,123332,123332,123335,0,3,4
35202,1,2,123333,123335,123337,2,4,0
35203,2,2,123335,123337,123339,2,4,0
35204,5,1,123340,123340,123341,0,1,1
35205,2,2,123342,123342,123344,0,2,1
35206,5,3,123347,123347,123350,0,3,3
35207,6,3,123353,123353,123356,0,3,3
35208,4,2,123357,123357,123359,0,2,1
35209,1,3,123358,123359,123362,1,4,0
35210,2,2,123360,123362,123364,2,4,0
35211,3,2,123363,123364,123366,1,3,0
35212,1,2,123364,123366,123368,2,4,0
35213,4,2,123368,123368,123370,0,2,0
35214,4,1,123372,123372,123373,0,1,2
35215,2,2,123374,123374,123376,0,2,1
35216,6,1,123380,123380,123381,0,1,4
35217,5,1,123385,123385,123386,0,1,4
35218,4,1,123389,123389,123390,0,1,3
35219,1,2,123390,123390,123392,0,2,0
35220,5,1,123395,123395,123396,0,1,3
35221,2,3,123397,123397,123400,0,3,1
35222,1,2,123398,123400,123402,2,4,0
35223,5,3,123403,123403,123406,0,3,1
35224,2,1,123405,123406,123407,1,2,0
35225,4,2,123409,123409,123411,0,2,2
35226,3,2,123412,123412,123414,0,2,1
35227,4,1,123416,123416,123417,0,1,2
35228,6,1,123422,123422,123423,0,1,5
35229,5,2,123427,123427,123429,0,2,4
35230,1,3,123428,123429,123432,1,4,0
35231,1,3,123429,123432,123435,3,6,0
35232,2,2,123431,123435,123437,4,6,0
35233,3,1,123434,123437,123438,3,4,0
35234,6,1,123440,123440,123441,0,1,2
35235,4,1,123444,123444,123445,0,1,3
35236,6,1,123450,123450,123451,0,1,5
35237,3,2,123453,123453,123455,0,2,2
35238,4,1,123457,123457,123458,0,1,2
35239,3,2,123460,123460,123462,0,2,2
35240,4,3,123464,123464,123467,0,3,2
35241,6,3,123470,123470,123473,0,3,3
35242,5,1,123475,123475,123476,0,1,2
35243,4,2,123479,123479,123481,0,2,3
35244,5,2,123484,123484,123486,0,2,3
35245,3,1,123487,123487,123488,0,1,1
35246,1,2,123488,123488,123490,0,2,0
35247,4,1,123492,123492,123493,0,1,2
35248,2,2,123494,123494,123496,0,2,1
35249,6,1,123500,123500,123501,0,1,4
35250,1,1,123501,123501,123502,0,1,0
35251,1,3,123502,123502,123505,0,3,0
35252,2,3,123504,123505,123508,1,4,0
35253,3,3,123507,123508,123511,1,4,0
35254,6,1,123513,123513,123514,0,1,2
35255,3,1,123516,123516,123517,0,1,2
35256,6,3,123522,123522,123525,0,3,5
35257,3,2,123525,123525,123527,0,2,0
35258,4,3,123529,123529,123532,0,3,2
35259,1,3,123530,123532,123535,2,5,0
35260,1,2,123531,123535,123537,4,6,0
35261,6,3,123537,123537,123540,0,3,0
35262,1,3,123538,123540,123543,2,5,0
35263,6,1,123544,123544,123545,0,1,1
35264,6,3,123550,123550,123553,0,3,5
35265,1,1,123551,123553,123554,2,3,0
35266,4,2,123555,123555,123557,0,2,1
35267,1,1,123556,123557,123558,1,2,0
35268,1,2,123557,123558,123560,1,3,0
35269,5,1,123562,123562,123563,0,1,2
35270,2,2,123564,123564,123566,0,2,1
35271,1,1,123565,123566,123567,1,2,0
35272,4,1,123569,123569,123570,0,1,2
35273,5,3,123574,123574,123577,0,3,4
35274,1,3,123575,123577,123580,2,5,0
35275,5,2,123580,123580,123582,0,2,0
35276,1,2,123581,123582,123584,1,3,0
35277,5,1,123586,123586,123587,0,1,2
35278,2,2,123588,123588,123590,0,2,1
35279,2,3,123590,123590,123593,0,3,0
35280,5,1,123595,123595,123596,0,1,2
35281,5,3,123600,123600,123603,0,3,4
35282,1,1,123601,123603,123604,2,3,0
35283,4,3,123605,123605,123608,0,3,1
35284,2,3,123607,123608,123611,1,4,0
35285,5,2,123612,123612,123614,0,2,1
35286,3,1,123615,123615,123616,0,1,1
35287,4,3,123619,123619,123622,0,3,3
35288,5,2,123624,123624,123626,0,2,2
35289,1,2,123625,123626,123628,1,3,0
35290,4,1,123629,123629,123630,0,1,1
35291,5,2,123634,123634,123636,0,2,4
35292,3,1,123637,123637,123638,0,1,1
35293,1,2,123638,123638,123640,0,2,0
35294,1,1,123639,123640,123641,1,2,0
35295,3,3,123642,123642,123645,0,3,1
35296,6,3,123648,123648,123651,0,3,3
35297,3,2,123651,123651,123653,0,2,0
35298,2,2,123653,123653,123655,0,2,0
35299,6,3,123659,123659,123662,0,3,4
35300,2,1,123661,123662,123663,1,2,0
35301,5,1,123666,123666,123667,0,1,3
35302,3,3,123669,123669,123672,0,3,2
35303,6,1,123675,123675,123676,0,1,3
35304,3,2,123678,123678,123680,0,2,2
35305,1,2,123679,123680,123682,1,3,0
35306,3,3,123682,123682,123685,0,3,0
35307,4,3,123686,123686,123689,0,3,1
35308,3,3,123689,123689,123692,0,3,0
35309,6,3,123695,123695,123698,0,3,3
35310,5,3,123700,123700,123703,0,3,2
35311,3,1,123703,123703,123704,0,1,0
35312,6,1,123709,123709,123710,0,1,5
35313,6,3,123715,123715,123718,0,3,5
35314,1,2,123716,123718,123720,2,4,0
35315,4,1,123720,123720,123721,0,1,0
35316,2,3,123722,123722,123725,0,3,1
35317,4,3,123726,123726,123729,0,3,1
35318,3,3,123729,123729,123732,0,3,0
35319,2,1,123731,123732,123733,1,2,0
35320,3,3,123734,123734,123737,0,3,1
35321,2,3,123736,123737,123740,1,4,0
35322,6,3,123742,123742,123745,0,3,2
35323,1,2,123743,123745,123747,2,4,0
35324,4,3,123747,123747,123750,0,3,0
35325,2,3,123749,123750,123753,1,4,0
35326,1,1,123750,123753,123754,3,4,0
35327,1,1,123751,123754,123755,3,4,0
35328,5,2,123756,123756,123758,0,2,1
35329,5,1,123761,123761,123762,0,1,3
35330,2,3,123763,123763,123766,0,3,1
35331,2,1,123765,123766,123767,1,2,0
35332,1,2,123766,123767,123769,1,3,0
35333,3,1,123769,123769,123770,0,1,0
35334,5,1,123774,123774,123775,0,1,4
35335,4,1,123778,123778,123779,0,1,3
35336,5,3,123783,123783,123786,0,3,4
35337,6,1,123789,123789,123790,0,1,3
35338,4,1,123793,123793,123794,0,1,3
35339,3,2,123796,123796,123798,0,2,2
35340,4,1,123800,123800,123801,0,1,2
35341,5,3,123805,123805,123808,0,3,4
35342,5,1,123810,123810,123811,0,1,2
35343,4,1,123814,123814,123815,0,1,3
35344,1,1,123815,123815,123816,0,1,0
35345,4,1,123819,123819,123820,0,1,3
35346,6,2,123825,123825,123827,0,2,5
35347,2,2,123827,123827,123829,0,2,0
35348,4,2,123831,123831,123833,0,2,2
35349,3,1,123834,123834,123835,0,1,1
35350,6,3,123840,123840,123843,0,3,5
35351,2,2,123842,123843,123845,1,3,0
35352,5,3,123847,123847,123850,0,3,2
35353,2,1,123849,123850,123851,1,2,0
35354,6,2,123855,123855,123857,0,2,4
35355,1,1,123856,123857,123858,1,2,0
35356,1,2,123857,123858,123860,1,3,0
35357,5,2,123862,123862,123864,0,2,2
35358,3,3,123865,123865,123868,0,3,1
35359,5,1,123870,123870,123871,0,1,2
35360,4,3,123874,123874,123877,0,3,3
35361,6,1,123880,123880,123881,0,1,3
35362,5,2,123885,123885,123887,0,2,4
35363,3,1,123888,123888,123889,0,1,1
35364,3,3,123891,123891,123894,0,3,2
35365,4,3,123895,123895,123898,0,3,1
35366,3,1,123898,123898,123899,0,1,0
35367,1,2,123899,123899,123901,0,2,0
35368,3,2,123902,123902,123904,0,2,1
35369,6,1,123908,123908,123909,0,1,4
35370,4,3,123912,123912,123915,0,3,3
35371,2,2,123914,123915,123917,1,3,0
35372,5,3,123919,123919,123922,0,3,2
35373,4,3,123923,123923,123926,0,3,1
35374,6,1,123929,123929,123930,0,1,3
35375,4,1,123933,123933,123934,0,1,3
35376,6,1,123939,123939,123940,0,1,5
35377,6,1,123945,123945,123946,0,1,5
35378,1,1,123946,123946,123947,0,1,0
35379,5,3,123951,123951,123954,0,3,4
35380,2,3,123953,123954,123957,1,4,0
35381,3,2,123956,123957,123959,1,3,0
35382,5,3,123961,123961,123964,0,3,2
35383,4,2,123965,123965,123967,0,2,1
35384,1,1,123966,123967,123968,1,2,0
35385,1,3,123967,123968,123971,1,4,0
35386,1,2,123968,123971,123973,3,5,0
35387,5,3,123973,123973,123976,0,3,0
35388,2,2,123975,123976,123978,1,3,0
35389,4,2,123979,123979,123981,0,2,1
35390,5,1,123984,123984,123985,0,1,3
35391,6,2,123990,123990,123992,0,2,5
35392,1,1,123991,123992,123993,1,2,0
35393,3,2,123994,123994,123996,0,2,1
35394,3,2,123997,123997,123999,0,2,1
35395,1,3,123998,123999,124002,1,4,0
35396,2,2,124000,124002,124004,2,4,0
35397,5,2,124005,124005,124007,0,2,1
35398,5,3,124010,124010,124013,0,3,3
35399,3,3,124013,124013,124016,0,3,0
35400,4,2,124017,124017,124019,0,2,1
35401,3,2,124020,124020,124022,0,2,1
35402,3,2,124023,124023,124025,0,2,1
35403,5,1,124028,124028,124029,0,1,3
35404,5,3,124033,124033,124036,0,3,4
35405,5,1,124038,124038,124039,0,1,2
35406,4,2,124042,124042,124044,0,2,3
35407,1,1,124043,124044,124045,1,2,0
35408,1,2,124044,124045,124047,1,3,0
35409,3,1,124047,124047,124048,0,1,0
35410,2,1,124049,124049,124050,0,1,1
35411,3,1,124052,124052,124053,0,1,2
35412,4,3,124056,124056,124059,0,3,3
35413,2,2,124058,124059,124061,1,3,0
35414,3,2,124061,124061,124063,0,2,0
35415,2,2,124063,124063,124065,0,2,0
35416,5,1,124068,124068,124069,0,1,3
35417,2,3,124070,124070,124073,0,3,1
35418,4,2,124074,124074,124076,0,2,1
35419,5,3,124079,124079,124082,0,3,3
35420,3,2,124082,124082,124084,0,2,0
35421,3,1,124085,124085,124086,0,1,1
35422,2,1,124087,124087,124088,0,1,1
35423,4,1,124091,124091,124092,0,1,3
35424,4,2,124095,124095,124097,0,2,3
35425,3,1,124098,124098,124099,0,1,1
35426,2,3,124100,124100,124103,0,3,1
35427,2,2,124102,124103,124105,1,3,0
35428,2,3,124104,124105,124108,1,4,0
35429,4,3,124108,124108,124111,0,3,0
35430,3,3,124111,124111,124114,0,3,0
35431,3,1,124114,124114,124115,0,1,0
35432,4,2,124118,124118,124120,0,2,3
35433,2,3,124120,124120,124123,0,3,0
35434,1,2,124121,124123,124125,2,4,0
35435,1,1,124122,124125,124126,3,4,0
35436,4,1,124126,124126,124127,0,1,0
35437,2,1,124128,124128,124129,0,1,1
35438,1,1,124129,124129,124130,0,1,0
35439,4,1,124133,124133,124134,0,1,3
35440,4,2,124137,124137,124139,0,2,3
35441,5,1,124142,124142,124143,0,1,3
35442,3,1,124145,124145,124146,0,1,2
35443,5,1,124150,124150,124151,0,1,4
35444,6,1,124156,124156,124157,0,1,5
35445,6,3,124162,124162,124165,0,3,5
35446,1,3,124163,124165,124168,2,5,0
35447,3,1,124166,124168,124169,2,3,0
35448,4,3,124170,124170,124173,0,3,1
35449,4,3,124174,124174,124177,0,3,1
35450,2,2,124176,124177,124179,1,3,0
35451,2,3,124178,124179,124182,1,4,0
35452,5,2,124183,124183,124185,0,2,1
35453,5,1,124188,124188,124189,0,1,3
35454,2,3,124190,124190,124193,0,3,1
35455,1,2,124191,124193,124195,2,4,0
35456,3,3,124194,124195,124198,1,4,0
35457,5,1,124199,124199,124200,0,1,1
35458,5,3,124204,124204,124207,0,3,4
35459,2,3,124206,124207,124210,1,4,0
35460,1,1,124207,124210,124211,3,4,0
35461,3,2,124210,124211,124213,1,3,0
35462,3,3,124213,124213,124216,0,3,0
35463,6,1,124219,124219,124220,0,1,3
35464,3,1,124222,124222,124223,0,1,2
35465,2,1,124224,124224,124225,0,1,1
35466,2,1,124226,124226,124227,0,1,1
35467,5,3,124231,124231,124234,0,3,4
35468,5,1,124236,124236,124237,0,1,2
35469,2,3,124238,124238,124241,0,3,1
35470,5,1,124243,124243,124244,0,1,2
35471,4,1,124247,124247,124248,0,1,3
35472,5,3,124252,124252,124255,0,3,4
35473,4,3,124256,124256,124259,0,3,1
35474,1,3,124257,124259,124262,2,5,0
35475,2,3,124259,124262,124265,3,6,0
35476,3,2,124262,124265,124267,3,5,0
35477,3,1,124265,124267,124268,2,3,0
35478,3,1,124268,124268,124269,0,1,0
35479,3,1,124271,124271,124272,0,1,2
35480,1,1,124272,124272,124273,0,1,0
35481,2,3,124274,124274,124277,0,3,1
35482,3,2,124277,124277,124279,0,2,0
35483,3,2,124280,124280,124282,0,2,1
35484,1,2,124281,124282,124284,1,3,0
35485,6,1,124287,124287,124288,0,1,3
35486,5,3,124292,124292,124295,0,3,4
35487,2,1,124294,124295,124296,1,2,0
35488,5,3,124299,124299,124302,0,3,3
35489,6,3,124305,124305,124308,0,3,3
35490,1,1,124306,124308,124309,2,3,0
35491,4,3,124310,124310,124313,0,3,1
35492,6,2,124316,124316,124318,0,2,3
35493,1,2,124317,124318,124320,1,3,0
35494,5,3,124322,124322,124325,0,3,2
35495,4,2,124326,124326,124328,0,2,1
35496,1,3,124327,124328,124331,1,4,0
35497,4,1,124331,124331,124332,0,1,0
35498,1,1,124332,124332,124333,0,1,0
35499,1,3,124333,124333,124336,0,3,0
35500,5,3,124338,124338,124341,0,3,2
35501,1,1,124339,124341,124342,2,3,0
35502,4,3,124343,124343,124346,0,3,1
35503,2,3,124345,124346,124349,1,4,0
35504,3,3,124348,124349,124352,1,4,0
35505,4,3,124352,124352,124355,0,3,0
35506,3,3,124355,124355,124358,0,3,0
35507,4,1,124359,124359,124360,0,1,1
35508,1,1,124360,124360,124361,0,1,0
35509,1,2,124361,124361,124363,0,2,0
35510,6,2,124367,124367,124369,0,2,4
35511,2,2,124369,124369,124371,0,2,0
35512,3,3,124372,124372,124375,0,3,1
35513,3,2,124375,124375,124377,0,2,0
35514,2,2,124377,124377,124379,0,2,0
35515,6,3,124383,124383,124386,0,3,4
35516,6,3,124389,124389,124392,0,3,3
35517,2,3,124391,124392,124395,1,4,0
35518,2,1,124393,124395,124396,2,3,0
35519,2,1,124395,124396,124397,1,2,0
35520,6,1,124401,124401,124402,0,1,4
35521,1,1,124402,124402,124403,0,1,0
35522,2,3,124404,124404,124407,0,3,1
35523,6,2,124410,124410,124412,0,2,3
35524,3,1,124413,124413,124414,0,1,1
35525,2,2,124415,124415,124417,0,2,1
35526,2,1,124417,124417,124418,0,1,0
35527,4,2,124421,124421,124423,0,2,3
35528,6,2,124427,124427,124429,0,2,4
35529,1,3,124428,124429,124432,1,4,0
35530,5,1,124433,124433,124434,0,1,1
35531,3,1,124436,124436,124437,0,1,2
35532,6,1,124442,124442,124443,0,1,5
35533,6,2,124448,124448,124450,0,2,5
35534,6,2,124454,124454,124456,0,2,4
35535,6,2,124460,124460,124462,0,2,4
35536,5,1,124465,124465,124466,0,1,3
35537,5,3,124470,124470,124473,0,3,4
35538,3,1,124473,124473,124474,0,1,0
35539,6,3,124479,124479,124482,0,3,5
35540,2,1,124481,124482,124483,1,2,0
35541,3,2,124484,124484,124486,0,2,1
35542,3,2,124487,124487,124489,0,2,1
35543,1,1,124488,124489,124490,1,2,0
35544,4,1,124492,124492,124493,0,1,2
35545,4,1,124496,124496,124497,0,1,3
35546,1,2,124497,124497,124499,0,2,0
35547,6,1,124503,124503,124504,0,1,4
35548,1,1,124504,124504,124505,0,1,0
35549,2,3,124506,124506,124509,0,3,1
35550,6,3,124512,124512,124515,0,3,3
35551,2,1,124514,124515,124516,1,2,0
35552,1,1,124515,124516,124517,1,2,0
35553,2,3,124517,124517,124520,0,3,0
35554,4,3,124521,124521,124524,0,3,1
35555,4,1,124525,124525,124526,0,1,1
35556,5,1,124530,124530,124531,0,1,4
35557,3,2,124533,124533,124535,0,2,2
35558,4,3,124537,124537,124540,0,3,2
35559,6,2,124543,124543,124545,0,2,3
35560,5,3,124548,124548,124551,0,3,3
35561,3,2,124551,124551,124553,0,2,0
35562,1,2,124552,124553,124555,1,3,0
35563,6,1,124558,124558,124559,0,1,3
35564,1,3,124559,124559,124562,0,3,0
35565,4,1,124563,124563,124564,0,1,1
35566,6,3,124569,124569,124572,0,3,5
35567,6,3,124575,124575,124578,0,3,3
35568,4,2,124579,124579,124581,0,2,1
35569,6,3,124585,124585,124588,0,3,4
35570,4,2,124589,124589,124591,0,2,1
35571,5,1,124594,124594,124595,0,1,3
35572,4,1,124598,124598,124599,0,1,3
35573,4,2,124602,124602,124604,0,2,3
35574,3,2,124605,124605,124607,0,2,1
35575,2,1,124607,124607,124608,0,1,0
35576,3,1,124610,124610,124611,0,1,2
35577,6,3,124616,124616,124619,0,3,5
35578,1,2,124617,124619,124621,2,4,0
35579,2,2,124619,124621,124623,2,4,0
35580,3,1,124622,124623,124624,1,2,0
35581,6,1,124628,124628,124629,0,1,4
35582,1,3,124629,124629,124632,0,3,0
35583,6,3,124635,124635,124638,0,3,3
35584,6,3,124641,124641,124644,0,3,3
35585,4,2,124645,124645,124647,0,2,1
35586,3,3,124648,124648,124651,0,3,1
35587,4,2,124652,124652,124654,0,2,1
35588,2,2,124654,124654,124656,0,2,0
35589,3,3,124657,124657,124660,0,3,1
35590,2,3,124659,124660,124663,1,4,0
35591,5,2,124664,124664,124666,0,2,1
35592,6,1,124670,124670,124671,0,1,4
35593,3,1,124673,124673,124674,0,1,2
35594,4,1,124677,124677,124678,0,1,3
35595,6,2,124683,124683,124685,0,2,5
35596,3,1,124686,124686,124687,0,1,1
35597,3,2,124689,124689,124691,0,2,2
35598,6,3,124695,124695,124698,0,3,4
35599,1,1,124696,124698,124699,2,3,0
35600,2,3,124698,124699,124702,1,4,0
35601,3,1,124701,124702,124703,1,2,0
35602,6,1,124707,124707,124708,0,1,4
35603,6,3,124713,124713,124716,0,3,5
35604,6,3,124719,124719,124722,0,3,3
35605,3,2,124722,124722,124724,0,2,0
35606,3,1,124725,124725,124726,0,1,1
35607,2,3,124727,124727,124730,0,3,1
35608,5,1,124732,124732,124733,0,1,2
35609,4,1,124736,124736,124737,0,1,3
35610,4,2,124740,124740,124742,0,2,3
35611,1,1,124741,124742,124743,1,2,0
35612,6,2,124747,124747,124749,0,2,4
35613,6,3,124753,124753,124756,0,3,4
35614,2,1,124755,124756,124757,1,2,0
35615,5,1,124760,124760,124761,0,1,3
35616,5,2,124765,124765,124767,0,2,4
35617,3,2,124768,124768,124770,0,2,1
35618,3,1,124771,124771,124772,0,1,1
35619,1,3,124772,124772,124775,0,3,0
35620,2,2,124774,124775,124777,1,3,0
35621,3,1,124777,124777,124778,0,1,0
35622,2,3,124779,124779,124782,0,3,1
35623,3,1,124782,124782,124783,0,1,0
35624,2,2,124784,124784,124786,0,2,1
35625,5,3,124789,124789,124792,0,3,3
35626,2,2,124791,124792,124794,1,3,0
35627,1,3,124792,124794,124797,2,5,0
35628,3,1,124795,124797,124798,2,3,0
35629,6,3,124801,124801,124804,0,3,3
35630,2,3,124803,124804,124807,1,4,0
35631,5,1,124808,124808,124809,0,1,1
35632,6,2,124814,124814,124816,0,2,5
35633,4,1,124818,124818,124819,0,1,2
35634,4,1,124822,124822,124823,0,1,3
35635,3,3,124825,124825,124828,0,3,2
35636,1,3,124826,124828,124831,2,5,0
35637,6,2,124832,124832,124834,0,2,1
35638,6,2,124838,124838,124840,0,2,4
35639,2,2,124840,124840,124842,0,2,0
35640,6,2,124846,124846,124848,0,2,4
35641,4,3,124850,124850,124853,0,3,2
35642,1,1,124851,124853,124854,2,3,0
35643,4,1,124855,124855,124856,0,1,1
35644,4,1,124859,124859,124860,0,1,3
35645,3,1,124862,124862,124863,0,1,2
35646,3,3,124865,124865,124868,0,3,2
35647,5,2,124870,124870,124872,0,2,2
35648,6,3,124876,124876,124879,0,3,4
35649,1,3,124877,124879,124882,2,5,0
35650,5,2,124882,124882,124884,0,2,0
35651,3,2,124885,124885,124887,0,2,1
35652,3,2,124888,124888,124890,0,2,1
35653,6,2,124894,124894,124896,0,2,4
35654,3,1,124897,124897,124898,0,1,1
35655,6,1,124903,124903,124904,0,1,5
35656,2,2,124905,124905,124907,0,2,1
35657,4,2,124909,124909,124911,0,2,2
35658,4,3,124913,124913,124916,0,3,2
35659,5,2,124918,124918,124920,0,2,2
35660,4,1,124922,124922,124923,0,1,2
35661,1,2,124923,124923,124925,0,2,0
35662,3,1,124926,124926,124927,0,1,1
35663,6,1,124932,124932,124933,0,1,5
35664,5,2,124937,124937,124939,0,2,4
35665,5,2,124942,124942,124944,0,2,3
35666,2,3,124944,124944,124947,0,3,0
35667,4,2,124948,124948,124950,0,2,1
35668,2,2,124950,124950,124952,0,2,0
35669,5,2,124955,124955,124957,0,2,3
35670,5,3,124960,124960,124963,0,3,3
35671,5,3,124965,124965,124968,0,3,2
35672,5,2,124970,124970,124972,0,2,2
35673,3,2,124973,124973,124975,0,2,1
35674,5,3,124978,124978,124981,0,3,3
35675,2,1,124980,124981,124982,1,2,0
35676,1,3,124981,124982,124985,1,4,0
35677,2,1,124983,124985,124986,2,3,0
35678,5,3,124988,124988,124991,0,3,2
35679,3,3,124991,124991,124994,0,3,0
35680,1,1,124992,124994,124995,2,3,0
35681,5,2,124997,124997,124999,0,2,2
35682,2,3,124999,124999,125002,0,3,0
35683,5,3,125004,125004,125007,0,3,2
35684,1,3,125005,125007,125010,2,5,0
35685,5,2,125010,125010,125012,0,2,0
35686,2,3,125012,125012,125015,0,3,0
35687,2,3,125014,125015,125018,1,4,0
35688,2,2,125016,125018,125020,2,4,0
35689,4,3,125020,125020,125023,0,3,0
35690,6,2,125026,125026,125028,0,2,3
35691,5,3,125031,125031,125034,0,3,3
35692,6,2,125037,125037,125039,0,2,3
35693,1,3,125038,125039,125042,1,4,0
35694,6,3,125044,125044,125047,0,3,2
35695,1,1,125045,125047,125048,2,3,0
35696,3,2,125048,125048,125050,0,2,0
35697,3,3,125051,125051,125054,0,3,1
35698,3,3,125054,125054,125057,0,3,0
35699,1,1,125055,125057,125058,2,3,0
35700,3,3,125058,125058,125061,0,3,0
35701,4,3,125062,125062,125065,0,3,1
35702,4,3,125066,125066,125069,0,3,1
35703,1,2,125067,125069,125071,2,4,0
35704,5,2,125072,125072,125074,0,2,1
35705,1,3,125073,125074,125077,1,4,0
35706,3,2,125076,125077,125079,1,3,0
35707,6,1,125082,125082,125083,0,1,3
35708,2,2,125084,125084,125086,0,2,1
35709,5,1,125089,125089,125090,0,1,3
35710,1,1,125090,125090,125091,0,1,0
35711,3,1,125093,125093,125094,0,1,2
35712,3,1,125096,125096,125097,0,1,2
35713,2,3,125098,125098,125101,0,3,1
35714,5,3,125103,125103,125106,0,3,2
35715,6,3,125109,125109,125112,0,3,3
35716,1,2,125110,125112,125114,2,4,0
35717,5,2,125115,125115,125117,0,2,1
35718,3,1,125118,125118,125119,0,1,1
35719,3,1,125121,125121,125122,0,1,2
35720,2,2,125123,125123,125125,0,2,1
35721,2,1,125125,125125,125126,0,1,0
35722,2,1,125127,125127,125128,0,1,1
35723,6,1,125133,125133,125134,0,1,5
35724,6,3,125139,125139,125142,0,3,5
35725,4,1,125143,125143,125144,0,1,1
35726,4,1,125147,125147,125148,0,1,3
35727,2,1,125149,125149,125150,0,1,1
35728,5,3,125154,125154,125157,0,3,4
35729,2,3,125156,125157,125160,1,4,0
35730,3,1,125159,125160,125161,1,2,0
35731,3,3,125162,125162,125165,0,3,1
35732,4,1,125166,125166,125167,0,1,1
35733,3,3,125169,125169,125172,0,3,2
35734,6,3,125175,125175,125178,0,3,3
35735,2,1,125177,125178,125179,1,2,0
35736,1,2,125178,125179,125181,1,3,0
35737,5,3,125183,125183,125186,0,3,2
35738,2,1,125185,125186,125187,1,2,0
35739,6,3,125191,125191,125194,0,3,4
35740,5,3,125196,125196,125199,0,3,2
35741,6,1,125202,125202,125203,0,1,3
35742,5,1,125207,125207,125208,0,1,4
35743,3,1,125210,125210,125211,0,1,2
35744,5,3,125215,125215,125218,0,3,4
35745,1,3,125216,125218,125221,2,5,0
35746,1,2,125217,125221,125223,4,6,0
35747,1,2,125218,125223,125225,5,7,0
35748,2,1,125220,125225,125226,5,6,0
35749,3,2,125223,125226,125228,3,5,0
35750,4,2,125227,125228,125230,1,3,0
35751,4,2,125231,125231,125233,0,2,1
35752,4,2,125235,125235,125237,0,2,2
35753,5,1,125240,125240,125241,0,1,3
35754,2,1,125242,125242,125243,0,1,1
35755,5,3,125247,125247,125250,0,3,4
35756,3,3,125250,125250,125253,0,3,0
35757,5,3,125255,125255,125258,0,3,2
35758,5,2,125260,125260,125262,0,2,2
35759,2,3,125262,125262,125265,0,3,0
35760,4,1,125266,125266,125267,0,1,1
35761,3,3,125269,125269,125272,0,3,2
35762,1,2,125270,125272,125274,2,4,0
35763,2,2,125272,125274,125276,2,4,0
35764,4,3,125276,125276,125279,0,3,0
35765,3,1,125279,125279,125280,0,1,0
35766,5,2,125284,125284,125286,0,2,4
35767,3,1,125287,125287,125288,0,1,1
35768,6,3,125293,125293,125296,0,3,5
35769,6,2,125299,125299,125301,0,2,3
35770,5,3,125304,125304,125307,0,3,3
35771,6,2,125310,125310,125312,0,2,3
35772,5,2,125315,125315,125317,0,2,3
35773,1,1,125316,125317,125318,1,2,0
35774,6,1,125322,125322,125323,0,1,4
35775,3,3,125325,125325,125328,0,3,2
35776,3,1,125328,125328,125329,0,1,0
35777,1,1,125329,125329,125330,0,1,0
35778,5,1,125334,125334,125335,0,1,4
35779,4,2,125338,125338,125340,0,2,3
35780,6,2,125344,125344,125346,0,2,4
35781,5,3,125349,125349,125352,0,3,3
35782,2,1,125351,125352,125353,1,2,0
35783,4,1,125355,125355,125356,0,1,2
35784,3,2,125358,125358,125360,0,2,2
35785,5,2,125363,125363,125365,0,2,3
35786,3,2,125366,125366,125368,0,2,1
35787,5,2,125371,125371,125373,0,2,3
35788,1,2,125372,125373,125375,1,3,0
35789,3,3,125375,125375,125378,0,3,0
35790,6,1,125381,125381,125382,0,1,3
35791,6,1,125387,125387,125388,0,1,5
35792,3,2,125390,125390,125392,0,2,2
35793,2,1,125392,125392,125393,0,1,0
35794,5,2,125397,125397,125399,0,2,4
35795,3,3,125400,125400,125403,0,3,1
35796,1,2,125401,125403,125405,2,4,0
35797,1,1,125402,125405,125406,3,4,0
35798,5,2,125407,125407,125409,0,2,1
35799,5,1,125412,125412,125413,0,1,3
35800,3,3,125415,125415,125418,0,3,2
35801,3,3,125418,125418,125421,0,3,0
35802,4,3,125422,125422,125425,0,3,1
35803,3,3,125425,125425,125428,0,3,0
35804,6,2,125431,125431,125433,0,2,3
35805,6,2,125437,125437,125439,0,2,4
35806,4,2,125441,125441,125443,0,2,2
35807,3,3,125444,125444,125447,0,3,1
35808,4,2,125448,125448,125450,0,2,1
35809,2,2,125450,125450,125452,0,2,0
35810,5,2,125455,125455,125457,0,2,3
35811,4,1,125459,125459,125460,0,1,2
35812,1,1,125460,125460,125461,0,1,0
35813,4,1,125464,125464,125465,0,1,3
35814,5,2,125469,125469,125471,0,2,4
35815,6,1,125475,125475,125476,0,1,4
35816,4,1,125479,125479,125480,0,1,3
35817,5,2,125484,125484,125486,0,2,4
35818,6,1,125490,125490,125491,0,1,4
35819,1,2,125491,125491,125493,0,2,0
35820,2,1,125493,125493,125494,0,1,0
35821,4,1,125497,125497,125498,0,1,3
35822,4,3,125501,125501,125504,0,3,3
35823,3,2,125504,125504,125506,0,2,0
35824,4,3,125508,125508,125511,0,3,2
35825,4,1,125512,125512,125513,0,1,1
35826,4,1,125516,125516,125517,0,1,3
35827,1,1,125517,125517,125518,0,1,0
35828,5,2,125522,125522,125524,0,2,4
35829,2,3,125524,125524,125527,0,3,0
35830,6,3,125530,125530,125533,0,3,3
35831,5,2,125535,125535,125537,0,2,2
35832,3,3,125538,125538,125541,0,3,1
35833,3,2,125541,125541,125543,0,2,0
35834,4,3,125545,125545,125548,0,3,2
35835,5,3,125550,125550,125553,0,3,2
35836,2,2,125552,125553,125555,1,3,0
35837,4,1,125556,125556,125557,0,1,1
35838,1,3,125557,125557,125560,0,3,0
35839,6,2,125563,125563,125565,0,2,3
35840,2,2,125565,125565,125567,0,2,0
35841,3,1,125568,125568,125569,0,1,1
35842,1,3,125569,125569,125572,0,3,0
35843,4,3,125573,125573,125576,0,3,1
35844,4,1,125577,125577,125578,0,1,1
35845,5,3,125582,125582,125585,0,3,4
35846,5,2,125587,125587,125589,0,2,2
35847,5,1,125592,125592,125593,0,1,3
35848,4,1,125596,125596,125597,0,1,3
35849,6,3,125602,125602,125605,0,3,5
35850,1,2,125603,125605,125607,2,4,0
35851,5,3,125608,125608,125611,0,3,1
35852,3,3,125611,125611,125614,0,3,0
35853,6,1,125617,125617,125618,0,1,3
35854,4,3,125621,125621,125624,0,3,3
35855,2,1,125623,125624,125625,1,2,0
35856,2,3,125625,125625,125628,0,3,0
35857,1,1,125626,125628,125629,2,3,0
35858,1,1,125627,125629,125630,2,3,0
35859,1,2,125628,125630,125632,2,4,0
35860,6,2,125634,125634,125636,0,2,2
35861,5,1,125639,125639,125640,0,1,3
35862,1,3,125640,125640,125643,0,3,0
35863,3,3,125643,125643,125646,0,3,0
35864,3,2,125646,125646,125648,0,2,0
35865,5,2,125651,125651,125653,0,2,3
35866,2,3,125653,125653,125656,0,3,0
35867,3,3,125656,125656,125659,0,3,0
35868,4,1,125660,125660,125661,0,1,1
35869,4,3,125664,125664,125667,0,3,3
35870,1,1,125665,125667,125668,2,3,0
35871,2,3,125667,125668,125671,1,4,0
35872,6,1,125673,125673,125674,0,1,2
35873,1,1,125674,125674,125675,0,1,0
35874,4,2,125678,125678,125680,0,2,3
35875,2,1,125680,125680,125681,0,1,0
35876,1,1,125681,125681,125682,0,1,0
35877,1,1,125682,125682,125683,0,1,0
35878,1,3,125683,125683,125686,0,3,0
35879,5,2,125688,125688,125690,0,2,2
35880,2,3,125690,125690,125693,0,3,0
35881,3,2,125693,125693,125695,0,2,0
35882,2,1,125695,125695,125696,0,1,0
35883,2,2,125697,125697,125699,0,2,1
35884,4,1,125701,125701,125702,0,1,2
35885,1,3,125702,125702,125705,0,3,0
35886,1,3,125703,125705,125708,2,5,0
35887,5,1,125708,125708,125709,0,1,0
35888,5,3,125713,125713,125716,0,3,4
35889,3,2,125716,125716,125718,0,2,0
35890,2,2,125718,125718,125720,0,2,0
35891,3,1,125721,125721,125722,0,1,1
35892,1,3,125722,125722,125725,0,3,0
35893,4,1,125726,125726,125727,0,1,1
35894,4,2,125730,125730,125732,0,2,3
35895,2,3,125732,125732,125735,0,3,0
35896,3,3,125735,125735,125738,0,3,0
35897,1,1,125736,125738,125739,2,3,0
35898,3,3,125739,125739,125742,0,3,0
35899,5,1,125744,125744,125745,0,1,2
35900,6,3,125750,125750,125753,0,3,5
35901,6,1,125756,125756,125757,0,1,3
35902,6,1,125762,125762,125763,0,1,5
35903,3,2,125765,125765,125767,0,2,2
35904,2,3,125767,125767,125770,0,3,0
35905,3,3,125770,125770,125773,0,3,0
35906,3,2,125773,125773,125775,0,2,0
35907,6,3,125779,125779,125782,0,3,4
35908,6,3,125785,125785,125788,0,3,3
35909,3,3,125788,125788,125791,0,3,0
35910,1,1,125789,125791,125792,2,3,0
35911,1,1,125790,125792,125793,2,3,0
35912,1,1,125791,125793,125794,2,3,0
35913,4,3,125795,125795,125798,0,3,1
35914,4,2,125799,125799,125801,0,2,1
35915,3,2,125802,125802,125804,0,2,1
35916,5,2,125807,125807,125809,0,2,3
35917,1,2,125808,125809,125811,1,3,0
35918,6,1,125814,125814,125815,0,1,3
35919,3,2,125817,125817,125819,0,2,2
35920,2,1,125819,125819,125820,0,1,0
35921,6,1,125825,125825,125826,0,1,5
35922,3,2,125828,125828,125830,0,2,2
35923,1,3,125829,125830,125833,1,4,0
35924,4,3,125833,125833,125836,0,3,0
35925,1,3,125834,125836,125839,2,5,0
35926,3,3,125837,125839,125842,2,5,0
35927,2,2,125839,125842,125844,3,5,0
35928,5,1,125844,125844,125845,0,1,0
35929,5,3,125849,125849,125852,0,3,4
35930,3,2,125852,125852,125854,0,2,0
35931,3,3,125855,125855,125858,0,3,1
35932,1,1,125856,125858,125859,2,3,0
35933,3,1,125859,125859,125860,0,1,0
35934,3,2,125862,125862,125864,0,2,2
35935,4,2,125866,125866,125868,0,2,2
35936,6,2,125872,125872,125874,0,2,4
35937,5,1,125877,125877,125878,0,1,3
35938,2,1,125879,125879,125880,0,1,1
35939,4,1,125883,125883,125884,0,1,3
35940,3,2,125886,125886,125888,0,2,2
35941,6,1,125892,125892,125893,0,1,4
35942,5,1,125897,125897,125898,0,1,4
35943,2,1,125899,125899,125900,0,1,1
35944,5,1,125904,125904,125905,0,1,4
35945,4,2,125908,125908,125910,0,2,3
35946,6,2,125914,125914,125916,0,2,4
35947,5,3,125919,125919,125922,0,3,3
35948,6,1,125925,125925,125926,0,1,3
35949,5,1,125930,125930,125931,0,1,4
35950,2,3,125932,125932,125935,0,3,1
35951,1,3,125933,125935,125938,2,5,0
35952,3,1,125936,125938,125939,2,3,0
35953,3,3,125939,125939,125942,0,3,0
35954,2,1,125941,125942,125943,1,2,0
35955,6,3,125947,125947,125950,0,3,4
35956,6,1,125953,125953,125954,0,1,3
35957,2,2,125955,125955,125957,0,2,1
35958,3,3,125958,125958,125961,0,3,1
35959,4,3,125962,125962,125965,0,3,1
35960,1,1,125963,125965,125966,2,3,0
35961,5,3,125968,125968,125971,0,3,2
35962,6,1,125974,125974,125975,0,1,3
35963,2,3,125976,125976,125979,0,3,1
35964,5,1,125981,125981,125982,0,1,2
35965,5,1,125986,125986,125987,0,1,4
35966,1,2,125987,125987,125989,0,2,0
35967,6,3,125993,125993,125996,0,3,4
35968,6,2,125999,125999,126001,0,2,3
35969,5,1,126004,126004,126005,0,1,3
35970,2,2,126006,126006,126008,0,2,1
35971,1,1,126007,126008,126009,1,2,0
35972,4,1,126011,126011,126012,0,1,2
35973,3,3,126014,126014,126017,0,3,2
35974,6,3,126020,126020,126023,0,3,3
35975,2,3,126022,126023,126026,1,4,0
35976,4,1,126026,126026,126027,0,1,0
35977,3,2,126029,126029,126031,0,2,2
35978,4,3,126033,126033,126036,0,3,2
35979,5,1,126038,126038,126039,0,1,2
35980,1,1,126039,126039,126040,0,1,0
35981,1,1,126040,126040,126041,0,1,0
35982,6,2,126046,126046,126048,0,2,5
35983,5,3,126051,126051,126054,0,3,3
35984,5,1,126056,126056,126057,0,1,2
35985,2,1,126058,126058,126059,0,1,1
35986,4,1,126062,126062,126063,0,1,3
35987,3,2,126065,126065,126067,0,2,2
35988,3,2,126068,126068,126070,0,2,1
35989,4,3,126072,126072,126075,0,3,2
35990,2,2,126074,126075,126077,1,3,0
35991,2,3,126076,126077,126080,1,4,0
35992,4,2,126080,126080,126082,0,2,0
35993,5,1,126085,126085,126086,0,1,3
35994,3,3,126088,126088,126091,0,3,2
35995,3,3,126091,126091,126094,0,3,0
35996,2,1,126093,126094,126095,1,2,0
35997,5,1,126098,126098,126099,0,1,3
35998,1,3,126099,126099,126102,0,3,0
35999,2,3,126101,126102,126105,1,4,0
36000,2,3,126103,126105,126108,2,5,0
36001,4,3,126107,126108,126111,1,4,0
36002,5,2,126112,126112,126114,0,2,1
36003,4,1,126116,126116,126117,0,1,2
36004,2,3,126118,126118,126121,0,3,1
36005,6,3,126124,126124,126127,0,3,3
36006,2,2,126126,126127,126129,1,3,0
36007,5,1,126131,126131,126132,0,1,2
36008,5,1,126136,126136,126137,0,1,4
36009,5,3,126141,126141,126144,0,3,4
36010,5,3,126146,126146,126149,0,3,2
36011,4,2,126150,126150,126152,0,2,1
36012,4,2,126154,126154,126156,0,2,2
36013,4,3,126158,126158,126161,0,3,2
36014,3,1,126161,126161,126162,0,1,0
36015,2,3,126163,126163,126166,0,3,1
36016,6,3,126169,126169,126172,0,3,3
36017,2,3,126171,126172,126175,1,4,0
36018,4,3,126175,126175,126178,0,3,0
36019,1,1,126176,126178,126179,2,3,0
36020,3,1,126179,126179,126180,0,1,0
36021,3,3,126182,126182,126185,0,3,2
36022,5,2,126187,126187,126189,0,2,2
36023,3,3,126190,126190,126193,0,3,1
36024,4,1,126194,126194,126195,0,1,1
36025,6,2,126200,126200,126202,0,2,5
36026,1,1,126201,126202,126203,1,2,0
36027,4,2,126205,126205,126207,0,2,2
36028,2,1,126207,126207,126208,0,1,0
36029,1,2,126208,126208,126210,0,2,0
36030,3,1,126211,126211,126212,0,1,1
36031,5,3,126216,126216,126219,0,3,4
36032,5,2,126221,126221,126223,0,2,2
36033,3,2,126224,126224,126226,0,2,1
36034,4,1,126228,126228,126229,0,1,2
36035,5,2,126233,126233,126235,0,2,4
36036,2,2,126235,126235,126237,0,2,0
36037,2,3,126237,126237,126240,0,3,0
36038,1,2,126238,126240,126242,2,4,0
36039,3,3,126241,126242,126245,1,4,0
36040,4,3,126245,126245,126248,0,3,0
36041,1,1,126246,126248,126249,2,3,0
36042,1,2,126247,126249,126251,2,4,0
36043,1,3,126248,126251,126254,3,6,0
36044,1,3,126249,126254,126257,5,8,0
36045,5,3,126254,126257,126260,3,6,0
36046,4,3,126258,126260,126263,2,5,0
36047,5,1,126263,126263,126264,0,1,0
36048,1,3,126264,126264,126267,0,3,0
36049,6,3,126270,126270,126273,0,3,3
36050,3,3,126273,126273,126276,0,3,0
36051,5,1,126278,126278,126279,0,1,2
36052,4,1,126282,126282,126283,0,1,3
36053,4,3,126286,126286,126289,0,3,3
36054,3,3,126289,126289,126292,0,3,0
36055,5,3,126294,126294,126297,0,3,2
36056,2,3,126296,126297,126300,1,4,0
36057,5,1,126301,126301,126302,0,1,1
36058,4,2,126305,126305,126307,0,2,3
36059,3,2,126308,126308,126310,0,2,1
36060,3,1,126311,126311,126312,0,1,1
36061,5,1,126316,126316,126317,0,1,4
36062,1,2,126317,126317,126319,0,2,0
36063,1,2,126318,126319,126321,1,3,0
36064,5,1,126323,126323,126324,0,1,2
36065,5,2,126328,126328,126330,0,2,4
36066,3,1,126331,126331,126332,0,1,1
36067,5,2,126336,126336,126338,0,2,4
36068,4,1,126340,126340,126341,0,1,2
36069,4,2,126344,126344,126346,0,2,3
36070,3,3,126347,126347,126350,0,3,1
36071,3,2,126350,126350,126352,0,2,0
36072,3,1,126353,126353,126354,0,1,1
36073,2,1,126355,126355,126356,0,1,1
36074,6,2,126361,126361,126363,0,2,5
36075,5,1,126366,126366,126367,0,1,3
36076,1,1,126367,126367,126368,0,1,0
36077,1,2,126368,126368,126370,0,2,0
36078,1,2,126369,126370,126372,1,3,0
36079,2,3,126371,126372,126375,1,4,0
36080,5,3,126376,126376,126379,0,3,1
36081,5,3,126381,126381,126384,0,3,2
36082,6,3,126387,126387,126390,0,3,3
36083,2,3,126389,126390,126393,1,4,0
36084,5,3,126394,126394,126397,0,3,1
36085,5,3,126399,126399,126402,0,3,2
36086,3,3,126402,126402,126405,0,3,0
36087,4,1,126406,126406,126407,0,1,1
36088,1,3,126407,126407,126410,0,3,0
36089,4,2,126411,126411,126413,0,2,1
36090,3,1,126414,126414,126415,0,1,1
36091,4,2,126418,126418,126420,0,2,3
36092,5,3,126423,126423,126426,0,3,3
36093,3,1,126426,126426,126427,0,1,0
36094,3,2,126429,126429,126431,0,2,2
36095,5,2,126434,126434,126436,0,2,3
36096,2,3,126436,126436,126439,0,3,0
36097,1,1,126437,126439,126440,2,3,0
36098,4,3,126441,126441,126444,0,3,1
36099,1,2,126442,126444,126446,2,4,0
36100,1,2,126443,126446,126448,3,5,0
36101,1,3,126444,126448,126451,4,7,0
36102,1,2,126445,126451,126453,6,8,0
36103,5,1,126450,126453,126454,3,4,0
36104,6,3,126456,126456,126459,0,3,2
36105,1,2,126457,126459,126461,2,4,0
36106,2,2,126459,126461,126463,2,4,0
36107,1,2,126460,126463,126465,3,5,0
36108,2,1,126462,126465,126466,3,4,0
36109,1,1,126463,126466,126467,3,4,0
36110,1,2,126464,126467,126469,3,5,0
36111,1,2,126465,126469,126471,4,6,0
36112,4,2,126469,126471,126473,2,4,0
36113,2,3,126471,126473,126476,2,5,0
36114,5,3,126476,126476,126479,0,3,0
36115,5,1,126481,126481,126482,0,1,2
36116,4,2,126485,126485,126487,0,2,3
36117,3,3,126488,126488,126491,0,3,1
36118,4,2,126492,126492,126494,0,2,1
36119,1,2,126493,126494,126496,1,3,0
36120,1,2,126494,126496,126498,2,4,0
36121,2,1,126496,126498,126499,2,3,0
36122,1,2,126497,126499,126501,2,4,0
36123,2,1,126499,126501,126502,2,3,0
36124,5,3,126504,126504,126507,0,3,2
36125,3,1,126507,126507,126508,0,1,0
36126,3,2,126510,126510,126512,0,2,2
36127,5,3,126515,126515,126518,0,3,3
36128,5,1,126520,126520,126521,0,1,2
36129,1,2,126521,126521,126523,0,2,0
36130,5,1,126526,126526,126527,0,1,3
36131,3,2,126529,126529,126531,0,2,2
36132,2,2,126531,126531,126533,0,2,0
36133,4,3,126535,126535,126538,0,3,2
36134,3,2,126538,126538,126540,0,2,0
36135,4,3,126542,126542,126545,0,3,2
36136,4,2,126546,126546,126548,0,2,1
36137,4,2,126550,126550,126552,0,2,2
36138,2,1,126552,126552,126553,0,1,0
36139,1,1,126553,126553,126554,0,1,0
36140,4,1,126557,126557,126558,0,1,3
36141,2,2,126559,126559,126561,0,2,1
36142,1,2,126560,126561,126563,1,3,0
36143,1,1,126561,126563,126564,2,3,0
36144,4,3,126565,126565,126568,0,3,1
36145,2,2,126567,126568,126570,1,3,0
36146,2,2,126569,126570,126572,1,3,0
36147,2,1,126571,126572,126573,1,2,0
36148,5,3,126576,126576,126579,0,3,3
36149,3,1,126579,126579,126580,0,1,0
36150,3,1,126582,126582,126583,0,1,2
36151,5,3,126587,126587,126590,0,3,4
36152,1,2,126588,126590,126592,2,4,0
36153,3,2,126591,126592,126594,1,3,0
36154,5,1,126596,126596,126597,0,1,2
36155,4,1,126600,126600,126601,0,1,3
36156,3,2,126603,126603,126605,0,2,2
36157,1,3,126604,126605,126608,1,4,0
36158,1,1,126605,126608,126609,3,4,0
36159,3,2,126608,126609,126611,1,3,0
36160,2,2,126610,126611,126613,1,3,0
36161,2,3,126612,126613,126616,1,4,0
36162,3,3,126615,126616,126619,1,4,0
36163,2,2,126617,126619,126621,2,4,0
36164,6,2,126623,126623,126625,0,2,2
36165,1,3,126624,126625,126628,1,4,0
36166,4,1,126628,126628,126629,0,1,0
36167,3,1,126631,126631,126632,0,1,2
36168,3,1,126634,126634,126635,0,1,2
36169,1,3,126635,126635,126638,0,3,0
36170,1,3,126636,126638,126641,2,5,0
36171,1,2,126637,126641,126643,4,6,0
36172,5,2,126642,126643,126645,1,3,0
36173,5,3,126647,126647,126650,0,3,2
36174,6,2,126653,126653,126655,0,2,3
36175,2,1,126655,126655,126656,0,1,0
36176,3,2,126658,126658,126660,0,2,2
36177,5,2,126663,126663,126665,0,2,3
36178,1,1,126664,126665,126666,1,2,0
36179,5,2,126669,126669,126671,0,2,3
36180,4,1,126673,126673,126674,0,1,2
36181,5,2,126678,126678,126680,0,2,4
36182,2,2,126680,126680,126682,0,2,0
36183,1,3,126681,126682,126685,1,4,0
36184,1,3,126682,126685,126688,3,6,0
36185,4,1,126686,126688,126689,2,3,0
36186,1,2,126687,126689,126691,2,4,0
36187,3,1,126690,126691,126692,1,2,0
36188,5,3,126695,126695,126698,0,3,3
36189,2,1,126697,126698,126699,1,2,0
36190,5,3,126702,126702,126705,0,3,3
36191,5,1,126707,126707,126708,0,1,2
36192,2,3,126709,126709,126712,0,3,1
36193,1,3,126710,126712,126715,2,5,0
36194,6,2,126716,126716,126718,0,2,1
36195,4,3,126720,126720,126723,0,3,2
36196,2,3,126722,126723,126726,1,4,0
36197,6,3,126728,126728,126731,0,3,2
36198,2,1,126730,126731,126732,1,2,0
36199,5,3,126735,126735,126738,0,3,3
36200,5,1,126740,126740,126741,0,1,2
36201,4,3,126744,126744,126747,0,3,3
36202,4,3,126748,126748,126751,0,3,1
36203,5,2,126753,126753,126755,0,2,2
36204,4,2,126757,126757,126759,0,2,2
36205,1,2,126758,126759,126761,1,3,0
36206,3,1,126761,126761,126762,0,1,0
36207,4,1,126765,126765,126766,0,1,3
36208,4,1,126769,126769,126770,0,1,3
36209,4,3,126773,126773,126776,0,3,3
36210,1,2,126774,126776,126778,2,4,0
36211,1,2,126775,126778,126780,3,5,0
36212,6,3,126781,126781,126784,0,3,1
36213,2,1,126783,126784,126785,1,2,0
36214,1,2,126784,126785,126787,1,3,0
36215,3,2,126787,126787,126789,0,2,0
36216,5,3,126792,126792,126795,0,3,3
36217,6,3,126798,126798,126801,0,3,3
36218,3,2,126801,126801,126803,0,2,0
36219,4,2,126805,126805,126807,0,2,2
36220,3,2,126808,126808,126810,0,2,1
36221,1,1,126809,126810,126811,1,2,0
36222,5,3,126814,126814,126817,0,3,3
36223,6,1,126820,126820,126821,0,1,3
36224,3,1,126823,126823,126824,0,1,2
36225,4,2,126827,126827,126829,0,2,3
36226,1,2,126828,126829,126831,1,3,0
36227,2,1,126830,126831,126832,1,2,0
36228,6,2,126836,126836,126838,0,2,4
36229,1,2,126837,126838,126840,1,3,0
36230,3,1,126840,126840,126841,0,1,0
36231,2,2,126842,126842,126844,0,2,1
36232,3,3,126845,126845,126848,0,3,1
36233,3,1,126848,126848,126849,0,1,0
36234,1,2,126849,126849,126851,0,2,0
36235,6,3,126855,126855,126858,0,3,4
36236,4,3,126859,126859,126862,0,3,1
36237,2,3,126861,126862,126865,1,4,0
36238,5,3,126866,126866,126869,0,3,1
36239,3,3,126869,126869,126872,0,3,0
36240,3,3,126872,126872,126875,0,3,0
36241,5,3,126877,126877,126880,0,3,2
36242,1,2,126878,126880,126882,2,4,0
36243,6,2,126884,126884,126886,0,2,2
36244,6,2,126890,126890,126892,0,2,4
36245,5,3,126895,126895,126898,0,3,3
36246,4,1,126899,126899,126900,0,1,1
36247,4,3,126903,126903,126906,0,3,3
36248,5,3,126908,126908,126911,0,3,2
36249,4,2,126912,126912,126914,0,2,1
36250,5,3,126917,126917,126920,0,3,3
36251,5,3,126922,126922,126925,0,3,2
36252,3,3,126925,126925,126928,0,3,0
36253,2,3,126927,126928,126931,1,4,0
36254,2,1,126929,126931,126932,2,3,0
36255,3,2,126932,126932,126934,0,2,0
36256,5,1,126937,126937,126938,0,1,3
36257,4,1,126941,126941,126942,0,1,3
36258,4,1,126945,126945,126946,0,1,3
36259,6,2,126951,126951,126953,0,2,5
36260,1,2,126952,126953,126955,1,3,0
36261,3,3,126955,126955,126958,0,3,0
36262,3,2,126958,126958,126960,0,2,0
36263,3,3,126961,126961,126964,0,3,1
36264,2,2,126963,126964,126966,1,3,0
36265,5,2,126968,126968,126970,0,2,2
36266,4,3,126972,126972,126975,0,3,2
36267,1,3,126973,126975,126978,2,5,0
36268,4,2,126977,126978,126980,1,3,0
36269,1,2,126978,126980,126982,2,4,0
36270,5,1,126983,126983,126984,0,1,1
36271,6,3,126989,126989,126992,0,3,5
36272,1,1,126990,126992,126993,2,3,0
36273,1,3,126991,126993,126996,2,5,0
36274,1,3,126992,126996,126999,4,7,0
36275,1,3,126993,126999,127002,6,9,0
36276,2,1,126995,127002,127003,7,8,0
36277,6,3,127001,127003,127006,2,5,0
36278,6,2,127007,127007,127009,0,2,1
36279,6,3,127013,127013,127016,0,3,4
36280,6,1,127019,127019,127020,0,1,3
36281,1,2,127020,127020,127022,0,2,0
36282,6,3,127026,127026,127029,0,3,4
36283,3,2,127029,127029,127031,0,2,0
36284,2,3,127031,127031,127034,0,3,0
36285,3,2,127034,127034,127036,0,2,0
36286,6,2,127040,127040,127042,0,2,4
36287,6,3,127046,127046,127049,0,3,4
36288,6,1,127052,127052,127053,0,1,3
36289,6,1,127058,127058,127059,0,1,5
36290,4,1,127062,127062,127063,0,1,3
36291,3,1,127065,127065,127066,0,1,2
36292,5,2,127070,127070,127072,0,2,4
36293,3,3,127073,127073,127076,0,3,1
36294,2,2,127075,127076,127078,1,3,0
36295,3,1,127078,127078,127079,0,1,0
36296,3,2,127081,127081,127083,0,2,2
36297,4,3,127085,127085,127088,0,3,2
36298,5,2,127090,127090,127092,0,2,2
36299,5,3,127095,127095,127098,0,3,3
36300,2,1,127097,127098,127099,1,2,0
36301,5,3,127102,127102,127105,0,3,3
36302,3,1,127105,127105,127106,0,1,0
36303,6,3,127111,127111,127114,0,3,5
36304,2,1,127113,127114,127115,1,2,0
36305,2,1,127115,127115,127116,0,1,0
36306,2,3,127117,127117,127120,0,3,1
36307,6,2,127123,127123,127125,0,2,3
36308,4,2,127127,127127,127129,0,2,2
36309,1,1,127128,127129,127130,1,2,0
36310,5,1,127133,127133,127134,0,1,3
36311,4,2,127137,127137,127139,0,2,3
36312,1,2,127138,127139,127141,1,3,0
36313,1,2,127139,127141,127143,2,4,0
36314,1,2,127140,127143,127145,3,5,0
36315,4,3,127144,127145,127148,1,4,0
36316,3,1,127147,127148,127149,1,2,0
36317,1,1,127148,127149,127150,1,2,0
36318,6,1,127154,127154,127155,0,1,4
36319,5,2,127159,127159,127161,0,2,4
36320,4,2,127163,127163,127165,0,2,2
36321,1,1,127164,127165,127166,1,2,0
36322,6,2,127170,127170,127172,0,2,4
36323,4,3,127174,127174,127177,0,3,2
36324,6,2,127180,127180,127182,0,2,3
36325,6,3,127186,127186,127189,0,3,4
36326,4,1,127190,127190,127191,0,1,1
36327,6,1,127196,127196,127197,0,1,5
36328,3,1,127199,127199,127200,0,1,2
36329,2,3,127201,127201,127204,0,3,1
36330,4,3,127205,127205,127208,0,3,1
36331,3,2,127208,127208,127210,0,2,0
36332,6,3,127214,127214,127217,0,3,4
36333,3,1,127217,127217,127218,0,1,0
36334,1,3,127218,127218,127221,0,3,0
36335,6,1,127224,127224,127225,0,1,3
36336,6,3,127230,127230,127233,0,3,5
36337,5,2,127235,127235,127237,0,2,2
36338,2,1,127237,127237,127238,0,1,0
36339,1,3,127238,127238,127241,0,3,0
36340,6,3,127244,127244,127247,0,3,3
36341,6,2,127250,127250,127252,0,2,3
36342,6,1,127256,127256,127257,0,1,4
36343,2,3,127258,127258,127261,0,3,1
36344,6,3,127264,127264,127267,0,3,3
36345,1,3,127265,127267,127270,2,5,0
36346,6,2,127271,127271,127273,0,2,1
36347,2,3,127273,127273,127276,0,3,0
36348,2,3,127275,127276,127279,1,4,0
36349,1,1,127276,127279,127280,3,4,0
36350,1,3,127277,127280,127283,3,6,0
36351,5,2,127282,127283,127285,1,3,0
36352,6,3,127288,127288,127291,0,3,3
36353,6,3,127294,127294,127297,0,3,3
36354,1,1,127295,127297,127298,2,3,0
36355,1,2,127296,127298,127300,2,4,0
36356,3,3,127299,127300,127303,1,4,0
36357,1,2,127300,127303,127305,3,5,0
36358,6,2,127306,127306,127308,0,2,1
36359,6,2,127312,127312,127314,0,2,4
36360,6,3,127318,127318,127321,0,3,4
36361,2,3,127320,127321,127324,1,4,0
36362,4,1,127324,127324,127325,0,1,0
36363,1,1,127325,127325,127326,0,1,0
36364,2,3,127327,127327,127330,0,3,1
36365,1,1,127328,127330,127331,2,3,0
36366,6,1,127334,127334,127335,0,1,3
36367,6,1,127340,127340,127341,0,1,5
36368,1,1,127341,127341,127342,0,1,0
36369,5,3,127346,127346,127349,0,3,4
36370,5,1,127351,127351,127352,0,1,2
36371,3,1,127354,127354,127355,0,1,2
36372,4,1,127358,127358,127359,0,1,3
36373,6,1,127364,127364,127365,0,1,5
36374,1,1,127365,127365,127366,0,1,0
36375,6,3,127371,127371,127374,0,3,5
36376,3,1,127374,127374,127375,0,1,0
36377,5,2,127379,127379,127381,0,2,4
36378,4,2,127383,127383,127385,0,2,2
36379,6,2,127389,127389,127391,0,2,4
36380,6,2,127395,127395,127397,0,2,4
36381,2,2,127397,127397,127399,0,2,0
36382,4,2,127401,127401,127403,0,2,2
36383,6,2,127407,127407,127409,0,2,4
36384,4,3,127411,127411,127414,0,3,2
36385,5,1,127416,127416,127417,0,1,2
36386,1,1,127417,127417,127418,0,1,0
36387,3,1,127420,127420,127421,0,1,2
36388,4,3,127424,127424,127427,0,3,3
36389,3,1,127427,127427,127428,0,1,0
36390,1,1,127428,127428,127429,0,1,0
36391,4,1,127432,127432,127433,0,1,3
36392,1,3,127433,127433,127436,0,3,0
36393,1,3,127434,127436,127439,2,5,0
36394,3,2,127437,127439,127441,2,4,0
36395,6,1,127443,127443,127444,0,1,2
36396,2,3,127445,127445,127448,0,3,1
36397,1,3,127446,127448,127451,2,5,0
36398,6,2,127452,127452,127454,0,2,1
36399,5,1,127457,127457,127458,0,1,3
36400,5,1,127462,127462,127463,0,1,4
36401,5,3,127467,127467,127470,0,3,4
36402,4,1,127471,127471,127472,0,1,1
36403,5,2,127476,127476,127478,0,2,4
36404,1,1,127477,127478,127479,1,2,0
36405,5,2,127482,127482,127484,0,2,3
36406,5,3,127487,127487,127490,0,3,3
36407,2,1,127489,127490,127491,1,2,0
36408,3,1,127492,127492,127493,0,1,1
36409,3,3,127495,127495,127498,0,3,2
36410,2,3,127497,127498,127501,1,4,0
36411,1,1,127498,127501,127502,3,4,0
36412,6,1,127504,127504,127505,0,1,2
36413,2,3,127506,127506,127509,0,3,1
36414,3,3,127509,127509,127512,0,3,0
36415,2,3,127511,127512,127515,1,4,0
36416,3,3,127514,127515,127518,1,4,0
36417,5,2,127519,127519,127521,0,2,1
36418,2,3,127521,127521,127524,0,3,0
36419,5,3,127526,127526,127529,0,3,2
36420,3,2,127529,127529,127531,0,2,0
36421,3,1,127532,127532,127533,0,1,1
36422,2,1,127534,127534,127535,0,1,1
36423,2,2,127536,127536,127538,0,2,1
36424,4,3,127540,127540,127543,0,3,2
36425,6,3,127546,127546,127549,0,3,3
36426,2,2,127548,127549,127551,1,3,0
36427,4,3,127552,127552,127555,0,3,1
36428,3,3,127555,127555,127558,0,3,0
36429,4,2,127559,127559,127561,0,2,1
36430,3,1,127562,127562,127563,0,1,1
36431,4,3,127566,127566,127569,0,3,3
36432,3,3,127569,127569,127572,0,3,0
36433,6,3,127575,127575,127578,0,3,3
36434,6,2,127581,127581,127583,0,2,3
36435,3,2,127584,127584,127586,0,2,1
36436,1,3,127585,127586,127589,1,4,0
36437,3,2,127588,127589,127591,1,3,0
36438,6,1,127594,127594,127595,0,1,3
36439,4,1,127598,127598,127599,0,1,3
36440,2,3,127600,127600,127603,0,3,1
36441,3,3,127603,127603,127606,0,3,0
36442,1,1,127604,127606,127607,2,3,0
36443,6,3,127610,127610,127613,0,3,3
36444,6,3,127616,127616,127619,0,3,3
36445,2,3,127618,127619,127622,1,4,0
36446,5,1,127623,127623,127624,0,1,1
36447,2,2,127625,127625,127627,0,2,1
36448,2,1,127627,127627,127628,0,1,0
36449,1,3,127628,127628,127631,0,3,0
36450,4,1,127632,127632,127633,0,1,1
36451,6,3,127638,127638,127641,0,3,5
36452,6,3,127644,127644,127647,0,3,3
36453,2,1,127646,127647,127648,1,2,0
36454,6,2,127652,127652,127654,0,2,4
36455,5,1,127657,127657,127658,0,1,3
36456,5,3,127662,127662,127665,0,3,4
36457,5,2,127667,127667,127669,0,2,2
36458,3,1,127670,127670,127671,0,1,1
36459,2,2,127672,127672,127674,0,2,1
36460,4,3,127676,127676,127679,0,3,2
36461,4,1,127680,127680,127681,0,1,1
36462,5,1,127685,127685,127686,0,1,4
36463,1,2,127686,127686,127688,0,2,0
36464,4,2,127690,127690,127692,0,2,2
36465,3,3,127693,127693,127696,0,3,1
36466,4,2,127697,127697,127699,0,2,1
36467,6,2,127703,127703,127705,0,2,4
36468,6,2,127709,127709,127711,0,2,4
36469,2,1,127711,127711,127712,0,1,0
36470,3,2,127714,127714,127716,0,2,2
36471,1,3,127715,127716,127719,1,4,0
36472,6,1,127721,127721,127722,0,1,2
36473,6,2,127727,127727,127729,0,2,5
36474,5,1,127732,127732,127733,0,1,3
36475,2,2,127734,127734,127736,0,2,1
36476,6,1,127740,127740,127741,0,1,4
36477,3,1,127743,127743,127744,0,1,2
36478,1,1,127744,127744,127745,0,1,0
36479,5,1,127749,127749,127750,0,1,4
36480,5,3,127754,127754,127757,0,3,4
36481,6,2,127760,127760,127762,0,2,3
36482,2,1,127762,127762,127763,0,1,0
36483,5,1,127767,127767,127768,0,1,4
36484,5,2,127772,127772,127774,0,2,4
36485,6,1,127778,127778,127779,0,1,4
36486,1,2,127779,127779,127781,0,2,0
36487,6,3,127785,127785,127788,0,3,4
36488,2,3,127787,127788,127791,1,4,0
36489,2,3,127789,127791,127794,2,5,0
36490,2,1,127791,127794,127795,3,4,0
36491,5,3,127796,127796,127799,0,3,1
36492,3,3,127799,127799,127802,0,3,0
36493,3,2,127802,127802,127804,0,2,0
36494,6,3,127808,127808,127811,0,3,4
36495,1,3,127809,127811,127814,2,5,0
36496,1,1,127810,127814,127815,4,5,0
36497,4,2,127814,127815,127817,1,3,0
36498,2,3,127816,127817,127820,1,4,0
36499,5,1,127821,127821,127822,0,1,1
36500,3,2,127824,127824,127826,0,2,2
36501,2,2,127826,127826,127828,0,2,0
36502,1,2,127827,127828,127830,1,3,0
36503,1,1,127828,127830,127831,2,3,0
36504,3,2,127831,127831,127833,0,2,0
36505,6,3,127837,127837,127840,0,3,4
36506,6,2,127843,127843,127845,0,2,3
36507,5,3,127848,127848,127851,0,3,3
36508,5,3,127853,127853,127856,0,3,2
36509,1,3,127854,127856,127859,2,5,0
36510,2,1,127856,127859,127860,3,4,0
36511,5,1,127861,127861,127862,0,1,1
36512,1,1,127862,127862,127863,0,1,0
36513,1,1,127863,127863,127864,0,1,0
36514,6,2,127869,127869,127871,0,2,5
36515,6,2,127875,127875,127877,0,2,4
36516,5,3,127880,127880,127883,0,3,3
36517,6,3,127886,127886,127889,0,3,3
36518,1,1,127887,127889,127890,2,3,0
36519,3,3,127890,127890,127893,0,3,0
36520,6,1,127896,127896,127897,0,1,3
36521,2,3,127898,127898,127901,0,3,1
36522,4,3,127902,127902,127905,0,3,1
36523,5,2,127907,127907,127909,0,2,2
36524,3,2,127910,127910,127912,0,2,1
36525,1,1,127911,127912,127913,1,2,0
36526,5,1,127916,127916,127917,0,1,3
36527,2,3,127918,127918,127921,0,3,1
36528,1,3,127919,127921,127924,2,5,0
36529,3,3,127922,127924,127927,2,5,0
36530,6,1,127928,127928,127929,0,1,1
36531,4,1,127932,127932,127933,0,1,3
36532,6,2,127938,127938,127940,0,2,5
36533,4,1,127942,127942,127943,0,1,2
36534,1,2,127943,127943,127945,0,2,0
36535,2,1,127945,127945,127946,0,1,0
36536,6,2,127951,127951,127953,0,2,5
36537,6,3,127957,127957,127960,0,3,4
36538,3,1,127960,127960,127961,0,1,0
36539,3,3,127963,127963,127966,0,3,2
36540,6,1,127969,127969,127970,0,1,3
36541,2,1,127971,127971,127972,0,1,1
36542,5,3,127976,127976,127979,0,3,4
36543,1,3,127977,127979,127982,2,5,0
36544,5,1,127982,127982,127983,0,1,0
36545,1,1,127983,127983,127984,0,1,0
36546,4,2,127987,127987,127989,0,2,3
36547,6,2,127993,127993,127995,0,2,4
36548,2,2,127995,127995,127997,0,2,0
36549,2,1,127997,127997,127998,0,1,0
36550,6,1,128003,128003,128004,0,1,5
36551,4,1,128007,128007,128008,0,1,3
36552,1,1,128008,128008,128009,0,1,0
36553,6,3,128014,128014,128017,0,3,5
36554,4,2,128018,128018,128020,0,2,1
36555,3,1,128021,128021,128022,0,1,1
36556,3,2,128024,128024,128026,0,2,2
36557,2,3,128026,128026,128029,0,3,0
36558,4,2,128030,128030,128032,0,2,1
36559,5,3,128035,128035,128038,0,3,3
36560,2,3,128037,128038,128041,1,4,0
36561,3,1,128040,128041,128042,1,2,0
36562,6,1,128046,128046,128047,0,1,4
36563,3,3,128049,128049,128052,0,3,2
36564,5,1,128054,128054,128055,0,1,2
36565,6,1,128060,128060,128061,0,1,5
36566,2,1,128062,128062,128063,0,1,1
36567,3,3,128065,128065,128068,0,3,2
36568,3,1,128068,128068,128069,0,1,0
36569,3,3,128071,128071,128074,0,3,2
36570,5,1,128076,128076,128077,0,1,2
36571,4,2,128080,128080,128082,0,2,3
36572,3,1,128083,128083,128084,0,1,1
36573,3,1,128086,128086,128087,0,1,2
36574,1,2,128087,128087,128089,0,2,0
36575,6,3,128093,128093,128096,0,3,4
36576,6,3,128099,128099,128102,0,3,3
36577,2,2,128101,128102,128104,1,3,0
36578,1,3,128102,128104,128107,2,5,0
36579,3,2,128105,128107,128109,2,4,0
36580,5,2,128110,128110,128112,0,2,1
36581,4,2,128114,128114,128116,0,2,2
36582,4,1,128118,128118,128119,0,1,2
36583,3,3,128121,128121,128124,0,3,2
36584,3,3,128124,128124,128127,0,3,0
36585,6,1,128130,128130,128131,0,1,3
36586,3,3,128133,128133,128136,0,3,2
36587,1,1,128134,128136,128137,2,3,0
36588,5,1,128139,128139,128140,0,1,2
36589,6,3,128145,128145,128148,0,3,5
36590,3,1,128148,128148,128149,0,1,0
36591,5,1,128153,128153,128154,0,1,4
36592,4,3,128157,128157,128160,0,3,3
36593,5,2,128162,128162,128164,0,2,2
36594,3,2,128165,128165,128167,0,2,1
36595,2,1,128167,128167,128168,0,1,0
36596,5,2,128172,128172,128174,0,2,4
36597,4,3,128176,128176,128179,0,3,2
36598,6,1,128182,128182,128183,0,1,3
36599,3,2,128185,128185,128187,0,2,2
36600,3,2,128188,128188,128190,0,2,1
36601,3,2,128191,128191,128193,0,2,1
36602,4,3,128195,128195,128198,0,3,2
36603,2,1,128197,128198,128199,1,2,0
36604,1,3,128198,128199,128202,1,4,0
36605,3,3,128201,128202,128205,1,4,0
36606,3,1,128204,128205,128206,1,2,0
36607,2,2,128206,128206,128208,0,2,0
36608,1,2,128207,128208,128210,1,3,0
36609,4,2,128211,128211,128213,0,2,1
36610,5,1,128216,128216,128217,0,1,3
36611,3,2,128219,128219,128221,0,2,2
36612,6,2,128225,128225,128227,0,2,4
36613,4,1,128229,128229,128230,0,1,2
36614,2,2,128231,128231,128233,0,2,1
36615,3,3,128234,128234,128237,0,3,1
36616,3,1,128237,128237,128238,0,1,0
36617,4,1,128241,128241,128242,0,1,3
36618,4,1,128245,128245,128246,0,1,3
36619,6,1,128251,128251,128252,0,1,5
36620,3,3,128254,128254,128257,0,3,2
36621,6,1,128260,128260,128261,0,1,3
36622,4,1,128264,128264,128265,0,1,3
36623,6,3,128270,128270,128273,0,3,5
36624,5,2,128275,128275,128277,0,2,2
36625,6,1,128281,128281,128282,0,1,4
36626,3,2,128284,128284,128286,0,2,2
36627,3,3,128287,128287,128290,0,3,1
36628,3,3,128290,128290,128293,0,3,0
36629,2,1,128292,128293,128294,1,2,0
36630,4,3,128296,128296,128299,0,3,2
36631,2,2,128298,128299,128301,1,3,0
36632,6,2,128304,128304,128306,0,2,3
36633,4,2,128308,128308,128310,0,2,2
36634,5,1,128313,128313,128314,0,1,3
36635,2,3,128315,128315,128318,0,3,1
36636,4,1,128319,128319,128320,0,1,1
36637,5,1,128324,128324,128325,0,1,4
36638,4,2,128328,128328,128330,0,2,3
36639,5,3,128333,128333,128336,0,3,3
36640,3,2,128336,128336,128338,0,2,0
36641,6,3,128342,128342,128345,0,3,4
36642,3,3,128345,128345,128348,0,3,0
36643,3,3,128348,128348,128351,0,3,0
36644,5,3,128353,128353,128356,0,3,2
36645,1,1,128354,128356,128357,2,3,0
36646,5,3,128359,128359,128362,0,3,2
36647,3,3,128362,128362,128365,0,3,0
36648,6,1,128368,128368,128369,0,1,3
36649,3,3,128371,128371,128374,0,3,2
36650,5,3,128376,128376,128379,0,3,2
36651,3,3,128379,128379,128382,0,3,0
36652,3,3,128382,128382,128385,0,3,0
36653,6,3,128388,128388,128391,0,3,3
36654,2,2,128390,128391,128393,1,3,0
36655,4,3,128394,128394,128397,0,3,1
36656,3,3,128397,128397,128400,0,3,0
36657,5,2,128402,128402,128404,0,2,2
36658,6,3,128408,128408,128411,0,3,4
36659,4,1,128412,128412,128413,0,1,1
36660,5,3,128417,128417,128420,0,3,4
36661,6,3,128423,128423,128426,0,3,3
36662,4,1,128427,128427,128428,0,1,1
36663,3,1,128430,128430,128431,0,1,2
36664,6,2,128436,128436,128438,0,2,5
36665,2,2,128438,128438,128440,0,2,0
36666,3,1,128441,128441,128442,0,1,1
36667,4,3,128445,128445,128448,0,3,3
36668,4,1,128449,128449,128450,0,1,1
36669,1,3,128450,128450,128453,0,3,0
36670,4,3,128454,128454,128457,0,3,1
36671,3,2,128457,128457,128459,0,2,0
36672,2,1,128459,128459,128460,0,1,0
36673,2,1,128461,128461,128462,0,1,1
36674,1,2,128462,128462,128464,0,2,0
36675,4,3,128466,128466,128469,0,3,2
36676,1,2,128467,128469,128471,2,4,0
36677,2,3,128469,128471,128474,2,5,0
36678,3,2,128472,128474,128476,2,4,0
36679,6,1,128478,128478,128479,0,1,2
36680,2,3,128480,128480,128483,0,3,1
36681,6,2,128486,128486,128488,0,2,3
36682,6,1,128492,128492,128493,0,1,4
36683,5,2,128497,128497,128499,0,2,4
36684,2,3,128499,128499,128502,0,3,0
36685,4,2,128503,128503,128505,0,2,1
36686,5,1,128508,128508,128509,0,1,3
36687,1,2,128509,128509,128511,0,2,0
36688,5,3,128514,128514,128517,0,3,3
36689,4,2,128518,128518,128520,0,2,1
36690,2,1,128520,128520,128521,0,1,0
36691,2,3,128522,128522,128525,0,3,1
36692,6,1,128528,128528,128529,0,1,3
36693,2,1,128530,128530,128531,0,1,1
36694,4,3,128534,128534,128537,0,3,3
36695,4,2,128538,128538,128540,0,2,1
36696,3,2,128541,128541,128543,0,2,1
36697,6,1,128547,128547,128548,0,1,4
36698,5,2,128552,128552,128554,0,2,4
36699,1,1,128553,128554,128555,1,2,0
36700,2,2,128555,128555,128557,0,2,0
36701,1,3,128556,128557,128560,1,4,0
36702,5,2,128561,128561,128563,0,2,1
36703,3,3,128564,128564,128567,0,3,1
36704,6,3,128570,128570,128573,0,3,3
36705,6,1,128576,128576,128577,0,1,3
36706,6,1,128582,128582,128583,0,1,5
36707,5,2,128587,128587,128589,0,2,4
36708,1,3,128588,128589,128592,1,4,0
36709,4,1,128592,128592,128593,0,1,0
36710,5,2,128597,128597,128599,0,2,4
36711,3,3,128600,128600,128603,0,3,1
36712,1,2,128601,128603,128605,2,4,0
36713,3,2,128604,128605,128607,1,3,0
36714,5,2,128609,128609,128611,0,2,2
36715,6,2,128615,128615,128617,0,2,4
36716,4,2,128619,128619,128621,0,2,2
36717,5,1,128624,128624,128625,0,1,3
36718,4,1,128628,128628,128629,0,1,3
36719,2,1,128630,128630,128631,0,1,1
36720,2,3,128632,128632,128635,0,3,1
36721,1,1,128633,128635,128636,2,3,0
36722,5,1,128638,128638,128639,0,1,2
36723,4,1,128642,128642,128643,0,1,3
36724,1,3,128643,128643,128646,0,3,0
36725,6,2,128649,128649,128651,0,2,3
36726,5,3,128654,128654,128657,0,3,3
36727,4,2,128658,128658,128660,0,2,1
36728,2,2,128660,128660,128662,0,2,0
36729,6,1,128666,128666,128667,0,1,4
36730,1,1,128667,128667,128668,0,1,0
36731,5,3,128672,128672,128675,0,3,4
36732,1,2,128673,128675,128677,2,4,0
36733,5,3,128678,128678,128681,0,3,1
36734,6,3,128684,128684,128687,0,3,3
36735,2,2,128686,128687,128689,1,3,0
36736,3,2,128689,128689,128691,0,2,0
36737,4,1,128693,128693,128694,0,1,2
36738,1,2,128694,128694,128696,0,2,0
36739,6,3,128700,128700,128703,0,3,4
36740,3,3,128703,128703,128706,0,3,0
36741,6,2,128709,128709,128711,0,2,3
36742,3,1,128712,128712,128713,0,1,1
36743,1,1,128713,128713,128714,0,1,0
36744,5,1,128718,128718,128719,0,1,4
36745,1,3,128719,128719,128722,0,3,0
36746,5,3,128724,128724,128727,0,3,2
36747,5,2,128729,128729,128731,0,2,2
36748,5,3,128734,128734,128737,0,3,3
36749,3,1,128737,128737,128738,0,1,0
36750,3,2,128740,128740,128742,0,2,2
36751,6,2,128746,128746,128748,0,2,4
36752,1,2,128747,128748,128750,1,3,0
36753,5,2,128752,128752,128754,0,2,2
36754,2,1,128754,128754,128755,0,1,0
36755,3,2,128757,128757,128759,0,2,2
36756,4,3,128761,128761,128764,0,3,2
36757,1,2,128762,128764,128766,2,4,0
36758,5,1,128767,128767,128768,0,1,1
36759,4,3,128771,128771,128774,0,3,3
36760,1,1,128772,128774,128775,2,3,0
36761,2,1,128774,128775,128776,1,2,0
36762,3,3,128777,128777,128780,0,3,1
36763,1,3,128778,128780,128783,2,5,0
36764,2,2,128780,128783,128785,3,5,0
36765,2,2,128782,128785,128787,3,5,0
36766,3,2,128785,128787,128789,2,4,0
36767,5,1,128790,128790,128791,0,1,1
36768,5,3,128795,128795,128798,0,3,4
36769,4,1,128799,128799,128800,0,1,1
36770,3,2,128802,128802,128804,0,2,2
36771,5,3,128807,128807,128810,0,3,3
36772,1,3,128808,128810,128813,2,5,0
36773,3,3,128811,128813,128816,2,5,0
36774,1,1,128812,128816,128817,4,5,0
36775,4,1,128816,128817,128818,1,2,0
36776,4,1,128820,128820,128821,0,1,2
36777,1,2,128821,128821,128823,0,2,0
36778,6,3,128827,128827,128830,0,3,4
36779,3,3,128830,128830,128833,0,3,0
36780,5,3,128835,128835,128838,0,3,2
36781,4,2,128839,128839,128841,0,2,1
36782,4,1,128843,128843,128844,0,1,2
36783,3,2,128846,128846,128848,0,2,2
36784,6,2,128852,128852,128854,0,2,4
36785,6,1,128858,128858,128859,0,1,4
36786,3,1,128861,128861,128862,0,1,2
36787,2,1,128863,128863,128864,0,1,1
36788,5,2,128868,128868,128870,0,2,4
36789,3,1,128871,128871,128872,0,1,1
36790,5,2,128876,128876,128878,0,2,4
36791,1,1,128877,128878,128879,1,2,0
36792,1,1,128878,128879,128880,1,2,0
36793,3,1,128881,128881,128882,0,1,1
36794,6,3,128887,128887,128890,0,3,5
36795,1,3,128888,128890,128893,2,5,0
36796,2,2,128890,128893,128895,3,5,0
36797,2,2,128892,128895,128897,3,5,0
36798,5,2,128897,128897,128899,0,2,0
36799,3,2,128900,128900,128902,0,2,1
36800,5,2,128905,128905,128907,0,2,3
36801,2,3,128907,128907,128910,0,3,0
36802,2,1,128909,128910,128911,1,2,0
36803,6,3,128915,128915,128918,0,3,4
36804,5,3,128920,128920,128923,0,3,2
36805,6,2,128926,128926,128928,0,2,3
36806,4,1,128930,128930,128931,0,1,2
36807,2,3,128932,128932,128935,0,3,1
36808,5,1,128937,128937,128938,0,1,2
36809,6,2,128943,128943,128945,0,2,5
36810,6,3,128949,128949,128952,0,3,4
36811,6,3,128955,128955,128958,0,3,3
36812,3,1,128958,128958,128959,0,1,0
36813,5,2,128963,128963,128965,0,2,4
36814,2,1,128965,128965,128966,0,1,0
36815,4,1,128969,128969,128970,0,1,3
36816,2,1,128971,128971,128972,0,1,1
36817,6,3,128977,128977,128980,0,3,5
36818,1,1,128978,128980,128981,2,3,0
36819,5,3,128983,128983,128986,0,3,2
36820,6,3,128989,128989,128992,0,3,3
36821,6,1,128995,128995,128996,0,1,3
36822,3,1,128998,128998,128999,0,1,2
36823,6,1,129004,129004,129005,0,1,5
36824,6,2,129010,129010,129012,0,2,5
36825,3,3,129013,129013,129016,0,3,1
36826,4,3,129017,129017,129020,0,3,1
36827,6,2,129023,129023,129025,0,2,3
36828,4,2,129027,129027,129029,0,2,2
36829,3,3,129030,129030,129033,0,3,1
36830,6,1,129036,129036,129037,0,1,3
36831,1,2,129037,129037,129039,0,2,0
36832,2,3,129039,129039,129042,0,3,0
36833,3,2,129042,129042,129044,0,2,0
36834,2,2,129044,129044,129046,0,2,0
36835,1,1,129045,129046,129047,1,2,0
36836,3,2,129048,129048,129050,0,2,1
36837,4,1,129052,129052,129053,0,1,2
36838,2,1,129054,129054,129055,0,1,1
36839,6,1,129060,129060,129061,0,1,5
36840,2,2,129062,129062,129064,0,2,1
36841,3,1,129065,129065,129066,0,1,1
36842,3,2,129068,129068,129070,0,2,2
36843,4,2,129072,129072,129074,0,2,2
36844,1,1,129073,129074,129075,1,2,0
36845,3,3,129076,129076,129079,0,3,1
36846,6,2,129082,129082,129084,0,2,3
36847,4,2,129086,129086,129088,0,2,2
36848,3,3,129089,129089,129092,0,3,1
36849,1,1,129090,129092,129093,2,3,0
36850,1,2,129091,129093,129095,2,4,0
36851,2,3,129093,129095,129098,2,5,0
36852,4,1,129097,129098,129099,1,2,0
36853,5,3,129102,129102,129105,0,3,3
36854,2,1,129104,129105,129106,1,2,0
36855,5,2,129109,129109,129111,0,2,3
36856,2,2,129111,129111,129113,0,2,0
36857,6,1,129117,129117,129118,0,1,4
36858,3,2,129120,129120,129122,0,2,2
36859,4,3,129124,129124,129127,0,3,2
36860,1,3,129125,129127,129130,2,5,0
36861,1,1,129126,129130,129131,4,5,0
36862,3,3,129129,129131,129134,2,5,0
36863,1,2,129130,129134,129136,4,6,0
36864,6,3,129136,129136,129139,0,3,0
36865,1,3,129137,129139,129142,2,5,0
36866,6,3,129143,129143,129146,0,3,1
36867,6,3,129149,129149,129152,0,3,3
36868,1,3,129150,129152,129155,2,5,0
36869,6,1,129156,129156,129157,0,1,1
36870,4,1,129160,129160,129161,0,1,3
36871,2,2,129162,129162,129164,0,2,1
36872,2,3,129164,129164,129167,0,3,0
36873,5,2,129169,129169,129171,0,2,2
36874,4,2,129173,129173,129175,0,2,2
36875,3,1,129176,129176,129177,0,1,1
36876,3,2,129179,129179,129181,0,2,2
36877,5,1,129184,129184,129185,0,1,3
36878,5,1,129189,129189,129190,0,1,4
36879,2,3,129191,129191,129194,0,3,1
36880,1,2,129192,129194,129196,2,4,0
36881,6,2,129198,129198,129200,0,2,2
36882,2,1,129200,129200,129201,0,1,0
36883,2,2,129202,129202,129204,0,2,1
36884,2,1,129204,129204,129205,0,1,0
36885,5,3,129209,129209,129212,0,3,4
36886,4,3,129213,129213,129216,0,3,1
36887,5,3,129218,129218,129221,0,3,2
36888,2,3,129220,129221,129224,1,4,0
36889,5,2,129225,129225,129227,0,2,1
36890,3,3,129228,129228,129231,0,3,1
36891,2,1,129230,129231,129232,1,2,0
36892,2,2,129232,129232,129234,0,2,0
36893,1,3,129233,129234,129237,1,4,0
36894,4,2,129237,129237,129239,0,2,0
36895,3,3,129240,129240,129243,0,3,1
36896,3,3,129243,129243,129246,0,3,0
36897,1,3,129244,129246,129249,2,5,0
36898,1,2,129245,129249,129251,4,6,0
36899,4,2,129249,129251,129253,2,4,0
36900,1,3,129250,129253,129256,3,6,0
36901,4,1,129254,129256,129257,2,3,0
36902,1,3,129255,129257,129260,2,5,0
36903,4,2,129259,129260,129262,1,3,0
36904,3,1,129262,129262,129263,0,1,0
36905,3,1,129265,129265,129266,0,1,2
36906,2,2,129267,129267,129269,0,2,1
36907,5,2,129272,129272,129274,0,2,3
36908,4,3,129276,129276,129279,0,3,2
36909,2,2,129278,129279,129281,1,3,0
36910,5,2,129283,129283,129285,0,2,2
36911,6,3,129289,129289,129292,0,3,4
36912,4,1,129293,129293,129294,0,1,1
36913,4,1,129297,129297,129298,0,1,3
36914,5,3,129302,129302,129305,0,3,4
36915,2,2,129304,129305,129307,1,3,0
36916,1,3,129305,129307,129310,2,5,0
36917,5,3,129310,129310,129313,0,3,0
36918,5,1,129315,129315,129316,0,1,2
36919,2,1,129317,129317,129318,0,1,1
36920,5,2,129322,129322,129324,0,2,4
36921,4,2,129326,129326,129328,0,2,2
36922,5,1,129331,129331,129332,0,1,3
36923,4,2,129335,129335,129337,0,2,3
36924,4,2,129339,129339,129341,0,2,2
36925,6,2,129345,129345,129347,0,2,4
36926,1,2,129346,129347,129349,1,3,0
36927,4,2,129350,129350,129352,0,2,1
36928,2,3,129352,129352,129355,0,3,0
36929,2,1,129354,129355,129356,1,2,0
36930,2,2,129356,129356,129358,0,2,0
36931,1,1,129357,129358,129359,1,2,0
36932,5,2,129362,129362,129364,0,2,3
36933,1,2,129363,129364,129366,1,3,0
36934,5,1,129368,129368,129369,0,1,2
36935,2,3,129370,129370,129373,0,3,1
36936,3,3,129373,129373,129376,0,3,0
36937,2,3,129375,129376,129379,1,4,0
36938,5,2,129380,129380,129382,0,2,1
36939,4,1,129384,129384,129385,0,1,2
36940,5,3,129389,129389,129392,0,3,4
36941,2,2,129391,129392,129394,1,3,0
36942,3,2,129394,129394,129396,0,2,0
36943,4,1,129398,129398,129399,0,1,2
36944,3,1,129401,129401,129402,0,1,2
36945,3,1,129404,129404,129405,0,1,2
36946,1,1,129405,129405,129406,0,1,0
36947,1,2,129406,129406,129408,0,2,0
36948,3,3,129409,129409,129412,0,3,1
36949,4,3,129413,129413,129416,0,3,1
36950,4,3,129417,129417,129420,0,3,1
36951,2,2,129419,129420,129422,1,3,0
36952,4,2,129423,129423,129425,0,2,1
36953,2,3,129425,129425,129428,0,3,0
36954,4,3,129429,129429,129432,0,3,1
36955,4,2,129433,129433,129435,0,2,1
36956,3,1,129436,129436,129437,0,1,1
36957,5,2,129441,129441,129443,0,2,4
36958,6,1,129447,129447,129448,0,1,4
36959,3,1,129450,129450,129451,0,1,2
36960,4,1,129454,129454,129455,0,1,3
36961,1,3,129455,129455,129458,0,3,0
36962,4,2,129459,129459,129461,0,2,1
36963,4,3,129463,129463,129466,0,3,2
36964,1,1,129464,129466,129467,2,3,0
36965,5,3,129469,129469,129472,0,3,2
36966,6,1,129475,129475,129476,0,1,3
36967,1,1,129476,129476,129477,0,1,0
36968,1,3,129477,129477,129480,0,3,0
36969,6,2,129483,129483,129485,0,2,3
36970,5,1,129488,129488,129489,0,1,3
36971,2,3,129490,129490,129493,0,3,1
36972,5,3,129495,129495,129498,0,3,2
36973,6,1,129501,129501,129502,0,1,3
36974,3,1,129504,129504,129505,0,1,2
36975,2,1,129506,129506,129507,0,1,1
36976,6,1,129512,129512,129513,0,1,5
36977,2,2,129514,129514,129516,0,2,1
36978,3,2,129517,129517,129519,0,2,1
36979,2,1,129519,129519,129520,0,1,0
36980,1,2,129520,129520,129522,0,2,0
36981,6,3,129526,129526,129529,0,3,4
36982,6,3,129532,129532,129535,0,3,3
36983,5,2,129537,129537,129539,0,2,2
36984,2,3,129539,129539,129542,0,3,0
36985,6,2,129545,129545,129547,0,2,3
36986,3,2,129548,129548,129550,0,2,1
36987,2,1,129550,129550,129551,0,1,0
36988,4,3,129554,129554,129557,0,3,3
36989,3,3,129557,129557,129560,0,3,0
36990,4,1,129561,129561,129562,0,1,1
36991,3,3,129564,129564,129567,0,3,2
36992,1,3,129565,129567,129570,2,5,0
36993,5,3,129570,129570,129573,0,3,0
36994,3,2,129573,129573,129575,0,2,0
36995,6,1,129579,129579,129580,0,1,4
36996,1,1,129580,129580,129581,0,1,0
36997,6,2,129586,129586,129588,0,2,5
36998,1,3,129587,129588,129591,1,4,0
36999,1,2,129588,129591,129593,3,5,0
37000,1,2,129589,129593,129595,4,6,0
37001,5,3,129594,129595,129598,1,4,0
37002,5,2,129599,129599,129601,0,2,1
37003,4,3,129603,129603,129606,0,3,2
37004,6,2,129609,129609,129611,0,2,3
37005,3,3,129612,129612,129615,0,3,1
37006,4,1,129616,129616,129617,0,1,1
37007,1,1,129617,129617,129618,0,1,0
37008,3,1,129620,129620,129621,0,1,2
37009,5,3,129625,129625,129628,0,3,4
37010,5,3,129630,129630,129633,0,3,2
37011,3,2,129633,129633,129635,0,2,0
37012,3,2,129636,129636,129638,0,2,1
37013,3,1,129639,129639,129640,0,1,1
37014,1,2,129640,129640,129642,0,2,0
37015,3,1,129643,129643,129644,0,1,1
37016,2,2,129645,129645,129647,0,2,1
37017,3,2,129648,129648,129650,0,2,1
37018,1,3,129649,129650,129653,1,4,0
37019,3,1,129652,129653,129654,1,2,0
37020,1,1,129653,129654,129655,1,2,0
37021,5,1,129658,129658,129659,0,1,3
37022,4,1,129662,129662,129663,0,1,3
37023,4,3,129666,129666,129669,0,3,3
37024,3,2,129669,129669,129671,0,2,0
37025,2,2,129671,129671,129673,0,2,0
37026,1,1,129672,129673,129674,1,2,0
37027,3,3,129675,129675,129678,0,3,1
37028,4,1,129679,129679,129680,0,1,1
37029,4,2,129683,129683,129685,0,2,3
37030,5,2,129688,129688,129690,0,2,3
37031,1,2,129689,129690,129692,1,3,0
37032,5,1,129694,129694,129695,0,1,2
37033,5,1,129699,129699,129700,0,1,4
37034,2,2,129701,129701,129703,0,2,1
37035,3,1,129704,129704,129705,0,1,1
37036,1,3,129705,129705,129708,0,3,0
37037,4,3,129709,129709,129712,0,3,1
37038,1,2,129710,129712,129714,2,4,0
37039,6,3,129716,129716,129719,0,3,2
37040,1,2,129717,129719,129721,2,4,0
37041,6,1,129723,129723,129724,0,1,2
37042,6,3,129729,129729,129732,0,3,5
37043,5,2,129734,129734,129736,0,2,2
37044,1,1,129735,129736,129737,1,2,0
37045,3,2,129738,129738,129740,0,2,1
37046,6,3,129744,129744,129747,0,3,4
37047,2,3,129746,129747,129750,1,4,0
37048,6,1,129752,129752,129753,0,1,2
37049,6,2,129758,129758,129760,0,2,5
37050,6,3,129764,129764,129767,0,3,4
37051,5,3,129769,129769,129772,0,3,2
37052,3,2,129772,129772,129774,0,2,0
37053,2,2,129774,129774,129776,0,2,0
37054,4,3,129778,129778,129781,0,3,2
37055,5,1,129783,129783,129784,0,1,2
37056,3,1,129786,129786,129787,0,1,2
37057,2,3,129788,129788,129791,0,3,1
37058,1,2,129789,129791,129793,2,4,0
37059,1,3,129790,129793,129796,3,6,0
37060,4,2,129794,129796,129798,2,4,0
37061,1,2,129795,129798,129800,3,5,0
37062,6,1,129801,129801,129802,0,1,1
37063,1,2,129802,129802,129804,0,2,0
37064,1,1,129803,129804,129805,1,2,0
37065,5,1,129808,129808,129809,0,1,3
37066,4,3,129812,129812,129815,0,3,3
37067,3,2,129815,129815,129817,0,2,0
37068,1,1,129816,129817,129818,1,2,0
37069,6,3,129822,129822,129825,0,3,4
37070,1,2,129823,129825,129827,2,4,0
37071,2,2,129825,129827,129829,2,4,0
37072,4,2,129829,129829,129831,0,2,0
37073,1,3,129830,129831,129834,1,4,0
37074,2,1,129832,129834,129835,2,3,0
37075,4,2,129836,129836,129838,0,2,1
37076,5,1,129841,129841,129842,0,1,3
37077,5,1,129846,129846,129847,0,1,4
37078,6,2,129852,129852,129854,0,2,5
37079,4,2,129856,129856,129858,0,2,2
37080,6,1,129862,129862,129863,0,1,4
37081,4,1,129866,129866,129867,0,1,3
37082,5,2,129871,129871,129873,0,2,4
37083,6,3,129877,129877,129880,0,3,4
37084,5,2,129882,129882,129884,0,2,2
37085,5,1,129887,129887,129888,0,1,3
37086,3,3,129890,129890,129893,0,3,2
37087,4,2,129894,129894,129896,0,2,1
37088,3,2,129897,129897,129899,0,2,1
37089,1,3,129898,129899,129902,1,4,0
37090,2,2,129900,129902,129904,2,4,0
37091,5,2,129905,129905,129907,0,2,1
37092,1,1,129906,129907,129908,1,2,0
37093,1,1,129907,129908,129909,1,2,0
37094,1,1,129908,129909,129910,1,2,0
37095,1,3,129909,129910,129913,1,4,0
37096,1,1,129910,129913,129914,3,4,0
37097,5,2,129915,129915,129917,0,2,1
37098,6,1,129921,129921,129922,0,1,4
37099,5,2,129926,129926,129928,0,2,4
37100,2,2,129928,129928,129930,0,2,0
37101,2,3,129930,129930,129933,0,3,0
37102,4,3,129934,129934,129937,0,3,1
37103,6,3,129940,129940,129943,0,3,3
37104,3,1,129943,129943,129944,0,1,0
37105,3,1,129946,129946,129947,0,1,2
37106,6,2,129952,129952,129954,0,2,5
37107,3,2,129955,129955,129957,0,2,1
37108,2,3,129957,129957,129960,0,3,0
37109,3,1,129960,129960,129961,0,1,0
37110,3,2,129963,129963,129965,0,2,2
37111,1,2,129964,129965,129967,1,3,0
37112,3,1,129967,129967,129968,0,1,0
37113,3,2,129970,129970,129972,0,2,2
37114,1,2,129971,129972,129974,1,3,0
37115,3,1,129974,129974,129975,0,1,0
37116,4,3,129978,129978,129981,0,3,3
37117,2,2,129980,129981,129983,1,3,0
37118,6,2,129986,129986,129988,0,2,3
37119,5,1,129991,129991,129992,0,1,3
37120,6,3,129997,129997,130000,0,3,5
37121,2,2,129999,130000,130002,1,3,0
37122,3,3,130002,130002,130005,0,3,0
37123,5,1,130007,130007,130008,0,1,2
37124,3,3,130010,130010,130013,0,3,2
37125,4,1,130014,130014,130015,0,1,1
37126,3,1,130017,130017,130018,0,1,2
37127,1,2,130018,130018,130020,0,2,0
37128,6,1,130024,130024,130025,0,1,4
37129,6,3,130030,130030,130033,0,3,5
37130,6,1,130036,130036,130037,0,1,3
37131,3,3,130039,130039,130042,0,3,2
37132,1,2,130040,130042,130044,2,4,0
37133,2,2,130042,130044,130046,2,4,0
37134,3,3,130045,130046,130049,1,4,0
37135,5,3,130050,130050,130053,0,3,1
37136,2,3,130052,130053,130056,1,4,0
37137,4,2,130056,130056,130058,0,2,0
37138,2,1,130058,130058,130059,0,1,0
37139,3,3,130061,130061,130064,0,3,2
37140,3,3,130064,130064,130067,0,3,0
37141,5,2,130069,130069,130071,0,2,2
37142,5,3,130074,130074,130077,0,3,3
37143,4,1,130078,130078,130079,0,1,1
37144,1,2,130079,130079,130081,0,2,0
37145,5,3,130084,130084,130087,0,3,3
37146,6,3,130090,130090,130093,0,3,3
37147,5,1,130095,130095,130096,0,1,2
37148,4,1,130099,130099,130100,0,1,3
37149,5,2,130104,130104,130106,0,2,4
37150,5,2,130109,130109,130111,0,2,3
37151,6,3,130115,130115,130118,0,3,4
37152,6,1,130121,130121,130122,0,1,3
37153,6,1,130127,130127,130128,0,1,5
37154,4,2,130131,130131,130133,0,2,3
37155,2,3,130133,130133,130136,0,3,0
37156,4,2,130137,130137,130139,0,2,1
37157,2,1,130139,130139,130140,0,1,0
37158,3,3,130142,130142,130145,0,3,2
37159,5,2,130147,130147,130149,0,2,2
37160,5,1,130152,130152,130153,0,1,3
37161,5,3,130157,130157,130160,0,3,4
37162,4,1,130161,130161,130162,0,1,1
37163,2,3,130163,130163,130166,0,3,1
37164,1,3,130164,130166,130169,2,5,0
37165,4,3,130168,130169,130172,1,4,0
37166,2,3,130170,130172,130175,2,5,0
37167,6,2,130176,130176,130178,0,2,1
37168,6,1,130182,130182,130183,0,1,4
37169,4,3,130186,130186,130189,0,3,3
37170,2,2,130188,130189,130191,1,3,0
37171,4,1,130192,130192,130193,0,1,1
37172,2,3,130194,130194,130197,0,3,1
37173,1,2,130195,130197,130199,2,4,0
37174,2,1,130197,130199,130200,2,3,0
37175,2,3,130199,130200,130203,1,4,0
37176,5,1,130204,130204,130205,0,1,1
37177,1,1,130205,130205,130206,0,1,0
37178,2,3,130207,130207,130210,0,3,1
37179,4,1,130211,130211,130212,0,1,1
37180,5,1,130216,130216,130217,0,1,4
37181,4,3,130220,130220,130223,0,3,3
37182,4,2,130224,130224,130226,0,2,1
37183,2,1,130226,130226,130227,0,1,0
37184,4,2,130230,130230,130232,0,2,3
37185,5,2,130235,130235,130237,0,2,3
37186,3,1,130238,130238,130239,0,1,1
37187,4,1,130242,130242,130243,0,1,3
37188,2,2,130244,130244,130246,0,2,1
37189,5,2,130249,130249,130251,0,2,3
37190,1,1,130250,130251,130252,1,2,0
37191,6,1,130256,130256,130257,0,1,4
37192,6,1,130262,130262,130263,0,1,5
37193,1,2,130263,130263,130265,0,2,0
37194,3,1,130266,130266,130267,0,1,1
37195,2,1,130268,130268,130269,0,1,1
37196,3,3,130271,130271,130274,0,3,2
37197,6,1,130277,130277,130278,0,1,3
37198,4,2,130281,130281,130283,0,2,3
37199,3,1,130284,130284,130285,0,1,1
37200,4,1,130288,130288,130289,0,1,3
37201,3,1,130291,130291,130292,0,1,2
37202,3,3,130294,130294,130297,0,3,2
37203,3,2,130297,130297,130299,0,2,0
37204,3,3,130300,130300,130303,0,3,1
37205,1,3,130301,130303,130306,2,5,0
37206,2,3,130303,130306,130309,3,6,0
37207,6,2,130309,130309,130311,0,2,0
37208,3,1,130312,130312,130313,0,1,1
37209,6,3,130318,130318,130321,0,3,5
37210,2,3,130320,130321,130324,1,4,0
37211,3,3,130323,130324,130327,1,4,0
37212,3,2,130326,130327,130329,1,3,0
37213,5,2,130331,130331,130333,0,2,2
37214,2,1,130333,130333,130334,0,1,0
37215,5,1,130338,130338,130339,0,1,4
37216,4,3,130342,130342,130345,0,3,3
37217,3,3,130345,130345,130348,0,3,0
37218,2,2,130347,130348,130350,1,3,0
37219,1,3,130348,130350,130353,2,5,0
37220,3,3,130351,130353,130356,2,5,0
37221,1,3,130352,130356,130359,4,7,0
37222,1,2,130353,130359,130361,6,8,0
37223,5,3,130358,130361,130364,3,6,0
37224,2,1,130360,130364,130365,4,5,0
37225,6,2,130366,130366,130368,0,2,1
37226,2,2,130368,130368,130370,0,2,0
37227,2,3,130370,130370,130373,0,3,0
37228,6,3,130376,130376,130379,0,3,3
37229,1,3,130377,130379,130382,2,5,0
37230,6,3,130383,130383,130386,0,3,1
37231,1,1,130384,130386,130387,2,3,0
37232,3,2,130387,130387,130389,0,2,0
37233,4,1,130391,130391,130392,0,1,2
37234,2,1,130393,130393,130394,0,1,1
37235,1,2,130394,130394,130396,0,2,0
37236,6,2,130400,130400,130402,0,2,4
37237,2,1,130402,130402,130403,0,1,0
37238,6,3,130408,130408,130411,0,3,5
37239,4,1,130412,130412,130413,0,1,1
37240,3,2,130415,130415,130417,0,2,2
37241,5,2,130420,130420,130422,0,2,3
37242,1,1,130421,130422,130423,1,2,0
37243,4,2,130425,130425,130427,0,2,2
37244,2,3,130427,130427,130430,0,3,0
37245,5,3,130432,130432,130435,0,3,2
37246,2,2,130434,130435,130437,1,3,0
37247,5,3,130439,130439,130442,0,3,2
37248,2,2,130441,130442,130444,1,3,0
37249,4,2,130445,130445,130447,0,2,1
37250,2,2,130447,130447,130449,0,2,0
37251,3,2,130450,130450,130452,0,2,1
37252,4,2,130454,130454,130456,0,2,2
37253,5,3,130459,130459,130462,0,3,3
37254,6,1,130465,130465,130466,0,1,3
37255,1,3,130466,130466,130469,0,3,0
37256,2,2,130468,130469,130471,1,3,0
37257,2,3,130470,130471,130474,1,4,0
37258,5,3,130475,130475,130478,0,3,1
37259,2,2,130477,130478,130480,1,3,0
37260,6,2,130483,130483,130485,0,2,3
37261,1,3,130484,130485,130488,1,4,0
37262,3,2,130487,130488,130490,1,3,0
37263,5,2,130492,130492,130494,0,2,2
37264,5,1,130497,130497,130498,0,1,3
37265,5,2,130502,130502,130504,0,2,4
37266,4,2,130506,130506,130508,0,2,2
37267,5,1,130511,130511,130512,0,1,3
37268,3,3,130514,130514,130517,0,3,2
37269,1,1,130515,130517,130518,2,3,0
37270,5,3,130520,130520,130523,0,3,2
37271,1,3,130521,130523,130526,2,5,0
37272,3,1,130524,130526,130527,2,3,0
37273,4,3,130528,130528,130531,0,3,1
37274,3,1,130531,130531,130532,0,1,0
37275,2,1,130533,130533,130534,0,1,1
37276,3,2,130536,130536,130538,0,2,2
37277,5,3,130541,130541,130544,0,3,3
37278,2,2,130543,130544,130546,1,3,0
37279,5,3,130548,130548,130551,0,3,2
37280,1,1,130549,130551,130552,2,3,0
37281,3,2,130552,130552,130554,0,2,0
37282,1,3,130553,130554,130557,1,4,0
37283,1,3,130554,130557,130560,3,6,0
37284,6,1,130560,130560,130561,0,1,0
37285,4,1,130564,130564,130565,0,1,3
37286,2,2,130566,130566,130568,0,2,1
37287,1,1,130567,130568,130569,1,2,0
37288,4,2,130571,130571,130573,0,2,2
37289,3,1,130574,130574,130575,0,1,1
37290,5,2,130579,130579,130581,0,2,4
37291,2,1,130581,130581,130582,0,1,0
37292,1,2,130582,130582,130584,0,2,0
37293,3,1,130585,130585,130586,0,1,1
37294,3,2,130588,130588,130590,0,2,2
37295,3,1,130591,130591,130592,0,1,1
37296,6,3,130597,130597,130600,0,3,5
37297,5,3,130602,130602,130605,0,3,2
37298,2,1,130604,130605,130606,1,2,0
37299,4,1,130608,130608,130609,0,1,2
37300,1,2,130609,130609,130611,0,2,0
37301,3,1,130612,130612,130613,0,1,1
37302,3,3,130615,130615,130618,0,3,2
37303,2,1,130617,130618,130619,1,2,0
37304,2,2,130619,130619,130621,0,2,0
37305,1,2,130620,130621,130623,1,3,0
37306,5,3,130625,130625,130628,0,3,2
37307,2,3,130627,130628,130631,1,4,0
37308,3,1,130630,130631,130632,1,2,0
37309,4,3,130634,130634,130637,0,3,2
37310,3,2,130637,130637,130639,0,2,0
37311,1,3,130638,130639,130642,1,4,0
37312,3,3,130641,130642,130645,1,4,0
37313,5,2,130646,130646,130648,0,2,1
37314,1,2,130647,130648,130650,1,3,0
37315,1,3,130648,130650,130653,2,5,0
37316,5,2,130653,130653,130655,0,2,0
37317,5,3,130658,130658,130661,0,3,3
37318,2,1,130660,130661,130662,1,2,0
37319,2,3,130662,130662,130665,0,3,0
37320,3,1,130665,130665,130666,0,1,0
37321,4,2,130669,130669,130671,0,2,3
37322,1,2,130670,130671,130673,1,3,0
37323,3,3,130673,130673,130676,0,3,0
37324,3,2,130676,130676,130678,0,2,0
37325,2,2,130678,130678,130680,0,2,0
37326,2,2,130680,130680,130682,0,2,0
37327,3,1,130683,130683,130684,0,1,1
37328,6,2,130689,130689,130691,0,2,5
37329,5,1,130694,130694,130695,0,1,3
37330,5,3,130699,130699,130702,0,3,4
37331,5,2,130704,130704,130706,0,2,2
37332,1,1,130705,130706,130707,1,2,0
37333,6,2,130711,130711,130713,0,2,4
37334,3,2,130714,130714,130716,0,2,1
37335,2,1,130716,130716,130717,0,1,0
37336,6,3,130722,130722,130725,0,3,5
37337,1,2,130723,130725,130727,2,4,0
37338,5,2,130728,130728,130730,0,2,1
37339,1,1,130729,130730,130731,1,2,0
37340,3,1,130732,130732,130733,0,1,1
37341,4,1,130736,130736,130737,0,1,3
37342,6,2,130742,130742,130744,0,2,5
37343,3,1,130745,130745,130746,0,1,1
37344,5,2,130750,130750,130752,0,2,4
37345,5,3,130755,130755,130758,0,3,3
37346,6,1,130761,130761,130762,0,1,3
37347,4,1,130765,130765,130766,0,1,3
37348,4,2,130769,130769,130771,0,2,3
37349,3,3,130772,130772,130775,0,3,1
37350,5,3,130777,130777,130780,0,3,2
37351,4,3,130781,130781,130784,0,3,1
37352,1,1,130782,130784,130785,2,3,0
37353,6,3,130788,130788,130791,0,3,3
37354,6,1,130794,130794,130795,0,1,3
37355,1,3,130795,130795,130798,0,3,0
37356,3,2,130798,130798,130800,0,2,0
37357,1,2,130799,130800,130802,1,3,0
37358,3,1,130802,130802,130803,0,1,0
37359,5,2,130807,130807,130809,0,2,4
37360,4,2,130811,130811,130813,0,2,2
37361,4,2,130815,130815,130817,0,2,2
37362,1,1,130816,130817,130818,1,2,0
37363,3,3,130819,130819,130822,0,3,1
37364,4,1,130823,130823,130824,0,1,1
37365,1,3,130824,130824,130827,0,3,0
37366,5,2,130829,130829,130831,0,2,2
37367,4,1,130833,130833,130834,0,1,2
37368,1,2,130834,130834,130836,0,2,0
37369,2,2,130836,130836,130838,0,2,0
37370,3,2,130839,130839,130841,0,2,1
37371,4,2,130843,130843,130845,0,2,2
37372,1,2,130844,130845,130847,1,3,0
37373,3,3,130847,130847,130850,0,3,0
37374,2,1,130849,130850,130851,1,2,0
37375,4,1,130853,130853,130854,0,1,2
37376,4,3,130857,130857,130860,0,3,3
37377,4,1,130861,130861,130862,0,1,1
37378,5,1,130866,130866,130867,0,1,4
37379,5,3,130871,130871,130874,0,3,4
37380,6,3,130877,130877,130880,0,3,3
37381,4,1,130881,130881,130882,0,1,1
37382,3,2,130884,130884,130886,0,2,2
37383,4,3,130888,130888,130891,0,3,2
37384,5,3,130893,130893,130896,0,3,2
37385,3,1,130896,130896,130897,0,1,0
37386,6,3,130902,130902,130905,0,3,5
37387,2,1,130904,130905,130906,1,2,0
37388,6,2,130910,130910,130912,0,2,4
37389,3,1,130913,130913,130914,0,1,1
37390,3,3,130916,130916,130919,0,3,2
37391,5,3,130921,130921,130924,0,3,2
37392,5,3,130926,130926,130929,0,3,2
37393,5,1,130931,130931,130932,0,1,2
37394,1,3,130932,130932,130935,0,3,0
37395,1,3,130933,130935,130938,2,5,0
37396,6,1,130939,130939,130940,0,1,1
37397,1,3,130940,130940,130943,0,3,0
37398,2,2,130942,130943,130945,1,3,0
37399,5,3,130947,130947,130950,0,3,2
37400,6,1,130953,130953,130954,0,1,3
37401,5,2,130958,130958,130960,0,2,4
37402,6,2,130964,130964,130966,0,2,4
37403,1,1,130965,130966,130967,1,2,0
37404,4,1,130969,130969,130970,0,1,2
37405,5,3,130974,130974,130977,0,3,4
37406,3,2,130977,130977,130979,0,2,0
37407,3,1,130980,130980,130981,0,1,1
37408,5,3,130985,130985,130988,0,3,4
37409,6,1,130991,130991,130992,0,1,3
37410,5,3,130996,130996,130999,0,3,4
37411,5,2,131001,131001,131003,0,2,2
37412,2,2,131003,131003,131005,0,2,0
37413,3,2,131006,131006,131008,0,2,1
37414,6,3,131012,131012,131015,0,3,4
37415,2,1,131014,131015,131016,1,2,0
37416,6,1,131020,131020,131021,0,1,4
37417,2,3,131022,131022,131025,0,3,1
37418,1,2,131023,131025,131027,2,4,0
37419,6,2,131029,131029,131031,0,2,2
37420,5,2,131034,131034,131036,0,2,3
37421,3,1,131037,131037,131038,0,1,1
37422,3,2,131040,131040,131042,0,2,2
37423,1,3,131041,131042,131045,1,4,0
37424,4,1,131045,131045,131046,0,1,0
37425,3,3,131048,131048,131051,0,3,2
37426,5,1,131053,131053,131054,0,1,2
37427,1,2,131054,131054,131056,0,2,0
37428,6,3,131060,131060,131063,0,3,4
37429,1,2,131061,131063,131065,2,4,0
37430,6,1,131067,131067,131068,0,1,2
37431,1,1,131068,131068,131069,0,1,0
37432,5,3,131073,131073,131076,0,3,4
37433,1,2,131074,131076,131078,2,4,0
37434,5,2,131079,131079,131081,0,2,1
37435,6,1,131085,131085,131086,0,1,4
37436,1,3,131086,131086,131089,0,3,0
37437,4,2,131090,131090,131092,0,2,1
37438,2,2,131092,131092,131094,0,2,0
37439,2,1,131094,131094,131095,0,1,0
37440,6,2,131100,131100,131102,0,2,5
37441,3,2,131103,131103,131105,0,2,1
37442,5,1,131108,131108,131109,0,1,3
37443,5,3,131113,131113,131116,0,3,4
37444,4,2,131117,131117,131119,0,2,1
37445,5,3,131122,131122,131125,0,3,3
37446,5,1,131127,131127,131128,0,1,2
37447,5,1,131132,131132,131133,0,1,4
37448,2,3,131134,131134,131137,0,3,1
37449,1,1,131135,131137,131138,2,3,0
37450,4,3,131139,131139,131142,0,3,1
37451,4,2,131143,131143,131145,0,2,1
37452,3,1,131146,131146,131147,0,1,1
37453,5,2,131151,131151,131153,0,2,4
37454,6,2,131157,131157,131159,0,2,4
37455,3,1,131160,131160,131161,0,1,1
37456,6,3,131166,131166,131169,0,3,5
37457,6,3,131172,131172,131175,0,3,3
37458,4,3,131176,131176,131179,0,3,1
37459,1,2,131177,131179,131181,2,4,0
37460,1,3,131178,131181,131184,3,6,0
37461,4,1,131182,131184,131185,2,3,0
37462,2,2,131184,131185,131187,1,3,0
37463,5,2,131189,131189,131191,0,2,2
37464,6,3,131195,131195,131198,0,3,4
37465,6,1,131201,131201,131202,0,1,3
37466,6,2,131207,131207,131209,0,2,5
37467,5,2,131212,131212,131214,0,2,3
37468,3,2,131215,131215,131217,0,2,1
37469,6,2,131221,131221,131223,0,2,4
37470,3,3,131224,131224,131227,0,3,1
37471,3,3,131227,131227,131230,0,3,0
37472,5,3,131232,131232,131235,0,3,2
37473,5,1,131237,131237,131238,0,1,2
37474,4,1,131241,131241,131242,0,1,3
37475,5,2,131246,131246,131248,0,2,4
37476,6,1,131252,131252,131253,0,1,4
37477,5,1,131257,131257,131258,0,1,4
37478,4,1,131261,131261,131262,0,1,3
37479,6,3,131267,131267,131270,0,3,5
37480,1,2,131268,131270,131272,2,4,0
37481,5,1,131273,131273,131274,0,1,1
37482,5,2,131278,131278,131280,0,2,4
37483,3,3,131281,131281,131284,0,3,1
37484,3,3,131284,131284,131287,0,3,0
37485,6,3,131290,131290,131293,0,3,3
37486,3,1,131293,131293,131294,0,1,0
37487,5,1,131298,131298,131299,0,1,4
37488,4,2,131302,131302,131304,0,2,3
37489,5,1,131307,131307,131308,0,1,3
37490,5,3,131312,131312,131315,0,3,4
37491,2,3,131314,131315,131318,1,4,0
37492,4,3,131318,131318,131321,0,3,0
37493,3,3,131321,131321,131324,0,3,0
37494,1,1,131322,131324,131325,2,3,0
37495,1,1,131323,131325,131326,2,3,0
37496,6,3,131329,131329,131332,0,3,3
37497,6,1,131335,131335,131336,0,1,3
37498,4,1,131339,131339,131340,0,1,3
37499,4,1,131343,131343,131344,0,1,3
37500,5,2,131348,131348,131350,0,2,4
37501,6,1,131354,131354,131355,0,1,4
37502,1,1,131355,131355,131356,0,1,0
37503,5,1,131360,131360,131361,0,1,4
37504,6,2,131366,131366,131368,0,2,5
37505,2,3,131368,131368,131371,0,3,0
37506,1,3,131369,131371,131374,2,5,0
37507,5,1,131374,131374,131375,0,1,0
37508,4,3,131378,131378,131381,0,3,3
37509,3,3,131381,131381,131384,0,3,0
37510,5,2,131386,131386,131388,0,2,2
37511,2,3,131388,131388,131391,0,3,0
37512,2,3,131390,131391,131394,1,4,0
37513,5,2,131395,131395,131397,0,2,1
37514,6,3,131401,131401,131404,0,3,4
37515,5,1,131406,131406,131407,0,1,2
37516,5,2,131411,131411,131413,0,2,4
37517,3,2,131414,131414,131416,0,2,1
37518,1,3,131415,131416,131419,1,4,0
37519,4,3,131419,131419,131422,0,3,0
37520,2,2,131421,131422,131424,1,3,0
37521,6,3,131427,131427,131430,0,3,3
37522,6,2,131433,131433,131435,0,2,3
37523,4,1,131437,131437,131438,0,1,2
37524,5,3,131442,131442,131445,0,3,4
37525,6,1,131448,131448,131449,0,1,3
37526,1,3,131449,131449,131452,0,3,0
37527,6,1,131455,131455,131456,0,1,3
37528,5,1,131460,131460,131461,0,1,4
37529,2,3,131462,131462,131465,0,3,1
37530,6,1,131468,131468,131469,0,1,3
37531,6,2,131474,131474,131476,0,2,5
37532,5,2,131479,131479,131481,0,2,3
37533,1,3,131480,131481,131484,1,4,0
37534,6,2,131486,131486,131488,0,2,2
37535,3,3,131489,131489,131492,0,3,1
37536,6,3,131495,131495,131498,0,3,3
37537,4,2,131499,131499,131501,0,2,1
37538,6,3,131505,131505,131508,0,3,4
37539,3,3,131508,131508,131511,0,3,0
37540,6,1,131514,131514,131515,0,1,3
37541,6,1,131520,131520,131521,0,1,5
37542,2,1,131522,131522,131523,0,1,1
37543,3,3,131525,131525,131528,0,3,2
37544,4,3,131529,131529,131532,0,3,1
37545,4,2,131533,131533,131535,0,2,1
37546,4,1,131537,131537,131538,0,1,2
37547,4,3,131541,131541,131544,0,3,3
37548,6,1,131547,131547,131548,0,1,3
37549,4,1,131551,131551,131552,0,1,3
37550,4,2,131555,131555,131557,0,2,3
37551,3,3,131558,131558,131561,0,3,1
37552,6,3,131564,131564,131567,0,3,3
37553,2,3,131566,131567,131570,1,4,0
37554,1,2,131567,131570,131572,3,5,0
37555,3,3,131570,131572,131575,2,5,0
37556,6,3,131576,131576,131579,0,3,1
37557,5,2,131581,131581,131583,0,2,2
37558,5,3,131586,131586,131589,0,3,3
37559,3,1,131589,131589,131590,0,1,0
37560,6,3,131595,131595,131598,0,3,5
37561,3,1,131598,131598,131599,0,1,0
37562,5,3,131603,131603,131606,0,3,4
37563,2,1,131605,131606,131607,1,2,0
37564,4,2,131609,131609,131611,0,2,2
37565,1,3,131610,131611,131614,1,4,0
37566,1,2,131611,131614,131616,3,5,0
37567,2,1,131613,131616,131617,3,4,0
37568,3,1,131616,131617,131618,1,2,0
37569,1,2,131617,131618,131620,1,3,0
37570,4,2,131621,131621,131623,0,2,1
37571,1,1,131622,131623,131624,1,2,0
37572,1,3,131623,131624,131627,1,4,0
37573,6,3,131629,131629,131632,0,3,2
37574,2,1,131631,131632,131633,1,2,0
37575,1,3,131632,131633,131636,1,4,0
37576,1,1,131633,131636,131637,3,4,0
37577,6,2,131639,131639,131641,0,2,2
37578,5,3,131644,131644,131647,0,3,3
37579,5,1,131649,131649,131650,0,1,2
37580,5,2,131654,131654,131656,0,2,4
37581,3,2,131657,131657,131659,0,2,1
37582,1,2,131658,131659,131661,1,3,0
37583,1,3,131659,131661,131664,2,5,0
37584,5,1,131664,131664,131665,0,1,0
37585,5,1,131669,131669,131670,0,1,4
37586,3,3,131672,131672,131675,0,3,2
37587,5,2,131677,131677,131679,0,2,2
37588,6,2,131683,131683,131685,0,2,4
37589,5,2,131688,131688,131690,0,2,3
37590,2,2,131690,131690,131692,0,2,0
37591,2,3,131692,131692,131695,0,3,0
37592,6,2,131698,131698,131700,0,2,3
37593,5,1,131703,131703,131704,0,1,3
37594,3,1,131706,131706,131707,0,1,2
37595,3,2,131709,131709,131711,0,2,2
37596,3,1,131712,131712,131713,0,1,1
37597,4,3,131716,131716,131719,0,3,3
37598,4,2,131720,131720,131722,0,2,1
37599,5,2,131725,131725,131727,0,2,3
37600,5,3,131730,131730,131733,0,3,3
37601,2,3,131732,131733,131736,1,4,0
37602,5,2,131737,131737,131739,0,2,1
37603,4,1,131741,131741,131742,0,1,2
37604,1,1,131742,131742,131743,0,1,0
37605,6,3,131748,131748,131751,0,3,5
37606,2,1,131750,131751,131752,1,2,0
37607,1,2,131751,131752,131754,1,3,0
37608,4,2,131755,131755,131757,0,2,1
37609,6,1,131761,131761,131762,0,1,4
37610,3,1,131764,131764,131765,0,1,2
37611,4,3,131768,131768,131771,0,3,3
37612,1,2,131769,131771,131773,2,4,0
37613,4,2,131773,131773,131775,0,2,0
37614,4,3,131777,131777,131780,0,3,2
37615,3,1,131780,131780,131781,0,1,0
37616,5,2,131785,131785,131787,0,2,4
37617,6,2,131791,131791,131793,0,2,4
37618,6,1,131797,131797,131798,0,1,4
37619,3,1,131800,131800,131801,0,1,2
37620,6,1,131806,131806,131807,0,1,5
37621,1,1,131807,131807,131808,0,1,0
37622,3,3,131810,131810,131813,0,3,2
37623,3,3,131813,131813,131816,0,3,0
37624,5,3,131818,131818,131821,0,3,2
37625,5,1,131823,131823,131824,0,1,2
37626,1,3,131824,131824,131827,0,3,0
37627,6,2,131830,131830,131832,0,2,3
37628,2,1,131832,131832,131833,0,1,0
37629,5,3,131837,131837,131840,0,3,4
37630,1,2,131838,131840,131842,2,4,0
37631,6,3,131844,131844,131847,0,3,2
37632,1,2,131845,131847,131849,2,4,0
37633,2,3,131847,131849,131852,2,5,0
37634,5,1,131852,131852,131853,0,1,0
37635,5,3,131857,131857,131860,0,3,4
37636,3,1,131860,131860,131861,0,1,0
37637,1,2,131861,131861,131863,0,2,0
37638,5,3,131866,131866,131869,0,3,3
37639,4,2,131870,131870,131872,0,2,1
37640,4,3,131874,131874,131877,0,3,2
37641,3,2,131877,131877,131879,0,2,0
37642,4,1,131881,131881,131882,0,1,2
37643,1,2,131882,131882,131884,0,2,0
37644,2,3,131884,131884,131887,0,3,0
37645,5,2,131889,131889,131891,0,2,2
37646,3,3,131892,131892,131895,0,3,1
37647,2,3,131894,131895,131898,1,4,0
37648,1,2,131895,131898,131900,3,5,0
37649,1,3,131896,131900,131903,4,7,0
37650,3,2,131899,131903,131905,4,6,0
37651,3,3,131902,131905,131908,3,6,0
37652,2,2,131904,131908,131910,4,6,0
37653,2,1,131906,131910,131911,4,5,0
37654,5,1,131911,131911,131912,0,1,0
37655,2,3,131913,131913,131916,0,3,1
37656,5,3,131918,131918,131921,0,3,2
37657,2,2,131920,131921,131923,1,3,0
37658,6,2,131926,131926,131928,0,2,3
37659,6,2,131932,131932,131934,0,2,4
37660,6,2,131938,131938,131940,0,2,4
37661,4,3,131942,131942,131945,0,3,2
37662,3,1,131945,131945,131946,0,1,0
37663,3,3,131948,131948,131951,0,3,2
37664,4,2,131952,131952,131954,0,2,1
37665,4,1,131956,131956,131957,0,1,2
37666,3,3,131959,131959,131962,0,3,2
37667,4,2,131963,131963,131965,0,2,1
37668,3,3,131966,131966,131969,0,3,1
37669,6,2,131972,131972,131974,0,2,3
37670,1,3,131973,131974,131977,1,4,0
37671,3,1,131976,131977,131978,1,2,0
37672,4,1,131980,131980,131981,0,1,2
37673,4,1,131984,131984,131985,0,1,3
37674,6,2,131990,131990,131992,0,2,5
37675,5,1,131995,131995,131996,0,1,3
37676,6,3,132001,132001,132004,0,3,5
37677,3,2,132004,132004,132006,0,2,0
37678,2,3,132006,132006,132009,0,3,0
37679,6,3,132012,132012,132015,0,3,3
37680,2,2,132014,132015,132017,1,3,0
37681,5,2,132019,132019,132021,0,2,2
37682,1,1,132020,132021,132022,1,2,0
37683,1,3,132021,132022,132025,1,4,0
37684,1,2,132022,132025,132027,3,5,0
37685,3,3,132025,132027,132030,2,5,0
37686,3,2,132028,132030,132032,2,4,0
37687,1,1,132029,132032,132033,3,4,0
37688,5,1,132034,132034,132035,0,1,1
37689,2,2,132036,132036,132038,0,2,1
37690,2,3,132038,132038,132041,0,3,0
37691,1,2,132039,132041,132043,2,4,0
37692,4,3,132043,132043,132046,0,3,0
37693,1,3,132044,132046,132049,2,5,0
37694,5,1,132049,132049,132050,0,1,0
37695,4,1,132053,132053,132054,0,1,3
37696,5,2,132058,132058,132060,0,2,4
37697,3,3,132061,132061,132064,0,3,1
37698,3,2,132064,132064,132066,0,2,0
37699,3,2,132067,132067,132069,0,2,1
37700,4,2,132071,132071,132073,0,2,2
37701,3,2,132074,132074,132076,0,2,1
37702,4,1,132078,132078,132079,0,1,2
37703,4,3,132082,132082,132085,0,3,3
37704,5,2,132087,132087,132089,0,2,2
37705,6,3,132093,132093,132096,0,3,4
37706,3,1,132096,132096,132097,0,1,0
37707,2,3,132098,132098,132101,0,3,1
37708,2,3,132100,132101,132104,1,4,0
37709,3,2,132103,132104,132106,1,3,0
37710,6,3,132109,132109,132112,0,3,3
37711,4,2,132113,132113,132115,0,2,1
37712,5,2,132118,132118,132120,0,2,3
37713,4,3,132122,132122,132125,0,3,2
37714,4,3,132126,132126,132129,0,3,1
37715,2,1,132128,132129,132130,1,2,0
37716,4,2,132132,132132,132134,0,2,2
37717,1,1,132133,132134,132135,1,2,0
37718,4,1,132137,132137,132138,0,1,2
37719,3,3,132140,132140,132143,0,3,2
37720,2,1,132142,132143,132144,1,2,0
37721,3,1,132145,132145,132146,0,1,1
37722,6,1,132151,132151,132152,0,1,5
37723,3,2,132154,132154,132156,0,2,2
37724,6,3,132160,132160,132163,0,3,4
37725,5,1,132165,132165,132166,0,1,2
37726,2,2,132167,132167,132169,0,2,1
37727,6,2,132173,132173,132175,0,2,4
37728,1,1,132174,132175,132176,1,2,0
37729,2,1,132176,132176,132177,0,1,0
37730,1,3,132177,132177,132180,0,3,0
37731,2,1,132179,132180,132181,1,2,0
37732,2,1,132181,132181,132182,0,1,0
37733,6,3,132187,132187,132190,0,3,5
37734,5,1,132192,132192,132193,0,1,2
37735,3,2,132195,132195,132197,0,2,2
37736,2,2,132197,132197,132199,0,2,0
37737,3,3,132200,132200,132203,0,3,1
37738,5,2,132205,132205,132207,0,2,2
37739,1,3,132206,132207,132210,1,4,0
37740,2,3,132208,132210,132213,2,5,0
37741,2,2,132210,132213,132215,3,5,0
37742,6,3,132216,132216,132219,0,3,1
37743,4,1,132220,132220,132221,0,1,1
37744,1,1,132221,132221,132222,0,1,0
37745,6,3,132227,132227,132230,0,3,5
37746,2,1,132229,132230,132231,1,2,0
37747,3,2,132232,132232,132234,0,2,1
37748,6,1,132238,132238,132239,0,1,4
37749,6,2,132244,132244,132246,0,2,5
37750,5,2,132249,132249,132251,0,2,3
37751,3,3,132252,132252,132255,0,3,1
37752,6,1,132258,132258,132259,0,1,3
37753,5,2,132263,132263,132265,0,2,4
37754,2,2,132265,132265,132267,0,2,0
37755,1,3,132266,132267,132270,1,4,0
37756,4,2,132270,132270,132272,0,2,0
37757,5,2,132275,132275,132277,0,2,3
37758,6,2,132281,132281,132283,0,2,4
37759,6,3,132287,132287,132290,0,3,4
37760,2,3,132289,132290,132293,1,4,0
37761,4,1,132293,132293,132294,0,1,0
37762,1,1,132294,132294,132295,0,1,0
37763,3,3,132297,132297,132300,0,3,2
37764,4,2,132301,132301,132303,0,2,1
37765,3,2,132304,132304,132306,0,2,1
37766,1,1,132305,132306,132307,1,2,0
37767,6,3,132311,132311,132314,0,3,4
37768,2,3,132313,132314,132317,1,4,0
37769,2,1,132315,132317,132318,2,3,0
37770,5,2,132320,132320,132322,0,2,2
37771,5,3,132325,132325,132328,0,3,3
37772,1,2,132326,132328,132330,2,4,0
37773,6,2,132332,132332,132334,0,2,2
37774,1,3,132333,132334,132337,1,4,0
37775,3,2,132336,132337,132339,1,3,0
37776,5,3,132341,132341,132344,0,3,2
37777,5,2,132346,132346,132348,0,2,2
37778,4,3,132350,132350,132353,0,3,2
37779,5,3,132355,132355,132358,0,3,2
37780,6,2,132361,132361,132363,0,2,3
37781,2,3,132363,132363,132366,0,3,0
37782,6,1,132369,132369,132370,0,1,3
37783,1,3,132370,132370,132373,0,3,0
37784,1,3,132371,132373,132376,2,5,0
37785,1,2,132372,132376,132378,4,6,0
37786,4,3,132376,132378,132381,2,5,0
37787,3,2,132379,132381,132383,2,4,0
37788,1,1,132380,132383,132384,3,4,0
37789,2,3,132382,132384,132387,2,5,0
37790,1,2,132383,132387,132389,4,6,0
37791,5,1,132388,132389,132390,1,2,0
37792,6,2,132394,132394,132396,0,2,4
37793,6,2,132400,132400,132402,0,2,4
37794,4,3,132404,132404,132407,0,3,2
37795,6,1,132410,132410,132411,0,1,3
37796,2,3,132412,132412,132415,0,3,1
37797,4,1,132416,132416,132417,0,1,1
37798,6,2,132422,132422,132424,0,2,5
37799,4,1,132426,132426,132427,0,1,2
37800,4,1,132430,132430,132431,0,1,3
37801,6,2,132436,132436,132438,0,2,5
37802,6,1,132442,132442,132443,0,1,4
37803,1,1,132443,132443,132444,0,1,0
37804,2,1,132445,132445,132446,0,1,1
37805,2,3,132447,132447,132450,0,3,1
37806,3,3,132450,132450,132453,0,3,0
37807,3,2,132453,132453,132455,0,2,0
37808,5,1,132458,132458,132459,0,1,3
37809,4,1,132462,132462,132463,0,1,3
37810,3,3,132465,132465,132468,0,3,2
37811,2,3,132467,132468,132471,1,4,0
37812,4,1,132471,132471,132472,0,1,0
37813,4,3,132475,132475,132478,0,3,3
37814,3,2,132478,132478,132480,0,2,0
37815,2,3,132480,132480,132483,0,3,0
37816,1,2,132481,132483,132485,2,4,0
37817,4,1,132485,132485,132486,0,1,0
37818,1,3,132486,132486,132489,0,3,0
37819,2,3,132488,132489,132492,1,4,0
37820,6,2,132494,132494,132496,0,2,2
37821,1,3,132495,132496,132499,1,4,0
37822,2,2,132497,132499,132501,2,4,0
37823,1,3,132498,132501,132504,3,6,0
37824,2,1,132500,132504,132505,4,5,0
37825,3,2,132503,132505,132507,2,4,0
37826,3,2,132506,132507,132509,1,3,0
37827,2,1,132508,132509,132510,1,2,0
37828,5,2,132513,132513,132515,0,2,3
37829,6,1,132519,132519,132520,0,1,4
37830,6,2,132525,132525,132527,0,2,5
37831,2,1,132527,132527,132528,0,1,0
37832,2,2,132529,132529,132531,0,2,1
37833,6,2,132535,132535,132537,0,2,4
37834,6,3,132541,132541,132544,0,3,4
37835,5,2,132546,132546,132548,0,2,2
37836,3,3,132549,132549,132552,0,3,1
37837,6,3,132555,132555,132558,0,3,3
37838,1,3,132556,132558,132561,2,5,0
37839,3,2,132559,132561,132563,2,4,0
37840,3,3,132562,132563,132566,1,4,0
37841,5,2,132567,132567,132569,0,2,1
37842,4,3,132571,132571,132574,0,3,2
37843,3,1,132574,132574,132575,0,1,0
37844,1,3,132575,132575,132578,0,3,0
37845,3,2,132578,132578,132580,0,2,0
37846,2,1,132580,132580,132581,0,1,0
37847,3,1,132583,132583,132584,0,1,2
37848,6,2,132589,132589,132591,0,2,5
37849,5,2,132594,132594,132596,0,2,3
37850,3,2,132597,132597,132599,0,2,1
37851,1,3,132598,132599,132602,1,4,0
37852,6,1,132604,132604,132605,0,1,2
37853,4,2,132608,132608,132610,0,2,3
37854,4,2,132612,132612,132614,0,2,2
37855,6,2,132618,132618,132620,0,2,4
37856,6,2,132624,132624,132626,0,2,4
37857,6,3,132630,132630,132633,0,3,4
37858,4,1,132634,132634,132635,0,1,1
37859,1,1,132635,132635,132636,0,1,0
37860,1,2,132636,132636,132638,0,2,0
37861,4,1,132640,132640,132641,0,1,2
37862,2,2,132642,132642,132644,0,2,1
37863,1,1,132643,132644,132645,1,2,0
37864,4,3,132647,132647,132650,0,3,2
37865,5,3,132652,132652,132655,0,3,2
37866,3,1,132655,132655,132656,0,1,0
37867,1,1,132656,132656,132657,0,1,0
37868,3,1,132659,132659,132660,0,1,2
37869,6,1,132665,132665,132666,0,1,5
37870,2,1,132667,132667,132668,0,1,1
37871,3,3,132670,132670,132673,0,3,2
37872,3,2,132673,132673,132675,0,2,0
37873,1,2,132674,132675,132677,1,3,0
37874,1,1,132675,132677,132678,2,3,0
37875,6,2,132681,132681,132683,0,2,3
37876,1,1,132682,132683,132684,1,2,0
37877,1,1,132683,132684,132685,1,2,0
37878,2,3,132685,132685,132688,0,3,0
37879,1,2,132686,132688,132690,2,4,0
37880,3,1,132689,132690,132691,1,2,0
37881,6,1,132695,132695,132696,0,1,4
37882,1,3,132696,132696,132699,0,3,0
37883,5,2,132701,132701,132703,0,2,2
37884,3,2,132704,132704,132706,0,2,1
37885,5,3,132709,132709,132712,0,3,3
37886,4,1,132713,132713,132714,0,1,1
37887,6,2,132719,132719,132721,0,2,5
37888,4,1,132723,132723,132724,0,1,2
37889,2,1,132725,132725,132726,0,1,1
37890,4,2,132729,132729,132731,0,2,3
37891,2,2,132731,132731,132733,0,2,0
37892,4,2,132735,132735,132737,0,2,2
37893,6,3,132741,132741,132744,0,3,4
37894,4,1,132745,132745,132746,0,1,1
37895,5,1,132750,132750,132751,0,1,4
37896,3,1,132753,132753,132754,0,1,2
37897,6,3,132759,132759,132762,0,3,5
37898,6,1,132765,132765,132766,0,1,3
37899,2,1,132767,132767,132768,0,1,1
37900,5,3,132772,132772,132775,0,3,4
37901,5,3,132777,132777,132780,0,3,2
37902,2,1,132779,132780,132781,1,2,0
37903,6,1,132785,132785,132786,0,1,4
37904,5,2,132790,132790,132792,0,2,4
37905,3,1,132793,132793,132794,0,1,1
37906,5,3,132798,132798,132801,0,3,4
37907,1,3,132799,132801,132804,2,5,0
37908,2,1,132801,132804,132805,3,4,0
37909,5,2,132806,132806,132808,0,2,1
37910,5,3,132811,132811,132814,0,3,3
37911,1,3,132812,132814,132817,2,5,0
37912,5,3,132817,132817,132820,0,3,0
37913,4,3,132821,132821,132824,0,3,1
37914,3,3,132824,132824,132827,0,3,0
37915,5,1,132829,132829,132830,0,1,2
37916,3,3,132832,132832,132835,0,3,2
37917,4,3,132836,132836,132839,0,3,1
37918,6,3,132842,132842,132845,0,3,3
37919,3,3,132845,132845,132848,0,3,0
37920,6,1,132851,132851,132852,0,1,3
37921,2,2,132853,132853,132855,0,2,1
37922,5,3,132858,132858,132861,0,3,3
37923,5,1,132863,132863,132864,0,1,2
37924,5,3,132868,132868,132871,0,3,4
37925,5,2,132873,132873,132875,0,2,2
37926,2,1,132875,132875,132876,0,1,0
37927,1,3,132876,132876,132879,0,3,0
37928,2,2,132878,132879,132881,1,3,0
37929,2,1,132880,132881,132882,1,2,0
37930,5,2,132885,132885,132887,0,2,3
37931,2,1,132887,132887,132888,0,1,0
37932,6,2,132893,132893,132895,0,2,5
37933,3,2,132896,132896,132898,0,2,1
37934,1,2,132897,132898,132900,1,3,0
37935,5,3,132902,132902,132905,0,3,2
37936,4,1,132906,132906,132907,0,1,1
37937,4,1,132910,132910,132911,0,1,3
37938,4,1,132914,132914,132915,0,1,3
37939,2,1,132916,132916,132917,0,1,1
37940,2,2,132918,132918,132920,0,2,1
37941,3,1,132921,132921,132922,0,1,1
37942,3,1,132924,132924,132925,0,1,2
37943,5,1,132929,132929,132930,0,1,4
37944,6,3,132935,132935,132938,0,3,5
37945,3,2,132938,132938,132940,0,2,0
37946,4,2,132942,132942,132944,0,2,2
37947,2,2,132944,132944,132946,0,2,0
37948,3,2,132947,132947,132949,0,2,1
37949,2,2,132949,132949,132951,0,2,0
37950,2,2,132951,132951,132953,0,2,0
37951,5,2,132956,132956,132958,0,2,3
37952,4,1,132960,132960,132961,0,1,2
37953,1,1,132961,132961,132962,0,1,0
37954,2,2,132963,132963,132965,0,2,1
37955,6,3,132969,132969,132972,0,3,4
37956,3,2,132972,132972,132974,0,2,0
37957,2,1,132974,132974,132975,0,1,0
37958,3,3,132977,132977,132980,0,3,2
37959,3,1,132980,132980,132981,0,1,0
37960,2,1,132982,132982,132983,0,1,1
37961,3,1,132985,132985,132986,0,1,2
37962,1,1,132986,132986,132987,0,1,0
37963,5,2,132991,132991,132993,0,2,4
37964,1,3,132992,132993,132996,1,4,0
37965,5,1,132997,132997,132998,0,1,1
37966,2,2,132999,132999,133001,0,2,1
37967,1,1,133000,133001,133002,1,2,0
37968,4,3,133004,133004,133007,0,3,2
37969,3,2,133007,133007,133009,0,2,0
37970,1,1,133008,133009,133010,1,2,0
37971,2,3,133010,133010,133013,0,3,0
37972,3,3,133013,133013,133016,0,3,0
37973,2,1,133015,133016,133017,1,2,0
37974,4,3,133019,133019,133022,0,3,2
37975,6,2,133025,133025,133027,0,2,3
37976,3,3,133028,133028,133031,0,3,1
37977,2,3,133030,133031,133034,1,4,0
37978,5,2,133035,133035,133037,0,2,1
37979,6,3,133041,133041,133044,0,3,4
37980,3,1,133044,133044,133045,0,1,0
37981,5,1,133049,133049,133050,0,1,4
37982,4,2,133053,133053,133055,0,2,3
37983,6,2,133059,133059,133061,0,2,4
37984,1,2,133060,133061,133063,1,3,0
37985,3,3,133063,133063,133066,0,3,0
37986,2,1,133065,133066,133067,1,2,0
37987,2,2,133067,133067,133069,0,2,0
37988,5,1,133072,133072,133073,0,1,3
37989,4,1,133076,133076,133077,0,1,3
37990,4,2,133080,133080,133082,0,2,3
37991,2,3,133082,133082,133085,0,3,0
37992,5,3,133087,133087,133090,0,3,2
37993,5,2,133092,133092,133094,0,2,2
37994,6,1,133098,133098,133099,0,1,4
37995,2,2,133100,133100,133102,0,2,1
37996,2,3,133102,133102,133105,0,3,0
37997,1,3,133103,133105,133108,2,5,0
37998,4,2,133107,133108,133110,1,3,0
37999,1,3,133108,133110,133113,2,5,0
38000,1,3,133109,133113,133116,4,7,0
38001,4,3,133113,133116,133119,3,6,0
38002,3,2,133116,133119,133121,3,5,0
38003,2,3,133118,133121,133124,3,6,0
38004,2,2,133120,133124,133126,4,6,0
38005,5,2,133125,133126,133128,1,3,0
38006,6,3,133131,133131,133134,0,3,3
38007,4,1,133135,133135,133136,0,1,1
38008,6,3,133141,133141,133144,0,3,5
38009,4,1,133145,133145,133146,0,1,1
38010,3,3,133148,133148,133151,0,3,2
38011,2,1,133150,133151,133152,1,2,0
38012,6,3,133156,133156,133159,0,3,4
38013,4,1,133160,133160,133161,0,1,1
38014,6,2,133166,133166,133168,0,2,5
38015,1,3,133167,133168,133171,1,4,0
38016,5,1,133172,133172,133173,0,1,1
38017,5,3,133177,133177,133180,0,3,4
38018,1,3,133178,133180,133183,2,5,0
38019,3,3,133181,133183,133186,2,5,0
38020,3,1,133184,133186,133187,2,3,0
38021,1,2,133185,133187,133189,2,4,0
38022,1,1,133186,133189,133190,3,4,0
38023,5,2,133191,133191,133193,0,2,1
38024,3,3,133194,133194,133197,0,3,1
38025,3,3,133197,133197,133200,0,3,0
38026,3,2,133200,133200,133202,0,2,0
38027,6,3,133206,133206,133209,0,3,4
38028,5,3,133211,133211,133214,0,3,2
38029,3,1,133214,133214,133215,0,1,0
38030,4,3,133218,133218,133221,0,3,3
38031,4,2,133222,133222,133224,0,2,1
38032,5,1,133227,133227,133228,0,1,3
38033,2,3,133229,133229,133232,0,3,1
38034,2,3,133231,133232,133235,1,4,0
38035,3,2,133234,133235,133237,1,3,0
38036,4,3,133238,133238,133241,0,3,1
38037,1,2,133239,133241,133243,2,4,0
38038,5,3,133244,133244,133247,0,3,1
38039,6,2,133250,133250,133252,0,2,3
38040,1,3,133251,133252,133255,1,4,0
38041,4,1,133255,133255,133256,0,1,0
38042,5,2,133260,133260,133262,0,2,4
38043,3,2,133263,133263,133265,0,2,1
38044,2,2,133265,133265,133267,0,2,0
38045,4,2,133269,133269,133271,0,2,2
38046,1,3,133270,133271,133274,1,4,0
38047,6,2,133276,133276,133278,0,2,2
38048,6,2,133282,133282,133284,0,2,4
38049,3,3,133285,133285,133288,0,3,1
38050,2,3,133287,133288,133291,1,4,0
38051,4,1,133291,133291,133292,0,1,0
38052,4,2,133295,133295,133297,0,2,3
38053,5,3,133300,133300,133303,0,3,3
38054,6,1,133306,133306,133307,0,1,3
38055,1,3,133307,133307,133310,0,3,0
38056,4,1,133311,133311,133312,0,1,1
38057,1,2,133312,133312,133314,0,2,0
38058,6,3,133318,133318,133321,0,3,4
38059,2,2,133320,133321,133323,1,3,0
38060,1,2,133321,133323,133325,2,4,0
38061,3,2,133324,133325,133327,1,3,0
38062,3,2,133327,133327,133329,0,2,0
38063,5,2,133332,133332,133334,0,2,3
38064,6,2,133338,133338,133340,0,2,4
38065,3,1,133341,133341,133342,0,1,1
38066,6,2,133347,133347,133349,0,2,5
38067,5,3,133352,133352,133355,0,3,3
38068,4,2,133356,133356,133358,0,2,1
38069,5,1,133361,133361,133362,0,1,3
38070,2,3,133363,133363,133366,0,3,1
38071,3,2,133366,133366,133368,0,2,0
38072,4,1,133370,133370,133371,0,1,2
38073,6,1,133376,133376,133377,0,1,5
38074,6,3,133382,133382,133385,0,3,5
38075,1,2,133383,133385,133387,2,4,0
38076,1,1,133384,133387,133388,3,4,0
38077,2,1,133386,133388,133389,2,3,0
38078,3,1,133389,133389,133390,0,1,0
38079,4,3,133393,133393,133396,0,3,3
38080,1,1,133394,133396,133397,2,3,0
38081,2,1,133396,133397,133398,1,2,0
38082,4,3,133400,133400,133403,0,3,2
38083,6,1,133406,133406,133407,0,1,3
38084,6,1,133412,133412,133413,0,1,5
38085,6,2,133418,133418,133420,0,2,5
38086,1,1,133419,133420,133421,1,2,0
38087,1,3,133420,133421,133424,1,4,0
38088,2,1,133422,133424,133425,2,3,0
38089,1,3,133423,133425,133428,2,5,0
38090,3,2,133426,133428,133430,2,4,0
38091,4,1,133430,133430,133431,0,1,0
38092,5,1,133435,133435,133436,0,1,4
38093,3,1,133438,133438,133439,0,1,2
38094,5,3,133443,133443,133446,0,3,4
38095,5,2,133448,133448,133450,0,2,2
38096,1,3,133449,133450,133453,1,4,0
38097,5,1,133454,133454,133455,0,1,1
38098,5,2,133459,133459,133461,0,2,4
38099,5,3,133464,133464,133467,0,3,3
38100,2,2,133466,133467,133469,1,3,0
38101,5,3,133471,133471,133474,0,3,2
38102,6,3,133477,133477,133480,0,3,3
38103,3,1,133480,133480,133481,0,1,0
38104,5,3,133485,133485,133488,0,3,4
38105,5,3,133490,133490,133493,0,3,2
38106,3,2,133493,133493,133495,0,2,0
38107,6,3,133499,133499,133502,0,3,4
38108,2,1,133501,133502,133503,1,2,0
38109,4,3,133505,133505,133508,0,3,2
38110,2,3,133507,133508,133511,1,4,0
38111,1,3,133508,133511,133514,3,6,0
38112,4,2,133512,133514,133516,2,4,0
38113,1,3,133513,133516,133519,3,6,0
38114,2,3,133515,133519,133522,4,7,0
38115,5,1,133520,133522,133523,2,3,0
38116,6,2,133526,133526,133528,0,2,3
38117,4,3,133530,133530,133533,0,3,2
38118,6,3,133536,133536,133539,0,3,3
38119,5,2,133541,133541,133543,0,2,2
38120,6,3,133547,133547,133550,0,3,4
38121,1,2,133548,133550,133552,2,4,0
38122,3,3,133551,133552,133555,1,4,0
38123,2,1,133553,133555,133556,2,3,0
38124,2,3,133555,133556,133559,1,4,0
38125,5,1,133560,133560,133561,0,1,1
38126,5,2,133565,133565,133567,0,2,4
38127,4,3,133569,133569,133572,0,3,2
38128,3,2,133572,133572,133574,0,2,0
38129,3,2,133575,133575,133577,0,2,1
38130,3,1,133578,133578,133579,0,1,1
38131,6,2,133584,133584,133586,0,2,5
38132,5,1,133589,133589,133590,0,1,3
38133,2,3,133591,133591,133594,0,3,1
38134,1,1,133592,133594,133595,2,3,0
38135,3,1,133595,133595,133596,0,1,0
38136,6,3,133601,133601,133604,0,3,5
38137,4,3,133605,133605,133608,0,3,1
38138,4,2,133609,133609,133611,0,2,1
38139,2,1,133611,133611,133612,0,1,0
38140,3,2,133614,133614,133616,0,2,2
38141,1,1,133615,133616,133617,1,2,0
38142,6,3,133621,133621,133624,0,3,4
38143,2,3,133623,133624,133627,1,4,0
38144,2,3,133625,133627,133630,2,5,0
38145,5,3,133630,133630,133633,0,3,0
38146,5,1,133635,133635,133636,0,1,2
38147,3,2,133638,133638,133640,0,2,2
38148,1,1,133639,133640,133641,1,2,0
38149,4,3,133643,133643,133646,0,3,2
38150,1,3,133644,133646,133649,2,5,0
38151,4,3,133648,133649,133652,1,4,0
38152,3,3,133651,133652,133655,1,4,0
38153,3,1,133654,133655,133656,1,2,0
38154,3,2,133657,133657,133659,0,2,1
38155,1,1,133658,133659,133660,1,2,0
38156,6,2,133664,133664,133666,0,2,4
38157,6,3,133670,133670,133673,0,3,4
38158,4,1,133674,133674,133675,0,1,1
38159,1,1,133675,133675,133676,0,1,0
38160,1,3,133676,133676,133679,0,3,0
38161,3,2,133679,133679,133681,0,2,0
38162,2,1,133681,133681,133682,0,1,0
38163,5,3,133686,133686,133689,0,3,4
38164,3,1,133689,133689,133690,0,1,0
38165,5,3,133694,133694,133697,0,3,4
38166,5,3,133699,133699,133702,0,3,2
38167,2,2,133701,133702,133704,1,3,0
38168,5,2,133706,133706,133708,0,2,2
38169,2,2,133708,133708,133710,0,2,0
38170,5,1,133713,133713,133714,0,1,3
38171,5,2,133718,133718,133720,0,2,4
38172,3,3,133721,133721,133724,0,3,1
38173,6,3,133727,133727,133730,0,3,3
38174,6,3,133733,133733,133736,0,3,3
38175,5,3,133738,133738,133741,0,3,2
38176,4,1,133742,133742,133743,0,1,1
38177,3,1,133745,133745,133746,0,1,2
38178,5,1,133750,133750,133751,0,1,4
38179,2,2,133752,133752,133754,0,2,1
38180,6,3,133758,133758,133761,0,3,4
38181,3,1,133761,133761,133762,0,1,0
38182,4,1,133765,133765,133766,0,1,3
38183,6,1,133771,133771,133772,0,1,5
38184,4,2,133775,133775,133777,0,2,3
38185,6,2,133781,133781,133783,0,2,4
38186,3,2,133784,133784,133786,0,2,1
38187,3,1,133787,133787,133788,0,1,1
38188,3,1,133790,133790,133791,0,1,2
38189,5,1,133795,133795,133796,0,1,4
38190,1,2,133796,133796,133798,0,2,0
38191,5,2,133801,133801,133803,0,2,3
38192,4,3,133805,133805,133808,0,3,2
38193,2,3,133807,133808,133811,1,4,0
38194,6,3,133813,133813,133816,0,3,2
38195,5,3,133818,133818,133821,0,3,2
38196,6,1,133824,133824,133825,0,1,3
38197,4,3,133828,133828,133831,0,3,3
38198,5,2,133833,133833,133835,0,2,2
38199,4,1,133837,133837,133838,0,1,2
38200,3,1,133840,133840,133841,0,1,2
38201,3,3,133843,133843,133846,0,3,2
38202,2,2,133845,133846,133848,1,3,0
38203,6,3,133851,133851,133854,0,3,3
38204,5,3,133856,133856,133859,0,3,2
38205,1,3,133857,133859,133862,2,5,0
38206,2,3,133859,133862,133865,3,6,0
38207,4,2,133863,133865,133867,2,4,0
38208,5,2,133868,133868,133870,0,2,1
38209,4,2,133872,133872,133874,0,2,2
38210,2,3,133874,133874,133877,0,3,0
38211,4,3,133878,133878,133881,0,3,1
38212,1,3,133879,133881,133884,2,5,0
38213,6,3,133885,133885,133888,0,3,1
38214,5,3,133890,133890,133893,0,3,2
38215,5,2,133895,133895,133897,0,2,2
38216,3,1,133898,133898,133899,0,1,1
38217,5,3,133903,133903,133906,0,3,4
38218,4,2,133907,133907,133909,0,2,1
38219,1,2,133908,133909,133911,1,3,0
38220,5,2,133913,133913,133915,0,2,2
38221,4,1,133917,133917,133918,0,1,2
38222,2,3,133919,133919,133922,0,3,1
38223,5,3,133924,133924,133927,0,3,2
38224,6,3,133930,133930,133933,0,3,3
38225,3,1,133933,133933,133934,0,1,0
38226,1,2,133934,133934,133936,0,2,0
38227,4,3,133938,133938,133941,0,3,2
38228,1,3,133939,133941,133944,2,5,0
38229,3,1,133942,133944,133945,2,3,0
38230,2,1,133944,133945,133946,1,2,0
38231,6,2,133950,133950,133952,0,2,4
38232,4,3,133954,133954,133957,0,3,2
38233,5,1,133959,133959,133960,0,1,2
38234,3,1,133962,133962,133963,0,1,2
38235,6,2,133968,133968,133970,0,2,5
38236,5,2,133973,133973,133975,0,2,3
38237,3,2,133976,133976,133978,0,2,1
38238,3,3,133979,133979,133982,0,3,1
38239,1,1,133980,133982,133983,2,3,0
38240,4,3,133984,133984,133987,0,3,1
38241,1,2,133985,133987,133989,2,4,0
38242,3,3,133988,133989,133992,1,4,0
38243,2,1,133990,133992,133993,2,3,0
38244,6,1,133996,133996,133997,0,1,3
38245,1,1,133997,133997,133998,0,1,0
38246,5,1,134002,134002,134003,0,1,4
38247,2,2,134004,134004,134006,0,2,1
38248,6,2,134010,134010,134012,0,2,4
38249,3,1,134013,134013,134014,0,1,1
38250,5,1,134018,134018,134019,0,1,4
38251,4,2,134022,134022,134024,0,2,3
38252,1,1,134023,134024,134025,1,2,0
38253,1,3,134024,134025,134028,1,4,0
38254,4,2,134028,134028,134030,0,2,0
38255,6,3,134034,134034,134037,0,3,4
38256,5,2,134039,134039,134041,0,2,2
38257,3,3,134042,134042,134045,0,3,1
38258,6,3,134048,134048,134051,0,3,3
38259,4,2,134052,134052,134054,0,2,1
38260,6,1,134058,134058,134059,0,1,4
38261,4,1,134062,134062,134063,0,1,3
38262,1,2,134063,134063,134065,0,2,0
38263,3,1,134066,134066,134067,0,1,1
38264,6,3,134072,134072,134075,0,3,5
38265,2,3,134074,134075,134078,1,4,0
38266,1,2,134075,134078,134080,3,5,0
38267,2,3,134077,134080,134083,3,6,0
38268,4,1,134081,134083,134084,2,3,0
38269,3,1,134084,134084,134085,0,1,0
38270,2,3,134086,134086,134089,0,3,1
38271,3,3,134089,134089,134092,0,3,0
38272,4,2,134093,134093,134095,0,2,1
38273,3,2,134096,134096,134098,0,2,1
38274,5,1,134101,134101,134102,0,1,3
38275,3,3,134104,134104,134107,0,3,2
38276,1,2,134105,134107,134109,2,4,0
38277,6,3,134111,134111,134114,0,3,2
38278,2,1,134113,134114,134115,1,2,0
38279,4,3,134117,134117,134120,0,3,2
38280,4,3,134121,134121,134124,0,3,1
38281,1,3,134122,134124,134127,2,5,0
38282,3,3,134125,134127,134130,2,5,0
38283,5,3,134130,134130,134133,0,3,0
38284,2,3,134132,134133,134136,1,4,0
38285,3,1,134135,134136,134137,1,2,0
38286,3,2,134138,134138,134140,0,2,1
38287,3,1,134141,134141,134142,0,1,1
38288,3,3,134144,134144,134147,0,3,2
38289,1,2,134145,134147,134149,2,4,0
38290,1,3,134146,134149,134152,3,6,0
38291,3,2,134149,134152,134154,3,5,0
38292,6,1,134155,134155,134156,0,1,1
38293,4,2,134159,134159,134161,0,2,3
38294,2,3,134161,134161,134164,0,3,0
38295,6,3,134167,134167,134170,0,3,3
38296,1,1,134168,134170,134171,2,3,0
38297,3,1,134171,134171,134172,0,1,0
38298,4,2,134175,134175,134177,0,2,3
38299,4,3,134179,134179,134182,0,3,2
38300,2,1,134181,134182,134183,1,2,0
38301,6,2,134187,134187,134189,0,2,4
38302,1,2,134188,134189,134191,1,3,0
38303,5,1,134193,134193,134194,0,1,2
38304,1,2,134194,134194,134196,0,2,0
38305,3,3,134197,134197,134200,0,3,1
38306,3,1,134200,134200,134201,0,1,0
38307,3,2,134203,134203,134205,0,2,2
38308,4,1,134207,134207,134208,0,1,2
38309,1,3,134208,134208,134211,0,3,0
38310,2,3,134210,134211,134214,1,4,0
38311,5,2,134215,134215,134217,0,2,1
38312,3,3,134218,134218,134221,0,3,1
38313,5,2,134223,134223,134225,0,2,2
38314,3,1,134226,134226,134227,0,1,1
38315,1,1,134227,134227,134228,0,1,0
38316,4,3,134231,134231,134234,0,3,3
38317,6,2,134237,134237,134239,0,2,3
38318,6,2,134243,134243,134245,0,2,4
38319,4,3,134247,134247,134250,0,3,2
38320,5,1,134252,134252,134253,0,1,2
38321,6,2,134258,134258,134260,0,2,5
38322,5,2,134263,134263,134265,0,2,3
38323,5,3,134268,134268,134271,0,3,3
38324,4,3,134272,134272,134275,0,3,1
38325,5,2,134277,134277,134279,0,2,2
38326,3,1,134280,134280,134281,0,1,1
38327,3,2,134283,134283,134285,0,2,2
38328,1,3,134284,134285,134288,1,4,0
38329,4,1,134288,134288,134289,0,1,0
38330,3,3,134291,134291,134294,0,3,2
38331,4,1,134295,134295,134296,0,1,1
38332,3,1,134298,134298,134299,0,1,2
38333,2,3,134300,134300,134303,0,3,1
38334,6,1,134306,134306,134307,0,1,3
38335,6,1,134312,134312,134313,0,1,5
38336,3,1,134315,134315,134316,0,1,2
38337,3,1,134318,134318,134319,0,1,2
38338,3,1,134321,134321,134322,0,1,2
38339,4,1,134325,134325,134326,0,1,3
38340,4,2,134329,134329,134331,0,2,3
38341,2,3,134331,134331,134334,0,3,0
38342,2,1,134333,134334,134335,1,2,0
38343,5,1,134338,134338,134339,0,1,3
38344,6,3,134344,134344,134347,0,3,5
38345,1,2,134345,134347,134349,2,4,0
38346,5,1,134350,134350,134351,0,1,1
38347,6,1,134356,134356,134357,0,1,5
38348,6,2,134362,134362,134364,0,2,5
38349,2,2,134364,134364,134366,0,2,0
38350,2,2,134366,134366,134368,0,2,0
38351,3,2,134369,134369,134371,0,2,1
38352,1,3,134370,134371,134374,1,4,0
38353,1,2,134371,134374,134376,3,5,0
38354,5,3,134376,134376,134379,0,3,0
38355,4,3,134380,134380,134383,0,3,1
38356,5,2,134385,134385,134387,0,2,2
38357,1,2,134386,134387,134389,1,3,0
38358,3,2,134389,134389,134391,0,2,0
38359,4,3,134393,134393,134396,0,3,2
38360,1,1,134394,134396,134397,2,3,0
38361,1,3,134395,134397,134400,2,5,0
38362,6,3,134401,134401,134404,0,3,1
38363,3,1,134404,134404,134405,0,1,0
38364,6,1,134410,134410,134411,0,1,5
38365,2,1,134412,134412,134413,0,1,1
38366,6,1,134418,134418,134419,0,1,5
38367,4,3,134422,134422,134425,0,3,3
38368,2,1,134424,134425,134426,1,2,0
38369,5,1,134429,134429,134430,0,1,3
38370,6,2,134435,134435,134437,0,2,5
38371,5,3,134440,134440,134443,0,3,3
38372,6,2,134446,134446,134448,0,2,3
38373,4,3,134450,134450,134453,0,3,2
38374,3,1,134453,134453,134454,0,1,0
38375,6,1,134459,134459,134460,0,1,5
38376,5,2,134464,134464,134466,0,2,4
38377,1,1,134465,134466,134467,1,2,0
38378,1,1,134466,134467,134468,1,2,0
38379,4,1,134470,134470,134471,0,1,2
38380,1,2,134471,134471,134473,0,2,0
38381,5,2,134476,134476,134478,0,2,3
38382,3,1,134479,134479,134480,0,1,1
38383,4,1,134483,134483,134484,0,1,3
38384,5,3,134488,134488,134491,0,3,4
38385,4,3,134492,134492,134495,0,3,1
38386,4,2,134496,134496,134498,0,2,1
38387,2,3,134498,134498,134501,0,3,0
38388,6,2,134504,134504,134506,0,2,3
38389,5,2,134509,134509,134511,0,2,3
38390,3,2,134512,134512,134514,0,2,1
38391,6,1,134518,134518,134519,0,1,4
38392,1,2,134519,134519,134521,0,2,0
38393,2,3,134521,134521,134524,0,3,0
38394,5,3,134526,134526,134529,0,3,2
38395,1,2,134527,134529,134531,2,4,0
38396,3,2,134530,134531,134533,1,3,0
38397,2,3,134532,134533,134536,1,4,0
38398,2,1,134534,134536,134537,2,3,0
38399,4,2,134538,134538,134540,0,2,1
38400,2,1,134540,134540,134541,0,1,0
38401,4,1,134544,134544,134545,0,1,3
38402,1,1,134545,134545,134546,0,1,0
38403,2,2,134547,134547,134549,0,2,1
38404,2,3,134549,134549,134552,0,3,0
38405,4,1,134553,134553,134554,0,1,1
38406,1,1,134554,134554,134555,0,1,0
38407,2,1,134556,134556,134557,0,1,1
38408,5,2,134561,134561,134563,0,2,4
38409,6,2,134567,134567,134569,0,2,4
38410,3,3,134570,134570,134573,0,3,1
38411,2,1,134572,134573,134574,1,2,0
38412,4,3,134576,134576,134579,0,3,2
38413,5,2,134581,134581,134583,0,2,2
38414,2,3,134583,134583,134586,0,3,0
38415,1,2,134584,134586,134588,2,4,0
38416,2,3,134586,134588,134591,2,5,0
38417,4,3,134590,134591,134594,1,4,0
38418,6,3,134596,134596,134599,0,3,2
38419,3,3,134599,134599,134602,0,3,0
38420,2,1,134601,134602,134603,1,2,0
38421,3,2,134604,134604,134606,0,2,1
38422,5,3,134609,134609,134612,0,3,3
38423,3,1,134612,134612,134613,0,1,0
38424,4,3,134616,134616,134619,0,3,3
38425,5,2,134621,134621,134623,0,2,2
38426,3,2,134624,134624,134626,0,2,1
38427,4,2,134628,134628,134630,0,2,2
38428,5,3,134633,134633,134636,0,3,3
38429,2,3,134635,134636,134639,1,4,0
38430,1,1,134636,134639,134640,3,4,0
38431,1,3,134637,134640,134643,3,6,0
38432,4,3,134641,134643,134646,2,5,0
38433,6,2,134647,134647,134649,0,2,1
38434,3,3,134650,134650,134653,0,3,1
38435,3,1,134653,134653,134654,0,1,0
38436,5,2,134658,134658,134660,0,2,4
38437,6,3,134664,134664,134667,0,3,4
38438,1,2,134665,134667,134669,2,4,0
38439,3,2,134668,134669,134671,1,3,0
38440,4,1,134672,134672,134673,0,1,1
38441,2,3,134674,134674,134677,0,3,1
38442,1,3,134675,134677,134680,2,5,0
38443,1,3,134676,134680,134683,4,7,0
38444,5,2,134681,134683,134685,2,4,0
38445,3,3,134684,134685,134688,1,4,0
38446,4,2,134688,134688,134690,0,2,0
38447,3,1,134691,134691,134692,0,1,1
38448,6,3,134697,134697,134700,0,3,5
38449,4,1,134701,134701,134702,0,1,1
38450,6,1,134707,134707,134708,0,1,5
38451,1,1,134708,134708,134709,0,1,0
38452,1,3,134709,134709,134712,0,3,0
38453,6,1,134715,134715,134716,0,1,3
38454,5,3,134720,134720,134723,0,3,4
38455,3,2,134723,134723,134725,0,2,0
38456,6,3,134729,134729,134732,0,3,4
38457,3,3,134732,134732,134735,0,3,0
38458,5,3,134737,134737,134740,0,3,2
38459,4,2,134741,134741,134743,0,2,1
38460,5,1,134746,134746,134747,0,1,3
38461,1,3,134747,134747,134750,0,3,0
38462,6,3,134753,134753,134756,0,3,3
38463,3,2,134756,134756,134758,0,2,0
38464,3,2,134759,134759,134761,0,2,1
38465,3,3,134762,134762,134765,0,3,1
38466,5,3,134767,134767,134770,0,3,2
38467,6,3,134773,134773,134776,0,3,3
38468,2,2,134775,134776,134778,1,3,0
38469,6,1,134781,134781,134782,0,1,3
38470,4,2,134785,134785,134787,0,2,3
38471,6,2,134791,134791,134793,0,2,4
38472,4,3,134795,134795,134798,0,3,2
38473,5,1,134800,134800,134801,0,1,2
38474,2,1,134802,134802,134803,0,1,1
38475,6,2,134808,134808,134810,0,2,5
38476,6,1,134814,134814,134815,0,1,4
38477,4,2,134818,134818,134820,0,2,3
38478,1,3,134819,134820,134823,1,4,0
38479,2,3,134821,134823,134826,2,5,0
38480,3,1,134824,134826,134827,2,3,0
38481,3,3,134827,134827,134830,0,3,0
38482,5,1,134832,134832,134833,0,1,2
38483,3,3,134835,134835,134838,0,3,2
38484,6,2,134841,134841,134843,0,2,3
38485,5,1,134846,134846,134847,0,1,3
38486,1,1,134847,134847,134848,0,1,0
38487,2,3,134849,134849,134852,0,3,1
38488,1,3,134850,134852,134855,2,5,0
38489,2,1,134852,134855,134856,3,4,0
38490,3,3,134855,134856,134859,1,4,0
38491,2,3,134857,134859,134862,2,5,0
38492,6,3,134863,134863,134866,0,3,1
38493,6,3,134869,134869,134872,0,3,3
38494,1,3,134870,134872,134875,2,5,0
38495,5,3,134875,134875,134878,0,3,0
38496,3,2,134878,134878,134880,0,2,0
38497,1,2,134879,134880,134882,1,3,0
38498,5,1,134884,134884,134885,0,1,2
38499,4,2,134888,134888,134890,0,2,3
38500,4,1,134892,134892,134893,0,1,2
38501,5,3,134897,134897,134900,0,3,4
38502,4,1,134901,134901,134902,0,1,1
38503,6,1,134907,134907,134908,0,1,5
38504,5,3,134912,134912,134915,0,3,4
38505,5,3,134917,134917,134920,0,3,2
38506,3,2,134920,134920,134922,0,2,0
38507,2,3,134922,134922,134925,0,3,0
38508,6,1,134928,134928,134929,0,1,3
38509,2,1,134930,134930,134931,0,1,1
38510,3,3,134933,134933,134936,0,3,2
38511,6,3,134939,134939,134942,0,3,3
38512,3,3,134942,134942,134945,0,3,0
38513,4,2,134946,134946,134948,0,2,1
38514,5,2,134951,134951,134953,0,2,3
38515,3,1,134954,134954,134955,0,1,1
38516,4,1,134958,134958,134959,0,1,3
38517,5,3,134963,134963,134966,0,3,4
38518,4,1,134967,134967,134968,0,1,1
38519,5,2,134972,134972,134974,0,2,4
38520,2,3,134974,134974,134977,0,3,0
38521,2,1,134976,134977,134978,1,2,0
38522,6,3,134982,134982,134985,0,3,4
38523,4,2,134986,134986,134988,0,2,1
38524,1,1,134987,134988,134989,1,2,0
38525,3,3,134990,134990,134993,0,3,1
38526,1,1,134991,134993,134994,2,3,0
38527,1,2,134992,134994,134996,2,4,0
38528,3,3,134995,134996,134999,1,4,0
38529,1,3,134996,134999,135002,3,6,0
38530,2,2,134998,135002,135004,4,6,0
38531,4,3,135002,135004,135007,2,5,0
38532,3,2,135005,135007,135009,2,4,0
38533,6,3,135011,135011,135014,0,3,2
38534,3,3,135014,135014,135017,0,3,0
38535,4,1,135018,135018,135019,0,1,1
38536,3,3,135021,135021,135024,0,3,2
38537,5,1,135026,135026,135027,0,1,2
38538,4,3,135030,135030,135033,0,3,3
38539,3,2,135033,135033,135035,0,2,0
38540,6,3,135039,135039,135042,0,3,4
38541,5,3,135044,135044,135047,0,3,2
38542,4,3,135048,135048,135051,0,3,1
38543,4,3,135052,135052,135055,0,3,1
38544,3,2,135055,135055,135057,0,2,0
38545,5,1,135060,135060,135061,0,1,3
38546,3,2,135063,135063,135065,0,2,2
38547,3,3,135066,135066,135069,0,3,1
38548,5,3,135071,135071,135074,0,3,2
38549,1,2,135072,135074,135076,2,4,0
38550,5,2,135077,135077,135079,0,2,1
38551,4,2,135081,135081,135083,0,2,2
38552,1,2,135082,135083,135085,1,3,0
38553,5,3,135087,135087,135090,0,3,2
38554,6,3,135093,135093,135096,0,3,3
38555,4,3,135097,135097,135100,0,3,1
38556,5,1,135102,135102,135103,0,1,2
38557,6,2,135108,135108,135110,0,2,5
38558,4,3,135112,135112,135115,0,3,2
38559,5,3,135117,135117,135120,0,3,2
38560,4,2,135121,135121,135123,0,2,1
38561,2,3,135123,135123,135126,0,3,0
38562,6,3,135129,135129,135132,0,3,3
38563,1,3,135130,135132,135135,2,5,0
38564,2,1,135132,135135,135136,3,4,0
38565,2,1,135134,135136,135137,2,3,0
38566,4,1,135138,135138,135139,0,1,1
38567,4,2,135142,135142,135144,0,2,3
38568,1,3,135143,135144,135147,1,4,0
38569,6,3,135149,135149,135152,0,3,2
38570,2,3,135151,135152,135155,1,4,0
38571,1,1,135152,135155,135156,3,4,0
38572,5,2,135157,135157,135159,0,2,1
38573,6,3,135163,135163,135166,0,3,4
38574,3,2,135166,135166,135168,0,2,0
38575,1,3,135167,135168,135171,1,4,0
38576,3,3,135170,135171,135174,1,4,0
38577,5,3,135175,135175,135178,0,3,1
38578,4,2,135179,135179,135181,0,2,1
38579,1,1,135180,135181,135182,1,2,0
38580,5,1,135185,135185,135186,0,1,3
38581,1,3,135186,135186,135189,0,3,0
38582,4,1,135190,135190,135191,0,1,1
38583,3,3,135193,135193,135196,0,3,2
38584,5,3,135198,135198,135201,0,3,2
38585,1,2,135199,135201,135203,2,4,0
38586,4,1,135203,135203,135204,0,1,0
38587,3,2,135206,135206,135208,0,2,2
38588,6,1,135212,135212,135213,0,1,4
38589,5,2,135217,135217,135219,0,2,4
38590,6,1,135223,135223,135224,0,1,4
38591,6,2,135229,135229,135231,0,2,5
38592,4,2,135233,135233,135235,0,2,2
38593,2,1,135235,135235,135236,0,1,0
38594,1,1,135236,135236,135237,0,1,0
38595,2,2,135238,135238,135240,0,2,1
38596,4,2,135242,135242,135244,0,2,2
38597,5,1,135247,135247,135248,0,1,3
38598,5,3,135252,135252,135255,0,3,4
38599,6,3,135258,135258,135261,0,3,3
38600,5,2,135263,135263,135265,0,2,2
38601,3,2,135266,135266,135268,0,2,1
38602,3,1,135269,135269,135270,0,1,1
38603,1,2,135270,135270,135272,0,2,0
38604,3,1,135273,135273,135274,0,1,1
38605,3,3,135276,135276,135279,0,3,2
38606,6,1,135282,135282,135283,0,1,3
38607,4,3,135286,135286,135289,0,3,3
38608,1,2,135287,135289,135291,2,4,0
38609,4,2,135291,135291,135293,0,2,0
38610,1,3,135292,135293,135296,1,4,0
38611,5,1,135297,135297,135298,0,1,1
38612,2,1,135299,135299,135300,0,1,1
38613,3,2,135302,135302,135304,0,2,2
38614,3,1,135305,135305,135306,0,1,1
38615,6,1,135311,135311,135312,0,1,5
38616,1,3,135312,135312,135315,0,3,0
38617,4,2,135316,135316,135318,0,2,1
38618,1,1,135317,135318,135319,1,2,0
38619,4,2,135321,135321,135323,0,2,2
38620,4,1,135325,135325,135326,0,1,2
38621,2,2,135327,135327,135329,0,2,1
38622,2,2,135329,135329,135331,0,2,0
38623,5,2,135334,135334,135336,0,2,3
38624,1,2,135335,135336,135338,1,3,0
38625,6,2,135341,135341,135343,0,2,3
38626,4,1,135345,135345,135346,0,1,2
38627,4,1,135349,135349,135350,0,1,3
38628,3,3,135352,135352,135355,0,3,2
38629,3,2,135355,135355,135357,0,2,0
38630,6,2,135361,135361,135363,0,2,4
38631,1,2,135362,135363,135365,1,3,0
38632,1,1,135363,135365,135366,2,3,0
38633,3,1,135366,135366,135367,0,1,0
38634,1,3,135367,135367,135370,0,3,0
38635,5,1,135372,135372,135373,0,1,2
38636,1,3,135373,135373,135376,0,3,0
38637,5,1,135378,135378,135379,0,1,2
38638,2,3,135380,135380,135383,0,3,1
38639,4,1,135384,135384,135385,0,1,1
38640,3,3,135387,135387,135390,0,3,2
38641,3,3,135390,135390,135393,0,3,0
38642,3,2,135393,135393,135395,0,2,0
38643,3,2,135396,135396,135398,0,2,1
38644,2,2,135398,135398,135400,0,2,0
38645,2,1,135400,135400,135401,0,1,0
38646,4,1,135404,135404,135405,0,1,3
38647,1,2,135405,135405,135407,0,2,0
38648,5,2,135410,135410,135412,0,2,3
38649,3,1,135413,135413,135414,0,1,1
38650,5,3,135418,135418,135421,0,3,4
38651,1,1,135419,135421,135422,2,3,0
38652,3,1,135422,135422,135423,0,1,0
38653,6,3,135428,135428,135431,0,3,5
38654,1,3,135429,135431,135434,2,5,0
38655,5,2,135434,135434,135436,0,2,0
38656,4,2,135438,135438,135440,0,2,2
38657,2,3,135440,135440,135443,0,3,0
38658,3,1,135443,135443,135444,0,1,0
38659,2,2,135445,135445,135447,0,2,1
38660,2,1,135447,135447,135448,0,1,0
38661,4,3,135451,135451,135454,0,3,3
38662,6,1,135457,135457,135458,0,1,3
38663,6,1,135463,135463,135464,0,1,5
38664,6,3,135469,135469,135472,0,3,5
38665,6,2,135475,135475,135477,0,2,3
38666,5,2,135480,135480,135482,0,2,3
38667,6,1,135486,135486,135487,0,1,4
38668,4,2,135490,135490,135492,0,2,3
38669,5,1,135495,135495,135496,0,1,3
38670,6,1,135501,135501,135502,0,1,5
38671,2,3,135503,135503,135506,0,3,1
38672,2,2,135505,135506,135508,1,3,0
38673,5,2,135510,135510,135512,0,2,2
38674,1,1,135511,135512,135513,1,2,0
38675,3,1,135514,135514,135515,0,1,1
38676,5,3,135519,135519,135522,0,3,4
38677,6,2,135525,135525,135527,0,2,3
38678,3,1,135528,135528,135529,0,1,1
38679,6,3,135534,135534,135537,0,3,5
38680,2,3,135536,135537,135540,1,4,0
38681,6,3,135542,135542,135545,0,3,2
38682,2,3,135544,135545,135548,1,4,0
38683,3,1,135547,135548,135549,1,2,0
38684,6,1,135553,135553,135554,0,1,4
38685,4,2,135557,135557,135559,0,2,3
38686,2,3,135559,135559,135562,0,3,0
38687,2,1,135561,135562,135563,1,2,0
38688,6,2,135567,135567,135569,0,2,4
38689,2,2,135569,135569,135571,0,2,0
38690,4,3,135573,135573,135576,0,3,2
38691,1,3,135574,135576,135579,2,5,0
38692,2,3,135576,135579,135582,3,6,0
38693,5,3,135581,135582,135585,1,4,0
38694,4,2,135585,135585,135587,0,2,0
38695,5,1,135590,135590,135591,0,1,3
38696,1,3,135591,135591,135594,0,3,0
38697,4,1,135595,135595,135596,0,1,1
38698,6,1,135601,135601,135602,0,1,5
38699,5,3,135606,135606,135609,0,3,4
38700,2,1,135608,135609,135610,1,2,0
38701,5,1,135613,135613,135614,0,1,3
38702,4,3,135617,135617,135620,0,3,3
38703,4,3,135621,135621,135624,0,3,1
38704,6,1,135627,135627,135628,0,1,3
38705,3,2,135630,135630,135632,0,2,2
38706,5,1,135635,135635,135636,0,1,3
38707,4,2,135639,135639,135641,0,2,3
38708,4,3,135643,135643,135646,0,3,2
38709,4,3,135647,135647,135650,0,3,1
38710,6,1,135653,135653,135654,0,1,3
38711,5,3,135658,135658,135661,0,3,4
38712,1,1,135659,135661,135662,2,3,0
38713,3,1,135662,135662,135663,0,1,0
38714,1,1,135663,135663,135664,0,1,0
38715,4,2,135667,135667,135669,0,2,3
38716,3,3,135670,135670,135673,0,3,1
38717,1,2,135671,135673,135675,2,4,0
38718,3,2,135674,135675,135677,1,3,0
38719,3,3,135677,135677,135680,0,3,0
38720,4,1,135681,135681,135682,0,1,1
38721,6,3,135687,135687,135690,0,3,5
38722,2,3,135689,135690,135693,1,4,0
38723,4,1,135693,135693,135694,0,1,0
38724,5,2,135698,135698,135700,0,2,4
38725,2,1,135700,135700,135701,0,1,0
38726,3,1,135703,135703,135704,0,1,2
38727,1,2,135704,135704,135706,0,2,0
38728,2,3,135706,135706,135709,0,3,0
38729,6,2,135712,135712,135714,0,2,3
38730,2,1,135714,135714,135715,0,1,0
38731,6,2,135720,135720,135722,0,2,5
38732,4,1,135724,135724,135725,0,1,2
38733,3,2,135727,135727,135729,0,2,2
38734,1,3,135728,135729,135732,1,4,0
38735,1,3,135729,135732,135735,3,6,0
38736,2,2,135731,135735,135737,4,6,0
38737,2,1,135733,135737,135738,4,5,0
38738,5,2,135738,135738,135740,0,2,0
38739,3,2,135741,135741,135743,0,2,1
38740,4,2,135745,135745,135747,0,2,2
38741,5,2,135750,135750,135752,0,2,3
38742,2,3,135752,135752,135755,0,3,0
38743,4,1,135756,135756,135757,0,1,1
38744,1,1,135757,135757,135758,0,1,0
38745,5,2,135762,135762,135764,0,2,4
38746,6,1,135768,135768,135769,0,1,4
38747,4,3,135772,135772,135775,0,3,3
38748,6,2,135778,135778,135780,0,2,3
38749,4,3,135782,135782,135785,0,3,2
38750,3,3,135785,135785,135788,0,3,0
38751,4,2,135789,135789,135791,0,2,1
38752,5,2,135794,135794,135796,0,2,3
38753,2,3,135796,135796,135799,0,3,0
38754,6,3,135802,135802,135805,0,3,3
38755,5,1,135807,135807,135808,0,1,2
38756,2,1,135809,135809,135810,0,1,1
38757,6,1,135815,135815,135816,0,1,5
38758,1,3,135816,135816,135819,0,3,0
38759,1,2,135817,135819,135821,2,4,0
38760,3,3,135820,135821,135824,1,4,0
38761,3,1,135823,135824,135825,1,2,0
38762,3,2,135826,135826,135828,0,2,1
38763,6,3,135832,135832,135835,0,3,4
38764,1,2,135833,135835,135837,2,4,0
38765,6,1,135839,135839,135840,0,1,2
38766,4,2,135843,135843,135845,0,2,3
38767,2,3,135845,135845,135848,0,3,0
38768,4,2,135849,135849,135851,0,2,1
38769,4,2,135853,135853,135855,0,2,2
38770,6,3,135859,135859,135862,0,3,4
38771,4,2,135863,135863,135865,0,2,1
38772,5,3,135868,135868,135871,0,3,3
38773,2,3,135870,135871,135874,1,4,0
38774,4,1,135874,135874,135875,0,1,0
38775,1,1,135875,135875,135876,0,1,0
38776,3,2,135878,135878,135880,0,2,2
38777,1,2,135879,135880,135882,1,3,0
38778,3,1,135882,135882,135883,0,1,0
38779,3,2,135885,135885,135887,0,2,2
38780,2,3,135887,135887,135890,0,3,0
38781,1,1,135888,135890,135891,2,3,0
38782,6,3,135894,135894,135897,0,3,3
38783,3,1,135897,135897,135898,0,1,0
38784,5,3,135902,135902,135905,0,3,4
38785,2,3,135904,135905,135908,1,4,0
38786,6,1,135910,135910,135911,0,1,2
38787,6,2,135916,135916,135918,0,2,5
38788,3,1,135919,135919,135920,0,1,1
38789,2,1,135921,135921,135922,0,1,1
38790,1,1,135922,135922,135923,0,1,0
38791,2,1,135924,135924,135925,0,1,1
38792,5,2,135929,135929,135931,0,2,4
38793,1,3,135930,135931,135934,1,4,0
38794,3,1,135933,135934,135935,1,2,0
38795,5,2,135938,135938,135940,0,2,3
38796,6,2,135944,135944,135946,0,2,4
38797,3,2,135947,135947,135949,0,2,1
38798,1,3,135948,135949,135952,1,4,0
38799,6,2,135954,135954,135956,0,2,2
38800,1,3,135955,135956,135959,1,4,0
38801,2,3,135957,135959,135962,2,5,0
38802,1,3,135958,135962,135965,4,7,0
38803,3,3,135961,135965,135968,4,7,0
38804,3,3,135964,135968,135971,4,7,0
38805,2,2,135966,135971,135973,5,7,0
38806,3,2,135969,135973,135975,4,6,0
38807,1,2,135970,135975,135977,5,7,0
38808,4,2,135974,135977,135979,3,5,0
38809,3,2,135977,135979,135981,2,4,0
38810,4,2,135981,135981,135983,0,2,0
38811,6,2,135987,135987,135989,0,2,4
38812,5,2,135992,135992,135994,0,2,3
38813,3,3,135995,135995,135998,0,3,1
38814,1,1,135996,135998,135999,2,3,0
38815,4,1,136000,136000,136001,0,1,1
38816,1,2,136001,136001,136003,0,2,0
38817,5,1,136006,136006,136007,0,1,3
38818,2,1,136008,136008,136009,0,1,1
38819,5,3,136013,136013,136016,0,3,4
38820,5,2,136018,136018,136020,0,2,2
38821,3,1,136021,136021,136022,0,1,1
38822,1,3,136022,136022,136025,0,3,0
38823,5,3,136027,136027,136030,0,3,2
38824,4,1,136031,136031,136032,0,1,1
38825,3,1,136034,136034,136035,0,1,2
38826,6,3,136040,136040,136043,0,3,5
38827,6,1,136046,136046,136047,0,1,3
38828,4,3,136050,136050,136053,0,3,3
38829,2,3,136052,136053,136056,1,4,0
38830,5,3,136057,136057,136060,0,3,1
38831,1,3,136058,136060,136063,2,5,0
38832,4,1,136062,136063,136064,1,2,0
38833,6,1,136068,136068,136069,0,1,4
38834,6,1,136074,136074,136075,0,1,5
38835,3,2,136077,136077,136079,0,2,2
38836,5,1,136082,136082,136083,0,1,3
38837,2,2,136084,136084,136086,0,2,1
38838,3,2,136087,136087,136089,0,2,1
38839,1,2,136088,136089,136091,1,3,0
38840,3,2,136091,136091,136093,0,2,0
38841,1,1,136092,136093,136094,1,2,0
38842,4,1,136096,136096,136097,0,1,2
38843,4,3,136100,136100,136103,0,3,3
38844,6,2,136106,136106,136108,0,2,3
38845,1,1,136107,136108,136109,1,2,0
38846,4,2,136111,136111,136113,0,2,2
38847,5,3,136116,136116,136119,0,3,3
38848,4,2,136120,136120,136122,0,2,1
38849,1,1,136121,136122,136123,1,2,0
38850,6,1,136127,136127,136128,0,1,4
38851,4,1,136131,136131,136132,0,1,3
38852,5,2,136136,136136,136138,0,2,4
38853,4,3,136140,136140,136143,0,3,2
38854,5,2,136145,136145,136147,0,2,2
38855,1,3,136146,136147,136150,1,4,0
38856,1,3,136147,136150,136153,3,6,0
38857,4,3,136151,136153,136156,2,5,0
38858,2,1,136153,136156,136157,3,4,0
38859,3,1,136156,136157,136158,1,2,0
38860,5,3,136161,136161,136164,0,3,3
38861,4,2,136165,136165,136167,0,2,1
38862,4,1,136169,136169,136170,0,1,2
38863,3,2,136172,136172,136174,0,2,2
38864,4,1,136176,136176,136177,0,1,2
38865,2,2,136178,136178,136180,0,2,1
38866,6,3,136184,136184,136187,0,3,4
38867,4,3,136188,136188,136191,0,3,1
38868,4,3,136192,136192,136195,0,3,1
38869,4,2,136196,136196,136198,0,2,1
38870,1,1,136197,136198,136199,1,2,0
38871,3,2,136200,136200,136202,0,2,1
38872,4,1,136204,136204,136205,0,1,2
38873,4,2,136208,136208,136210,0,2,3
38874,5,1,136213,136213,136214,0,1,3
38875,5,1,136218,136218,136219,0,1,4
38876,2,2,136220,136220,136222,0,2,1
38877,3,3,136223,136223,136226,0,3,1
38878,3,3,136226,136226,136229,0,3,0
38879,5,1,136231,136231,136232,0,1,2
38880,4,3,136235,136235,136238,0,3,3
38881,3,2,136238,136238,136240,0,2,0
38882,5,2,136243,136243,136245,0,2,3
38883,2,2,136245,136245,136247,0,2,0
38884,2,1,136247,136247,136248,0,1,0
38885,4,2,136251,136251,136253,0,2,3
38886,1,3,136252,136253,136256,1,4,0
38887,3,1,136255,136256,136257,1,2,0
38888,5,3,136260,136260,136263,0,3,3
38889,2,3,136262,136263,136266,1,4,0
38890,4,1,136266,136266,136267,0,1,0
38891,6,3,136272,136272,136275,0,3,5
38892,4,1,136276,136276,136277,0,1,1
38893,4,1,136280,136280,136281,0,1,3
38894,3,1,136283,136283,136284,0,1,2
38895,2,1,136285,136285,136286,0,1,1
38896,5,2,136290,136290,136292,0,2,4
38897,5,2,136295,136295,136297,0,2,3
38898,1,3,136296,136297,136300,1,4,0
38899,4,1,136300,136300,136301,0,1,0
38900,5,1,136305,136305,136306,0,1,4
38901,2,1,136307,136307,136308,0,1,1
38902,1,3,136308,136308,136311,0,3,0
38903,6,2,136314,136314,136316,0,2,3
38904,5,1,136319,136319,136320,0,1,3
38905,6,1,136325,136325,136326,0,1,5
38906,3,2,136328,136328,136330,0,2,2
38907,2,3,136330,136330,136333,0,3,0
38908,1,2,136331,136333,136335,2,4,0
38909,1,2,136332,136335,136337,3,5,0
38910,4,3,136336,136337,136340,1,4,0
38911,4,1,136340,136340,136341,0,1,0
38912,3,2,136343,136343,136345,0,2,2
38913,4,3,136347,136347,136350,0,3,2
38914,1,1,136348,136350,136351,2,3,0
38915,5,3,136353,136353,136356,0,3,2
38916,6,3,136359,136359,136362,0,3,3
38917,5,3,136364,136364,136367,0,3,2
38918,6,1,136370,136370,136371,0,1,3
38919,3,2,136373,136373,136375,0,2,2
38920,4,1,136377,136377,136378,0,1,2
38921,6,1,136383,136383,136384,0,1,5
38922,6,1,136389,136389,136390,0,1,5
38923,1,2,136390,136390,136392,0,2,0
38924,2,1,136392,136392,136393,0,1,0
38925,2,1,136394,136394,136395,0,1,1
38926,6,1,136400,136400,136401,0,1,5
38927,5,2,136405,136405,136407,0,2,4
38928,5,2,136410,136410,136412,0,2,3
38929,5,1,136415,136415,136416,0,1,3
38930,5,1,136420,136420,136421,0,1,4
38931,3,1,136423,136423,136424,0,1,2
38932,2,3,136425,136425,136428,0,3,1
38933,2,2,136427,136428,136430,1,3,0
38934,2,1,136429,136430,136431,1,2,0
38935,4,1,136433,136433,136434,0,1,2
38936,1,1,136434,136434,136435,0,1,0
38937,2,3,136436,136436,136439,0,3,1
38938,3,1,136439,136439,136440,0,1,0
38939,5,2,136444,136444,136446,0,2,4
38940,1,2,136445,136446,136448,1,3,0
38941,2,3,136447,136448,136451,1,4,0
38942,4,2,136451,136451,136453,0,2,0
38943,4,1,136455,136455,136456,0,1,2
38944,2,3,136457,136457,136460,0,3,1
38945,1,3,136458,136460,136463,2,5,0
38946,3,3,136461,136463,136466,2,5,0
38947,2,1,136463,136466,136467,3,4,0
38948,5,2,136468,136468,136470,0,2,1
38949,5,3,136473,136473,136476,0,3,3
38950,3,1,136476,136476,136477,0,1,0
38951,5,3,136481,136481,136484,0,3,4
38952,2,1,136483,136484,136485,1,2,0
38953,3,2,136486,136486,136488,0,2,1
38954,4,2,136490,136490,136492,0,2,2
38955,1,3,136491,136492,136495,1,4,0
38956,3,3,136494,136495,136498,1,4,0
38957,3,3,136497,136498,136501,1,4,0
38958,2,3,136499,136501,136504,2,5,0
38959,1,2,136500,136504,136506,4,6,0
38960,4,3,136504,136506,136509,2,5,0
38961,5,1,136509,136509,136510,0,1,0
38962,3,1,136512,136512,136513,0,1,2
38963,6,1,136518,136518,136519,0,1,5
38964,6,2,136524,136524,136526,0,2,5
38965,6,2,136530,136530,136532,0,2,4
38966,4,1,136534,136534,136535,0,1,2
38967,3,2,136537,136537,136539,0,2,2
38968,6,1,136543,136543,136544,0,1,4
38969,1,2,136544,136544,136546,0,2,0
38970,6,3,136550,136550,136553,0,3,4
38971,6,1,136556,136556,136557,0,1,3
38972,2,1,136558,136558,136559,0,1,1
38973,5,2,136563,136563,136565,0,2,4
38974,1,1,136564,136565,136566,1,2,0
38975,4,3,136568,136568,136571,0,3,2
38976,6,3,136574,136574,136577,0,3,3
38977,6,1,136580,136580,136581,0,1,3
38978,3,2,136583,136583,136585,0,2,2
38979,4,1,136587,136587,136588,0,1,2
38980,3,1,136590,136590,136591,0,1,2
38981,3,2,136593,136593,136595,0,2,2
38982,5,3,136598,136598,136601,0,3,3
38983,4,3,136602,136602,136605,0,3,1
38984,6,3,136608,136608,136611,0,3,3
38985,5,3,136613,136613,136616,0,3,2
38986,2,2,136615,136616,136618,1,3,0
38987,5,2,136620,136620,136622,0,2,2
38988,6,2,136626,136626,136628,0,2,4
38989,3,2,136629,136629,136631,0,2,1
38990,4,3,136633,136633,136636,0,3,2
38991,5,1,136638,136638,136639,0,1,2
38992,5,2,136643,136643,136645,0,2,4
38993,3,3,136646,136646,136649,0,3,1
38994,5,2,136651,136651,136653,0,2,2
38995,4,2,136655,136655,136657,0,2,2
38996,3,2,136658,136658,136660,0,2,1
38997,1,2,136659,136660,136662,1,3,0
38998,5,2,136664,136664,136666,0,2,2
38999,2,2,136666,136666,136668,0,2,0
39000,1,2,136667,136668,136670,1,3,0
39001,1,1,136668,136670,136671,2,3,0
39002,4,3,136672,136672,136675,0,3,1
39003,6,3,136678,136678,136681,0,3,3
39004,5,2,136683,136683,136685,0,2,2
39005,3,2,136686,136686,136688,0,2,1
39006,3,3,136689,136689,136692,0,3,1
39007,2,2,136691,136692,136694,1,3,0
39008,3,3,136694,136694,136697,0,3,0
39009,3,1,136697,136697,136698,0,1,0
39010,1,2,136698,136698,136700,0,2,0
39011,1,1,136699,136700,136701,1,2,0
39012,3,3,136702,136702,136705,0,3,1
39013,6,3,136708,136708,136711,0,3,3
39014,4,1,136712,136712,136713,0,1,1
39015,1,2,136713,136713,136715,0,2,0
39016,1,1,136714,136715,136716,1,2,0
39017,2,3,136716,136716,136719,0,3,0
39018,5,1,136721,136721,136722,0,1,2
39019,6,1,136727,136727,136728,0,1,5
39020,1,1,136728,136728,136729,0,1,0
39021,5,3,136733,136733,136736,0,3,4
39022,1,3,136734,136736,136739,2,5,0
39023,4,1,136738,136739,136740,1,2,0
39024,1,3,136739,136740,136743,1,4,0
39025,2,2,136741,136743,136745,2,4,0
39026,1,2,136742,136745,136747,3,5,0
39027,2,3,136744,136747,136750,3,6,0
39028,4,1,136748,136750,136751,2,3,0
39029,1,2,136749,136751,136753,2,4,0
39030,6,2,136755,136755,136757,0,2,2
39031,6,3,136761,136761,136764,0,3,4
39032,6,2,136767,136767,136769,0,2,3
39033,2,1,136769,136769,136770,0,1,0
39034,6,2,136775,136775,136777,0,2,5
39035,4,1,136779,136779,136780,0,1,2
39036,1,2,136780,136780,136782,0,2,0
39037,4,1,136784,136784,136785,0,1,2
39038,2,1,136786,136786,136787,0,1,1
39039,6,3,136792,136792,136795,0,3,5
39040,5,2,136797,136797,136799,0,2,2
39041,5,1,136802,136802,136803,0,1,3
39042,6,1,136808,136808,136809,0,1,5
39043,3,3,136811,136811,136814,0,3,2
39044,1,1,136812,136814,136815,2,3,0
39045,2,1,136814,136815,136816,1,2,0
39046,5,3,136819,136819,136822,0,3,3
39047,2,1,136821,136822,136823,1,2,0
39048,4,2,136825,136825,136827,0,2,2
39049,6,2,136831,136831,136833,0,2,4
39050,3,2,136834,136834,136836,0,2,1
39051,1,3,136835,136836,136839,1,4,0
39052,6,1,136841,136841,136842,0,1,2
39053,4,1,136845,136845,136846,0,1,3
39054,1,2,136846,136846,136848,0,2,0
39055,4,2,136850,136850,136852,0,2,2
39056,4,3,136854,136854,136857,0,3,2
39057,1,1,136855,136857,136858,2,3,0
39058,5,1,136860,136860,136861,0,1,2
39059,3,2,136863,136863,136865,0,2,2
39060,5,3,136868,136868,136871,0,3,3
39061,3,3,136871,136871,136874,0,3,0
39062,1,2,136872,136874,136876,2,4,0
39063,5,2,136877,136877,136879,0,2,1
39064,6,1,136883,136883,136884,0,1,4
39065,5,2,136888,136888,136890,0,2,4
39066,1,2,136889,136890,136892,1,3,0
39067,1,3,136890,136892,136895,2,5,0
39068,4,1,136894,136895,136896,1,2,0
39069,6,2,136900,136900,136902,0,2,4
39070,6,3,136906,136906,136909,0,3,4
39071,5,1,136911,136911,136912,0,1,2
39072,5,3,136916,136916,136919,0,3,4
39073,3,2,136919,136919,136921,0,2,0
39074,3,3,136922,136922,136925,0,3,1
39075,5,2,136927,136927,136929,0,2,2
39076,4,2,136931,136931,136933,0,2,2
39077,4,1,136935,136935,136936,0,1,2
39078,4,2,136939,136939,136941,0,2,3
39079,1,2,136940,136941,136943,1,3,0
39080,4,1,136944,136944,136945,0,1,1
39081,6,2,136950,136950,136952,0,2,5
39082,4,1,136954,136954,136955,0,1,2
39083,6,2,136960,136960,136962,0,2,5
39084,3,2,136963,136963,136965,0,2,1
39085,5,3,136968,136968,136971,0,3,3
39086,5,2,136973,136973,136975,0,2,2
39087,5,3,136978,136978,136981,0,3,3
39088,3,1,136981,136981,136982,0,1,0
39089,2,3,136983,136983,136986,0,3,1
39090,5,3,136988,136988,136991,0,3,2
39091,3,3,136991,136991,136994,0,3,0
39092,1,3,136992,136994,136997,2,5,0
39093,4,3,136996,136997,137000,1,4,0
39094,2,3,136998,137000,137003,2,5,0
39095,3,2,137001,137003,137005,2,4,0
39096,5,2,137006,137006,137008,0,2,1
39097,4,2,137010,137010,137012,0,2,2
39098,4,1,137014,137014,137015,0,1,2
39099,1,1,137015,137015,137016,0,1,0
39100,1,2,137016,137016,137018,0,2,0
39101,4,3,137020,137020,137023,0,3,2
39102,1,1,137021,137023,137024,2,3,0
39103,3,2,137024,137024,137026,0,2,0
39104,6,3,137030,137030,137033,0,3,4
39105,3,1,137033,137033,137034,0,1,0
39106,5,2,137038,137038,137040,0,2,4
39107,3,1,137041,137041,137042,0,1,1
39108,6,2,137047,137047,137049,0,2,5
39109,6,2,137053,137053,137055,0,2,4
39110,2,1,137055,137055,137056,0,1,0
39111,1,1,137056,137056,137057,0,1,0
39112,3,1,137059,137059,137060,0,1,2
39113,1,2,137060,137060,137062,0,2,0
39114,3,3,137063,137063,137066,0,3,1
39115,5,2,137068,137068,137070,0,2,2
39116,4,1,137072,137072,137073,0,1,2
39117,2,2,137074,137074,137076,0,2,1
39118,3,2,137077,137077,137079,0,2,1
39119,2,2,137079,137079,137081,0,2,0
39120,2,2,137081,137081,137083,0,2,0
39121,1,3,137082,137083,137086,1,4,0
39122,1,1,137083,137086,137087,3,4,0
39123,3,3,137086,137087,137090,1,4,0
39124,5,2,137091,137091,137093,0,2,1
39125,4,2,137095,137095,137097,0,2,2
39126,6,1,137101,137101,137102,0,1,4
39127,1,2,137102,137102,137104,0,2,0
39128,1,1,137103,137104,137105,1,2,0
39129,1,1,137104,137105,137106,1,2,0
39130,1,1,137105,137106,137107,1,2,0
39131,1,2,137106,137107,137109,1,3,0
39132,5,2,137111,137111,137113,0,2,2
39133,6,2,137117,137117,137119,0,2,4
39134,5,1,137122,137122,137123,0,1,3
39135,2,1,137124,137124,137125,0,1,1
39136,1,1,137125,137125,137126,0,1,0
39137,6,1,137131,137131,137132,0,1,5
39138,1,3,137132,137132,137135,0,3,0
39139,1,1,137133,137135,137136,2,3,0
39140,4,3,137137,137137,137140,0,3,1
39141,4,1,137141,137141,137142,0,1,1
39142,2,3,137143,137143,137146,0,3,1
39143,4,2,137147,137147,137149,0,2,1
39144,2,3,137149,137149,137152,0,3,0
39145,6,1,137155,137155,137156,0,1,3
39146,6,3,137161,137161,137164,0,3,5
39147,3,2,137164,137164,137166,0,2,0
39148,4,2,137168,137168,137170,0,2,2
39149,1,3,137169,137170,137173,1,4,0
39150,6,2,137175,137175,137177,0,2,2
39151,4,1,137179,137179,137180,0,1,2
39152,5,2,137184,137184,137186,0,2,4
39153,2,2,137186,137186,137188,0,2,0
39154,1,2,137187,137188,137190,1,3,0
39155,3,3,137190,137190,137193,0,3,0
39156,2,1,137192,137193,137194,1,2,0
39157,5,2,137197,137197,137199,0,2,3
39158,6,3,137203,137203,137206,0,3,4
39159,1,1,137204,137206,137207,2,3,0
39160,5,2,137209,137209,137211,0,2,2
39161,5,3,137214,137214,137217,0,3,3
39162,3,3,137217,137217,137220,0,3,0
39163,3,1,137220,137220,137221,0,1,0
39164,1,1,137221,137221,137222,0,1,0
39165,3,3,137224,137224,137227,0,3,2
39166,1,1,137225,137227,137228,2,3,0
39167,5,2,137230,137230,137232,0,2,2
39168,3,2,137233,137233,137235,0,2,1
39169,3,3,137236,137236,137239,0,3,1
39170,1,1,137237,137239,137240,2,3,0
39171,2,3,137239,137240,137243,1,4,0
39172,1,1,137240,137243,137244,3,4,0
39173,5,3,137245,137245,137248,0,3,1
39174,5,2,137250,137250,137252,0,2,2
39175,4,3,137254,137254,137257,0,3,2
39176,4,3,137258,137258,137261,0,3,1
39177,2,2,137260,137261,137263,1,3,0
39178,1,1,137261,137263,137264,2,3,0
39179,6,3,137267,137267,137270,0,3,3
39180,3,2,137270,137270,137272,0,2,0
39181,4,2,137274,137274,137276,0,2,2
39182,4,1,137278,137278,137279,0,1,2
39183,3,1,137281,137281,137282,0,1,2
39184,5,1,137286,137286,137287,0,1,4
39185,3,3,137289,137289,137292,0,3,2
39186,3,1,137292,137292,137293,0,1,0
39187,1,2,137293,137293,137295,0,2,0
39188,1,1,137294,137295,137296,1,2,0
39189,1,2,137295,137296,137298,1,3,0
39190,3,1,137298,137298,137299,0,1,0
39191,5,3,137303,137303,137306,0,3,4
39192,3,3,137306,137306,137309,0,3,0
39193,2,2,137308,137309,137311,1,3,0
39194,1,2,137309,137311,137313,2,4,0
39195,1,3,137310,137313,137316,3,6,0
39196,4,1,137314,137316,137317,2,3,0
39197,6,3,137320,137320,137323,0,3,3
39198,1,2,137321,137323,137325,2,4,0
39199,6,1,137327,137327,137328,0,1,2
39200,5,3,137332,137332,137335,0,3,4
39201,1,1,137333,137335,137336,2,3,0
39202,4,3,137337,137337,137340,0,3,1
39203,4,2,137341,137341,137343,0,2,1
39204,5,2,137346,137346,137348,0,2,3
39205,3,3,137349,137349,137352,0,3,1
39206,1,1,137350,137352,137353,2,3,0
39207,6,3,137356,137356,137359,0,3,3
39208,6,1,137362,137362,137363,0,1,3
39209,3,2,137365,137365,137367,0,2,2
39210,1,1,137366,137367,137368,1,2,0
39211,2,1,137368,137368,137369,0,1,0
39212,3,2,137371,137371,137373,0,2,2
39213,5,1,137376,137376,137377,0,1,3
39214,4,3,137380,137380,137383,0,3,3
39215,6,3,137386,137386,137389,0,3,3
39216,6,2,137392,137392,137394,0,2,3
39217,5,2,137397,137397,137399,0,2,3
39218,6,1,137403,137403,137404,0,1,4
39219,5,2,137408,137408,137410,0,2,4
39220,1,2,137409,137410,137412,1,3,0
39221,5,1,137414,137414,137415,0,1,2
39222,1,1,137415,137415,137416,0,1,0
39223,6,2,137421,137421,137423,0,2,5
39224,4,3,137425,137425,137428,0,3,2
39225,6,3,137431,137431,137434,0,3,3
39226,4,1,137435,137435,137436,0,1,1
39227,2,3,137437,137437,137440,0,3,1
39228,3,1,137440,137440,137441,0,1,0
39229,1,1,137441,137441,137442,0,1,0
39230,2,2,137443,137443,137445,0,2,1
39231,1,1,137444,137445,137446,1,2,0
39232,3,2,137447,137447,137449,0,2,1
39233,6,1,137453,137453,137454,0,1,4
39234,1,3,137454,137454,137457,0,3,0
39235,4,3,137458,137458,137461,0,3,1
39236,3,2,137461,137461,137463,0,2,0
39237,4,3,137465,137465,137468,0,3,2
39238,6,3,137471,137471,137474,0,3,3
39239,5,1,137476,137476,137477,0,1,2
39240,4,1,137480,137480,137481,0,1,3
39241,3,2,137483,137483,137485,0,2,2
39242,2,3,137485,137485,137488,0,3,0
39243,4,2,137489,137489,137491,0,2,1
39244,2,1,137491,137491,137492,0,1,0
39245,6,1,137497,137497,137498,0,1,5
39246,1,2,137498,137498,137500,0,2,0
39247,5,1,137503,137503,137504,0,1,3
39248,2,1,137505,137505,137506,0,1,1
39249,4,3,137509,137509,137512,0,3,3
39250,5,3,137514,137514,137517,0,3,2
39251,2,3,137516,137517,137520,1,4,0
39252,4,1,137520,137520,137521,0,1,0
39253,6,3,137526,137526,137529,0,3,5
39254,1,2,137527,137529,137531,2,4,0
39255,5,3,137532,137532,137535,0,3,1
39256,1,2,137533,137535,137537,2,4,0
39257,3,2,137536,137537,137539,1,3,0
39258,3,1,137539,137539,137540,0,1,0
39259,6,3,137545,137545,137548,0,3,5
39260,4,3,137549,137549,137552,0,3,1
39261,5,2,137554,137554,137556,0,2,2
39262,4,3,137558,137558,137561,0,3,2
39263,3,3,137561,137561,137564,0,3,0
39264,5,1,137566,137566,137567,0,1,2
39265,2,3,137568,137568,137571,0,3,1
39266,3,1,137571,137571,137572,0,1,0
39267,4,2,137575,137575,137577,0,2,3
39268,4,1,137579,137579,137580,0,1,2
39269,4,1,137583,137583,137584,0,1,3
39270,3,2,137586,137586,137588,0,2,2
39271,2,3,137588,137588,137591,0,3,0
39272,6,1,137594,137594,137595,0,1,3
39273,4,1,137598,137598,137599,0,1,3
39274,1,1,137599,137599,137600,0,1,0
39275,6,3,137605,137605,137608,0,3,5
39276,2,2,137607,137608,137610,1,3,0
39277,6,2,137613,137613,137615,0,2,3
39278,1,1,137614,137615,137616,1,2,0
39279,5,1,137619,137619,137620,0,1,3
39280,4,1,137623,137623,137624,0,1,3
39281,4,1,137627,137627,137628,0,1,3
39282,5,2,137632,137632,137634,0,2,4
39283,3,2,137635,137635,137637,0,2,1
39284,2,1,137637,137637,137638,0,1,0
39285,5,3,137642,137642,137645,0,3,4
39286,1,1,137643,137645,137646,2,3,0
39287,5,3,137648,137648,137651,0,3,2
39288,6,3,137654,137654,137657,0,3,3
39289,3,2,137657,137657,137659,0,2,0
39290,1,2,137658,137659,137661,1,3,0
39291,3,3,137661,137661,137664,0,3,0
39292,4,1,137665,137665,137666,0,1,1
39293,6,2,137671,137671,137673,0,2,5
39294,6,1,137677,137677,137678,0,1,4
39295,2,1,137679,137679,137680,0,1,1
39296,1,3,137680,137680,137683,0,3,0
39297,1,1,137681,137683,137684,2,3,0
39298,3,2,137684,137684,137686,0,2,0
39299,5,3,137689,137689,137692,0,3,3
39300,5,1,137694,137694,137695,0,1,2
39301,5,3,137699,137699,137702,0,3,4
39302,3,3,137702,137702,137705,0,3,0
39303,1,3,137703,137705,137708,2,5,0
39304,5,2,137708,137708,137710,0,2,0
39305,1,3,137709,137710,137713,1,4,0
39306,2,2,137711,137713,137715,2,4,0
39307,6,1,137717,137717,137718,0,1,2
39308,3,2,137720,137720,137722,0,2,2
39309,1,1,137721,137722,137723,1,2,0
39310,2,1,137723,137723,137724,0,1,0
39311,4,2,137727,137727,137729,0,2,3
39312,5,3,137732,137732,137735,0,3,3
39313,3,3,137735,137735,137738,0,3,0
39314,4,3,137739,137739,137742,0,3,1
39315,4,1,137743,137743,137744,0,1,1
39316,4,3,137747,137747,137750,0,3,3
39317,6,2,137753,137753,137755,0,2,3
39318,1,3,137754,137755,137758,1,4,0
39319,1,1,137755,137758,137759,3,4,0
39320,4,3,137759,137759,137762,0,3,0
39321,6,3,137765,137765,137768,0,3,3
39322,2,3,137767,137768,137771,1,4,0
39323,6,1,137773,137773,137774,0,1,2
39324,3,1,137776,137776,137777,0,1,2
39325,3,3,137779,137779,137782,0,3,2
39326,2,3,137781,137782,137785,1,4,0
39327,1,1,137782,137785,137786,3,4,0
39328,2,3,137784,137786,137789,2,5,0
39329,3,3,137787,137789,137792,2,5,0
39330,2,2,137789,137792,137794,3,5,0
39331,3,1,137792,137794,137795,2,3,0
39332,4,1,137796,137796,137797,0,1,1
39333,5,1,137801,137801,137802,0,1,4
39334,6,2,137807,137807,137809,0,2,5
39335,1,1,137808,137809,137810,1,2,0
39336,5,1,137813,137813,137814,0,1,3
39337,5,2,137818,137818,137820,0,2,4
39338,1,1,137819,137820,137821,1,2,0
39339,4,1,137823,137823,137824,0,1,2
39340,2,1,137825,137825,137826,0,1,1
39341,6,3,137831,137831,137834,0,3,5
39342,2,2,137833,137834,137836,1,3,0
39343,6,3,137839,137839,137842,0,3,3
39344,3,3,137842,137842,137845,0,3,0
39345,3,1,137845,137845,137846,0,1,0
39346,5,1,137850,137850,137851,0,1,4
39347,4,1,137854,137854,137855,0,1,3
39348,3,1,137857,137857,137858,0,1,2
39349,4,2,137861,137861,137863,0,2,3
39350,4,1,137865,137865,137866,0,1,2
39351,1,2,137866,137866,137868,0,2,0
39352,5,1,137871,137871,137872,0,1,3
39353,2,3,137873,137873,137876,0,3,1
39354,2,2,137875,137876,137878,1,3,0
39355,3,3,137878,137878,137881,0,3,0
39356,6,1,137884,137884,137885,0,1,3
39357,1,1,137885,137885,137886,0,1,0
39358,1,1,137886,137886,137887,0,1,0
39359,6,3,137892,137892,137895,0,3,5
39360,1,1,137893,137895,137896,2,3,0
39361,5,1,137898,137898,137899,0,1,2
39362,6,3,137904,137904,137907,0,3,5
39363,3,2,137907,137907,137909,0,2,0
39364,6,3,137913,137913,137916,0,3,4
39365,1,3,137914,137916,137919,2,5,0
39366,4,3,137918,137919,137922,1,4,0
39367,6,2,137924,137924,137926,0,2,2
39368,1,3,137925,137926,137929,1,4,0
39369,1,1,137926,137929,137930,3,4,0
39370,6,3,137932,137932,137935,0,3,2
39371,5,2,137937,137937,137939,0,2,2
39372,2,1,137939,137939,137940,0,1,0
39373,5,1,137944,137944,137945,0,1,4
39374,5,2,137949,137949,137951,0,2,4
39375,6,1,137955,137955,137956,0,1,4
39376,1,3,137956,137956,137959,0,3,0
39377,3,3,137959,137959,137962,0,3,0
39378,6,1,137965,137965,137966,0,1,3
39379,4,2,137969,137969,137971,0,2,3
39380,6,1,137975,137975,137976,0,1,4
39381,2,2,137977,137977,137979,0,2,1
39382,3,1,137980,137980,137981,0,1,1
39383,4,2,137984,137984,137986,0,2,3
39384,5,3,137989,137989,137992,0,3,3
39385,2,3,137991,137992,137995,1,4,0
39386,4,2,137995,137995,137997,0,2,0
39387,4,3,137999,137999,138002,0,3,2
39388,3,3,138002,138002,138005,0,3,0
39389,1,2,138003,138005,138007,2,4,0
39390,3,3,138006,138007,138010,1,4,0
39391,4,2,138010,138010,138012,0,2,0
39392,2,2,138012,138012,138014,0,2,0
39393,4,3,138016,138016,138019,0,3,2
39394,4,1,138020,138020,138021,0,1,1
39395,3,2,138023,138023,138025,0,2,2
39396,5,3,138028,138028,138031,0,3,3
39397,2,3,138030,138031,138034,1,4,0
39398,3,3,138033,138034,138037,1,4,0
39399,5,1,138038,138038,138039,0,1,1
39400,2,3,138040,138040,138043,0,3,1
39401,3,1,138043,138043,138044,0,1,0
39402,2,2,138045,138045,138047,0,2,1
39403,2,1,138047,138047,138048,0,1,0
39404,6,2,138053,138053,138055,0,2,5
39405,4,2,138057,138057,138059,0,2,2
39406,2,1,138059,138059,138060,0,1,0
39407,5,3,138064,138064,138067,0,3,4
39408,4,1,138068,138068,138069,0,1,1
39409,5,1,138073,138073,138074,0,1,4
39410,2,3,138075,138075,138078,0,3,1
39411,2,1,138077,138078,138079,1,2,0
39412,1,1,138078,138079,138080,1,2,0
39413,1,1,138079,138080,138081,1,2,0
39414,6,1,138085,138085,138086,0,1,4
39415,2,1,138087,138087,138088,0,1,1
39416,5,1,138092,138092,138093,0,1,4
39417,2,2,138094,138094,138096,0,2,1
39418,4,2,138098,138098,138100,0,2,2
39419,3,2,138101,138101,138103,0,2,1
39420,3,3,138104,138104,138107,0,3,1
39421,2,1,138106,138107,138108,1,2,0
39422,1,2,138107,138108,138110,1,3,0
39423,3,2,138110,138110,138112,0,2,0
39424,6,3,138116,138116,138119,0,3,4
39425,5,1,138121,138121,138122,0,1,2
39426,5,2,138126,138126,138128,0,2,4
39427,3,1,138129,138129,138130,0,1,1
39428,1,3,138130,138130,138133,0,3,0
39429,4,1,138134,138134,138135,0,1,1
39430,4,3,138138,138138,138141,0,3,3
39431,2,2,138140,138141,138143,1,3,0
39432,1,2,138141,138143,138145,2,4,0
39433,3,3,138144,138145,138148,1,4,0
39434,4,2,138148,138148,138150,0,2,0
39435,4,3,138152,138152,138155,0,3,2
39436,5,3,138157,138157,138160,0,3,2
39437,2,1,138159,138160,138161,1,2,0
39438,3,2,138162,138162,138164,0,2,1
39439,2,1,138164,138164,138165,0,1,0
39440,3,3,138167,138167,138170,0,3,2
39441,4,2,138171,138171,138173,0,2,1
39442,1,2,138172,138173,138175,1,3,0
39443,2,1,138174,138175,138176,1,2,0
39444,5,3,138179,138179,138182,0,3,3
39445,2,2,138181,138182,138184,1,3,0
39446,3,2,138184,138184,138186,0,2,0
39447,2,3,138186,138186,138189,0,3,0
39448,1,2,138187,138189,138191,2,4,0
39449,6,3,138193,138193,138196,0,3,2
39450,1,1,138194,138196,138197,2,3,0
39451,3,3,138197,138197,138200,0,3,0
39452,1,1,138198,138200,138201,2,3,0
39453,6,2,138204,138204,138206,0,2,3
39454,6,3,138210,138210,138213,0,3,4
39455,2,2,138212,138213,138215,1,3,0
39456,1,2,138213,138215,138217,2,4,0
39457,5,1,138218,138218,138219,0,1,1
39458,5,1,138223,138223,138224,0,1,4
39459,4,1,138227,138227,138228,0,1,3
39460,2,1,138229,138229,138230,0,1,1
39461,4,1,138233,138233,138234,0,1,3
39462,5,1,138238,138238,138239,0,1,4
39463,2,3,138240,138240,138243,0,3,1
39464,3,2,138243,138243,138245,0,2,0
39465,3,2,138246,138246,138248,0,2,1
39466,5,2,138251,138251,138253,0,2,3
39467,6,2,138257,138257,138259,0,2,4
39468,3,2,138260,138260,138262,0,2,1
39469,6,2,138266,138266,138268,0,2,4
39470,6,1,138272,138272,138273,0,1,4
39471,1,2,138273,138273,138275,0,2,0
39472,1,3,138274,138275,138278,1,4,0
39473,4,1,138278,138278,138279,0,1,0
39474,1,3,138279,138279,138282,0,3,0
39475,3,2,138282,138282,138284,0,2,0
39476,4,1,138286,138286,138287,0,1,2
39477,2,3,138288,138288,138291,0,3,1
39478,3,2,138291,138291,138293,0,2,0
39479,3,3,138294,138294,138297,0,3,1
39480,2,2,138296,138297,138299,1,3,0
39481,3,2,138299,138299,138301,0,2,0
39482,5,3,138304,138304,138307,0,3,3
39483,6,2,138310,138310,138312,0,2,3
39484,2,3,138312,138312,138315,0,3,0
39485,2,1,138314,138315,138316,1,2,0
39486,1,2,138315,138316,138318,1,3,0
39487,3,3,138318,138318,138321,0,3,0
39488,1,2,138319,138321,138323,2,4,0
39489,5,1,138324,138324,138325,0,1,1
39490,1,1,138325,138325,138326,0,1,0
39491,4,3,138329,138329,138332,0,3,3
39492,5,3,138334,138334,138337,0,3,2
39493,4,1,138338,138338,138339,0,1,1
39494,3,3,138341,138341,138344,0,3,2
39495,1,1,138342,138344,138345,2,3,0
39496,5,1,138347,138347,138348,0,1,2
39497,5,2,138352,138352,138354,0,2,4
39498,5,1,138357,138357,138358,0,1,3
39499,2,1,138359,138359,138360,0,1,1
39500,1,3,138360,138360,138363,0,3,0
39501,4,3,138364,138364,138367,0,3,1
39502,5,3,138369,138369,138372,0,3,2
39503,1,1,138370,138372,138373,2,3,0
39504,3,2,138373,138373,138375,0,2,0
39505,4,1,138377,138377,138378,0,1,2
39506,2,2,138379,138379,138381,0,2,1
39507,1,3,138380,138381,138384,1,4,0
39508,2,1,138382,138384,138385,2,3,0
39509,5,1,138387,138387,138388,0,1,2
39510,2,3,138389,138389,138392,0,3,1
39511,4,1,138393,138393,138394,0,1,1
39512,6,1,138399,138399,138400,0,1,5
39513,3,3,138402,138402,138405,0,3,2
39514,5,1,138407,138407,138408,0,1,2
39515,5,2,138412,138412,138414,0,2,4
39516,1,2,138413,138414,138416,1,3,0
39517,6,2,138419,138419,138421,0,2,3
39518,4,2,138423,138423,138425,0,2,2
39519,6,1,138429,138429,138430,0,1,4
39520,1,3,138430,138430,138433,0,3,0
39521,2,3,138432,138433,138436,1,4,0
39522,3,1,138435,138436,138437,1,2,0
39523,4,1,138439,138439,138440,0,1,2
39524,4,2,138443,138443,138445,0,2,3
39525,3,1,138446,138446,138447,0,1,1
39526,4,2,138450,138450,138452,0,2,3
39527,5,3,138455,138455,138458,0,3,3
39528,1,3,138456,138458,138461,2,5,0
39529,4,2,138460,138461,138463,1,3,0
39530,5,2,138465,138465,138467,0,2,2
39531,1,3,138466,138467,138470,1,4,0
39532,4,2,138470,138470,138472,0,2,0
39533,3,2,138473,138473,138475,0,2,1
39534,1,2,138474,138475,138477,1,3,0
39535,5,2,138479,138479,138481,0,2,2
39536,4,1,138483,138483,138484,0,1,2
39537,3,1,138486,138486,138487,0,1,2
39538,4,3,138490,138490,138493,0,3,3
39539,2,2,138492,138493,138495,1,3,0
39540,6,2,138498,138498,138500,0,2,3
39541,3,3,138501,138501,138504,0,3,1
39542,2,2,138503,138504,138506,1,3,0
39543,1,2,138504,138506,138508,2,4,0
39544,2,3,138506,138508,138511,2,5,0
39545,6,1,138512,138512,138513,0,1,1
39546,1,2,138513,138513,138515,0,2,0
39547,3,3,138516,138516,138519,0,3,1
39548,1,2,138517,138519,138521,2,4,0
39549,6,3,138523,138523,138526,0,3,2
39550,5,3,138528,138528,138531,0,3,2
39551,1,3,138529,138531,138534,2,5,0
39552,6,2,138535,138535,138537,0,2,1
39553,5,1,138540,138540,138541,0,1,3
39554,4,2,138544,138544,138546,0,2,3
39555,5,3,138549,138549,138552,0,3,3
39556,5,3,138554,138554,138557,0,3,2
39557,5,1,138559,138559,138560,0,1,2
39558,4,3,138563,138563,138566,0,3,3
39559,6,2,138569,138569,138571,0,2,3
39560,6,3,138575,138575,138578,0,3,4
39561,4,3,138579,138579,138582,0,3,1
39562,5,1,138584,138584,138585,0,1,2
39563,6,3,138590,138590,138593,0,3,5
39564,5,2,138595,138595,138597,0,2,2
39565,5,2,138600,138600,138602,0,2,3
39566,5,3,138605,138605,138608,0,3,3
39567,4,2,138609,138609,138611,0,2,1
39568,5,3,138614,138614,138617,0,3,3
39569,6,1,138620,138620,138621,0,1,3
39570,6,1,138626,138626,138627,0,1,5
39571,3,1,138629,138629,138630,0,1,2
39572,2,3,138631,138631,138634,0,3,1
39573,1,3,138632,138634,138637,2,5,0
39574,6,2,138638,138638,138640,0,2,1
39575,1,3,138639,138640,138643,1,4,0
39576,2,3,138641,138643,138646,2,5,0
39577,5,3,138646,138646,138649,0,3,0
39578,3,1,138649,138649,138650,0,1,0
39579,4,1,138653,138653,138654,0,1,3
39580,6,2,138659,138659,138661,0,2,5
39581,1,2,138660,138661,138663,1,3,0
39582,2,1,138662,138663,138664,1,2,0
39583,1,3,138663,138664,138667,1,4,0
39584,1,1,138664,138667,138668,3,4,0
39585,5,1,138669,138669,138670,0,1,1
39586,4,1,138673,138673,138674,0,1,3
39587,3,2,138676,138676,138678,0,2,2
39588,3,2,138679,138679,138681,0,2,1
39589,6,2,138685,138685,138687,0,2,4
39590,6,3,138691,138691,138694,0,3,4
39591,5,1,138696,138696,138697,0,1,2
39592,6,3,138702,138702,138705,0,3,5
39593,4,1,138706,138706,138707,0,1,1
39594,2,2,138708,138708,138710,0,2,1
39595,6,1,138714,138714,138715,0,1,4
39596,6,1,138720,138720,138721,0,1,5
39597,6,1,138726,138726,138727,0,1,5
39598,1,1,138727,138727,138728,0,1,0
39599,3,2,138730,138730,138732,0,2,2
39600,5,3,138735,138735,138738,0,3,3
39601,6,1,138741,138741,138742,0,1,3
39602,4,2,138745,138745,138747,0,2,3
39603,1,2,138746,138747,138749,1,3,0
39604,1,1,138747,138749,138750,2,3,0
39605,4,3,138751,138751,138754,0,3,1
39606,3,2,138754,138754,138756,0,2,0
39607,2,1,138756,138756,138757,0,1,0
39608,3,2,138759,138759,138761,0,2,2
39609,5,3,138764,138764,138767,0,3,3
39610,1,3,138765,138767,138770,2,5,0
39611,3,1,138768,138770,138771,2,3,0
39612,6,1,138774,138774,138775,0,1,3
39613,5,3,138779,138779,138782,0,3,4
39614,1,1,138780,138782,138783,2,3,0
39615,2,3,138782,138783,138786,1,4,0
39616,5,1,138787,138787,138788,0,1,1
39617,6,2,138793,138793,138795,0,2,5
39618,4,3,138797,138797,138800,0,3,2
39619,2,1,138799,138800,138801,1,2,0
39620,6,3,138805,138805,138808,0,3,4
39621,6,1,138811,138811,138812,0,1,3
39622,5,2,138816,138816,138818,0,2,4
39623,6,1,138822,138822,138823,0,1,4
39624,3,2,138825,138825,138827,0,2,2
39625,6,1,138831,138831,138832,0,1,4
39626,4,1,138835,138835,138836,0,1,3
39627,6,1,138841,138841,138842,0,1,5
39628,5,3,138846,138846,138849,0,3,4
39629,2,1,138848,138849,138850,1,2,0
39630,1,3,138849,138850,138853,1,4,0
39631,5,1,138854,138854,138855,0,1,1
39632,5,2,138859,138859,138861,0,2,4
39633,4,3,138863,138863,138866,0,3,2
39634,3,2,138866,138866,138868,0,2,0
39635,1,3,138867,138868,138871,1,4,0
39636,3,1,138870,138871,138872,1,2,0
39637,5,2,138875,138875,138877,0,2,3
39638,3,2,138878,138878,138880,0,2,1
39639,5,3,138883,138883,138886,0,3,3
39640,4,2,138887,138887,138889,0,2,1
39641,3,2,138890,138890,138892,0,2,1
39642,4,3,138894,138894,138897,0,3,2
39643,1,2,138895,138897,138899,2,4,0
39644,3,3,138898,138899,138902,1,4,0
39645,6,1,138904,138904,138905,0,1,2
39646,6,3,138910,138910,138913,0,3,5
39647,6,3,138916,138916,138919,0,3,3
39648,6,3,138922,138922,138925,0,3,3
39649,2,3,138924,138925,138928,1,4,0
39650,5,1,138929,138929,138930,0,1,1
39651,6,3,138935,138935,138938,0,3,5
39652,6,3,138941,138941,138944,0,3,3
39653,1,2,138942,138944,138946,2,4,0
39654,4,3,138946,138946,138949,0,3,0
39655,4,2,138950,138950,138952,0,2,1
39656,5,1,138955,138955,138956,0,1,3
39657,1,2,138956,138956,138958,0,2,0
39658,2,1,138958,138958,138959,0,1,0
39659,4,1,138962,138962,138963,0,1,3
39660,3,3,138965,138965,138968,0,3,2
39661,3,2,138968,138968,138970,0,2,0
39662,1,1,138969,138970,138971,1,2,0
39663,6,3,138975,138975,138978,0,3,4
39664,6,3,138981,138981,138984,0,3,3
39665,5,1,138986,138986,138987,0,1,2
39666,2,2,138988,138988,138990,0,2,1
39667,3,2,138991,138991,138993,0,2,1
39668,4,3,138995,138995,138998,0,3,2
39669,4,2,138999,138999,139001,0,2,1
39670,5,3,139004,139004,139007,0,3,3
39671,1,1,139005,139007,139008,2,3,0
39672,1,2,139006,139008,139010,2,4,0
39673,2,1,139008,139010,139011,2,3,0
39674,5,3,139013,139013,139016,0,3,2
39675,2,2,139015,139016,139018,1,3,0
39676,1,1,139016,139018,139019,2,3,0
39677,4,3,139020,139020,139023,0,3,1
39678,5,3,139025,139025,139028,0,3,2
39679,3,1,139028,139028,139029,0,1,0
39680,2,2,139030,139030,139032,0,2,1
39681,1,2,139031,139032,139034,1,3,0
39682,3,2,139034,139034,139036,0,2,0
39683,3,1,139037,139037,139038,0,1,1
39684,5,2,139042,139042,139044,0,2,4
39685,2,2,139044,139044,139046,0,2,0
39686,4,1,139048,139048,139049,0,1,2
39687,4,1,139052,139052,139053,0,1,3
39688,5,3,139057,139057,139060,0,3,4
39689,5,1,139062,139062,139063,0,1,2
39690,4,3,139066,139066,139069,0,3,3
39691,3,2,139069,139069,139071,0,2,0
39692,3,1,139072,139072,139073,0,1,1
39693,6,1,139078,139078,139079,0,1,5
39694,6,3,139084,139084,139087,0,3,5
39695,2,3,139086,139087,139090,1,4,0
39696,5,2,139091,139091,139093,0,2,1
39697,3,1,139094,139094,139095,0,1,1
39698,1,1,139095,139095,139096,0,1,0
39699,2,2,139097,139097,139099,0,2,1
39700,2,2,139099,139099,139101,0,2,0
39701,3,3,139102,139102,139105,0,3,1
39702,1,1,139103,139105,139106,2,3,0
39703,2,1,139105,139106,139107,1,2,0
39704,5,2,139110,139110,139112,0,2,3
39705,4,3,139114,139114,139117,0,3,2
39706,3,1,139117,139117,139118,0,1,0
39707,4,2,139121,139121,139123,0,2,3
39708,3,1,139124,139124,139125,0,1,1
39709,3,3,139127,139127,139130,0,3,2
39710,4,1,139131,139131,139132,0,1,1
39711,2,3,139133,139133,139136,0,3,1
39712,3,2,139136,139136,139138,0,2,0
39713,3,1,139139,139139,139140,0,1,1
39714,5,3,139144,139144,139147,0,3,4
39715,2,2,139146,139147,139149,1,3,0
39716,2,1,139148,139149,139150,1,2,0
39717,2,1,139150,139150,139151,0,1,0
39718,1,1,139151,139151,139152,0,1,0
39719,2,2,139153,139153,139155,0,2,1
39720,5,2,139158,139158,139160,0,2,3
39721,1,3,139159,139160,139163,1,4,0
39722,1,3,139160,139163,139166,3,6,0
39723,4,1,139164,139166,139167,2,3,0
39724,5,2,139169,139169,139171,0,2,2
39725,3,2,139172,139172,139174,0,2,1
39726,1,1,139173,139174,139175,1,2,0
39727,3,2,139176,139176,139178,0,2,1
39728,3,2,139179,139179,139181,0,2,1
39729,4,1,139183,139183,139184,0,1,2
39730,1,1,139184,139184,139185,0,1,0
39731,5,3,139189,139189,139192,0,3,4
39732,2,2,139191,139192,139194,1,3,0
39733,2,3,139193,139194,139197,1,4,0
39734,1,3,139194,139197,139200,3,6,0
39735,5,2,139199,139200,139202,1,3,0
39736,2,3,139201,139202,139205,1,4,0
39737,5,1,139206,139206,139207,0,1,1
39738,4,3,139210,139210,139213,0,3,3
39739,2,2,139212,139213,139215,1,3,0
39740,6,2,139218,139218,139220,0,2,3
39741,4,2,139222,139222,139224,0,2,2
39742,5,1,139227,139227,139228,0,1,3
39743,5,2,139232,139232,139234,0,2,4
39744,4,1,139236,139236,139237,0,1,2
39745,5,1,139241,139241,139242,0,1,4
39746,3,3,139244,139244,139247,0,3,2
39747,4,1,139248,139248,139249,0,1,1
39748,3,1,139251,139251,139252,0,1,2
39749,2,2,139253,139253,139255,0,2,1
39750,4,3,139257,139257,139260,0,3,2
39751,5,1,139262,139262,139263,0,1,2
39752,1,3,139263,139263,139266,0,3,0
39753,5,3,139268,139268,139271,0,3,2
39754,2,2,139270,139271,139273,1,3,0
39755,6,3,139276,139276,139279,0,3,3
39756,4,1,139280,139280,139281,0,1,1
39757,3,2,139283,139283,139285,0,2,2
39758,1,2,139284,139285,139287,1,3,0
39759,6,1,139290,139290,139291,0,1,3
39760,3,1,139293,139293,139294,0,1,2
39761,5,2,139298,139298,139300,0,2,4
39762,5,3,139303,139303,139306,0,3,3
39763,4,2,139307,139307,139309,0,2,1
39764,5,3,139312,139312,139315,0,3,3
39765,1,3,139313,139315,139318,2,5,0
39766,2,3,139315,139318,139321,3,6,0
39767,4,2,139319,139321,139323,2,4,0
39768,4,1,139323,139323,139324,0,1,0
39769,2,2,139325,139325,139327,0,2,1
39770,1,3,139326,139327,139330,1,4,0
39771,6,1,139332,139332,139333,0,1,2
39772,2,2,139334,139334,139336,0,2,1
39773,4,1,139338,139338,139339,0,1,2
39774,4,3,139342,139342,139345,0,3,3
39775,6,3,139348,139348,139351,0,3,3
39776,6,3,139354,139354,139357,0,3,3
39777,2,3,139356,139357,139360,1,4,0
39778,6,1,139362,139362,139363,0,1,2
39779,3,1,139365,139365,139366,0,1,2
39780,1,2,139366,139366,139368,0,2,0
39781,2,1,139368,139368,139369,0,1,0
39782,4,2,139372,139372,139374,0,2,3
39783,1,1,139373,139374,139375,1,2,0
39784,4,3,139377,139377,139380,0,3,2
39785,1,1,139378,139380,139381,2,3,0
39786,6,1,139384,139384,139385,0,1,3
39787,2,3,139386,139386,139389,0,3,1
39788,5,3,139391,139391,139394,0,3,2
39789,3,1,139394,139394,139395,0,1,0
39790,6,1,139400,139400,139401,0,1,5
39791,4,1,139404,139404,139405,0,1,3
39792,3,3,139407,139407,139410,0,3,2
39793,4,2,139411,139411,139413,0,2,1
39794,6,1,139417,139417,139418,0,1,4
39795,1,3,139418,139418,139421,0,3,0
39796,2,2,139420,139421,139423,1,3,0
39797,5,2,139425,139425,139427,0,2,2
39798,3,3,139428,139428,139431,0,3,1
39799,6,2,139434,139434,139436,0,2,3
39800,5,1,139439,139439,139440,0,1,3
39801,2,2,139441,139441,139443,0,2,1
39802,3,3,139444,139444,139447,0,3,1
39803,6,3,139450,139450,139453,0,3,3
39804,4,2,139454,139454,139456,0,2,1
39805,2,3,139456,139456,139459,0,3,0
39806,4,2,139460,139460,139462,0,2,1
39807,1,2,139461,139462,139464,1,3,0
39808,4,1,139465,139465,139466,0,1,1
39809,5,3,139470,139470,139473,0,3,4
39810,5,3,139475,139475,139478,0,3,2
39811,2,2,139477,139478,139480,1,3,0
39812,2,3,139479,139480,139483,1,4,0
39813,4,1,139483,139483,139484,0,1,0
39814,2,1,139485,139485,139486,0,1,1
39815,3,2,139488,139488,139490,0,2,2
39816,3,1,139491,139491,139492,0,1,1
39817,5,1,139496,139496,139497,0,1,4
39818,6,2,139502,139502,139504,0,2,5
39819,3,3,139505,139505,139508,0,3,1
39820,2,1,139507,139508,139509,1,2,0
39821,1,1,139508,139509,139510,1,2,0
39822,1,1,139509,139510,139511,1,2,0
39823,5,2,139514,139514,139516,0,2,3
39824,6,3,139520,139520,139523,0,3,4
39825,4,2,139524,139524,139526,0,2,1
39826,6,3,139530,139530,139533,0,3,4
39827,3,1,139533,139533,139534,0,1,0
39828,5,2,139538,139538,139540,0,2,4
39829,1,1,139539,139540,139541,1,2,0
39830,5,3,139544,139544,139547,0,3,3
39831,3,2,139547,139547,139549,0,2,0
39832,1,3,139548,139549,139552,1,4,0
39833,4,1,139552,139552,139553,0,1,0
39834,1,1,139553,139553,139554,0,1,0
39835,5,1,139558,139558,139559,0,1,4
39836,4,3,139562,139562,139565,0,3,3
39837,3,2,139565,139565,139567,0,2,0
39838,3,3,139568,139568,139571,0,3,1
39839,1,3,139569,139571,139574,2,5,0
39840,2,3,139571,139574,139577,3,6,0
39841,6,1,139577,139577,139578,0,1,0
39842,2,1,139579,139579,139580,0,1,1
39843,2,3,139581,139581,139584,0,3,1
39844,4,2,139585,139585,139587,0,2,1
39845,4,3,139589,139589,139592,0,3,2
39846,2,2,139591,139592,139594,1,3,0
39847,3,3,139594,139594,139597,0,3,0
39848,2,1,139596,139597,139598,1,2,0
39849,5,3,139601,139601,139604,0,3,3
39850,1,1,139602,139604,139605,2,3,0
39851,2,3,139604,139605,139608,1,4,0
39852,1,2,139605,139608,139610,3,5,0
39853,5,2,139610,139610,139612,0,2,0
39854,4,1,139614,139614,139615,0,1,2
39855,4,1,139618,139618,139619,0,1,3
39856,3,1,139621,139621,139622,0,1,2
39857,4,1,139625,139625,139626,0,1,3
39858,5,2,139630,139630,139632,0,2,4
39859,4,3,139634,139634,139637,0,3,2
39860,4,2,139638,139638,139640,0,2,1
39861,4,3,139642,139642,139645,0,3,2
39862,2,2,139644,139645,139647,1,3,0
39863,3,1,139647,139647,139648,0,1,0
39864,3,2,139650,139650,139652,0,2,2
39865,2,1,139652,139652,139653,0,1,0
39866,4,3,139656,139656,139659,0,3,3
39867,2,3,139658,139659,139662,1,4,0
39868,1,3,139659,139662,139665,3,6,0
39869,5,3,139664,139665,139668,1,4,0
39870,3,3,139667,139668,139671,1,4,0
39871,2,3,139669,139671,139674,2,5,0
39872,3,2,139672,139674,139676,2,4,0
39873,1,3,139673,139676,139679,3,6,0
39874,1,3,139674,139679,139682,5,8,0
39875,3,2,139677,139682,139684,5,7,0
39876,4,1,139681,139684,139685,3,4,0
39877,6,2,139687,139687,139689,0,2,2
39878,1,1,139688,139689,139690,1,2,0
39879,3,3,139691,139691,139694,0,3,1
39880,5,3,139696,139696,139699,0,3,2
39881,6,2,139702,139702,139704,0,2,3
39882,3,3,139705,139705,139708,0,3,1
39883,1,1,139706,139708,139709,2,3,0
39884,1,1,139707,139709,139710,2,3,0
39885,2,2,139709,139710,139712,1,3,0
39886,5,1,139714,139714,139715,0,1,2
39887,5,1,139719,139719,139720,0,1,4
39888,6,3,139725,139725,139728,0,3,5
39889,4,3,139729,139729,139732,0,3,1
39890,6,1,139735,139735,139736,0,1,3
39891,4,3,139739,139739,139742,0,3,3
39892,2,3,139741,139742,139745,1,4,0
39893,6,2,139747,139747,139749,0,2,2
39894,2,2,139749,139749,139751,0,2,0
39895,2,2,139751,139751,139753,0,2,0
39896,1,1,139752,139753,139754,1,2,0
39897,4,2,139756,139756,139758,0,2,2
39898,1,3,139757,139758,139761,1,4,0
39899,5,3,139762,139762,139765,0,3,1
39900,4,3,139766,139766,139769,0,3,1
39901,5,2,139771,139771,139773,0,2,2
39902,4,1,139775,139775,139776,0,1,2
39903,4,1,139779,139779,139780,0,1,3
39904,2,1,139781,139781,139782,0,1,1
39905,4,3,139785,139785,139788,0,3,3
39906,6,2,139791,139791,139793,0,2,3
39907,4,1,139795,139795,139796,0,1,2
39908,6,3,139801,139801,139804,0,3,5
39909,1,1,139802,139804,139805,2,3,0
39910,1,2,139803,139805,139807,2,4,0
39911,2,3,139805,139807,139810,2,5,0
39912,6,3,139811,139811,139814,0,3,1
39913,4,3,139815,139815,139818,0,3,1
39914,1,2,139816,139818,139820,2,4,0
39915,4,3,139820,139820,139823,0,3,0
39916,4,2,139824,139824,139826,0,2,1
39917,6,3,139830,139830,139833,0,3,4
39918,6,3,139836,139836,139839,0,3,3
39919,6,2,139842,139842,139844,0,2,3
39920,6,1,139848,139848,139849,0,1,4
39921,5,3,139853,139853,139856,0,3,4
39922,2,3,139855,139856,139859,1,4,0
39923,2,3,139857,139859,139862,2,5,0
39924,3,2,139860,139862,139864,2,4,0
39925,1,3,139861,139864,139867,3,6,0
39926,5,2,139866,139867,139869,1,3,0
39927,6,1,139872,139872,139873,0,1,3
39928,2,2,139874,139874,139876,0,2,1
39929,1,2,139875,139876,139878,1,3,0
39930,3,2,139878,139878,139880,0,2,0
39931,4,1,139882,139882,139883,0,1,2
39932,5,3,139887,139887,139890,0,3,4
39933,5,2,139892,139892,139894,0,2,2
39934,5,2,139897,139897,139899,0,2,3
39935,6,1,139903,139903,139904,0,1,4
39936,3,1,139906,139906,139907,0,1,2
39937,1,2,139907,139907,139909,0,2,0
39938,1,1,139908,139909,139910,1,2,0
39939,3,1,139911,139911,139912,0,1,1
39940,5,2,139916,139916,139918,0,2,4
39941,2,3,139918,139918,139921,0,3,0
39942,1,2,139919,139921,139923,2,4,0
39943,2,3,139921,139923,139926,2,5,0
39944,5,1,139926,139926,139927,0,1,0
39945,2,2,139928,139928,139930,0,2,1
39946,4,1,139932,139932,139933,0,1,2
39947,2,3,139934,139934,139937,0,3,1
39948,5,3,139939,139939,139942,0,3,2
39949,3,3,139942,139942,139945,0,3,0
39950,1,2,139943,139945,139947,2,4,0
39951,6,3,139949,139949,139952,0,3,2
39952,3,2,139952,139952,139954,0,2,0
39953,5,1,139957,139957,139958,0,1,3
39954,3,2,139960,139960,139962,0,2,2
39955,2,2,139962,139962,139964,0,2,0
39956,5,2,139967,139967,139969,0,2,3
39957,4,3,139971,139971,139974,0,3,2
39958,5,1,139976,139976,139977,0,1,2
39959,2,3,139978,139978,139981,0,3,1
39960,3,3,139981,139981,139984,0,3,0
39961,2,2,139983,139984,139986,1,3,0
39962,2,3,139985,139986,139989,1,4,0
39963,2,1,139987,139989,139990,2,3,0
39964,4,1,139991,139991,139992,0,1,1
39965,2,1,139993,139993,139994,0,1,1
39966,1,2,139994,139994,139996,0,2,0
39967,6,1,140000,140000,140001,0,1,4
39968,4,1,140004,140004,140005,0,1,3
39969,3,3,140007,140007,140010,0,3,2
39970,5,3,140012,140012,140015,0,3,2
39971,5,3,140017,140017,140020,0,3,2
39972,4,1,140021,140021,140022,0,1,1
39973,1,2,140022,140022,140024,0,2,0
39974,2,3,140024,140024,140027,0,3,0
39975,1,2,140025,140027,140029,2,4,0
39976,2,3,140027,140029,140032,2,5,0
39977,1,2,140028,140032,140034,4,6,0
39978,2,3,140030,140034,140037,4,7,0
39979,2,3,140032,140037,140040,5,8,0
39980,1,3,140033,140040,140043,7,10,0
39981,1,2,140034,140043,140045,9,11,0
39982,4,3,140038,140045,140048,7,10,0
39983,3,3,140041,140048,140051,7,10,0
39984,3,1,140044,140051,140052,7,8,0
39985,6,1,140050,140052,140053,2,3,0
39986,5,2,140055,140055,140057,0,2,2
39987,1,1,140056,140057,140058,1,2,0
39988,5,2,140061,140061,140063,0,2,3
39989,4,1,140065,140065,140066,0,1,2
39990,1,1,140066,140066,140067,0,1,0
39991,1,2,140067,140067,140069,0,2,0
39992,5,1,140072,140072,140073,0,1,3
39993,2,2,140074,140074,140076,0,2,1
39994,3,2,140077,140077,140079,0,2,1
39995,1,1,140078,140079,140080,1,2,0
39996,6,2,140084,140084,140086,0,2,4
39997,4,2,140088,140088,140090,0,2,2
39998,2,2,140090,140090,140092,0,2,0
39999,1,3,140091,140092,140095,1,4,0
40000,1,1,140092,140095,140096,3,4,0
40001,2,3,140094,140096,140099,2,5,0
40002,4,3,140098,140099,140102,1,4,0
40003,6,3,140104,140104,140107,0,3,2
40004,6,2,140110,140110,140112,0,2,3
40005,5,1,140115,140115,140116,0,1,3
40006,3,1,140118,140118,140119,0,1,2
40007,1,3,140119,140119,140122,0,3,0
40008,3,1,140122,140122,140123,0,1,0
40009,5,1,140127,140127,140128,0,1,4
40010,1,1,140128,140128,140129,0,1,0
40011,4,1,140132,140132,140133,0,1,3
40012,6,2,140138,140138,140140,0,2,5
40013,4,1,140142,140142,140143,0,1,2
40014,2,3,140144,140144,140147,0,3,1
40015,1,3,140145,140147,140150,2,5,0
40016,2,1,140147,140150,140151,3,4,0
40017,1,3,140148,140151,140154,3,6,0
40018,2,1,140150,140154,140155,4,5,0
40019,1,1,140151,140155,140156,4,5,0
40020,3,1,140154,140156,140157,2,3,0
40021,2,2,140156,140157,140159,1,3,0
40022,1,2,140157,140159,140161,2,4,0
40023,2,1,140159,140161,140162,2,3,0
40024,1,3,140160,140162,140165,2,5,0
40025,6,2,140166,140166,140168,0,2,1
40026,1,1,140167,140168,140169,1,2,0
40027,3,1,140170,140170,140171,0,1,1
40028,1,3,140171,140171,140174,0,3,0
40029,3,1,140174,140174,140175,0,1,0
40030,6,3,140180,140180,140183,0,3,5
40031,6,3,140186,140186,140189,0,3,3
40032,3,2,140189,140189,140191,0,2,0
40033,4,2,140193,140193,140195,0,2,2
40034,2,3,140195,140195,140198,0,3,0
40035,1,3,140196,140198,140201,2,5,0
40036,2,2,140198,140201,140203,3,5,0
40037,2,3,140200,140203,140206,3,6,0
40038,3,2,140203,140206,140208,3,5,0
40039,1,2,140204,140208,140210,4,6,0
40040,5,3,140209,140210,140213,1,4,0
40041,4,1,140213,140213,140214,0,1,0
40042,3,3,140216,140216,140219,0,3,2
40043,4,2,140220,140220,140222,0,2,1
40044,3,1,140223,140223,140224,0,1,1
40045,5,2,140228,140228,140230,0,2,4
40046,3,2,140231,140231,140233,0,2,1
40047,3,3,140234,140234,140237,0,3,1
40048,3,1,140237,140237,140238,0,1,0
40049,4,2,140241,140241,140243,0,2,3
40050,3,3,140244,140244,140247,0,3,1
40051,3,2,140247,140247,140249,0,2,0
40052,5,3,140252,140252,140255,0,3,3
40053,2,1,140254,140255,140256,1,2,0
40054,2,1,140256,140256,140257,0,1,0
40055,6,2,140262,140262,140264,0,2,5
40056,2,3,140264,140264,140267,0,3,0
40057,5,3,140269,140269,140272,0,3,2
40058,6,1,140275,140275,140276,0,1,3
40059,6,1,140281,140281,140282,0,1,5
40060,5,1,140286,140286,140287,0,1,4
40061,5,1,140291,140291,140292,0,1,4
40062,6,3,140297,140297,140300,0,3,5
40063,2,1,140299,140300,140301,1,2,0
40064,6,2,140305,140305,140307,0,2,4
40065,4,1,140309,140309,140310,0,1,2
40066,2,2,140311,140311,140313,0,2,1
40067,6,2,140317,140317,140319,0,2,4
40068,3,3,140320,140320,140323,0,3,1
40069,1,2,140321,140323,140325,2,4,0
40070,5,2,140326,140326,140328,0,2,1
40071,4,1,140330,140330,140331,0,1,2
40072,3,1,140333,140333,140334,0,1,2
40073,1,2,140334,140334,140336,0,2,0
40074,6,1,140340,140340,140341,0,1,4
40075,5,2,140345,140345,140347,0,2,4
40076,4,2,140349,140349,140351,0,2,2
40077,6,1,140355,140355,140356,0,1,4
40078,1,1,140356,140356,140357,0,1,0
40079,3,1,140359,140359,140360,0,1,2
40080,1,3,140360,140360,140363,0,3,0
40081,5,2,140365,140365,140367,0,2,2
40082,4,1,140369,140369,140370,0,1,2
40083,5,3,140374,140374,140377,0,3,4
40084,1,3,140375,140377,140380,2,5,0
40085,5,2,140380,140380,140382,0,2,0
40086,1,3,140381,140382,140385,1,4,0
40087,3,2,140384,140385,140387,1,3,0
40088,1,3,140385,140387,140390,2,5,0
40089,1,2,140386,140390,140392,4,6,0
40090,3,1,140389,140392,140393,3,4,0
40091,3,1,140392,140393,140394,1,2,0
40092,6,1,140398,140398,140399,0,1,4
40093,6,1,140404,140404,140405,0,1,5
40094,4,3,140408,140408,140411,0,3,3
40095,4,3,140412,140412,140415,0,3,1
40096,5,1,140417,140417,140418,0,1,2
40097,4,1,140421,140421,140422,0,1,3
40098,6,2,140427,140427,140429,0,2,5
40099,6,3,140433,140433,140436,0,3,4
40100,5,3,140438,140438,140441,0,3,2
40101,6,2,140444,140444,140446,0,2,3
40102,5,2,140449,140449,140451,0,2,3
40103,3,3,140452,140452,140455,0,3,1
40104,4,2,140456,140456,140458,0,2,1
40105,1,3,140457,140458,140461,1,4,0
40106,3,2,140460,140461,140463,1,3,0
40107,1,3,140461,140463,140466,2,5,0
40108,3,2,140464,140466,140468,2,4,0
40109,4,1,140468,140468,140469,0,1,0
40110,1,2,140469,140469,140471,0,2,0
40111,1,2,140470,140471,140473,1,3,0
40112,1,2,140471,140473,140475,2,4,0
40113,4,2,140475,140475,140477,0,2,0
40114,2,1,140477,140477,140478,0,1,0
40115,4,2,140481,140481,140483,0,2,3
40116,3,2,140484,140484,140486,0,2,1
40117,3,3,140487,140487,140490,0,3,1
40118,1,1,140488,140490,140491,2,3,0
40119,5,1,140493,140493,140494,0,1,2
40120,1,1,140494,140494,140495,0,1,0
40121,2,1,140496,140496,140497,0,1,1
40122,5,3,140501,140501,140504,0,3,4
40123,1,2,140502,140504,140506,2,4,0
40124,5,1,140507,140507,140508,0,1,1
40125,4,2,140511,140511,140513,0,2,3
40126,4,2,140515,140515,140517,0,2,2
40127,4,1,140519,140519,140520,0,1,2
40128,6,3,140525,140525,140528,0,3,5
40129,1,1,140526,140528,140529,2,3,0
40130,3,2,140529,140529,140531,0,2,0
40131,2,1,140531,140531,140532,0,1,0
40132,1,3,140532,140532,140535,0,3,0
40133,6,1,140538,140538,140539,0,1,3
40134,6,3,140544,140544,140547,0,3,5
40135,5,2,140549,140549,140551,0,2,2
40136,3,3,140552,140552,140555,0,3,1
40137,3,3,140555,140555,140558,0,3,0
40138,4,3,140559,140559,140562,0,3,1
40139,3,1,140562,140562,140563,0,1,0
40140,3,3,140565,140565,140568,0,3,2
40141,4,1,140569,140569,140570,0,1,1
40142,4,2,140573,140573,140575,0,2,3
40143,2,2,140575,140575,140577,0,2,0
40144,6,1,140581,140581,140582,0,1,4
40145,5,2,140586,140586,140588,0,2,4
40146,3,3,140589,140589,140592,0,3,1
40147,5,3,140594,140594,140597,0,3,2
40148,3,1,140597,140597,140598,0,1,0
40149,6,3,140603,140603,140606,0,3,5
40150,2,2,140605,140606,140608,1,3,0
40151,2,1,140607,140608,140609,1,2,0
40152,2,1,140609,140609,140610,0,1,0
40153,2,1,140611,140611,140612,0,1,1
40154,2,1,140613,140613,140614,0,1,1
40155,4,2,140617,140617,140619,0,2,3
40156,4,2,140621,140621,140623,0,2,2
40157,1,1,140622,140623,140624,1,2,0
40158,2,3,140624,140624,140627,0,3,0
40159,5,2,140629,140629,140631,0,2,2
40160,2,1,140631,140631,140632,0,1,0
40161,6,3,140637,140637,140640,0,3,5
40162,2,2,140639,140640,140642,1,3,0
40163,5,2,140644,140644,140646,0,2,2
40164,1,2,140645,140646,140648,1,3,0
40165,4,3,140649,140649,140652,0,3,1
40166,2,2,140651,140652,140654,1,3,0
40167,3,1,140654,140654,140655,0,1,0
40168,2,3,140656,140656,140659,0,3,1
40169,5,3,140661,140661,140664,0,3,2
40170,1,2,140662,140664,140666,2,4,0
40171,5,2,140667,140667,140669,0,2,1
40172,2,1,140669,140669,140670,0,1,0
40173,4,3,140673,140673,140676,0,3,3
40174,5,2,140678,140678,140680,0,2,2
40175,4,3,140682,140682,140685,0,3,2
40176,5,3,140687,140687,140690,0,3,2
40177,6,2,140693,140693,140695,0,2,3
40178,4,2,140697,140697,140699,0,2,2
40179,6,1,140703,140703,140704,0,1,4
40180,4,3,140707,140707,140710,0,3,3
40181,4,1,140711,140711,140712,0,1,1
40182,1,2,140712,140712,140714,0,2,0
40183,3,1,140715,140715,140716,0,1,1
40184,3,3,140718,140718,140721,0,3,2
40185,3,3,140721,140721,140724,0,3,0
40186,5,1,140726,140726,140727,0,1,2
40187,3,1,140729,140729,140730,0,1,2
40188,4,1,140733,140733,140734,0,1,3
40189,2,1,140735,140735,140736,0,1,1
40190,4,2,140739,140739,140741,0,2,3
40191,1,3,140740,140741,140744,1,4,0
40192,1,3,140741,140744,140747,3,6,0
40193,2,2,140743,140747,140749,4,6,0
40194,4,1,140747,140749,140750,2,3,0
40195,1,3,140748,140750,140753,2,5,0
40196,5,2,140753,140753,140755,0,2,0
40197,3,2,140756,140756,140758,0,2,1
40198,3,2,140759,140759,140761,0,2,1
40199,6,3,140765,140765,140768,0,3,4
40200,6,1,140771,140771,140772,0,1,3
40201,4,2,140775,140775,140777,0,2,3
40202,5,2,140780,140780,140782,0,2,3
40203,1,3,140781,140782,140785,1,4,0
40204,3,1,140784,140785,140786,1,2,0
40205,6,2,140790,140790,140792,0,2,4
40206,1,3,140791,140792,140795,1,4,0
40207,4,3,140795,140795,140798,0,3,0
40208,4,3,140799,140799,140802,0,3,1
40209,6,3,140805,140805,140808,0,3,3
40210,5,2,140810,140810,140812,0,2,2
40211,3,2,140813,140813,140815,0,2,1
40212,1,2,140814,140815,140817,1,3,0
40213,6,3,140820,140820,140823,0,3,3
40214,3,3,140823,140823,140826,0,3,0
40215,5,2,140828,140828,140830,0,2,2
40216,1,3,140829,140830,140833,1,4,0
40217,2,3,140831,140833,140836,2,5,0
40218,2,3,140833,140836,140839,3,6,0
40219,2,3,140835,140839,140842,4,7,0
40220,2,3,140837,140842,140845,5,8,0
40221,5,2,140842,140845,140847,3,5,0
40222,4,3,140846,140847,140850,1,4,0
40223,6,2,140852,140852,140854,0,2,2
40224,1,1,140853,140854,140855,1,2,0
40225,3,3,140856,140856,140859,0,3,1
40226,5,2,140861,140861,140863,0,2,2
40227,5,2,140866,140866,140868,0,2,3
40228,3,1,140869,140869,140870,0,1,1
40229,5,3,140874,140874,140877,0,3,4
40230,6,1,140880,140880,140881,0,1,3
40231,2,3,140882,140882,140885,0,3,1
40232,1,2,140883,140885,140887,2,4,0
40233,5,1,140888,140888,140889,0,1,1
40234,2,2,140890,140890,140892,0,2,1
40235,2,2,140892,140892,140894,0,2,0
40236,3,3,140895,140895,140898,0,3,1
40237,1,3,140896,140898,140901,2,5,0
40238,3,1,140899,140901,140902,2,3,0
40239,3,3,140902,140902,140905,0,3,0
40240,3,1,140905,140905,140906,0,1,0
40241,4,3,140909,140909,140912,0,3,3
40242,3,2,140912,140912,140914,0,2,0
40243,5,1,140917,140917,140918,0,1,3
40244,2,2,140919,140919,140921,0,2,1
40245,1,3,140920,140921,140924,1,4,0
40246,3,2,140923,140924,140926,1,3,0
40247,3,3,140926,140926,140929,0,3,0
40248,5,2,140931,140931,140933,0,2,2
40249,4,1,140935,140935,140936,0,1,2
40250,5,1,140940,140940,140941,0,1,4
40251,2,3,140942,140942,140945,0,3,1
40252,1,2,140943,140945,140947,2,4,0
40253,6,1,140949,140949,140950,0,1,2
40254,2,1,140951,140951,140952,0,1,1
40255,2,3,140953,140953,140956,0,3,1
40256,4,3,140957,140957,140960,0,3,1
40257,4,1,140961,140961,140962,0,1,1
40258,6,1,140967,140967,140968,0,1,5
40259,6,2,140973,140973,140975,0,2,5
40260,2,1,140975,140975,140976,0,1,0
40261,4,2,140979,140979,140981,0,2,3
40262,1,1,140980,140981,140982,1,2,0
40263,5,2,140985,140985,140987,0,2,3
40264,6,2,140991,140991,140993,0,2,4
40265,4,2,140995,140995,140997,0,2,2
40266,4,3,140999,140999,141002,0,3,2
40267,2,2,141001,141002,141004,1,3,0
40268,6,2,141007,141007,141009,0,2,3
40269,3,3,141010,141010,141013,0,3,1
40270,4,2,141014,141014,141016,0,2,1
40271,4,1,141018,141018,141019,0,1,2
40272,1,3,141019,141019,141022,0,3,0
40273,4,3,141023,141023,141026,0,3,1
40274,6,3,141029,141029,141032,0,3,3
40275,3,1,141032,141032,141033,0,1,0
40276,6,1,141038,141038,141039,0,1,5
40277,2,3,141040,141040,141043,0,3,1
40278,4,2,141044,141044,141046,0,2,1
40279,3,2,141047,141047,141049,0,2,1
40280,2,2,141049,141049,141051,0,2,0
40281,2,1,141051,141051,141052,0,1,0
40282,1,1,141052,141052,141053,0,1,0
40283,4,1,141056,141056,141057,0,1,3
40284,4,3,141060,141060,141063,0,3,3
40285,1,3,141061,141063,141066,2,5,0
40286,3,2,141064,141066,141068,2,4,0
40287,4,1,141068,141068,141069,0,1,0
40288,4,2,141072,141072,141074,0,2,3
40289,5,1,141077,141077,141078,0,1,3
40290,5,3,141082,141082,141085,0,3,4
40291,6,3,141088,141088,141091,0,3,3
40292,2,1,141090,141091,141092,1,2,0
40293,5,3,141095,141095,141098,0,3,3
40294,5,1,141100,141100,141101,0,1,2
40295,4,3,141104,141104,141107,0,3,3
40296,3,1,141107,141107,141108,0,1,0
40297,5,1,141112,141112,141113,0,1,4
40298,5,2,141117,141117,141119,0,2,4
40299,3,3,141120,141120,141123,0,3,1
40300,1,2,141121,141123,141125,2,4,0
40301,6,2,141127,141127,141129,0,2,2
40302,2,2,141129,141129,141131,0,2,0
40303,3,3,141132,141132,141135,0,3,1
40304,3,3,141135,141135,141138,0,3,0
40305,1,2,141136,141138,141140,2,4,0
40306,6,2,141142,141142,141144,0,2,2
40307,6,2,141148,141148,141150,0,2,4
40308,4,2,141152,141152,141154,0,2,2
40309,4,2,141156,141156,141158,0,2,2
40310,2,2,141158,141158,141160,0,2,0
40311,1,2,141159,141160,141162,1,3,0
40312,5,3,141164,141164,141167,0,3,2
40313,3,2,141167,141167,141169,0,2,0
40314,3,2,141170,141170,141172,0,2,1
40315,4,1,141174,141174,141175,0,1,2
40316,6,3,141180,141180,141183,0,3,5
40317,4,2,141184,141184,141186,0,2,1
40318,5,1,141189,141189,141190,0,1,3
40319,6,3,141195,141195,141198,0,3,5
40320,4,3,141199,141199,141202,0,3,1
40321,1,3,141200,141202,141205,2,5,0
40322,6,1,141206,141206,141207,0,1,1
40323,2,1,141208,141208,141209,0,1,1
40324,1,2,141209,141209,141211,0,2,0
40325,1,1,141210,141211,141212,1,2,0
40326,4,3,141214,141214,141217,0,3,2
40327,2,3,141216,141217,141220,1,4,0
40328,6,2,141222,141222,141224,0,2,2
40329,1,3,141223,141224,141227,1,4,0
40330,4,3,141227,141227,141230,0,3,0
40331,2,1,141229,141230,141231,1,2,0
40332,3,3,141232,141232,141235,0,3,1
40333,2,2,141234,141235,141237,1,3,0
40334,3,3,141237,141237,141240,0,3,0
40335,3,3,141240,141240,141243,0,3,0
40336,4,2,141244,141244,141246,0,2,1
40337,6,1,141250,141250,141251,0,1,4
40338,3,1,141253,141253,141254,0,1,2
40339,3,1,141256,141256,141257,0,1,2
40340,5,2,141261,141261,141263,0,2,4
40341,3,3,141264,141264,141267,0,3,1
40342,3,3,141267,141267,141270,0,3,0
40343,4,2,141271,141271,141273,0,2,1
40344,5,2,141276,141276,141278,0,2,3
40345,4,3,141280,141280,141283,0,3,2
40346,4,2,141284,141284,141286,0,2,1
40347,3,3,141287,141287,141290,0,3,1
40348,1,2,141288,141290,141292,2,4,0
40349,5,2,141293,141293,141295,0,2,1
40350,5,2,141298,141298,141300,0,2,3
40351,4,1,141302,141302,141303,0,1,2
40352,5,2,141307,141307,141309,0,2,4
40353,3,2,141310,141310,141312,0,2,1
40354,6,1,141316,141316,141317,0,1,4
40355,6,1,141322,141322,141323,0,1,5
40356,5,2,141327,141327,141329,0,2,4
40357,2,1,141329,141329,141330,0,1,0
40358,2,1,141331,141331,141332,0,1,1
40359,3,1,141334,141334,141335,0,1,2
40360,3,2,141337,141337,141339,0,2,2
40361,2,1,141339,141339,141340,0,1,0
40362,4,2,141343,141343,141345,0,2,3
40363,5,2,141348,141348,141350,0,2,3
40364,1,1,141349,141350,141351,1,2,0
40365,4,3,141353,141353,141356,0,3,2
40366,2,1,141355,141356,141357,1,2,0
40367,1,2,141356,141357,141359,1,3,0
40368,3,1,141359,141359,141360,0,1,0
40369,2,1,141361,141361,141362,0,1,1
40370,3,3,141364,141364,141367,0,3,2
40371,3,1,141367,141367,141368,0,1,0
40372,2,3,141369,141369,141372,0,3,1
40373,6,1,141375,141375,141376,0,1,3
40374,3,3,141378,141378,141381,0,3,2
40375,6,2,141384,141384,141386,0,2,3
40376,6,2,141390,141390,141392,0,2,4
40377,1,3,141391,141392,141395,1,4,0
40378,5,2,141396,141396,141398,0,2,1
40379,5,2,141401,141401,141403,0,2,3
40380,5,3,141406,141406,141409,0,3,3
40381,2,1,141408,141409,141410,1,2,0
40382,6,2,141414,141414,141416,0,2,4
40383,1,3,141415,141416,141419,1,4,0
40384,2,2,141417,141419,141421,2,4,0
40385,5,1,141422,141422,141423,0,1,1
40386,4,2,141426,141426,141428,0,2,3
40387,3,1,141429,141429,141430,0,1,1
40388,4,1,141433,141433,141434,0,1,3
40389,6,2,141439,141439,141441,0,2,5
40390,5,1,141444,141444,141445,0,1,3
40391,2,1,141446,141446,141447,0,1,1
40392,6,2,141452,141452,141454,0,2,5
40393,4,2,141456,141456,141458,0,2,2
40394,5,2,141461,141461,141463,0,2,3
40395,2,1,141463,141463,141464,0,1,0
40396,1,1,141464,141464,141465,0,1,0
40397,5,1,141469,141469,141470,0,1,4
40398,3,2,141472,141472,141474,0,2,2
40399,6,1,141478,141478,141479,0,1,4
40400,1,1,141479,141479,141480,0,1,0
40401,5,1,141484,141484,141485,0,1,4
40402,5,3,141489,141489,141492,0,3,4
40403,5,2,141494,141494,141496,0,2,2
40404,4,1,141498,141498,141499,0,1,2
40405,4,1,141502,141502,141503,0,1,3
40406,3,3,141505,141505,141508,0,3,2
40407,2,3,141507,141508,141511,1,4,0
40408,5,1,141512,141512,141513,0,1,1
40409,1,2,141513,141513,141515,0,2,0
40410,3,2,141516,141516,141518,0,2,1
40411,3,3,141519,141519,141522,0,3,1
40412,2,3,141521,141522,141525,1,4,0
40413,1,3,141522,141525,141528,3,6,0
40414,2,3,141524,141528,141531,4,7,0
40415,6,3,141530,141531,141534,1,4,0
40416,1,3,141531,141534,141537,3,6,0
40417,1,3,141532,141537,141540,5,8,0
40418,1,1,141533,141540,141541,7,8,0
40419,3,2,141536,141541,141543,5,7,0
40420,5,1,141541,141543,141544,2,3,0
40421,1,3,141542,141544,141547,2,5,0
40422,2,2,141544,141547,141549,3,5,0
40423,5,3,141549,141549,141552,0,3,0
40424,2,2,141551,141552,141554,1,3,0
40425,5,3,141556,141556,141559,0,3,2
40426,6,2,141562,141562,141564,0,2,3
40427,4,3,141566,141566,141569,0,3,2
40428,5,2,141571,141571,141573,0,2,2
40429,6,1,141577,141577,141578,0,1,4
40430,3,1,141580,141580,141581,0,1,2
40431,1,3,141581,141581,141584,0,3,0
40432,4,3,141585,141585,141588,0,3,1
40433,5,1,141590,141590,141591,0,1,2
40434,2,3,141592,141592,141595,0,3,1
40435,3,1,141595,141595,141596,0,1,0
40436,6,1,141601,141601,141602,0,1,5
40437,1,2,141602,141602,141604,0,2,0
40438,1,3,141603,141604,141607,1,4,0
40439,4,2,141607,141607,141609,0,2,0
40440,5,1,141612,141612,141613,0,1,3
40441,6,3,141618,141618,141621,0,3,5
40442,4,3,141622,141622,141625,0,3,1
40443,6,1,141628,141628,141629,0,1,3
40444,5,2,141633,141633,141635,0,2,4
40445,5,2,141638,141638,141640,0,2,3
40446,3,1,141641,141641,141642,0,1,1
40447,3,3,141644,141644,141647,0,3,2
40448,2,3,141646,141647,141650,1,4,0
40449,1,1,141647,141650,141651,3,4,0
40450,3,1,141650,141651,141652,1,2,0
40451,4,1,141654,141654,141655,0,1,2
40452,5,2,141659,141659,141661,0,2,4
40453,6,3,141665,141665,141668,0,3,4
40454,4,3,141669,141669,141672,0,3,1
40455,2,3,141671,141672,141675,1,4,0
40456,2,1,141673,141675,141676,2,3,0
40457,1,1,141674,141676,141677,2,3,0
40458,6,1,141680,141680,141681,0,1,3
40459,1,1,141681,141681,141682,0,1,0
40460,6,3,141687,141687,141690,0,3,5
40461,2,1,141689,141690,141691,1,2,0
40462,1,2,141690,141691,141693,1,3,0
40463,6,3,141696,141696,141699,0,3,3
40464,1,1,141697,141699,141700,2,3,0
40465,3,1,141700,141700,141701,0,1,0
40466,6,2,141706,141706,141708,0,2,5
40467,2,1,141708,141708,141709,0,1,0
40468,6,3,141714,141714,141717,0,3,5
40469,3,1,141717,141717,141718,0,1,0
40470,5,2,141722,141722,141724,0,2,4
40471,3,2,141725,141725,141727,0,2,1
40472,4,3,141729,141729,141732,0,3,2
40473,1,3,141730,141732,141735,2,5,0
40474,1,1,141731,141735,141736,4,5,0
40475,5,2,141736,141736,141738,0,2,0
40476,4,1,141740,141740,141741,0,1,2
40477,6,2,141746,141746,141748,0,2,5
40478,1,2,141747,141748,141750,1,3,0
40479,1,1,141748,141750,141751,2,3,0
40480,2,2,141750,141751,141753,1,3,0
40481,6,3,141756,141756,141759,0,3,3
40482,3,1,141759,141759,141760,0,1,0
40483,1,2,141760,141760,141762,0,2,0
40484,2,2,141762,141762,141764,0,2,0
40485,3,2,141765,141765,141767,0,2,1
40486,5,3,141770,141770,141773,0,3,3
40487,4,1,141774,141774,141775,0,1,1
40488,3,2,141777,141777,141779,0,2,2
40489,3,1,141780,141780,141781,0,1,1
40490,2,1,141782,141782,141783,0,1,1
40491,3,3,141785,141785,141788,0,3,2
40492,6,2,141791,141791,141793,0,2,3
40493,1,1,141792,141793,141794,1,2,0
40494,2,2,141794,141794,141796,0,2,0
40495,6,3,141800,141800,141803,0,3,4
40496,2,1,141802,141803,141804,1,2,0
40497,2,1,141804,141804,141805,0,1,0
40498,3,2,141807,141807,141809,0,2,2
40499,1,1,141808,141809,141810,1,2,0
40500,6,2,141814,141814,141816,0,2,4
40501,3,2,141817,141817,141819,0,2,1
40502,4,3,141821,141821,141824,0,3,2
40503,6,1,141827,141827,141828,0,1,3
40504,4,1,141831,141831,141832,0,1,3
40505,1,2,141832,141832,141834,0,2,0
40506,5,2,141837,141837,141839,0,2,3
40507,2,2,141839,141839,141841,0,2,0
40508,2,1,141841,141841,141842,0,1,0
40509,5,2,141846,141846,141848,0,2,4
40510,4,2,141850,141850,141852,0,2,2
40511,3,3,141853,141853,141856,0,3,1
40512,6,1,141859,141859,141860,0,1,3
40513,4,3,141863,141863,141866,0,3,3
40514,4,2,141867,141867,141869,0,2,1
40515,3,3,141870,141870,141873,0,3,1
40516,4,3,141874,141874,141877,0,3,1
40517,6,2,141880,141880,141882,0,2,3
40518,1,1,141881,141882,141883,1,2,0
40519,3,2,141884,141884,141886,0,2,1
40520,5,2,141889,141889,141891,0,2,3
40521,4,1,141893,141893,141894,0,1,2
40522,4,1,141897,141897,141898,0,1,3
40523,4,2,141901,141901,141903,0,2,3
40524,4,2,141905,141905,141907,0,2,2
40525,2,1,141907,141907,141908,0,1,0
40526,5,2,141912,141912,141914,0,2,4
40527,5,1,141917,141917,141918,0,1,3
40528,6,2,141923,141923,141925,0,2,5
40529,3,3,141926,141926,141929,0,3,1
40530,3,2,141929,141929,141931,0,2,0
40531,4,2,141933,141933,141935,0,2,2
40532,6,2,141939,141939,141941,0,2,4
40533,1,3,141940,141941,141944,1,4,0
40534,1,3,141941,141944,141947,3,6,0
40535,3,3,141944,141947,141950,3,6,0
40536,4,1,141948,141950,141951,2,3,0
40537,6,2,141954,141954,141956,0,2,3
40538,2,1,141956,141956,141957,0,1,0
40539,6,2,141962,141962,141964,0,2,5
40540,6,3,141968,141968,141971,0,3,4
40541,5,2,141973,141973,141975,0,2,2
40542,4,3,141977,141977,141980,0,3,2
40543,6,2,141983,141983,141985,0,2,3
40544,1,1,141984,141985,141986,1,2,0
40545,6,1,141990,141990,141991,0,1,4
40546,6,2,141996,141996,141998,0,2,5
40547,6,3,142002,142002,142005,0,3,4
40548,4,1,142006,142006,142007,0,1,1
40549,4,1,142010,142010,142011,0,1,3
40550,2,2,142012,142012,142014,0,2,1
40551,4,1,142016,142016,142017,0,1,2
40552,4,3,142020,142020,142023,0,3,3
40553,6,3,142026,142026,142029,0,3,3
40554,3,1,142029,142029,142030,0,1,0
40555,1,3,142030,142030,142033,0,3,0
40556,4,3,142034,142034,142037,0,3,1
40557,6,2,142040,142040,142042,0,2,3
40558,1,1,142041,142042,142043,1,2,0
40559,5,3,142046,142046,142049,0,3,3
40560,5,1,142051,142051,142052,0,1,2
40561,3,1,142054,142054,142055,0,1,2
40562,2,1,142056,142056,142057,0,1,1
40563,5,3,142061,142061,142064,0,3,4
40564,5,2,142066,142066,142068,0,2,2
40565,6,3,142072,142072,142075,0,3,4
40566,6,2,142078,142078,142080,0,2,3
40567,1,1,142079,142080,142081,1,2,0
40568,4,1,142083,142083,142084,0,1,2
40569,1,1,142084,142084,142085,0,1,0
40570,1,3,142085,142085,142088,0,3,0
40571,4,3,142089,142089,142092,0,3,1
40572,5,3,142094,142094,142097,0,3,2
40573,5,2,142099,142099,142101,0,2,2
40574,1,2,142100,142101,142103,1,3,0
40575,3,3,142103,142103,142106,0,3,0
40576,1,1,142104,142106,142107,2,3,0
40577,4,1,142108,142108,142109,0,1,1
40578,2,1,142110,142110,142111,0,1,1
40579,2,1,142112,142112,142113,0,1,1
40580,1,3,142113,142113,142116,0,3,0
40581,6,2,142119,142119,142121,0,2,3
40582,6,2,142125,142125,142127,0,2,4
40583,5,1,142130,142130,142131,0,1,3
40584,1,3,142131,142131,142134,0,3,0
40585,2,3,142133,142134,142137,1,4,0
40586,1,3,142134,142137,142140,3,6,0
40587,3,1,142137,142140,142141,3,4,0
40588,2,3,142139,142141,142144,2,5,0
40589,3,3,142142,142144,142147,2,5,0
40590,6,1,142148,142148,142149,0,1,1
40591,2,1,142150,142150,142151,0,1,1
40592,1,3,142151,142151,142154,0,3,0
40593,4,1,142155,142155,142156,0,1,1
40594,5,2,142160,142160,142162,0,2,4
40595,4,2,142164,142164,142166,0,2,2
40596,1,3,142165,142166,142169,1,4,0
40597,6,2,142171,142171,142173,0,2,2
40598,6,3,142177,142177,142180,0,3,4
40599,1,1,142178,142180,142181,2,3,0
40600,2,2,142180,142181,142183,1,3,0
40601,2,1,142182,142183,142184,1,2,0
40602,5,1,142187,142187,142188,0,1,3
40603,2,2,142189,142189,142191,0,2,1
40604,5,3,142194,142194,142197,0,3,3
40605,1,3,142195,142197,142200,2,5,0
40606,6,1,142201,142201,142202,0,1,1
40607,5,1,142206,142206,142207,0,1,4
40608,2,3,142208,142208,142211,0,3,1
40609,5,2,142213,142213,142215,0,2,2
40610,2,2,142215,142215,142217,0,2,0
40611,5,3,142220,142220,142223,0,3,3
40612,5,1,142225,142225,142226,0,1,2
40613,1,1,142226,142226,142227,0,1,0
40614,4,1,142230,142230,142231,0,1,3
40615,2,3,142232,142232,142235,0,3,1
40616,3,2,142235,142235,142237,0,2,0
40617,4,2,142239,142239,142241,0,2,2
40618,1,3,142240,142241,142244,1,4,0
40619,6,1,142246,142246,142247,0,1,2
40620,1,2,142247,142247,142249,0,2,0
40621,3,2,142250,142250,142252,0,2,1
40622,2,3,142252,142252,142255,0,3,0
40623,6,1,142258,142258,142259,0,1,3
40624,6,2,142264,142264,142266,0,2,5
40625,5,1,142269,142269,142270,0,1,3
40626,3,1,142272,142272,142273,0,1,2
40627,6,3,142278,142278,142281,0,3,5
40628,1,2,142279,142281,142283,2,4,0
40629,1,1,142280,142283,142284,3,4,0
40630,6,3,142286,142286,142289,0,3,2
40631,1,2,142287,142289,142291,2,4,0
40632,5,3,142292,142292,142295,0,3,1
40633,4,1,142296,142296,142297,0,1,1
40634,5,2,142301,142301,142303,0,2,4
40635,1,3,142302,142303,142306,1,4,0
40636,5,2,142307,142307,142309,0,2,1
40637,1,2,142308,142309,142311,1,3,0
40638,6,3,142314,142314,142317,0,3,3
40639,2,3,142316,142317,142320,1,4,0
40640,4,2,142320,142320,142322,0,2,0
40641,5,3,142325,142325,142328,0,3,3
40642,6,1,142331,142331,142332,0,1,3
40643,4,3,142335,142335,142338,0,3,3
40644,1,3,142336,142338,142341,2,5,0
40645,1,3,142337,142341,142344,4,7,0
40646,1,3,142338,142344,142347,6,9,0
40647,1,3,142339,142347,142350,8,11,0
40648,1,3,142340,142350,142353,10,13,0
40649,2,3,142342,142353,142356,11,14,0
40650,2,2,142344,142356,142358,12,14,0
40651,6,1,142350,142358,142359,8,9,0
40652,3,3,142353,142359,142362,6,9,0
40653,2,1,142355,142362,142363,7,8,0
40654,2,1,142357,142363,142364,6,7,0
40655,5,1,142362,142364,142365,2,3,0
40656,5,2,142367,142367,142369,0,2,2
40657,3,2,142370,142370,142372,0,2,1
40658,5,2,142375,142375,142377,0,2,3
40659,6,2,142381,142381,142383,0,2,4
40660,5,2,142386,142386,142388,0,2,3
40661,4,1,142390,142390,142391,0,1,2
40662,2,3,142392,142392,142395,0,3,1
40663,2,3,142394,142395,142398,1,4,0
40664,6,1,142400,142400,142401,0,1,2
40665,3,1,142403,142403,142404,0,1,2
40666,4,1,142407,142407,142408,0,1,3
40667,6,3,142413,142413,142416,0,3,5
40668,1,1,142414,142416,142417,2,3,0
40669,2,2,142416,142417,142419,1,3,0
40670,3,1,142419,142419,142420,0,1,0
40671,6,3,142425,142425,142428,0,3,5
40672,6,3,142431,142431,142434,0,3,3
40673,5,2,142436,142436,142438,0,2,2
40674,2,2,142438,142438,142440,0,2,0
40675,2,3,142440,142440,142443,0,3,0
40676,1,3,142441,142443,142446,2,5,0
40677,1,1,142442,142446,142447,4,5,0
40678,3,1,142445,142447,142448,2,3,0
40679,6,1,142451,142451,142452,0,1,3
40680,2,2,142453,142453,142455,0,2,1
40681,2,1,142455,142455,142456,0,1,0
40682,1,2,142456,142456,142458,0,2,0
40683,4,3,142460,142460,142463,0,3,2
40684,5,3,142465,142465,142468,0,3,2
40685,3,3,142468,142468,142471,0,3,0
40686,3,3,142471,142471,142474,0,3,0
40687,4,1,142475,142475,142476,0,1,1
40688,1,3,142476,142476,142479,0,3,0
40689,1,3,142477,142479,142482,2,5,0
40690,5,1,142482,142482,142483,0,1,0
40691,3,2,142485,142485,142487,0,2,2
40692,1,1,142486,142487,142488,1,2,0
40693,5,2,142491,142491,142493,0,2,3
40694,5,2,142496,142496,142498,0,2,3
40695,3,2,142499,142499,142501,0,2,1
40696,1,3,142500,142501,142504,1,4,0
40697,6,2,142506,142506,142508,0,2,2
40698,5,3,142511,142511,142514,0,3,3
40699,4,2,142515,142515,142517,0,2,1
40700,6,2,142521,142521,142523,0,2,4
40701,4,3,142525,142525,142528,0,3,2
40702,5,1,142530,142530,142531,0,1,2
40703,5,3,142535,142535,142538,0,3,4
40704,4,3,142539,142539,142542,0,3,1
40705,5,1,142544,142544,142545,0,1,2
40706,2,2,142546,142546,142548,0,2,1
40707,6,2,142552,142552,142554,0,2,4
40708,2,1,142554,142554,142555,0,1,0
40709,1,3,142555,142555,142558,0,3,0
40710,3,2,142558,142558,142560,0,2,0
40711,6,2,142564,142564,142566,0,2,4
40712,3,2,142567,142567,142569,0,2,1
40713,2,2,142569,142569,142571,0,2,0
40714,5,3,142574,142574,142577,0,3,3
40715,2,2,142576,142577,142579,1,3,0
40716,6,2,142582,142582,142584,0,2,3
40717,5,3,142587,142587,142590,0,3,3
40718,3,3,142590,142590,142593,0,3,0
40719,6,2,142596,142596,142598,0,2,3
40720,1,3,142597,142598,142601,1,4,0
40721,3,1,142600,142601,142602,1,2,0
40722,6,3,142606,142606,142609,0,3,4
40723,2,1,142608,142609,142610,1,2,0
40724,3,2,142611,142611,142613,0,2,1
40725,5,2,142616,142616,142618,0,2,3
40726,2,3,142618,142618,142621,0,3,0
40727,6,2,142624,142624,142626,0,2,3
40728,5,1,142629,142629,142630,0,1,3
40729,4,2,142633,142633,142635,0,2,3
40730,6,3,142639,142639,142642,0,3,4
40731,5,2,142644,142644,142646,0,2,2
40732,4,1,142648,142648,142649,0,1,2
40733,3,2,142651,142651,142653,0,2,2
40734,1,2,142652,142653,142655,1,3,0
40735,1,3,142653,142655,142658,2,5,0
40736,2,3,142655,142658,142661,3,6,0
40737,5,2,142660,142661,142663,1,3,0
40738,2,3,142662,142663,142666,1,4,0
40739,3,1,142665,142666,142667,1,2,0
40740,3,3,142668,142668,142671,0,3,1
40741,5,2,142673,142673,142675,0,2,2
40742,6,1,142679,142679,142680,0,1,4
40743,1,3,142680,142680,142683,0,3,0
40744,4,3,142684,142684,142687,0,3,1
40745,4,3,142688,142688,142691,0,3,1
40746,4,2,142692,142692,142694,0,2,1
40747,1,1,142693,142694,142695,1,2,0
40748,6,2,142699,142699,142701,0,2,4
40749,3,1,142702,142702,142703,0,1,1
40750,5,3,142707,142707,142710,0,3,4
40751,1,2,142708,142710,142712,2,4,0
40752,4,2,142712,142712,142714,0,2,0
40753,6,1,142718,142718,142719,0,1,4
40754,5,1,142723,142723,142724,0,1,4
40755,5,3,142728,142728,142731,0,3,4
40756,1,3,142729,142731,142734,2,5,0
40757,4,2,142733,142734,142736,1,3,0
40758,1,2,142734,142736,142738,2,4,0
40759,1,1,142735,142738,142739,3,4,0
40760,5,1,142740,142740,142741,0,1,1
40761,6,3,142746,142746,142749,0,3,5
40762,5,1,142751,142751,142752,0,1,2
40763,4,1,142755,142755,142756,0,1,3
40764,5,2,142760,142760,142762,0,2,4
40765,4,3,142764,142764,142767,0,3,2
40766,3,3,142767,142767,142770,0,3,0
40767,2,1,142769,142770,142771,1,2,0
40768,5,2,142774,142774,142776,0,2,3
40769,1,1,142775,142776,142777,1,2,0
40770,5,2,142780,142780,142782,0,2,3
40771,6,1,142786,142786,142787,0,1,4
40772,2,3,142788,142788,142791,0,3,1
40773,5,3,142793,142793,142796,0,3,2
40774,3,3,142796,142796,142799,0,3,0
40775,1,2,142797,142799,142801,2,4,0
40776,5,1,142802,142802,142803,0,1,1
40777,1,3,142803,142803,142806,0,3,0
40778,5,3,142808,142808,142811,0,3,2
40779,3,1,142811,142811,142812,0,1,0
40780,5,2,142816,142816,142818,0,2,4
40781,1,1,142817,142818,142819,1,2,0
40782,5,3,142822,142822,142825,0,3,3
40783,5,1,142827,142827,142828,0,1,2
40784,2,1,142829,142829,142830,0,1,1
40785,6,2,142835,142835,142837,0,2,5
40786,5,3,142840,142840,142843,0,3,3
40787,4,2,142844,142844,142846,0,2,1
40788,5,1,142849,142849,142850,0,1,3
40789,1,3,142850,142850,142853,0,3,0
40790,5,1,142855,142855,142856,0,1,2
40791,5,3,142860,142860,142863,0,3,4
40792,3,3,142863,142863,142866,0,3,0
40793,2,3,142865,142866,142869,1,4,0
40794,6,3,142871,142871,142874,0,3,2
40795,4,1,142875,142875,142876,0,1,1
40796,1,3,142876,142876,142879,0,3,0
40797,5,2,142881,142881,142883,0,2,2
40798,1,3,142882,142883,142886,1,4,0
40799,4,3,142886,142886,142889,0,3,0
40800,5,2,142891,142891,142893,0,2,2
40801,1,1,142892,142893,142894,1,2,0
40802,2,2,142894,142894,142896,0,2,0
40803,2,3,142896,142896,142899,0,3,0
40804,2,3,142898,142899,142902,1,4,0
40805,3,3,142901,142902,142905,1,4,0
40806,2,1,142903,142905,142906,2,3,0
40807,2,2,142905,142906,142908,1,3,0
40808,3,2,142908,142908,142910,0,2,0
40809,4,2,142912,142912,142914,0,2,2
40810,5,1,142917,142917,142918,0,1,3
40811,3,2,142920,142920,142922,0,2,2
40812,3,1,142923,142923,142924,0,1,1
40813,2,1,142925,142925,142926,0,1,1
40814,6,3,142931,142931,142934,0,3,5
40815,1,1,142932,142934,142935,2,3,0
40816,2,2,142934,142935,142937,1,3,0
40817,1,1,142935,142937,142938,2,3,0
40818,2,3,142937,142938,142941,1,4,0
40819,2,1,142939,142941,142942,2,3,0
40820,3,3,142942,142942,142945,0,3,0
40821,5,3,142947,142947,142950,0,3,2
40822,4,1,142951,142951,142952,0,1,1
40823,4,2,142955,142955,142957,0,2,3
40824,6,1,142961,142961,142962,0,1,4
40825,3,3,142964,142964,142967,0,3,2
40826,3,2,142967,142967,142969,0,2,0
40827,3,2,142970,142970,142972,0,2,1
40828,5,2,142975,142975,142977,0,2,3
40829,4,1,142979,142979,142980,0,1,2
40830,2,2,142981,142981,142983,0,2,1
40831,3,2,142984,142984,142986,0,2,1
40832,5,1,142989,142989,142990,0,1,3
40833,2,3,142991,142991,142994,0,3,1
40834,3,1,142994,142994,142995,0,1,0
40835,5,3,142999,142999,143002,0,3,4
40836,1,3,143000,143002,143005,2,5,0
40837,3,2,143003,143005,143007,2,4,0
40838,2,2,143005,143007,143009,2,4,0
40839,2,3,143007,143009,143012,2,5,0
40840,5,1,143012,143012,143013,0,1,0
40841,6,2,143018,143018,143020,0,2,5
40842,2,2,143020,143020,143022,0,2,0
40843,4,2,143024,143024,143026,0,2,2
40844,1,2,143025,143026,143028,1,3,0
40845,1,2,143026,143028,143030,2,4,0
40846,2,3,143028,143030,143033,2,5,0
40847,6,1,143034,143034,143035,0,1,1
40848,2,3,143036,143036,143039,0,3,1
40849,6,1,143042,143042,143043,0,1,3
40850,1,1,143043,143043,143044,0,1,0
40851,2,2,143045,143045,143047,0,2,1
40852,2,1,143047,143047,143048,0,1,0
40853,3,3,143050,143050,143053,0,3,2
40854,5,3,143055,143055,143058,0,3,2
40855,5,3,143060,143060,143063,0,3,2
40856,4,3,143064,143064,143067,0,3,1
40857,1,3,143065,143067,143070,2,5,0
40858,4,3,143069,143070,143073,1,4,0
40859,3,2,143072,143073,143075,1,3,0
40860,4,2,143076,143076,143078,0,2,1
40861,3,1,143079,143079,143080,0,1,1
40862,5,3,143084,143084,143087,0,3,4
40863,4,1,143088,143088,143089,0,1,1
40864,1,1,143089,143089,143090,0,1,0
40865,1,3,143090,143090,143093,0,3,0
40866,4,2,143094,143094,143096,0,2,1
40867,2,1,143096,143096,143097,0,1,0
40868,2,3,143098,143098,143101,0,3,1
40869,6,1,143104,143104,143105,0,1,3
40870,5,1,143109,143109,143110,0,1,4
40871,2,3,143111,143111,143114,0,3,1
40872,6,3,143117,143117,143120,0,3,3
40873,5,2,143122,143122,143124,0,2,2
40874,2,2,143124,143124,143126,0,2,0
40875,4,2,143128,143128,143130,0,2,2
40876,4,2,143132,143132,143134,0,2,2
40877,6,1,143138,143138,143139,0,1,4
40878,5,1,143143,143143,143144,0,1,4
40879,2,2,143145,143145,143147,0,2,1
40880,2,3,143147,143147,143150,0,3,0
40881,2,1,143149,143150,143151,1,2,0
40882,1,3,143150,143151,143154,1,4,0
40883,4,1,143154,143154,143155,0,1,0
40884,3,1,143157,143157,143158,0,1,2
40885,2,1,143159,143159,143160,0,1,1
40886,3,3,143162,143162,143165,0,3,2
40887,3,1,143165,143165,143166,0,1,0
40888,3,3,143168,143168,143171,0,3,2
40889,1,1,143169,143171,143172,2,3,0
40890,2,3,143171,143172,143175,1,4,0
40891,6,1,143177,143177,143178,0,1,2
40892,2,2,143179,143179,143181,0,2,1
40893,4,1,143183,143183,143184,0,1,2
40894,3,1,143186,143186,143187,0,1,2
40895,4,3,143190,143190,143193,0,3,3
40896,2,3,143192,143193,143196,1,4,0
40897,2,3,143194,143196,143199,2,5,0
40898,4,2,143198,143199,143201,1,3,0
40899,5,1,143203,143203,143204,0,1,2
40900,5,3,143208,143208,143211,0,3,4
40901,3,1,143211,143211,143212,0,1,0
40902,4,2,143215,143215,143217,0,2,3
40903,6,3,143221,143221,143224,0,3,4
40904,2,1,143223,143224,143225,1,2,0
40905,4,1,143227,143227,143228,0,1,2
40906,2,2,143229,143229,143231,0,2,1
40907,1,1,143230,143231,143232,1,2,0
40908,1,1,143231,143232,143233,1,2,0
40909,2,1,143233,143233,143234,0,1,0
40910,2,2,143235,143235,143237,0,2,1
40911,3,3,143238,143238,143241,0,3,1
40912,1,2,143239,143241,143243,2,4,0
40913,1,3,143240,143243,143246,3,6,0
40914,1,2,143241,143246,143248,5,7,0
40915,3,3,143244,143248,143251,4,7,0
40916,5,2,143249,143251,143253,2,4,0
40917,6,3,143255,143255,143258,0,3,2
40918,5,2,143260,143260,143262,0,2,2
40919,1,3,143261,143262,143265,1,4,0
40920,6,1,143267,143267,143268,0,1,2
40921,1,1,143268,143268,143269,0,1,0
40922,4,2,143272,143272,143274,0,2,3
40923,2,1,143274,143274,143275,0,1,0
40924,6,1,143280,143280,143281,0,1,5
40925,4,3,143284,143284,143287,0,3,3
40926,2,1,143286,143287,143288,1,2,0
40927,1,1,143287,143288,143289,1,2,0
40928,3,1,143290,143290,143291,0,1,1
40929,5,3,143295,143295,143298,0,3,4
40930,2,1,143297,143298,143299,1,2,0
40931,5,2,143302,143302,143304,0,2,3
40932,4,3,143306,143306,143309,0,3,2
40933,1,3,143307,143309,143312,2,5,0
40934,1,3,143308,143312,143315,4,7,0
40935,4,3,143312,143315,143318,3,6,0
40936,2,3,143314,143318,143321,4,7,0
40937,3,1,143317,143321,143322,4,5,0
40938,6,3,143323,143323,143326,0,3,1
40939,1,2,143324,143326,143328,2,4,0
40940,3,2,143327,143328,143330,1,3,0
40941,1,3,143328,143330,143333,2,5,0
40942,2,1,143330,143333,143334,3,4,0
40943,3,3,143333,143334,143337,1,4,0
40944,1,2,143334,143337,143339,3,5,0
40945,6,2,143340,143340,143342,0,2,1
40946,2,1,143342,143342,143343,0,1,0
40947,3,3,143345,143345,143348,0,3,2
40948,3,2,143348,143348,143350,0,2,0
40949,6,1,143354,143354,143355,0,1,4
40950,1,3,143355,143355,143358,0,3,0
40951,2,3,143357,143358,143361,1,4,0
40952,1,2,143358,143361,143363,3,5,0
40953,1,3,143359,143363,143366,4,7,0
40954,1,3,143360,143366,143369,6,9,0
40955,3,3,143363,143369,143372,6,9,0
40956,1,3,143364,143372,143375,8,11,0
40957,3,1,143367,143375,143376,8,9,0
40958,2,1,143369,143376,143377,7,8,0
40959,4,3,143373,143377,143380,4,7,0
40960,2,1,143375,143380,143381,5,6,0
40961,6,3,143381,143381,143384,0,3,0
40962,4,1,143385,143385,143386,0,1,1
40963,4,2,143389,143389,143391,0,2,3
40964,6,2,143395,143395,143397,0,2,4
40965,6,1,143401,143401,143402,0,1,4
40966,1,2,143402,143402,143404,0,2,0
40967,5,1,143407,143407,143408,0,1,3
40968,2,2,143409,143409,143411,0,2,1
40969,1,2,143410,143411,143413,1,3,0
40970,4,1,143414,143414,143415,0,1,1
40971,2,2,143416,143416,143418,0,2,1
40972,3,3,143419,143419,143422,0,3,1
40973,1,1,143420,143422,143423,2,3,0
40974,4,2,143424,143424,143426,0,2,1
40975,2,3,143426,143426,143429,0,3,0
40976,6,2,143432,143432,143434,0,2,3
40977,3,3,143435,143435,143438,0,3,1
40978,1,3,143436,143438,143441,2,5,0
40979,4,2,143440,143441,143443,1,3,0
40980,1,3,143441,143443,143446,2,5,0
40981,2,1,143443,143446,143447,3,4,0
40982,5,1,143448,143448,143449,0,1,1
40983,6,2,143454,143454,143456,0,2,5
40984,4,1,143458,143458,143459,0,1,2
40985,5,2,143463,143463,143465,0,2,4
40986,5,3,143468,143468,143471,0,3,3
40987,1,2,143469,143471,143473,2,4,0
40988,6,2,143475,143475,143477,0,2,2
40989,2,3,143477,143477,143480,0,3,0
40990,6,1,143483,143483,143484,0,1,3
40991,2,1,143485,143485,143486,0,1,1
40992,4,1,143489,143489,143490,0,1,3
40993,5,1,143494,143494,143495,0,1,4
40994,5,3,143499,143499,143502,0,3,4
40995,3,1,143502,143502,143503,0,1,0
40996,6,3,143508,143508,143511,0,3,5
40997,2,3,143510,143511,143514,1,4,0
40998,3,3,143513,143514,143517,1,4,0
40999,6,3,143519,143519,143522,0,3,2
41000,2,1,143521,143522,143523,1,2,0
41001,5,3,143526,143526,143529,0,3,3
41002,1,2,143527,143529,143531,2,4,0
41003,6,1,143533,143533,143534,0,1,2
41004,4,1,143537,143537,143538,0,1,3
41005,4,1,143541,143541,143542,0,1,3
41006,1,1,143542,143542,143543,0,1,0
41007,6,3,143548,143548,143551,0,3,5
41008,1,3,143549,143551,143554,2,5,0
41009,2,2,143551,143554,143556,3,5,0
41010,4,1,143555,143556,143557,1,2,0
41011,5,3,143560,143560,143563,0,3,3
41012,6,3,143566,143566,143569,0,3,3
41013,4,2,143570,143570,143572,0,2,1
41014,6,2,143576,143576,143578,0,2,4
41015,6,1,143582,143582,143583,0,1,4
41016,2,2,143584,143584,143586,0,2,1
41017,1,3,143585,143586,143589,1,4,0
41018,3,2,143588,143589,143591,1,3,0
41019,3,3,143591,143591,143594,0,3,0
41020,6,2,143597,143597,143599,0,2,3
41021,3,1,143600,143600,143601,0,1,1
41022,6,1,143606,143606,143607,0,1,5
41023,1,2,143607,143607,143609,0,2,0
41024,6,2,143613,143613,143615,0,2,4
41025,6,2,143619,143619,143621,0,2,4
41026,3,3,143622,143622,143625,0,3,1
41027,3,2,143625,143625,143627,0,2,0
41028,4,2,143629,143629,143631,0,2,2
41029,2,3,143631,143631,143634,0,3,0
41030,4,3,143635,143635,143638,0,3,1
41031,5,2,143640,143640,143642,0,2,2
41032,1,3,143641,143642,143645,1,4,0
41033,6,1,143647,143647,143648,0,1,2
41034,4,1,143651,143651,143652,0,1,3
41035,4,3,143655,143655,143658,0,3,3
41036,3,3,143658,143658,143661,0,3,0
41037,5,1,143663,143663,143664,0,1,2
41038,6,2,143669,143669,143671,0,2,5
41039,2,1,143671,143671,143672,0,1,0
41040,4,3,143675,143675,143678,0,3,3
41041,2,1,143677,143678,143679,1,2,0
41042,4,1,143681,143681,143682,0,1,2
41043,2,1,143683,143683,143684,0,1,1
41044,1,1,143684,143684,143685,0,1,0
41045,4,2,143688,143688,143690,0,2,3
41046,3,3,143691,143691,143694,0,3,1
41047,3,2,143694,143694,143696,0,2,0
41048,4,3,143698,143698,143701,0,3,2
41049,5,3,143703,143703,143706,0,3,2
41050,3,2,143706,143706,143708,0,2,0
41051,1,1,143707,143708,143709,1,2,0
41052,6,3,143713,143713,143716,0,3,4
41053,5,3,143718,143718,143721,0,3,2
41054,2,2,143720,143721,143723,1,3,0
41055,4,2,143724,143724,143726,0,2,1
41056,6,1,143730,143730,143731,0,1,4
41057,3,2,143733,143733,143735,0,2,2
41058,2,1,143735,143735,143736,0,1,0
41059,3,1,143738,143738,143739,0,1,2
41060,1,1,143739,143739,143740,0,1,0
41061,6,1,143745,143745,143746,0,1,5
41062,2,2,143747,143747,143749,0,2,1
41063,2,2,143749,143749,143751,0,2,0
41064,5,3,143754,143754,143757,0,3,3
41065,2,3,143756,143757,143760,1,4,0
41066,6,2,143762,143762,143764,0,2,2
41067,4,1,143766,143766,143767,0,1,2
41068,2,1,143768,143768,143769,0,1,1
41069,4,2,143772,143772,143774,0,2,3
41070,6,1,143778,143778,143779,0,1,4
41071,1,3,143779,143779,143782,0,3,0
41072,3,1,143782,143782,143783,0,1,0
41073,4,2,143786,143786,143788,0,2,3
41074,4,3,143790,143790,143793,0,3,2
41075,1,3,143791,143793,143796,2,5,0
41076,1,2,143792,143796,143798,4,6,0
41077,2,3,143794,143798,143801,4,7,0
41078,5,3,143799,143801,143804,2,5,0
41079,1,3,143800,143804,143807,4,7,0
41080,1,3,143801,143807,143810,6,9,0
41081,6,2,143807,143810,143812,3,5,0
41082,4,2,143811,143812,143814,1,3,0
41083,6,3,143817,143817,143820,0,3,3
41084,5,1,143822,143822,143823,0,1,2
41085,2,1,143824,143824,143825,0,1,1
41086,2,2,143826,143826,143828,0,2,1
41087,6,3,143832,143832,143835,0,3,4
41088,6,3,143838,143838,143841,0,3,3
41089,3,1,143841,143841,143842,0,1,0
41090,1,2,143842,143842,143844,0,2,0
41091,3,1,143845,143845,143846,0,1,1
41092,2,1,143847,143847,143848,0,1,1
41093,2,3,143849,143849,143852,0,3,1
41094,2,1,143851,143852,143853,1,2,0
41095,6,1,143857,143857,143858,0,1,4
41096,1,2,143858,143858,143860,0,2,0
41097,3,1,143861,143861,143862,0,1,1
41098,2,1,143863,143863,143864,0,1,1
41099,4,1,143867,143867,143868,0,1,3
41100,5,1,143872,143872,143873,0,1,4
41101,6,3,143878,143878,143881,0,3,5
41102,2,1,143880,143881,143882,1,2,0
41103,1,3,143881,143882,143885,1,4,0
41104,5,1,143886,143886,143887,0,1,1
41105,6,1,143892,143892,143893,0,1,5
41106,6,2,143898,143898,143900,0,2,5
41107,3,2,143901,143901,143903,0,2,1
41108,4,1,143905,143905,143906,0,1,2
41109,1,1,143906,143906,143907,0,1,0
41110,3,1,143909,143909,143910,0,1,2
41111,2,3,143911,143911,143914,0,3,1
41112,1,2,143912,143914,143916,2,4,0
41113,2,1,143914,143916,143917,2,3,0
41114,6,3,143920,143920,143923,0,3,3
41115,1,3,143921,143923,143926,2,5,0
41116,3,2,143924,143926,143928,2,4,0
41117,6,1,143930,143930,143931,0,1,2
41118,1,2,143931,143931,143933,0,2,0
41119,6,2,143937,143937,143939,0,2,4
41120,2,3,143939,143939,143942,0,3,0
41121,6,3,143945,143945,143948,0,3,3
41122,6,2,143951,143951,143953,0,2,3
41123,3,1,143954,143954,143955,0,1,1
41124,1,1,143955,143955,143956,0,1,0
41125,5,1,143960,143960,143961,0,1,4
41126,4,1,143964,143964,143965,0,1,3
41127,1,1,143965,143965,143966,0,1,0
41128,6,2,143971,143971,143973,0,2,5
41129,4,1,143975,143975,143976,0,1,2
41130,2,3,143977,143977,143980,0,3,1
41131,6,1,143983,143983,143984,0,1,3
41132,6,1,143989,143989,143990,0,1,5
41133,1,3,143990,143990,143993,0,3,0
41134,1,3,143991,143993,143996,2,5,0
41135,2,2,143993,143996,143998,3,5,0
41136,1,2,143994,143998,144000,4,6,0
41137,5,1,143999,144000,144001,1,2,0
41138,4,1,144003,144003,144004,0,1,2
41139,5,1,144008,144008,144009,0,1,4
41140,1,2,144009,144009,144011,0,2,0
41141,5,2,144014,144014,144016,0,2,3
41142,5,1,144019,144019,144020,0,1,3
41143,2,2,144021,144021,144023,0,2,1
41144,6,1,144027,144027,144028,0,1,4
41145,2,2,144029,144029,144031,0,2,1
41146,5,2,144034,144034,144036,0,2,3
41147,3,3,144037,144037,144040,0,3,1
41148,2,1,144039,144040,144041,1,2,0
41149,4,1,144043,144043,144044,0,1,2
41150,6,2,144049,144049,144051,0,2,5
41151,5,3,144054,144054,144057,0,3,3
41152,3,1,144057,144057,144058,0,1,0
41153,6,1,144063,144063,144064,0,1,5
41154,2,3,144065,144065,144068,0,3,1
41155,1,3,144066,144068,144071,2,5,0
41156,3,3,144069,144071,144074,2,5,0
41157,2,3,144071,144074,144077,3,6,0
41158,2,3,144073,144077,144080,4,7,0
41159,5,3,144078,144080,144083,2,5,0
41160,5,1,144083,144083,144084,0,1,0
41161,4,2,144087,144087,144089,0,2,3
41162,4,2,144091,144091,144093,0,2,2
41163,5,2,144096,144096,144098,0,2,3
41164,2,3,144098,144098,144101,0,3,0
41165,4,1,144102,144102,144103,0,1,1
41166,1,2,144103,144103,144105,0,2,0
41167,1,2,144104,144105,144107,1,3,0
41168,5,3,144109,144109,144112,0,3,2
41169,5,1,144114,144114,144115,0,1,2
41170,3,2,144117,144117,144119,0,2,2
41171,2,2,144119,144119,144121,0,2,0
41172,3,1,144122,144122,144123,0,1,1
41173,4,3,144126,144126,144129,0,3,3
41174,3,2,144129,144129,144131,0,2,0
41175,3,1,144132,144132,144133,0,1,1
41176,6,1,144138,144138,144139,0,1,5
41177,2,2,144140,144140,144142,0,2,1
41178,1,2,144141,144142,144144,1,3,0
41179,5,1,144146,144146,144147,0,1,2
41180,1,2,144147,144147,144149,0,2,0
41181,3,1,144150,144150,144151,0,1,1
41182,4,2,144154,144154,144156,0,2,3
41183,5,1,144159,144159,144160,0,1,3
41184,5,1,144164,144164,144165,0,1,4
41185,3,2,144167,144167,144169,0,2,2
41186,6,2,144173,144173,144175,0,2,4
41187,6,2,144179,144179,144181,0,2,4
41188,5,3,144184,144184,144187,0,3,3
41189,1,2,144185,144187,144189,2,4,0
41190,5,1,144190,144190,144191,0,1,1
41191,6,1,144196,144196,144197,0,1,5
41192,5,3,144201,144201,144204,0,3,4
41193,5,1,144206,144206,144207,0,1,2
41194,3,3,144209,144209,144212,0,3,2
41195,4,1,144213,144213,144214,0,1,1
41196,5,1,144218,144218,144219,0,1,4
41197,5,2,144223,144223,144225,0,2,4
41198,2,2,144225,144225,144227,0,2,0
41199,3,2,144228,144228,144230,0,2,1
41200,4,3,144232,144232,144235,0,3,2
41201,1,1,144233,144235,144236,2,3,0
41202,2,2,144235,144236,144238,1,3,0
41203,1,1,144236,144238,144239,2,3,0
41204,6,2,144242,144242,144244,0,2,3
41205,3,2,144245,144245,144247,0,2,1
41206,2,3,144247,144247,144250,0,3,0
41207,5,3,144252,144252,144255,0,3,2
41208,2,2,144254,144255,144257,1,3,0
41209,3,1,144257,144257,144258,0,1,0
41210,1,2,144258,144258,144260,0,2,0
41211,5,2,144263,144263,144265,0,2,3
41212,5,2,144268,144268,144270,0,2,3
41213,4,1,144272,144272,144273,0,1,2
41214,5,3,144277,144277,144280,0,3,4
41215,5,1,144282,144282,144283,0,1,2
41216,2,1,144284,144284,144285,0,1,1
41217,5,3,144289,144289,144292,0,3,4
41218,2,3,144291,144292,144295,1,4,0
41219,6,1,144297,144297,144298,0,1,2
41220,3,1,144300,144300,144301,0,1,2
41221,4,1,144304,144304,144305,0,1,3
41222,3,2,144307,144307,144309,0,2,2
41223,5,3,144312,144312,144315,0,3,3
41224,6,3,144318,144318,144321,0,3,3
41225,3,3,144321,144321,144324,0,3,0
41226,3,3,144324,144324,144327,0,3,0
41227,5,1,144329,144329,144330,0,1,2
41228,6,3,144335,144335,144338,0,3,5
41229,1,1,144336,144338,144339,2,3,0
41230,6,1,144342,144342,144343,0,1,3
41231,2,2,144344,144344,144346,0,2,1
41232,6,3,144350,144350,144353,0,3,4
41233,2,3,144352,144353,144356,1,4,0
41234,1,1,144353,144356,144357,3,4,0
41235,5,2,144358,144358,144360,0,2,1
41236,3,1,144361,144361,144362,0,1,1
41237,3,3,144364,144364,144367,0,3,2
41238,2,2,144366,144367,144369,1,3,0
41239,1,2,144367,144369,144371,2,4,0
41240,2,1,144369,144371,144372,2,3,0
41241,6,2,144375,144375,144377,0,2,3
41242,2,3,144377,144377,144380,0,3,0
41243,6,1,144383,144383,144384,0,1,3
41244,2,2,144385,144385,144387,0,2,1
41245,5,3,144390,144390,144393,0,3,3
41246,4,1,144394,144394,144395,0,1,1
41247,4,3,144398,144398,144401,0,3,3
41248,6,3,144404,144404,144407,0,3,3
41249,5,2,144409,144409,144411,0,2,2
41250,2,1,144411,144411,144412,0,1,0
41251,1,1,144412,144412,144413,0,1,0
41252,5,3,144417,144417,144420,0,3,4
41253,1,3,144418,144420,144423,2,5,0
41254,2,2,144420,144423,144425,3,5,0
41255,2,1,144422,144425,144426,3,4,0
41256,6,3,144428,144428,144431,0,3,2
41257,4,2,144432,144432,144434,0,2,1
41258,1,2,144433,144434,144436,1,3,0
41259,5,2,144438,144438,144440,0,2,2
41260,3,1,144441,144441,144442,0,1,1
41261,1,3,144442,144442,144445,0,3,0
41262,3,2,144445,144445,144447,0,2,0
41263,3,2,144448,144448,144450,0,2,1
41264,1,3,144449,144450,144453,1,4,0
41265,5,1,144454,144454,144455,0,1,1
41266,3,3,144457,144457,144460,0,3,2
41267,1,2,144458,144460,144462,2,4,0
41268,6,2,144464,144464,144466,0,2,2
41269,3,2,144467,144467,144469,0,2,1
41270,4,1,144471,144471,144472,0,1,2
41271,4,1,144475,144475,144476,0,1,3
41272,6,1,144481,144481,144482,0,1,5
41273,5,2,144486,144486,144488,0,2,4
41274,6,1,144492,144492,144493,0,1,4
41275,3,2,144495,144495,144497,0,2,2
41276,5,1,144500,144500,144501,0,1,3
41277,1,2,144501,144501,144503,0,2,0
41278,6,1,144507,144507,144508,0,1,4
41279,5,2,144512,144512,144514,0,2,4
41280,3,2,144515,144515,144517,0,2,1
41281,6,2,144521,144521,144523,0,2,4
41282,4,3,144525,144525,144528,0,3,2
41283,3,1,144528,144528,144529,0,1,0
41284,3,2,144531,144531,144533,0,2,2
41285,4,3,144535,144535,144538,0,3,2
41286,1,2,144536,144538,144540,2,4,0
41287,5,3,144541,144541,144544,0,3,1
41288,2,3,144543,144544,144547,1,4,0
41289,3,3,144546,144547,144550,1,4,0
41290,3,2,144549,144550,144552,1,3,0
41291,3,3,144552,144552,144555,0,3,0
41292,2,2,144554,144555,144557,1,3,0
41293,6,1,144560,144560,144561,0,1,3
41294,3,1,144563,144563,144564,0,1,2
41295,6,1,144569,144569,144570,0,1,5
41296,4,1,144573,144573,144574,0,1,3
41297,4,3,144577,144577,144580,0,3,3
41298,6,3,144583,144583,144586,0,3,3
41299,6,3,144589,144589,144592,0,3,3
41300,4,3,144593,144593,144596,0,3,1
41301,3,1,144596,144596,144597,0,1,0
41302,1,2,144597,144597,144599,0,2,0
41303,6,3,144603,144603,144606,0,3,4
41304,3,3,144606,144606,144609,0,3,0
41305,1,1,144607,144609,144610,2,3,0
41306,4,3,144611,144611,144614,0,3,1
41307,5,3,144616,144616,144619,0,3,2
41308,3,3,144619,144619,144622,0,3,0
41309,2,1,144621,144622,144623,1,2,0
41310,1,3,144622,144623,144626,1,4,0
41311,5,3,144627,144627,144630,0,3,1
41312,1,2,144628,144630,144632,2,4,0
41313,4,3,144632,144632,144635,0,3,0
41314,4,2,144636,144636,144638,0,2,1
41315,1,1,144637,144638,144639,1,2,0
41316,2,3,144639,144639,144642,0,3,0
41317,3,3,144642,144642,144645,0,3,0
41318,5,1,144647,144647,144648,0,1,2
41319,4,1,144651,144651,144652,0,1,3
41320,3,1,144654,144654,144655,0,1,2
41321,6,1,144660,144660,144661,0,1,5
41322,5,3,144665,144665,144668,0,3,4
41323,4,3,144669,144669,144672,0,3,1
41324,2,3,144671,144672,144675,1,4,0
41325,3,3,144674,144675,144678,1,4,0
41326,6,2,144680,144680,144682,0,2,2
41327,2,3,144682,144682,144685,0,3,0
41328,1,1,144683,144685,144686,2,3,0
41329,4,1,144687,144687,144688,0,1,1
41330,2,1,144689,144689,144690,0,1,1
41331,1,2,144690,144690,144692,0,2,0
41332,1,1,144691,144692,144693,1,2,0
41333,1,2,144692,144693,144695,1,3,0
41334,6,3,144698,144698,144701,0,3,3
41335,5,2,144703,144703,144705,0,2,2
41336,2,1,144705,144705,144706,0,1,0
41337,4,1,144709,144709,144710,0,1,3
41338,4,3,144713,144713,144716,0,3,3
41339,4,2,144717,144717,144719,0,2,1
41340,1,1,144718,144719,144720,1,2,0
41341,1,2,144719,144720,144722,1,3,0
41342,6,3,144725,144725,144728,0,3,3
41343,4,2,144729,144729,144731,0,2,1
41344,4,3,144733,144733,144736,0,3,2
41345,5,2,144738,144738,144740,0,2,2
41346,4,2,144742,144742,144744,0,2,2
41347,5,1,144747,144747,144748,0,1,3
41348,5,2,144752,144752,144754,0,2,4
41349,2,1,144754,144754,144755,0,1,0
41350,3,2,144757,144757,144759,0,2,2
41351,3,2,144760,144760,144762,0,2,1
41352,4,1,144764,144764,144765,0,1,2
41353,2,3,144766,144766,144769,0,3,1
41354,1,2,144767,144769,144771,2,4,0
41355,1,1,144768,144771,144772,3,4,0
41356,2,2,144770,144772,144774,2,4,0
41357,6,2,144776,144776,144778,0,2,2
41358,1,1,144777,144778,144779,1,2,0
41359,4,3,144781,144781,144784,0,3,2
41360,5,3,144786,144786,144789,0,3,2
41361,4,3,144790,144790,144793,0,3,1
41362,4,2,144794,144794,144796,0,2,1
41363,4,1,144798,144798,144799,0,1,2
41364,6,3,144804,144804,144807,0,3,5
41365,2,3,144806,144807,144810,1,4,0
41366,6,1,144812,144812,144813,0,1,2
41367,1,2,144813,144813,144815,0,2,0
41368,1,1,144814,144815,144816,1,2,0
41369,1,2,144815,144816,144818,1,3,0
41370,3,2,144818,144818,144820,0,2,0
41371,2,1,144820,144820,144821,0,1,0
41372,6,3,144826,144826,144829,0,3,5
41373,2,3,144828,144829,144832,1,4,0
41374,2,3,144830,144832,144835,2,5,0
41375,3,1,144833,144835,144836,2,3,0
41376,4,2,144837,144837,144839,0,2,1
41377,3,2,144840,144840,144842,0,2,1
41378,4,2,144844,144844,144846,0,2,2
41379,5,2,144849,144849,144851,0,2,3
41380,4,3,144853,144853,144856,0,3,2
41381,2,2,144855,144856,144858,1,3,0
41382,3,1,144858,144858,144859,0,1,0
41383,2,3,144860,144860,144863,0,3,1
41384,2,3,144862,144863,144866,1,4,0
41385,1,1,144863,144866,144867,3,4,0
41386,4,1,144867,144867,144868,0,1,0
41387,6,1,144873,144873,144874,0,1,5
41388,5,3,144878,144878,144881,0,3,4
41389,4,2,144882,144882,144884,0,2,1
41390,1,1,144883,144884,144885,1,2,0
41391,6,3,144889,144889,144892,0,3,4
41392,3,3,144892,144892,144895,0,3,0
41393,3,3,144895,144895,144898,0,3,0
41394,1,2,144896,144898,144900,2,4,0
41395,1,3,144897,144900,144903,3,6,0
41396,2,1,144899,144903,144904,4,5,0
41397,3,3,144902,144904,144907,2,5,0
41398,2,3,144904,144907,144910,3,6,0
41399,1,3,144905,144910,144913,5,8,0
41400,5,3,144910,144913,144916,3,6,0
41401,1,2,144911,144916,144918,5,7,0
41402,6,3,144917,144918,144921,1,4,0
41403,3,3,144920,144921,144924,1,4,0
41404,5,3,144925,144925,144928,0,3,1
41405,6,3,144931,144931,144934,0,3,3
41406,6,2,144937,144937,144939,0,2,3
41407,5,2,144942,144942,144944,0,2,3
41408,4,2,144946,144946,144948,0,2,2
41409,6,3,144952,144952,144955,0,3,4
41410,2,2,144954,144955,144957,1,3,0
41411,6,2,144960,144960,144962,0,2,3
41412,5,2,144965,144965,144967,0,2,3
41413,5,3,144970,144970,144973,0,3,3
41414,4,1,144974,144974,144975,0,1,1
41415,1,1,144975,144975,144976,0,1,0
41416,1,1,144976,144976,144977,0,1,0
41417,3,2,144979,144979,144981,0,2,2
41418,5,2,144984,144984,144986,0,2,3
41419,1,3,144985,144986,144989,1,4,0
41420,5,1,144990,144990,144991,0,1,1
41421,3,2,144993,144993,144995,0,2,2
41422,1,2,144994,144995,144997,1,3,0
41423,4,2,144998,144998,145000,0,2,1
41424,2,3,145000,145000,145003,0,3,0
41425,1,2,145001,145003,145005,2,4,0
41426,5,2,145006,145006,145008,0,2,1
41427,6,2,145012,145012,145014,0,2,4
41428,5,1,145017,145017,145018,0,1,3
41429,3,2,145020,145020,145022,0,2,2
41430,1,1,145021,145022,145023,1,2,0
41431,1,1,145022,145023,145024,1,2,0
41432,6,1,145028,145028,145029,0,1,4
41433,2,1,145030,145030,145031,0,1,1
41434,2,3,145032,145032,145035,0,3,1
41435,5,1,145037,145037,145038,0,1,2
41436,5,2,145042,145042,145044,0,2,4
41437,4,2,145046,145046,145048,0,2,2
41438,2,2,145048,145048,145050,0,2,0
41439,3,1,145051,145051,145052,0,1,1
41440,5,2,145056,145056,145058,0,2,4
41441,1,1,145057,145058,145059,1,2,0
41442,6,3,145063,145063,145066,0,3,4
41443,1,1,145064,145066,145067,2,3,0
41444,6,3,145070,145070,145073,0,3,3
41445,1,3,145071,145073,145076,2,5,0
41446,3,3,145074,145076,145079,2,5,0
41447,3,1,145077,145079,145080,2,3,0
41448,6,1,145083,145083,145084,0,1,3
41449,2,2,145085,145085,145087,0,2,1
41450,2,1,145087,145087,145088,0,1,0
41451,1,1,145088,145088,145089,0,1,0
41452,1,1,145089,145089,145090,0,1,0
41453,2,2,145091,145091,145093,0,2,1
41454,6,1,145097,145097,145098,0,1,4
41455,4,2,145101,145101,145103,0,2,3
41456,2,3,145103,145103,145106,0,3,0
41457,6,1,145109,145109,145110,0,1,3
41458,1,1,145110,145110,145111,0,1,0
41459,5,3,145115,145115,145118,0,3,4
41460,4,2,145119,145119,145121,0,2,1
41461,3,3,145122,145122,145125,0,3,1
41462,5,2,145127,145127,145129,0,2,2
41463,3,1,145130,145130,145131,0,1,1
41464,6,2,145136,145136,145138,0,2,5
41465,2,3,145138,145138,145141,0,3,0
41466,5,1,145143,145143,145144,0,1,2
41467,1,2,145144,145144,145146,0,2,0
41468,1,3,145145,145146,145149,1,4,0
41469,4,2,145149,145149,145151,0,2,0
41470,4,3,145153,145153,145156,0,3,2
41471,1,1,145154,145156,145157,2,3,0
41472,5,2,145159,145159,145161,0,2,2
41473,3,1,145162,145162,145163,0,1,1
41474,5,1,145167,145167,145168,0,1,4
41475,1,2,145168,145168,145170,0,2,0
41476,5,2,145173,145173,145175,0,2,3
41477,6,3,145179,145179,145182,0,3,4
41478,6,3,145185,145185,145188,0,3,3
41479,2,3,145187,145188,145191,1,4,0
41480,5,1,145192,145192,145193,0,1,1
41481,6,2,145198,145198,145200,0,2,5
41482,2,2,145200,145200,145202,0,2,0
41483,2,3,145202,145202,145205,0,3,0
41484,6,3,145208,145208,145211,0,3,3
41485,5,2,145213,145213,145215,0,2,2
41486,2,1,145215,145215,145216,0,1,0
41487,4,3,145219,145219,145222,0,3,3
41488,1,3,145220,145222,145225,2,5,0
41489,5,1,145225,145225,145226,0,1,0
41490,3,3,145228,145228,145231,0,3,2
41491,4,3,145232,145232,145235,0,3,1
41492,6,2,145238,145238,145240,0,2,3
41493,3,1,145241,145241,145242,0,1,1
41494,2,3,145243,145243,145246,0,3,1
41495,6,3,145249,145249,145252,0,3,3
41496,3,1,145252,145252,145253,0,1,0
41497,1,1,145253,145253,145254,0,1,0
41498,5,1,145258,145258,145259,0,1,4
41499,4,2,145262,145262,145264,0,2,3
41500,6,1,145268,145268,145269,0,1,4
41501,6,1,145274,145274,145275,0,1,5
41502,6,1,145280,145280,145281,0,1,5
41503,3,1,145283,145283,145284,0,1,2
41504,1,1,145284,145284,145285,0,1,0
41505,4,3,145288,145288,145291,0,3,3
41506,1,3,145289,145291,145294,2,5,0
41507,2,3,145291,145294,145297,3,6,0
41508,2,3,145293,145297,145300,4,7,0
41509,5,1,145298,145300,145301,2,3,0
41510,5,1,145303,145303,145304,0,1,2
41511,1,3,145304,145304,145307,0,3,0
41512,2,2,145306,145307,145309,1,3,0
41513,3,3,145309,145309,145312,0,3,0
41514,6,2,145315,145315,145317,0,2,3
41515,6,1,145321,145321,145322,0,1,4
41516,5,2,145326,145326,145328,0,2,4
41517,4,3,145330,145330,145333,0,3,2
41518,1,1,145331,145333,145334,2,3,0
41519,2,3,145333,145334,145337,1,4,0
41520,4,2,145337,145337,145339,0,2,0
41521,1,2,145338,145339,145341,1,3,0
41522,2,2,145340,145341,145343,1,3,0
41523,3,2,145343,145343,145345,0,2,0
41524,1,2,145344,145345,145347,1,3,0
41525,4,1,145348,145348,145349,0,1,1
41526,2,1,145350,145350,145351,0,1,1
41527,2,3,145352,145352,145355,0,3,1
41528,4,2,145356,145356,145358,0,2,1
41529,3,1,145359,145359,145360,0,1,1
41530,4,2,145363,145363,145365,0,2,3
41531,1,1,145364,145365,145366,1,2,0
41532,4,2,145368,145368,145370,0,2,2
41533,4,2,145372,145372,145374,0,2,2
41534,2,2,145374,145374,145376,0,2,0
41535,5,1,145379,145379,145380,0,1,3
41536,3,2,145382,145382,145384,0,2,2
41537,3,2,145385,145385,145387,0,2,1
41538,6,2,145391,145391,145393,0,2,4
41539,4,3,145395,145395,145398,0,3,2
41540,5,2,145400,145400,145402,0,2,2
41541,3,3,145403,145403,145406,0,3,1
41542,4,2,145407,145407,145409,0,2,1
41543,1,3,145408,145409,145412,1,4,0
41544,3,1,145411,145412,145413,1,2,0
41545,6,3,145417,145417,145420,0,3,4
41546,2,2,145419,145420,145422,1,3,0
41547,2,2,145421,145422,145424,1,3,0
41548,4,3,145425,145425,145428,0,3,1
41549,1,3,145426,145428,145431,2,5,0
41550,3,1,145429,145431,145432,2,3,0
41551,1,3,145430,145432,145435,2,5,0
41552,4,2,145434,145435,145437,1,3,0
41553,6,3,145440,145440,145443,0,3,3
41554,6,2,145446,145446,145448,0,2,3
41555,5,2,145451,145451,145453,0,2,3
41556,6,1,145457,145457,145458,0,1,4
41557,4,3,145461,145461,145464,0,3,3
41558,3,1,145464,145464,145465,0,1,0
41559,3,3,145467,145467,145470,0,3,2
41560,4,2,145471,145471,145473,0,2,1
41561,6,2,145477,145477,145479,0,2,4
41562,6,3,145483,145483,145486,0,3,4
41563,4,2,145487,145487,145489,0,2,1
41564,4,1,145491,145491,145492,0,1,2
41565,2,2,145493,145493,145495,0,2,1
41566,5,2,145498,145498,145500,0,2,3
41567,5,2,145503,145503,145505,0,2,3
41568,2,2,145505,145505,145507,0,2,0
41569,1,2,145506,145507,145509,1,3,0
41570,5,3,145511,145511,145514,0,3,2
41571,6,1,145517,145517,145518,0,1,3
41572,6,3,145523,145523,145526,0,3,5
41573,3,2,145526,145526,145528,0,2,0
41574,5,3,145531,145531,145534,0,3,3
41575,4,1,145535,145535,145536,0,1,1
41576,1,3,145536,145536,145539,0,3,0
41577,6,3,145542,145542,145545,0,3,3
41578,1,1,145543,145545,145546,2,3,0
41579,2,1,145545,145546,145547,1,2,0
41580,6,1,145551,145551,145552,0,1,4
41581,3,3,145554,145554,145557,0,3,2
41582,2,3,145556,145557,145560,1,4,0
41583,1,2,145557,145560,145562,3,5,0
41584,3,3,145560,145562,145565,2,5,0
41585,3,3,145563,145565,145568,2,5,0
41586,3,2,145566,145568,145570,2,4,0
41587,2,3,145568,145570,145573,2,5,0
41588,6,3,145574,145574,145577,0,3,1
41589,5,2,145579,145579,145581,0,2,2
41590,4,2,145583,145583,145585,0,2,2
41591,5,2,145588,145588,145590,0,2,3
41592,5,3,145593,145593,145596,0,3,3
41593,3,3,145596,145596,145599,0,3,0
41594,4,1,145600,145600,145601,0,1,1
41595,4,3,145604,145604,145607,0,3,3
41596,3,2,145607,145607,145609,0,2,0
41597,2,3,145609,145609,145612,0,3,0
41598,5,2,145614,145614,145616,0,2,2
41599,5,2,145619,145619,145621,0,2,3
41600,4,3,145623,145623,145626,0,3,2
41601,3,2,145626,145626,145628,0,2,0
41602,1,1,145627,145628,145629,1,2,0
41603,6,2,145633,145633,145635,0,2,4
41604,4,3,145637,145637,145640,0,3,2
41605,2,1,145639,145640,145641,1,2,0
41606,3,2,145642,145642,145644,0,2,1
41607,2,1,145644,145644,145645,0,1,0
41608,6,2,145650,145650,145652,0,2,5
41609,3,3,145653,145653,145656,0,3,1
41610,5,3,145658,145658,145661,0,3,2
41611,3,1,145661,145661,145662,0,1,0
41612,5,2,145666,145666,145668,0,2,4
41613,1,2,145667,145668,145670,1,3,0
41614,6,2,145673,145673,145675,0,2,3
41615,3,1,145676,145676,145677,0,1,1
41616,1,3,145677,145677,145680,0,3,0
41617,2,1,145679,145680,145681,1,2,0
41618,4,3,145683,145683,145686,0,3,2
41619,6,3,145689,145689,145692,0,3,3
41620,1,2,145690,145692,145694,2,4,0
41621,2,2,145692,145694,145696,2,4,0
41622,3,1,145695,145696,145697,1,2,0
41623,3,1,145698,145698,145699,0,1,1
41624,2,2,145700,145700,145702,0,2,1
41625,6,1,145706,145706,145707,0,1,4
41626,2,3,145708,145708,145711,0,3,1
41627,2,2,145710,145711,145713,1,3,0
41628,3,1,145713,145713,145714,0,1,0
41629,2,1,145715,145715,145716,0,1,1
41630,5,2,145720,145720,145722,0,2,4
41631,5,3,145725,145725,145728,0,3,3
41632,6,2,145731,145731,145733,0,2,3
41633,3,2,145734,145734,145736,0,2,1
41634,4,3,145738,145738,145741,0,3,2
41635,2,1,145740,145741,145742,1,2,0
41636,6,1,145746,145746,145747,0,1,4
41637,4,1,145750,145750,145751,0,1,3
41638,5,2,145755,145755,145757,0,2,4
41639,2,3,145757,145757,145760,0,3,0
41640,1,3,145758,145760,145763,2,5,0
41641,1,1,145759,145763,145764,4,5,0
41642,2,3,145761,145764,145767,3,6,0
41643,5,1,145766,145767,145768,1,2,0
41644,5,2,145771,145771,145773,0,2,3
41645,2,2,145773,145773,145775,0,2,0
41646,5,2,145778,145778,145780,0,2,3
41647,1,3,145779,145780,145783,1,4,0
41648,4,2,145783,145783,145785,0,2,0
41649,1,3,145784,145785,145788,1,4,0
41650,5,2,145789,145789,145791,0,2,1
41651,6,2,145795,145795,145797,0,2,4
41652,3,1,145798,145798,145799,0,1,1
41653,5,2,145803,145803,145805,0,2,4
41654,6,2,145809,145809,145811,0,2,4
41655,4,3,145813,145813,145816,0,3,2
41656,3,3,145816,145816,145819,0,3,0
41657,5,2,145821,145821,145823,0,2,2
41658,6,1,145827,145827,145828,0,1,4
41659,6,3,145833,145833,145836,0,3,5
41660,3,1,145836,145836,145837,0,1,0
41661,4,1,145840,145840,145841,0,1,3
41662,6,1,145846,145846,145847,0,1,5
41663,1,1,145847,145847,145848,0,1,0
41664,5,1,145852,145852,145853,0,1,4
41665,1,2,145853,145853,145855,0,2,0
41666,5,2,145858,145858,145860,0,2,3
41667,3,3,145861,145861,145864,0,3,1
41668,1,3,145862,145864,145867,2,5,0
41669,2,2,145864,145867,145869,3,5,0
41670,5,2,145869,145869,145871,0,2,0
41671,1,2,145870,145871,145873,1,3,0
41672,1,1,145871,145873,145874,2,3,0
41673,4,2,145875,145875,145877,0,2,1
41674,3,1,145878,145878,145879,0,1,1
41675,6,3,145884,145884,145887,0,3,5
41676,4,2,145888,145888,145890,0,2,1
41677,4,1,145892,145892,145893,0,1,2
41678,5,2,145897,145897,145899,0,2,4
41679,6,3,145903,145903,145906,0,3,4
41680,3,1,145906,145906,145907,0,1,0
41681,4,1,145910,145910,145911,0,1,3
41682,6,3,145916,145916,145919,0,3,5
41683,2,3,145918,145919,145922,1,4,0
41684,4,3,145922,145922,145925,0,3,0
41685,6,3,145928,145928,145931,0,3,3
41686,1,2,145929,145931,145933,2,4,0
41687,5,2,145934,145934,145936,0,2,1
41688,5,3,145939,145939,145942,0,3,3
41689,6,3,145945,145945,145948,0,3,3
41690,2,3,145947,145948,145951,1,4,0
41691,5,1,145952,145952,145953,0,1,1
41692,4,2,145956,145956,145958,0,2,3
41693,3,2,145959,145959,145961,0,2,1
41694,1,2,145960,145961,145963,1,3,0
41695,4,1,145964,145964,145965,0,1,1
41696,6,3,145970,145970,145973,0,3,5
41697,6,1,145976,145976,145977,0,1,3
41698,6,2,145982,145982,145984,0,2,5
41699,3,1,145985,145985,145986,0,1,1
41700,5,3,145990,145990,145993,0,3,4
41701,6,2,145996,145996,145998,0,2,3
41702,2,1,145998,145998,145999,0,1,0
41703,4,2,146002,146002,146004,0,2,3
41704,5,3,146007,146007,146010,0,3,3
41705,5,3,146012,146012,146015,0,3,2
41706,6,2,146018,146018,146020,0,2,3
41707,4,1,146022,146022,146023,0,1,2
41708,2,2,146024,146024,146026,0,2,1
41709,4,1,146028,146028,146029,0,1,2
41710,5,1,146033,146033,146034,0,1,4
41711,2,3,146035,146035,146038,0,3,1
41712,4,3,146039,146039,146042,0,3,1
41713,5,2,146044,146044,146046,0,2,2
41714,1,3,146045,146046,146049,1,4,0
41715,4,2,146049,146049,146051,0,2,0
41716,5,2,146054,146054,146056,0,2,3
41717,5,1,146059,146059,146060,0,1,3
41718,2,3,146061,146061,146064,0,3,1
41719,1,1,146062,146064,146065,2,3,0
41720,5,1,146067,146067,146068,0,1,2
41721,1,3,146068,146068,146071,0,3,0
41722,4,1,146072,146072,146073,0,1,1
41723,1,1,146073,146073,146074,0,1,0
41724,5,3,146078,146078,146081,0,3,4
41725,4,2,146082,146082,146084,0,2,1
41726,4,1,146086,146086,146087,0,1,2
41727,4,2,146090,146090,146092,0,2,3
41728,2,1,146092,146092,146093,0,1,0
41729,4,3,146096,146096,146099,0,3,3
41730,2,3,146098,146099,146102,1,4,0
41731,3,3,146101,146102,146105,1,4,0
41732,2,3,146103,146105,146108,2,5,0
41733,5,1,146108,146108,146109,0,1,0
41734,5,3,146113,146113,146116,0,3,4
41735,3,3,146116,146116,146119,0,3,0
41736,1,3,146117,146119,146122,2,5,0
41737,3,2,146120,146122,146124,2,4,0
41738,6,3,146126,146126,146129,0,3,2
41739,1,1,146127,146129,146130,2,3,0
41740,2,2,146129,146130,146132,1,3,0
41741,4,1,146133,146133,146134,0,1,1
41742,5,3,146138,146138,146141,0,3,4
41743,5,2,146143,146143,146145,0,2,2
41744,2,1,146145,146145,146146,0,1,0
41745,3,3,146148,146148,146151,0,3,2
41746,3,1,146151,146151,146152,0,1,0
41747,2,2,146153,146153,146155,0,2,1
41748,4,1,146157,146157,146158,0,1,2
41749,4,1,146161,146161,146162,0,1,3
41750,5,3,146166,146166,146169,0,3,4
41751,2,2,146168,146169,146171,1,3,0
41752,5,2,146173,146173,146175,0,2,2
41753,1,2,146174,146175,146177,1,3,0
41754,2,2,146176,146177,146179,1,3,0
41755,4,3,146180,146180,146183,0,3,1
41756,5,3,146185,146185,146188,0,3,2
41757,2,3,146187,146188,146191,1,4,0
41758,5,3,146192,146192,146195,0,3,1
41759,4,1,146196,146196,146197,0,1,1
41760,1,1,146197,146197,146198,0,1,0
41761,6,1,146203,146203,146204,0,1,5
41762,4,1,146207,146207,146208,0,1,3
41763,2,2,146209,146209,146211,0,2,1
41764,3,1,146212,146212,146213,0,1,1
41765,6,3,146218,146218,146221,0,3,5
41766,4,2,146222,146222,146224,0,2,1
41767,3,2,146225,146225,146227,0,2,1
41768,1,2,146226,146227,146229,1,3,0
41769,1,2,146227,146229,146231,2,4,0
41770,4,1,146231,146231,146232,0,1,0
41771,6,1,146237,146237,146238,0,1,5
41772,2,2,146239,146239,146241,0,2,1
41773,2,2,146241,146241,146243,0,2,0
41774,2,1,146243,146243,146244,0,1,0
41775,1,2,146244,146244,146246,0,2,0
41776,1,1,146245,146246,146247,1,2,0
41777,2,1,146247,146247,146248,0,1,0
41778,1,2,146248,146248,146250,0,2,0
41779,4,3,146252,146252,146255,0,3,2
41780,2,2,146254,146255,146257,1,3,0
41781,1,2,146255,146257,146259,2,4,0
41782,5,2,146260,146260,146262,0,2,1
41783,6,1,146266,146266,146267,0,1,4
41784,4,3,146270,146270,146273,0,3,3
41785,5,2,146275,146275,146277,0,2,2
41786,4,1,146279,146279,146280,0,1,2
41787,5,1,146284,146284,146285,0,1,4
41788,4,3,146288,146288,146291,0,3,3
41789,6,1,146294,146294,146295,0,1,3
41790,6,1,146300,146300,146301,0,1,5
41791,1,1,146301,146301,146302,0,1,0
41792,3,1,146304,146304,146305,0,1,2
41793,2,3,146306,146306,146309,0,3,1
41794,4,3,146310,146310,146313,0,3,1
41795,5,1,146315,146315,146316,0,1,2
41796,3,3,146318,146318,146321,0,3,2
41797,4,1,146322,146322,146323,0,1,1
41798,1,2,146323,146323,146325,0,2,0
41799,6,3,146329,146329,146332,0,3,4
41800,3,1,146332,146332,146333,0,1,0
41801,6,3,146338,146338,146341,0,3,5
41802,5,1,146343,146343,146344,0,1,2
41803,6,2,146349,146349,146351,0,2,5
41804,2,1,146351,146351,146352,0,1,0
41805,2,2,146353,146353,146355,0,2,1
41806,2,3,146355,146355,146358,0,3,0
41807,2,3,146357,146358,146361,1,4,0
41808,5,3,146362,146362,146365,0,3,1
41809,2,3,146364,146365,146368,1,4,0
41810,2,1,146366,146368,146369,2,3,0
41811,3,1,146369,146369,146370,0,1,0
41812,2,1,146371,146371,146372,0,1,1
41813,1,3,146372,146372,146375,0,3,0
41814,4,1,146376,146376,146377,0,1,1
41815,4,1,146380,146380,146381,0,1,3
41816,2,2,146382,146382,146384,0,2,1
41817,3,2,146385,146385,146387,0,2,1
41818,4,3,146389,146389,146392,0,3,2
41819,3,1,146392,146392,146393,0,1,0
41820,6,2,146398,146398,146400,0,2,5
41821,5,3,146403,146403,146406,0,3,3
41822,5,3,146408,146408,146411,0,3,2
41823,3,3,146411,146411,146414,0,3,0
41824,3,1,146414,146414,146415,0,1,0
41825,4,3,146418,146418,146421,0,3,3
41826,4,2,146422,146422,146424,0,2,1
41827,5,2,146427,146427,146429,0,2,3
41828,3,2,146430,146430,146432,0,2,1
41829,2,3,146432,146432,146435,0,3,0
41830,5,3,146437,146437,146440,0,3,2
41831,4,2,146441,146441,146443,0,2,1
41832,4,3,146445,146445,146448,0,3,2
41833,4,1,146449,146449,146450,0,1,1
41834,3,2,146452,146452,146454,0,2,2
41835,6,3,146458,146458,146461,0,3,4
41836,1,1,146459,146461,146462,2,3,0
41837,4,1,146463,146463,146464,0,1,1
41838,4,2,146467,146467,146469,0,2,3
41839,4,3,146471,146471,146474,0,3,2
41840,1,2,146472,146474,146476,2,4,0
41841,2,3,146474,146476,146479,2,5,0
41842,1,3,146475,146479,146482,4,7,0
41843,1,1,146476,146482,146483,6,7,0
41844,2,2,146478,146483,146485,5,7,0
41845,2,2,146480,146485,146487,5,7,0
41846,3,2,146483,146487,146489,4,6,0
41847,3,3,146486,146489,146492,3,6,0
41848,2,1,146488,146492,146493,4,5,0
41849,2,2,146490,146493,146495,3,5,0
41850,4,1,146494,146495,146496,1,2,0
41851,3,2,146497,146497,146499,0,2,1
41852,3,3,146500,146500,146503,0,3,1
41853,5,3,146505,146505,146508,0,3,2
41854,1,2,146506,146508,146510,2,4,0
41855,2,2,146508,146510,146512,2,4,0
41856,2,2,146510,146512,146514,2,4,0
41857,6,2,146516,146516,146518,0,2,2
41858,5,2,146521,146521,146523,0,2,3
41859,3,1,146524,146524,146525,0,1,1
41860,6,3,146530,146530,146533,0,3,5
41861,1,1,146531,146533,146534,2,3,0
41862,4,1,146535,146535,146536,0,1,1
41863,6,2,146541,146541,146543,0,2,5
41864,6,1,146547,146547,146548,0,1,4
41865,6,2,146553,146553,146555,0,2,5
41866,4,2,146557,146557,146559,0,2,2
41867,4,2,146561,146561,146563,0,2,2
41868,4,1,146565,146565,146566,0,1,2
41869,5,1,146570,146570,146571,0,1,4
41870,5,1,146575,146575,146576,0,1,4
41871,2,2,146577,146577,146579,0,2,1
41872,2,3,146579,146579,146582,0,3,0
41873,3,2,146582,146582,146584,0,2,0
41874,5,1,146587,146587,146588,0,1,3
41875,3,2,146590,146590,146592,0,2,2
41876,6,1,146596,146596,146597,0,1,4
41877,6,2,146602,146602,146604,0,2,5
41878,6,2,146608,146608,146610,0,2,4
41879,6,2,146614,146614,146616,0,2,4
41880,5,3,146619,146619,146622,0,3,3
41881,6,2,146625,146625,146627,0,2,3
41882,1,1,146626,146627,146628,1,2,0
41883,2,1,146628,146628,146629,0,1,0
41884,1,3,146629,146629,146632,0,3,0
41885,4,1,146633,146633,146634,0,1,1
41886,3,2,146636,146636,146638,0,2,2
41887,4,3,146640,146640,146643,0,3,2
41888,4,3,146644,146644,146647,0,3,1
41889,2,1,146646,146647,146648,1,2,0
41890,3,3,146649,146649,146652,0,3,1
41891,1,3,146650,146652,146655,2,5,0
41892,3,3,146653,146655,146658,2,5,0
41893,6,2,146659,146659,146661,0,2,1
41894,5,3,146664,146664,146667,0,3,3
41895,1,2,146665,146667,146669,2,4,0
41896,1,3,146666,146669,146672,3,6,0
41897,6,2,146672,146672,146674,0,2,0
41898,4,1,146676,146676,146677,0,1,2
41899,5,1,146681,146681,146682,0,1,4
41900,4,1,146685,146685,146686,0,1,3
41901,4,3,146689,146689,146692,0,3,3
41902,6,1,146695,146695,146696,0,1,3
41903,5,2,146700,146700,146702,0,2,4
41904,6,3,146706,146706,146709,0,3,4
41905,5,2,146711,146711,146713,0,2,2
41906,2,1,146713,146713,146714,0,1,0
41907,6,2,146719,146719,146721,0,2,5
41908,2,1,146721,146721,146722,0,1,0
41909,5,2,146726,146726,146728,0,2,4
41910,2,2,146728,146728,146730,0,2,0
41911,4,3,146732,146732,146735,0,3,2
41912,3,3,146735,146735,146738,0,3,0
41913,3,1,146738,146738,146739,0,1,0
41914,6,1,146744,146744,146745,0,1,5
41915,4,2,146748,146748,146750,0,2,3
41916,3,1,146751,146751,146752,0,1,1
41917,4,2,146755,146755,146757,0,2,3
41918,1,2,146756,146757,146759,1,3,0
41919,6,2,146762,146762,146764,0,2,3
41920,6,1,146768,146768,146769,0,1,4
41921,5,2,146773,146773,146775,0,2,4
41922,5,3,146778,146778,146781,0,3,3
41923,1,3,146779,146781,146784,2,5,0
41924,2,3,146781,146784,146787,3,6,0
41925,3,2,146784,146787,146789,3,5,0
41926,3,1,146787,146789,146790,2,3,0
41927,4,2,146791,146791,146793,0,2,1
41928,5,3,146796,146796,146799,0,3,3
41929,1,1,146797,146799,146800,2,3,0
41930,5,1,146802,146802,146803,0,1,2
41931,2,3,146804,146804,146807,0,3,1
41932,1,1,146805,146807,146808,2,3,0
41933,2,1,146807,146808,146809,1,2,0
41934,5,3,146812,146812,146815,0,3,3
41935,2,3,146814,146815,146818,1,4,0
41936,1,3,146815,146818,146821,3,6,0
41937,1,2,146816,146821,146823,5,7,0
41938,6,1,146822,146823,146824,1,2,0
41939,4,2,146826,146826,146828,0,2,2
41940,4,3,146830,146830,146833,0,3,2
41941,2,3,146832,146833,146836,1,4,0
41942,1,3,146833,146836,146839,3,6,0
41943,6,2,146839,146839,146841,0,2,0
41944,2,2,146841,146841,146843,0,2,0
41945,1,2,146842,146843,146845,1,3,0
41946,4,3,146846,146846,146849,0,3,1
41947,3,3,146849,146849,146852,0,3,0
41948,4,2,146853,146853,146855,0,2,1
41949,1,1,146854,146855,146856,1,2,0
41950,5,2,146859,146859,146861,0,2,3
41951,6,3,146865,146865,146868,0,3,4
41952,5,1,146870,146870,146871,0,1,2
41953,6,3,146876,146876,146879,0,3,5
41954,1,3,146877,146879,146882,2,5,0
41955,6,2,146883,146883,146885,0,2,1
41956,2,3,146885,146885,146888,0,3,0
41957,6,1,146891,146891,146892,0,1,3
41958,1,1,146892,146892,146893,0,1,0
41959,4,3,146896,146896,146899,0,3,3
41960,6,1,146902,146902,146903,0,1,3
41961,6,3,146908,146908,146911,0,3,5
41962,3,3,146911,146911,146914,0,3,0
41963,5,2,146916,146916,146918,0,2,2
41964,4,1,146920,146920,146921,0,1,2
41965,6,2,146926,146926,146928,0,2,5
41966,1,2,146927,146928,146930,1,3,0
41967,3,3,146930,146930,146933,0,3,0
41968,4,1,146934,146934,146935,0,1,1
41969,2,3,146936,146936,146939,0,3,1
41970,5,1,146941,146941,146942,0,1,2
41971,3,3,146944,146944,146947,0,3,2
41972,4,3,146948,146948,146951,0,3,1
41973,3,3,146951,146951,146954,0,3,0
41974,6,3,146957,146957,146960,0,3,3
41975,5,1,146962,146962,146963,0,1,2
41976,6,1,146968,146968,146969,0,1,5
41977,6,1,146974,146974,146975,0,1,5
41978,1,1,146975,146975,146976,0,1,0
41979,3,1,146978,146978,146979,0,1,2
41980,5,1,146983,146983,146984,0,1,4
41981,1,2,146984,146984,146986,0,2,0
41982,1,1,146985,146986,146987,1,2,0
41983,1,3,146986,146987,146990,1,4,0
41984,6,2,146992,146992,146994,0,2,2
41985,2,3,146994,146994,146997,0,3,0
41986,3,2,146997,146997,146999,0,2,0
41987,4,3,147001,147001,147004,0,3,2
41988,4,2,147005,147005,147007,0,2,1
41989,1,2,147006,147007,147009,1,3,0
41990,3,2,147009,147009,147011,0,2,0
41991,3,2,147012,147012,147014,0,2,1
41992,1,3,147013,147014,147017,1,4,0
41993,5,1,147018,147018,147019,0,1,1
41994,6,2,147024,147024,147026,0,2,5
41995,3,3,147027,147027,147030,0,3,1
41996,2,2,147029,147030,147032,1,3,0
41997,6,2,147035,147035,147037,0,2,3
41998,3,2,147038,147038,147040,0,2,1
41999,2,3,147040,147040,147043,0,3,0
42000,5,2,147045,147045,147047,0,2,2
42001,4,1,147049,147049,147050,0,1,2
42002,5,3,147054,147054,147057,0,3,4
42003,2,2,147056,147057,147059,1,3,0
42004,6,2,147062,147062,147064,0,2,3
42005,1,1,147063,147064,147065,1,2,0
42006,2,3,147065,147065,147068,0,3,0
42007,4,3,147069,147069,147072,0,3,1
42008,4,1,147073,147073,147074,0,1,1
42009,4,2,147077,147077,147079,0,2,3
42010,3,3,147080,147080,147083,0,3,1
42011,4,1,147084,147084,147085,0,1,1
42012,2,3,147086,147086,147089,0,3,1
42013,4,3,147090,147090,147093,0,3,1
42014,6,2,147096,147096,147098,0,2,3
42015,4,2,147100,147100,147102,0,2,2
42016,6,2,147106,147106,147108,0,2,4
42017,2,2,147108,147108,147110,0,2,0
42018,3,2,147111,147111,147113,0,2,1
42019,3,2,147114,147114,147116,0,2,1
42020,6,3,147120,147120,147123,0,3,4
42021,1,1,147121,147123,147124,2,3,0
42022,2,3,147123,147124,147127,1,4,0
42023,5,1,147128,147128,147129,0,1,1
42024,6,1,147134,147134,147135,0,1,5
42025,2,3,147136,147136,147139,0,3,1
42026,3,1,147139,147139,147140,0,1,0
42027,2,1,147141,147141,147142,0,1,1
42028,1,2,147142,147142,147144,0,2,0
42029,5,2,147147,147147,147149,0,2,3
42030,6,3,147153,147153,147156,0,3,4
42031,5,1,147158,147158,147159,0,1,2
42032,2,3,147160,147160,147163,0,3,1
42033,2,2,147162,147163,147165,1,3,0
42034,3,2,147165,147165,147167,0,2,0
42035,3,3,147168,147168,147171,0,3,1
42036,5,2,147173,147173,147175,0,2,2
42037,3,2,147176,147176,147178,0,2,1
42038,6,3,147182,147182,147185,0,3,4
42039,6,2,147188,147188,147190,0,2,3
42040,3,3,147191,147191,147194,0,3,1
42041,6,1,147197,147197,147198,0,1,3
42042,2,3,147199,147199,147202,0,3,1
42043,5,2,147204,147204,147206,0,2,2
42044,4,1,147208,147208,147209,0,1,2
42045,2,1,147210,147210,147211,0,1,1
42046,6,2,147216,147216,147218,0,2,5
42047,6,1,147222,147222,147223,0,1,4
42048,4,3,147226,147226,147229,0,3,3
42049,3,2,147229,147229,147231,0,2,0
42050,5,3,147234,147234,147237,0,3,3
42051,6,2,147240,147240,147242,0,2,3
42052,3,2,147243,147243,147245,0,2,1
42053,4,3,147247,147247,147250,0,3,2
42054,4,1,147251,147251,147252,0,1,1
42055,5,2,147256,147256,147258,0,2,4
42056,6,2,147262,147262,147264,0,2,4
42057,6,3,147268,147268,147271,0,3,4
42058,3,2,147271,147271,147273,0,2,0
42059,6,1,147277,147277,147278,0,1,4
42060,4,1,147281,147281,147282,0,1,3
42061,2,3,147283,147283,147286,0,3,1
42062,5,3,147288,147288,147291,0,3,2
42063,3,1,147291,147291,147292,0,1,0
42064,5,1,147296,147296,147297,0,1,4
42065,6,2,147302,147302,147304,0,2,5
42066,6,3,147308,147308,147311,0,3,4
42067,6,1,147314,147314,147315,0,1,3
42068,3,1,147317,147317,147318,0,1,2
42069,6,1,147323,147323,147324,0,1,5
42070,3,2,147326,147326,147328,0,2,2
42071,6,1,147332,147332,147333,0,1,4
42072,5,3,147337,147337,147340,0,3,4
42073,2,1,147339,147340,147341,1,2,0
42074,5,2,147344,147344,147346,0,2,3
42075,1,1,147345,147346,147347,1,2,0
42076,4,2,147349,147349,147351,0,2,2
42077,6,2,147355,147355,147357,0,2,4
42078,2,2,147357,147357,147359,0,2,0
42079,5,3,147362,147362,147365,0,3,3
42080,3,3,147365,147365,147368,0,3,0
42081,1,3,147366,147368,147371,2,5,0
42082,5,2,147371,147371,147373,0,2,0
42083,2,1,147373,147373,147374,0,1,0
42084,1,2,147374,147374,147376,0,2,0
42085,5,2,147379,147379,147381,0,2,3
42086,3,2,147382,147382,147384,0,2,1
42087,2,1,147384,147384,147385,0,1,0
42088,4,2,147388,147388,147390,0,2,3
42089,2,2,147390,147390,147392,0,2,0
42090,1,2,147391,147392,147394,1,3,0
42091,4,2,147395,147395,147397,0,2,1
42092,4,1,147399,147399,147400,0,1,2
42093,1,2,147400,147400,147402,0,2,0
42094,6,3,147406,147406,147409,0,3,4
42095,1,3,147407,147409,147412,2,5,0
42096,3,3,147410,147412,147415,2,5,0
42097,3,3,147413,147415,147418,2,5,0
42098,5,3,147418,147418,147421,0,3,0
42099,4,2,147422,147422,147424,0,2,1
42100,6,3,147428,147428,147431,0,3,4
42101,3,3,147431,147431,147434,0,3,0
42102,3,2,147434,147434,147436,0,2,0
42103,3,1,147437,147437,147438,0,1,1
42104,5,3,147442,147442,147445,0,3,4
42105,2,1,147444,147445,147446,1,2,0
42106,6,3,147450,147450,147453,0,3,4
42107,6,2,147456,147456,147458,0,2,3
42108,1,3,147457,147458,147461,1,4,0
42109,2,1,147459,147461,147462,2,3,0
42110,6,3,147465,147465,147468,0,3,3
42111,1,1,147466,147468,147469,2,3,0
42112,2,3,147468,147469,147472,1,4,0
42113,5,2,147473,147473,147475,0,2,1
42114,3,3,147476,147476,147479,0,3,1
42115,2,1,147478,147479,147480,1,2,0
42116,6,2,147484,147484,147486,0,2,4
42117,3,1,147487,147487,147488,0,1,1
42118,3,3,147490,147490,147493,0,3,2
42119,2,1,147492,147493,147494,1,2,0
42120,2,1,147494,147494,147495,0,1,0
42121,2,3,147496,147496,147499,0,3,1
42122,6,2,147502,147502,147504,0,2,3
42123,2,1,147504,147504,147505,0,1,0
42124,2,2,147506,147506,147508,0,2,1
42125,5,3,147511,147511,147514,0,3,3
42126,2,3,147513,147514,147517,1,4,0
42127,6,2,147519,147519,147521,0,2,2
42128,5,1,147524,147524,147525,0,1,3
42129,3,3,147527,147527,147530,0,3,2
42130,3,1,147530,147530,147531,0,1,0
42131,1,3,147531,147531,147534,0,3,0
42132,2,3,147533,147534,147537,1,4,0
42133,5,3,147538,147538,147541,0,3,1
42134,1,3,147539,147541,147544,2,5,0
42135,4,1,147543,147544,147545,1,2,0
42136,6,1,147549,147549,147550,0,1,4
42137,2,2,147551,147551,147553,0,2,1
42138,5,3,147556,147556,147559,0,3,3
42139,3,2,147559,147559,147561,0,2,0
42140,6,2,147565,147565,147567,0,2,4
42141,5,2,147570,147570,147572,0,2,3
42142,5,1,147575,147575,147576,0,1,3
42143,2,2,147577,147577,147579,0,2,1
42144,2,2,147579,147579,147581,0,2,0
42145,1,3,147580,147581,147584,1,4,0
42146,6,3,147586,147586,147589,0,3,2
42147,3,1,147589,147589,147590,0,1,0
42148,4,2,147593,147593,147595,0,2,3
42149,6,1,147599,147599,147600,0,1,4
42150,5,1,147604,147604,147605,0,1,4
42151,6,3,147610,147610,147613,0,3,5
42152,3,2,147613,147613,147615,0,2,0
42153,2,3,147615,147615,147618,0,3,0
42154,6,3,147621,147621,147624,0,3,3
42155,1,2,147622,147624,147626,2,4,0
42156,5,1,147627,147627,147628,0,1,1
42157,3,1,147630,147630,147631,0,1,2
42158,1,2,147631,147631,147633,0,2,0
42159,4,1,147635,147635,147636,0,1,2
42160,3,3,147638,147638,147641,0,3,2
42161,5,1,147643,147643,147644,0,1,2
42162,4,2,147647,147647,147649,0,2,3
42163,3,1,147650,147650,147651,0,1,1
42164,3,3,147653,147653,147656,0,3,2
42165,3,1,147656,147656,147657,0,1,0
42166,1,2,147657,147657,147659,0,2,0
42167,1,3,147658,147659,147662,1,4,0
42168,1,2,147659,147662,147664,3,5,0
42169,1,3,147660,147664,147667,4,7,0
42170,1,3,147661,147667,147670,6,9,0
42171,4,3,147665,147670,147673,5,8,0
42172,2,1,147667,147673,147674,6,7,0
42173,6,3,147673,147674,147677,1,4,0
42174,5,1,147678,147678,147679,0,1,1
42175,1,1,147679,147679,147680,0,1,0
42176,1,3,147680,147680,147683,0,3,0
42177,1,3,147681,147683,147686,2,5,0
42178,6,1,147687,147687,147688,0,1,1
42179,1,1,147688,147688,147689,0,1,0
42180,6,1,147694,147694,147695,0,1,5
42181,2,1,147696,147696,147697,0,1,1
42182,1,1,147697,147697,147698,0,1,0
42183,2,1,147699,147699,147700,0,1,1
42184,1,3,147700,147700,147703,0,3,0
42185,2,1,147702,147703,147704,1,2,0
42186,1,3,147703,147704,147707,1,4,0
42187,4,2,147707,147707,147709,0,2,0
42188,3,1,147710,147710,147711,0,1,1
42189,6,2,147716,147716,147718,0,2,5
42190,5,3,147721,147721,147724,0,3,3
42191,3,1,147724,147724,147725,0,1,0
42192,6,2,147730,147730,147732,0,2,5
42193,3,1,147733,147733,147734,0,1,1
42194,3,2,147736,147736,147738,0,2,2
42195,1,3,147737,147738,147741,1,4,0
42196,2,3,147739,147741,147744,2,5,0
42197,6,3,147745,147745,147748,0,3,1
42198,5,3,147750,147750,147753,0,3,2
42199,4,1,147754,147754,147755,0,1,1
42200,1,1,147755,147755,147756,0,1,0
42201,3,1,147758,147758,147759,0,1,2
42202,6,2,147764,147764,147766,0,2,5
42203,6,1,147770,147770,147771,0,1,4
42204,4,2,147774,147774,147776,0,2,3
42205,1,1,147775,147776,147777,1,2,0
42206,6,3,147781,147781,147784,0,3,4
42207,6,1,147787,147787,147788,0,1,3
42208,5,1,147792,147792,147793,0,1,4
42209,5,1,147797,147797,147798,0,1,4
42210,3,2,147800,147800,147802,0,2,2
42211,2,1,147802,147802,147803,0,1,0
42212,3,3,147805,147805,147808,0,3,2
42213,1,2,147806,147808,147810,2,4,0
42214,2,3,147808,147810,147813,2,5,0
42215,1,1,147809,147813,147814,4,5,0
42216,1,3,147810,147814,147817,4,7,0
42217,6,3,147816,147817,147820,1,4,0
42218,3,3,147819,147820,147823,1,4,0
42219,6,3,147825,147825,147828,0,3,2
42220,2,3,147827,147828,147831,1,4,0
42221,6,3,147833,147833,147836,0,3,2
42222,6,2,147839,147839,147841,0,2,3
42223,3,1,147842,147842,147843,0,1,1
42224,2,1,147844,147844,147845,0,1,1
42225,1,3,147845,147845,147848,0,3,0
42226,3,1,147848,147848,147849,0,1,0
42227,2,2,147850,147850,147852,0,2,1
42228,1,2,147851,147852,147854,1,3,0
42229,1,1,147852,147854,147855,2,3,0
42230,3,2,147855,147855,147857,0,2,0
42231,3,2,147858,147858,147860,0,2,1
42232,2,3,147860,147860,147863,0,3,0
42233,2,2,147862,147863,147865,1,3,0
42234,2,3,147864,147865,147868,1,4,0
42235,1,2,147865,147868,147870,3,5,0
42236,2,2,147867,147870,147872,3,5,0
42237,4,1,147871,147872,147873,1,2,0
42238,1,2,147872,147873,147875,1,3,0
42239,4,3,147876,147876,147879,0,3,1
42240,2,3,147878,147879,147882,1,4,0
42241,1,1,147879,147882,147883,3,4,0
42242,1,3,147880,147883,147886,3,6,0
42243,5,3,147885,147886,147889,1,4,0
42244,4,2,147889,147889,147891,0,2,0
42245,5,2,147894,147894,147896,0,2,3
42246,4,3,147898,147898,147901,0,3,2
42247,3,2,147901,147901,147903,0,2,0
42248,6,1,147907,147907,147908,0,1,4
42249,5,1,147912,147912,147913,0,1,4
42250,4,1,147916,147916,147917,0,1,3
42251,4,3,147920,147920,147923,0,3,3
42252,1,3,147921,147923,147926,2,5,0
42253,6,3,147927,147927,147930,0,3,1
42254,6,1,147933,147933,147934,0,1,3
42255,1,3,147934,147934,147937,0,3,0
42256,4,2,147938,147938,147940,0,2,1
42257,2,1,147940,147940,147941,0,1,0
42258,4,3,147944,147944,147947,0,3,3
42259,3,3,147947,147947,147950,0,3,0
42260,1,1,147948,147950,147951,2,3,0
42261,4,1,147952,147952,147953,0,1,1
42262,3,1,147955,147955,147956,0,1,2
42263,5,2,147960,147960,147962,0,2,4
42264,6,1,147966,147966,147967,0,1,4
42265,3,2,147969,147969,147971,0,2,2
42266,1,3,147970,147971,147974,1,4,0
42267,2,3,147972,147974,147977,2,5,0
42268,4,1,147976,147977,147978,1,2,0
42269,6,2,147982,147982,147984,0,2,4
42270,6,1,147988,147988,147989,0,1,4
42271,5,2,147993,147993,147995,0,2,4
42272,1,2,147994,147995,147997,1,3,0
42273,3,1,147997,147997,147998,0,1,0
42274,1,2,147998,147998,148000,0,2,0
42275,6,3,148004,148004,148007,0,3,4
42276,1,3,148005,148007,148010,2,5,0
42277,4,1,148009,148010,148011,1,2,0
42278,4,2,148013,148013,148015,0,2,2
42279,1,3,148014,148015,148018,1,4,0
42280,1,2,148015,148018,148020,3,5,0
42281,5,2,148020,148020,148022,0,2,0
42282,2,2,148022,148022,148024,0,2,0
42283,4,2,148026,148026,148028,0,2,2
42284,1,1,148027,148028,148029,1,2,0
42285,6,3,148033,148033,148036,0,3,4
42286,1,2,148034,148036,148038,2,4,0
42287,2,1,148036,148038,148039,2,3,0
42288,4,1,148040,148040,148041,0,1,1
42289,2,3,148042,148042,148045,0,3,1
42290,5,3,148047,148047,148050,0,3,2
42291,1,1,148048,148050,148051,2,3,0
42292,6,1,148054,148054,148055,0,1,3
42293,5,3,148059,148059,148062,0,3,4
42294,3,2,148062,148062,148064,0,2,0
42295,1,3,148063,148064,148067,1,4,0
42296,6,1,148069,148069,148070,0,1,2
42297,6,1,148075,148075,148076,0,1,5
42298,1,3,148076,148076,148079,0,3,0
42299,6,1,148082,148082,148083,0,1,3
42300,6,2,148088,148088,148090,0,2,5
42301,2,1,148090,148090,148091,0,1,0
42302,4,2,148094,148094,148096,0,2,3
42303,3,2,148097,148097,148099,0,2,1
42304,4,2,148101,148101,148103,0,2,2
42305,6,3,148107,148107,148110,0,3,4
42306,5,2,148112,148112,148114,0,2,2
42307,6,2,148118,148118,148120,0,2,4
42308,5,2,148123,148123,148125,0,2,3
42309,1,2,148124,148125,148127,1,3,0
42310,3,2,148127,148127,148129,0,2,0
42311,6,3,148133,148133,148136,0,3,4
42312,6,1,148139,148139,148140,0,1,3
42313,6,2,148145,148145,148147,0,2,5
42314,2,1,148147,148147,148148,0,1,0
42315,6,2,148153,148153,148155,0,2,5
42316,1,3,148154,148155,148158,1,4,0
42317,2,3,148156,148158,148161,2,5,0
42318,3,3,148159,148161,148164,2,5,0
42319,6,2,148165,148165,148167,0,2,1
42320,1,2,148166,148167,148169,1,3,0
42321,6,3,148172,148172,148175,0,3,3
42322,1,3,148173,148175,148178,2,5,0
42323,3,3,148176,148178,148181,2,5,0
42324,4,3,148180,148181,148184,1,4,0
42325,6,1,148186,148186,148187,0,1,2
42326,6,1,148192,148192,148193,0,1,5
42327,4,1,148196,148196,148197,0,1,3
42328,1,2,148197,148197,148199,0,2,0
42329,5,3,148202,148202,148205,0,3,3
42330,5,3,148207,148207,148210,0,3,2
42331,3,1,148210,148210,148211,0,1,0
42332,5,3,148215,148215,148218,0,3,4
42333,5,1,148220,148220,148221,0,1,2
42334,1,2,148221,148221,148223,0,2,0
42335,5,1,148226,148226,148227,0,1,3
42336,4,3,148230,148230,148233,0,3,3
42337,3,1,148233,148233,148234,0,1,0
42338,2,2,148235,148235,148237,0,2,1
42339,3,3,148238,148238,148241,0,3,1
42340,1,3,148239,148241,148244,2,5,0
42341,6,1,148245,148245,148246,0,1,1
42342,2,1,148247,148247,148248,0,1,1
42343,6,2,148253,148253,148255,0,2,5
42344,4,1,148257,148257,148258,0,1,2
42345,5,3,148262,148262,148265,0,3,4
42346,1,3,148263,148265,148268,2,5,0
42347,4,1,148267,148268,148269,1,2,0
42348,3,3,148270,148270,148273,0,3,1
42349,2,2,148272,148273,148275,1,3,0
42350,2,3,148274,148275,148278,1,4,0
42351,6,2,148280,148280,148282,0,2,2
42352,5,3,148285,148285,148288,0,3,3
42353,2,2,148287,148288,148290,1,3,0
42354,6,3,148293,148293,148296,0,3,3
42355,1,1,148294,148296,148297,2,3,0
42356,3,2,148297,148297,148299,0,2,0
42357,1,2,148298,148299,148301,1,3,0
42358,5,3,148303,148303,148306,0,3,2
42359,6,2,148309,148309,148311,0,2,3
42360,1,3,148310,148311,148314,1,4,0
42361,4,1,148314,148314,148315,0,1,0
42362,2,1,148316,148316,148317,0,1,1
42363,3,1,148319,148319,148320,0,1,2
42364,5,2,148324,148324,148326,0,2,4
42365,5,1,148329,148329,148330,0,1,3
42366,3,2,148332,148332,148334,0,2,2
42367,2,1,148334,148334,148335,0,1,0
42368,3,1,148337,148337,148338,0,1,2
42369,6,2,148343,148343,148345,0,2,5
42370,6,3,148349,148349,148352,0,3,4
42371,1,2,148350,148352,148354,2,4,0
42372,3,3,148353,148354,148357,1,4,0
42373,3,2,148356,148357,148359,1,3,0
42374,6,2,148362,148362,148364,0,2,3
42375,3,1,148365,148365,148366,0,1,1
42376,4,1,148369,148369,148370,0,1,3
42377,2,1,148371,148371,148372,0,1,1
42378,5,3,148376,148376,148379,0,3,4
42379,4,1,148380,148380,148381,0,1,1
42380,5,2,148385,148385,148387,0,2,4
42381,6,1,148391,148391,148392,0,1,4
42382,4,1,148395,148395,148396,0,1,3
42383,3,2,148398,148398,148400,0,2,2
42384,4,3,148402,148402,148405,0,3,2
42385,6,1,148408,148408,148409,0,1,3
42386,3,3,148411,148411,148414,0,3,2
42387,4,3,148415,148415,148418,0,3,1
42388,5,3,148420,148420,148423,0,3,2
42389,3,1,148423,148423,148424,0,1,0
42390,6,1,148429,148429,148430,0,1,5
42391,3,1,148432,148432,148433,0,1,2
42392,2,1,148434,148434,148435,0,1,1
42393,3,2,148437,148437,148439,0,2,2
42394,1,3,148438,148439,148442,1,4,0
42395,6,2,148444,148444,148446,0,2,2
42396,1,2,148445,148446,148448,1,3,0
42397,4,3,148449,148449,148452,0,3,1
42398,4,1,148453,148453,148454,0,1,1
42399,4,2,148457,148457,148459,0,2,3
42400,5,1,148462,148462,148463,0,1,3
42401,3,1,148465,148465,148466,0,1,2
42402,1,2,148466,148466,148468,0,2,0
42403,4,3,148470,148470,148473,0,3,2
42404,5,2,148475,148475,148477,0,2,2
42405,6,1,148481,148481,148482,0,1,4
42406,5,3,148486,148486,148489,0,3,4
42407,2,3,148488,148489,148492,1,4,0
42408,2,2,148490,148492,148494,2,4,0
42409,6,3,148496,148496,148499,0,3,2
42410,5,1,148501,148501,148502,0,1,2
42411,4,3,148505,148505,148508,0,3,3
42412,1,2,148506,148508,148510,2,4,0
42413,6,2,148512,148512,148514,0,2,2
42414,6,1,148518,148518,148519,0,1,4
42415,2,2,148520,148520,148522,0,2,1
42416,1,2,148521,148522,148524,1,3,0
42417,3,1,148524,148524,148525,0,1,0
42418,5,1,148529,148529,148530,0,1,4
42419,6,2,148535,148535,148537,0,2,5
42420,4,2,148539,148539,148541,0,2,2
42421,4,2,148543,148543,148545,0,2,2
42422,5,2,148548,148548,148550,0,2,3
42423,6,3,148554,148554,148557,0,3,4
42424,3,1,148557,148557,148558,0,1,0
42425,3,3,148560,148560,148563,0,3,2
42426,4,3,148564,148564,148567,0,3,1
42427,3,1,148567,148567,148568,0,1,0
42428,2,1,148569,148569,148570,0,1,1
42429,4,1,148573,148573,148574,0,1,3
42430,6,2,148579,148579,148581,0,2,5
42431,3,3,148582,148582,148585,0,3,1
42432,1,1,148583,148585,148586,2,3,0
42433,2,2,148585,148586,148588,1,3,0
42434,2,1,148587,148588,148589,1,2,0
42435,4,2,148591,148591,148593,0,2,2
42436,3,3,148594,148594,148597,0,3,1
42437,5,3,148599,148599,148602,0,3,2
42438,2,2,148601,148602,148604,1,3,0
42439,3,1,148604,148604,148605,0,1,0
42440,1,3,148605,148605,148608,0,3,0
42441,5,3,148610,148610,148613,0,3,2
42442,5,1,148615,148615,148616,0,1,2
42443,6,3,148621,148621,148624,0,3,5
42444,2,2,148623,148624,148626,1,3,0
42445,1,2,148624,148626,148628,2,4,0
42446,3,3,148627,148628,148631,1,4,0
42447,6,1,148633,148633,148634,0,1,2
42448,3,1,148636,148636,148637,0,1,2
42449,2,3,148638,148638,148641,0,3,1
42450,2,2,148640,148641,148643,1,3,0
42451,2,3,148642,148643,148646,1,4,0
42452,2,3,148644,148646,148649,2,5,0
42453,5,3,148649,148649,148652,0,3,0
42454,2,1,148651,148652,148653,1,2,0
42455,1,1,148652,148653,148654,1,2,0
42456,5,1,148657,148657,148658,0,1,3
42457,1,3,148658,148658,148661,0,3,0
42458,4,3,148662,148662,148665,0,3,1
42459,2,1,148664,148665,148666,1,2,0
42460,6,2,148670,148670,148672,0,2,4
42461,2,3,148672,148672,148675,0,3,0
42462,4,2,148676,148676,148678,0,2,1
42463,2,1,148678,148678,148679,0,1,0
42464,3,1,148681,148681,148682,0,1,2
42465,6,1,148687,148687,148688,0,1,5
42466,4,3,148691,148691,148694,0,3,3
42467,4,3,148695,148695,148698,0,3,1
42468,2,1,148697,148698,148699,1,2,0
42469,5,1,148702,148702,148703,0,1,3
42470,1,3,148703,148703,148706,0,3,0
42471,2,2,148705,148706,148708,1,3,0
42472,4,3,148709,148709,148712,0,3,1
42473,5,1,148714,148714,148715,0,1,2
42474,4,1,148718,148718,148719,0,1,3
42475,3,1,148721,148721,148722,0,1,2
42476,2,3,148723,148723,148726,0,3,1
42477,5,2,148728,148728,148730,0,2,2
42478,5,3,148733,148733,148736,0,3,3
42479,3,3,148736,148736,148739,0,3,0
42480,2,1,148738,148739,148740,1,2,0
42481,6,1,148744,148744,148745,0,1,4
42482,4,1,148748,148748,148749,0,1,3
42483,2,1,148750,148750,148751,0,1,1
42484,3,1,148753,148753,148754,0,1,2
42485,4,1,148757,148757,148758,0,1,3
42486,2,2,148759,148759,148761,0,2,1
42487,6,2,148765,148765,148767,0,2,4
42488,5,1,148770,148770,148771,0,1,3
42489,5,3,148775,148775,148778,0,3,4
42490,5,1,148780,148780,148781,0,1,2
42491,6,1,148786,148786,148787,0,1,5
42492,5,2,148791,148791,148793,0,2,4
42493,1,3,148792,148793,148796,1,4,0
42494,3,1,148795,148796,148797,1,2,0
42495,2,2,148797,148797,148799,0,2,0
42496,4,1,148801,148801,148802,0,1,2
42497,1,3,148802,148802,148805,0,3,0
42498,3,1,148805,148805,148806,0,1,0
42499,6,1,148811,148811,148812,0,1,5
42500,6,3,148817,148817,148820,0,3,5
42501,2,3,148819,148820,148823,1,4,0
42502,6,2,148825,148825,148827,0,2,2
42503,4,3,148829,148829,148832,0,3,2
42504,1,3,148830,148832,148835,2,5,0
42505,6,1,148836,148836,148837,0,1,1
42506,6,1,148842,148842,148843,0,1,5
42507,5,3,148847,148847,148850,0,3,4
42508,2,1,148849,148850,148851,1,2,0
42509,6,1,148855,148855,148856,0,1,4
42510,2,1,148857,148857,148858,0,1,1
42511,6,2,148863,148863,148865,0,2,5
42512,5,2,148868,148868,148870,0,2,3
42513,4,3,148872,148872,148875,0,3,2
42514,3,1,148875,148875,148876,0,1,0
42515,5,1,148880,148880,148881,0,1,4
42516,4,1,148884,148884,148885,0,1,3
42517,6,1,148890,148890,148891,0,1,5
42518,5,2,148895,148895,148897,0,2,4
42519,6,2,148901,148901,148903,0,2,4
42520,6,2,148907,148907,148909,0,2,4
42521,5,1,148912,148912,148913,0,1,3
42522,1,3,148913,148913,148916,0,3,0
42523,4,1,148917,148917,148918,0,1,1
42524,6,2,148923,148923,148925,0,2,5
42525,1,3,148924,148925,148928,1,4,0
42526,5,3,148929,148929,148932,0,3,1
42527,5,3,148934,148934,148937,0,3,2
42528,2,1,148936,148937,148938,1,2,0
42529,2,3,148938,148938,148941,0,3,0
42530,1,3,148939,148941,148944,2,5,0
42531,3,1,148942,148944,148945,2,3,0
42532,4,1,148946,148946,148947,0,1,1
42533,1,1,148947,148947,148948,0,1,0
42534,2,1,148949,148949,148950,0,1,1
42535,4,1,148953,148953,148954,0,1,3
42536,5,1,148958,148958,148959,0,1,4
42537,1,3,148959,148959,148962,0,3,0
42538,2,2,148961,148962,148964,1,3,0
42539,5,2,148966,148966,148968,0,2,2
42540,1,1,148967,148968,148969,1,2,0
42541,1,2,148968,148969,148971,1,3,0
42542,3,1,148971,148971,148972,0,1,0
42543,6,1,148977,148977,148978,0,1,5
42544,5,3,148982,148982,148985,0,3,4
42545,5,3,148987,148987,148990,0,3,2
42546,2,2,148989,148990,148992,1,3,0
42547,2,3,148991,148992,148995,1,4,0
42548,5,1,148996,148996,148997,0,1,1
42549,3,2,148999,148999,149001,0,2,2
42550,2,1,149001,149001,149002,0,1,0
42551,6,2,149007,149007,149009,0,2,5
42552,6,1,149013,149013,149014,0,1,4
42553,2,2,149015,149015,149017,0,2,1
42554,1,1,149016,149017,149018,1,2,0
42555,5,3,149021,149021,149024,0,3,3
42556,3,3,149024,149024,149027,0,3,0
42557,6,2,149030,149030,149032,0,2,3
42558,2,1,149032,149032,149033,0,1,0
42559,2,3,149034,149034,149037,0,3,1
42560,5,1,149039,149039,149040,0,1,2
42561,1,1,149040,149040,149041,0,1,0
42562,4,2,149044,149044,149046,0,2,3
42563,4,2,149048,149048,149050,0,2,2
42564,6,2,149054,149054,149056,0,2,4
42565,6,1,149060,149060,149061,0,1,4
42566,5,3,149065,149065,149068,0,3,4
42567,6,3,149071,149071,149074,0,3,3
42568,1,1,149072,149074,149075,2,3,0
42569,4,3,149076,149076,149079,0,3,1
42570,3,2,149079,149079,149081,0,2,0
42571,1,3,149080,149081,149084,1,4,0
42572,6,1,149086,149086,149087,0,1,2
42573,5,3,149091,149091,149094,0,3,4
42574,1,2,149092,149094,149096,2,4,0
42575,3,2,149095,149096,149098,1,3,0
42576,2,2,149097,149098,149100,1,3,0
42577,6,1,149103,149103,149104,0,1,3
42578,6,1,149109,149109,149110,0,1,5
42579,1,2,149110,149110,149112,0,2,0
42580,1,3,149111,149112,149115,1,4,0
42581,6,3,149117,149117,149120,0,3,2
42582,5,1,149122,149122,149123,0,1,2
42583,2,3,149124,149124,149127,0,3,1
42584,5,3,149129,149129,149132,0,3,2
42585,2,1,149131,149132,149133,1,2,0
42586,2,3,149133,149133,149136,0,3,0
42587,4,2,149137,149137,149139,0,2,1
42588,5,2,149142,149142,149144,0,2,3
42589,5,1,149147,149147,149148,0,1,3
42590,2,2,149149,149149,149151,0,2,1
42591,4,3,149153,149153,149156,0,3,2
42592,5,1,149158,149158,149159,0,1,2
42593,1,1,149159,149159,149160,0,1,0
42594,3,1,149162,149162,149163,0,1,2
42595,5,1,149167,149167,149168,0,1,4
42596,4,1,149171,149171,149172,0,1,3
42597,1,3,149172,149172,149175,0,3,0
42598,2,2,149174,149175,149177,1,3,0
42599,4,3,149178,149178,149181,0,3,1
42600,6,1,149184,149184,149185,0,1,3
42601,4,2,149188,149188,149190,0,2,3
42602,6,3,149194,149194,149197,0,3,4
42603,3,3,149197,149197,149200,0,3,0
42604,1,2,149198,149200,149202,2,4,0
42605,3,2,149201,149202,149204,1,3,0
42606,4,1,149205,149205,149206,0,1,1
42607,2,3,149207,149207,149210,0,3,1
42608,2,2,149209,149210,149212,1,3,0
42609,4,1,149213,149213,149214,0,1,1
42610,4,3,149217,149217,149220,0,3,3
42611,1,1,149218,149220,149221,2,3,0
42612,1,3,149219,149221,149224,2,5,0
42613,2,1,149221,149224,149225,3,4,0
42614,6,2,149227,149227,149229,0,2,2
42615,5,1,149232,149232,149233,0,1,3
42616,6,1,149238,149238,149239,0,1,5
42617,1,3,149239,149239,149242,0,3,0
42618,1,3,149240,149242,149245,2,5,0
42619,3,1,149243,149245,149246,2,3,0
42620,2,2,149245,149246,149248,1,3,0
42621,2,1,149247,149248,149249,1,2,0
42622,5,3,149252,149252,149255,0,3,3
42623,5,1,149257,149257,149258,0,1,2
42624,4,3,149261,149261,149264,0,3,3
42625,6,3,149267,149267,149270,0,3,3
42626,2,3,149269,149270,149273,1,4,0
42627,2,2,149271,149273,149275,2,4,0
42628,4,2,149275,149275,149277,0,2,0
42629,1,1,149276,149277,149278,1,2,0
42630,6,3,149282,149282,149285,0,3,4
42631,5,3,149287,149287,149290,0,3,2
42632,1,2,149288,149290,149292,2,4,0
42633,1,3,149289,149292,149295,3,6,0
42634,5,2,149294,149295,149297,1,3,0
42635,6,3,149300,149300,149303,0,3,3
42636,3,2,149303,149303,149305,0,2,0
42637,2,2,149305,149305,149307,0,2,0
42638,1,1,149306,149307,149308,1,2,0
42639,2,1,149308,149308,149309,0,1,0
42640,3,3,149311,149311,149314,0,3,2
42641,6,3,149317,149317,149320,0,3,3
42642,1,3,149318,149320,149323,2,5,0
42643,5,3,149323,149323,149326,0,3,0
42644,2,3,149325,149326,149329,1,4,0
42645,3,2,149328,149329,149331,1,3,0
42646,5,3,149333,149333,149336,0,3,2
42647,6,1,149339,149339,149340,0,1,3
42648,5,1,149344,149344,149345,0,1,4
42649,4,1,149348,149348,149349,0,1,3
42650,1,3,149349,149349,149352,0,3,0
42651,5,2,149354,149354,149356,0,2,2
42652,5,1,149359,149359,149360,0,1,3
42653,3,2,149362,149362,149364,0,2,2
42654,5,2,149367,149367,149369,0,2,3
42655,6,3,149373,149373,149376,0,3,4
42656,4,2,149377,149377,149379,0,2,1
42657,6,2,149383,149383,149385,0,2,4
42658,4,3,149387,149387,149390,0,3,2
42659,6,2,149393,149393,149395,0,2,3
42660,5,2,149398,149398,149400,0,2,3
42661,2,1,149400,149400,149401,0,1,0
42662,1,3,149401,149401,149404,0,3,0
42663,3,3,149404,149404,149407,0,3,0
42664,1,3,149405,149407,149410,2,5,0
42665,2,1,149407,149410,149411,3,4,0
42666,5,2,149412,149412,149414,0,2,1
42667,4,1,149416,149416,149417,0,1,2
42668,2,2,149418,149418,149420,0,2,1
42669,1,3,149419,149420,149423,1,4,0
42670,6,3,149425,149425,149428,0,3,2
42671,5,3,149430,149430,149433,0,3,2
42672,1,1,149431,149433,149434,2,3,0
42673,3,1,149434,149434,149435,0,1,0
42674,6,3,149440,149440,149443,0,3,5
42675,2,3,149442,149443,149446,1,4,0
42676,6,3,149448,149448,149451,0,3,2
42677,5,2,149453,149453,149455,0,2,2
42678,3,3,149456,149456,149459,0,3,1
42679,1,2,149457,149459,149461,2,4,0
42680,5,3,149462,149462,149465,0,3,1
42681,5,1,149467,149467,149468,0,1,2
42682,4,3,149471,149471,149474,0,3,3
42683,2,2,149473,149474,149476,1,3,0
42684,2,3,149475,149476,149479,1,4,0
42685,6,3,149481,149481,149484,0,3,2
42686,4,3,149485,149485,149488,0,3,1
42687,1,2,149486,149488,149490,2,4,0
42688,3,1,149489,149490,149491,1,2,0
42689,6,2,149495,149495,149497,0,2,4
42690,1,2,149496,149497,149499,1,3,0
42691,4,1,149500,149500,149501,0,1,1
42692,2,3,149502,149502,149505,0,3,1
42693,6,3,149508,149508,149511,0,3,3
42694,4,1,149512,149512,149513,0,1,1
42695,1,3,149513,149513,149516,0,3,0
42696,5,3,149518,149518,149521,0,3,2
42697,3,3,149521,149521,149524,0,3,0
42698,3,3,149524,149524,149527,0,3,0
42699,2,2,149526,149527,149529,1,3,0
42700,1,3,149527,149529,149532,2,5,0
42701,6,2,149533,149533,149535,0,2,1
42702,2,2,149535,149535,149537,0,2,0
42703,3,1,149538,149538,149539,0,1,1
42704,6,3,149544,149544,149547,0,3,5
42705,4,1,149548,149548,149549,0,1,1
42706,2,3,149550,149550,149553,0,3,1
42707,6,3,149556,149556,149559,0,3,3
42708,2,2,149558,149559,149561,1,3,0
42709,5,3,149563,149563,149566,0,3,2
42710,3,2,149566,149566,149568,0,2,0
42711,5,2,149571,149571,149573,0,2,3
42712,3,3,149574,149574,149577,0,3,1
42713,3,1,149577,149577,149578,0,1,0
42714,2,3,149579,149579,149582,0,3,1
42715,6,3,149585,149585,149588,0,3,3
42716,5,2,149590,149590,149592,0,2,2
42717,4,3,149594,149594,149597,0,3,2
42718,3,3,149597,149597,149600,0,3,0
42719,1,2,149598,149600,149602,2,4,0
42720,6,2,149604,149604,149606,0,2,2
42721,3,3,149607,149607,149610,0,3,1
42722,4,2,149611,149611,149613,0,2,1
42723,5,2,149616,149616,149618,0,2,3
42724,3,3,149619,149619,149622,0,3,1
42725,4,3,149623,149623,149626,0,3,1
42726,6,3,149629,149629,149632,0,3,3
42727,3,2,149632,149632,149634,0,2,0
42728,4,1,149636,149636,149637,0,1,2
42729,6,1,149642,149642,149643,0,1,5
42730,1,3,149643,149643,149646,0,3,0
42731,4,1,149647,149647,149648,0,1,1
42732,4,3,149651,149651,149654,0,3,3
42733,3,2,149654,149654,149656,0,2,0
42734,4,2,149658,149658,149660,0,2,2
42735,3,1,149661,149661,149662,0,1,1
42736,6,2,149667,149667,149669,0,2,5
42737,1,2,149668,149669,149671,1,3,0
42738,1,2,149669,149671,149673,2,4,0
42739,2,1,149671,149673,149674,2,3,0
42740,1,2,149672,149674,149676,2,4,0
42741,6,3,149678,149678,149681,0,3,2
42742,6,2,149684,149684,149686,0,2,3
42743,2,1,149686,149686,149687,0,1,0
42744,5,1,149691,149691,149692,0,1,4
42745,3,2,149694,149694,149696,0,2,2
42746,4,1,149698,149698,149699,0,1,2
42747,2,1,149700,149700,149701,0,1,1
42748,1,2,149701,149701,149703,0,2,0
42749,1,1,149702,149703,149704,1,2,0
42750,5,2,149707,149707,149709,0,2,3
42751,4,1,149711,149711,149712,0,1,2
42752,2,1,149713,149713,149714,0,1,1
42753,2,2,149715,149715,149717,0,2,1
42754,5,3,149720,149720,149723,0,3,3
42755,3,3,149723,149723,149726,0,3,0
42756,5,1,149728,149728,149729,0,1,2
42757,6,2,149734,149734,149736,0,2,5
42758,2,2,149736,149736,149738,0,2,0
42759,1,2,149737,149738,149740,1,3,0
42760,2,2,149739,149740,149742,1,3,0
42761,5,2,149744,149744,149746,0,2,2
42762,3,1,149747,149747,149748,0,1,1
42763,4,1,149751,149751,149752,0,1,3
42764,3,2,149754,149754,149756,0,2,2
42765,2,1,149756,149756,149757,0,1,0
42766,6,2,149762,149762,149764,0,2,5
42767,4,1,149766,149766,149767,0,1,2
42768,5,1,149771,149771,149772,0,1,4
42769,1,2,149772,149772,149774,0,2,0
42770,4,1,149776,149776,149777,0,1,2
42771,2,3,149778,149778,149781,0,3,1
42772,6,1,149784,149784,149785,0,1,3
42773,3,1,149787,149787,149788,0,1,2
42774,2,3,149789,149789,149792,0,3,1
42775,1,1,149790,149792,149793,2,3,0
42776,1,2,149791,149793,149795,2,4,0
42777,6,1,149797,149797,149798,0,1,2
42778,6,2,149803,149803,149805,0,2,5
42779,6,1,149809,149809,149810,0,1,4
42780,3,1,149812,149812,149813,0,1,2
42781,5,3,149817,149817,149820,0,3,4
42782,2,3,149819,149820,149823,1,4,0
42783,6,2,149825,149825,149827,0,2,2
42784,3,1,149828,149828,149829,0,1,1
42785,3,2,149831,149831,149833,0,2,2
42786,4,3,149835,149835,149838,0,3,2
42787,3,2,149838,149838,149840,0,2,0
42788,6,1,149844,149844,149845,0,1,4
42789,2,1,149846,149846,149847,0,1,1
42790,5,2,149851,149851,149853,0,2,4
42791,5,1,149856,149856,149857,0,1,3
42792,3,3,149859,149859,149862,0,3,2
42793,6,1,149865,149865,149866,0,1,3
42794,4,1,149869,149869,149870,0,1,3
42795,1,1,149870,149870,149871,0,1,0
42796,5,3,149875,149875,149878,0,3,4
42797,4,2,149879,149879,149881,0,2,1
42798,1,3,149880,149881,149884,1,4,0
42799,3,3,149883,149884,149887,1,4,0
42800,6,2,149889,149889,149891,0,2,2
42801,4,2,149893,149893,149895,0,2,2
42802,6,2,149899,149899,149901,0,2,4
42803,4,3,149903,149903,149906,0,3,2
42804,3,3,149906,149906,149909,0,3,0
42805,6,3,149912,149912,149915,0,3,3
42806,1,2,149913,149915,149917,2,4,0
42807,6,1,149919,149919,149920,0,1,2
42808,3,2,149922,149922,149924,0,2,2
42809,1,3,149923,149924,149927,1,4,0
42810,1,2,149924,149927,149929,3,5,0
42811,5,1,149929,149929,149930,0,1,0
42812,6,2,149935,149935,149937,0,2,5
42813,4,1,149939,149939,149940,0,1,2
42814,5,3,149944,149944,149947,0,3,4
42815,6,1,149950,149950,149951,0,1,3
42816,5,1,149955,149955,149956,0,1,4
42817,4,3,149959,149959,149962,0,3,3
42818,3,2,149962,149962,149964,0,2,0
42819,4,1,149966,149966,149967,0,1,2
42820,5,3,149971,149971,149974,0,3,4
42821,3,1,149974,149974,149975,0,1,0
42822,5,1,149979,149979,149980,0,1,4
42823,6,3,149985,149985,149988,0,3,5
42824,6,2,149991,149991,149993,0,2,3
42825,6,1,149997,149997,149998,0,1,4
42826,2,3,149999,149999,150002,0,3,1
42827,5,2,150004,150004,150006,0,2,2
42828,6,2,150010,150010,150012,0,2,4
42829,2,2,150012,150012,150014,0,2,0
42830,2,1,150014,150014,150015,0,1,0
42831,2,2,150016,150016,150018,0,2,1
42832,3,2,150019,150019,150021,0,2,1
42833,2,2,150021,150021,150023,0,2,0
42834,2,2,150023,150023,150025,0,2,0
42835,2,1,150025,150025,150026,0,1,0
42836,3,3,150028,150028,150031,0,3,2
42837,5,2,150033,150033,150035,0,2,2
42838,3,3,150036,150036,150039,0,3,1
42839,1,1,150037,150039,150040,2,3,0
42840,2,1,150039,150040,150041,1,2,0
42841,2,1,150041,150041,150042,0,1,0
42842,2,2,150043,150043,150045,0,2,1
42843,2,1,150045,150045,150046,0,1,0
42844,3,2,150048,150048,150050,0,2,2
42845,4,2,150052,150052,150054,0,2,2
42846,4,3,150056,150056,150059,0,3,2
42847,6,1,150062,150062,150063,0,1,3
42848,5,2,150067,150067,150069,0,2,4
42849,3,1,150070,150070,150071,0,1,1
42850,5,2,150075,150075,150077,0,2,4
42851,5,3,150080,150080,150083,0,3,3
42852,3,2,150083,150083,150085,0,2,0
42853,3,3,150086,150086,150089,0,3,1
42854,3,3,150089,150089,150092,0,3,0
42855,2,3,150091,150092,150095,1,4,0
42856,1,1,150092,150095,150096,3,4,0
42857,3,1,150095,150096,150097,1,2,0
42858,2,3,150097,150097,150100,0,3,0
42859,6,1,150103,150103,150104,0,1,3
42860,2,1,150105,150105,150106,0,1,1
42861,1,2,150106,150106,150108,0,2,0
42862,4,1,150110,150110,150111,0,1,2
42863,4,3,150114,150114,150117,0,3,3
42864,1,3,150115,150117,150120,2,5,0
42865,5,3,150120,150120,150123,0,3,0
42866,1,2,150121,150123,150125,2,4,0
42867,2,3,150123,150125,150128,2,5,0
42868,2,1,150125,150128,150129,3,4,0
42869,1,1,150126,150129,150130,3,4,0
42870,1,3,150127,150130,150133,3,6,0
42871,1,2,150128,150133,150135,5,7,0
42872,1,2,150129,150135,150137,6,8,0
42873,3,1,150132,150137,150138,5,6,0
42874,5,2,150137,150138,150140,1,3,0
42875,6,3,150143,150143,150146,0,3,3
42876,4,3,150147,150147,150150,0,3,1
42877,4,2,150151,150151,150153,0,2,1
42878,1,1,150152,150153,150154,1,2,0
42879,1,3,150153,150154,150157,1,4,0
42880,6,3,150159,150159,150162,0,3,2
42881,4,3,150163,150163,150166,0,3,1
42882,3,3,150166,150166,150169,0,3,0
42883,3,1,150169,150169,150170,0,1,0
42884,4,2,150173,150173,150175,0,2,3
42885,4,2,150177,150177,150179,0,2,2
42886,6,3,150183,150183,150186,0,3,4
42887,3,3,150186,150186,150189,0,3,0
42888,1,3,150187,150189,150192,2,5,0
42889,6,3,150193,150193,150196,0,3,1
42890,6,1,150199,150199,150200,0,1,3
42891,3,1,150202,150202,150203,0,1,2
42892,5,3,150207,150207,150210,0,3,4
42893,2,3,150209,150210,150213,1,4,0
42894,6,2,150215,150215,150217,0,2,2
42895,4,1,150219,150219,150220,0,1,2
42896,2,3,150221,150221,150224,0,3,1
42897,5,2,150226,150226,150228,0,2,2
42898,3,3,150229,150229,150232,0,3,1
42899,5,2,150234,150234,150236,0,2,2
42900,5,2,150239,150239,150241,0,2,3
42901,4,2,150243,150243,150245,0,2,2
42902,1,3,150244,150245,150248,1,4,0
42903,6,1,150250,150250,150251,0,1,2
42904,6,1,150256,150256,150257,0,1,5
42905,4,1,150260,150260,150261,0,1,3
42906,3,3,150263,150263,150266,0,3,2
42907,4,3,150267,150267,150270,0,3,1
42908,2,3,150269,150270,150273,1,4,0
42909,2,2,150271,150273,150275,2,4,0
42910,3,2,150274,150275,150277,1,3,0
42911,3,2,150277,150277,150279,0,2,0
42912,5,1,150282,150282,150283,0,1,3
42913,3,1,150285,150285,150286,0,1,2
42914,4,2,150289,150289,150291,0,2,3
42915,4,1,150293,150293,150294,0,1,2
42916,3,2,150296,150296,150298,0,2,2
42917,4,2,150300,150300,150302,0,2,2
42918,2,2,150302,150302,150304,0,2,0
42919,5,1,150307,150307,150308,0,1,3
42920,4,2,150311,150311,150313,0,2,3
42921,6,1,150317,150317,150318,0,1,4
42922,1,2,150318,150318,150320,0,2,0
42923,6,2,150324,150324,150326,0,2,4
42924,3,3,150327,150327,150330,0,3,1
42925,5,2,150332,150332,150334,0,2,2
42926,3,1,150335,150335,150336,0,1,1
42927,3,1,150338,150338,150339,0,1,2
42928,2,3,150340,150340,150343,0,3,1
42929,2,2,150342,150343,150345,1,3,0
42930,4,2,150346,150346,150348,0,2,1
42931,1,3,150347,150348,150351,1,4,0
42932,3,2,150350,150351,150353,1,3,0
42933,3,1,150353,150353,150354,0,1,0
42934,6,2,150359,150359,150361,0,2,5
42935,2,2,150361,150361,150363,0,2,0
42936,1,3,150362,150363,150366,1,4,0
42937,5,2,150367,150367,150369,0,2,1
42938,3,1,150370,150370,150371,0,1,1
42939,5,3,150375,150375,150378,0,3,4
42940,1,1,150376,150378,150379,2,3,0
42941,1,3,150377,150379,150382,2,5,0
42942,3,2,150380,150382,150384,2,4,0
42943,1,2,150381,150384,150386,3,5,0
42944,1,3,150382,150386,150389,4,7,0
42945,1,1,150383,150389,150390,6,7,0
42946,5,1,150388,150390,150391,2,3,0
42947,6,1,150394,150394,150395,0,1,3
42948,6,3,150400,150400,150403,0,3,5
42949,3,3,150403,150403,150406,0,3,0
42950,6,3,150409,150409,150412,0,3,3
42951,6,2,150415,150415,150417,0,2,3
42952,2,2,150417,150417,150419,0,2,0
42953,6,2,150423,150423,150425,0,2,4
42954,3,2,150426,150426,150428,0,2,1
42955,1,3,150427,150428,150431,1,4,0
42956,6,3,150433,150433,150436,0,3,2
42957,6,2,150439,150439,150441,0,2,3
42958,3,1,150442,150442,150443,0,1,1
42959,5,2,150447,150447,150449,0,2,4
42960,1,2,150448,150449,150451,1,3,0
42961,1,2,150449,150451,150453,2,4,0
42962,6,2,150455,150455,150457,0,2,2
42963,5,1,150460,150460,150461,0,1,3
42964,4,2,150464,150464,150466,0,2,3
42965,1,1,150465,150466,150467,1,2,0
42966,4,1,150469,150469,150470,0,1,2
42967,1,1,150470,150470,150471,0,1,0
42968,6,3,150476,150476,150479,0,3,5
42969,2,2,150478,150479,150481,1,3,0
42970,5,2,150483,150483,150485,0,2,2
42971,3,2,150486,150486,150488,0,2,1
42972,3,3,150489,150489,150492,0,3,1
42973,3,1,150492,150492,150493,0,1,0
42974,3,3,150495,150495,150498,0,3,2
42975,1,3,150496,150498,150501,2,5,0
42976,1,1,150497,150501,150502,4,5,0
42977,5,3,150502,150502,150505,0,3,0
42978,6,3,150508,150508,150511,0,3,3
42979,5,1,150513,150513,150514,0,1,2
42980,6,3,150519,150519,150522,0,3,5
42981,6,2,150525,150525,150527,0,2,3
42982,1,1,150526,150527,150528,1,2,0
42983,5,2,150531,150531,150533,0,2,3
42984,2,3,150533,150533,150536,0,3,0
42985,2,1,150535,150536,150537,1,2,0
42986,5,2,150540,150540,150542,0,2,3
42987,5,2,150545,150545,150547,0,2,3
42988,2,3,150547,150547,150550,0,3,0
42989,5,2,150552,150552,150554,0,2,2
42990,3,3,150555,150555,150558,0,3,1
42991,1,3,150556,150558,150561,2,5,0
42992,1,1,150557,150561,150562,4,5,0
42993,2,3,150559,150562,150565,3,6,0
42994,1,1,150560,150565,150566,5,6,0
42995,1,3,150561,150566,150569,5,8,0
42996,5,3,150566,150569,150572,3,6,0
42997,5,2,150571,150572,150574,1,3,0
42998,4,3,150575,150575,150578,0,3,1
42999,3,2,150578,150578,150580,0,2,0
43000,5,2,150583,150583,150585,0,2,3
43001,3,2,150586,150586,150588,0,2,1
43002,2,1,150588,150588,150589,0,1,0
43003,6,2,150594,150594,150596,0,2,5
43004,1,3,150595,150596,150599,1,4,0
43005,6,2,150601,150601,150603,0,2,2
43006,6,3,150607,150607,150610,0,3,4
43007,3,2,150610,150610,150612,0,2,0
43008,2,3,150612,150612,150615,0,3,0
43009,2,2,150614,150615,150617,1,3,0
43010,2,1,150616,150617,150618,1,2,0
43011,6,3,150622,150622,150625,0,3,4
43012,6,3,150628,150628,150631,0,3,3
43013,5,2,150633,150633,150635,0,2,2
43014,5,3,150638,150638,150641,0,3,3
43015,4,3,150642,150642,150645,0,3,1
43016,2,2,150644,150645,150647,1,3,0
43017,2,1,150646,150647,150648,1,2,0
43018,2,3,150648,150648,150651,0,3,0
43019,1,2,150649,150651,150653,2,4,0
43020,6,1,150655,150655,150656,0,1,2
43021,4,1,150659,150659,150660,0,1,3
43022,2,3,150661,150661,150664,0,3,1
43023,4,3,150665,150665,150668,0,3,1
43024,4,2,150669,150669,150671,0,2,1
43025,2,2,150671,150671,150673,0,2,0
43026,6,3,150677,150677,150680,0,3,4
43027,2,1,150679,150680,150681,1,2,0
43028,1,3,150680,150681,150684,1,4,0
43029,3,1,150683,150684,150685,1,2,0
43030,6,2,150689,150689,150691,0,2,4
43031,3,2,150692,150692,150694,0,2,1
43032,1,1,150693,150694,150695,1,2,0
43033,4,2,150697,150697,150699,0,2,2
43034,1,3,150698,150699,150702,1,4,0
43035,3,2,150701,150702,150704,1,3,0
43036,2,3,150703,150704,150707,1,4,0
43037,6,1,150709,150709,150710,0,1,2
43038,5,1,150714,150714,150715,0,1,4
43039,3,3,150717,150717,150720,0,3,2
43040,5,1,150722,150722,150723,0,1,2
43041,4,3,150726,150726,150729,0,3,3
43042,3,1,150729,150729,150730,0,1,0
43043,1,1,150730,150730,150731,0,1,0
43044,2,3,150732,150732,150735,0,3,1
43045,4,2,150736,150736,150738,0,2,1
43046,2,1,150738,150738,150739,0,1,0
43047,3,2,150741,150741,150743,0,2,2
43048,4,2,150745,150745,150747,0,2,2
43049,1,3,150746,150747,150750,1,4,0
43050,5,1,150751,150751,150752,0,1,1
43051,2,1,150753,150753,150754,0,1,1
43052,6,1,150759,150759,150760,0,1,5
43053,1,2,150760,150760,150762,0,2,0
43054,3,2,150763,150763,150765,0,2,1
43055,5,2,150768,150768,150770,0,2,3
43056,5,1,150773,150773,150774,0,1,3
43057,3,1,150776,150776,150777,0,1,2
43058,2,1,150778,150778,150779,0,1,1
43059,2,2,150780,150780,150782,0,2,1
43060,1,2,150781,150782,150784,1,3,0
43061,1,3,150782,150784,150787,2,5,0
43062,4,3,150786,150787,150790,1,4,0
43063,3,2,150789,150790,150792,1,3,0
43064,3,3,150792,150792,150795,0,3,0
43065,1,3,150793,150795,150798,2,5,0
43066,3,2,150796,150798,150800,2,4,0
43067,1,1,150797,150800,150801,3,4,0
43068,2,2,150799,150801,150803,2,4,0
43069,3,1,150802,150803,150804,1,2,0
43070,6,1,150808,150808,150809,0,1,4
43071,1,3,150809,150809,150812,0,3,0
43072,2,3,150811,150812,150815,1,4,0
43073,3,1,150814,150815,150816,1,2,0
43074,6,2,150820,150820,150822,0,2,4
43075,2,2,150822,150822,150824,0,2,0
43076,6,1,150828,150828,150829,0,1,4
43077,5,1,150833,150833,150834,0,1,4
43078,4,1,150837,150837,150838,0,1,3
43079,4,1,150841,150841,150842,0,1,3
43080,2,3,150843,150843,150846,0,3,1
43081,4,1,150847,150847,150848,0,1,1
43082,5,2,150852,150852,150854,0,2,4
43083,1,2,150853,150854,150856,1,3,0
43084,1,1,150854,150856,150857,2,3,0
43085,5,1,150859,150859,150860,0,1,2
43086,1,1,150860,150860,150861,0,1,0
43087,4,2,150864,150864,150866,0,2,3
43088,5,3,150869,150869,150872,0,3,3
43089,3,1,150872,150872,150873,0,1,0
43090,4,3,150876,150876,150879,0,3,3
43091,5,3,150881,150881,150884,0,3,2
43092,4,2,150885,150885,150887,0,2,1
43093,5,2,150890,150890,150892,0,2,3
43094,3,3,150893,150893,150896,0,3,1
43095,4,2,150897,150897,150899,0,2,1
43096,1,1,150898,150899,150900,1,2,0
43097,4,3,150902,150902,150905,0,3,2
43098,2,2,150904,150905,150907,1,3,0
43099,6,1,150910,150910,150911,0,1,3
43100,5,3,150915,150915,150918,0,3,4
43101,3,1,150918,150918,150919,0,1,0
43102,3,3,150921,150921,150924,0,3,2
43103,5,2,150926,150926,150928,0,2,2
43104,6,1,150932,150932,150933,0,1,4
43105,1,1,150933,150933,150934,0,1,0
43106,5,1,150938,150938,150939,0,1,4
43107,2,3,150940,150940,150943,0,3,1
43108,4,1,150944,150944,150945,0,1,1
43109,5,3,150949,150949,150952,0,3,4
43110,2,1,150951,150952,150953,1,2,0
43111,3,2,150954,150954,150956,0,2,1
43112,2,3,150956,150956,150959,0,3,0
43113,4,2,150960,150960,150962,0,2,1
43114,4,2,150964,150964,150966,0,2,2
43115,5,3,150969,150969,150972,0,3,3
43116,6,1,150975,150975,150976,0,1,3
43117,5,1,150980,150980,150981,0,1,4
43118,6,2,150986,150986,150988,0,2,5
43119,2,2,150988,150988,150990,0,2,0
43120,2,3,150990,150990,150993,0,3,0
43121,3,3,150993,150993,150996,0,3,0
43122,5,2,150998,150998,151000,0,2,2
43123,5,3,151003,151003,151006,0,3,3
43124,4,1,151007,151007,151008,0,1,1
43125,2,3,151009,151009,151012,0,3,1
43126,3,2,151012,151012,151014,0,2,0
43127,4,3,151016,151016,151019,0,3,2
43128,4,1,151020,151020,151021,0,1,1
43129,4,3,151024,151024,151027,0,3,3
43130,1,2,151025,151027,151029,2,4,0
43131,2,3,151027,151029,151032,2,5,0
43132,4,1,151031,151032,151033,1,2,0
43133,3,1,151034,151034,151035,0,1,1
43134,5,2,151039,151039,151041,0,2,4
43135,4,1,151043,151043,151044,0,1,2
43136,5,1,151048,151048,151049,0,1,4
43137,5,1,151053,151053,151054,0,1,4
43138,3,2,151056,151056,151058,0,2,2
43139,3,1,151059,151059,151060,0,1,1
43140,6,2,151065,151065,151067,0,2,5
43141,2,1,151067,151067,151068,0,1,0
43142,3,1,151070,151070,151071,0,1,2
43143,6,2,151076,151076,151078,0,2,5
43144,4,1,151080,151080,151081,0,1,2
43145,1,3,151081,151081,151084,0,3,0
43146,1,2,151082,151084,151086,2,4,0
43147,2,1,151084,151086,151087,2,3,0
43148,2,1,151086,151087,151088,1,2,0
43149,2,3,151088,151088,151091,0,3,0
43150,4,1,151092,151092,151093,0,1,1
43151,5,1,151097,151097,151098,0,1,4
43152,1,1,151098,151098,151099,0,1,0
43153,3,2,151101,151101,151103,0,2,2
43154,6,3,151107,151107,151110,0,3,4
43155,3,2,151110,151110,151112,0,2,0
43156,1,3,151111,151112,151115,1,4,0
43157,1,2,151112,151115,151117,3,5,0
43158,2,3,151114,151117,151120,3,6,0
43159,1,2,151115,151120,151122,5,7,0
43160,5,1,151120,151122,151123,2,3,0
43161,3,3,151123,151123,151126,0,3,0
43162,5,2,151128,151128,151130,0,2,2
43163,6,2,151134,151134,151136,0,2,4
43164,4,3,151138,151138,151141,0,3,2
43165,4,3,151142,151142,151145,0,3,1
43166,2,2,151144,151145,151147,1,3,0
43167,2,3,151146,151147,151150,1,4,0
43168,1,1,151147,151150,151151,3,4,0
43169,3,2,151150,151151,151153,1,3,0
43170,6,2,151156,151156,151158,0,2,3
43171,2,1,151158,151158,151159,0,1,0
43172,6,3,151164,151164,151167,0,3,5
43173,1,1,151165,151167,151168,2,3,0
43174,6,3,151171,151171,151174,0,3,3
43175,5,2,151176,151176,151178,0,2,2
43176,4,2,151180,151180,151182,0,2,2
43177,1,1,151181,151182,151183,1,2,0
43178,5,2,151186,151186,151188,0,2,3
43179,1,3,151187,151188,151191,1,4,0
43180,5,1,151192,151192,151193,0,1,1
43181,3,3,151195,151195,151198,0,3,2
43182,4,1,151199,151199,151200,0,1,1
43183,6,1,151205,151205,151206,0,1,5
43184,2,1,151207,151207,151208,0,1,1
43185,6,3,151213,151213,151216,0,3,5
43186,5,2,151218,151218,151220,0,2,2
43187,2,2,151220,151220,151222,0,2,0
43188,2,3,151222,151222,151225,0,3,0
43189,6,1,151228,151228,151229,0,1,3
43190,2,1,151230,151230,151231,0,1,1
43191,4,1,151234,151234,151235,0,1,3
43192,6,3,151240,151240,151243,0,3,5
43193,5,3,151245,151245,151248,0,3,2
43194,1,2,151246,151248,151250,2,4,0
43195,6,1,151252,151252,151253,0,1,2
43196,3,3,151255,151255,151258,0,3,2
43197,4,2,151259,151259,151261,0,2,1
43198,6,2,151265,151265,151267,0,2,4
43199,6,3,151271,151271,151274,0,3,4
43200,5,2,151276,151276,151278,0,2,2
43201,1,3,151277,151278,151281,1,4,0
43202,5,1,151282,151282,151283,0,1,1
43203,5,3,151287,151287,151290,0,3,4
43204,6,1,151293,151293,151294,0,1,3
43205,4,2,151297,151297,151299,0,2,3
43206,6,1,151303,151303,151304,0,1,4
43207,2,1,151305,151305,151306,0,1,1
43208,5,1,151310,151310,151311,0,1,4
43209,1,3,151311,151311,151314,0,3,0
43210,3,1,151314,151314,151315,0,1,0
43211,3,2,151317,151317,151319,0,2,2
43212,1,1,151318,151319,151320,1,2,0
43213,5,3,151323,151323,151326,0,3,3
43214,3,1,151326,151326,151327,0,1,0
43215,5,2,151331,151331,151333,0,2,4
43216,3,3,151334,151334,151337,0,3,1
43217,4,2,151338,151338,151340,0,2,1
43218,5,3,151343,151343,151346,0,3,3
43219,3,3,151346,151346,151349,0,3,0
43220,1,3,151347,151349,151352,2,5,0
43221,5,3,151352,151352,151355,0,3,0
43222,4,1,151356,151356,151357,0,1,1
43223,6,2,151362,151362,151364,0,2,5
43224,2,3,151364,151364,151367,0,3,0
43225,5,2,151369,151369,151371,0,2,2
43226,3,1,151372,151372,151373,0,1,1
43227,3,1,151375,151375,151376,0,1,2
43228,6,2,151381,151381,151383,0,2,5
43229,6,1,151387,151387,151388,0,1,4
43230,3,1,151390,151390,151391,0,1,2
43231,5,1,151395,151395,151396,0,1,4
43232,3,3,151398,151398,151401,0,3,2
43233,6,3,151404,151404,151407,0,3,3
43234,4,3,151408,151408,151411,0,3,1
43235,6,2,151414,151414,151416,0,2,3
43236,5,1,151419,151419,151420,0,1,3
43237,6,3,151425,151425,151428,0,3,5
43238,5,2,151430,151430,151432,0,2,2
43239,4,2,151434,151434,151436,0,2,2
43240,4,1,151438,151438,151439,0,1,2
43241,1,3,151439,151439,151442,0,3,0
43242,4,2,151443,151443,151445,0,2,1
43243,2,2,151445,151445,151447,0,2,0
43244,6,3,151451,151451,151454,0,3,4
43245,4,3,151455,151455,151458,0,3,1
43246,2,1,151457,151458,151459,1,2,0
43247,3,1,151460,151460,151461,0,1,1
43248,1,3,151461,151461,151464,0,3,0
43249,3,2,151464,151464,151466,0,2,0
43250,3,2,151467,151467,151469,0,2,1
43251,1,1,151468,151469,151470,1,2,0
43252,1,3,151469,151470,151473,1,4,0
43253,3,2,151472,151473,151475,1,3,0
43254,1,2,151473,151475,151477,2,4,0
43255,4,1,151477,151477,151478,0,1,0
43256,1,2,151478,151478,151480,0,2,0
43257,5,2,151483,151483,151485,0,2,3
43258,2,1,151485,151485,151486,0,1,0
43259,2,1,151487,151487,151488,0,1,1
43260,2,1,151489,151489,151490,0,1,1
43261,4,3,151493,151493,151496,0,3,3
43262,4,1,151497,151497,151498,0,1,1
43263,4,2,151501,151501,151503,0,2,3
43264,3,2,151504,151504,151506,0,2,1
43265,3,1,151507,151507,151508,0,1,1
43266,3,3,151510,151510,151513,0,3,2
43267,2,1,151512,151513,151514,1,2,0
43268,3,3,151515,151515,151518,0,3,1
43269,2,2,151517,151518,151520,1,3,0
43270,2,3,151519,151520,151523,1,4,0
43271,1,3,151520,151523,151526,3,6,0
43272,5,3,151525,151526,151529,1,4,0
43273,1,2,151526,151529,151531,3,5,0
43274,3,1,151529,151531,151532,2,3,0
43275,6,2,151535,151535,151537,0,2,3
43276,3,3,151538,151538,151541,0,3,1
43277,2,3,151540,151541,151544,1,4,0
43278,2,1,151542,151544,151545,2,3,0
43279,1,3,151543,151545,151548,2,5,0
43280,4,3,151547,151548,151551,1,4,0
43281,1,3,151548,151551,151554,3,6,0
43282,6,1,151554,151554,151555,0,1,0
43283,2,2,151556,151556,151558,0,2,1
43284,4,1,151560,151560,151561,0,1,2
43285,5,3,151565,151565,151568,0,3,4
43286,2,1,151567,151568,151569,1,2,0
43287,4,3,151571,151571,151574,0,3,2
43288,4,3,151575,151575,151578,0,3,1
43289,5,2,151580,151580,151582,0,2,2
43290,6,2,151586,151586,151588,0,2,4
43291,1,2,151587,151588,151590,1,3,0
43292,2,3,151589,151590,151593,1,4,0
43293,2,1,151591,151593,151594,2,3,0
43294,3,3,151594,151594,151597,0,3,0
43295,4,2,151598,151598,151600,0,2,1
43296,4,2,151602,151602,151604,0,2,2
43297,6,3,151608,151608,151611,0,3,4
43298,5,3,151613,151613,151616,0,3,2
43299,3,2,151616,151616,151618,0,2,0
43300,5,1,151621,151621,151622,0,1,3
43301,1,2,151622,151622,151624,0,2,0
43302,3,1,151625,151625,151626,0,1,1
43303,3,1,151628,151628,151629,0,1,2
43304,5,1,151633,151633,151634,0,1,4
43305,6,3,151639,151639,151642,0,3,5
43306,4,3,151643,151643,151646,0,3,1
43307,6,3,151649,151649,151652,0,3,3
43308,5,3,151654,151654,151657,0,3,2
43309,3,3,151657,151657,151660,0,3,0
43310,5,2,151662,151662,151664,0,2,2
43311,2,3,151664,151664,151667,0,3,0
43312,6,3,151670,151670,151673,0,3,3
43313,3,2,151673,151673,151675,0,2,0
43314,4,2,151677,151677,151679,0,2,2
43315,1,1,151678,151679,151680,1,2,0
43316,5,1,151683,151683,151684,0,1,3
43317,5,2,151688,151688,151690,0,2,4
43318,2,2,151690,151690,151692,0,2,0
43319,2,2,151692,151692,151694,0,2,0
43320,5,1,151697,151697,151698,0,1,3
43321,2,3,151699,151699,151702,0,3,1
43322,2,2,151701,151702,151704,1,3,0
43323,5,3,151706,151706,151709,0,3,2
43324,3,1,151709,151709,151710,0,1,0
43325,4,3,151713,151713,151716,0,3,3
43326,1,3,151714,151716,151719,2,5,0
43327,6,3,151720,151720,151723,0,3,1
43328,6,1,151726,151726,151727,0,1,3
43329,5,1,151731,151731,151732,0,1,4
43330,1,2,151732,151732,151734,0,2,0
43331,4,3,151736,151736,151739,0,3,2
43332,5,1,151741,151741,151742,0,1,2
43333,4,3,151745,151745,151748,0,3,3
43334,4,2,151749,151749,151751,0,2,1
43335,1,3,151750,151751,151754,1,4,0
43336,1,2,151751,151754,151756,3,5,0
43337,6,2,151757,151757,151759,0,2,1
43338,3,2,151760,151760,151762,0,2,1
43339,6,1,151766,151766,151767,0,1,4
43340,5,2,151771,151771,151773,0,2,4
43341,6,1,151777,151777,151778,0,1,4
43342,5,2,151782,151782,151784,0,2,4
43343,6,2,151788,151788,151790,0,2,4
43344,6,3,151794,151794,151797,0,3,4
43345,4,1,151798,151798,151799,0,1,1
43346,2,3,151800,151800,151803,0,3,1
43347,1,3,151801,151803,151806,2,5,0
43348,2,1,151803,151806,151807,3,4,0
43349,3,1,151806,151807,151808,1,2,0
43350,3,2,151809,151809,151811,0,2,1
43351,1,1,151810,151811,151812,1,2,0
43352,6,2,151816,151816,151818,0,2,4
43353,6,3,151822,151822,151825,0,3,4
43354,5,2,151827,151827,151829,0,2,2
43355,2,1,151829,151829,151830,0,1,0
43356,4,3,151833,151833,151836,0,3,3
43357,2,3,151835,151836,151839,1,4,0
43358,3,3,151838,151839,151842,1,4,0
43359,4,1,151842,151842,151843,0,1,0
43360,1,1,151843,151843,151844,0,1,0
43361,5,3,151848,151848,151851,0,3,4
43362,5,3,151853,151853,151856,0,3,2
43363,5,3,151858,151858,151861,0,3,2
43364,3,1,151861,151861,151862,0,1,0
43365,6,1,151867,151867,151868,0,1,5
43366,5,1,151872,151872,151873,0,1,4
43367,5,2,151877,151877,151879,0,2,4
43368,4,3,151881,151881,151884,0,3,2
43369,2,1,151883,151884,151885,1,2,0
43370,2,3,151885,151885,151888,0,3,0
43371,3,2,151888,151888,151890,0,2,0
43372,1,3,151889,151890,151893,1,4,0
43373,3,1,151892,151893,151894,1,2,0
43374,6,2,151898,151898,151900,0,2,4
43375,5,1,151903,151903,151904,0,1,3
43376,4,1,151907,151907,151908,0,1,3
43377,5,2,151912,151912,151914,0,2,4
43378,2,2,151914,151914,151916,0,2,0
43379,5,2,151919,151919,151921,0,2,3
43380,4,2,151923,151923,151925,0,2,2
43381,3,1,151926,151926,151927,0,1,1
43382,6,1,151932,151932,151933,0,1,5
43383,2,3,151934,151934,151937,0,3,1
43384,5,2,151939,151939,151941,0,2,2
43385,4,3,151943,151943,151946,0,3,2
43386,6,2,151949,151949,151951,0,2,3
43387,6,2,151955,151955,151957,0,2,4
43388,2,3,151957,151957,151960,0,3,0
43389,5,3,151962,151962,151965,0,3,2
43390,6,1,151968,151968,151969,0,1,3
43391,2,1,151970,151970,151971,0,1,1
43392,4,2,151974,151974,151976,0,2,3
43393,5,2,151979,151979,151981,0,2,3
43394,2,2,151981,151981,151983,0,2,0
43395,1,3,151982,151983,151986,1,4,0
43396,6,3,151988,151988,151991,0,3,2
43397,1,1,151989,151991,151992,2,3,0
43398,1,3,151990,151992,151995,2,5,0
43399,3,1,151993,151995,151996,2,3,0
43400,5,1,151998,151998,151999,0,1,2
43401,1,1,151999,151999,152000,0,1,0
43402,4,3,152003,152003,152006,0,3,3
43403,3,2,152006,152006,152008,0,2,0
43404,6,2,152012,152012,152014,0,2,4
43405,5,3,152017,152017,152020,0,3,3
43406,1,1,152018,152020,152021,2,3,0
43407,6,2,152024,152024,152026,0,2,3
43408,3,3,152027,152027,152030,0,3,1
43409,6,3,152033,152033,152036,0,3,3
43410,5,2,152038,152038,152040,0,2,2
43411,3,3,152041,152041,152044,0,3,1
43412,6,1,152047,152047,152048,0,1,3
43413,1,3,152048,152048,152051,0,3,0
43414,5,2,152053,152053,152055,0,2,2
43415,5,2,152058,152058,152060,0,2,3
43416,6,2,152064,152064,152066,0,2,4
43417,6,1,152070,152070,152071,0,1,4
43418,4,1,152074,152074,152075,0,1,3
43419,4,1,152078,152078,152079,0,1,3
43420,2,3,152080,152080,152083,0,3,1
43421,2,2,152082,152083,152085,1,3,0
43422,4,2,152086,152086,152088,0,2,1
43423,3,3,152089,152089,152092,0,3,1
43424,3,3,152092,152092,152095,0,3,0
43425,1,1,152093,152095,152096,2,3,0
43426,2,3,152095,152096,152099,1,4,0
43427,4,1,152099,152099,152100,0,1,0
43428,5,1,152104,152104,152105,0,1,4
43429,5,3,152109,152109,152112,0,3,4
43430,6,3,152115,152115,152118,0,3,3
43431,4,2,152119,152119,152121,0,2,1
43432,3,1,152122,152122,152123,0,1,1
43433,3,3,152125,152125,152128,0,3,2
43434,1,2,152126,152128,152130,2,4,0
43435,3,2,152129,152130,152132,1,3,0
43436,3,1,152132,152132,152133,0,1,0
43437,5,3,152137,152137,152140,0,3,4
43438,5,2,152142,152142,152144,0,2,2
43439,5,3,152147,152147,152150,0,3,3
43440,5,3,152152,152152,152155,0,3,2
43441,4,2,152156,152156,152158,0,2,1
43442,6,3,152162,152162,152165,0,3,4
43443,6,2,152168,152168,152170,0,2,3
43444,6,3,152174,152174,152177,0,3,4
43445,2,3,152176,152177,152180,1,4,0
43446,4,3,152180,152180,152183,0,3,0
43447,3,2,152183,152183,152185,0,2,0
43448,2,2,152185,152185,152187,0,2,0
43449,1,3,152186,152187,152190,1,4,0
43450,5,2,152191,152191,152193,0,2,1
43451,3,2,152194,152194,152196,0,2,1
43452,2,3,152196,152196,152199,0,3,0
43453,1,3,152197,152199,152202,2,5,0
43454,3,2,152200,152202,152204,2,4,0
43455,6,2,152206,152206,152208,0,2,2
43456,5,2,152211,152211,152213,0,2,3
43457,6,3,152217,152217,152220,0,3,4
43458,3,1,152220,152220,152221,0,1,0
43459,5,1,152225,152225,152226,0,1,4
43460,2,2,152227,152227,152229,0,2,1
43461,2,2,152229,152229,152231,0,2,0
43462,1,2,152230,152231,152233,1,3,0
43463,5,2,152235,152235,152237,0,2,2
43464,4,1,152239,152239,152240,0,1,2
43465,2,2,152241,152241,152243,0,2,1
43466,2,3,152243,152243,152246,0,3,0
43467,5,2,152248,152248,152250,0,2,2
43468,5,1,152253,152253,152254,0,1,3
43469,1,3,152254,152254,152257,0,3,0
43470,1,3,152255,152257,152260,2,5,0
43471,2,1,152257,152260,152261,3,4,0
43472,5,3,152262,152262,152265,0,3,1
43473,4,1,152266,152266,152267,0,1,1
43474,1,3,152267,152267,152270,0,3,0
43475,5,3,152272,152272,152275,0,3,2
43476,2,2,152274,152275,152277,1,3,0
43477,6,2,152280,152280,152282,0,2,3
43478,3,1,152283,152283,152284,0,1,1
43479,5,1,152288,152288,152289,0,1,4
43480,6,3,152294,152294,152297,0,3,5
43481,6,1,152300,152300,152301,0,1,3
43482,2,2,152302,152302,152304,0,2,1
43483,1,2,152303,152304,152306,1,3,0
43484,5,2,152308,152308,152310,0,2,2
43485,6,2,152314,152314,152316,0,2,4
43486,2,1,152316,152316,152317,0,1,0
43487,2,1,152318,152318,152319,0,1,1
43488,2,2,152320,152320,152322,0,2,1
43489,5,2,152325,152325,152327,0,2,3
43490,3,1,152328,152328,152329,0,1,1
43491,2,1,152330,152330,152331,0,1,1
43492,3,2,152333,152333,152335,0,2,2
43493,2,1,152335,152335,152336,0,1,0
43494,5,3,152340,152340,152343,0,3,4
43495,5,3,152345,152345,152348,0,3,2
43496,4,1,152349,152349,152350,0,1,1
43497,6,1,152355,152355,152356,0,1,5
43498,2,3,152357,152357,152360,0,3,1
43499,3,2,152360,152360,152362,0,2,0
43500,4,3,152364,152364,152367,0,3,2
43501,3,3,152367,152367,152370,0,3,0
43502,3,3,152370,152370,152373,0,3,0
43503,1,1,152371,152373,152374,2,3,0
43504,1,1,152372,152374,152375,2,3,0
43505,6,2,152378,152378,152380,0,2,3
43506,2,1,152380,152380,152381,0,1,0
43507,2,1,152382,152382,152383,0,1,1
43508,2,3,152384,152384,152387,0,3,1
43509,2,3,152386,152387,152390,1,4,0
43510,2,3,152388,152390,152393,2,5,0
43511,6,3,152394,152394,152397,0,3,1
43512,3,3,152397,152397,152400,0,3,0
43513,5,1,152402,152402,152403,0,1,2
43514,4,1,152406,152406,152407,0,1,3
43515,6,2,152412,152412,152414,0,2,5
43516,3,1,152415,152415,152416,0,1,1
43517,4,3,152419,152419,152422,0,3,3
43518,6,1,152425,152425,152426,0,1,3
43519,2,3,152427,152427,152430,0,3,1
43520,1,3,152428,152430,152433,2,5,0
43521,2,2,152430,152433,152435,3,5,0
43522,2,3,152432,152435,152438,3,6,0
43523,4,2,152436,152438,152440,2,4,0
43524,6,1,152442,152442,152443,0,1,2
43525,5,3,152447,152447,152450,0,3,4
43526,3,1,152450,152450,152451,0,1,0
43527,2,2,152452,152452,152454,0,2,1
43528,6,3,152458,152458,152461,0,3,4
43529,2,2,152460,152461,152463,1,3,0
43530,1,3,152461,152463,152466,2,5,0
43531,1,3,152462,152466,152469,4,7,0
43532,2,2,152464,152469,152471,5,7,0
43533,6,1,152470,152471,152472,1,2,0
43534,1,3,152471,152472,152475,1,4,0
43535,6,2,152477,152477,152479,0,2,2
43536,5,1,152482,152482,152483,0,1,3
43537,2,2,152484,152484,152486,0,2,1
43538,5,3,152489,152489,152492,0,3,3
43539,3,1,152492,152492,152493,0,1,0
43540,1,2,152493,152493,152495,0,2,0
43541,4,1,152497,152497,152498,0,1,2
43542,4,1,152501,152501,152502,0,1,3
43543,5,3,152506,152506,152509,0,3,4
43544,3,1,152509,152509,152510,0,1,0
43545,3,1,152512,152512,152513,0,1,2
43546,4,3,152516,152516,152519,0,3,3
43547,4,2,152520,152520,152522,0,2,1
43548,2,2,152522,152522,152524,0,2,0
43549,6,2,152528,152528,152530,0,2,4
43550,1,1,152529,152530,152531,1,2,0
43551,1,1,152530,152531,152532,1,2,0
43552,2,1,152532,152532,152533,0,1,0
43553,1,2,152533,152533,152535,0,2,0
43554,3,3,152536,152536,152539,0,3,1
43555,6,3,152542,152542,152545,0,3,3
43556,2,2,152544,152545,152547,1,3,0
43557,6,1,152550,152550,152551,0,1,3
43558,2,2,152552,152552,152554,0,2,1
43559,5,2,152557,152557,152559,0,2,3
43560,6,3,152563,152563,152566,0,3,4
43561,3,2,152566,152566,152568,0,2,0
43562,1,3,152567,152568,152571,1,4,0
43563,1,3,152568,152571,152574,3,6,0
43564,2,1,152570,152574,152575,4,5,0
43565,1,3,152571,152575,152578,4,7,0
43566,3,1,152574,152578,152579,4,5,0
43567,4,1,152578,152579,152580,1,2,0
43568,4,1,152582,152582,152583,0,1,2
43569,4,1,152586,152586,152587,0,1,3
43570,4,2,152590,152590,152592,0,2,3
43571,2,3,152592,152592,152595,0,3,0
43572,3,3,152595,152595,152598,0,3,0
43573,1,2,152596,152598,152600,2,4,0
43574,3,1,152599,152600,152601,1,2,0
43575,4,3,152603,152603,152606,0,3,2
43576,5,2,152608,152608,152610,0,2,2
43577,3,2,152611,152611,152613,0,2,1
43578,6,2,152617,152617,152619,0,2,4
43579,4,2,152621,152621,152623,0,2,2
43580,6,2,152627,152627,152629,0,2,4
43581,2,2,152629,152629,152631,0,2,0
43582,5,1,152634,152634,152635,0,1,3
43583,2,3,152636,152636,152639,0,3,1
43584,1,1,152637,152639,152640,2,3,0
43585,6,1,152643,152643,152644,0,1,3
43586,1,3,152644,152644,152647,0,3,0
43587,6,1,152650,152650,152651,0,1,3
43588,5,1,152655,152655,152656,0,1,4
43589,1,3,152656,152656,152659,0,3,0
43590,1,2,152657,152659,152661,2,4,0
43591,4,3,152661,152661,152664,0,3,0
43592,4,2,152665,152665,152667,0,2,1
43593,3,2,152668,152668,152670,0,2,1
43594,5,1,152673,152673,152674,0,1,3
43595,6,3,152679,152679,152682,0,3,5
43596,6,2,152685,152685,152687,0,2,3
43597,3,3,152688,152688,152691,0,3,1
43598,2,2,152690,152691,152693,1,3,0
43599,4,1,152694,152694,152695,0,1,1
43600,1,3,152695,152695,152698,0,3,0
43601,2,1,152697,152698,152699,1,2,0
43602,5,1,152702,152702,152703,0,1,3
43603,2,2,152704,152704,152706,0,2,1
43604,3,2,152707,152707,152709,0,2,1
43605,4,1,152711,152711,152712,0,1,2
43606,3,3,152714,152714,152717,0,3,2
43607,6,2,152720,152720,152722,0,2,3
43608,4,2,152724,152724,152726,0,2,2
43609,6,3,152730,152730,152733,0,3,4
43610,1,1,152731,152733,152734,2,3,0
43611,1,2,152732,152734,152736,2,4,0
43612,5,1,152737,152737,152738,0,1,1
43613,5,1,152742,152742,152743,0,1,4
43614,1,3,152743,152743,152746,0,3,0
43615,6,1,152749,152749,152750,0,1,3
43616,4,1,152753,152753,152754,0,1,3
43617,5,2,152758,152758,152760,0,2,4
43618,2,3,152760,152760,152763,0,3,0
43619,2,2,152762,152763,152765,1,3,0
43620,2,2,152764,152765,152767,1,3,0
43621,4,1,152768,152768,152769,0,1,1
43622,1,1,152769,152769,152770,0,1,0
43623,4,1,152773,152773,152774,0,1,3
43624,4,2,152777,152777,152779,0,2,3
43625,3,2,152780,152780,152782,0,2,1
43626,4,2,152784,152784,152786,0,2,2
43627,4,3,152788,152788,152791,0,3,2
43628,1,1,152789,152791,152792,2,3,0
43629,3,3,152792,152792,152795,0,3,0
43630,5,1,152797,152797,152798,0,1,2
43631,5,3,152802,152802,152805,0,3,4
43632,6,2,152808,152808,152810,0,2,3
43633,6,1,152814,152814,152815,0,1,4
43634,5,3,152819,152819,152822,0,3,4
43635,2,3,152821,152822,152825,1,4,0
43636,3,3,152824,152825,152828,1,4,0
43637,1,3,152825,152828,152831,3,6,0
43638,6,2,152831,152831,152833,0,2,0
43639,6,1,152837,152837,152838,0,1,4
43640,6,3,152843,152843,152846,0,3,5
43641,5,3,152848,152848,152851,0,3,2
43642,5,3,152853,152853,152856,0,3,2
43643,6,3,152859,152859,152862,0,3,3
43644,2,3,152861,152862,152865,1,4,0
43645,6,2,152867,152867,152869,0,2,2
43646,3,1,152870,152870,152871,0,1,1
43647,4,3,152874,152874,152877,0,3,3
43648,1,3,152875,152877,152880,2,5,0
43649,3,2,152878,152880,152882,2,4,0
43650,4,1,152882,152882,152883,0,1,0
43651,3,2,152885,152885,152887,0,2,2
43652,2,2,152887,152887,152889,0,2,0
43653,5,2,152892,152892,152894,0,2,3
43654,5,2,152897,152897,152899,0,2,3
43655,5,1,152902,152902,152903,0,1,3
43656,1,3,152903,152903,152906,0,3,0
43657,5,1,152908,152908,152909,0,1,2
43658,4,2,152912,152912,152914,0,2,3
43659,5,3,152917,152917,152920,0,3,3
43660,1,3,152918,152920,152923,2,5,0
43661,1,1,152919,152923,152924,4,5,0
43662,4,2,152923,152924,152926,1,3,0
43663,1,3,152924,152926,152929,2,5,0
43664,2,3,152926,152929,152932,3,6,0
43665,4,2,152930,152932,152934,2,4,0
43666,5,1,152935,152935,152936,0,1,1
43667,3,2,152938,152938,152940,0,2,2
43668,4,3,152942,152942,152945,0,3,2
43669,4,1,152946,152946,152947,0,1,1
43670,1,1,152947,152947,152948,0,1,0
43671,4,1,152951,152951,152952,0,1,3
43672,5,2,152956,152956,152958,0,2,4
43673,5,3,152961,152961,152964,0,3,3
43674,1,3,152962,152964,152967,2,5,0
43675,6,1,152968,152968,152969,0,1,1
43676,2,1,152970,152970,152971,0,1,1
43677,1,3,152971,152971,152974,0,3,0
43678,4,2,152975,152975,152977,0,2,1
43679,5,2,152980,152980,152982,0,2,3
43680,6,1,152986,152986,152987,0,1,4
43681,1,1,152987,152987,152988,0,1,0
43682,1,1,152988,152988,152989,0,1,0
43683,4,3,152992,152992,152995,0,3,3
43684,1,1,152993,152995,152996,2,3,0
43685,2,1,152995,152996,152997,1,2,0
43686,2,3,152997,152997,153000,0,3,0
43687,1,2,152998,153000,153002,2,4,0
43688,1,3,152999,153002,153005,3,6,0
43689,3,1,153002,153005,153006,3,4,0
43690,2,1,153004,153006,153007,2,3,0
43691,5,2,153009,153009,153011,0,2,2
43692,6,3,153015,153015,153018,0,3,4
43693,3,1,153018,153018,153019,0,1,0
43694,2,3,153020,153020,153023,0,3,1
43695,5,2,153025,153025,153027,0,2,2
43696,3,2,153028,153028,153030,0,2,1
43697,6,2,153034,153034,153036,0,2,4
43698,3,1,153037,153037,153038,0,1,1
43699,4,1,153041,153041,153042,0,1,3
43700,1,1,153042,153042,153043,0,1,0
43701,3,1,153045,153045,153046,0,1,2
43702,6,2,153051,153051,153053,0,2,5
43703,5,2,153056,153056,153058,0,2,3
43704,3,3,153059,153059,153062,0,3,1
43705,2,3,153061,153062,153065,1,4,0
43706,3,2,153064,153065,153067,1,3,0
43707,2,3,153066,153067,153070,1,4,0
43708,3,3,153069,153070,153073,1,4,0
43709,2,1,153071,153073,153074,2,3,0
43710,1,3,153072,153074,153077,2,5,0
43711,1,3,153073,153077,153080,4,7,0
43712,6,2,153079,153080,153082,1,3,0
43713,3,1,153082,153082,153083,0,1,0
43714,5,1,153087,153087,153088,0,1,4
43715,6,3,153093,153093,153096,0,3,5
43716,6,1,153099,153099,153100,0,1,3
43717,6,1,153105,153105,153106,0,1,5
43718,4,3,153109,153109,153112,0,3,3
43719,5,1,153114,153114,153115,0,1,2
43720,2,2,153116,153116,153118,0,2,1
43721,2,3,153118,153118,153121,0,3,0
43722,6,1,153124,153124,153125,0,1,3
43723,1,2,153125,153125,153127,0,2,0
43724,3,2,153128,153128,153130,0,2,1
43725,6,2,153134,153134,153136,0,2,4
43726,3,3,153137,153137,153140,0,3,1
43727,4,2,153141,153141,153143,0,2,1
43728,3,3,153144,153144,153147,0,3,1
43729,6,2,153150,153150,153152,0,2,3
43730,4,2,153154,153154,153156,0,2,2
43731,6,1,153160,153160,153161,0,1,4
43732,4,1,153164,153164,153165,0,1,3
43733,2,3,153166,153166,153169,0,3,1
43734,5,1,153171,153171,153172,0,1,2
43735,4,1,153175,153175,153176,0,1,3
43736,3,2,153178,153178,153180,0,2,2
43737,3,1,153181,153181,153182,0,1,1
43738,5,3,153186,153186,153189,0,3,4
43739,6,2,153192,153192,153194,0,2,3
43740,4,1,153196,153196,153197,0,1,2
43741,6,2,153202,153202,153204,0,2,5
43742,2,3,153204,153204,153207,0,3,0
43743,5,1,153209,153209,153210,0,1,2
43744,5,2,153214,153214,153216,0,2,4
43745,2,2,153216,153216,153218,0,2,0
43746,6,2,153222,153222,153224,0,2,4
43747,1,1,153223,153224,153225,1,2,0
43748,1,1,153224,153225,153226,1,2,0
43749,2,1,153226,153226,153227,0,1,0
43750,4,1,153230,153230,153231,0,1,3
43751,5,3,153235,153235,153238,0,3,4
43752,4,3,153239,153239,153242,0,3,1
43753,6,3,153245,153245,153248,0,3,3
43754,4,3,153249,153249,153252,0,3,1
43755,5,2,153254,153254,153256,0,2,2
43756,5,2,153259,153259,153261,0,2,3
43757,1,3,153260,153261,153264,1,4,0
43758,2,2,153262,153264,153266,2,4,0
43759,6,1,153268,153268,153269,0,1,2
43760,1,1,153269,153269,153270,0,1,0
43761,1,3,153270,153270,153273,0,3,0
43762,6,3,153276,153276,153279,0,3,3
43763,1,2,153277,153279,153281,2,4,0
43764,4,3,153281,153281,153284,0,3,0
43765,6,3,153287,153287,153290,0,3,3
43766,2,1,153289,153290,153291,1,2,0
43767,1,3,153290,153291,153294,1,4,0
43768,2,2,153292,153294,153296,2,4,0
43769,4,2,153296,153296,153298,0,2,0
43770,2,3,153298,153298,153301,0,3,0
43771,2,2,153300,153301,153303,1,3,0
43772,3,1,153303,153303,153304,0,1,0
43773,6,2,153309,153309,153311,0,2,5
43774,5,1,153314,153314,153315,0,1,3
43775,6,1,153320,153320,153321,0,1,5
43776,6,3,153326,153326,153329,0,3,5
43777,2,3,153328,153329,153332,1,4,0
43778,4,1,153332,153332,153333,0,1,0
43779,1,1,153333,153333,153334,0,1,0
43780,2,1,153335,153335,153336,0,1,1
43781,6,3,153341,153341,153344,0,3,5
43782,6,1,153347,153347,153348,0,1,3
43783,3,1,153350,153350,153351,0,1,2
43784,4,3,153354,153354,153357,0,3,3
43785,5,1,153359,153359,153360,0,1,2
43786,3,1,153362,153362,153363,0,1,2
43787,3,3,153365,153365,153368,0,3,2
43788,1,1,153366,153368,153369,2,3,0
43789,5,2,153371,153371,153373,0,2,2
43790,1,1,153372,153373,153374,1,2,0
43791,1,1,153373,153374,153375,1,2,0
43792,4,3,153377,153377,153380,0,3,2
43793,2,3,153379,153380,153383,1,4,0
43794,2,3,153381,153383,153386,2,5,0
43795,6,3,153387,153387,153390,0,3,1
43796,3,3,153390,153390,153393,0,3,0
43797,3,3,153393,153393,153396,0,3,0
43798,1,1,153394,153396,153397,2,3,0
43799,5,3,153399,153399,153402,0,3,2
43800,3,2,153402,153402,153404,0,2,0
43801,5,1,153407,153407,153408,0,1,3
43802,2,3,153409,153409,153412,0,3,1
43803,2,3,153411,153412,153415,1,4,0
43804,6,3,153417,153417,153420,0,3,2
43805,2,3,153419,153420,153423,1,4,0
43806,2,1,153421,153423,153424,2,3,0
43807,3,3,153424,153424,153427,0,3,0
43808,1,3,153425,153427,153430,2,5,0
43809,2,1,153427,153430,153431,3,4,0
43810,2,3,153429,153431,153434,2,5,0
43811,2,3,153431,153434,153437,3,6,0
43812,4,1,153435,153437,153438,2,3,0
43813,3,1,153438,153438,153439,0,1,0
43814,2,2,153440,153440,153442,0,2,1
43815,3,3,153443,153443,153446,0,3,1
43816,3,1,153446,153446,153447,0,1,0
43817,2,1,153448,153448,153449,0,1,1
43818,4,1,153452,153452,153453,0,1,3
43819,6,1,153458,153458,153459,0,1,5
43820,3,1,153461,153461,153462,0,1,2
43821,6,3,153467,153467,153470,0,3,5
43822,5,2,153472,153472,153474,0,2,2
43823,2,1,153474,153474,153475,0,1,0
43824,1,1,153475,153475,153476,0,1,0
43825,2,1,153477,153477,153478,0,1,1
43826,3,3,153480,153480,153483,0,3,2
43827,1,3,153481,153483,153486,2,5,0
43828,6,2,153487,153487,153489,0,2,1
43829,4,3,153491,153491,153494,0,3,2
43830,4,1,153495,153495,153496,0,1,1
43831,5,2,153500,153500,153502,0,2,4
43832,5,3,153505,153505,153508,0,3,3
43833,3,2,153508,153508,153510,0,2,0
43834,5,2,153513,153513,153515,0,2,3
43835,6,3,153519,153519,153522,0,3,4
43836,3,1,153522,153522,153523,0,1,0
43837,4,3,153526,153526,153529,0,3,3
43838,5,2,153531,153531,153533,0,2,2
43839,4,3,153535,153535,153538,0,3,2
43840,2,3,153537,153538,153541,1,4,0
43841,1,1,153538,153541,153542,3,4,0
43842,6,3,153544,153544,153547,0,3,2
43843,5,3,153549,153549,153552,0,3,2
43844,6,3,153555,153555,153558,0,3,3
43845,3,1,153558,153558,153559,0,1,0
43846,3,3,153561,153561,153564,0,3,2
43847,4,2,153565,153565,153567,0,2,1
43848,6,2,153571,153571,153573,0,2,4
43849,1,2,153572,153573,153575,1,3,0
43850,5,3,153577,153577,153580,0,3,2
43851,3,1,153580,153580,153581,0,1,0
43852,5,3,153585,153585,153588,0,3,4
43853,4,2,153589,153589,153591,0,2,1
43854,5,3,153594,153594,153597,0,3,3
43855,2,3,153596,153597,153600,1,4,0
43856,4,2,153600,153600,153602,0,2,0
43857,4,1,153604,153604,153605,0,1,2
43858,6,2,153610,153610,153612,0,2,5
43859,2,1,153612,153612,153613,0,1,0
43860,3,1,153615,153615,153616,0,1,2
43861,4,3,153619,153619,153622,0,3,3
43862,4,2,153623,153623,153625,0,2,1
43863,4,3,153627,153627,153630,0,3,2
43864,5,1,153632,153632,153633,0,1,2
43865,5,1,153637,153637,153638,0,1,4
43866,2,2,153639,153639,153641,0,2,1
43867,4,2,153643,153643,153645,0,2,2
43868,4,2,153647,153647,153649,0,2,2
43869,3,1,153650,153650,153651,0,1,1
43870,4,3,153654,153654,153657,0,3,3
43871,6,3,153660,153660,153663,0,3,3
43872,5,3,153665,153665,153668,0,3,2
43873,4,1,153669,153669,153670,0,1,1
43874,5,3,153674,153674,153677,0,3,4
43875,3,3,153677,153677,153680,0,3,0
43876,5,1,153682,153682,153683,0,1,2
43877,5,3,153687,153687,153690,0,3,4
43878,4,2,153691,153691,153693,0,2,1
43879,5,1,153696,153696,153697,0,1,3
43880,6,1,153702,153702,153703,0,1,5
43881,4,3,153706,153706,153709,0,3,3
43882,3,2,153709,153709,153711,0,2,0
43883,1,3,153710,153711,153714,1,4,0
43884,3,1,153713,153714,153715,1,2,0
43885,2,1,153715,153715,153716,0,1,0
43886,5,1,153720,153720,153721,0,1,4
43887,2,3,153722,153722,153725,0,3,1
43888,2,1,153724,153725,153726,1,2,0
43889,2,2,153726,153726,153728,0,2,0
43890,4,2,153730,153730,153732,0,2,2
43891,6,2,153736,153736,153738,0,2,4
43892,6,2,153742,153742,153744,0,2,4
43893,3,1,153745,153745,153746,0,1,1
43894,4,2,153749,153749,153751,0,2,3
43895,2,2,153751,153751,153753,0,2,0
43896,5,1,153756,153756,153757,0,1,3
43897,3,2,153759,153759,153761,0,2,2
43898,3,2,153762,153762,153764,0,2,1
43899,2,1,153764,153764,153765,0,1,0
43900,5,3,153769,153769,153772,0,3,4
43901,6,3,153775,153775,153778,0,3,3
43902,3,2,153778,153778,153780,0,2,0
43903,1,3,153779,153780,153783,1,4,0
43904,6,2,153785,153785,153787,0,2,2
43905,2,1,153787,153787,153788,0,1,0
43906,6,1,153793,153793,153794,0,1,5
43907,5,1,153798,153798,153799,0,1,4
43908,6,3,153804,153804,153807,0,3,5
43909,3,3,153807,153807,153810,0,3,0
43910,1,1,153808,153810,153811,2,3,0
43911,5,1,153813,153813,153814,0,1,2
43912,1,2,153814,153814,153816,0,2,0
43913,6,1,153820,153820,153821,0,1,4
43914,2,1,153822,153822,153823,0,1,1
43915,5,3,153827,153827,153830,0,3,4
43916,1,1,153828,153830,153831,2,3,0
43917,6,2,153834,153834,153836,0,2,3
43918,6,1,153840,153840,153841,0,1,4
43919,1,2,153841,153841,153843,0,2,0
43920,6,3,153847,153847,153850,0,3,4
43921,3,1,153850,153850,153851,0,1,0
43922,4,1,153854,153854,153855,0,1,3
43923,1,1,153855,153855,153856,0,1,0
43924,5,1,153860,153860,153861,0,1,4
43925,3,1,153863,153863,153864,0,1,2
43926,2,1,153865,153865,153866,0,1,1
43927,6,1,153871,153871,153872,0,1,5
43928,3,3,153874,153874,153877,0,3,2
43929,5,3,153879,153879,153882,0,3,2
43930,1,2,153880,153882,153884,2,4,0
43931,3,2,153883,153884,153886,1,3,0
43932,3,2,153886,153886,153888,0,2,0
43933,3,2,153889,153889,153891,0,2,1
43934,3,2,153892,153892,153894,0,2,1
43935,3,3,153895,153895,153898,0,3,1
43936,5,1,153900,153900,153901,0,1,2
43937,3,3,153903,153903,153906,0,3,2
43938,1,2,153904,153906,153908,2,4,0
43939,2,3,153906,153908,153911,2,5,0
43940,6,3,153912,153912,153915,0,3,1
43941,4,3,153916,153916,153919,0,3,1
43942,5,1,153921,153921,153922,0,1,2
43943,5,2,153926,153926,153928,0,2,4
43944,3,1,153929,153929,153930,0,1,1
43945,6,3,153935,153935,153938,0,3,5
43946,3,3,153938,153938,153941,0,3,0
43947,4,3,153942,153942,153945,0,3,1
43948,6,1,153948,153948,153949,0,1,3
43949,5,1,153953,153953,153954,0,1,4
43950,2,1,153955,153955,153956,0,1,1
43951,2,1,153957,153957,153958,0,1,1
43952,3,2,153960,153960,153962,0,2,2
43953,1,1,153961,153962,153963,1,2,0
43954,5,1,153966,153966,153967,0,1,3
43955,5,1,153971,153971,153972,0,1,4
43956,5,1,153976,153976,153977,0,1,4
43957,5,1,153981,153981,153982,0,1,4
43958,1,3,153982,153982,153985,0,3,0
43959,6,2,153988,153988,153990,0,2,3
43960,3,1,153991,153991,153992,0,1,1
43961,4,1,153995,153995,153996,0,1,3
43962,1,3,153996,153996,153999,0,3,0
43963,1,3,153997,153999,154002,2,5,0
43964,4,2,154001,154002,154004,1,3,0
43965,5,2,154006,154006,154008,0,2,2
43966,4,3,154010,154010,154013,0,3,2
43967,3,2,154013,154013,154015,0,2,0
43968,1,1,154014,154015,154016,1,2,0
43969,2,3,154016,154016,154019,0,3,0
43970,3,1,154019,154019,154020,0,1,0
43971,2,3,154021,154021,154024,0,3,1
43972,1,3,154022,154024,154027,2,5,0
43973,5,3,154027,154027,154030,0,3,0
43974,2,2,154029,154030,154032,1,3,0
43975,4,1,154033,154033,154034,0,1,1
43976,6,2,154039,154039,154041,0,2,5
43977,6,1,154045,154045,154046,0,1,4
43978,6,3,154051,154051,154054,0,3,5
43979,5,3,154056,154056,154059,0,3,2
43980,4,3,154060,154060,154063,0,3,1
43981,2,2,154062,154063,154065,1,3,0
43982,6,2,154068,154068,154070,0,2,3
43983,6,2,154074,154074,154076,0,2,4
43984,1,2,154075,154076,154078,1,3,0
43985,3,3,154078,154078,154081,0,3,0
43986,6,2,154084,154084,154086,0,2,3
43987,2,2,154086,154086,154088,0,2,0
43988,4,3,154090,154090,154093,0,3,2
43989,4,1,154094,154094,154095,0,1,1
43990,2,2,154096,154096,154098,0,2,1
43991,1,1,154097,154098,154099,1,2,0
43992,6,3,154103,154103,154106,0,3,4
43993,4,2,154107,154107,154109,0,2,1
43994,2,2,154109,154109,154111,0,2,0
43995,5,2,154114,154114,154116,0,2,3
43996,1,1,154115,154116,154117,1,2,0
43997,3,2,154118,154118,154120,0,2,1
43998,1,2,154119,154120,154122,1,3,0
43999,1,2,154120,154122,154124,2,4,0
44000,6,3,154126,154126,154129,0,3,2
44001,6,1,154132,154132,154133,0,1,3
44002,5,3,154137,154137,154140,0,3,4
44003,2,2,154139,154140,154142,1,3,0
44004,2,1,154141,154142,154143,1,2,0
44005,1,1,154142,154143,154144,1,2,0
44006,1,1,154143,154144,154145,1,2,0
44007,2,2,154145,154145,154147,0,2,0
44008,1,1,154146,154147,154148,1,2,0
44009,4,2,154150,154150,154152,0,2,2
44010,1,1,154151,154152,154153,1,2,0
44011,1,1,154152,154153,154154,1,2,0
44012,1,3,154153,154154,154157,1,4,0
44013,5,1,154158,154158,154159,0,1,1
44014,5,1,154163,154163,154164,0,1,4
44015,1,2,154164,154164,154166,0,2,0
44016,6,3,154170,154170,154173,0,3,4
44017,6,3,154176,154176,154179,0,3,3
44018,4,1,154180,154180,154181,0,1,1
44019,6,2,154186,154186,154188,0,2,5
44020,3,2,154189,154189,154191,0,2,1
44021,3,3,154192,154192,154195,0,3,1
44022,4,1,154196,154196,154197,0,1,1
44023,3,3,154199,154199,154202,0,3,2
44024,4,3,154203,154203,154206,0,3,1
44025,5,3,154208,154208,154211,0,3,2
44026,6,1,154214,154214,154215,0,1,3
44027,2,1,154216,154216,154217,0,1,1
44028,3,2,154219,154219,154221,0,2,2
44029,2,1,154221,154221,154222,0,1,0
44030,5,3,154226,154226,154229,0,3,4
44031,6,1,154232,154232,154233,0,1,3
44032,1,2,154233,154233,154235,0,2,0
44033,5,2,154238,154238,154240,0,2,3
44034,2,1,154240,154240,154241,0,1,0
44035,5,2,154245,154245,154247,0,2,4
44036,1,3,154246,154247,154250,1,4,0
44037,4,2,154250,154250,154252,0,2,0
44038,2,1,154252,154252,154253,0,1,0
44039,3,2,154255,154255,154257,0,2,2
44040,3,3,154258,154258,154261,0,3,1
44041,5,3,154263,154263,154266,0,3,2
44042,1,2,154264,154266,154268,2,4,0
44043,4,1,154268,154268,154269,0,1,0
44044,3,3,154271,154271,154274,0,3,2
44045,3,1,154274,154274,154275,0,1,0
44046,5,2,154279,154279,154281,0,2,4
44047,2,1,154281,154281,154282,0,1,0
44048,6,1,154287,154287,154288,0,1,5
44049,3,3,154290,154290,154293,0,3,2
44050,6,2,154296,154296,154298,0,2,3
44051,5,3,154301,154301,154304,0,3,3
44052,6,2,154307,154307,154309,0,2,3
44053,4,3,154311,154311,154314,0,3,2
44054,6,3,154317,154317,154320,0,3,3
44055,1,2,154318,154320,154322,2,4,0
44056,4,3,154322,154322,154325,0,3,0
44057,4,1,154326,154326,154327,0,1,1
44058,3,2,154329,154329,154331,0,2,2
44059,6,2,154335,154335,154337,0,2,4
44060,1,1,154336,154337,154338,1,2,0
44061,4,3,154340,154340,154343,0,3,2
44062,1,1,154341,154343,154344,2,3,0
44063,5,3,154346,154346,154349,0,3,2
44064,5,2,154351,154351,154353,0,2,2
44065,1,3,154352,154353,154356,1,4,0
44066,5,3,154357,154357,154360,0,3,1
44067,3,2,154360,154360,154362,0,2,0
44068,5,1,154365,154365,154366,0,1,3
44069,5,1,154370,154370,154371,0,1,4
44070,5,2,154375,154375,154377,0,2,4
44071,5,1,154380,154380,154381,0,1,3
44072,4,2,154384,154384,154386,0,2,3
44073,2,1,154386,154386,154387,0,1,0
44074,2,3,154388,154388,154391,0,3,1
44075,4,3,154392,154392,154395,0,3,1
44076,4,3,154396,154396,154399,0,3,1
44077,5,1,154401,154401,154402,0,1,2
44078,6,1,154407,154407,154408,0,1,5
44079,4,3,154411,154411,154414,0,3,3
44080,5,3,154416,154416,154419,0,3,2
44081,5,1,154421,154421,154422,0,1,2
44082,3,3,154424,154424,154427,0,3,2
44083,1,1,154425,154427,154428,2,3,0
44084,2,3,154427,154428,154431,1,4,0
44085,6,1,154433,154433,154434,0,1,2
44086,3,2,154436,154436,154438,0,2,2
44087,3,2,154439,154439,154441,0,2,1
44088,5,2,154444,154444,154446,0,2,3
44089,5,1,154449,154449,154450,0,1,3
44090,4,2,154453,154453,154455,0,2,3
44091,1,2,154454,154455,154457,1,3,0
44092,6,2,154460,154460,154462,0,2,3
44093,1,1,154461,154462,154463,1,2,0
44094,2,3,154463,154463,154466,0,3,0
44095,5,3,154468,154468,154471,0,3,2
44096,3,3,154471,154471,154474,0,3,0
44097,3,3,154474,154474,154477,0,3,0
44098,6,2,154480,154480,154482,0,2,3
44099,6,3,154486,154486,154489,0,3,4
44100,1,1,154487,154489,154490,2,3,0
44101,3,2,154490,154490,154492,0,2,0
44102,6,2,154496,154496,154498,0,2,4
44103,2,2,154498,154498,154500,0,2,0
44104,2,3,154500,154500,154503,0,3,0
44105,3,1,154503,154503,154504,0,1,0
44106,6,1,154509,154509,154510,0,1,5
44107,3,1,154512,154512,154513,0,1,2
44108,6,1,154518,154518,154519,0,1,5
44109,6,1,154524,154524,154525,0,1,5
44110,2,3,154526,154526,154529,0,3,1
44111,5,2,154531,154531,154533,0,2,2
44112,3,3,154534,154534,154537,0,3,1
44113,2,3,154536,154537,154540,1,4,0
44114,6,3,154542,154542,154545,0,3,2
44115,4,3,154546,154546,154549,0,3,1
44116,1,3,154547,154549,154552,2,5,0
44117,4,1,154551,154552,154553,1,2,0
44118,5,2,154556,154556,154558,0,2,3
44119,6,3,154562,154562,154565,0,3,4
44120,6,3,154568,154568,154571,0,3,3
44121,1,3,154569,154571,154574,2,5,0
44122,5,2,154574,154574,154576,0,2,0
44123,5,3,154579,154579,154582,0,3,3
44124,4,3,154583,154583,154586,0,3,1
44125,6,2,154589,154589,154591,0,2,3
44126,1,1,154590,154591,154592,1,2,0
44127,5,3,154595,154595,154598,0,3,3
44128,3,1,154598,154598,154599,0,1,0
44129,4,1,154602,154602,154603,0,1,3
44130,5,3,154607,154607,154610,0,3,4
44131,5,1,154612,154612,154613,0,1,2
44132,3,1,154615,154615,154616,0,1,2
44133,3,1,154618,154618,154619,0,1,2
44134,5,3,154623,154623,154626,0,3,4
44135,5,1,154628,154628,154629,0,1,2
44136,6,2,154634,154634,154636,0,2,5
44137,5,3,154639,154639,154642,0,3,3
44138,6,1,154645,154645,154646,0,1,3
44139,4,2,154649,154649,154651,0,2,3
44140,4,3,154653,154653,154656,0,3,2
44141,6,2,154659,154659,154661,0,2,3
44142,5,2,154664,154664,154666,0,2,3
44143,3,2,154667,154667,154669,0,2,1
44144,5,1,154672,154672,154673,0,1,3
44145,5,2,154677,154677,154679,0,2,4
44146,6,2,154683,154683,154685,0,2,4
44147,6,3,154689,154689,154692,0,3,4
44148,4,1,154693,154693,154694,0,1,1
44149,1,3,154694,154694,154697,0,3,0
44150,5,2,154699,154699,154701,0,2,2
44151,3,2,154702,154702,154704,0,2,1
44152,1,2,154703,154704,154706,1,3,0
44153,3,3,154706,154706,154709,0,3,0
44154,3,3,154709,154709,154712,0,3,0
44155,4,1,154713,154713,154714,0,1,1
44156,6,3,154719,154719,154722,0,3,5
44157,4,1,154723,154723,154724,0,1,1
44158,1,1,154724,154724,154725,0,1,0
44159,6,2,154730,154730,154732,0,2,5
44160,6,3,154736,154736,154739,0,3,4
44161,5,1,154741,154741,154742,0,1,2
44162,2,2,154743,154743,154745,0,2,1
44163,6,1,154749,154749,154750,0,1,4
44164,4,1,154753,154753,154754,0,1,3
44165,4,2,154757,154757,154759,0,2,3
44166,1,3,154758,154759,154762,1,4,0
44167,5,3,154763,154763,154766,0,3,1
44168,5,3,154768,154768,154771,0,3,2
44169,3,1,154771,154771,154772,0,1,0
44170,4,2,154775,154775,154777,0,2,3
44171,1,1,154776,154777,154778,1,2,0
44172,4,1,154780,154780,154781,0,1,2
44173,1,3,154781,154781,154784,0,3,0
44174,3,3,154784,154784,154787,0,3,0
44175,3,1,154787,154787,154788,0,1,0
44176,4,2,154791,154791,154793,0,2,3
44177,5,2,154796,154796,154798,0,2,3
44178,4,3,154800,154800,154803,0,3,2
44179,1,1,154801,154803,154804,2,3,0
44180,2,1,154803,154804,154805,1,2,0
44181,3,2,154806,154806,154808,0,2,1
44182,3,2,154809,154809,154811,0,2,1
44183,2,1,154811,154811,154812,0,1,0
44184,5,3,154816,154816,154819,0,3,4
44185,1,2,154817,154819,154821,2,4,0
44186,5,1,154822,154822,154823,0,1,1
44187,6,3,154828,154828,154831,0,3,5
44188,2,1,154830,154831,154832,1,2,0
44189,5,2,154835,154835,154837,0,2,3
44190,1,3,154836,154837,154840,1,4,0
44191,6,3,154842,154842,154845,0,3,2
44192,5,1,154847,154847,154848,0,1,2
44193,4,2,154851,154851,154853,0,2,3
44194,3,2,154854,154854,154856,0,2,1
44195,3,3,154857,154857,154860,0,3,1
44196,6,2,154863,154863,154865,0,2,3
44197,1,1,154864,154865,154866,1,2,0
44198,3,3,154867,154867,154870,0,3,1
44199,4,1,154871,154871,154872,0,1,1
44200,3,2,154874,154874,154876,0,2,2
44201,5,3,154879,154879,154882,0,3,3
44202,5,1,154884,154884,154885,0,1,2
44203,1,2,154885,154885,154887,0,2,0
44204,1,2,154886,154887,154889,1,3,0
44205,2,2,154888,154889,154891,1,3,0
44206,6,2,154894,154894,154896,0,2,3
44207,4,2,154898,154898,154900,0,2,2
44208,4,2,154902,154902,154904,0,2,2
44209,4,3,154906,154906,154909,0,3,2
44210,2,1,154908,154909,154910,1,2,0
44211,6,1,154914,154914,154915,0,1,4
44212,5,3,154919,154919,154922,0,3,4
44213,2,3,154921,154922,154925,1,4,0
44214,2,3,154923,154925,154928,2,5,0
44215,5,1,154928,154928,154929,0,1,0
44216,5,3,154933,154933,154936,0,3,4
44217,2,3,154935,154936,154939,1,4,0
44218,6,2,154941,154941,154943,0,2,2
44219,3,1,154944,154944,154945,0,1,1
44220,5,1,154949,154949,154950,0,1,4
44221,1,1,154950,154950,154951,0,1,0
44222,5,2,154955,154955,154957,0,2,4
44223,1,2,154956,154957,154959,1,3,0
44224,2,2,154958,154959,154961,1,3,0
44225,6,3,154964,154964,154967,0,3,3
44226,3,1,154967,154967,154968,0,1,0
44227,1,1,154968,154968,154969,0,1,0
44228,5,3,154973,154973,154976,0,3,4
44229,3,2,154976,154976,154978,0,2,0
44230,3,3,154979,154979,154982,0,3,1
44231,3,3,154982,154982,154985,0,3,0
44232,4,2,154986,154986,154988,0,2,1
44233,4,2,154990,154990,154992,0,2,2
44234,5,2,154995,154995,154997,0,2,3
44235,2,3,154997,154997,155000,0,3,0
44236,1,2,154998,155000,155002,2,4,0
44237,1,2,154999,155002,155004,3,5,0
44238,6,2,155005,155005,155007,0,2,1
44239,6,3,155011,155011,155014,0,3,4
44240,4,2,155015,155015,155017,0,2,1
44241,4,2,155019,155019,155021,0,2,2
44242,3,1,155022,155022,155023,0,1,1
44243,3,1,155025,155025,155026,0,1,2
44244,6,3,155031,155031,155034,0,3,5
44245,2,2,155033,155034,155036,1,3,0
44246,4,2,155037,155037,155039,0,2,1
44247,5,1,155042,155042,155043,0,1,3
44248,3,3,155045,155045,155048,0,3,2
44249,5,2,155050,155050,155052,0,2,2
44250,6,2,155056,155056,155058,0,2,4
44251,3,3,155059,155059,155062,0,3,1
44252,6,1,155065,155065,155066,0,1,3
44253,4,3,155069,155069,155072,0,3,3
44254,6,1,155075,155075,155076,0,1,3
44255,1,2,155076,155076,155078,0,2,0
44256,2,1,155078,155078,155079,0,1,0
44257,4,3,155082,155082,155085,0,3,3
44258,3,2,155085,155085,155087,0,2,0
44259,6,3,155091,155091,155094,0,3,4
44260,3,2,155094,155094,155096,0,2,0
44261,6,1,155100,155100,155101,0,1,4
44262,3,1,155103,155103,155104,0,1,2
44263,1,2,155104,155104,155106,0,2,0
44264,6,2,155110,155110,155112,0,2,4
44265,5,1,155115,155115,155116,0,1,3
44266,6,2,155121,155121,155123,0,2,5
44267,6,3,155127,155127,155130,0,3,4
44268,5,3,155132,155132,155135,0,3,2
44269,1,1,155133,155135,155136,2,3,0
44270,4,1,155137,155137,155138,0,1,1
44271,2,2,155139,155139,155141,0,2,1
44272,6,1,155145,155145,155146,0,1,4
44273,3,2,155148,155148,155150,0,2,2
44274,3,1,155151,155151,155152,0,1,1
44275,5,1,155156,155156,155157,0,1,4
44276,5,1,155161,155161,155162,0,1,4
44277,5,3,155166,155166,155169,0,3,4
44278,1,3,155167,155169,155172,2,5,0
44279,2,3,155169,155172,155175,3,6,0
44280,3,3,155172,155175,155178,3,6,0
44281,1,2,155173,155178,155180,5,7,0
44282,4,1,155177,155180,155181,3,4,0
44283,4,1,155181,155181,155182,0,1,0
44284,3,3,155184,155184,155187,0,3,2
44285,3,2,155187,155187,155189,0,2,0
44286,1,2,155188,155189,155191,1,3,0
44287,1,2,155189,155191,155193,2,4,0
44288,2,2,155191,155193,155195,2,4,0
44289,6,3,155197,155197,155200,0,3,2
44290,6,3,155203,155203,155206,0,3,3
44291,2,2,155205,155206,155208,1,3,0
44292,5,1,155210,155210,155211,0,1,2
44293,1,3,155211,155211,155214,0,3,0
44294,2,3,155213,155214,155217,1,4,0
44295,2,2,155215,155217,155219,2,4,0
44296,6,2,155221,155221,155223,0,2,2
44297,5,2,155226,155226,155228,0,2,3
44298,4,3,155230,155230,155233,0,3,2
44299,6,1,155236,155236,155237,0,1,3
44300,3,2,155239,155239,155241,0,2,2
44301,4,3,155243,155243,155246,0,3,2
44302,5,3,155248,155248,155251,0,3,2
44303,3,3,155251,155251,155254,0,3,0
44304,6,3,155257,155257,155260,0,3,3
44305,4,3,155261,155261,155264,0,3,1
44306,5,1,155266,155266,155267,0,1,2
44307,3,3,155269,155269,155272,0,3,2
44308,6,1,155275,155275,155276,0,1,3
44309,5,1,155280,155280,155281,0,1,4
44310,2,1,155282,155282,155283,0,1,1
44311,1,2,155283,155283,155285,0,2,0
44312,4,2,155287,155287,155289,0,2,2
44313,4,1,155291,155291,155292,0,1,2
44314,3,1,155294,155294,155295,0,1,2
44315,4,2,155298,155298,155300,0,2,3
44316,4,1,155302,155302,155303,0,1,2
44317,4,3,155306,155306,155309,0,3,3
44318,1,3,155307,155309,155312,2,5,0
44319,5,1,155312,155312,155313,0,1,0
44320,1,1,155313,155313,155314,0,1,0
44321,3,3,155316,155316,155319,0,3,2
44322,1,1,155317,155319,155320,2,3,0
44323,1,3,155318,155320,155323,2,5,0
44324,1,3,155319,155323,155326,4,7,0
44325,1,1,155320,155326,155327,6,7,0
44326,4,2,155324,155327,155329,3,5,0
44327,1,2,155325,155329,155331,4,6,0
44328,3,2,155328,155331,155333,3,5,0
44329,3,1,155331,155333,155334,2,3,0
44330,2,2,155333,155334,155336,1,3,0
44331,1,2,155334,155336,155338,2,4,0
44332,2,3,155336,155338,155341,2,5,0
44333,4,1,155340,155341,155342,1,2,0
44334,2,2,155342,155342,155344,0,2,0
44335,2,2,155344,155344,155346,0,2,0
44336,5,1,155349,155349,155350,0,1,3
44337,6,1,155355,155355,155356,0,1,5
44338,2,2,155357,155357,155359,0,2,1
44339,2,1,155359,155359,155360,0,1,0
44340,3,3,155362,155362,155365,0,3,2
44341,3,2,155365,155365,155367,0,2,0
44342,3,1,155368,155368,155369,0,1,1
44343,5,1,155373,155373,155374,0,1,4
44344,3,1,155376,155376,155377,0,1,2
44345,2,2,155378,155378,155380,0,2,1
44346,2,1,155380,155380,155381,0,1,0
44347,1,3,155381,155381,155384,0,3,0
44348,5,3,155386,155386,155389,0,3,2
44349,4,3,155390,155390,155393,0,3,1
44350,2,3,155392,155393,155396,1,4,0
44351,3,1,155395,155396,155397,1,2,0
44352,5,3,155400,155400,155403,0,3,3
44353,5,3,155405,155405,155408,0,3,2
44354,6,2,155411,155411,155413,0,2,3
44355,6,1,155417,155417,155418,0,1,4
44356,2,2,155419,155419,155421,0,2,1
44357,1,1,155420,155421,155422,1,2,0
44358,1,3,155421,155422,155425,1,4,0
44359,1,2,155422,155425,155427,3,5,0
44360,2,1,155424,155427,155428,3,4,0
44361,2,2,155426,155428,155430,2,4,0
44362,3,1,155429,155430,155431,1,2,0
44363,5,2,155434,155434,155436,0,2,3
44364,5,2,155439,155439,155441,0,2,3
44365,4,1,155443,155443,155444,0,1,2
44366,5,3,155448,155448,155451,0,3,4
44367,1,2,155449,155451,155453,2,4,0
44368,3,2,155452,155453,155455,1,3,0
44369,5,2,155457,155457,155459,0,2,2
44370,4,3,155461,155461,155464,0,3,2
44371,3,1,155464,155464,155465,0,1,0
44372,2,1,155466,155466,155467,0,1,1
44373,1,1,155467,155467,155468,0,1,0
44374,6,1,155473,155473,155474,0,1,5
44375,2,2,155475,155475,155477,0,2,1
44376,1,1,155476,155477,155478,1,2,0
44377,5,1,155481,155481,155482,0,1,3
44378,3,2,155484,155484,155486,0,2,2
44379,6,1,155490,155490,155491,0,1,4
44380,1,3,155491,155491,155494,0,3,0
44381,3,1,155494,155494,155495,0,1,0
44382,2,3,155496,155496,155499,0,3,1
44383,3,2,155499,155499,155501,0,2,0
44384,4,2,155503,155503,155505,0,2,2
44385,6,2,155509,155509,155511,0,2,4
44386,1,3,155510,155511,155514,1,4,0
44387,6,1,155516,155516,155517,0,1,2
44388,3,2,155519,155519,155521,0,2,2
44389,6,3,155525,155525,155528,0,3,4
44390,1,2,155526,155528,155530,2,4,0
44391,5,1,155531,155531,155532,0,1,1
44392,3,2,155534,155534,155536,0,2,2
44393,5,3,155539,155539,155542,0,3,3
44394,3,2,155542,155542,155544,0,2,0
44395,6,3,155548,155548,155551,0,3,4
44396,3,3,155551,155551,155554,0,3,0
44397,4,3,155555,155555,155558,0,3,1
44398,3,3,155558,155558,155561,0,3,0
44399,5,2,155563,155563,155565,0,2,2
44400,5,2,155568,155568,155570,0,2,3
44401,1,3,155569,155570,155573,1,4,0
44402,6,2,155575,155575,155577,0,2,2
44403,6,3,155581,155581,155584,0,3,4
44404,6,3,155587,155587,155590,0,3,3
44405,3,1,155590,155590,155591,0,1,0
44406,3,2,155593,155593,155595,0,2,2
44407,2,2,155595,155595,155597,0,2,0
44408,1,1,155596,155597,155598,1,2,0
44409,6,1,155602,155602,155603,0,1,4
44410,5,3,155607,155607,155610,0,3,4
44411,5,1,155612,155612,155613,0,1,2
44412,5,2,155617,155617,155619,0,2,4
44413,2,3,155619,155619,155622,0,3,0
44414,3,1,155622,155622,155623,0,1,0
44415,4,3,155626,155626,155629,0,3,3
44416,3,2,155629,155629,155631,0,2,0
44417,3,3,155632,155632,155635,0,3,1
44418,2,1,155634,155635,155636,1,2,0
44419,4,2,155638,155638,155640,0,2,2
44420,5,2,155643,155643,155645,0,2,3
44421,1,2,155644,155645,155647,1,3,0
44422,6,1,155650,155650,155651,0,1,3
44423,5,2,155655,155655,155657,0,2,4
44424,5,1,155660,155660,155661,0,1,3
44425,1,1,155661,155661,155662,0,1,0
44426,4,2,155665,155665,155667,0,2,3
44427,5,3,155670,155670,155673,0,3,3
44428,5,3,155675,155675,155678,0,3,2
44429,2,3,155677,155678,155681,1,4,0
44430,1,1,155678,155681,155682,3,4,0
44431,5,1,155683,155683,155684,0,1,1
44432,6,1,155689,155689,155690,0,1,5
44433,5,2,155694,155694,155696,0,2,4
44434,3,1,155697,155697,155698,0,1,1
44435,5,1,155702,155702,155703,0,1,4
44436,5,3,155707,155707,155710,0,3,4
44437,4,3,155711,155711,155714,0,3,1
44438,3,2,155714,155714,155716,0,2,0
44439,4,1,155718,155718,155719,0,1,2
44440,1,3,155719,155719,155722,0,3,0
44441,5,1,155724,155724,155725,0,1,2
44442,4,1,155728,155728,155729,0,1,3
44443,4,2,155732,155732,155734,0,2,3
44444,4,3,155736,155736,155739,0,3,2
44445,5,2,155741,155741,155743,0,2,2
44446,6,2,155747,155747,155749,0,2,4
44447,3,1,155750,155750,155751,0,1,1
44448,3,2,155753,155753,155755,0,2,2
44449,6,2,155759,155759,155761,0,2,4
44450,3,1,155762,155762,155763,0,1,1
44451,1,1,155763,155763,155764,0,1,0
44452,6,1,155769,155769,155770,0,1,5
44453,4,1,155773,155773,155774,0,1,3
44454,1,2,155774,155774,155776,0,2,0
44455,5,3,155779,155779,155782,0,3,3
44456,2,1,155781,155782,155783,1,2,0
44457,6,1,155787,155787,155788,0,1,4
44458,3,1,155790,155790,155791,0,1,2
44459,5,3,155795,155795,155798,0,3,4
44460,6,1,155801,155801,155802,0,1,3
44461,5,2,155806,155806,155808,0,2,4
44462,1,2,155807,155808,155810,1,3,0
44463,4,2,155811,155811,155813,0,2,1
44464,4,1,155815,155815,155816,0,1,2
44465,2,2,155817,155817,155819,0,2,1
44466,3,2,155820,155820,155822,0,2,1
44467,1,2,155821,155822,155824,1,3,0
44468,5,3,155826,155826,155829,0,3,2
44469,3,2,155829,155829,155831,0,2,0
44470,1,2,155830,155831,155833,1,3,0
44471,4,2,155834,155834,155836,0,2,1
44472,1,1,155835,155836,155837,1,2,0
44473,5,1,155840,155840,155841,0,1,3
44474,6,2,155846,155846,155848,0,2,5
44475,2,2,155848,155848,155850,0,2,0
44476,5,2,155853,155853,155855,0,2,3
44477,5,3,155858,155858,155861,0,3,3
44478,4,3,155862,155862,155865,0,3,1
44479,1,1,155863,155865,155866,2,3,0
44480,6,3,155869,155869,155872,0,3,3
44481,5,3,155874,155874,155877,0,3,2
44482,1,2,155875,155877,155879,2,4,0
44483,1,2,155876,155879,155881,3,5,0
44484,4,2,155880,155881,155883,1,3,0
44485,4,1,155884,155884,155885,0,1,1
44486,2,2,155886,155886,155888,0,2,1
44487,3,3,155889,155889,155892,0,3,1
44488,3,2,155892,155892,155894,0,2,0
44489,1,2,155893,155894,155896,1,3,0
44490,3,3,155896,155896,155899,0,3,0
44491,4,2,155900,155900,155902,0,2,1
44492,3,2,155903,155903,155905,0,2,1
44493,3,3,155906,155906,155909,0,3,1
44494,6,2,155912,155912,155914,0,2,3
44495,2,2,155914,155914,155916,0,2,0
44496,6,1,155920,155920,155921,0,1,4
44497,4,3,155924,155924,155927,0,3,3
44498,1,1,155925,155927,155928,2,3,0
44499,6,2,155931,155931,155933,0,2,3
44500,6,2,155937,155937,155939,0,2,4
44501,6,2,155943,155943,155945,0,2,4
44502,4,2,155947,155947,155949,0,2,2
44503,2,1,155949,155949,155950,0,1,0
44504,4,2,155953,155953,155955,0,2,3
44505,3,3,155956,155956,155959,0,3,1
44506,6,3,155962,155962,155965,0,3,3
44507,1,2,155963,155965,155967,2,4,0
44508,1,2,155964,155967,155969,3,5,0
44509,5,1,155969,155969,155970,0,1,0
44510,6,3,155975,155975,155978,0,3,5
44511,1,2,155976,155978,155980,2,4,0
44512,4,3,155980,155980,155983,0,3,0
44513,2,2,155982,155983,155985,1,3,0
44514,3,1,155985,155985,155986,0,1,0
44515,2,1,155987,155987,155988,0,1,1
44516,4,3,155991,155991,155994,0,3,3
44517,4,2,155995,155995,155997,0,2,1
44518,5,1,156000,156000,156001,0,1,3
44519,2,3,156002,156002,156005,0,3,1
44520,3,3,156005,156005,156008,0,3,0
44521,4,2,156009,156009,156011,0,2,1
44522,2,2,156011,156011,156013,0,2,0
44523,4,1,156015,156015,156016,0,1,2
44524,3,2,156018,156018,156020,0,2,2
44525,5,3,156023,156023,156026,0,3,3
44526,4,1,156027,156027,156028,0,1,1
44527,6,3,156033,156033,156036,0,3,5
44528,1,1,156034,156036,156037,2,3,0
44529,5,1,156039,156039,156040,0,1,2
44530,5,2,156044,156044,156046,0,2,4
44531,6,3,156050,156050,156053,0,3,4
44532,2,2,156052,156053,156055,1,3,0
44533,4,3,156056,156056,156059,0,3,1
44534,6,2,156062,156062,156064,0,2,3
44535,6,3,156068,156068,156071,0,3,4
44536,2,1,156070,156071,156072,1,2,0
44537,6,1,156076,156076,156077,0,1,4
44538,1,3,156077,156077,156080,0,3,0
44539,5,1,156082,156082,156083,0,1,2
44540,4,3,156086,156086,156089,0,3,3
44541,3,3,156089,156089,156092,0,3,0
44542,3,2,156092,156092,156094,0,2,0
44543,1,2,156093,156094,156096,1,3,0
44544,6,3,156099,156099,156102,0,3,3
44545,3,1,156102,156102,156103,0,1,0
44546,4,2,156106,156106,156108,0,2,3
44547,1,1,156107,156108,156109,1,2,0
44548,1,1,156108,156109,156110,1,2,0
44549,4,1,156112,156112,156113,0,1,2
44550,5,1,156117,156117,156118,0,1,4
44551,5,2,156122,156122,156124,0,2,4
44552,1,2,156123,156124,156126,1,3,0
44553,5,3,156128,156128,156131,0,3,2
44554,2,1,156130,156131,156132,1,2,0
44555,3,2,156133,156133,156135,0,2,1
44556,2,3,156135,156135,156138,0,3,0
44557,5,3,156140,156140,156143,0,3,2
44558,6,1,156146,156146,156147,0,1,3
44559,5,2,156151,156151,156153,0,2,4
44560,3,3,156154,156154,156157,0,3,1
44561,3,1,156157,156157,156158,0,1,0
44562,2,1,156159,156159,156160,0,1,1
44563,3,3,156162,156162,156165,0,3,2
44564,4,1,156166,156166,156167,0,1,1
44565,6,3,156172,156172,156175,0,3,5
44566,6,1,156178,156178,156179,0,1,3
44567,4,2,156182,156182,156184,0,2,3
44568,2,2,156184,156184,156186,0,2,0
44569,1,3,156185,156186,156189,1,4,0
44570,1,3,156186,156189,156192,3,6,0
44571,6,1,156192,156192,156193,0,1,0
44572,3,2,156195,156195,156197,0,2,2
44573,2,3,156197,156197,156200,0,3,0
44574,5,1,156202,156202,156203,0,1,2
44575,6,1,156208,156208,156209,0,1,5
44576,6,2,156214,156214,156216,0,2,5
44577,4,2,156218,156218,156220,0,2,2
44578,1,1,156219,156220,156221,1,2,0
44579,4,3,156223,156223,156226,0,3,2
44580,2,2,156225,156226,156228,1,3,0
44581,2,3,156227,156228,156231,1,4,0
44582,1,1,156228,156231,156232,3,4,0
44583,6,1,156234,156234,156235,0,1,2
44584,4,2,156238,156238,156240,0,2,3
44585,6,1,156244,156244,156245,0,1,4
44586,1,3,156245,156245,156248,0,3,0
44587,2,2,156247,156248,156250,1,3,0
44588,4,2,156251,156251,156253,0,2,1
44589,6,3,156257,156257,156260,0,3,4
44590,1,1,156258,156260,156261,2,3,0
44591,4,3,156262,156262,156265,0,3,1
44592,6,2,156268,156268,156270,0,2,3
44593,5,2,156273,156273,156275,0,2,3
44594,1,2,156274,156275,156277,1,3,0
44595,2,1,156276,156277,156278,1,2,0
44596,6,2,156282,156282,156284,0,2,4
44597,2,3,156284,156284,156287,0,3,0
44598,2,3,156286,156287,156290,1,4,0
44599,6,3,156292,156292,156295,0,3,2
44600,3,1,156295,156295,156296,0,1,0
44601,1,3,156296,156296,156299,0,3,0
44602,6,1,156302,156302,156303,0,1,3
44603,6,1,156308,156308,156309,0,1,5
44604,1,2,156309,156309,156311,0,2,0
44605,5,3,156314,156314,156317,0,3,3
44606,2,1,156316,156317,156318,1,2,0
44607,5,3,156321,156321,156324,0,3,3
44608,6,2,156327,156327,156329,0,2,3
44609,2,2,156329,156329,156331,0,2,0
44610,2,3,156331,156331,156334,0,3,0
44611,2,1,156333,156334,156335,1,2,0
44612,3,2,156336,156336,156338,0,2,1
44613,1,3,156337,156338,156341,1,4,0
44614,1,2,156338,156341,156343,3,5,0
44615,2,1,156340,156343,156344,3,4,0
44616,6,1,156346,156346,156347,0,1,2
44617,5,3,156351,156351,156354,0,3,4
44618,3,1,156354,156354,156355,0,1,0
44619,1,1,156355,156355,156356,0,1,0
44620,4,1,156359,156359,156360,0,1,3
44621,6,1,156365,156365,156366,0,1,5
44622,4,2,156369,156369,156371,0,2,3
44623,5,1,156374,156374,156375,0,1,3
44624,4,2,156378,156378,156380,0,2,3
44625,3,2,156381,156381,156383,0,2,1
44626,1,2,156382,156383,156385,1,3,0
44627,5,3,156387,156387,156390,0,3,2
44628,3,3,156390,156390,156393,0,3,0
44629,5,3,156395,156395,156398,0,3,2
44630,5,1,156400,156400,156401,0,1,2
44631,1,3,156401,156401,156404,0,3,0
44632,3,2,156404,156404,156406,0,2,0
44633,6,2,156410,156410,156412,0,2,4
44634,5,2,156415,156415,156417,0,2,3
44635,5,3,156420,156420,156423,0,3,3
44636,4,1,156424,156424,156425,0,1,1
44637,4,3,156428,156428,156431,0,3,3
44638,2,2,156430,156431,156433,1,3,0
44639,4,3,156434,156434,156437,0,3,1
44640,1,3,156435,156437,156440,2,5,0
44641,5,3,156440,156440,156443,0,3,0
44642,4,2,156444,156444,156446,0,2,1
44643,4,3,156448,156448,156451,0,3,2
44644,4,1,156452,156452,156453,0,1,1
44645,2,3,156454,156454,156457,0,3,1
44646,6,2,156460,156460,156462,0,2,3
44647,4,1,156464,156464,156465,0,1,2
44648,5,1,156469,156469,156470,0,1,4
44649,2,2,156471,156471,156473,0,2,1
44650,2,3,156473,156473,156476,0,3,0
44651,3,1,156476,156476,156477,0,1,0
44652,5,1,156481,156481,156482,0,1,4
44653,4,2,156485,156485,156487,0,2,3
44654,5,2,156490,156490,156492,0,2,3
44655,1,2,156491,156492,156494,1,3,0
44656,5,2,156496,156496,156498,0,2,2
44657,5,3,156501,156501,156504,0,3,3
44658,5,2,156506,156506,156508,0,2,2
44659,4,3,156510,156510,156513,0,3,2
44660,2,2,156512,156513,156515,1,3,0
44661,1,1,156513,156515,156516,2,3,0
44662,1,3,156514,156516,156519,2,5,0
44663,4,1,156518,156519,156520,1,2,0
44664,5,1,156523,156523,156524,0,1,3
44665,6,2,156529,156529,156531,0,2,5
44666,6,2,156535,156535,156537,0,2,4
44667,2,2,156537,156537,156539,0,2,0
44668,2,2,156539,156539,156541,0,2,0
44669,1,2,156540,156541,156543,1,3,0
44670,3,3,156543,156543,156546,0,3,0
44671,2,1,156545,156546,156547,1,2,0
44672,6,2,156551,156551,156553,0,2,4
44673,2,3,156553,156553,156556,0,3,0
44674,2,2,156555,156556,156558,1,3,0
44675,2,1,156557,156558,156559,1,2,0
44676,1,3,156558,156559,156562,1,4,0
44677,4,2,156562,156562,156564,0,2,0
44678,1,3,156563,156564,156567,1,4,0
44679,6,2,156569,156569,156571,0,2,2
44680,1,3,156570,156571,156574,1,4,0
44681,1,1,156571,156574,156575,3,4,0
44682,4,2,156575,156575,156577,0,2,0
44683,4,1,156579,156579,156580,0,1,2
44684,2,2,156581,156581,156583,0,2,1
44685,6,2,156587,156587,156589,0,2,4
44686,6,1,156593,156593,156594,0,1,4
44687,5,2,156598,156598,156600,0,2,4
44688,3,2,156601,156601,156603,0,2,1
44689,3,2,156604,156604,156606,0,2,1
44690,2,3,156606,156606,156609,0,3,0
44691,6,2,156612,156612,156614,0,2,3
44692,3,2,156615,156615,156617,0,2,1
44693,5,3,156620,156620,156623,0,3,3
44694,1,2,156621,156623,156625,2,4,0
44695,6,3,156627,156627,156630,0,3,2
44696,3,2,156630,156630,156632,0,2,0
44697,2,1,156632,156632,156633,0,1,0
44698,1,3,156633,156633,156636,0,3,0
44699,4,3,156637,156637,156640,0,3,1
44700,4,2,156641,156641,156643,0,2,1
44701,5,3,156646,156646,156649,0,3,3
44702,1,1,156647,156649,156650,2,3,0
44703,1,2,156648,156650,156652,2,4,0
44704,5,2,156653,156653,156655,0,2,1
44705,6,2,156659,156659,156661,0,2,4
44706,2,1,156661,156661,156662,0,1,0
44707,6,2,156667,156667,156669,0,2,5
44708,5,1,156672,156672,156673,0,1,3
44709,4,3,156676,156676,156679,0,3,3
44710,4,3,156680,156680,156683,0,3,1
44711,5,3,156685,156685,156688,0,3,2
44712,4,2,156689,156689,156691,0,2,1
44713,4,2,156693,156693,156695,0,2,2
44714,5,2,156698,156698,156700,0,2,3
44715,5,3,156703,156703,156706,0,3,3
44716,6,1,156709,156709,156710,0,1,3
44717,3,2,156712,156712,156714,0,2,2
44718,2,2,156714,156714,156716,0,2,0
44719,6,1,156720,156720,156721,0,1,4
44720,3,2,156723,156723,156725,0,2,2
44721,1,1,156724,156725,156726,1,2,0
44722,5,3,156729,156729,156732,0,3,3
44723,5,3,156734,156734,156737,0,3,2
44724,3,1,156737,156737,156738,0,1,0
44725,5,3,156742,156742,156745,0,3,4
44726,1,3,156743,156745,156748,2,5,0
44727,3,3,156746,156748,156751,2,5,0
44728,5,1,156751,156751,156752,0,1,0
44729,4,1,156755,156755,156756,0,1,3
44730,6,2,156761,156761,156763,0,2,5
44731,6,2,156767,156767,156769,0,2,4
44732,4,2,156771,156771,156773,0,2,2
44733,3,3,156774,156774,156777,0,3,1
44734,2,1,156776,156777,156778,1,2,0
44735,5,1,156781,156781,156782,0,1,3
44736,5,3,156786,156786,156789,0,3,4
44737,5,3,156791,156791,156794,0,3,2
44738,5,2,156796,156796,156798,0,2,2
44739,5,3,156801,156801,156804,0,3,3
44740,4,1,156805,156805,156806,0,1,1
44741,6,3,156811,156811,156814,0,3,5
44742,3,3,156814,156814,156817,0,3,0
44743,1,1,156815,156817,156818,2,3,0
44744,2,2,156817,156818,156820,1,3,0
44745,5,1,156822,156822,156823,0,1,2
44746,5,1,156827,156827,156828,0,1,4
44747,5,1,156832,156832,156833,0,1,4
44748,5,1,156837,156837,156838,0,1,4
44749,5,2,156842,156842,156844,0,2,4
44750,4,1,156846,156846,156847,0,1,2
44751,3,1,156849,156849,156850,0,1,2
44752,3,1,156852,156852,156853,0,1,2
44753,4,2,156856,156856,156858,0,2,3
44754,5,1,156861,156861,156862,0,1,3
44755,1,3,156862,156862,156865,0,3,0
44756,4,3,156866,156866,156869,0,3,1
44757,5,1,156871,156871,156872,0,1,2
44758,2,1,156873,156873,156874,0,1,1
44759,2,1,156875,156875,156876,0,1,1
44760,4,3,156879,156879,156882,0,3,3
44761,6,2,156885,156885,156887,0,2,3
44762,3,3,156888,156888,156891,0,3,1
44763,3,2,156891,156891,156893,0,2,0
44764,6,1,156897,156897,156898,0,1,4
44765,4,2,156901,156901,156903,0,2,3
44766,5,2,156906,156906,156908,0,2,3
44767,2,3,156908,156908,156911,0,3,0
44768,6,3,156914,156914,156917,0,3,3
44769,3,1,156917,156917,156918,0,1,0
44770,1,2,156918,156918,156920,0,2,0
44771,6,3,156924,156924,156927,0,3,4
44772,2,1,156926,156927,156928,1,2,0
44773,1,1,156927,156928,156929,1,2,0
44774,2,2,156929,156929,156931,0,2,0
44775,2,2,156931,156931,156933,0,2,0
44776,4,1,156935,156935,156936,0,1,2
44777,6,1,156941,156941,156942,0,1,5
44778,2,1,156943,156943,156944,0,1,1
44779,4,3,156947,156947,156950,0,3,3
44780,5,2,156952,156952,156954,0,2,2
44781,5,2,156957,156957,156959,0,2,3
44782,1,1,156958,156959,156960,1,2,0
44783,6,1,156964,156964,156965,0,1,4
44784,5,2,156969,156969,156971,0,2,4
44785,2,1,156971,156971,156972,0,1,0
44786,2,3,156973,156973,156976,0,3,1
44787,3,2,156976,156976,156978,0,2,0
44788,5,3,156981,156981,156984,0,3,3
44789,4,1,156985,156985,156986,0,1,1
44790,1,1,156986,156986,156987,0,1,0
44791,1,3,156987,156987,156990,0,3,0
44792,4,2,156991,156991,156993,0,2,1
44793,6,3,156997,156997,157000,0,3,4
44794,2,3,156999,157000,157003,1,4,0
44795,6,1,157005,157005,157006,0,1,2
44796,1,1,157006,157006,157007,0,1,0
44797,2,2,157008,157008,157010,0,2,1
44798,2,1,157010,157010,157011,0,1,0
44799,1,2,157011,157011,157013,0,2,0
44800,5,2,157016,157016,157018,0,2,3
44801,4,3,157020,157020,157023,0,3,2
44802,4,1,157024,157024,157025,0,1,1
44803,3,1,157027,157027,157028,0,1,2
44804,1,2,157028,157028,157030,0,2,0
44805,4,3,157032,157032,157035,0,3,2
44806,5,2,157037,157037,157039,0,2,2
44807,6,3,157043,157043,157046,0,3,4
44808,4,3,157047,157047,157050,0,3,1
44809,4,2,157051,157051,157053,0,2,1
44810,1,3,157052,157053,157056,1,4,0
44811,2,2,157054,157056,157058,2,4,0
44812,4,1,157058,157058,157059,0,1,0
44813,1,3,157059,157059,157062,0,3,0
44814,2,2,157061,157062,157064,1,3,0
44815,2,2,157063,157064,157066,1,3,0
44816,5,3,157068,157068,157071,0,3,2
44817,5,3,157073,157073,157076,0,3,2
44818,3,1,157076,157076,157077,0,1,0
44819,5,1,157081,157081,157082,0,1,4
44820,6,2,157087,157087,157089,0,2,5
44821,2,2,157089,157089,157091,0,2,0
44822,6,3,157095,157095,157098,0,3,4
44823,1,1,157096,157098,157099,2,3,0
44824,6,1,157102,157102,157103,0,1,3
44825,5,2,157107,157107,157109,0,2,4
44826,1,3,157108,157109,157112,1,4,0
44827,1,3,157109,157112,157115,3,6,0
44828,2,1,157111,157115,157116,4,5,0
44829,2,3,157113,157116,157119,3,6,0
44830,2,1,157115,157119,157120,4,5,0
44831,4,2,157119,157120,157122,1,3,0
44832,2,3,157121,157122,157125,1,4,0
44833,1,3,157122,157125,157128,3,6,0
44834,2,2,157124,157128,157130,4,6,0
44835,6,1,157130,157130,157131,0,1,0
44836,1,1,157131,157131,157132,0,1,0
44837,1,1,157132,157132,157133,0,1,0
44838,2,3,157134,157134,157137,0,3,1
44839,3,3,157137,157137,157140,0,3,0
44840,4,3,157141,157141,157144,0,3,1
44841,5,1,157146,157146,157147,0,1,2
44842,5,2,157151,157151,157153,0,2,4
44843,6,2,157157,157157,157159,0,2,4
44844,2,2,157159,157159,157161,0,2,0
44845,2,2,157161,157161,157163,0,2,0
44846,1,1,157162,157163,157164,1,2,0
44847,4,2,157166,157166,157168,0,2,2
44848,1,2,157167,157168,157170,1,3,0
44849,4,2,157171,157171,157173,0,2,1
44850,1,2,157172,157173,157175,1,3,0
44851,5,1,157177,157177,157178,0,1,2
44852,5,2,157182,157182,157184,0,2,4
44853,1,2,157183,157184,157186,1,3,0
44854,4,1,157187,157187,157188,0,1,1
44855,2,1,157189,157189,157190,0,1,1
44856,3,3,157192,157192,157195,0,3,2
44857,1,3,157193,157195,157198,2,5,0
44858,5,2,157198,157198,157200,0,2,0
44859,3,2,157201,157201,157203,0,2,1
44860,4,3,157205,157205,157208,0,3,2
44861,4,3,157209,157209,157212,0,3,1
44862,5,1,157214,157214,157215,0,1,2
44863,5,2,157219,157219,157221,0,2,4
44864,3,3,157222,157222,157225,0,3,1
44865,6,3,157228,157228,157231,0,3,3
44866,3,3,157231,157231,157234,0,3,0
44867,1,3,157232,157234,157237,2,5,0
44868,6,1,157238,157238,157239,0,1,1
44869,4,2,157242,157242,157244,0,2,3
44870,6,1,157248,157248,157249,0,1,4
44871,2,2,157250,157250,157252,0,2,1
44872,6,1,157256,157256,157257,0,1,4
44873,6,2,157262,157262,157264,0,2,5
44874,1,1,157263,157264,157265,1,2,0
44875,5,2,157268,157268,157270,0,2,3
44876,5,1,157273,157273,157274,0,1,3
44877,3,2,157276,157276,157278,0,2,2
44878,5,3,157281,157281,157284,0,3,3
44879,4,1,157285,157285,157286,0,1,1
44880,3,3,157288,157288,157291,0,3,2
44881,4,1,157292,157292,157293,0,1,1
44882,1,1,157293,157293,157294,0,1,0
44883,5,3,157298,157298,157301,0,3,4
44884,4,2,157302,157302,157304,0,2,1
44885,1,1,157303,157304,157305,1,2,0
44886,3,3,157306,157306,157309,0,3,1
44887,3,1,157309,157309,157310,0,1,0
44888,5,1,157314,157314,157315,0,1,4
44889,1,2,157315,157315,157317,0,2,0
44890,3,2,157318,157318,157320,0,2,1
44891,1,3,157319,157320,157323,1,4,0
44892,2,2,157321,157323,157325,2,4,0
44893,3,1,157324,157325,157326,1,2,0
44894,1,1,157325,157326,157327,1,2,0
44895,1,3,157326,157327,157330,1,4,0
44896,6,2,157332,157332,157334,0,2,2
44897,4,3,157336,157336,157339,0,3,2
44898,5,3,157341,157341,157344,0,3,2
44899,3,2,157344,157344,157346,0,2,0
44900,3,1,157347,157347,157348,0,1,1
44901,6,2,157353,157353,157355,0,2,5
44902,3,2,157356,157356,157358,0,2,1
44903,2,3,157358,157358,157361,0,3,0
44904,4,3,157362,157362,157365,0,3,1
44905,6,2,157368,157368,157370,0,2,3
44906,2,1,157370,157370,157371,0,1,0
44907,1,3,157371,157371,157374,0,3,0
44908,4,3,157375,157375,157378,0,3,1
44909,1,1,157376,157378,157379,2,3,0
44910,4,3,157380,157380,157383,0,3,1
44911,2,1,157382,157383,157384,1,2,0
44912,6,3,157388,157388,157391,0,3,4
44913,2,3,157390,157391,157394,1,4,0
44914,1,3,157391,157394,157397,3,6,0
44915,5,1,157396,157397,157398,1,2,0
44916,2,2,157398,157398,157400,0,2,0
44917,5,3,157403,157403,157406,0,3,3
44918,1,3,157404,157406,157409,2,5,0
44919,5,1,157409,157409,157410,0,1,0
44920,5,3,157414,157414,157417,0,3,4
44921,6,3,157420,157420,157423,0,3,3
44922,5,3,157425,157425,157428,0,3,2
44923,1,1,157426,157428,157429,2,3,0
44924,6,3,157432,157432,157435,0,3,3
44925,1,2,157433,157435,157437,2,4,0
44926,3,2,157436,157437,157439,1,3,0
44927,5,1,157441,157441,157442,0,1,2
44928,4,2,157445,157445,157447,0,2,3
44929,2,1,157447,157447,157448,0,1,0
44930,6,2,157453,157453,157455,0,2,5
44931,2,1,157455,157455,157456,0,1,0
44932,5,1,157460,157460,157461,0,1,4
44933,2,3,157462,157462,157465,0,3,1
44934,4,2,157466,157466,157468,0,2,1
44935,3,2,157469,157469,157471,0,2,1
44936,1,2,157470,157471,157473,1,3,0
44937,1,3,157471,157473,157476,2,5,0
44938,1,2,157472,157476,157478,4,6,0
44939,1,1,157473,157478,157479,5,6,0
44940,2,3,157475,157479,157482,4,7,0
44941,6,2,157481,157482,157484,1,3,0
44942,4,2,157485,157485,157487,0,2,1
44943,4,1,157489,157489,157490,0,1,2
44944,5,3,157494,157494,157497,0,3,4
44945,6,2,157500,157500,157502,0,2,3
44946,4,2,157504,157504,157506,0,2,2
44947,3,1,157507,157507,157508,0,1,1
44948,1,3,157508,157508,157511,0,3,0
44949,6,2,157514,157514,157516,0,2,3
44950,1,2,157515,157516,157518,1,3,0
44951,5,2,157520,157520,157522,0,2,2
44952,6,1,157526,157526,157527,0,1,4
44953,2,2,157528,157528,157530,0,2,1
44954,4,3,157532,157532,157535,0,3,2
44955,2,2,157534,157535,157537,1,3,0
44956,3,2,157537,157537,157539,0,2,0
44957,4,2,157541,157541,157543,0,2,2
44958,4,1,157545,157545,157546,0,1,2
44959,6,3,157551,157551,157554,0,3,5
44960,1,3,157552,157554,157557,2,5,0
44961,6,2,157558,157558,157560,0,2,1
44962,6,1,157564,157564,157565,0,1,4
44963,3,3,157567,157567,157570,0,3,2
44964,1,3,157568,157570,157573,2,5,0
44965,1,1,157569,157573,157574,4,5,0
44966,4,2,157573,157574,157576,1,3,0
44967,6,2,157579,157579,157581,0,2,3
44968,5,3,157584,157584,157587,0,3,3
44969,6,3,157590,157590,157593,0,3,3
44970,4,2,157594,157594,157596,0,2,1
44971,5,3,157599,157599,157602,0,3,3
44972,5,2,157604,157604,157606,0,2,2
44973,5,1,157609,157609,157610,0,1,3
44974,6,1,157615,157615,157616,0,1,5
44975,4,3,157619,157619,157622,0,3,3
44976,5,3,157624,157624,157627,0,3,2
44977,1,2,157625,157627,157629,2,4,0
44978,4,2,157629,157629,157631,0,2,0
44979,3,1,157632,157632,157633,0,1,1
44980,1,1,157633,157633,157634,0,1,0
44981,4,2,157637,157637,157639,0,2,3
44982,1,2,157638,157639,157641,1,3,0
44983,5,1,157643,157643,157644,0,1,2
44984,1,1,157644,157644,157645,0,1,0
44985,4,1,157648,157648,157649,0,1,3
44986,5,3,157653,157653,157656,0,3,4
44987,3,3,157656,157656,157659,0,3,0
44988,6,3,157662,157662,157665,0,3,3
44989,3,2,157665,157665,157667,0,2,0
44990,2,1,157667,157667,157668,0,1,0
44991,2,2,157669,157669,157671,0,2,1
44992,6,1,157675,157675,157676,0,1,4
44993,4,2,157679,157679,157681,0,2,3
44994,1,1,157680,157681,157682,1,2,0
44995,2,3,157682,157682,157685,0,3,0
44996,5,3,157687,157687,157690,0,3,2
44997,5,2,157692,157692,157694,0,2,2
44998,5,3,157697,157697,157700,0,3,3
44999,6,2,157703,157703,157705,0,2,3
45000,6,2,157709,157709,157711,0,2,4
45001,1,3,157710,157711,157714,1,4,0
45002,5,2,157715,157715,157717,0,2,1
45003,3,1,157718,157718,157719,0,1,1
45004,2,1,157720,157720,157721,0,1,1
45005,2,1,157722,157722,157723,0,1,1
45006,4,3,157726,157726,157729,0,3,3
45007,5,3,157731,157731,157734,0,3,2
45008,5,1,157736,157736,157737,0,1,2
45009,3,3,157739,157739,157742,0,3,2
45010,5,2,157744,157744,157746,0,2,2
45011,4,3,157748,157748,157751,0,3,2
45012,4,1,157752,157752,157753,0,1,1
45013,2,2,157754,157754,157756,0,2,1
45014,3,3,157757,157757,157760,0,3,1
45015,4,1,157761,157761,157762,0,1,1
45016,3,1,157764,157764,157765,0,1,2
45017,1,3,157765,157765,157768,0,3,0
45018,6,3,157771,157771,157774,0,3,3
45019,1,2,157772,157774,157776,2,4,0
45020,3,2,157775,157776,157778,1,3,0
45021,1,3,157776,157778,157781,2,5,0
45022,3,1,157779,157781,157782,2,3,0
45023,6,2,157785,157785,157787,0,2,3
45024,6,3,157791,157791,157794,0,3,4
45025,1,3,157792,157794,157797,2,5,0
45026,4,2,157796,157797,157799,1,3,0
45027,4,1,157800,157800,157801,0,1,1
45028,1,2,157801,157801,157803,0,2,0
45029,6,3,157807,157807,157810,0,3,4
45030,1,1,157808,157810,157811,2,3,0
45031,5,3,157813,157813,157816,0,3,2
45032,3,1,157816,157816,157817,0,1,0
45033,3,2,157819,157819,157821,0,2,2
45034,4,3,157823,157823,157826,0,3,2
45035,1,3,157824,157826,157829,2,5,0
45036,6,3,157830,157830,157833,0,3,1
45037,2,3,157832,157833,157836,1,4,0
45038,5,1,157837,157837,157838,0,1,1
45039,3,3,157840,157840,157843,0,3,2
45040,2,3,157842,157843,157846,1,4,0
45041,1,3,157843,157846,157849,3,6,0
45042,6,2,157849,157849,157851,0,2,0
45043,3,1,157852,157852,157853,0,1,1
45044,1,3,157853,157853,157856,0,3,0
45045,5,3,157858,157858,157861,0,3,2
45046,2,1,157860,157861,157862,1,2,0
45047,3,3,157863,157863,157866,0,3,1
45048,2,1,157865,157866,157867,1,2,0
45049,3,1,157868,157868,157869,0,1,1
45050,2,2,157870,157870,157872,0,2,1
45051,6,2,157876,157876,157878,0,2,4
45052,6,3,157882,157882,157885,0,3,4
45053,5,1,157887,157887,157888,0,1,2
45054,5,2,157892,157892,157894,0,2,4
45055,5,2,157897,157897,157899,0,2,3
45056,1,3,157898,157899,157902,1,4,0
45057,4,3,157902,157902,157905,0,3,0
45058,4,1,157906,157906,157907,0,1,1
45059,3,2,157909,157909,157911,0,2,2
45060,3,1,157912,157912,157913,0,1,1
45061,3,2,157915,157915,157917,0,2,2
45062,2,3,157917,157917,157920,0,3,0
45063,3,2,157920,157920,157922,0,2,0
45064,2,1,157922,157922,157923,0,1,0
45065,5,2,157927,157927,157929,0,2,4
45066,1,2,157928,157929,157931,1,3,0
45067,4,1,157932,157932,157933,0,1,1
45068,6,3,157938,157938,157941,0,3,5
45069,6,1,157944,157944,157945,0,1,3
45070,2,1,157946,157946,157947,0,1,1
45071,2,3,157948,157948,157951,0,3,1
45072,1,1,157949,157951,157952,2,3,0
45073,4,1,157953,157953,157954,0,1,1
45074,3,2,157956,157956,157958,0,2,2
45075,5,2,157961,157961,157963,0,2,3
45076,3,2,157964,157964,157966,0,2,1
45077,3,3,157967,157967,157970,0,3,1
45078,1,1,157968,157970,157971,2,3,0
45079,4,3,157972,157972,157975,0,3,1
45080,6,2,157978,157978,157980,0,2,3
45081,2,2,157980,157980,157982,0,2,0
45082,2,1,157982,157982,157983,0,1,0
45083,3,2,157985,157985,157987,0,2,2
45084,6,1,157991,157991,157992,0,1,4
45085,5,3,157996,157996,157999,0,3,4
45086,2,3,157998,157999,158002,1,4,0
45087,6,1,158004,158004,158005,0,1,2
45088,6,1,158010,158010,158011,0,1,5
45089,4,3,158014,158014,158017,0,3,3
45090,1,2,158015,158017,158019,2,4,0
45091,5,3,158020,158020,158023,0,3,1
45092,4,3,158024,158024,158027,0,3,1
45093,6,1,158030,158030,158031,0,1,3
45094,4,1,158034,158034,158035,0,1,3
45095,1,3,158035,158035,158038,0,3,0
45096,2,2,158037,158038,158040,1,3,0
45097,1,3,158038,158040,158043,2,5,0
45098,4,3,158042,158043,158046,1,4,0
45099,4,2,158046,158046,158048,0,2,0
45100,1,3,158047,158048,158051,1,4,0
45101,2,3,158049,158051,158054,2,5,0
45102,4,3,158053,158054,158057,1,4,0
45103,4,1,158057,158057,158058,0,1,0
45104,1,2,158058,158058,158060,0,2,0
45105,2,2,158060,158060,158062,0,2,0
45106,4,2,158064,158064,158066,0,2,2
45107,4,2,158068,158068,158070,0,2,2
45108,6,3,158074,158074,158077,0,3,4
45109,5,3,158079,158079,158082,0,3,2
45110,5,3,158084,158084,158087,0,3,2
45111,3,3,158087,158087,158090,0,3,0
45112,6,2,158093,158093,158095,0,2,3
45113,1,1,158094,158095,158096,1,2,0
45114,1,3,158095,158096,158099,1,4,0
45115,3,3,158098,158099,158102,1,4,0
45116,2,1,158100,158102,158103,2,3,0
45117,5,3,158105,158105,158108,0,3,2
45118,5,3,158110,158110,158113,0,3,2
45119,5,3,158115,158115,158118,0,3,2
45120,5,1,158120,158120,158121,0,1,2
45121,6,3,158126,158126,158129,0,3,5
45122,4,2,158130,158130,158132,0,2,1
45123,2,3,158132,158132,158135,0,3,0
45124,2,2,158134,158135,158137,1,3,0
45125,4,1,158138,158138,158139,0,1,1
45126,1,3,158139,158139,158142,0,3,0
45127,6,3,158145,158145,158148,0,3,3
45128,5,1,158150,158150,158151,0,1,2
45129,1,1,158151,158151,158152,0,1,0
45130,5,3,158156,158156,158159,0,3,4
45131,6,3,158162,158162,158165,0,3,3
45132,1,3,158163,158165,158168,2,5,0
45133,6,2,158169,158169,158171,0,2,1
45134,1,2,158170,158171,158173,1,3,0
45135,2,2,158172,158173,158175,1,3,0
45136,1,1,158173,158175,158176,2,3,0
45137,5,3,158178,158178,158181,0,3,2
45138,6,2,158184,158184,158186,0,2,3
45139,6,1,158190,158190,158191,0,1,4
45140,6,3,158196,158196,158199,0,3,5
45141,1,1,158197,158199,158200,2,3,0
45142,1,2,158198,158200,158202,2,4,0
45143,3,1,158201,158202,158203,1,2,0
45144,5,3,158206,158206,158209,0,3,3
45145,4,1,158210,158210,158211,0,1,1
45146,4,2,158214,158214,158216,0,2,3
45147,4,1,158218,158218,158219,0,1,2
45148,4,3,158222,158222,158225,0,3,3
45149,2,3,158224,158225,158228,1,4,0
45150,4,2,158228,158228,158230,0,2,0
45151,1,2,158229,158230,158232,1,3,0
45152,5,2,158234,158234,158236,0,2,2
45153,4,3,158238,158238,158241,0,3,2
45154,3,3,158241,158241,158244,0,3,0
45155,4,2,158245,158245,158247,0,2,1
45156,4,3,158249,158249,158252,0,3,2
45157,1,2,158250,158252,158254,2,4,0
45158,6,1,158256,158256,158257,0,1,2
45159,6,2,158262,158262,158264,0,2,5
45160,2,3,158264,158264,158267,0,3,0
45161,6,2,158270,158270,158272,0,2,3
45162,1,1,158271,158272,158273,1,2,0
45163,2,2,158273,158273,158275,0,2,0
45164,2,2,158275,158275,158277,0,2,0
45165,1,2,158276,158277,158279,1,3,0
45166,5,2,158281,158281,158283,0,2,2
45167,1,1,158282,158283,158284,1,2,0
45168,3,2,158285,158285,158287,0,2,1
45169,2,2,158287,158287,158289,0,2,0
45170,1,1,158288,158289,158290,1,2,0
45171,1,2,158289,158290,158292,1,3,0
45172,1,2,158290,158292,158294,2,4,0
45173,3,2,158293,158294,158296,1,3,0
45174,1,2,158294,158296,158298,2,4,0
45175,6,3,158300,158300,158303,0,3,2
45176,5,2,158305,158305,158307,0,2,2
45177,5,3,158310,158310,158313,0,3,3
45178,1,3,158311,158313,158316,2,5,0
45179,4,3,158315,158316,158319,1,4,0
45180,1,1,158316,158319,158320,3,4,0
45181,6,3,158322,158322,158325,0,3,2
45182,4,2,158326,158326,158328,0,2,1
45183,6,3,158332,158332,158335,0,3,4
45184,1,2,158333,158335,158337,2,4,0
45185,4,2,158337,158337,158339,0,2,0
45186,6,2,158343,158343,158345,0,2,4
45187,1,2,158344,158345,158347,1,3,0
45188,2,2,158346,158347,158349,1,3,0
45189,6,3,158352,158352,158355,0,3,3
45190,5,2,158357,158357,158359,0,2,2
45191,1,1,158358,158359,158360,1,2,0
45192,2,3,158360,158360,158363,0,3,0
45193,6,2,158366,158366,158368,0,2,3
45194,5,1,158371,158371,158372,0,1,3
45195,5,2,158376,158376,158378,0,2,4
45196,1,3,158377,158378,158381,1,4,0
45197,4,2,158381,158381,158383,0,2,0
45198,3,2,158384,158384,158386,0,2,1
45199,5,3,158389,158389,158392,0,3,3
45200,4,1,158393,158393,158394,0,1,1
45201,5,2,158398,158398,158400,0,2,4
45202,1,1,158399,158400,158401,1,2,0
45203,3,1,158402,158402,158403,0,1,1
45204,3,2,158405,158405,158407,0,2,2
45205,1,3,158406,158407,158410,1,4,0
45206,5,1,158411,158411,158412,0,1,1
45207,3,2,158414,158414,158416,0,2,2
45208,4,3,158418,158418,158421,0,3,2
45209,5,3,158423,158423,158426,0,3,2
45210,4,2,158427,158427,158429,0,2,1
45211,4,1,158431,158431,158432,0,1,2
45212,6,1,158437,158437,158438,0,1,5
45213,4,3,158441,158441,158444,0,3,3
45214,4,3,158445,158445,158448,0,3,1
45215,2,3,158447,158448,158451,1,4,0
45216,5,3,158452,158452,158455,0,3,1
45217,3,2,158455,158455,158457,0,2,0
45218,5,3,158460,158460,158463,0,3,3
45219,3,2,158463,158463,158465,0,2,0
45220,5,2,158468,158468,158470,0,2,3
45221,2,1,158470,158470,158471,0,1,0
45222,3,3,158473,158473,158476,0,3,2
45223,1,1,158474,158476,158477,2,3,0
45224,5,2,158479,158479,158481,0,2,2
45225,1,3,158480,158481,158484,1,4,0
45226,5,2,158485,158485,158487,0,2,1
45227,3,3,158488,158488,158491,0,3,1
45228,5,1,158493,158493,158494,0,1,2
45229,4,2,158497,158497,158499,0,2,3
45230,3,2,158500,158500,158502,0,2,1
45231,2,1,158502,158502,158503,0,1,0
45232,4,3,158506,158506,158509,0,3,3
45233,1,3,158507,158509,158512,2,5,0
45234,1,2,158508,158512,158514,4,6,0
45235,1,2,158509,158514,158516,5,7,0
45236,1,1,158510,158516,158517,6,7,0
45237,1,1,158511,158517,158518,6,7,0
45238,6,3,158517,158518,158521,1,4,0
45239,3,2,158520,158521,158523,1,3,0
45240,4,1,158524,158524,158525,0,1,1
45241,3,1,158527,158527,158528,0,1,2
45242,2,1,158529,158529,158530,0,1,1
45243,5,2,158534,158534,158536,0,2,4
45244,5,1,158539,158539,158540,0,1,3
45245,2,3,158541,158541,158544,0,3,1
45246,6,2,158547,158547,158549,0,2,3
45247,4,1,158551,158551,158552,0,1,2
45248,4,1,158555,158555,158556,0,1,3
45249,2,3,158557,158557,158560,0,3,1
45250,4,3,158561,158561,158564,0,3,1
45251,4,2,158565,158565,158567,0,2,1
45252,3,2,158568,158568,158570,0,2,1
45253,3,2,158571,158571,158573,0,2,1
45254,3,3,158574,158574,158577,0,3,1
45255,1,1,158575,158577,158578,2,3,0
45256,6,2,158581,158581,158583,0,2,3
45257,3,3,158584,158584,158587,0,3,1
45258,5,3,158589,158589,158592,0,3,2
45259,2,1,158591,158592,158593,1,2,0
45260,3,2,158594,158594,158596,0,2,1
45261,3,2,158597,158597,158599,0,2,1
45262,1,2,158598,158599,158601,1,3,0
45263,2,1,158600,158601,158602,1,2,0
45264,1,3,158601,158602,158605,1,4,0
45265,6,3,158607,158607,158610,0,3,2
45266,4,2,158611,158611,158613,0,2,1
45267,1,1,158612,158613,158614,1,2,0
45268,4,2,158616,158616,158618,0,2,2
45269,6,1,158622,158622,158623,0,1,4
45270,5,1,158627,158627,158628,0,1,4
45271,6,1,158633,158633,158634,0,1,5
45272,3,1,158636,158636,158637,0,1,2
45273,4,1,158640,158640,158641,0,1,3
45274,6,3,158646,158646,158649,0,3,5
45275,2,1,158648,158649,158650,1,2,0
45276,1,1,158649,158650,158651,1,2,0
45277,4,1,158653,158653,158654,0,1,2
45278,2,3,158655,158655,158658,0,3,1
45279,6,3,158661,158661,158664,0,3,3
45280,6,2,158667,158667,158669,0,2,3
45281,4,1,158671,158671,158672,0,1,2
45282,6,2,158677,158677,158679,0,2,5
45283,5,3,158682,158682,158685,0,3,3
45284,6,2,158688,158688,158690,0,2,3
45285,5,2,158693,158693,158695,0,2,3
45286,1,1,158694,158695,158696,1,2,0
45287,1,3,158695,158696,158699,1,4,0
45288,3,1,158698,158699,158700,1,2,0
45289,5,2,158703,158703,158705,0,2,3
45290,2,2,158705,158705,158707,0,2,0
45291,6,3,158711,158711,158714,0,3,4
45292,4,3,158715,158715,158718,0,3,1
45293,6,3,158721,158721,158724,0,3,3
45294,3,3,158724,158724,158727,0,3,0
45295,4,2,158728,158728,158730,0,2,1
45296,1,1,158729,158730,158731,1,2,0
45297,6,2,158735,158735,158737,0,2,4
45298,4,1,158739,158739,158740,0,1,2
45299,1,2,158740,158740,158742,0,2,0
45300,2,3,158742,158742,158745,0,3,0
45301,2,1,158744,158745,158746,1,2,0
45302,6,3,158750,158750,158753,0,3,4
45303,6,1,158756,158756,158757,0,1,3
45304,2,2,158758,158758,158760,0,2,1
45305,3,2,158761,158761,158763,0,2,1
45306,6,3,158767,158767,158770,0,3,4
45307,4,1,158771,158771,158772,0,1,1
45308,4,1,158775,158775,158776,0,1,3
45309,6,3,158781,158781,158784,0,3,5
45310,2,3,158783,158784,158787,1,4,0
45311,4,1,158787,158787,158788,0,1,0
45312,3,1,158790,158790,158791,0,1,2
45313,2,1,158792,158792,158793,0,1,1
45314,1,3,158793,158793,158796,0,3,0
45315,5,2,158798,158798,158800,0,2,2
45316,2,2,158800,158800,158802,0,2,0
45317,4,3,158804,158804,158807,0,3,2
45318,5,1,158809,158809,158810,0,1,2
45319,3,2,158812,158812,158814,0,2,2
45320,1,1,158813,158814,158815,1,2,0
45321,3,3,158816,158816,158819,0,3,1
45322,1,1,158817,158819,158820,2,3,0
45323,2,3,158819,158820,158823,1,4,0
45324,2,3,158821,158823,158826,2,5,0
45325,5,2,158826,158826,158828,0,2,0
45326,3,1,158829,158829,158830,0,1,1
45327,3,2,158832,158832,158834,0,2,2
45328,3,1,158835,158835,158836,0,1,1
45329,1,3,158836,158836,158839,0,3,0
45330,3,3,158839,158839,158842,0,3,0
45331,2,3,158841,158842,158845,1,4,0
45332,6,2,158847,158847,158849,0,2,2
45333,3,3,158850,158850,158853,0,3,1
45334,6,3,158856,158856,158859,0,3,3
45335,1,2,158857,158859,158861,2,4,0
45336,1,3,158858,158861,158864,3,6,0
45337,2,3,158860,158864,158867,4,7,0
45338,1,3,158861,158867,158870,6,9,0
45339,4,2,158865,158870,158872,5,7,0
45340,4,2,158869,158872,158874,3,5,0
45341,6,3,158875,158875,158878,0,3,1
45342,6,3,158881,158881,158884,0,3,3
45343,3,2,158884,158884,158886,0,2,0
45344,3,3,158887,158887,158890,0,3,1
45345,3,3,158890,158890,158893,0,3,0
45346,5,2,158895,158895,158897,0,2,2
45347,5,3,158900,158900,158903,0,3,3
45348,3,1,158903,158903,158904,0,1,0
45349,5,3,158908,158908,158911,0,3,4
45350,1,2,158909,158911,158913,2,4,0
45351,1,1,158910,158913,158914,3,4,0
45352,6,3,158916,158916,158919,0,3,2
45353,5,2,158921,158921,158923,0,2,2
45354,4,3,158925,158925,158928,0,3,2
45355,6,1,158931,158931,158932,0,1,3
45356,2,3,158933,158933,158936,0,3,1
45357,2,3,158935,158936,158939,1,4,0
45358,4,2,158939,158939,158941,0,2,0
45359,1,3,158940,158941,158944,1,4,0
45360,6,2,158946,158946,158948,0,2,2
45361,2,2,158948,158948,158950,0,2,0
45362,4,2,158952,158952,158954,0,2,2
45363,3,1,158955,158955,158956,0,1,1
45364,5,1,158960,158960,158961,0,1,4
45365,1,3,158961,158961,158964,0,3,0
45366,2,2,158963,158964,158966,1,3,0
45367,5,3,158968,158968,158971,0,3,2
45368,2,3,158970,158971,158974,1,4,0
45369,2,2,158972,158974,158976,2,4,0
45370,3,1,158975,158976,158977,1,2,0
45371,1,1,158976,158977,158978,1,2,0
45372,5,1,158981,158981,158982,0,1,3
45373,5,2,158986,158986,158988,0,2,4
45374,2,1,158988,158988,158989,0,1,0
45375,6,2,158994,158994,158996,0,2,5
45376,1,1,158995,158996,158997,1,2,0
45377,4,2,158999,158999,159001,0,2,2
45378,6,1,159005,159005,159006,0,1,4
45379,5,1,159010,159010,159011,0,1,4
45380,5,1,159015,159015,159016,0,1,4
45381,5,1,159020,159020,159021,0,1,4
45382,2,2,159022,159022,159024,0,2,1
45383,6,3,159028,159028,159031,0,3,4
45384,3,1,159031,159031,159032,0,1,0
45385,1,3,159032,159032,159035,0,3,0
45386,1,1,159033,159035,159036,2,3,0
45387,5,2,159038,159038,159040,0,2,2
45388,4,3,159042,159042,159045,0,3,2
45389,4,3,159046,159046,159049,0,3,1
45390,5,1,159051,159051,159052,0,1,2
45391,4,2,159055,159055,159057,0,2,3
45392,6,3,159061,159061,159064,0,3,4
45393,2,1,159063,159064,159065,1,2,0
45394,3,1,159066,159066,159067,0,1,1
45395,4,3,159070,159070,159073,0,3,3
45396,4,2,159074,159074,159076,0,2,1
45397,5,1,159079,159079,159080,0,1,3
45398,6,1,159085,159085,159086,0,1,5
45399,2,2,159087,159087,159089,0,2,1
45400,5,2,159092,159092,159094,0,2,3
45401,2,2,159094,159094,159096,0,2,0
45402,2,1,159096,159096,159097,0,1,0
45403,1,2,159097,159097,159099,0,2,0
45404,3,2,159100,159100,159102,0,2,1
45405,3,3,159103,159103,159106,0,3,1
45406,2,1,159105,159106,159107,1,2,0
45407,5,2,159110,159110,159112,0,2,3
45408,4,3,159114,159114,159117,0,3,2
45409,2,2,159116,159117,159119,1,3,0
45410,5,1,159121,159121,159122,0,1,2
45411,3,1,159124,159124,159125,0,1,2
45412,2,1,159126,159126,159127,0,1,1
45413,3,1,159129,159129,159130,0,1,2
45414,4,2,159133,159133,159135,0,2,3
45415,1,2,159134,159135,159137,1,3,0
45416,6,3,159140,159140,159143,0,3,3
45417,3,2,159143,159143,159145,0,2,0
45418,2,2,159145,159145,159147,0,2,0
45419,3,1,159148,159148,159149,0,1,1
45420,3,3,159151,159151,159154,0,3,2
45421,1,1,159152,159154,159155,2,3,0
45422,3,1,159155,159155,159156,0,1,0
45423,6,1,159161,159161,159162,0,1,5
45424,5,1,159166,159166,159167,0,1,4
45425,2,1,159168,159168,159169,0,1,1
45426,6,2,159174,159174,159176,0,2,5
45427,1,3,159175,159176,159179,1,4,0
45428,2,2,159177,159179,159181,2,4,0
45429,3,3,159180,159181,159184,1,4,0
45430,2,1,159182,159184,159185,2,3,0
45431,4,2,159186,159186,159188,0,2,1
45432,1,1,159187,159188,159189,1,2,0
45433,1,3,159188,159189,159192,1,4,0
45434,3,2,159191,159192,159194,1,3,0
45435,4,2,159195,159195,159197,0,2,1
45436,2,3,159197,159197,159200,0,3,0
45437,5,2,159202,159202,159204,0,2,2
45438,1,1,159203,159204,159205,1,2,0
45439,3,3,159206,159206,159209,0,3,1
45440,4,1,159210,159210,159211,0,1,1
45441,2,3,159212,159212,159215,0,3,1
45442,3,1,159215,159215,159216,0,1,0
45443,2,1,159217,159217,159218,0,1,1
45444,1,1,159218,159218,159219,0,1,0
45445,5,1,159223,159223,159224,0,1,4
45446,5,2,159228,159228,159230,0,2,4
45447,1,1,159229,159230,159231,1,2,0
45448,2,2,159231,159231,159233,0,2,0
45449,5,2,159236,159236,159238,0,2,3
45450,3,2,159239,159239,159241,0,2,1
45451,3,3,159242,159242,159245,0,3,1
45452,6,2,159248,159248,159250,0,2,3
45453,5,1,159253,159253,159254,0,1,3
45454,2,1,159255,159255,159256,0,1,1
45455,3,3,159258,159258,159261,0,3,2
45456,1,1,159259,159261,159262,2,3,0
45457,1,1,159260,159262,159263,2,3,0
45458,5,1,159265,159265,159266,0,1,2
45459,5,2,159270,159270,159272,0,2,4
45460,3,2,159273,159273,159275,0,2,1
45461,5,2,159278,159278,159280,0,2,3
45462,5,3,159283,159283,159286,0,3,3
45463,6,3,159289,159289,159292,0,3,3
45464,4,3,159293,159293,159296,0,3,1
45465,4,3,159297,159297,159300,0,3,1
45466,4,2,159301,159301,159303,0,2,1
45467,3,3,159304,159304,159307,0,3,1
45468,4,1,159308,159308,159309,0,1,1
45469,2,2,159310,159310,159312,0,2,1
45470,5,2,159315,159315,159317,0,2,3
45471,2,1,159317,159317,159318,0,1,0
45472,5,2,159322,159322,159324,0,2,4
45473,3,3,159325,159325,159328,0,3,1
45474,5,3,159330,159330,159333,0,3,2
45475,6,1,159336,159336,159337,0,1,3
45476,6,2,159342,159342,159344,0,2,5
45477,2,2,159344,159344,159346,0,2,0
45478,1,3,159345,159346,159349,1,4,0
45479,4,2,159349,159349,159351,0,2,0
45480,1,3,159350,159351,159354,1,4,0
45481,2,2,159352,159354,159356,2,4,0
45482,2,2,159354,159356,159358,2,4,0
45483,1,2,159355,159358,159360,3,5,0
45484,4,2,159359,159360,159362,1,3,0
45485,3,3,159362,159362,159365,0,3,0
45486,3,2,159365,159365,159367,0,2,0
45487,2,3,159367,159367,159370,0,3,0
45488,4,1,159371,159371,159372,0,1,1
45489,6,2,159377,159377,159379,0,2,5
45490,1,3,159378,159379,159382,1,4,0
45491,1,3,159379,159382,159385,3,6,0
45492,5,1,159384,159385,159386,1,2,0
45493,6,2,159390,159390,159392,0,2,4
45494,1,3,159391,159392,159395,1,4,0
45495,4,2,159395,159395,159397,0,2,0
45496,4,3,159399,159399,159402,0,3,2
45497,2,1,159401,159402,159403,1,2,0
45498,6,1,159407,159407,159408,0,1,4
45499,6,3,159413,159413,159416,0,3,5
45500,5,2,159418,159418,159420,0,2,2
45501,6,1,159424,159424,159425,0,1,4
45502,5,2,159429,159429,159431,0,2,4
45503,1,1,159430,159431,159432,1,2,0
45504,6,3,159436,159436,159439,0,3,4
45505,1,2,159437,159439,159441,2,4,0
45506,2,3,159439,159441,159444,2,5,0
45507,6,1,159445,159445,159446,0,1,1
45508,3,1,159448,159448,159449,0,1,2
45509,4,3,159452,159452,159455,0,3,3
45510,3,1,159455,159455,159456,0,1,0
45511,3,1,159458,159458,159459,0,1,2
45512,5,1,159463,159463,159464,0,1,4
45513,3,1,159466,159466,159467,0,1,2
45514,2,1,159468,159468,159469,0,1,1
45515,4,2,159472,159472,159474,0,2,3
45516,4,1,159476,159476,159477,0,1,2
45517,1,2,159477,159477,159479,0,2,0
45518,4,3,159481,159481,159484,0,3,2
45519,3,3,159484,159484,159487,0,3,0
45520,5,2,159489,159489,159491,0,2,2
45521,2,1,159491,159491,159492,0,1,0
45522,4,3,159495,159495,159498,0,3,3
45523,6,2,159501,159501,159503,0,2,3
45524,5,1,159506,159506,159507,0,1,3
45525,4,1,159510,159510,159511,0,1,3
45526,6,1,159516,159516,159517,0,1,5
45527,6,3,159522,159522,159525,0,3,5
45528,1,2,159523,159525,159527,2,4,0
45529,3,2,159526,159527,159529,1,3,0
45530,2,3,159528,159529,159532,1,4,0
45531,1,1,159529,159532,159533,3,4,0
45532,5,2,159534,159534,159536,0,2,1
45533,5,2,159539,159539,159541,0,2,3
45534,3,1,159542,159542,159543,0,1,1
45535,3,1,159545,159545,159546,0,1,2
45536,5,2,159550,159550,159552,0,2,4
45537,4,3,159554,159554,159557,0,3,2
45538,5,2,159559,159559,159561,0,2,2
45539,6,1,159565,159565,159566,0,1,4
45540,2,1,159567,159567,159568,0,1,1
45541,3,3,159570,159570,159573,0,3,2
45542,5,1,159575,159575,159576,0,1,2
45543,6,3,159581,159581,159584,0,3,5
45544,3,1,159584,159584,159585,0,1,0
45545,6,1,159590,159590,159591,0,1,5
45546,6,3,159596,159596,159599,0,3,5
45547,2,2,159598,159599,159601,1,3,0
45548,4,3,159602,159602,159605,0,3,1
45549,4,3,159606,159606,159609,0,3,1
45550,1,1,159607,159609,159610,2,3,0
45551,3,1,159610,159610,159611,0,1,0
45552,5,3,159615,159615,159618,0,3,4
45553,1,3,159616,159618,159621,2,5,0
45554,1,3,159617,159621,159624,4,7,0
45555,1,2,159618,159624,159626,6,8,0
45556,2,3,159620,159626,159629,6,9,0
45557,3,1,159623,159629,159630,6,7,0
45558,2,3,159625,159630,159633,5,8,0
45559,1,3,159626,159633,159636,7,10,0
45560,3,3,159629,159636,159639,7,10,0
45561,5,3,159634,159639,159642,5,8,0
45562,1,3,159635,159642,159645,7,10,0
45563,4,2,159639,159645,159647,6,8,0
45564,4,2,159643,159647,159649,4,6,0
45565,4,1,159647,159649,159650,2,3,0
45566,2,2,159649,159650,159652,1,3,0
45567,6,1,159655,159655,159656,0,1,3
45568,1,1,159656,159656,159657,0,1,0
45569,2,3,159658,159658,159661,0,3,1
45570,3,3,159661,159661,159664,0,3,0
45571,3,3,159664,159664,159667,0,3,0
45572,1,1,159665,159667,159668,2,3,0
45573,3,2,159668,159668,159670,0,2,0
45574,5,3,159673,159673,159676,0,3,3
45575,6,1,159679,159679,159680,0,1,3
45576,3,3,159682,159682,159685,0,3,2
45577,6,3,159688,159688,159691,0,3,3
45578,4,3,159692,159692,159695,0,3,1
45579,4,2,159696,159696,159698,0,2,1
45580,2,3,159698,159698,159701,0,3,0
45581,4,2,159702,159702,159704,0,2,1
45582,6,3,159708,159708,159711,0,3,4
45583,6,1,159714,159714,159715,0,1,3
45584,1,2,159715,159715,159717,0,2,0
45585,2,1,159717,159717,159718,0,1,0
45586,4,3,159721,159721,159724,0,3,3
45587,5,2,159726,159726,159728,0,2,2
45588,1,2,159727,159728,159730,1,3,0
45589,1,3,159728,159730,159733,2,5,0
45590,1,2,159729,159733,159735,4,6,0
45591,3,2,159732,159735,159737,3,5,0
45592,5,2,159737,159737,159739,0,2,0
45593,1,3,159738,159739,159742,1,4,0
45594,5,1,159743,159743,159744,0,1,1
45595,4,1,159747,159747,159748,0,1,3
45596,4,1,159751,159751,159752,0,1,3
45597,1,3,159752,159752,159755,0,3,0
45598,4,3,159756,159756,159759,0,3,1
45599,5,1,159761,159761,159762,0,1,2
45600,1,3,159762,159762,159765,0,3,0
45601,5,1,159767,159767,159768,0,1,2
45602,6,2,159773,159773,159775,0,2,5
45603,3,3,159776,159776,159779,0,3,1
45604,1,3,159777,159779,159782,2,5,0
45605,5,2,159782,159782,159784,0,2,0
45606,3,3,159785,159785,159788,0,3,1
45607,2,3,159787,159788,159791,1,4,0
45608,6,1,159793,159793,159794,0,1,2
45609,3,1,159796,159796,159797,0,1,2
45610,2,1,159798,159798,159799,0,1,1
45611,1,1,159799,159799,159800,0,1,0
45612,3,3,159802,159802,159805,0,3,2
45613,5,3,159807,159807,159810,0,3,2
45614,1,3,159808,159810,159813,2,5,0
45615,1,1,159809,159813,159814,4,5,0
45616,4,1,159813,159814,159815,1,2,0
45617,1,2,159814,159815,159817,1,3,0
45618,2,2,159816,159817,159819,1,3,0
45619,4,1,159820,159820,159821,0,1,1
45620,2,2,159822,159822,159824,0,2,1
45621,5,3,159827,159827,159830,0,3,3
45622,3,2,159830,159830,159832,0,2,0
45623,6,2,159836,159836,159838,0,2,4
45624,5,2,159841,159841,159843,0,2,3
45625,3,3,159844,159844,159847,0,3,1
45626,1,1,159845,159847,159848,2,3,0
45627,4,1,159849,159849,159850,0,1,1
45628,6,2,159855,159855,159857,0,2,5
45629,2,3,159857,159857,159860,0,3,0
45630,2,1,159859,159860,159861,1,2,0
45631,4,1,159863,159863,159864,0,1,2
45632,1,2,159864,159864,159866,0,2,0
45633,1,1,159865,159866,159867,1,2,0
45634,3,1,159868,159868,159869,0,1,1
45635,2,1,159870,159870,159871,0,1,1
45636,1,2,159871,159871,159873,0,2,0
45637,6,2,159877,159877,159879,0,2,4
45638,2,2,159879,159879,159881,0,2,0
45639,1,1,159880,159881,159882,1,2,0
45640,4,1,159884,159884,159885,0,1,2
45641,3,2,159887,159887,159889,0,2,2
45642,6,2,159893,159893,159895,0,2,4
45643,3,2,159896,159896,159898,0,2,1
45644,2,2,159898,159898,159900,0,2,0
45645,3,3,159901,159901,159904,0,3,1
45646,5,3,159906,159906,159909,0,3,2
45647,4,3,159910,159910,159913,0,3,1
45648,3,3,159913,159913,159916,0,3,0
45649,5,3,159918,159918,159921,0,3,2
45650,4,3,159922,159922,159925,0,3,1
45651,2,1,159924,159925,159926,1,2,0
45652,4,3,159928,159928,159931,0,3,2
45653,3,2,159931,159931,159933,0,2,0
45654,1,3,159932,159933,159936,1,4,0
45655,6,3,159938,159938,159941,0,3,2
45656,4,1,159942,159942,159943,0,1,1
45657,2,2,159944,159944,159946,0,2,1
45658,1,2,159945,159946,159948,1,3,0
45659,5,1,159950,159950,159951,0,1,2
45660,2,1,159952,159952,159953,0,1,1
45661,1,3,159953,159953,159956,0,3,0
45662,5,3,159958,159958,159961,0,3,2
45663,1,1,159959,159961,159962,2,3,0
45664,6,1,159965,159965,159966,0,1,3
45665,5,3,159970,159970,159973,0,3,4
45666,4,3,159974,159974,159977,0,3,1
45667,2,2,159976,159977,159979,1,3,0
45668,3,3,159979,159979,159982,0,3,0
45669,2,3,159981,159982,159985,1,4,0
45670,2,3,159983,159985,159988,2,5,0
45671,4,1,159987,159988,159989,1,2,0
45672,6,1,159993,159993,159994,0,1,4
45673,4,3,159997,159997,160000,0,3,3
45674,5,2,160002,160002,160004,0,2,2
45675,3,2,160005,160005,160007,0,2,1
45676,6,2,160011,160011,160013,0,2,4
45677,2,1,160013,160013,160014,0,1,0
45678,6,1,160019,160019,160020,0,1,5
45679,5,2,160024,160024,160026,0,2,4
45680,1,2,160025,160026,160028,1,3,0
45681,4,1,160029,160029,160030,0,1,1
45682,1,2,160030,160030,160032,0,2,0
45683,1,1,160031,160032,160033,1,2,0
45684,2,3,160033,160033,160036,0,3,0
45685,5,2,160038,160038,160040,0,2,2
45686,2,2,160040,160040,160042,0,2,0
45687,4,3,160044,160044,160047,0,3,2
45688,5,3,160049,160049,160052,0,3,2
45689,1,3,160050,160052,160055,2,5,0
45690,4,2,160054,160055,160057,1,3,0
45691,6,3,160060,160060,160063,0,3,3
45692,1,3,160061,160063,160066,2,5,0
45693,6,2,160067,160067,160069,0,2,1
45694,3,2,160070,160070,160072,0,2,1
45695,5,1,160075,160075,160076,0,1,3
45696,6,3,160081,160081,160084,0,3,5
45697,5,1,160086,160086,160087,0,1,2
45698,6,2,160092,160092,160094,0,2,5
45699,6,2,160098,160098,160100,0,2,4
45700,6,2,160104,160104,160106,0,2,4
45701,4,2,160108,160108,160110,0,2,2
45702,2,2,160110,160110,160112,0,2,0
45703,4,2,160114,160114,160116,0,2,2
45704,3,1,160117,160117,160118,0,1,1
45705,3,1,160120,160120,160121,0,1,2
45706,4,1,160124,160124,160125,0,1,3
45707,3,1,160127,160127,160128,0,1,2
45708,3,3,160130,160130,160133,0,3,2
45709,6,2,160136,160136,160138,0,2,3
45710,2,1,160138,160138,160139,0,1,0
45711,2,3,160140,160140,160143,0,3,1
45712,2,2,160142,160143,160145,1,3,0
45713,6,1,160148,160148,160149,0,1,3
45714,4,3,160152,160152,160155,0,3,3
45715,3,1,160155,160155,160156,0,1,0
45716,3,1,160158,160158,160159,0,1,2
45717,2,1,160160,160160,160161,0,1,1
45718,3,1,160163,160163,160164,0,1,2
45719,2,3,160165,160165,160168,0,3,1
45720,2,1,160167,160168,160169,1,2,0
45721,6,1,160173,160173,160174,0,1,4
45722,6,3,160179,160179,160182,0,3,5
45723,6,3,160185,160185,160188,0,3,3
45724,3,1,160188,160188,160189,0,1,0
45725,2,2,160190,160190,160192,0,2,1
45726,4,1,160194,160194,160195,0,1,2
45727,3,1,160197,160197,160198,0,1,2
45728,1,2,160198,160198,160200,0,2,0
45729,6,2,160204,160204,160206,0,2,4
45730,1,2,160205,160206,160208,1,3,0
45731,1,1,160206,160208,160209,2,3,0
45732,5,2,160211,160211,160213,0,2,2
45733,6,2,160217,160217,160219,0,2,4
45734,2,3,160219,160219,160222,0,3,0
45735,4,2,160223,160223,160225,0,2,1
45736,3,1,160226,160226,160227,0,1,1
45737,4,1,160230,160230,160231,0,1,3
45738,4,3,160234,160234,160237,0,3,3
45739,6,1,160240,160240,160241,0,1,3
45740,2,1,160242,160242,160243,0,1,1
45741,1,2,160243,160243,160245,0,2,0
45742,4,2,160247,160247,160249,0,2,2
45743,4,2,160251,160251,160253,0,2,2
45744,5,1,160256,160256,160257,0,1,3
45745,3,1,160259,160259,160260,0,1,2
45746,3,1,160262,160262,160263,0,1,2
45747,3,3,160265,160265,160268,0,3,2
45748,3,1,160268,160268,160269,0,1,0
45749,5,2,160273,160273,160275,0,2,4
45750,2,3,160275,160275,160278,0,3,0
45751,4,2,160279,160279,160281,0,2,1
45752,6,1,160285,160285,160286,0,1,4
45753,3,3,160288,160288,160291,0,3,2
45754,3,2,160291,160291,160293,0,2,0
45755,4,2,160295,160295,160297,0,2,2
45756,4,2,160299,160299,160301,0,2,2
45757,2,2,160301,160301,160303,0,2,0
45758,4,2,160305,160305,160307,0,2,2
45759,6,3,160311,160311,160314,0,3,4
45760,3,3,160314,160314,160317,0,3,0
45761,4,1,160318,160318,160319,0,1,1
45762,3,2,160321,160321,160323,0,2,2
45763,2,3,160323,160323,160326,0,3,0
45764,4,2,160327,160327,160329,0,2,1
45765,6,1,160333,160333,160334,0,1,4
45766,1,2,160334,160334,160336,0,2,0
45767,6,3,160340,160340,160343,0,3,4
45768,3,3,160343,160343,160346,0,3,0
45769,2,1,160345,160346,160347,1,2,0
45770,3,1,160348,160348,160349,0,1,1
45771,6,3,160354,160354,160357,0,3,5
45772,5,2,160359,160359,160361,0,2,2
45773,1,1,160360,160361,160362,1,2,0
45774,6,2,160366,160366,160368,0,2,4
45775,6,2,160372,160372,160374,0,2,4
45776,2,3,160374,160374,160377,0,3,0
45777,3,3,160377,160377,160380,0,3,0
45778,3,3,160380,160380,160383,0,3,0
45779,6,2,160386,160386,160388,0,2,3
45780,4,2,160390,160390,160392,0,2,2
45781,1,2,160391,160392,160394,1,3,0
45782,1,2,160392,160394,160396,2,4,0
45783,6,2,160398,160398,160400,0,2,2
45784,1,1,160399,160400,160401,1,2,0
45785,2,1,160401,160401,160402,0,1,0
45786,1,3,160402,160402,160405,0,3,0
45787,6,1,160408,160408,160409,0,1,3
45788,5,1,160413,160413,160414,0,1,4
45789,3,1,160416,160416,160417,0,1,2
45790,5,3,160421,160421,160424,0,3,4
45791,1,2,160422,160424,160426,2,4,0
45792,1,1,160423,160426,160427,3,4,0
45793,4,1,160427,160427,160428,0,1,0
45794,5,1,160432,160432,160433,0,1,4
45795,5,1,160437,160437,160438,0,1,4
45796,6,1,160443,160443,160444,0,1,5
45797,4,1,160447,160447,160448,0,1,3
45798,6,1,160453,160453,160454,0,1,5
45799,6,1,160459,160459,160460,0,1,5
45800,1,1,160460,160460,160461,0,1,0
45801,1,3,160461,160461,160464,0,3,0
45802,6,1,160467,160467,160468,0,1,3
45803,4,2,160471,160471,160473,0,2,3
45804,5,2,160476,160476,160478,0,2,3
45805,6,1,160482,160482,160483,0,1,4
45806,2,3,160484,160484,160487,0,3,1
45807,5,3,160489,160489,160492,0,3,2
45808,2,3,160491,160492,160495,1,4,0
45809,1,1,160492,160495,160496,3,4,0
45810,2,3,160494,160496,160499,2,5,0
45811,1,3,160495,160499,160502,4,7,0
45812,1,3,160496,160502,160505,6,9,0
45813,4,2,160500,160505,160507,5,7,0
45814,3,2,160503,160507,160509,4,6,0
45815,2,3,160505,160509,160512,4,7,0
45816,1,1,160506,160512,160513,6,7,0
45817,2,1,160508,160513,160514,5,6,0
45818,6,3,160514,160514,160517,0,3,0
45819,1,3,160515,160517,160520,2,5,0
45820,6,2,160521,160521,160523,0,2,1
45821,3,1,160524,160524,160525,0,1,1
45822,1,2,160525,160525,160527,0,2,0
45823,5,2,160530,160530,160532,0,2,3
45824,3,2,160533,160533,160535,0,2,1
45825,6,1,160539,160539,160540,0,1,4
45826,3,3,160542,160542,160545,0,3,2
45827,1,1,160543,160545,160546,2,3,0
45828,1,2,160544,160546,160548,2,4,0
45829,3,3,160547,160548,160551,1,4,0
45830,3,3,160550,160551,160554,1,4,0
45831,6,2,160556,160556,160558,0,2,2
45832,5,3,160561,160561,160564,0,3,3
45833,6,3,160567,160567,160570,0,3,3
45834,3,3,160570,160570,160573,0,3,0
45835,1,3,160571,160573,160576,2,5,0
45836,6,1,160577,160577,160578,0,1,1
45837,5,2,160582,160582,160584,0,2,4
45838,1,3,160583,160584,160587,1,4,0
45839,1,3,160584,160587,160590,3,6,0
45840,5,1,160589,160590,160591,1,2,0
45841,4,1,160593,160593,160594,0,1,2
45842,5,1,160598,160598,160599,0,1,4
45843,1,3,160599,160599,160602,0,3,0
45844,6,3,160605,160605,160608,0,3,3
45845,5,2,160610,160610,160612,0,2,2
45846,5,2,160615,160615,160617,0,2,3
45847,2,3,160617,160617,160620,0,3,0
45848,6,2,160623,160623,160625,0,2,3
45849,5,2,160628,160628,160630,0,2,3
45850,1,3,160629,160630,160633,1,4,0
45851,3,1,160632,160633,160634,1,2,0
45852,6,3,160638,160638,160641,0,3,4
45853,6,1,160644,160644,160645,0,1,3
45854,5,1,160649,160649,160650,0,1,4
45855,4,1,160653,160653,160654,0,1,3
45856,3,3,160656,160656,160659,0,3,2
45857,1,1,160657,160659,160660,2,3,0
45858,1,3,160658,160660,160663,2,5,0
45859,1,2,160659,160663,160665,4,6,0
45860,3,3,160662,160665,160668,3,6,0
45861,4,1,160666,160668,160669,2,3,0
45862,3,1,160669,160669,160670,0,1,0
45863,1,1,160670,160670,160671,0,1,0
45864,6,2,160676,160676,160678,0,2,5
45865,2,3,160678,160678,160681,0,3,0
45866,4,3,160682,160682,160685,0,3,1
45867,3,2,160685,160685,160687,0,2,0
45868,2,3,160687,160687,160690,0,3,0
45869,1,1,160688,160690,160691,2,3,0
45870,2,1,160690,160691,160692,1,2,0
45871,4,1,160694,160694,160695,0,1,2
45872,1,1,160695,160695,160696,0,1,0
45873,3,2,160698,160698,160700,0,2,2
45874,1,1,160699,160700,160701,1,2,0
45875,1,1,160700,160701,160702,1,2,0
45876,1,2,160701,160702,160704,1,3,0
45877,3,1,160704,160704,160705,0,1,0
45878,5,1,160709,160709,160710,0,1,4
45879,4,2,160713,160713,160715,0,2,3
45880,3,1,160716,160716,160717,0,1,1
45881,5,3,160721,160721,160724,0,3,4
45882,4,1,160725,160725,160726,0,1,1
45883,5,1,160730,160730,160731,0,1,4
45884,4,2,160734,160734,160736,0,2,3
45885,4,1,160738,160738,160739,0,1,2
45886,6,1,160744,160744,160745,0,1,5
45887,5,3,160749,160749,160752,0,3,4
45888,1,3,160750,160752,160755,2,5,0
45889,1,1,160751,160755,160756,4,5,0
45890,2,1,160753,160756,160757,3,4,0
45891,2,1,160755,160757,160758,2,3,0
45892,1,2,160756,160758,160760,2,4,0
45893,5,1,160761,160761,160762,0,1,1
45894,4,1,160765,160765,160766,0,1,3
45895,5,1,160770,160770,160771,0,1,4
45896,1,1,160771,160771,160772,0,1,0
45897,5,2,160776,160776,160778,0,2,4
45898,1,2,160777,160778,160780,1,3,0
45899,6,2,160783,160783,160785,0,2,3
45900,2,1,160785,160785,160786,0,1,0
45901,4,1,160789,160789,160790,0,1,3
45902,2,2,160791,160791,160793,0,2,1
45903,5,3,160796,160796,160799,0,3,3
45904,6,1,160802,160802,160803,0,1,3
45905,2,3,160804,160804,160807,0,3,1
45906,4,2,160808,160808,160810,0,2,1
45907,3,1,160811,160811,160812,0,1,1
45908,2,3,160813,160813,160816,0,3,1
45909,1,1,160814,160816,160817,2,3,0
45910,3,1,160817,160817,160818,0,1,0
45911,6,2,160823,160823,160825,0,2,5
45912,4,1,160827,160827,160828,0,1,2
45913,4,1,160831,160831,160832,0,1,3
45914,5,2,160836,160836,160838,0,2,4
45915,5,2,160841,160841,160843,0,2,3
45916,4,3,160845,160845,160848,0,3,2
45917,1,3,160846,160848,160851,2,5,0
45918,1,1,160847,160851,160852,4,5,0
45919,5,1,160852,160852,160853,0,1,0
45920,6,1,160858,160858,160859,0,1,5
45921,6,2,160864,160864,160866,0,2,5
45922,3,1,160867,160867,160868,0,1,1
45923,1,3,160868,160868,160871,0,3,0
45924,6,3,160874,160874,160877,0,3,3
45925,3,2,160877,160877,160879,0,2,0
45926,2,2,160879,160879,160881,0,2,0
45927,5,1,160884,160884,160885,0,1,3
45928,1,3,160885,160885,160888,0,3,0
45929,1,3,160886,160888,160891,2,5,0
45930,1,2,160887,160891,160893,4,6,0
45931,3,2,160890,160893,160895,3,5,0
45932,4,1,160894,160895,160896,1,2,0
45933,1,3,160895,160896,160899,1,4,0
45934,6,1,160901,160901,160902,0,1,2
45935,3,1,160904,160904,160905,0,1,2
45936,6,2,160910,160910,160912,0,2,5
45937,2,3,160912,160912,160915,0,3,0
45938,2,1,160914,160915,160916,1,2,0
45939,3,2,160917,160917,160919,0,2,1
45940,3,3,160920,160920,160923,0,3,1
45941,1,2,160921,160923,160925,2,4,0
45942,2,2,160923,160925,160927,2,4,0
45943,1,1,160924,160927,160928,3,4,0
45944,5,3,160929,160929,160932,0,3,1
45945,6,2,160935,160935,160937,0,2,3
45946,5,2,160940,160940,160942,0,2,3
45947,3,2,160943,160943,160945,0,2,1
45948,3,1,160946,160946,160947,0,1,1
45949,5,3,160951,160951,160954,0,3,4
45950,6,3,160957,160957,160960,0,3,3
45951,5,1,160962,160962,160963,0,1,2
45952,4,2,160966,160966,160968,0,2,3
45953,1,2,160967,160968,160970,1,3,0
45954,5,1,160972,160972,160973,0,1,2
45955,2,1,160974,160974,160975,0,1,1
45956,2,3,160976,160976,160979,0,3,1
45957,2,1,160978,160979,160980,1,2,0
45958,4,3,160982,160982,160985,0,3,2
45959,1,1,160983,160985,160986,2,3,0
45960,6,3,160989,160989,160992,0,3,3
45961,5,3,160994,160994,160997,0,3,2
45962,3,2,160997,160997,160999,0,2,0
45963,2,3,160999,160999,161002,0,3,0
45964,5,3,161004,161004,161007,0,3,2
45965,3,1,161007,161007,161008,0,1,0
45966,1,3,161008,161008,161011,0,3,0
45967,3,2,161011,161011,161013,0,2,0
45968,2,2,161013,161013,161015,0,2,0
45969,6,3,161019,161019,161022,0,3,4
45970,1,2,161020,161022,161024,2,4,0
45971,4,2,161024,161024,161026,0,2,0
45972,2,3,161026,161026,161029,0,3,0
45973,2,3,161028,161029,161032,1,4,0
45974,6,2,161034,161034,161036,0,2,2
45975,5,1,161039,161039,161040,0,1,3
45976,6,1,161045,161045,161046,0,1,5
45977,4,3,161049,161049,161052,0,3,3
45978,3,1,161052,161052,161053,0,1,0
45979,5,1,161057,161057,161058,0,1,4
45980,5,2,161062,161062,161064,0,2,4
45981,5,2,161067,161067,161069,0,2,3
45982,4,1,161071,161071,161072,0,1,2
45983,4,1,161075,161075,161076,0,1,3
45984,5,3,161080,161080,161083,0,3,4
45985,4,1,161084,161084,161085,0,1,1
45986,3,2,161087,161087,161089,0,2,2
45987,5,1,161092,161092,161093,0,1,3
45988,5,2,161097,161097,161099,0,2,4
45989,3,2,161100,161100,161102,0,2,1
45990,2,2,161102,161102,161104,0,2,0
45991,1,2,161103,161104,161106,1,3,0
45992,2,2,161105,161106,161108,1,3,0
45993,6,3,161111,161111,161114,0,3,3
45994,5,1,161116,161116,161117,0,1,2
45995,6,1,161122,161122,161123,0,1,5
45996,1,3,161123,161123,161126,0,3,0
45997,6,1,161129,161129,161130,0,1,3
45998,6,2,161135,161135,161137,0,2,5
45999,4,2,161139,161139,161141,0,2,2
46000,3,2,161142,161142,161144,0,2,1
46001,2,1,161144,161144,161145,0,1,0
46002,6,2,161150,161150,161152,0,2,5
46003,2,1,161152,161152,161153,0,1,0
46004,4,2,161156,161156,161158,0,2,3
46005,4,3,161160,161160,161163,0,3,2
46006,2,3,161162,161163,161166,1,4,0
46007,6,3,161168,161168,161171,0,3,2
46008,3,2,161171,161171,161173,0,2,0
46009,5,3,161176,161176,161179,0,3,3
46010,3,3,161179,161179,161182,0,3,0
46011,5,1,161184,161184,161185,0,1,2
46012,3,3,161187,161187,161190,0,3,2
46013,3,3,161190,161190,161193,0,3,0
46014,5,2,161195,161195,161197,0,2,2
46015,2,1,161197,161197,161198,0,1,0
46016,3,3,161200,161200,161203,0,3,2
46017,4,1,161204,161204,161205,0,1,1
46018,6,1,161210,161210,161211,0,1,5
46019,3,1,161213,161213,161214,0,1,2
46020,6,3,161219,161219,161222,0,3,5
46021,5,1,161224,161224,161225,0,1,2
46022,4,2,161228,161228,161230,0,2,3
46023,1,1,161229,161230,161231,1,2,0
46024,2,1,161231,161231,161232,0,1,0
46025,2,1,161233,161233,161234,0,1,1
46026,6,3,161239,161239,161242,0,3,5
46027,5,1,161244,161244,161245,0,1,2
46028,2,2,161246,161246,161248,0,2,1
46029,4,1,161250,161250,161251,0,1,2
46030,5,3,161255,161255,161258,0,3,4
46031,4,2,161259,161259,161261,0,2,1
46032,2,3,161261,161261,161264,0,3,0
46033,6,3,161267,161267,161270,0,3,3
46034,1,1,161268,161270,161271,2,3,0
46035,6,1,161274,161274,161275,0,1,3
46036,4,3,161278,161278,161281,0,3,3
46037,5,1,161283,161283,161284,0,1,2
46038,1,3,161284,161284,161287,0,3,0
46039,5,2,161289,161289,161291,0,2,2
46040,2,3,161291,161291,161294,0,3,0
46041,1,1,161292,161294,161295,2,3,0
46042,6,3,161298,161298,161301,0,3,3
46043,3,3,161301,161301,161304,0,3,0
46044,3,3,161304,161304,161307,0,3,0
46045,6,1,161310,161310,161311,0,1,3
46046,1,3,161311,161311,161314,0,3,0
46047,1,1,161312,161314,161315,2,3,0
46048,3,3,161315,161315,161318,0,3,0
46049,3,1,161318,161318,161319,0,1,0
46050,3,3,161321,161321,161324,0,3,2
46051,6,1,161327,161327,161328,0,1,3
46052,5,3,161332,161332,161335,0,3,4
46053,1,3,161333,161335,161338,2,5,0
46054,4,3,161337,161338,161341,1,4,0
46055,6,2,161343,161343,161345,0,2,2
46056,2,2,161345,161345,161347,0,2,0
46057,1,3,161346,161347,161350,1,4,0
46058,6,1,161352,161352,161353,0,1,2
46059,4,2,161356,161356,161358,0,2,3
46060,5,2,161361,161361,161363,0,2,3
46061,5,3,161366,161366,161369,0,3,3
46062,6,2,161372,161372,161374,0,2,3
46063,3,1,161375,161375,161376,0,1,1
46064,1,1,161376,161376,161377,0,1,0
46065,1,1,161377,161377,161378,0,1,0
46066,3,1,161380,161380,161381,0,1,2
46067,1,3,161381,161381,161384,0,3,0
46068,3,2,161384,161384,161386,0,2,0
46069,5,1,161389,161389,161390,0,1,3
46070,1,3,161390,161390,161393,0,3,0
46071,3,1,161393,161393,161394,0,1,0
46072,5,1,161398,161398,161399,0,1,4
46073,4,1,161402,161402,161403,0,1,3
46074,4,3,161406,161406,161409,0,3,3
46075,4,2,161410,161410,161412,0,2,1
46076,4,3,161414,161414,161417,0,3,2
46077,4,2,161418,161418,161420,0,2,1
46078,2,2,161420,161420,161422,0,2,0
46079,1,1,161421,161422,161423,1,2,0
46080,6,1,161427,161427,161428,0,1,4
46081,3,3,161430,161430,161433,0,3,2
46082,2,3,161432,161433,161436,1,4,0
46083,2,1,161434,161436,161437,2,3,0
46084,1,3,161435,161437,161440,2,5,0
46085,5,2,161440,161440,161442,0,2,0
46086,4,2,161444,161444,161446,0,2,2
46087,3,1,161447,161447,161448,0,1,1
46088,1,1,161448,161448,161449,0,1,0
46089,4,3,161452,161452,161455,0,3,3
46090,3,3,161455,161455,161458,0,3,0
46091,3,2,161458,161458,161460,0,2,0
46092,4,1,161462,161462,161463,0,1,2
46093,3,2,161465,161465,161467,0,2,2
46094,5,3,161470,161470,161473,0,3,3
46095,5,1,161475,161475,161476,0,1,2
46096,4,3,161479,161479,161482,0,3,3
46097,5,1,161484,161484,161485,0,1,2
46098,6,3,161490,161490,161493,0,3,5
46099,6,2,161496,161496,161498,0,2,3
46100,2,3,161498,161498,161501,0,3,0
46101,6,1,161504,161504,161505,0,1,3
46102,4,1,161508,161508,161509,0,1,3
46103,3,1,161511,161511,161512,0,1,2
46104,2,3,161513,161513,161516,0,3,1
46105,3,2,161516,161516,161518,0,2,0
46106,1,1,161517,161518,161519,1,2,0
46107,2,3,161519,161519,161522,0,3,0
46108,2,3,161521,161522,161525,1,4,0
46109,1,3,161522,161525,161528,3,6,0
46110,6,2,161528,161528,161530,0,2,0
46111,5,2,161533,161533,161535,0,2,3
46112,3,1,161536,161536,161537,0,1,1
46113,3,2,161539,161539,161541,0,2,2
46114,3,1,161542,161542,161543,0,1,1
46115,1,1,161543,161543,161544,0,1,0
46116,5,2,161548,161548,161550,0,2,4
46117,6,3,161554,161554,161557,0,3,4
46118,5,1,161559,161559,161560,0,1,2
46119,5,2,161564,161564,161566,0,2,4
46120,4,2,161568,161568,161570,0,2,2
46121,1,1,161569,161570,161571,1,2,0
46122,5,2,161574,161574,161576,0,2,3
46123,1,3,161575,161576,161579,1,4,0
46124,5,3,161580,161580,161583,0,3,1
46125,4,1,161584,161584,161585,0,1,1
46126,5,2,161589,161589,161591,0,2,4
46127,6,2,161595,161595,161597,0,2,4
46128,2,3,161597,161597,161600,0,3,0
46129,6,3,161603,161603,161606,0,3,3
46130,3,1,161606,161606,161607,0,1,0
46131,4,3,161610,161610,161613,0,3,3
46132,6,1,161616,161616,161617,0,1,3
46133,6,3,161622,161622,161625,0,3,5
46134,5,3,161627,161627,161630,0,3,2
46135,4,2,161631,161631,161633,0,2,1
46136,2,1,161633,161633,161634,0,1,0
46137,5,3,161638,161638,161641,0,3,4
46138,5,1,161643,161643,161644,0,1,2
46139,5,2,161648,161648,161650,0,2,4
46140,3,3,161651,161651,161654,0,3,1
46141,5,1,161656,161656,161657,0,1,2
46142,4,1,161660,161660,161661,0,1,3
46143,1,2,161661,161661,161663,0,2,0
46144,3,2,161664,161664,161666,0,2,1
46145,3,3,161667,161667,161670,0,3,1
46146,2,1,161669,161670,161671,1,2,0
46147,3,1,161672,161672,161673,0,1,1
46148,4,1,161676,161676,161677,0,1,3
46149,6,2,161682,161682,161684,0,2,5
46150,6,3,161688,161688,161691,0,3,4
46151,4,1,161692,161692,161693,0,1,1
46152,5,3,161697,161697,161700,0,3,4
46153,4,1,161701,161701,161702,0,1,1
46154,4,2,161705,161705,161707,0,2,3
46155,6,2,161711,161711,161713,0,2,4
46156,2,2,161713,161713,161715,0,2,0
46157,5,3,161718,161718,161721,0,3,3
46158,6,2,161724,161724,161726,0,2,3
46159,1,1,161725,161726,161727,1,2,0
46160,1,2,161726,161727,161729,1,3,0
46161,2,2,161728,161729,161731,1,3,0
46162,4,1,161732,161732,161733,0,1,1
46163,6,2,161738,161738,161740,0,2,5
46164,4,1,161742,161742,161743,0,1,2
46165,4,2,161746,161746,161748,0,2,3
46166,4,3,161750,161750,161753,0,3,2
46167,1,3,161751,161753,161756,2,5,0
46168,4,3,161755,161756,161759,1,4,0
46169,6,3,161761,161761,161764,0,3,2
46170,2,3,161763,161764,161767,1,4,0
46171,6,3,161769,161769,161772,0,3,2
46172,1,1,161770,161772,161773,2,3,0
46173,2,2,161772,161773,161775,1,3,0
46174,1,3,161773,161775,161778,2,5,0
46175,2,1,161775,161778,161779,3,4,0
46176,6,3,161781,161781,161784,0,3,2
46177,6,3,161787,161787,161790,0,3,3
46178,1,2,161788,161790,161792,2,4,0
46179,5,1,161793,161793,161794,0,1,1
46180,3,1,161796,161796,161797,0,1,2
46181,3,1,161799,161799,161800,0,1,2
46182,6,2,161805,161805,161807,0,2,5
46183,2,1,161807,161807,161808,0,1,0
46184,5,2,161812,161812,161814,0,2,4
46185,1,1,161813,161814,161815,1,2,0
46186,4,3,161817,161817,161820,0,3,2
46187,5,2,161822,161822,161824,0,2,2
46188,2,3,161824,161824,161827,0,3,0
46189,3,3,161827,161827,161830,0,3,0
46190,3,1,161830,161830,161831,0,1,0
46191,2,3,161832,161832,161835,0,3,1
46192,3,1,161835,161835,161836,0,1,0
46193,4,3,161839,161839,161842,0,3,3
46194,2,1,161841,161842,161843,1,2,0
46195,4,3,161845,161845,161848,0,3,2
46196,1,1,161846,161848,161849,2,3,0
46197,1,2,161847,161849,161851,2,4,0
46198,5,1,161852,161852,161853,0,1,1
46199,3,3,161855,161855,161858,0,3,2
46200,6,2,161861,161861,161863,0,2,3
46201,3,3,161864,161864,161867,0,3,1
46202,5,1,161869,161869,161870,0,1,2
46203,3,1,161872,161872,161873,0,1,2
46204,3,2,161875,161875,161877,0,2,2
46205,3,2,161878,161878,161880,0,2,1
46206,6,3,161884,161884,161887,0,3,4
46207,2,3,161886,161887,161890,1,4,0
46208,2,2,161888,161890,161892,2,4,0
46209,1,2,161889,161892,161894,3,5,0
46210,4,3,161893,161894,161897,1,4,0
46211,5,2,161898,161898,161900,0,2,1
46212,3,1,161901,161901,161902,0,1,1
46213,2,2,161903,161903,161905,0,2,1
46214,5,1,161908,161908,161909,0,1,3
46215,1,2,161909,161909,161911,0,2,0
46216,2,2,161911,161911,161913,0,2,0
46217,4,2,161915,161915,161917,0,2,2
46218,2,2,161917,161917,161919,0,2,0
46219,2,1,161919,161919,161920,0,1,0
46220,6,1,161925,161925,161926,0,1,5
46221,3,2,161928,161928,161930,0,2,2
46222,5,3,161933,161933,161936,0,3,3
46223,4,1,161937,161937,161938,0,1,1
46224,4,3,161941,161941,161944,0,3,3
46225,3,1,161944,161944,161945,0,1,0
46226,5,2,161949,161949,161951,0,2,4
46227,2,3,161951,161951,161954,0,3,0
46228,5,3,161956,161956,161959,0,3,2
46229,6,3,161962,161962,161965,0,3,3
46230,6,2,161968,161968,161970,0,2,3
46231,3,2,161971,161971,161973,0,2,1
46232,4,3,161975,161975,161978,0,3,2
46233,4,3,161979,161979,161982,0,3,1
46234,6,3,161985,161985,161988,0,3,3
46235,1,2,161986,161988,161990,2,4,0
46236,6,3,161992,161992,161995,0,3,2
46237,6,1,161998,161998,161999,0,1,3
46238,1,1,161999,161999,162000,0,1,0
46239,6,1,162005,162005,162006,0,1,5
46240,5,1,162010,162010,162011,0,1,4
46241,4,3,162014,162014,162017,0,3,3
46242,4,2,162018,162018,162020,0,2,1
46243,4,1,162022,162022,162023,0,1,2
46244,4,2,162026,162026,162028,0,2,3
46245,3,1,162029,162029,162030,0,1,1
46246,2,2,162031,162031,162033,0,2,1
46247,4,2,162035,162035,162037,0,2,2
46248,3,1,162038,162038,162039,0,1,1
46249,5,2,162043,162043,162045,0,2,4
46250,5,2,162048,162048,162050,0,2,3
46251,1,1,162049,162050,162051,1,2,0
46252,2,2,162051,162051,162053,0,2,0
46253,5,2,162056,162056,162058,0,2,3
46254,5,3,162061,162061,162064,0,3,3
46255,4,2,162065,162065,162067,0,2,1
46256,2,2,162067,162067,162069,0,2,0
46257,1,3,162068,162069,162072,1,4,0
46258,1,1,162069,162072,162073,3,4,0
46259,6,2,162075,162075,162077,0,2,2
46260,6,3,162081,162081,162084,0,3,4
46261,2,3,162083,162084,162087,1,4,0
46262,1,2,162084,162087,162089,3,5,0
46263,2,2,162086,162089,162091,3,5,0
46264,3,1,162089,162091,162092,2,3,0
46265,5,2,162094,162094,162096,0,2,2
46266,5,2,162099,162099,162101,0,2,3
46267,4,2,162103,162103,162105,0,2,2
46268,2,2,162105,162105,162107,0,2,0
46269,5,2,162110,162110,162112,0,2,3
46270,1,1,162111,162112,162113,1,2,0
46271,3,1,162114,162114,162115,0,1,1
46272,3,2,162117,162117,162119,0,2,2
46273,2,1,162119,162119,162120,0,1,0
46274,5,3,162124,162124,162127,0,3,4
46275,3,2,162127,162127,162129,0,2,0
46276,3,2,162130,162130,162132,0,2,1
46277,3,1,162133,162133,162134,0,1,1
46278,2,2,162135,162135,162137,0,2,1
46279,5,1,162140,162140,162141,0,1,3
46280,2,3,162142,162142,162145,0,3,1
46281,4,2,162146,162146,162148,0,2,1
46282,3,1,162149,162149,162150,0,1,1
46283,1,3,162150,162150,162153,0,3,0
46284,3,1,162153,162153,162154,0,1,0
46285,1,3,162154,162154,162157,0,3,0
46286,1,2,162155,162157,162159,2,4,0
46287,4,3,162159,162159,162162,0,3,0
46288,1,3,162160,162162,162165,2,5,0
46289,4,1,162164,162165,162166,1,2,0
46290,3,3,162167,162167,162170,0,3,1
46291,6,2,162173,162173,162175,0,2,3
46292,3,2,162176,162176,162178,0,2,1
46293,5,3,162181,162181,162184,0,3,3
46294,2,3,162183,162184,162187,1,4,0
46295,4,2,162187,162187,162189,0,2,0
46296,5,2,162192,162192,162194,0,2,3
46297,6,2,162198,162198,162200,0,2,4
46298,4,2,162202,162202,162204,0,2,2
46299,4,2,162206,162206,162208,0,2,2
46300,5,1,162211,162211,162212,0,1,3
46301,3,1,162214,162214,162215,0,1,2
46302,1,2,162215,162215,162217,0,2,0
46303,1,3,162216,162217,162220,1,4,0
46304,6,1,162222,162222,162223,0,1,2
46305,1,1,162223,162223,162224,0,1,0
46306,4,2,162227,162227,162229,0,2,3
46307,3,1,162230,162230,162231,0,1,1
46308,1,2,162231,162231,162233,0,2,0
46309,2,3,162233,162233,162236,0,3,0
46310,3,1,162236,162236,162237,0,1,0
46311,2,2,162238,162238,162240,0,2,1
46312,1,1,162239,162240,162241,1,2,0
46313,3,3,162242,162242,162245,0,3,1
46314,5,2,162247,162247,162249,0,2,2
46315,2,1,162249,162249,162250,0,1,0
46316,2,3,162251,162251,162254,0,3,1
46317,1,3,162252,162254,162257,2,5,0
46318,6,1,162258,162258,162259,0,1,1
46319,2,1,162260,162260,162261,0,1,1
46320,2,3,162262,162262,162265,0,3,1
46321,6,3,162268,162268,162271,0,3,3
46322,2,3,162270,162271,162274,1,4,0
46323,5,2,162275,162275,162277,0,2,1
46324,4,1,162279,162279,162280,0,1,2
46325,3,2,162282,162282,162284,0,2,2
46326,4,2,162286,162286,162288,0,2,2
46327,4,1,162290,162290,162291,0,1,2
46328,4,1,162294,162294,162295,0,1,3
46329,3,3,162297,162297,162300,0,3,2
46330,2,1,162299,162300,162301,1,2,0
46331,3,1,162302,162302,162303,0,1,1
46332,5,1,162307,162307,162308,0,1,4
46333,5,1,162312,162312,162313,0,1,4
46334,4,1,162316,162316,162317,0,1,3
46335,2,2,162318,162318,162320,0,2,1
46336,3,2,162321,162321,162323,0,2,1
46337,4,1,162325,162325,162326,0,1,2
46338,6,2,162331,162331,162333,0,2,5
46339,4,2,162335,162335,162337,0,2,2
46340,2,1,162337,162337,162338,0,1,0
46341,4,1,162341,162341,162342,0,1,3
46342,5,3,162346,162346,162349,0,3,4
46343,1,2,162347,162349,162351,2,4,0
46344,3,3,162350,162351,162354,1,4,0
46345,5,3,162355,162355,162358,0,3,1
46346,4,2,162359,162359,162361,0,2,1
46347,5,3,162364,162364,162367,0,3,3
46348,3,3,162367,162367,162370,0,3,0
46349,4,2,162371,162371,162373,0,2,1
46350,1,2,162372,162373,162375,1,3,0
46351,1,2,162373,162375,162377,2,4,0
46352,1,3,162374,162377,162380,3,6,0
46353,6,2,162380,162380,162382,0,2,0
46354,5,2,162385,162385,162387,0,2,3
46355,5,1,162390,162390,162391,0,1,3
46356,4,2,162394,162394,162396,0,2,3
46357,4,2,162398,162398,162400,0,2,2
46358,6,3,162404,162404,162407,0,3,4
46359,4,2,162408,162408,162410,0,2,1
46360,4,1,162412,162412,162413,0,1,2
46361,1,3,162413,162413,162416,0,3,0
46362,5,2,162418,162418,162420,0,2,2
46363,1,3,162419,162420,162423,1,4,0
46364,2,3,162421,162423,162426,2,5,0
46365,1,2,162422,162426,162428,4,6,0
46366,2,2,162424,162428,162430,4,6,0
46367,6,3,162430,162430,162433,0,3,0
46368,3,2,162433,162433,162435,0,2,0
46369,6,3,162439,162439,162442,0,3,4
46370,1,2,162440,162442,162444,2,4,0
46371,4,2,162444,162444,162446,0,2,0
46372,1,1,162445,162446,162447,1,2,0
46373,2,3,162447,162447,162450,0,3,0
46374,3,2,162450,162450,162452,0,2,0
46375,2,3,162452,162452,162455,0,3,0
46376,1,1,162453,162455,162456,2,3,0
46377,3,1,162456,162456,162457,0,1,0
46378,2,1,162458,162458,162459,0,1,1
46379,4,1,162462,162462,162463,0,1,3
46380,5,2,162467,162467,162469,0,2,4
46381,6,3,162473,162473,162476,0,3,4
46382,3,3,162476,162476,162479,0,3,0
46383,2,1,162478,162479,162480,1,2,0
46384,5,3,162483,162483,162486,0,3,3
46385,6,1,162489,162489,162490,0,1,3
46386,1,3,162490,162490,162493,0,3,0
46387,1,2,162491,162493,162495,2,4,0
46388,5,1,162496,162496,162497,0,1,1
46389,2,3,162498,162498,162501,0,3,1
46390,6,1,162504,162504,162505,0,1,3
46391,1,2,162505,162505,162507,0,2,0
46392,6,3,162511,162511,162514,0,3,4
46393,4,3,162515,162515,162518,0,3,1
46394,4,3,162519,162519,162522,0,3,1
46395,1,2,162520,162522,162524,2,4,0
46396,3,2,162523,162524,162526,1,3,0
46397,6,3,162529,162529,162532,0,3,3
46398,3,2,162532,162532,162534,0,2,0
46399,4,1,162536,162536,162537,0,1,2
46400,6,1,162542,162542,162543,0,1,5
46401,4,3,162546,162546,162549,0,3,3
46402,6,1,162552,162552,162553,0,1,3
46403,3,3,162555,162555,162558,0,3,2
46404,3,2,162558,162558,162560,0,2,0
46405,4,3,162562,162562,162565,0,3,2
46406,1,3,162563,162565,162568,2,5,0
46407,4,2,162567,162568,162570,1,3,0
46408,4,1,162571,162571,162572,0,1,1
46409,6,2,162577,162577,162579,0,2,5
46410,1,2,162578,162579,162581,1,3,0
46411,6,2,162584,162584,162586,0,2,3
46412,5,3,162589,162589,162592,0,3,3
46413,2,2,162591,162592,162594,1,3,0
46414,6,2,162597,162597,162599,0,2,3
46415,4,1,162601,162601,162602,0,1,2
46416,4,2,162605,162605,162607,0,2,3
46417,6,2,162611,162611,162613,0,2,4
46418,4,2,162615,162615,162617,0,2,2
46419,3,3,162618,162618,162621,0,3,1
46420,3,1,162621,162621,162622,0,1,0
46421,1,1,162622,162622,162623,0,1,0
46422,1,3,162623,162623,162626,0,3,0
46423,4,1,162627,162627,162628,0,1,1
46424,3,2,162630,162630,162632,0,2,2
46425,3,1,162633,162633,162634,0,1,1
46426,3,3,162636,162636,162639,0,3,2
46427,6,3,162642,162642,162645,0,3,3
46428,5,3,162647,162647,162650,0,3,2
46429,2,2,162649,162650,162652,1,3,0
46430,6,1,162655,162655,162656,0,1,3
46431,1,3,162656,162656,162659,0,3,0
46432,2,2,162658,162659,162661,1,3,0
46433,4,2,162662,162662,162664,0,2,1
46434,2,3,162664,162664,162667,0,3,0
46435,4,1,162668,162668,162669,0,1,1
46436,2,3,162670,162670,162673,0,3,1
46437,5,3,162675,162675,162678,0,3,2
46438,2,2,162677,162678,162680,1,3,0
46439,1,3,162678,162680,162683,2,5,0
46440,3,2,162681,162683,162685,2,4,0
46441,6,3,162687,162687,162690,0,3,2
46442,2,2,162689,162690,162692,1,3,0
46443,6,2,162695,162695,162697,0,2,3
46444,6,3,162701,162701,162704,0,3,4
46445,2,3,162703,162704,162707,1,4,0
46446,5,2,162708,162708,162710,0,2,1
46447,3,1,162711,162711,162712,0,1,1
46448,4,2,162715,162715,162717,0,2,3
46449,3,3,162718,162718,162721,0,3,1
46450,4,3,162722,162722,162725,0,3,1
46451,4,3,162726,162726,162729,0,3,1
46452,3,3,162729,162729,162732,0,3,0
46453,1,2,162730,162732,162734,2,4,0
46454,4,3,162734,162734,162737,0,3,0
46455,6,3,162740,162740,162743,0,3,3
46456,2,1,162742,162743,162744,1,2,0
46457,6,1,162748,162748,162749,0,1,4
46458,4,3,162752,162752,162755,0,3,3
46459,4,3,162756,162756,162759,0,3,1
46460,2,1,162758,162759,162760,1,2,0
46461,1,1,162759,162760,162761,1,2,0
46462,2,1,162761,162761,162762,0,1,0
46463,5,2,162766,162766,162768,0,2,4
46464,3,2,162769,162769,162771,0,2,1
46465,5,1,162774,162774,162775,0,1,3
46466,5,1,162779,162779,162780,0,1,4
46467,1,2,162780,162780,162782,0,2,0
46468,1,1,162781,162782,162783,1,2,0
46469,2,3,162783,162783,162786,0,3,0
46470,5,3,162788,162788,162791,0,3,2
46471,4,1,162792,162792,162793,0,1,1
46472,3,1,162795,162795,162796,0,1,2
46473,5,1,162800,162800,162801,0,1,4
46474,4,2,162804,162804,162806,0,2,3
46475,5,3,162809,162809,162812,0,3,3
46476,1,2,162810,162812,162814,2,4,0
46477,3,1,162813,162814,162815,1,2,0
46478,2,3,162815,162815,162818,0,3,0
46479,5,2,162820,162820,162822,0,2,2
46480,5,1,162825,162825,162826,0,1,3
46481,3,1,162828,162828,162829,0,1,2
46482,5,1,162833,162833,162834,0,1,4
46483,4,2,162837,162837,162839,0,2,3
46484,6,2,162843,162843,162845,0,2,4
46485,3,1,162846,162846,162847,0,1,1
46486,1,3,162847,162847,162850,0,3,0
46487,1,1,162848,162850,162851,2,3,0
46488,2,1,162850,162851,162852,1,2,0
46489,1,2,162851,162852,162854,1,3,0
46490,4,3,162855,162855,162858,0,3,1
46491,5,2,162860,162860,162862,0,2,2
46492,5,2,162865,162865,162867,0,2,3
46493,2,3,162867,162867,162870,0,3,0
46494,6,2,162873,162873,162875,0,2,3
46495,1,2,162874,162875,162877,1,3,0
46496,4,1,162878,162878,162879,0,1,1
46497,1,2,162879,162879,162881,0,2,0
46498,2,3,162881,162881,162884,0,3,0
46499,2,2,162883,162884,162886,1,3,0
46500,5,2,162888,162888,162890,0,2,2
46501,6,3,162894,162894,162897,0,3,4
46502,4,1,162898,162898,162899,0,1,1
46503,4,2,162902,162902,162904,0,2,3
46504,5,1,162907,162907,162908,0,1,3
46505,5,1,162912,162912,162913,0,1,4
46506,6,2,162918,162918,162920,0,2,5
46507,6,3,162924,162924,162927,0,3,4
46508,1,1,162925,162927,162928,2,3,0
46509,1,3,162926,162928,162931,2,5,0
46510,6,2,162932,162932,162934,0,2,1
46511,2,2,162934,162934,162936,0,2,0
46512,6,3,162940,162940,162943,0,3,4
46513,2,3,162942,162943,162946,1,4,0
46514,1,1,162943,162946,162947,3,4,0
46515,1,2,162944,162947,162949,3,5,0
46516,4,2,162948,162949,162951,1,3,0
46517,5,1,162953,162953,162954,0,1,2
46518,3,3,162956,162956,162959,0,3,2
46519,3,2,162959,162959,162961,0,2,0
46520,3,1,162962,162962,162963,0,1,1
46521,3,2,162965,162965,162967,0,2,2
46522,1,2,162966,162967,162969,1,3,0
46523,6,1,162972,162972,162973,0,1,3
46524,6,3,162978,162978,162981,0,3,5
46525,1,1,162979,162981,162982,2,3,0
46526,3,3,162982,162982,162985,0,3,0
46527,6,2,162988,162988,162990,0,2,3
46528,4,3,162992,162992,162995,0,3,2
46529,5,2,162997,162997,162999,0,2,2
46530,2,2,162999,162999,163001,0,2,0
46531,4,3,163003,163003,163006,0,3,2
46532,6,1,163009,163009,163010,0,1,3
46533,5,3,163014,163014,163017,0,3,4
46534,5,2,163019,163019,163021,0,2,2
46535,3,2,163022,163022,163024,0,2,1
46536,5,2,163027,163027,163029,0,2,3
46537,2,1,163029,163029,163030,0,1,0
46538,5,3,163034,163034,163037,0,3,4
46539,5,1,163039,163039,163040,0,1,2
46540,1,2,163040,163040,163042,0,2,0
46541,2,2,163042,163042,163044,0,2,0
46542,1,2,163043,163044,163046,1,3,0
46543,3,3,163046,163046,163049,0,3,0
46544,4,2,163050,163050,163052,0,2,1
46545,4,3,163054,163054,163057,0,3,2
46546,3,1,163057,163057,163058,0,1,0
46547,1,1,163058,163058,163059,0,1,0
46548,6,3,163064,163064,163067,0,3,5
46549,4,2,163068,163068,163070,0,2,1
46550,4,3,163072,163072,163075,0,3,2
46551,2,3,163074,163075,163078,1,4,0
46552,1,3,163075,163078,163081,3,6,0
46553,5,2,163080,163081,163083,1,3,0
46554,4,1,163084,163084,163085,0,1,1
46555,3,1,163087,163087,163088,0,1,2
46556,5,1,163092,163092,163093,0,1,4
46557,2,1,163094,163094,163095,0,1,1
46558,3,1,163097,163097,163098,0,1,2
46559,2,2,163099,163099,163101,0,2,1
46560,4,3,163103,163103,163106,0,3,2
46561,5,3,163108,163108,163111,0,3,2
46562,6,1,163114,163114,163115,0,1,3
46563,3,1,163117,163117,163118,0,1,2
46564,1,2,163118,163118,163120,0,2,0
46565,4,3,163122,163122,163125,0,3,2
46566,5,3,163127,163127,163130,0,3,2
46567,5,3,163132,163132,163135,0,3,2
46568,6,1,163138,163138,163139,0,1,3
46569,5,3,163143,163143,163146,0,3,4
46570,2,2,163145,163146,163148,1,3,0
46571,2,2,163147,163148,163150,1,3,0
46572,6,1,163153,163153,163154,0,1,3
46573,2,2,163155,163155,163157,0,2,1
46574,1,1,163156,163157,163158,1,2,0
46575,1,2,163157,163158,163160,1,3,0
46576,3,3,163160,163160,163163,0,3,0
46577,1,3,163161,163163,163166,2,5,0
46578,6,1,163167,163167,163168,0,1,1
46579,5,3,163172,163172,163175,0,3,4
46580,4,1,163176,163176,163177,0,1,1
46581,6,2,163182,163182,163184,0,2,5
46582,6,2,163188,163188,163190,0,2,4
46583,3,1,163191,163191,163192,0,1,1
46584,2,1,163193,163193,163194,0,1,1
46585,5,3,163198,163198,163201,0,3,4
46586,1,3,163199,163201,163204,2,5,0
46587,2,2,163201,163204,163206,3,5,0
46588,2,1,163203,163206,163207,3,4,0
46589,1,1,163204,163207,163208,3,4,0
46590,6,2,163210,163210,163212,0,2,2
46591,3,1,163213,163213,163214,0,1,1
46592,2,3,163215,163215,163218,0,3,1
46593,6,2,163221,163221,163223,0,2,3
46594,1,2,163222,163223,163225,1,3,0
46595,5,3,163227,163227,163230,0,3,2
46596,1,2,163228,163230,163232,2,4,0
46597,4,2,163232,163232,163234,0,2,0
46598,2,3,163234,163234,163237,0,3,0
46599,3,3,163237,163237,163240,0,3,0
46600,4,3,163241,163241,163244,0,3,1
46601,1,2,163242,163244,163246,2,4,0
46602,3,1,163245,163246,163247,1,2,0
46603,2,3,163247,163247,163250,0,3,0
46604,1,3,163248,163250,163253,2,5,0
46605,4,3,163252,163253,163256,1,4,0
46606,4,1,163256,163256,163257,0,1,0
46607,2,3,163258,163258,163261,0,3,1
46608,1,1,163259,163261,163262,2,3,0
46609,6,2,163265,163265,163267,0,2,3
46610,3,3,163268,163268,163271,0,3,1
46611,5,3,163273,163273,163276,0,3,2
46612,1,3,163274,163276,163279,2,5,0
46613,3,1,163277,163279,163280,2,3,0
46614,5,1,163282,163282,163283,0,1,2
46615,3,2,163285,163285,163287,0,2,2
46616,3,1,163288,163288,163289,0,1,1
46617,3,3,163291,163291,163294,0,3,2
46618,3,2,163294,163294,163296,0,2,0
46619,5,1,163299,163299,163300,0,1,3
46620,6,1,163305,163305,163306,0,1,5
46621,5,1,163310,163310,163311,0,1,4
46622,6,3,163316,163316,163319,0,3,5
46623,3,1,163319,163319,163320,0,1,0
46624,1,2,163320,163320,163322,0,2,0
46625,4,1,163324,163324,163325,0,1,2
46626,3,3,163327,163327,163330,0,3,2
46627,3,1,163330,163330,163331,0,1,0
46628,4,1,163334,163334,163335,0,1,3
46629,1,2,163335,163335,163337,0,2,0
46630,5,2,163340,163340,163342,0,2,3
46631,6,2,163346,163346,163348,0,2,4
46632,3,2,163349,163349,163351,0,2,1
46633,1,1,163350,163351,163352,1,2,0
46634,1,2,163351,163352,163354,1,3,0
46635,3,2,163354,163354,163356,0,2,0
46636,5,2,163359,163359,163361,0,2,3
46637,6,3,163365,163365,163368,0,3,4
46638,3,2,163368,163368,163370,0,2,0
46639,2,2,163370,163370,163372,0,2,0
46640,6,3,163376,163376,163379,0,3,4
46641,6,2,163382,163382,163384,0,2,3
46642,3,1,163385,163385,163386,0,1,1
46643,6,2,163391,163391,163393,0,2,5
46644,6,2,163397,163397,163399,0,2,4
46645,5,2,163402,163402,163404,0,2,3
46646,5,2,163407,163407,163409,0,2,3
46647,2,1,163409,163409,163410,0,1,0
46648,3,3,163412,163412,163415,0,3,2
46649,6,1,163418,163418,163419,0,1,3
46650,5,3,163423,163423,163426,0,3,4
46651,3,1,163426,163426,163427,0,1,0
46652,2,1,163428,163428,163429,0,1,1
46653,4,1,163432,163432,163433,0,1,3
46654,4,1,163436,163436,163437,0,1,3
46655,2,1,163438,163438,163439,0,1,1
46656,5,1,163443,163443,163444,0,1,4
46657,5,2,163448,163448,163450,0,2,4
46658,2,3,163450,163450,163453,0,3,0
46659,4,2,163454,163454,163456,0,2,1
46660,2,3,163456,163456,163459,0,3,0
46661,4,3,163460,163460,163463,0,3,1
46662,2,3,163462,163463,163466,1,4,0
46663,4,2,163466,163466,163468,0,2,0
46664,4,1,163470,163470,163471,0,1,2
46665,6,1,163476,163476,163477,0,1,5
46666,3,2,163479,163479,163481,0,2,2
46667,5,2,163484,163484,163486,0,2,3
46668,5,3,163489,163489,163492,0,3,3
46669,5,3,163494,163494,163497,0,3,2
46670,1,2,163495,163497,163499,2,4,0
46671,5,2,163500,163500,163502,0,2,1
46672,3,2,163503,163503,163505,0,2,1
46673,6,1,163509,163509,163510,0,1,4
46674,5,3,163514,163514,163517,0,3,4
46675,1,3,163515,163517,163520,2,5,0
46676,5,2,163520,163520,163522,0,2,0
46677,5,1,163525,163525,163526,0,1,3
46678,6,2,163531,163531,163533,0,2,5
46679,1,2,163532,163533,163535,1,3,0
46680,1,2,163533,163535,163537,2,4,0
46681,4,3,163537,163537,163540,0,3,0
46682,4,3,163541,163541,163544,0,3,1
46683,3,3,163544,163544,163547,0,3,0
46684,2,1,163546,163547,163548,1,2,0
46685,2,3,163548,163548,163551,0,3,0
46686,6,1,163554,163554,163555,0,1,3
46687,2,1,163556,163556,163557,0,1,1
46688,1,3,163557,163557,163560,0,3,0
46689,1,1,163558,163560,163561,2,3,0
46690,6,3,163564,163564,163567,0,3,3
46691,5,3,163569,163569,163572,0,3,2
46692,3,2,163572,163572,163574,0,2,0
46693,4,3,163576,163576,163579,0,3,2
46694,1,3,163577,163579,163582,2,5,0
46695,3,1,163580,163582,163583,2,3,0
46696,4,2,163584,163584,163586,0,2,1
46697,2,3,163586,163586,163589,0,3,0
46698,3,1,163589,163589,163590,0,1,0
46699,3,2,163592,163592,163594,0,2,2
46700,1,1,163593,163594,163595,1,2,0
46701,1,1,163594,163595,163596,1,2,0
46702,6,3,163600,163600,163603,0,3,4
46703,6,1,163606,163606,163607,0,1,3
46704,6,3,163612,163612,163615,0,3,5
46705,5,1,163617,163617,163618,0,1,2
46706,3,3,163620,163620,163623,0,3,2
46707,4,3,163624,163624,163627,0,3,1
46708,4,2,163628,163628,163630,0,2,1
46709,3,3,163631,163631,163634,0,3,1
46710,4,1,163635,163635,163636,0,1,1
46711,2,2,163637,163637,163639,0,2,1
46712,6,3,163643,163643,163646,0,3,4
46713,5,3,163648,163648,163651,0,3,2
46714,3,2,163651,163651,163653,0,2,0
46715,3,3,163654,163654,163657,0,3,1
46716,2,2,163656,163657,163659,1,3,0
46717,3,3,163659,163659,163662,0,3,0
46718,3,1,163662,163662,163663,0,1,0
46719,3,3,163665,163665,163668,0,3,2
46720,5,2,163670,163670,163672,0,2,2
46721,4,3,163674,163674,163677,0,3,2
46722,2,3,163676,163677,163680,1,4,0
46723,2,3,163678,163680,163683,2,5,0
46724,6,1,163684,163684,163685,0,1,1
46725,3,1,163687,163687,163688,0,1,2
46726,6,1,163693,163693,163694,0,1,5
46727,5,2,163698,163698,163700,0,2,4
46728,2,2,163700,163700,163702,0,2,0
46729,6,3,163706,163706,163709,0,3,4
46730,4,1,163710,163710,163711,0,1,1
46731,1,3,163711,163711,163714,0,3,0
46732,6,2,163717,163717,163719,0,2,3
46733,6,3,163723,163723,163726,0,3,4
46734,2,1,163725,163726,163727,1,2,0
46735,3,1,163728,163728,163729,0,1,1
46736,2,3,163730,163730,163733,0,3,1
46737,3,3,163733,163733,163736,0,3,0
46738,2,2,163735,163736,163738,1,3,0
46739,3,1,163738,163738,163739,0,1,0
46740,4,2,163742,163742,163744,0,2,3
46741,5,2,163747,163747,163749,0,2,3
46742,1,1,163748,163749,163750,1,2,0
46743,6,2,163754,163754,163756,0,2,4
46744,2,3,163756,163756,163759,0,3,0
46745,3,3,163759,163759,163762,0,3,0
46746,4,3,163763,163763,163766,0,3,1
46747,1,3,163764,163766,163769,2,5,0
46748,3,1,163767,163769,163770,2,3,0
46749,1,3,163768,163770,163773,2,5,0
46750,3,1,163771,163773,163774,2,3,0
46751,4,3,163775,163775,163778,0,3,1
46752,5,3,163780,163780,163783,0,3,2
46753,2,3,163782,163783,163786,1,4,0
46754,5,1,163787,163787,163788,0,1,1
46755,5,2,163792,163792,163794,0,2,4
46756,3,2,163795,163795,163797,0,2,1
46757,3,3,163798,163798,163801,0,3,1
46758,1,3,163799,163801,163804,2,5,0
46759,4,3,163803,163804,163807,1,4,0
46760,4,3,163807,163807,163810,0,3,0
46761,3,1,163810,163810,163811,0,1,0
46762,1,3,163811,163811,163814,0,3,0
46763,6,1,163817,163817,163818,0,1,3
46764,5,2,163822,163822,163824,0,2,4
46765,3,3,163825,163825,163828,0,3,1
46766,5,1,163830,163830,163831,0,1,2
46767,2,3,163832,163832,163835,0,3,1
46768,5,1,163837,163837,163838,0,1,2
46769,1,1,163838,163838,163839,0,1,0
46770,3,2,163841,163841,163843,0,2,2
46771,1,3,163842,163843,163846,1,4,0
46772,4,2,163846,163846,163848,0,2,0
46773,1,3,163847,163848,163851,1,4,0
46774,4,3,163851,163851,163854,0,3,0
46775,3,3,163854,163854,163857,0,3,0
46776,4,1,163858,163858,163859,0,1,1
46777,4,3,163862,163862,163865,0,3,3
46778,3,1,163865,163865,163866,0,1,0
46779,3,2,163868,163868,163870,0,2,2
46780,3,2,163871,163871,163873,0,2,1
46781,5,3,163876,163876,163879,0,3,3
46782,4,2,163880,163880,163882,0,2,1
46783,6,2,163886,163886,163888,0,2,4
46784,2,3,163888,163888,163891,0,3,0
46785,6,3,163894,163894,163897,0,3,3
46786,3,3,163897,163897,163900,0,3,0
46787,2,2,163899,163900,163902,1,3,0
46788,3,3,163902,163902,163905,0,3,0
46789,1,2,163903,163905,163907,2,4,0
46790,3,1,163906,163907,163908,1,2,0
46791,1,3,163907,163908,163911,1,4,0
46792,3,3,163910,163911,163914,1,4,0
46793,2,2,163912,163914,163916,2,4,0
46794,1,3,163913,163916,163919,3,6,0
46795,1,3,163914,163919,163922,5,8,0
46796,1,1,163915,163922,163923,7,8,0
46797,1,3,163916,163923,163926,7,10,0
46798,2,1,163918,163926,163927,8,9,0
46799,6,1,163924,163927,163928,3,4,0
46800,5,3,163929,163929,163932,0,3,1
46801,6,3,163935,163935,163938,0,3,3
46802,2,1,163937,163938,163939,1,2,0
46803,3,1,163940,163940,163941,0,1,1
46804,6,1,163946,163946,163947,0,1,5
46805,6,2,163952,163952,163954,0,2,5
46806,6,1,163958,163958,163959,0,1,4
46807,3,3,163961,163961,163964,0,3,2
46808,5,1,163966,163966,163967,0,1,2
46809,4,1,163970,163970,163971,0,1,3
46810,5,2,163975,163975,163977,0,2,4
46811,5,1,163980,163980,163981,0,1,3
46812,4,1,163984,163984,163985,0,1,3
46813,5,2,163989,163989,163991,0,2,4
46814,2,1,163991,163991,163992,0,1,0
46815,4,2,163995,163995,163997,0,2,3
46816,4,1,163999,163999,164000,0,1,2
46817,1,1,164000,164000,164001,0,1,0
46818,1,3,164001,164001,164004,0,3,0
46819,4,1,164005,164005,164006,0,1,1
46820,3,3,164008,164008,164011,0,3,2
46821,5,3,164013,164013,164016,0,3,2
46822,3,1,164016,164016,164017,0,1,0
46823,1,1,164017,164017,164018,0,1,0
46824,3,3,164020,164020,164023,0,3,2
46825,5,1,164025,164025,164026,0,1,2
46826,1,1,164026,164026,164027,0,1,0
46827,2,2,164028,164028,164030,0,2,1
46828,4,1,164032,164032,164033,0,1,2
46829,2,2,164034,164034,164036,0,2,1
46830,1,1,164035,164036,164037,1,2,0
46831,4,2,164039,164039,164041,0,2,2
46832,2,1,164041,164041,164042,0,1,0
46833,4,3,164045,164045,164048,0,3,3
46834,5,2,164050,164050,164052,0,2,2
46835,4,1,164054,164054,164055,0,1,2
46836,2,1,164056,164056,164057,0,1,1
46837,6,1,164062,164062,164063,0,1,5
46838,4,1,164066,164066,164067,0,1,3
46839,4,1,164070,164070,164071,0,1,3
46840,6,2,164076,164076,164078,0,2,5
46841,5,3,164081,164081,164084,0,3,3
46842,1,3,164082,164084,164087,2,5,0
46843,1,1,164083,164087,164088,4,5,0
46844,6,1,164089,164089,164090,0,1,1
46845,5,2,164094,164094,164096,0,2,4
46846,1,3,164095,164096,164099,1,4,0
46847,6,3,164101,164101,164104,0,3,2
46848,4,2,164105,164105,164107,0,2,1
46849,2,2,164107,164107,164109,0,2,0
46850,1,1,164108,164109,164110,1,2,0
46851,6,2,164114,164114,164116,0,2,4
46852,2,2,164116,164116,164118,0,2,0
46853,2,3,164118,164118,164121,0,3,0
46854,2,2,164120,164121,164123,1,3,0
46855,4,1,164124,164124,164125,0,1,1
46856,3,2,164127,164127,164129,0,2,2
46857,1,2,164128,164129,164131,1,3,0
46858,1,1,164129,164131,164132,2,3,0
46859,4,3,164133,164133,164136,0,3,1
46860,2,2,164135,164136,164138,1,3,0
46861,3,1,164138,164138,164139,0,1,0
46862,4,1,164142,164142,164143,0,1,3
46863,2,3,164144,164144,164147,0,3,1
46864,5,2,164149,164149,164151,0,2,2
46865,5,2,164154,164154,164156,0,2,3
46866,1,3,164155,164156,164159,1,4,0
46867,6,2,164161,164161,164163,0,2,2
46868,6,3,164167,164167,164170,0,3,4
46869,6,2,164173,164173,164175,0,2,3
46870,6,2,164179,164179,164181,0,2,4
46871,6,3,164185,164185,164188,0,3,4
46872,3,3,164188,164188,164191,0,3,0
46873,1,2,164189,164191,164193,2,4,0
46874,2,3,164191,164193,164196,2,5,0
46875,2,2,164193,164196,164198,3,5,0
46876,6,3,164199,164199,164202,0,3,1
46877,6,3,164205,164205,164208,0,3,3
46878,4,1,164209,164209,164210,0,1,1
46879,2,1,164211,164211,164212,0,1,1
46880,4,3,164215,164215,164218,0,3,3
46881,2,3,164217,164218,164221,1,4,0
46882,6,3,164223,164223,164226,0,3,2
46883,3,2,164226,164226,164228,0,2,0
46884,1,1,164227,164228,164229,1,2,0
46885,6,1,164233,164233,164234,0,1,4
46886,3,3,164236,164236,164239,0,3,2
46887,3,3,164239,164239,164242,0,3,0
46888,6,3,164245,164245,164248,0,3,3
46889,2,3,164247,164248,164251,1,4,0
46890,2,1,164249,164251,164252,2,3,0
46891,5,3,164254,164254,164257,0,3,2
46892,5,3,164259,164259,164262,0,3,2
46893,3,2,164262,164262,164264,0,2,0
46894,3,2,164265,164265,164267,0,2,1
46895,2,1,164267,164267,164268,0,1,0
46896,6,2,164273,164273,164275,0,2,5
46897,6,1,164279,164279,164280,0,1,4
46898,3,2,164282,164282,164284,0,2,2
46899,2,1,164284,164284,164285,0,1,0
46900,5,3,164289,164289,164292,0,3,4
46901,3,2,164292,164292,164294,0,2,0
46902,3,1,164295,164295,164296,0,1,1
46903,5,3,164300,164300,164303,0,3,4
46904,4,2,164304,164304,164306,0,2,1
46905,5,3,164309,164309,164312,0,3,3
46906,6,1,164315,164315,164316,0,1,3
46907,1,1,164316,164316,164317,0,1,0
46908,5,1,164321,164321,164322,0,1,4
46909,6,2,164327,164327,164329,0,2,5
46910,1,2,164328,164329,164331,1,3,0
46911,1,2,164329,164331,164333,2,4,0
46912,3,2,164332,164333,164335,1,3,0
46913,6,3,164338,164338,164341,0,3,3
46914,4,2,164342,164342,164344,0,2,1
46915,6,1,164348,164348,164349,0,1,4
46916,1,3,164349,164349,164352,0,3,0
46917,1,3,164350,164352,164355,2,5,0
46918,4,1,164354,164355,164356,1,2,0
46919,2,3,164356,164356,164359,0,3,0
46920,3,3,164359,164359,164362,0,3,0
46921,1,2,164360,164362,164364,2,4,0
46922,5,1,164365,164365,164366,0,1,1
46923,2,1,164367,164367,164368,0,1,1
46924,5,2,164372,164372,164374,0,2,4
46925,6,1,164378,164378,164379,0,1,4
46926,2,1,164380,164380,164381,0,1,1
46927,1,3,164381,164381,164384,0,3,0
46928,4,1,164385,164385,164386,0,1,1
46929,5,1,164390,164390,164391,0,1,4
46930,6,2,164396,164396,164398,0,2,5
46931,6,3,164402,164402,164405,0,3,4
46932,5,3,164407,164407,164410,0,3,2
46933,1,2,164408,164410,164412,2,4,0
46934,2,2,164410,164412,164414,2,4,0
46935,3,2,164413,164414,164416,1,3,0
46936,4,1,164417,164417,164418,0,1,1
46937,4,1,164421,164421,164422,0,1,3
46938,6,1,164427,164427,164428,0,1,5
46939,4,1,164431,164431,164432,0,1,3
46940,5,3,164436,164436,164439,0,3,4
46941,1,2,164437,164439,164441,2,4,0
46942,1,3,164438,164441,164444,3,6,0
46943,4,3,164442,164444,164447,2,5,0
46944,5,1,164447,164447,164448,0,1,0
46945,2,1,164449,164449,164450,0,1,1
46946,3,3,164452,164452,164455,0,3,2
46947,4,2,164456,164456,164458,0,2,1
46948,4,3,164460,164460,164463,0,3,2
46949,3,3,164463,164463,164466,0,3,0
46950,5,3,164468,164468,164471,0,3,2
46951,2,2,164470,164471,164473,1,3,0
46952,5,3,164475,164475,164478,0,3,2
46953,6,2,164481,164481,164483,0,2,3
46954,1,2,164482,164483,164485,1,3,0
46955,4,2,164486,164486,164488,0,2,1
46956,2,3,164488,164488,164491,0,3,0
46957,4,1,164492,164492,164493,0,1,1
46958,4,2,164496,164496,164498,0,2,3
46959,1,3,164497,164498,164501,1,4,0
46960,1,3,164498,164501,164504,3,6,0
46961,4,3,164502,164504,164507,2,5,0
46962,2,1,164504,164507,164508,3,4,0
46963,4,1,164508,164508,164509,0,1,0
46964,3,3,164511,164511,164514,0,3,2
46965,6,1,164517,164517,164518,0,1,3
46966,2,1,164519,164519,164520,0,1,1
46967,2,3,164521,164521,164524,0,3,1
46968,3,2,164524,164524,164526,0,2,0
46969,3,2,164527,164527,164529,0,2,1
46970,6,2,164533,164533,164535,0,2,4
46971,6,2,164539,164539,164541,0,2,4
46972,1,1,164540,164541,164542,1,2,0
46973,6,3,164546,164546,164549,0,3,4
46974,3,3,164549,164549,164552,0,3,0
46975,4,2,164553,164553,164555,0,2,1
46976,4,2,164557,164557,164559,0,2,2
46977,6,1,164563,164563,164564,0,1,4
46978,4,1,164567,164567,164568,0,1,3
46979,5,2,164572,164572,164574,0,2,4
46980,3,3,164575,164575,164578,0,3,1
46981,6,1,164581,164581,164582,0,1,3
46982,5,3,164586,164586,164589,0,3,4
46983,2,3,164588,164589,164592,1,4,0
46984,6,1,164594,164594,164595,0,1,2
46985,5,1,164599,164599,164600,0,1,4
46986,2,1,164601,164601,164602,0,1,1
46987,4,2,164605,164605,164607,0,2,3
46988,3,3,164608,164608,164611,0,3,1
46989,5,2,164613,164613,164615,0,2,2
46990,1,3,164614,164615,164618,1,4,0
46991,2,3,164616,164618,164621,2,5,0
46992,3,2,164619,164621,164623,2,4,0
46993,3,2,164622,164623,164625,1,3,0
46994,6,2,164628,164628,164630,0,2,3
46995,6,3,164634,164634,164637,0,3,4
46996,1,3,164635,164637,164640,2,5,0
46997,1,2,164636,164640,164642,4,6,0
46998,2,3,164638,164642,164645,4,7,0
46999,5,2,164643,164645,164647,2,4,0
47000,5,3,164648,164648,164651,0,3,1
47001,3,3,164651,164651,164654,0,3,0
47002,3,3,164654,164654,164657,0,3,0
47003,5,1,164659,164659,164660,0,1,2
47004,5,2,164664,164664,164666,0,2,4
47005,2,2,164666,164666,164668,0,2,0
47006,3,1,164669,164669,164670,0,1,1
47007,6,2,164675,164675,164677,0,2,5
47008,1,1,164676,164677,164678,1,2,0
47009,6,2,164682,164682,164684,0,2,4
47010,3,2,164685,164685,164687,0,2,1
47011,1,2,164686,164687,164689,1,3,0
47012,1,3,164687,164689,164692,2,5,0
47013,5,3,164692,164692,164695,0,3,0
47014,3,3,164695,164695,164698,0,3,0
47015,1,1,164696,164698,164699,2,3,0
47016,1,2,164697,164699,164701,2,4,0
47017,5,3,164702,164702,164705,0,3,1
47018,2,3,164704,164705,164708,1,4,0
47019,2,2,164706,164708,164710,2,4,0
47020,3,1,164709,164710,164711,1,2,0
47021,4,2,164713,164713,164715,0,2,2
47022,1,2,164714,164715,164717,1,3,0
47023,2,1,164716,164717,164718,1,2,0
47024,1,3,164717,164718,164721,1,4,0
47025,1,2,164718,164721,164723,3,5,0
47026,4,3,164722,164723,164726,1,4,0
47027,2,3,164724,164726,164729,2,5,0
47028,6,1,164730,164730,164731,0,1,1
47029,5,3,164735,164735,164738,0,3,4
47030,4,1,164739,164739,164740,0,1,1
47031,5,2,164744,164744,164746,0,2,4
47032,3,1,164747,164747,164748,0,1,1
47033,6,1,164753,164753,164754,0,1,5
47034,3,3,164756,164756,164759,0,3,2
47035,6,2,164762,164762,164764,0,2,3
47036,3,1,164765,164765,164766,0,1,1
47037,4,2,164769,164769,164771,0,2,3
47038,3,2,164772,164772,164774,0,2,1
47039,4,2,164776,164776,164778,0,2,2
47040,6,1,164782,164782,164783,0,1,4
47041,5,3,164787,164787,164790,0,3,4
47042,3,2,164790,164790,164792,0,2,0
47043,3,1,164793,164793,164794,0,1,1
47044,4,1,164797,164797,164798,0,1,3
47045,5,1,164802,164802,164803,0,1,4
47046,5,1,164807,164807,164808,0,1,4
47047,2,2,164809,164809,164811,0,2,1
47048,2,1,164811,164811,164812,0,1,0
47049,4,3,164815,164815,164818,0,3,3
47050,2,3,164817,164818,164821,1,4,0
47051,2,3,164819,164821,164824,2,5,0
47052,5,1,164824,164824,164825,0,1,0
47053,5,1,164829,164829,164830,0,1,4
47054,5,1,164834,164834,164835,0,1,4
47055,5,3,164839,164839,164842,0,3,4
47056,4,1,164843,164843,164844,0,1,1
47057,2,1,164845,164845,164846,0,1,1
47058,2,2,164847,164847,164849,0,2,1
47059,3,2,164850,164850,164852,0,2,1
47060,5,1,164855,164855,164856,0,1,3
47061,5,2,164860,164860,164862,0,2,4
47062,5,2,164865,164865,164867,0,2,3
47063,5,1,164870,164870,164871,0,1,3
47064,5,2,164875,164875,164877,0,2,4
47065,5,3,164880,164880,164883,0,3,3
47066,2,3,164882,164883,164886,1,4,0
47067,2,2,164884,164886,164888,2,4,0
47068,4,1,164888,164888,164889,0,1,0
47069,5,1,164893,164893,164894,0,1,4
47070,2,2,164895,164895,164897,0,2,1
47071,5,2,164900,164900,164902,0,2,3
47072,5,3,164905,164905,164908,0,3,3
47073,4,1,164909,164909,164910,0,1,1
47074,6,2,164915,164915,164917,0,2,5
47075,6,3,164921,164921,164924,0,3,4
47076,3,2,164924,164924,164926,0,2,0
47077,1,3,164925,164926,164929,1,4,0
47078,3,1,164928,164929,164930,1,2,0
47079,5,3,164933,164933,164936,0,3,3
47080,1,3,164934,164936,164939,2,5,0
47081,5,2,164939,164939,164941,0,2,0
47082,2,1,164941,164941,164942,0,1,0
47083,2,3,164943,164943,164946,0,3,1
47084,4,2,164947,164947,164949,0,2,1
47085,5,2,164952,164952,164954,0,2,3
47086,2,3,164954,164954,164957,0,3,0
47087,3,2,164957,164957,164959,0,2,0
47088,6,2,164963,164963,164965,0,2,4
47089,2,2,164965,164965,164967,0,2,0
47090,3,2,164968,164968,164970,0,2,1
47091,4,2,164972,164972,164974,0,2,2
47092,5,1,164977,164977,164978,0,1,3
47093,1,3,164978,164978,164981,0,3,0
47094,4,1,164982,164982,164983,0,1,1
47095,5,1,164987,164987,164988,0,1,4
47096,5,1,164992,164992,164993,0,1,4
47097,5,1,164997,164997,164998,0,1,4
47098,2,3,164999,164999,165002,0,3,1
47099,6,2,165005,165005,165007,0,2,3
47100,4,1,165009,165009,165010,0,1,2
47101,5,1,165014,165014,165015,0,1,4
47102,2,3,165016,165016,165019,0,3,1
47103,6,1,165022,165022,165023,0,1,3
47104,5,1,165027,165027,165028,0,1,4
47105,6,1,165033,165033,165034,0,1,5
47106,6,3,165039,165039,165042,0,3,5
47107,2,2,165041,165042,165044,1,3,0
47108,3,2,165044,165044,165046,0,2,0
47109,2,1,165046,165046,165047,0,1,0
47110,5,3,165051,165051,165054,0,3,4
47111,1,1,165052,165054,165055,2,3,0
47112,5,2,165057,165057,165059,0,2,2
47113,3,2,165060,165060,165062,0,2,1
47114,5,3,165065,165065,165068,0,3,3
47115,1,1,165066,165068,165069,2,3,0
47116,6,3,165072,165072,165075,0,3,3
47117,5,3,165077,165077,165080,0,3,2
47118,5,2,165082,165082,165084,0,2,2
47119,2,3,165084,165084,165087,0,3,0
47120,3,1,165087,165087,165088,0,1,0
47121,2,3,165089,165089,165092,0,3,1
47122,6,1,165095,165095,165096,0,1,3
47123,1,1,165096,165096,165097,0,1,0
47124,6,3,165102,165102,165105,0,3,5
47125,2,1,165104,165105,165106,1,2,0
47126,1,2,165105,165106,165108,1,3,0
47127,4,1,165109,165109,165110,0,1,1
47128,3,1,165112,165112,165113,0,1,2
47129,6,3,165118,165118,165121,0,3,5
47130,5,2,165123,165123,165125,0,2,2
47131,1,2,165124,165125,165127,1,3,0
47132,6,1,165130,165130,165131,0,1,3
47133,6,2,165136,165136,165138,0,2,5
47134,2,1,165138,165138,165139,0,1,0
47135,1,3,165139,165139,165142,0,3,0
47136,4,3,165143,165143,165146,0,3,1
47137,6,1,165149,165149,165150,0,1,3
47138,6,1,165155,165155,165156,0,1,5
47139,5,1,165160,165160,165161,0,1,4
47140,6,3,165166,165166,165169,0,3,5
47141,3,1,165169,165169,165170,0,1,0
47142,6,3,165175,165175,165178,0,3,5
47143,6,2,165181,165181,165183,0,2,3
47144,1,1,165182,165183,165184,1,2,0
47145,1,3,165183,165184,165187,1,4,0
47146,5,2,165188,165188,165190,0,2,1
47147,5,2,165193,165193,165195,0,2,3
47148,5,3,165198,165198,165201,0,3,3
47149,1,1,165199,165201,165202,2,3,0
47150,6,2,165205,165205,165207,0,2,3
47151,5,2,165210,165210,165212,0,2,3
47152,4,3,165214,165214,165217,0,3,2
47153,5,2,165219,165219,165221,0,2,2
47154,6,3,165225,165225,165228,0,3,4
47155,5,2,165230,165230,165232,0,2,2
47156,6,2,165236,165236,165238,0,2,4
47157,4,3,165240,165240,165243,0,3,2
47158,6,1,165246,165246,165247,0,1,3
47159,6,1,165252,165252,165253,0,1,5
47160,4,1,165256,165256,165257,0,1,3
47161,4,3,165260,165260,165263,0,3,3
47162,2,2,165262,165263,165265,1,3,0
47163,3,1,165265,165265,165266,0,1,0
47164,5,3,165270,165270,165273,0,3,4
47165,3,1,165273,165273,165274,0,1,0
47166,5,1,165278,165278,165279,0,1,4
47167,6,2,165284,165284,165286,0,2,5
47168,5,3,165289,165289,165292,0,3,3
47169,5,2,165294,165294,165296,0,2,2
47170,2,2,165296,165296,165298,0,2,0
47171,3,2,165299,165299,165301,0,2,1
47172,3,2,165302,165302,165304,0,2,1
47173,2,1,165304,165304,165305,0,1,0
47174,3,3,165307,165307,165310,0,3,2
47175,1,1,165308,165310,165311,2,3,0
47176,3,2,165311,165311,165313,0,2,0
47177,1,3,165312,165313,165316,1,4,0
47178,3,3,165315,165316,165319,1,4,0
47179,4,2,165319,165319,165321,0,2,0
47180,4,1,165323,165323,165324,0,1,2
47181,3,2,165326,165326,165328,0,2,2
47182,3,3,165329,165329,165332,0,3,1
47183,5,2,165334,165334,165336,0,2,2
47184,4,2,165338,165338,165340,0,2,2
47185,1,3,165339,165340,165343,1,4,0
47186,1,2,165340,165343,165345,3,5,0
47187,1,3,165341,165345,165348,4,7,0
47188,6,3,165347,165348,165351,1,4,0
47189,5,1,165352,165352,165353,0,1,1
47190,5,2,165357,165357,165359,0,2,4
47191,5,3,165362,165362,165365,0,3,3
47192,5,2,165367,165367,165369,0,2,2
47193,3,2,165370,165370,165372,0,2,1
47194,2,3,165372,165372,165375,0,3,0
47195,6,2,165378,165378,165380,0,2,3
47196,6,2,165384,165384,165386,0,2,4
47197,4,2,165388,165388,165390,0,2,2
47198,4,2,165392,165392,165394,0,2,2
47199,4,2,165396,165396,165398,0,2,2
47200,5,2,165401,165401,165403,0,2,3
47201,6,3,165407,165407,165410,0,3,4
47202,6,2,165413,165413,165415,0,2,3
47203,5,3,165418,165418,165421,0,3,3
47204,4,1,165422,165422,165423,0,1,1
47205,2,3,165424,165424,165427,0,3,1
47206,3,3,165427,165427,165430,0,3,0
47207,1,1,165428,165430,165431,2,3,0
47208,5,1,165433,165433,165434,0,1,2
47209,2,3,165435,165435,165438,0,3,1
47210,3,3,165438,165438,165441,0,3,0
47211,3,3,165441,165441,165444,0,3,0
47212,3,1,165444,165444,165445,0,1,0
47213,6,3,165450,165450,165453,0,3,5
47214,1,1,165451,165453,165454,2,3,0
47215,1,3,165452,165454,165457,2,5,0
47216,2,3,165454,165457,165460,3,6,0
47217,3,3,165457,165460,165463,3,6,0
47218,6,1,165463,165463,165464,0,1,0
47219,3,1,165466,165466,165467,0,1,2
47220,2,3,165468,165468,165471,0,3,1
47221,4,1,165472,165472,165473,0,1,1
47222,1,2,165473,165473,165475,0,2,0
47223,3,3,165476,165476,165479,0,3,1
47224,2,3,165478,165479,165482,1,4,0
47225,6,2,165484,165484,165486,0,2,2
47226,3,2,165487,165487,165489,0,2,1
47227,1,1,165488,165489,165490,1,2,0
47228,2,2,165490,165490,165492,0,2,0
47229,3,2,165493,165493,165495,0,2,1
47230,4,1,165497,165497,165498,0,1,2
47231,4,2,165501,165501,165503,0,2,3
47232,6,2,165507,165507,165509,0,2,4
47233,6,3,165513,165513,165516,0,3,4
47234,5,1,165518,165518,165519,0,1,2
47235,5,2,165523,165523,165525,0,2,4
47236,6,3,165529,165529,165532,0,3,4
47237,4,1,165533,165533,165534,0,1,1
47238,3,1,165536,165536,165537,0,1,2
47239,4,1,165540,165540,165541,0,1,3
47240,4,1,165544,165544,165545,0,1,3
47241,6,3,165550,165550,165553,0,3,5
47242,3,3,165553,165553,165556,0,3,0
47243,6,1,165559,165559,165560,0,1,3
47244,6,3,165565,165565,165568,0,3,5
47245,6,3,165571,165571,165574,0,3,3
47246,1,1,165572,165574,165575,2,3,0
47247,3,3,165575,165575,165578,0,3,0
47248,5,3,165580,165580,165583,0,3,2
47249,5,3,165585,165585,165588,0,3,2
47250,5,2,165590,165590,165592,0,2,2
47251,1,1,165591,165592,165593,1,2,0
47252,4,1,165595,165595,165596,0,1,2
47253,3,3,165598,165598,165601,0,3,2
47254,2,2,165600,165601,165603,1,3,0
47255,2,1,165602,165603,165604,1,2,0
47256,5,1,165607,165607,165608,0,1,3
47257,5,1,165612,165612,165613,0,1,4
47258,6,3,165618,165618,165621,0,3,5
47259,3,1,165621,165621,165622,0,1,0
47260,1,2,165622,165622,165624,0,2,0
47261,1,2,165623,165624,165626,1,3,0
47262,2,3,165625,165626,165629,1,4,0
47263,1,1,165626,165629,165630,3,4,0
47264,6,3,165632,165632,165635,0,3,2
47265,2,1,165634,165635,165636,1,2,0
47266,2,1,165636,165636,165637,0,1,0
47267,5,1,165641,165641,165642,0,1,4
47268,5,3,165646,165646,165649,0,3,4
47269,3,1,165649,165649,165650,0,1,0
47270,3,3,165652,165652,165655,0,3,2
47271,2,3,165654,165655,165658,1,4,0
47272,1,1,165655,165658,165659,3,4,0
47273,5,1,165660,165660,165661,0,1,1
47274,3,2,165663,165663,165665,0,2,2
47275,3,3,165666,165666,165669,0,3,1
47276,3,3,165669,165669,165672,0,3,0
47277,6,2,165675,165675,165677,0,2,3
47278,5,1,165680,165680,165681,0,1,3
47279,2,2,165682,165682,165684,0,2,1
47280,6,2,165688,165688,165690,0,2,4
47281,4,3,165692,165692,165695,0,3,2
47282,1,2,165693,165695,165697,2,4,0
47283,2,3,165695,165697,165700,2,5,0
47284,4,3,165699,165700,165703,1,4,0
47285,2,2,165701,165703,165705,2,4,0
47286,6,2,165707,165707,165709,0,2,2
47287,2,2,165709,165709,165711,0,2,0
47288,3,2,165712,165712,165714,0,2,1
47289,6,1,165718,165718,165719,0,1,4
47290,2,2,165720,165720,165722,0,2,1
47291,2,3,165722,165722,165725,0,3,0
47292,6,2,165728,165728,165730,0,2,3
47293,4,1,165732,165732,165733,0,1,2
47294,2,3,165734,165734,165737,0,3,1
47295,3,3,165737,165737,165740,0,3,0
47296,3,3,165740,165740,165743,0,3,0
47297,5,2,165745,165745,165747,0,2,2
47298,1,3,165746,165747,165750,1,4,0
47299,4,3,165750,165750,165753,0,3,0
47300,6,2,165756,165756,165758,0,2,3
47301,5,1,165761,165761,165762,0,1,3
47302,5,1,165766,165766,165767,0,1,4
47303,3,1,165769,165769,165770,0,1,2
47304,2,1,165771,165771,165772,0,1,1
47305,1,1,165772,165772,165773,0,1,0
47306,6,2,165778,165778,165780,0,2,5
47307,4,1,165782,165782,165783,0,1,2
47308,3,3,165785,165785,165788,0,3,2
47309,2,2,165787,165788,165790,1,3,0
47310,5,2,165792,165792,165794,0,2,2
47311,5,3,165797,165797,165800,0,3,3
47312,4,3,165801,165801,165804,0,3,1
47313,4,1,165805,165805,165806,0,1,1
47314,2,3,165807,165807,165810,0,3,1
47315,2,1,165809,165810,165811,1,2,0
47316,4,3,165813,165813,165816,0,3,2
47317,1,1,165814,165816,165817,2,3,0
47318,5,2,165819,165819,165821,0,2,2
47319,2,1,165821,165821,165822,0,1,0
47320,1,2,165822,165822,165824,0,2,0
47321,3,1,165825,165825,165826,0,1,1
47322,5,1,165830,165830,165831,0,1,4
47323,3,3,165833,165833,165836,0,3,2
47324,4,2,165837,165837,165839,0,2,1
47325,6,3,165843,165843,165846,0,3,4
47326,1,2,165844,165846,165848,2,4,0
47327,4,1,165848,165848,165849,0,1,0
47328,4,3,165852,165852,165855,0,3,3
47329,2,3,165854,165855,165858,1,4,0
47330,1,3,165855,165858,165861,3,6,0
47331,1,1,165856,165861,165862,5,6,0
47332,2,3,165858,165862,165865,4,7,0
47333,2,2,165860,165865,165867,5,7,0
47334,1,2,165861,165867,165869,6,8,0
47335,3,2,165864,165869,165871,5,7,0
47336,5,3,165869,165871,165874,2,5,0
47337,5,2,165874,165874,165876,0,2,0
47338,5,3,165879,165879,165882,0,3,3
47339,1,3,165880,165882,165885,2,5,0
47340,1,3,165881,165885,165888,4,7,0
47341,6,1,165887,165888,165889,1,2,0
47342,3,3,165890,165890,165893,0,3,1
47343,6,2,165896,165896,165898,0,2,3
47344,2,1,165898,165898,165899,0,1,0
47345,3,1,165901,165901,165902,0,1,2
47346,4,3,165905,165905,165908,0,3,3
47347,3,3,165908,165908,165911,0,3,0
47348,1,1,165909,165911,165912,2,3,0
47349,1,1,165910,165912,165913,2,3,0
47350,1,3,165911,165913,165916,2,5,0
47351,4,2,165915,165916,165918,1,3,0
47352,2,1,165917,165918,165919,1,2,0
47353,2,2,165919,165919,165921,0,2,0
47354,1,3,165920,165921,165924,1,4,0
47355,3,3,165923,165924,165927,1,4,0
47356,1,3,165924,165927,165930,3,6,0
47357,5,3,165929,165930,165933,1,4,0
47358,5,3,165934,165934,165937,0,3,1
47359,2,2,165936,165937,165939,1,3,0
47360,2,1,165938,165939,165940,1,2,0
47361,3,1,165941,165941,165942,0,1,1
47362,5,3,165946,165946,165949,0,3,4
47363,1,1,165947,165949,165950,2,3,0
47364,6,1,165953,165953,165954,0,1,3
47365,5,2,165958,165958,165960,0,2,4
47366,1,3,165959,165960,165963,1,4,0
47367,4,1,165963,165963,165964,0,1,0
47368,2,3,165965,165965,165968,0,3,1
47369,6,3,165971,165971,165974,0,3,3
47370,4,1,165975,165975,165976,0,1,1
47371,3,2,165978,165978,165980,0,2,2
47372,4,1,165982,165982,165983,0,1,2
47373,5,2,165987,165987,165989,0,2,4
47374,2,1,165989,165989,165990,0,1,0
47375,6,2,165995,165995,165997,0,2,5
47376,6,2,166001,166001,166003,0,2,4
47377,1,3,166002,166003,166006,1,4,0
47378,4,2,166006,166006,166008,0,2,0
47379,2,2,166008,166008,166010,0,2,0
47380,4,2,166012,166012,166014,0,2,2
47381,5,1,166017,166017,166018,0,1,3
47382,4,1,166021,166021,166022,0,1,3
47383,2,1,166023,166023,166024,0,1,1
47384,4,3,166027,166027,166030,0,3,3
47385,3,2,166030,166030,166032,0,2,0
47386,6,1,166036,166036,166037,0,1,4
47387,5,3,166041,166041,166044,0,3,4
47388,4,1,166045,166045,166046,0,1,1
47389,5,2,166050,166050,166052,0,2,4
47390,5,3,166055,166055,166058,0,3,3
47391,5,2,166060,166060,166062,0,2,2
47392,3,3,166063,166063,166066,0,3,1
47393,6,2,166069,166069,166071,0,2,3
47394,4,3,166073,166073,166076,0,3,2
47395,6,1,166079,166079,166080,0,1,3
47396,1,3,166080,166080,166083,0,3,0
47397,6,1,166086,166086,166087,0,1,3
47398,4,3,166090,166090,166093,0,3,3
47399,1,2,166091,166093,166095,2,4,0
47400,3,2,166094,166095,166097,1,3,0
47401,5,3,166099,166099,166102,0,3,2
47402,3,2,166102,166102,166104,0,2,0
47403,3,2,166105,166105,166107,0,2,1
47404,5,3,166110,166110,166113,0,3,3
47405,1,2,166111,166113,166115,2,4,0
47406,2,2,166113,166115,166117,2,4,0
47407,6,1,166119,166119,166120,0,1,2
47408,6,3,166125,166125,166128,0,3,5
47409,4,1,166129,166129,166130,0,1,1
47410,3,2,166132,166132,166134,0,2,2
47411,5,1,166137,166137,166138,0,1,3
47412,1,1,166138,166138,166139,0,1,0
47413,1,3,166139,166139,166142,0,3,0
47414,4,3,166143,166143,166146,0,3,1
47415,5,3,166148,166148,166151,0,3,2
47416,5,3,166153,166153,166156,0,3,2
47417,3,2,166156,166156,166158,0,2,0
47418,3,3,166159,166159,166162,0,3,1
47419,3,1,166162,166162,166163,0,1,0
47420,6,1,166168,166168,166169,0,1,5
47421,5,2,166173,166173,166175,0,2,4
47422,1,2,166174,166175,166177,1,3,0
47423,1,3,166175,166177,166180,2,5,0
47424,4,3,166179,166180,166183,1,4,0
47425,2,1,166181,166183,166184,2,3,0
47426,1,3,166182,166184,166187,2,5,0
47427,4,1,166186,166187,166188,1,2,0
47428,6,3,166192,166192,166195,0,3,4
47429,5,3,166197,166197,166200,0,3,2
47430,1,3,166198,166200,166203,2,5,0
47431,2,1,166200,166203,166204,3,4,0
47432,1,2,166201,166204,166206,3,5,0
47433,5,1,166206,166206,166207,0,1,0
47434,4,1,166210,166210,166211,0,1,3
47435,1,1,166211,166211,166212,0,1,0
47436,3,1,166214,166214,166215,0,1,2
47437,1,1,166215,166215,166216,0,1,0
47438,3,1,166218,166218,166219,0,1,2
47439,1,1,166219,166219,166220,0,1,0
47440,2,1,166221,166221,166222,0,1,1
47441,1,2,166222,166222,166224,0,2,0
47442,3,3,166225,166225,166228,0,3,1
47443,1,3,166226,166228,166231,2,5,0
47444,2,1,166228,166231,166232,3,4,0
47445,5,2,166233,166233,166235,0,2,1
47446,6,1,166239,166239,166240,0,1,4
47447,2,3,166241,166241,166244,0,3,1
47448,1,2,166242,166244,166246,2,4,0
47449,4,2,166246,166246,166248,0,2,0
47450,1,2,166247,166248,166250,1,3,0
47451,3,1,166250,166250,166251,0,1,0
47452,2,1,166252,166252,166253,0,1,1
47453,3,1,166255,166255,166256,0,1,2
47454,1,3,166256,166256,166259,0,3,0
47455,4,3,166260,166260,166263,0,3,1
47456,2,3,166262,166263,166266,1,4,0
47457,4,2,166266,166266,166268,0,2,0
47458,1,2,166267,166268,166270,1,3,0
47459,4,3,166271,166271,166274,0,3,1
47460,3,2,166274,166274,166276,0,2,0
47461,2,3,166276,166276,166279,0,3,0
47462,5,3,166281,166281,166284,0,3,2
47463,4,3,166285,166285,166288,0,3,1
47464,6,1,166291,166291,166292,0,1,3
47465,1,3,166292,166292,166295,0,3,0
47466,1,3,166293,166295,166298,2,5,0
47467,1,3,166294,166298,166301,4,7,0
47468,1,3,166295,166301,166304,6,9,0
47469,6,2,166301,166304,166306,3,5,0
47470,6,3,166307,166307,166310,0,3,1
47471,1,2,166308,166310,166312,2,4,0
47472,6,3,166314,166314,166317,0,3,2
47473,1,3,166315,166317,166320,2,5,0
47474,3,2,166318,166320,166322,2,4,0
47475,6,2,166324,166324,166326,0,2,2
47476,6,1,166330,166330,166331,0,1,4
47477,5,2,166335,166335,166337,0,2,4
47478,4,2,166339,166339,166341,0,2,2
47479,2,1,166341,166341,166342,0,1,0
47480,5,2,166346,166346,166348,0,2,4
47481,1,1,166347,166348,166349,1,2,0
47482,6,1,166353,166353,166354,0,1,4
47483,1,2,166354,166354,166356,0,2,0
47484,1,2,166355,166356,166358,1,3,0
47485,3,1,166358,166358,166359,0,1,0
47486,2,3,166360,166360,166363,0,3,1
47487,6,2,166366,166366,166368,0,2,3
47488,1,3,166367,166368,166371,1,4,0
47489,5,1,166372,166372,166373,0,1,1
47490,1,1,166373,166373,166374,0,1,0
47491,3,1,166376,166376,166377,0,1,2
47492,1,3,166377,166377,166380,0,3,0
47493,6,2,166383,166383,166385,0,2,3
47494,3,3,166386,166386,166389,0,3,1
47495,2,2,166388,166389,166391,1,3,0
47496,6,3,166394,166394,166397,0,3,3
47497,3,3,166397,166397,166400,0,3,0
47498,2,1,166399,166400,166401,1,2,0
47499,4,1,166403,166403,166404,0,1,2
47500,6,2,166409,166409,166411,0,2,5
47501,1,3,166410,166411,166414,1,4,0
47502,3,2,166413,166414,166416,1,3,0
47503,2,2,166415,166416,166418,1,3,0
47504,3,3,166418,166418,166421,0,3,0
47505,2,3,166420,166421,166424,1,4,0
47506,2,1,166422,166424,166425,2,3,0
47507,3,3,166425,166425,166428,0,3,0
47508,2,1,166427,166428,166429,1,2,0
47509,5,1,166432,166432,166433,0,1,3
47510,4,1,166436,166436,166437,0,1,3
47511,6,3,166442,166442,166445,0,3,5
47512,5,2,166447,166447,166449,0,2,2
47513,3,2,166450,166450,166452,0,2,1
47514,3,3,166453,166453,166456,0,3,1
47515,1,3,166454,166456,166459,2,5,0
47516,4,2,166458,166459,166461,1,3,0
47517,6,1,166464,166464,166465,0,1,3
47518,5,3,166469,166469,166472,0,3,4
47519,3,3,166472,166472,166475,0,3,0
47520,5,3,166477,166477,166480,0,3,2
47521,3,1,166480,166480,166481,0,1,0
47522,5,3,166485,166485,166488,0,3,4
47523,3,3,166488,166488,166491,0,3,0
47524,6,1,166494,166494,166495,0,1,3
47525,3,1,166497,166497,166498,0,1,2
47526,4,2,166501,166501,166503,0,2,3
47527,5,2,166506,166506,166508,0,2,3
47528,6,2,166512,166512,166514,0,2,4
47529,2,1,166514,166514,166515,0,1,0
47530,4,3,166518,166518,166521,0,3,3
47531,5,1,166523,166523,166524,0,1,2
47532,1,3,166524,166524,166527,0,3,0
47533,4,3,166528,166528,166531,0,3,1
47534,1,3,166529,166531,166534,2,5,0
47535,5,2,166534,166534,166536,0,2,0
47536,5,1,166539,166539,166540,0,1,3
47537,3,3,166542,166542,166545,0,3,2
47538,6,1,166548,166548,166549,0,1,3
47539,1,3,166549,166549,166552,0,3,0
47540,3,1,166552,166552,166553,0,1,0
47541,6,1,166558,166558,166559,0,1,5
47542,5,3,166563,166563,166566,0,3,4
47543,5,1,166568,166568,166569,0,1,2
47544,2,2,166570,166570,166572,0,2,1
47545,2,1,166572,166572,166573,0,1,0
47546,2,3,166574,166574,166577,0,3,1
47547,6,3,166580,166580,166583,0,3,3
47548,2,1,166582,166583,166584,1,2,0
47549,2,2,166584,166584,166586,0,2,0
47550,4,1,166588,166588,166589,0,1,2
47551,2,2,166590,166590,166592,0,2,1
47552,1,3,166591,166592,166595,1,4,0
47553,2,2,166593,166595,166597,2,4,0
47554,1,3,166594,166597,166600,3,6,0
47555,2,1,166596,166600,166601,4,5,0
47556,4,2,166600,166601,166603,1,3,0
47557,4,1,166604,166604,166605,0,1,1
47558,4,3,166608,166608,166611,0,3,3
47559,6,2,166614,166614,166616,0,2,3
47560,4,1,166618,166618,166619,0,1,2
47561,1,3,166619,166619,166622,0,3,0
47562,5,1,166624,166624,166625,0,1,2
47563,3,2,166627,166627,166629,0,2,2
47564,1,1,166628,166629,166630,1,2,0
47565,6,2,166634,166634,166636,0,2,4
47566,2,1,166636,166636,166637,0,1,0
47567,5,3,166641,166641,166644,0,3,4
47568,4,2,166645,166645,166647,0,2,1
47569,3,2,166648,166648,166650,0,2,1
47570,1,2,166649,166650,166652,1,3,0
47571,4,3,166653,166653,166656,0,3,1
47572,2,2,166655,166656,166658,1,3,0
47573,6,2,166661,166661,166663,0,2,3
47574,1,3,166662,166663,166666,1,4,0
47575,2,2,166664,166666,166668,2,4,0
47576,1,1,166665,166668,166669,3,4,0
47577,4,1,166669,166669,166670,0,1,0
47578,6,1,166675,166675,166676,0,1,5
47579,3,2,166678,166678,166680,0,2,2
47580,3,1,166681,166681,166682,0,1,1
47581,4,1,166685,166685,166686,0,1,3
47582,2,3,166687,166687,166690,0,3,1
47583,3,3,166690,166690,166693,0,3,0
47584,4,1,166694,166694,166695,0,1,1
47585,3,1,166697,166697,166698,0,1,2
47586,2,1,166699,166699,166700,0,1,1
47587,3,3,166702,166702,166705,0,3,2
47588,2,1,166704,166705,166706,1,2,0
47589,5,1,166709,166709,166710,0,1,3
47590,2,3,166711,166711,166714,0,3,1
47591,5,2,166716,166716,166718,0,2,2
47592,2,3,166718,166718,166721,0,3,0
47593,6,2,166724,166724,166726,0,2,3
47594,1,1,166725,166726,166727,1,2,0
47595,3,1,166728,166728,166729,0,1,1
47596,3,2,166731,166731,166733,0,2,2
47597,3,3,166734,166734,166737,0,3,1
47598,1,3,166735,166737,166740,2,5,0
47599,3,3,166738,166740,166743,2,5,0
47600,2,1,166740,166743,166744,3,4,0
47601,1,2,166741,166744,166746,3,5,0
47602,1,1,166742,166746,166747,4,5,0
47603,6,1,166748,166748,166749,0,1,1
47604,1,3,166749,166749,166752,0,3,0
47605,6,1,166755,166755,166756,0,1,3
47606,6,3,166761,166761,166764,0,3,5
47607,2,3,166763,166764,166767,1,4,0
47608,4,2,166767,166767,166769,0,2,0
47609,1,2,166768,166769,166771,1,3,0
47610,5,3,166773,166773,166776,0,3,2
47611,3,1,166776,166776,166777,0,1,0
47612,1,2,166777,166777,166779,0,2,0
47613,5,3,166782,166782,166785,0,3,3
47614,6,2,166788,166788,166790,0,2,3
47615,1,1,166789,166790,166791,1,2,0
47616,5,2,166794,166794,166796,0,2,3
47617,5,1,166799,166799,166800,0,1,3
47618,2,1,166801,166801,166802,0,1,1
47619,1,1,166802,166802,166803,0,1,0
47620,5,3,166807,166807,166810,0,3,4
47621,2,3,166809,166810,166813,1,4,0
47622,3,1,166812,166813,166814,1,2,0
47623,2,3,166814,166814,166817,0,3,0
47624,3,3,166817,166817,166820,0,3,0
47625,6,3,166823,166823,166826,0,3,3
47626,4,1,166827,166827,166828,0,1,1
47627,6,3,166833,166833,166836,0,3,5
47628,2,2,166835,166836,166838,1,3,0
47629,6,1,166841,166841,166842,0,1,3
47630,6,3,166847,166847,166850,0,3,5
47631,4,2,166851,166851,166853,0,2,1
47632,4,1,166855,166855,166856,0,1,2
47633,4,1,166859,166859,166860,0,1,3
47634,6,2,166865,166865,166867,0,2,5
47635,3,1,166868,166868,166869,0,1,1
47636,3,2,166871,166871,166873,0,2,2
47637,5,3,166876,166876,166879,0,3,3
47638,1,1,166877,166879,166880,2,3,0
47639,3,3,166880,166880,166883,0,3,0
47640,2,2,166882,166883,166885,1,3,0
47641,3,2,166885,166885,166887,0,2,0
47642,2,3,166887,166887,166890,0,3,0
47643,1,1,166888,166890,166891,2,3,0
47644,4,2,166892,166892,166894,0,2,1
47645,4,1,166896,166896,166897,0,1,2
47646,5,1,166901,166901,166902,0,1,4
47647,4,2,166905,166905,166907,0,2,3
47648,3,1,166908,166908,166909,0,1,1
47649,3,1,166911,166911,166912,0,1,2
47650,1,3,166912,166912,166915,0,3,0
47651,6,1,166918,166918,166919,0,1,3
47652,4,2,166922,166922,166924,0,2,3
47653,2,2,166924,166924,166926,0,2,0
47654,1,2,166925,166926,166928,1,3,0
47655,5,2,166930,166930,166932,0,2,2
47656,5,1,166935,166935,166936,0,1,3
47657,2,2,166937,166937,166939,0,2,1
47658,5,2,166942,166942,166944,0,2,3
47659,4,3,166946,166946,166949,0,3,2
47660,4,3,166950,166950,166953,0,3,1
47661,5,3,166955,166955,166958,0,3,2
47662,4,1,166959,166959,166960,0,1,1
47663,2,1,166961,166961,166962,0,1,1
47664,4,2,166965,166965,166967,0,2,3
47665,6,3,166971,166971,166974,0,3,4
47666,6,3,166977,166977,166980,0,3,3
47667,6,3,166983,166983,166986,0,3,3
47668,2,3,166985,166986,166989,1,4,0
47669,3,3,166988,166989,166992,1,4,0
47670,4,1,166992,166992,166993,0,1,0
47671,2,2,166994,166994,166996,0,2,1
47672,6,1,167000,167000,167001,0,1,4
47673,2,1,167002,167002,167003,0,1,1
47674,5,2,167007,167007,167009,0,2,4
47675,1,3,167008,167009,167012,1,4,0
47676,4,2,167012,167012,167014,0,2,0
47677,3,2,167015,167015,167017,0,2,1
47678,1,3,167016,167017,167020,1,4,0
47679,5,3,167021,167021,167024,0,3,1
47680,3,1,167024,167024,167025,0,1,0
47681,1,3,167025,167025,167028,0,3,0
47682,3,2,167028,167028,167030,0,2,0
47683,2,3,167030,167030,167033,0,3,0
47684,3,3,167033,167033,167036,0,3,0
47685,6,2,167039,167039,167041,0,2,3
47686,4,3,167043,167043,167046,0,3,2
47687,6,1,167049,167049,167050,0,1,3
47688,6,2,167055,167055,167057,0,2,5
47689,5,3,167060,167060,167063,0,3,3
47690,3,1,167063,167063,167064,0,1,0
47691,6,3,167069,167069,167072,0,3,5
47692,6,2,167075,167075,167077,0,2,3
47693,4,1,167079,167079,167080,0,1,2
47694,2,3,167081,167081,167084,0,3,1
47695,2,2,167083,167084,167086,1,3,0
47696,2,1,167085,167086,167087,1,2,0
47697,5,3,167090,167090,167093,0,3,3
47698,3,3,167093,167093,167096,0,3,0
47699,3,1,167096,167096,167097,0,1,0
47700,5,1,167101,167101,167102,0,1,4
47701,4,3,167105,167105,167108,0,3,3
47702,4,1,167109,167109,167110,0,1,1
47703,4,2,167113,167113,167115,0,2,3
47704,3,1,167116,167116,167117,0,1,1
47705,4,3,167120,167120,167123,0,3,3
47706,5,2,167125,167125,167127,0,2,2
47707,1,1,167126,167127,167128,1,2,0
47708,2,2,167128,167128,167130,0,2,0
47709,3,1,167131,167131,167132,0,1,1
47710,5,1,167136,167136,167137,0,1,4
47711,2,3,167138,167138,167141,0,3,1
47712,2,1,167140,167141,167142,1,2,0
47713,1,3,167141,167142,167145,1,4,0
47714,2,2,167143,167145,167147,2,4,0
47715,5,1,167148,167148,167149,0,1,1
47716,3,1,167151,167151,167152,0,1,2
47717,4,1,167155,167155,167156,0,1,3
47718,6,2,167161,167161,167163,0,2,5
47719,5,1,167166,167166,167167,0,1,3
47720,5,1,167171,167171,167172,0,1,4
47721,5,2,167176,167176,167178,0,2,4
47722,4,3,167180,167180,167183,0,3,2
47723,4,3,167184,167184,167187,0,3,1
47724,4,1,167188,167188,167189,0,1,1
47725,5,3,167193,167193,167196,0,3,4
47726,1,1,167194,167196,167197,2,3,0
47727,5,2,167199,167199,167201,0,2,2
47728,6,1,167205,167205,167206,0,1,4
47729,3,1,167208,167208,167209,0,1,2
47730,2,3,167210,167210,167213,0,3,1
47731,1,1,167211,167213,167214,2,3,0
47732,6,3,167217,167217,167220,0,3,3
47733,3,3,167220,167220,167223,0,3,0
47734,3,1,167223,167223,167224,0,1,0
47735,5,2,167228,167228,167230,0,2,4
47736,5,1,167233,167233,167234,0,1,3
47737,5,3,167238,167238,167241,0,3,4
47738,1,2,167239,167241,167243,2,4,0
47739,6,3,167245,167245,167248,0,3,2
47740,4,2,167249,167249,167251,0,2,1
47741,6,1,167255,167255,167256,0,1,4
47742,1,2,167256,167256,167258,0,2,0
47743,6,1,167262,167262,167263,0,1,4
47744,1,3,167263,167263,167266,0,3,0
47745,6,2,167269,167269,167271,0,2,3
47746,5,1,167274,167274,167275,0,1,3
47747,1,2,167275,167275,167277,0,2,0
47748,5,1,167280,167280,167281,0,1,3
47749,5,2,167285,167285,167287,0,2,4
47750,1,2,167286,167287,167289,1,3,0
47751,1,1,167287,167289,167290,2,3,0
47752,2,2,167289,167290,167292,1,3,0
47753,4,1,167293,167293,167294,0,1,1
47754,3,3,167296,167296,167299,0,3,2
47755,6,3,167302,167302,167305,0,3,3
47756,1,1,167303,167305,167306,2,3,0
47757,2,3,167305,167306,167309,1,4,0
47758,3,3,167308,167309,167312,1,4,0
47759,3,1,167311,167312,167313,1,2,0
47760,4,3,167315,167315,167318,0,3,2
47761,2,3,167317,167318,167321,1,4,0
47762,2,1,167319,167321,167322,2,3,0
47763,4,1,167323,167323,167324,0,1,1
47764,1,3,167324,167324,167327,0,3,0
47765,3,3,167327,167327,167330,0,3,0
47766,4,1,167331,167331,167332,0,1,1
47767,3,3,167334,167334,167337,0,3,2
47768,6,2,167340,167340,167342,0,2,3
47769,5,1,167345,167345,167346,0,1,3
47770,6,2,167351,167351,167353,0,2,5
47771,2,3,167353,167353,167356,0,3,0
47772,2,3,167355,167356,167359,1,4,0
47773,4,2,167359,167359,167361,0,2,0
47774,5,2,167364,167364,167366,0,2,3
47775,3,2,167367,167367,167369,0,2,1
47776,4,2,167371,167371,167373,0,2,2
47777,2,1,167373,167373,167374,0,1,0
47778,3,1,167376,167376,167377,0,1,2
47779,6,1,167382,167382,167383,0,1,5
47780,6,2,167388,167388,167390,0,2,5
47781,2,2,167390,167390,167392,0,2,0
47782,4,2,167394,167394,167396,0,2,2
47783,5,3,167399,167399,167402,0,3,3
47784,5,3,167404,167404,167407,0,3,2
47785,6,2,167410,167410,167412,0,2,3
47786,5,2,167415,167415,167417,0,2,3
47787,5,2,167420,167420,167422,0,2,3
47788,2,1,167422,167422,167423,0,1,0
47789,4,1,167426,167426,167427,0,1,3
47790,6,1,167432,167432,167433,0,1,5
47791,6,2,167438,167438,167440,0,2,5
47792,6,1,167444,167444,167445,0,1,4
47793,4,1,167448,167448,167449,0,1,3
47794,3,3,167451,167451,167454,0,3,2
47795,6,3,167457,167457,167460,0,3,3
47796,1,2,167458,167460,167462,2,4,0
47797,6,1,167464,167464,167465,0,1,2
47798,1,3,167465,167465,167468,0,3,0
47799,1,3,167466,167468,167471,2,5,0
47800,6,2,167472,167472,167474,0,2,1
47801,1,1,167473,167474,167475,1,2,0
47802,1,3,167474,167475,167478,1,4,0
47803,6,3,167480,167480,167483,0,3,2
47804,2,3,167482,167483,167486,1,4,0
47805,6,3,167488,167488,167491,0,3,2
47806,3,1,167491,167491,167492,0,1,0
47807,4,2,167495,167495,167497,0,2,3
47808,6,1,167501,167501,167502,0,1,4
47809,4,3,167505,167505,167508,0,3,3
47810,1,1,167506,167508,167509,2,3,0
47811,6,2,167512,167512,167514,0,2,3
47812,1,2,167513,167514,167516,1,3,0
47813,2,2,167515,167516,167518,1,3,0
47814,3,3,167518,167518,167521,0,3,0
47815,5,1,167523,167523,167524,0,1,2
47816,4,1,167527,167527,167528,0,1,3
47817,2,2,167529,167529,167531,0,2,1
47818,4,2,167533,167533,167535,0,2,2
47819,3,3,167536,167536,167539,0,3,1
47820,5,1,167541,167541,167542,0,1,2
47821,4,2,167545,167545,167547,0,2,3
47822,1,3,167546,167547,167550,1,4,0
47823,2,3,167548,167550,167553,2,5,0
47824,6,3,167554,167554,167557,0,3,1
47825,5,1,167559,167559,167560,0,1,2
47826,1,3,167560,167560,167563,0,3,0
47827,1,2,167561,167563,167565,2,4,0
47828,6,1,167567,167567,167568,0,1,2
47829,6,2,167573,167573,167575,0,2,5
47830,6,3,167579,167579,167582,0,3,4
47831,6,3,167585,167585,167588,0,3,3
47832,1,1,167586,167588,167589,2,3,0
47833,5,2,167591,167591,167593,0,2,2
47834,2,3,167593,167593,167596,0,3,0
47835,2,3,167595,167596,167599,1,4,0
47836,3,3,167598,167599,167602,1,4,0
47837,4,3,167602,167602,167605,0,3,0
47838,3,3,167605,167605,167608,0,3,0
47839,4,1,167609,167609,167610,0,1,1
47840,6,3,167615,167615,167618,0,3,5
47841,3,3,167618,167618,167621,0,3,0
47842,2,3,167620,167621,167624,1,4,0
47843,1,1,167621,167624,167625,3,4,0
47844,3,3,167624,167625,167628,1,4,0
47845,1,1,167625,167628,167629,3,4,0
47846,6,2,167631,167631,167633,0,2,2
47847,4,1,167635,167635,167636,0,1,2
47848,5,2,167640,167640,167642,0,2,4
47849,4,1,167644,167644,167645,0,1,2
47850,2,1,167646,167646,167647,0,1,1
47851,5,1,167651,167651,167652,0,1,4
47852,6,2,167657,167657,167659,0,2,5
47853,1,1,167658,167659,167660,1,2,0
47854,2,2,167660,167660,167662,0,2,0
47855,5,1,167665,167665,167666,0,1,3
47856,1,2,167666,167666,167668,0,2,0
47857,4,2,167670,167670,167672,0,2,2
47858,4,3,167674,167674,167677,0,3,2
47859,4,1,167678,167678,167679,0,1,1
47860,6,1,167684,167684,167685,0,1,5
47861,1,2,167685,167685,167687,0,2,0
47862,4,3,167689,167689,167692,0,3,2
47863,3,1,167692,167692,167693,0,1,0
47864,6,3,167698,167698,167701,0,3,5
47865,4,2,167702,167702,167704,0,2,1
47866,6,1,167708,167708,167709,0,1,4
47867,3,2,167711,167711,167713,0,2,2
47868,6,2,167717,167717,167719,0,2,4
47869,6,2,167723,167723,167725,0,2,4
47870,6,3,167729,167729,167732,0,3,4
47871,5,2,167734,167734,167736,0,2,2
47872,5,1,167739,167739,167740,0,1,3
47873,3,2,167742,167742,167744,0,2,2
47874,2,3,167744,167744,167747,0,3,0
47875,2,2,167746,167747,167749,1,3,0
47876,4,3,167750,167750,167753,0,3,1
47877,6,3,167756,167756,167759,0,3,3
47878,2,3,167758,167759,167762,1,4,0
47879,2,1,167760,167762,167763,2,3,0
47880,2,2,167762,167763,167765,1,3,0
47881,1,1,167763,167765,167766,2,3,0
47882,5,3,167768,167768,167771,0,3,2
47883,4,1,167772,167772,167773,0,1,1
47884,5,1,167777,167777,167778,0,1,4
47885,3,2,167780,167780,167782,0,2,2
47886,3,1,167783,167783,167784,0,1,1
47887,1,3,167784,167784,167787,0,3,0
47888,6,3,167790,167790,167793,0,3,3
47889,4,2,167794,167794,167796,0,2,1
47890,6,2,167800,167800,167802,0,2,4
47891,2,2,167802,167802,167804,0,2,0
47892,3,3,167805,167805,167808,0,3,1
47893,1,2,167806,167808,167810,2,4,0
47894,3,2,167809,167810,167812,1,3,0
47895,3,1,167812,167812,167813,0,1,0
47896,3,2,167815,167815,167817,0,2,2
47897,6,1,167821,167821,167822,0,1,4
47898,3,1,167824,167824,167825,0,1,2
47899,4,3,167828,167828,167831,0,3,3
47900,2,2,167830,167831,167833,1,3,0
47901,4,3,167834,167834,167837,0,3,1
47902,6,1,167840,167840,167841,0,1,3
47903,4,2,167844,167844,167846,0,2,3
47904,2,2,167846,167846,167848,0,2,0
47905,3,1,167849,167849,167850,0,1,1
47906,5,3,167854,167854,167857,0,3,4
47907,1,2,167855,167857,167859,2,4,0
47908,6,1,167861,167861,167862,0,1,2
47909,3,3,167864,167864,167867,0,3,2
47910,1,1,167865,167867,167868,2,3,0
47911,3,2,167868,167868,167870,0,2,0
47912,3,1,167871,167871,167872,0,1,1
47913,6,1,167877,167877,167878,0,1,5
47914,3,2,167880,167880,167882,0,2,2
47915,6,1,167886,167886,167887,0,1,4
47916,4,3,167890,167890,167893,0,3,3
47917,5,2,167895,167895,167897,0,2,2
47918,2,2,167897,167897,167899,0,2,0
47919,3,3,167900,167900,167903,0,3,1
47920,6,2,167906,167906,167908,0,2,3
47921,1,2,167907,167908,167910,1,3,0
47922,2,1,167909,167910,167911,1,2,0
47923,2,1,167911,167911,167912,0,1,0
47924,2,3,167913,167913,167916,0,3,1
47925,4,3,167917,167917,167920,0,3,1
47926,1,2,167918,167920,167922,2,4,0
47927,2,1,167920,167922,167923,2,3,0
47928,3,3,167923,167923,167926,0,3,0
47929,5,3,167928,167928,167931,0,3,2
47930,2,1,167930,167931,167932,1,2,0
47931,2,3,167932,167932,167935,0,3,0
47932,2,1,167934,167935,167936,1,2,0
47933,5,2,167939,167939,167941,0,2,3
47934,1,1,167940,167941,167942,1,2,0
47935,1,3,167941,167942,167945,1,4,0
47936,3,2,167944,167945,167947,1,3,0
47937,5,2,167949,167949,167951,0,2,2
47938,1,1,167950,167951,167952,1,2,0
47939,5,3,167955,167955,167958,0,3,3
47940,1,1,167956,167958,167959,2,3,0
47941,2,2,167958,167959,167961,1,3,0
47942,3,1,167961,167961,167962,0,1,0
47943,6,1,167967,167967,167968,0,1,5
47944,6,2,167973,167973,167975,0,2,5
47945,1,3,167974,167975,167978,1,4,0
47946,2,2,167976,167978,167980,2,4,0
47947,6,1,167982,167982,167983,0,1,2
47948,5,2,167987,167987,167989,0,2,4
47949,3,2,167990,167990,167992,0,2,1
47950,2,2,167992,167992,167994,0,2,0
47951,5,3,167997,167997,168000,0,3,3
47952,2,3,167999,168000,168003,1,4,0
47953,5,2,168004,168004,168006,0,2,1
47954,6,2,168010,168010,168012,0,2,4
47955,4,3,168014,168014,168017,0,3,2
47956,2,3,168016,168017,168020,1,4,0
47957,1,3,168017,168020,168023,3,6,0
47958,2,1,168019,168023,168024,4,5,0
47959,5,1,168024,168024,168025,0,1,0
47960,6,2,168030,168030,168032,0,2,5
47961,5,1,168035,168035,168036,0,1,3
47962,4,2,168039,168039,168041,0,2,3
47963,5,3,168044,168044,168047,0,3,3
47964,2,3,168046,168047,168050,1,4,0
47965,5,1,168051,168051,168052,0,1,1
47966,4,2,168055,168055,168057,0,2,3
47967,6,1,168061,168061,168062,0,1,4
47968,2,3,168063,168063,168066,0,3,1
47969,4,2,168067,168067,168069,0,2,1
47970,5,1,168072,168072,168073,0,1,3
47971,2,3,168074,168074,168077,0,3,1
47972,5,1,168079,168079,168080,0,1,2
47973,4,2,168083,168083,168085,0,2,3
47974,1,1,168084,168085,168086,1,2,0
47975,4,1,168088,168088,168089,0,1,2
47976,1,2,168089,168089,168091,0,2,0
47977,3,2,168092,168092,168094,0,2,1
47978,3,3,168095,168095,168098,0,3,1
47979,6,3,168101,168101,168104,0,3,3
47980,6,3,168107,168107,168110,0,3,3
47981,5,3,168112,168112,168115,0,3,2
47982,3,2,168115,168115,168117,0,2,0
47983,3,3,168118,168118,168121,0,3,1
47984,6,3,168124,168124,168127,0,3,3
47985,5,2,168129,168129,168131,0,2,2
47986,6,3,168135,168135,168138,0,3,4
47987,6,1,168141,168141,168142,0,1,3
47988,1,3,168142,168142,168145,0,3,0
47989,5,2,168147,168147,168149,0,2,2
47990,5,1,168152,168152,168153,0,1,3
47991,1,1,168153,168153,168154,0,1,0
47992,3,2,168156,168156,168158,0,2,2
47993,3,1,168159,168159,168160,0,1,1
47994,2,3,168161,168161,168164,0,3,1
47995,5,3,168166,168166,168169,0,3,2
47996,2,1,168168,168169,168170,1,2,0
47997,2,3,168170,168170,168173,0,3,0
47998,3,3,168173,168173,168176,0,3,0
47999,3,1,168176,168176,168177,0,1,0
48000,5,1,168181,168181,168182,0,1,4
48001,3,1,168184,168184,168185,0,1,2
48002,4,3,168188,168188,168191,0,3,3
48003,4,2,168192,168192,168194,0,2,1
48004,1,2,168193,168194,168196,1,3,0
48005,4,2,168197,168197,168199,0,2,1
48006,1,1,168198,168199,168200,1,2,0
48007,5,2,168203,168203,168205,0,2,3
48008,5,2,168208,168208,168210,0,2,3
48009,1,3,168209,168210,168213,1,4,0
48010,5,3,168214,168214,168217,0,3,1
48011,5,2,168219,168219,168221,0,2,2
48012,5,1,168224,168224,168225,0,1,3
48013,2,1,168226,168226,168227,0,1,1
48014,6,1,168232,168232,168233,0,1,5
48015,1,3,168233,168233,168236,0,3,0
48016,2,2,168235,168236,168238,1,3,0
48017,6,3,168241,168241,168244,0,3,3
48018,3,3,168244,168244,168247,0,3,0
48019,3,2,168247,168247,168249,0,2,0
48020,1,3,168248,168249,168252,1,4,0
48021,6,3,168254,168254,168257,0,3,2
48022,4,1,168258,168258,168259,0,1,1
48023,6,2,168264,168264,168266,0,2,5
48024,5,3,168269,168269,168272,0,3,3
48025,2,3,168271,168272,168275,1,4,0
48026,3,1,168274,168275,168276,1,2,0
48027,6,3,168280,168280,168283,0,3,4
48028,1,1,168281,168283,168284,2,3,0
48029,6,2,168287,168287,168289,0,2,3
48030,5,2,168292,168292,168294,0,2,3
48031,4,1,168296,168296,168297,0,1,2
48032,4,1,168300,168300,168301,0,1,3
48033,2,2,168302,168302,168304,0,2,1
48034,1,1,168303,168304,168305,1,2,0
48035,5,3,168308,168308,168311,0,3,3
48036,6,2,168314,168314,168316,0,2,3
48037,5,1,168319,168319,168320,0,1,3
48038,6,3,168325,168325,168328,0,3,5
48039,5,3,168330,168330,168333,0,3,2
48040,5,3,168335,168335,168338,0,3,2
48041,4,1,168339,168339,168340,0,1,1
48042,4,2,168343,168343,168345,0,2,3
48043,3,2,168346,168346,168348,0,2,1
48044,3,1,168349,168349,168350,0,1,1
48045,3,2,168352,168352,168354,0,2,2
48046,1,3,168353,168354,168357,1,4,0
48047,6,2,168359,168359,168361,0,2,2
48048,4,2,168363,168363,168365,0,2,2
48049,6,1,168369,168369,168370,0,1,4
48050,3,2,168372,168372,168374,0,2,2
48051,6,1,168378,168378,168379,0,1,4
48052,3,2,168381,168381,168383,0,2,2
48053,1,1,168382,168383,168384,1,2,0
48054,1,3,168383,168384,168387,1,4,0
48055,2,2,168385,168387,168389,2,4,0
48056,4,2,168389,168389,168391,0,2,0
48057,6,2,168395,168395,168397,0,2,4
48058,4,3,168399,168399,168402,0,3,2
48059,2,1,168401,168402,168403,1,2,0
48060,6,2,168407,168407,168409,0,2,4
48061,6,3,168413,168413,168416,0,3,4
48062,3,2,168416,168416,168418,0,2,0
48063,1,1,168417,168418,168419,1,2,0
48064,3,2,168420,168420,168422,0,2,1
48065,1,1,168421,168422,168423,1,2,0
48066,6,3,168427,168427,168430,0,3,4
48067,4,3,168431,168431,168434,0,3,1
48068,6,1,168437,168437,168438,0,1,3
48069,2,1,168439,168439,168440,0,1,1
48070,6,2,168445,168445,168447,0,2,5
48071,3,1,168448,168448,168449,0,1,1
48072,1,3,168449,168449,168452,0,3,0
48073,1,1,168450,168452,168453,2,3,0
48074,5,2,168455,168455,168457,0,2,2
48075,2,3,168457,168457,168460,0,3,0
48076,3,2,168460,168460,168462,0,2,0
48077,5,2,168465,168465,168467,0,2,3
48078,6,3,168471,168471,168474,0,3,4
48079,5,1,168476,168476,168477,0,1,2
48080,3,1,168479,168479,168480,0,1,2
48081,6,2,168485,168485,168487,0,2,5
48082,2,3,168487,168487,168490,0,3,0
48083,2,2,168489,168490,168492,1,3,0
48084,4,1,168493,168493,168494,0,1,1
48085,6,2,168499,168499,168501,0,2,5
48086,3,1,168502,168502,168503,0,1,1
48087,5,3,168507,168507,168510,0,3,4
48088,1,2,168508,168510,168512,2,4,0
48089,2,1,168510,168512,168513,2,3,0
48090,5,3,168515,168515,168518,0,3,2
48091,3,3,168518,168518,168521,0,3,0
48092,3,3,168521,168521,168524,0,3,0
48093,5,2,168526,168526,168528,0,2,2
48094,4,1,168530,168530,168531,0,1,2
48095,2,2,168532,168532,168534,0,2,1
48096,2,2,168534,168534,168536,0,2,0
48097,6,2,168540,168540,168542,0,2,4
48098,6,2,168546,168546,168548,0,2,4
48099,5,2,168551,168551,168553,0,2,3
48100,4,3,168555,168555,168558,0,3,2
48101,3,3,168558,168558,168561,0,3,0
48102,1,3,168559,168561,168564,2,5,0
48103,5,2,168564,168564,168566,0,2,0
48104,1,2,168565,168566,168568,1,3,0
48105,4,3,168569,168569,168572,0,3,1
48106,5,3,168574,168574,168577,0,3,2
48107,6,2,168580,168580,168582,0,2,3
48108,3,2,168583,168583,168585,0,2,1
48109,5,2,168588,168588,168590,0,2,3
48110,4,2,168592,168592,168594,0,2,2
48111,6,3,168598,168598,168601,0,3,4
48112,3,1,168601,168601,168602,0,1,0
48113,3,2,168604,168604,168606,0,2,2
48114,3,1,168607,168607,168608,0,1,1
48115,3,3,168610,168610,168613,0,3,2
48116,5,1,168615,168615,168616,0,1,2
48117,4,3,168619,168619,168622,0,3,3
48118,4,3,168623,168623,168626,0,3,1
48119,3,2,168626,168626,168628,0,2,0
48120,5,1,168631,168631,168632,0,1,3
48121,4,2,168635,168635,168637,0,2,3
48122,3,3,168638,168638,168641,0,3,1
48123,6,3,168644,168644,168647,0,3,3
48124,6,2,168650,168650,168652,0,2,3
48125,6,1,168656,168656,168657,0,1,4
48126,1,3,168657,168657,168660,0,3,0
48127,3,3,168660,168660,168663,0,3,0
48128,6,2,168666,168666,168668,0,2,3
48129,3,3,168669,168669,168672,0,3,1
48130,1,2,168670,168672,168674,2,4,0
48131,5,1,168675,168675,168676,0,1,1
48132,1,1,168676,168676,168677,0,1,0
48133,2,3,168678,168678,168681,0,3,1
48134,6,1,168684,168684,168685,0,1,3
48135,1,1,168685,168685,168686,0,1,0
48136,5,3,168690,168690,168693,0,3,4
48137,2,2,168692,168693,168695,1,3,0
48138,5,1,168697,168697,168698,0,1,2
48139,5,3,168702,168702,168705,0,3,4
48140,4,1,168706,168706,168707,0,1,1
48141,5,2,168711,168711,168713,0,2,4
48142,2,3,168713,168713,168716,0,3,0
48143,6,2,168719,168719,168721,0,2,3
48144,6,3,168725,168725,168728,0,3,4
48145,6,2,168731,168731,168733,0,2,3
48146,5,1,168736,168736,168737,0,1,3
48147,6,3,168742,168742,168745,0,3,5
48148,1,1,168743,168745,168746,2,3,0
48149,6,2,168749,168749,168751,0,2,3
48150,4,2,168753,168753,168755,0,2,2
48151,3,3,168756,168756,168759,0,3,1
48152,4,1,168760,168760,168761,0,1,1
48153,3,2,168763,168763,168765,0,2,2
48154,5,2,168768,168768,168770,0,2,3
48155,4,1,168772,168772,168773,0,1,2
48156,5,3,168777,168777,168780,0,3,4
48157,6,3,168783,168783,168786,0,3,3
48158,4,3,168787,168787,168790,0,3,1
48159,5,3,168792,168792,168795,0,3,2
48160,5,1,168797,168797,168798,0,1,2
48161,2,3,168799,168799,168802,0,3,1
48162,4,3,168803,168803,168806,0,3,1
48163,6,3,168809,168809,168812,0,3,3
48164,1,2,168810,168812,168814,2,4,0
48165,4,3,168814,168814,168817,0,3,0
48166,1,1,168815,168817,168818,2,3,0
48167,5,3,168820,168820,168823,0,3,2
48168,3,3,168823,168823,168826,0,3,0
48169,3,3,168826,168826,168829,0,3,0
48170,6,1,168832,168832,168833,0,1,3
48171,5,1,168837,168837,168838,0,1,4
48172,3,3,168840,168840,168843,0,3,2
48173,6,3,168846,168846,168849,0,3,3
48174,6,2,168852,168852,168854,0,2,3
48175,2,1,168854,168854,168855,0,1,0
48176,1,3,168855,168855,168858,0,3,0
48177,1,1,168856,168858,168859,2,3,0
48178,3,3,168859,168859,168862,0,3,0
48179,4,1,168863,168863,168864,0,1,1
48180,4,2,168867,168867,168869,0,2,3
48181,3,2,168870,168870,168872,0,2,1
48182,4,2,168874,168874,168876,0,2,2
48183,6,3,168880,168880,168883,0,3,4
48184,4,2,168884,168884,168886,0,2,1
48185,4,3,168888,168888,168891,0,3,2
48186,1,2,168889,168891,168893,2,4,0
48187,6,1,168895,168895,168896,0,1,2
48188,6,3,168901,168901,168904,0,3,5
48189,3,2,168904,168904,168906,0,2,0
48190,1,1,168905,168906,168907,1,2,0
48191,5,3,168910,168910,168913,0,3,3
48192,2,1,168912,168913,168914,1,2,0
48193,1,3,168913,168914,168917,1,4,0
48194,6,2,168919,168919,168921,0,2,2
48195,2,3,168921,168921,168924,0,3,0
48196,4,1,168925,168925,168926,0,1,1
48197,1,3,168926,168926,168929,0,3,0
48198,5,1,168931,168931,168932,0,1,2
48199,4,1,168935,168935,168936,0,1,3
48200,5,3,168940,168940,168943,0,3,4
48201,5,3,168945,168945,168948,0,3,2
48202,4,2,168949,168949,168951,0,2,1
48203,6,1,168955,168955,168956,0,1,4
48204,1,2,168956,168956,168958,0,2,0
48205,4,1,168960,168960,168961,0,1,2
48206,1,3,168961,168961,168964,0,3,0
48207,2,2,168963,168964,168966,1,3,0
48208,3,1,168966,168966,168967,0,1,0
48209,6,3,168972,168972,168975,0,3,5
48210,1,1,168973,168975,168976,2,3,0
48211,4,3,168977,168977,168980,0,3,1
48212,2,3,168979,168980,168983,1,4,0
48213,4,1,168983,168983,168984,0,1,0
48214,4,1,168987,168987,168988,0,1,3
48215,1,2,168988,168988,168990,0,2,0
48216,2,3,168990,168990,168993,0,3,0
48217,4,2,168994,168994,168996,0,2,1
48218,6,2,169000,169000,169002,0,2,4
48219,1,1,169001,169002,169003,1,2,0
48220,2,1,169003,169003,169004,0,1,0
48221,2,2,169005,169005,169007,0,2,1
48222,6,1,169011,169011,169012,0,1,4
48223,6,1,169017,169017,169018,0,1,5
48224,3,3,169020,169020,169023,0,3,2
48225,4,3,169024,169024,169027,0,3,1
48226,6,3,169030,169030,169033,0,3,3
48227,1,1,169031,169033,169034,2,3,0
48228,5,2,169036,169036,169038,0,2,2
48229,6,2,169042,169042,169044,0,2,4
48230,2,2,169044,169044,169046,0,2,0
48231,5,1,169049,169049,169050,0,1,3
48232,4,2,169053,169053,169055,0,2,3
48233,2,1,169055,169055,169056,0,1,0
48234,4,3,169059,169059,169062,0,3,3
48235,4,3,169063,169063,169066,0,3,1
48236,1,1,169064,169066,169067,2,3,0
48237,3,2,169067,169067,169069,0,2,0
48238,3,3,169070,169070,169073,0,3,1
48239,2,3,169072,169073,169076,1,4,0
48240,1,1,169073,169076,169077,3,4,0
48241,4,3,169077,169077,169080,0,3,0
48242,4,1,169081,169081,169082,0,1,1
48243,2,2,169083,169083,169085,0,2,1
48244,6,1,169089,169089,169090,0,1,4
48245,5,3,169094,169094,169097,0,3,4
48246,1,1,169095,169097,169098,2,3,0
48247,1,2,169096,169098,169100,2,4,0
48248,3,3,169099,169100,169103,1,4,0
48249,4,2,169103,169103,169105,0,2,0
48250,2,3,169105,169105,169108,0,3,0
48251,3,1,169108,169108,169109,0,1,0
48252,5,3,169113,169113,169116,0,3,4
48253,5,1,169118,169118,169119,0,1,2
48254,2,1,169120,169120,169121,0,1,1
48255,4,2,169124,169124,169126,0,2,3
48256,1,1,169125,169126,169127,1,2,0
48257,6,2,169131,169131,169133,0,2,4
48258,2,1,169133,169133,169134,0,1,0
48259,6,2,169139,169139,169141,0,2,5
48260,5,1,169144,169144,169145,0,1,3
48261,2,2,169146,169146,169148,0,2,1
48262,1,2,169147,169148,169150,1,3,0
48263,6,2,169153,169153,169155,0,2,3
48264,5,2,169158,169158,169160,0,2,3
48265,6,2,169164,169164,169166,0,2,4
48266,2,2,169166,169166,169168,0,2,0
48267,1,1,169167,169168,169169,1,2,0
48268,4,1,169171,169171,169172,0,1,2
48269,3,3,169174,169174,169177,0,3,2
48270,6,2,169180,169180,169182,0,2,3
48271,3,1,169183,169183,169184,0,1,1
48272,1,2,169184,169184,169186,0,2,0
48273,4,3,169188,169188,169191,0,3,2
48274,5,3,169193,169193,169196,0,3,2
48275,4,1,169197,169197,169198,0,1,1
48276,6,1,169203,169203,169204,0,1,5
48277,1,1,169204,169204,169205,0,1,0
48278,2,2,169206,169206,169208,0,2,1
48279,5,3,169211,169211,169214,0,3,3
48280,4,2,169215,169215,169217,0,2,1
48281,6,2,169221,169221,169223,0,2,4
48282,1,2,169222,169223,169225,1,3,0
48283,4,2,169226,169226,169228,0,2,1
48284,1,1,169227,169228,169229,1,2,0
48285,5,1,169232,169232,169233,0,1,3
48286,3,2,169235,169235,169237,0,2,2
48287,1,3,169236,169237,169240,1,4,0
48288,2,1,169238,169240,169241,2,3,0
48289,5,2,169243,169243,169245,0,2,2
48290,3,1,169246,169246,169247,0,1,1
48291,3,1,169249,169249,169250,0,1,2
48292,4,1,169253,169253,169254,0,1,3
48293,1,3,169254,169254,169257,0,3,0
48294,6,3,169260,169260,169263,0,3,3
48295,1,1,169261,169263,169264,2,3,0
48296,6,3,169267,169267,169270,0,3,3
48297,3,3,169270,169270,169273,0,3,0
48298,4,2,169274,169274,169276,0,2,1
48299,2,3,169276,169276,169279,0,3,0
48300,1,2,169277,169279,169281,2,4,0
48301,1,3,169278,169281,169284,3,6,0
48302,2,3,169280,169284,169287,4,7,0
48303,4,1,169284,169287,169288,3,4,0
48304,6,3,169290,169290,169293,0,3,2
48305,5,3,169295,169295,169298,0,3,2
48306,4,2,169299,169299,169301,0,2,1
48307,1,3,169300,169301,169304,1,4,0
48308,3,3,169303,169304,169307,1,4,0
48309,3,3,169306,169307,169310,1,4,0
48310,3,1,169309,169310,169311,1,2,0
48311,1,2,169310,169311,169313,1,3,0
48312,5,3,169315,169315,169318,0,3,2
48313,2,2,169317,169318,169320,1,3,0
48314,1,1,169318,169320,169321,2,3,0
48315,4,2,169322,169322,169324,0,2,1
48316,3,2,169325,169325,169327,0,2,1
48317,6,1,169331,169331,169332,0,1,4
48318,6,3,169337,169337,169340,0,3,5
48319,6,2,169343,169343,169345,0,2,3
48320,6,3,169349,169349,169352,0,3,4
48321,3,1,169352,169352,169353,0,1,0
48322,4,3,169356,169356,169359,0,3,3
48323,3,1,169359,169359,169360,0,1,0
48324,6,1,169365,169365,169366,0,1,5
48325,5,2,169370,169370,169372,0,2,4
48326,5,2,169375,169375,169377,0,2,3
48327,2,3,169377,169377,169380,0,3,0
48328,1,1,169378,169380,169381,2,3,0
48329,3,2,169381,169381,169383,0,2,0
48330,5,2,169386,169386,169388,0,2,3
48331,4,1,169390,169390,169391,0,1,2
48332,3,1,169393,169393,169394,0,1,2
48333,5,1,169398,169398,169399,0,1,4
48334,3,3,169401,169401,169404,0,3,2
48335,6,2,169407,169407,169409,0,2,3
48336,3,3,169410,169410,169413,0,3,1
48337,4,1,169414,169414,169415,0,1,1
48338,4,1,169418,169418,169419,0,1,3
48339,1,1,169419,169419,169420,0,1,0
48340,2,2,169421,169421,169423,0,2,1
48341,2,1,169423,169423,169424,0,1,0
48342,1,1,169424,169424,169425,0,1,0
48343,3,3,169427,169427,169430,0,3,2
48344,4,3,169431,169431,169434,0,3,1
48345,5,2,169436,169436,169438,0,2,2
48346,6,2,169442,169442,169444,0,2,4
48347,6,1,169448,169448,169449,0,1,4
48348,2,3,169450,169450,169453,0,3,1
48349,1,1,169451,169453,169454,2,3,0
48350,1,2,169452,169454,169456,2,4,0
48351,1,3,169453,169456,169459,3,6,0
48352,4,3,169457,169459,169462,2,5,0
48353,4,1,169461,169462,169463,1,2,0
48354,1,3,169462,169463,169466,1,4,0
48355,6,2,169468,169468,169470,0,2,2
48356,2,1,169470,169470,169471,0,1,0
48357,4,2,169474,169474,169476,0,2,3
48358,1,2,169475,169476,169478,1,3,0
48359,6,3,169481,169481,169484,0,3,3
48360,1,2,169482,169484,169486,2,4,0
48361,4,1,169486,169486,169487,0,1,0
48362,3,1,169489,169489,169490,0,1,2
48363,3,3,169492,169492,169495,0,3,2
48364,1,2,169493,169495,169497,2,4,0
48365,2,1,169495,169497,169498,2,3,0
48366,2,3,169497,169498,169501,1,4,0
48367,6,2,169503,169503,169505,0,2,2
48368,3,1,169506,169506,169507,0,1,1
48369,6,3,169512,169512,169515,0,3,5
48370,1,1,169513,169515,169516,2,3,0
48371,6,3,169519,169519,169522,0,3,3
48372,2,3,169521,169522,169525,1,4,0
48373,5,3,169526,169526,169529,0,3,1
48374,5,2,169531,169531,169533,0,2,2
48375,1,1,169532,169533,169534,1,2,0
48376,2,3,169534,169534,169537,0,3,0
48377,6,2,169540,169540,169542,0,2,3
48378,6,3,169546,169546,169549,0,3,4
48379,4,3,169550,169550,169553,0,3,1
48380,1,2,169551,169553,169555,2,4,0
48381,2,3,169553,169555,169558,2,5,0
48382,5,3,169558,169558,169561,0,3,0
48383,5,3,169563,169563,169566,0,3,2
48384,1,1,169564,169566,169567,2,3,0
48385,1,3,169565,169567,169570,2,5,0
48386,1,2,169566,169570,169572,4,6,0
48387,5,3,169571,169572,169575,1,4,0
48388,6,2,169577,169577,169579,0,2,2
48389,5,2,169582,169582,169584,0,2,3
48390,4,3,169586,169586,169589,0,3,2
48391,5,3,169591,169591,169594,0,3,2
48392,1,1,169592,169594,169595,2,3,0
48393,3,3,169595,169595,169598,0,3,0
48394,2,2,169597,169598,169600,1,3,0
48395,4,2,169601,169601,169603,0,2,1
48396,3,2,169604,169604,169606,0,2,1
48397,6,3,169610,169610,169613,0,3,4
48398,6,2,169616,169616,169618,0,2,3
48399,2,2,169618,169618,169620,0,2,0
48400,6,2,169624,169624,169626,0,2,4
48401,1,3,169625,169626,169629,1,4,0
48402,1,3,169626,169629,169632,3,6,0
48403,5,3,169631,169632,169635,1,4,0
48404,6,1,169637,169637,169638,0,1,2
48405,5,3,169642,169642,169645,0,3,4
48406,1,1,169643,169645,169646,2,3,0
48407,2,2,169645,169646,169648,1,3,0
48408,6,2,169651,169651,169653,0,2,3
48409,4,1,169655,169655,169656,0,1,2
48410,4,2,169659,169659,169661,0,2,3
48411,4,3,169663,169663,169666,0,3,2
48412,2,2,169665,169666,169668,1,3,0
48413,6,3,169671,169671,169674,0,3,3
48414,2,3,169673,169674,169677,1,4,0
48415,5,2,169678,169678,169680,0,2,1
48416,3,3,169681,169681,169684,0,3,1
48417,6,2,169687,169687,169689,0,2,3
48418,4,1,169691,169691,169692,0,1,2
48419,3,1,169694,169694,169695,0,1,2
48420,5,2,169699,169699,169701,0,2,4
48421,4,3,169703,169703,169706,0,3,2
48422,4,3,169707,169707,169710,0,3,1
48423,2,3,169709,169710,169713,1,4,0
48424,5,3,169714,169714,169717,0,3,1
48425,6,2,169720,169720,169722,0,2,3
48426,5,1,169725,169725,169726,0,1,3
48427,2,2,169727,169727,169729,0,2,1
48428,6,3,169733,169733,169736,0,3,4
48429,1,3,169734,169736,169739,2,5,0
48430,2,3,169736,169739,169742,3,6,0
48431,2,3,169738,169742,169745,4,7,0
48432,2,1,169740,169745,169746,5,6,0
48433,2,3,169742,169746,169749,4,7,0
48434,3,2,169745,169749,169751,4,6,0
48435,5,1,169750,169751,169752,1,2,0
48436,6,2,169756,169756,169758,0,2,4
48437,6,3,169762,169762,169765,0,3,4
48438,3,3,169765,169765,169768,0,3,0
48439,1,1,169766,169768,169769,2,3,0
48440,5,2,169771,169771,169773,0,2,2
48441,5,1,169776,169776,169777,0,1,3
48442,3,2,169779,169779,169781,0,2,2
48443,6,3,169785,169785,169788,0,3,4
48444,5,2,169790,169790,169792,0,2,2
48445,3,2,169793,169793,169795,0,2,1
48446,1,1,169794,169795,169796,1,2,0
48447,6,1,169800,169800,169801,0,1,4
48448,6,3,169806,169806,169809,0,3,5
48449,2,2,169808,169809,169811,1,3,0
48450,1,3,169809,169811,169814,2,5,0
48451,3,3,169812,169814,169817,2,5,0
48452,6,2,169818,169818,169820,0,2,1
48453,3,2,169821,169821,169823,0,2,1
48454,6,1,169827,169827,169828,0,1,4
48455,2,1,169829,169829,169830,0,1,1
48456,1,2,169830,169830,169832,0,2,0
48457,4,3,169834,169834,169837,0,3,2
48458,5,1,169839,169839,169840,0,1,2
48459,2,3,169841,169841,169844,0,3,1
48460,5,2,169846,169846,169848,0,2,2
48461,3,1,169849,169849,169850,0,1,1
48462,1,2,169850,169850,169852,0,2,0
48463,2,2,169852,169852,169854,0,2,0
48464,2,3,169854,169854,169857,0,3,0
48465,2,3,169856,169857,169860,1,4,0
48466,2,3,169858,169860,169863,2,5,0
48467,6,3,169864,169864,169867,0,3,1
48468,3,1,169867,169867,169868,0,1,0
48469,2,1,169869,169869,169870,0,1,1
48470,3,2,169872,169872,169874,0,2,2
48471,1,3,169873,169874,169877,1,4,0
48472,6,1,169879,169879,169880,0,1,2
48473,2,3,169881,169881,169884,0,3,1
48474,4,2,169885,169885,169887,0,2,1
48475,4,3,169889,169889,169892,0,3,2
48476,1,1,169890,169892,169893,2,3,0
48477,1,2,169891,169893,169895,2,4,0
48478,1,3,169892,169895,169898,3,6,0
48479,1,2,169893,169898,169900,5,7,0
48480,3,2,169896,169900,169902,4,6,0
48481,6,3,169902,169902,169905,0,3,0
48482,1,2,169903,169905,169907,2,4,0
48483,1,2,169904,169907,169909,3,5,0
48484,5,1,169909,169909,169910,0,1,0
48485,4,3,169913,169913,169916,0,3,3
48486,6,2,169919,169919,169921,0,2,3
48487,3,3,169922,169922,169925,0,3,1
48488,2,1,169924,169925,169926,1,2,0
48489,3,2,169927,169927,169929,0,2,1
48490,6,3,169933,169933,169936,0,3,4
48491,2,2,169935,169936,169938,1,3,0
48492,3,3,169938,169938,169941,0,3,0
48493,2,2,169940,169941,169943,1,3,0
48494,5,1,169945,169945,169946,0,1,2
48495,6,3,169951,169951,169954,0,3,5
48496,5,1,169956,169956,169957,0,1,2
48497,2,2,169958,169958,169960,0,2,1
48498,2,2,169960,169960,169962,0,2,0
48499,2,2,169962,169962,169964,0,2,0
48500,1,3,169963,169964,169967,1,4,0
48501,1,2,169964,169967,169969,3,5,0
48502,1,1,169965,169969,169970,4,5,0
48503,6,2,169971,169971,169973,0,2,1
48504,6,1,169977,169977,169978,0,1,4
48505,4,3,169981,169981,169984,0,3,3
48506,4,2,169985,169985,169987,0,2,1
48507,5,3,169990,169990,169993,0,3,3
48508,2,1,169992,169993,169994,1,2,0
48509,1,1,169993,169994,169995,1,2,0
48510,1,2,169994,169995,169997,1,3,0
48511,6,3,170000,170000,170003,0,3,3
48512,2,1,170002,170003,170004,1,2,0
48513,6,2,170008,170008,170010,0,2,4
48514,3,2,170011,170011,170013,0,2,1
48515,5,2,170016,170016,170018,0,2,3
48516,5,2,170021,170021,170023,0,2,3
48517,4,1,170025,170025,170026,0,1,2
48518,6,1,170031,170031,170032,0,1,5
48519,5,1,170036,170036,170037,0,1,4
48520,3,2,170039,170039,170041,0,2,2
48521,5,2,170044,170044,170046,0,2,3
48522,4,3,170048,170048,170051,0,3,2
48523,3,2,170051,170051,170053,0,2,0
48524,1,1,170052,170053,170054,1,2,0
48525,4,2,170056,170056,170058,0,2,2
48526,5,1,170061,170061,170062,0,1,3
48527,4,2,170065,170065,170067,0,2,3
48528,4,3,170069,170069,170072,0,3,2
48529,1,1,170070,170072,170073,2,3,0
48530,1,1,170071,170073,170074,2,3,0
48531,3,2,170074,170074,170076,0,2,0
48532,1,3,170075,170076,170079,1,4,0
48533,6,2,170081,170081,170083,0,2,2
48534,6,1,170087,170087,170088,0,1,4
48535,5,1,170092,170092,170093,0,1,4
48536,1,2,170093,170093,170095,0,2,0
48537,4,2,170097,170097,170099,0,2,2
48538,6,1,170103,170103,170104,0,1,4
48539,1,2,170104,170104,170106,0,2,0
48540,1,3,170105,170106,170109,1,4,0
48541,2,3,170107,170109,170112,2,5,0
48542,5,3,170112,170112,170115,0,3,0
48543,3,1,170115,170115,170116,0,1,0
48544,4,2,170119,170119,170121,0,2,3
48545,5,3,170124,170124,170127,0,3,3
48546,5,1,170129,170129,170130,0,1,2
48547,5,2,170134,170134,170136,0,2,4
48548,4,1,170138,170138,170139,0,1,2
48549,5,3,170143,170143,170146,0,3,4
48550,1,3,170144,170146,170149,2,5,0
48551,6,1,170150,170150,170151,0,1,1
48552,6,2,170156,170156,170158,0,2,5
48553,4,1,170160,170160,170161,0,1,2
48554,3,3,170163,170163,170166,0,3,2
48555,6,2,170169,170169,170171,0,2,3
48556,6,1,170175,170175,170176,0,1,4
48557,1,2,170176,170176,170178,0,2,0
48558,3,2,170179,170179,170181,0,2,1
48559,3,1,170182,170182,170183,0,1,1
48560,3,2,170185,170185,170187,0,2,2
48561,1,2,170186,170187,170189,1,3,0
48562,1,1,170187,170189,170190,2,3,0
48563,1,3,170188,170190,170193,2,5,0
48564,4,1,170192,170193,170194,1,2,0
48565,3,3,170195,170195,170198,0,3,1
48566,5,1,170200,170200,170201,0,1,2
48567,5,3,170205,170205,170208,0,3,4
48568,5,2,170210,170210,170212,0,2,2
48569,4,2,170214,170214,170216,0,2,2
48570,5,2,170219,170219,170221,0,2,3
48571,1,3,170220,170221,170224,1,4,0
48572,3,3,170223,170224,170227,1,4,0
48573,5,1,170228,170228,170229,0,1,1
48574,3,2,170231,170231,170233,0,2,2
48575,3,1,170234,170234,170235,0,1,1
48576,1,2,170235,170235,170237,0,2,0
48577,5,3,170240,170240,170243,0,3,3
48578,6,3,170246,170246,170249,0,3,3
48579,6,2,170252,170252,170254,0,2,3
48580,2,1,170254,170254,170255,0,1,0
48581,3,3,170257,170257,170260,0,3,2
48582,3,2,170260,170260,170262,0,2,0
48583,2,2,170262,170262,170264,0,2,0
48584,3,2,170265,170265,170267,0,2,1
48585,2,1,170267,170267,170268,0,1,0
48586,2,2,170269,170269,170271,0,2,1
48587,3,2,170272,170272,170274,0,2,1
48588,1,1,170273,170274,170275,1,2,0
48589,2,1,170275,170275,170276,0,1,0
48590,1,2,170276,170276,170278,0,2,0
48591,5,1,170281,170281,170282,0,1,3
48592,6,3,170287,170287,170290,0,3,5
48593,3,3,170290,170290,170293,0,3,0
48594,4,2,170294,170294,170296,0,2,1
48595,4,3,170298,170298,170301,0,3,2
48596,3,1,170301,170301,170302,0,1,0
48597,5,1,170306,170306,170307,0,1,4
48598,3,1,170309,170309,170310,0,1,2
48599,1,2,170310,170310,170312,0,2,0
48600,6,3,170316,170316,170319,0,3,4
48601,6,2,170322,170322,170324,0,2,3
48602,2,2,170324,170324,170326,0,2,0
48603,2,3,170326,170326,170329,0,3,0
48604,2,3,170328,170329,170332,1,4,0
48605,1,3,170329,170332,170335,3,6,0
48606,6,1,170335,170335,170336,0,1,0
48607,2,2,170337,170337,170339,0,2,1
48608,2,2,170339,170339,170341,0,2,0
48609,2,2,170341,170341,170343,0,2,0
48610,2,1,170343,170343,170344,0,1,0
48611,5,2,170348,170348,170350,0,2,4
48612,6,1,170354,170354,170355,0,1,4
48613,1,2,170355,170355,170357,0,2,0
48614,2,1,170357,170357,170358,0,1,0
48615,2,1,170359,170359,170360,0,1,1
48616,6,1,170365,170365,170366,0,1,5
48617,1,2,170366,170366,170368,0,2,0
48618,4,3,170370,170370,170373,0,3,2
48619,5,3,170375,170375,170378,0,3,2
48620,3,1,170378,170378,170379,0,1,0
48621,1,3,170379,170379,170382,0,3,0
48622,2,2,170381,170382,170384,1,3,0
48623,5,3,170386,170386,170389,0,3,2
48624,2,2,170388,170389,170391,1,3,0
48625,5,3,170393,170393,170396,0,3,2
48626,4,2,170397,170397,170399,0,2,1
48627,3,2,170400,170400,170402,0,2,1
48628,4,2,170404,170404,170406,0,2,2
48629,5,2,170409,170409,170411,0,2,3
48630,2,2,170411,170411,170413,0,2,0
48631,2,1,170413,170413,170414,0,1,0
48632,6,1,170419,170419,170420,0,1,5
48633,3,1,170422,170422,170423,0,1,2
48634,2,3,170424,170424,170427,0,3,1
48635,3,3,170427,170427,170430,0,3,0
48636,5,1,170432,170432,170433,0,1,2
48637,2,2,170434,170434,170436,0,2,1
48638,3,1,170437,170437,170438,0,1,1
48639,4,1,170441,170441,170442,0,1,3
48640,5,1,170446,170446,170447,0,1,4
48641,2,2,170448,170448,170450,0,2,1
48642,5,2,170453,170453,170455,0,2,3
48643,4,2,170457,170457,170459,0,2,2
48644,4,2,170461,170461,170463,0,2,2
48645,4,2,170465,170465,170467,0,2,2
48646,3,1,170468,170468,170469,0,1,1
48647,2,2,170470,170470,170472,0,2,1
48648,2,2,170472,170472,170474,0,2,0
48649,6,3,170478,170478,170481,0,3,4
48650,2,3,170480,170481,170484,1,4,0
48651,5,2,170485,170485,170487,0,2,1
48652,1,3,170486,170487,170490,1,4,0
48653,6,2,170492,170492,170494,0,2,2
48654,3,2,170495,170495,170497,0,2,1
48655,5,1,170500,170500,170501,0,1,3
48656,1,3,170501,170501,170504,0,3,0
48657,5,1,170506,170506,170507,0,1,2
48658,4,3,170510,170510,170513,0,3,3
48659,1,3,170511,170513,170516,2,5,0
48660,1,2,170512,170516,170518,4,6,0
48661,5,3,170517,170518,170521,1,4,0
48662,2,2,170519,170521,170523,2,4,0
48663,4,2,170523,170523,170525,0,2,0
48664,1,2,170524,170525,170527,1,3,0
48665,3,1,170527,170527,170528,0,1,0
48666,4,3,170531,170531,170534,0,3,3
48667,5,2,170536,170536,170538,0,2,2
48668,6,2,170542,170542,170544,0,2,4
48669,1,1,170543,170544,170545,1,2,0
48670,4,3,170547,170547,170550,0,3,2
48671,6,1,170553,170553,170554,0,1,3
48672,3,2,170556,170556,170558,0,2,2
48673,5,1,170561,170561,170562,0,1,3
48674,6,3,170567,170567,170570,0,3,5
48675,3,1,170570,170570,170571,0,1,0
48676,5,1,170575,170575,170576,0,1,4
48677,2,1,170577,170577,170578,0,1,1
48678,3,3,170580,170580,170583,0,3,2
48679,2,2,170582,170583,170585,1,3,0
48680,5,1,170587,170587,170588,0,1,2
48681,2,3,170589,170589,170592,0,3,1
48682,6,3,170595,170595,170598,0,3,3
48683,6,3,170601,170601,170604,0,3,3
48684,2,2,170603,170604,170606,1,3,0
48685,3,1,170606,170606,170607,0,1,0
48686,6,2,170612,170612,170614,0,2,5
48687,4,1,170616,170616,170617,0,1,2
48688,5,3,170621,170621,170624,0,3,4
48689,2,2,170623,170624,170626,1,3,0
48690,3,1,170626,170626,170627,0,1,0
48691,3,2,170629,170629,170631,0,2,2
48692,2,1,170631,170631,170632,0,1,0
48693,1,2,170632,170632,170634,0,2,0
48694,5,1,170637,170637,170638,0,1,3
48695,1,1,170638,170638,170639,0,1,0
48696,6,1,170644,170644,170645,0,1,5
48697,4,2,170648,170648,170650,0,2,3
48698,2,1,170650,170650,170651,0,1,0
48699,6,1,170656,170656,170657,0,1,5
48700,6,1,170662,170662,170663,0,1,5
48701,6,1,170668,170668,170669,0,1,5
48702,3,2,170671,170671,170673,0,2,2
48703,4,2,170675,170675,170677,0,2,2
48704,3,1,170678,170678,170679,0,1,1
48705,4,2,170682,170682,170684,0,2,3
48706,3,3,170685,170685,170688,0,3,1
48707,5,1,170690,170690,170691,0,1,2
48708,1,3,170691,170691,170694,0,3,0
48709,5,1,170696,170696,170697,0,1,2
48710,2,3,170698,170698,170701,0,3,1
48711,1,3,170699,170701,170704,2,5,0
48712,5,2,170704,170704,170706,0,2,0
48713,6,1,170710,170710,170711,0,1,4
48714,2,1,170712,170712,170713,0,1,1
48715,4,2,170716,170716,170718,0,2,3
48716,1,3,170717,170718,170721,1,4,0
48717,1,2,170718,170721,170723,3,5,0
48718,4,3,170722,170723,170726,1,4,0
48719,2,1,170724,170726,170727,2,3,0
48720,6,3,170730,170730,170733,0,3,3
48721,4,1,170734,170734,170735,0,1,1
48722,6,2,170740,170740,170742,0,2,5
48723,2,1,170742,170742,170743,0,1,0
48724,5,2,170747,170747,170749,0,2,4
48725,3,2,170750,170750,170752,0,2,1
48726,6,1,170756,170756,170757,0,1,4
48727,4,2,170760,170760,170762,0,2,3
48728,5,1,170765,170765,170766,0,1,3
48729,5,3,170770,170770,170773,0,3,4
48730,1,2,170771,170773,170775,2,4,0
48731,3,1,170774,170775,170776,1,2,0
48732,3,1,170777,170777,170778,0,1,1
48733,5,3,170782,170782,170785,0,3,4
48734,5,3,170787,170787,170790,0,3,2
48735,1,2,170788,170790,170792,2,4,0
48736,2,2,170790,170792,170794,2,4,0
48737,4,2,170794,170794,170796,0,2,0
48738,6,3,170800,170800,170803,0,3,4
48739,4,3,170804,170804,170807,0,3,1
48740,5,3,170809,170809,170812,0,3,2
48741,2,3,170811,170812,170815,1,4,0
48742,2,3,170813,170815,170818,2,5,0
48743,5,1,170818,170818,170819,0,1,0
48744,5,1,170823,170823,170824,0,1,4
48745,5,1,170828,170828,170829,0,1,4
48746,6,3,170834,170834,170837,0,3,5
48747,6,3,170840,170840,170843,0,3,3
48748,5,2,170845,170845,170847,0,2,2
48749,1,3,170846,170847,170850,1,4,0
48750,5,2,170851,170851,170853,0,2,1
48751,3,2,170854,170854,170856,0,2,1
48752,5,2,170859,170859,170861,0,2,3
48753,1,1,170860,170861,170862,1,2,0
48754,2,3,170862,170862,170865,0,3,0
48755,3,3,170865,170865,170868,0,3,0
48756,1,1,170866,170868,170869,2,3,0
48757,2,2,170868,170869,170871,1,3,0
48758,1,2,170869,170871,170873,2,4,0
48759,3,2,170872,170873,170875,1,3,0
48760,4,3,170876,170876,170879,0,3,1
48761,5,2,170881,170881,170883,0,2,2
48762,1,2,170882,170883,170885,1,3,0
48763,6,1,170888,170888,170889,0,1,3
48764,2,3,170890,170890,170893,0,3,1
48765,5,2,170895,170895,170897,0,2,2
48766,6,1,170901,170901,170902,0,1,4
48767,4,3,170905,170905,170908,0,3,3
48768,5,3,170910,170910,170913,0,3,2
48769,5,1,170915,170915,170916,0,1,2
48770,1,3,170916,170916,170919,0,3,0
48771,6,2,170922,170922,170924,0,2,3
48772,2,1,170924,170924,170925,0,1,0
48773,4,2,170928,170928,170930,0,2,3
48774,6,3,170934,170934,170937,0,3,4
48775,1,2,170935,170937,170939,2,4,0
48776,6,2,170941,170941,170943,0,2,2
48777,3,3,170944,170944,170947,0,3,1
48778,5,3,170949,170949,170952,0,3,2
48779,1,2,170950,170952,170954,2,4,0
48780,1,2,170951,170954,170956,3,5,0
48781,5,3,170956,170956,170959,0,3,0
48782,5,3,170961,170961,170964,0,3,2
48783,1,1,170962,170964,170965,2,3,0
48784,1,1,170963,170965,170966,2,3,0
48785,3,2,170966,170966,170968,0,2,0
48786,1,3,170967,170968,170971,1,4,0
48787,4,2,170971,170971,170973,0,2,0
48788,4,2,170975,170975,170977,0,2,2
48789,3,1,170978,170978,170979,0,1,1
48790,5,1,170983,170983,170984,0,1,4
48791,5,3,170988,170988,170991,0,3,4
48792,2,2,170990,170991,170993,1,3,0
48793,2,1,170992,170993,170994,1,2,0
48794,3,1,170995,170995,170996,0,1,1
48795,1,2,170996,170996,170998,0,2,0
48796,1,3,170997,170998,171001,1,4,0
48797,5,1,171002,171002,171003,0,1,1
48798,6,2,171008,171008,171010,0,2,5
48799,1,2,171009,171010,171012,1,3,0
48800,6,2,171015,171015,171017,0,2,3
48801,1,2,171016,171017,171019,1,3,0
48802,5,2,171021,171021,171023,0,2,2
48803,6,3,171027,171027,171030,0,3,4
48804,5,2,171032,171032,171034,0,2,2
48805,2,1,171034,171034,171035,0,1,0
48806,2,2,171036,171036,171038,0,2,1
48807,5,1,171041,171041,171042,0,1,3
48808,3,1,171044,171044,171045,0,1,2
48809,2,2,171046,171046,171048,0,2,1
48810,1,1,171047,171048,171049,1,2,0
48811,4,1,171051,171051,171052,0,1,2
48812,5,3,171056,171056,171059,0,3,4
48813,6,3,171062,171062,171065,0,3,3
48814,1,1,171063,171065,171066,2,3,0
48815,1,3,171064,171066,171069,2,5,0
48816,4,2,171068,171069,171071,1,3,0
48817,5,2,171073,171073,171075,0,2,2
48818,4,3,171077,171077,171080,0,3,2
48819,4,3,171081,171081,171084,0,3,1
48820,5,2,171086,171086,171088,0,2,2
48821,5,2,171091,171091,171093,0,2,3
48822,2,3,171093,171093,171096,0,3,0
48823,5,3,171098,171098,171101,0,3,2
48824,5,1,171103,171103,171104,0,1,2
48825,4,3,171107,171107,171110,0,3,3
48826,4,2,171111,171111,171113,0,2,1
48827,6,3,171117,171117,171120,0,3,4
48828,5,3,171122,171122,171125,0,3,2
48829,3,1,171125,171125,171126,0,1,0
48830,5,1,171130,171130,171131,0,1,4
48831,5,1,171135,171135,171136,0,1,4
48832,2,1,171137,171137,171138,0,1,1
48833,3,2,171140,171140,171142,0,2,2
48834,6,1,171146,171146,171147,0,1,4
48835,1,3,171147,171147,171150,0,3,0
48836,1,3,171148,171150,171153,2,5,0
48837,1,3,171149,171153,171156,4,7,0
48838,5,3,171154,171156,171159,2,5,0
48839,2,3,171156,171159,171162,3,6,0
48840,3,2,171159,171162,171164,3,5,0
48841,2,2,171161,171164,171166,3,5,0
48842,5,3,171166,171166,171169,0,3,0
48843,1,2,171167,171169,171171,2,4,0
48844,1,2,171168,171171,171173,3,5,0
48845,5,1,171173,171173,171174,0,1,0
48846,2,3,171175,171175,171178,0,3,1
48847,2,2,171177,171178,171180,1,3,0
48848,2,3,171179,171180,171183,1,4,0
48849,4,2,171183,171183,171185,0,2,0
48850,2,3,171185,171185,171188,0,3,0
48851,6,3,171191,171191,171194,0,3,3
48852,1,2,171192,171194,171196,2,4,0
48853,6,1,171198,171198,171199,0,1,2
48854,6,2,171204,171204,171206,0,2,5
48855,2,1,171206,171206,171207,0,1,0
48856,4,3,171210,171210,171213,0,3,3
48857,2,2,171212,171213,171215,1,3,0
48858,1,3,171213,171215,171218,2,5,0
48859,5,3,171218,171218,171221,0,3,0
48860,3,1,171221,171221,171222,0,1,0
48861,5,2,171226,171226,171228,0,2,4
48862,4,1,171230,171230,171231,0,1,2
48863,1,1,171231,171231,171232,0,1,0
48864,5,3,171236,171236,171239,0,3,4
48865,1,3,171237,171239,171242,2,5,0
48866,3,1,171240,171242,171243,2,3,0
48867,4,2,171244,171244,171246,0,2,1
48868,3,1,171247,171247,171248,0,1,1
48869,4,1,171251,171251,171252,0,1,3
48870,4,2,171255,171255,171257,0,2,3
48871,6,2,171261,171261,171263,0,2,4
48872,1,2,171262,171263,171265,1,3,0
48873,5,2,171267,171267,171269,0,2,2
48874,5,1,171272,171272,171273,0,1,3
48875,3,2,171275,171275,171277,0,2,2
48876,1,3,171276,171277,171280,1,4,0
48877,1,2,171277,171280,171282,3,5,0
48878,1,2,171278,171282,171284,4,6,0
48879,3,2,171281,171284,171286,3,5,0
48880,2,3,171283,171286,171289,3,6,0
48881,5,1,171288,171289,171290,1,2,0
48882,1,2,171289,171290,171292,1,3,0
48883,5,2,171294,171294,171296,0,2,2
48884,1,2,171295,171296,171298,1,3,0
48885,5,1,171300,171300,171301,0,1,2
48886,4,2,171304,171304,171306,0,2,3
48887,2,2,171306,171306,171308,0,2,0
48888,1,2,171307,171308,171310,1,3,0
48889,4,2,171311,171311,171313,0,2,1
48890,6,1,171317,171317,171318,0,1,4
48891,6,1,171323,171323,171324,0,1,5
48892,1,1,171324,171324,171325,0,1,0
48893,6,2,171330,171330,171332,0,2,5
48894,6,1,171336,171336,171337,0,1,4
48895,3,3,171339,171339,171342,0,3,2
48896,2,2,171341,171342,171344,1,3,0
48897,6,1,171347,171347,171348,0,1,3
48898,6,3,171353,171353,171356,0,3,5
48899,3,2,171356,171356,171358,0,2,0
48900,3,2,171359,171359,171361,0,2,1
48901,6,3,171365,171365,171368,0,3,4
48902,4,1,171369,171369,171370,0,1,1
48903,3,1,171372,171372,171373,0,1,2
48904,6,3,171378,171378,171381,0,3,5
48905,6,2,171384,171384,171386,0,2,3
48906,2,2,171386,171386,171388,0,2,0
48907,5,3,171391,171391,171394,0,3,3
48908,4,1,171395,171395,171396,0,1,1
48909,5,1,171400,171400,171401,0,1,4
48910,5,2,171405,171405,171407,0,2,4
48911,5,2,171410,171410,171412,0,2,3
48912,2,3,171412,171412,171415,0,3,0
48913,5,1,171417,171417,171418,0,1,2
48914,6,1,171423,171423,171424,0,1,5
48915,2,3,171425,171425,171428,0,3,1
48916,2,2,171427,171428,171430,1,3,0
48917,6,3,171433,171433,171436,0,3,3
48918,2,3,171435,171436,171439,1,4,0
48919,2,1,171437,171439,171440,2,3,0
48920,4,3,171441,171441,171444,0,3,1
48921,5,2,171446,171446,171448,0,2,2
48922,1,1,171447,171448,171449,1,2,0
48923,5,3,171452,171452,171455,0,3,3
48924,1,2,171453,171455,171457,2,4,0
48925,5,1,171458,171458,171459,0,1,1
48926,1,3,171459,171459,171462,0,3,0
48927,6,3,171465,171465,171468,0,3,3
48928,6,3,171471,171471,171474,0,3,3
48929,6,2,171477,171477,171479,0,2,3
48930,3,2,171480,171480,171482,0,2,1
48931,1,2,171481,171482,171484,1,3,0
48932,1,2,171482,171484,171486,2,4,0
48933,2,2,171484,171486,171488,2,4,0
48934,1,3,171485,171488,171491,3,6,0
48935,2,1,171487,171491,171492,4,5,0
48936,5,1,171492,171492,171493,0,1,0
48937,6,2,171498,171498,171500,0,2,5
48938,6,1,171504,171504,171505,0,1,4
48939,3,3,171507,171507,171510,0,3,2
48940,3,2,171510,171510,171512,0,2,0
48941,4,3,171514,171514,171517,0,3,2
48942,6,3,171520,171520,171523,0,3,3
48943,4,2,171524,171524,171526,0,2,1
48944,3,3,171527,171527,171530,0,3,1
48945,2,2,171529,171530,171532,1,3,0
48946,2,3,171531,171532,171535,1,4,0
48947,2,3,171533,171535,171538,2,5,0
48948,6,2,171539,171539,171541,0,2,1
48949,6,2,171545,171545,171547,0,2,4
48950,2,1,171547,171547,171548,0,1,0
48951,5,2,171552,171552,171554,0,2,4
48952,2,2,171554,171554,171556,0,2,0
48953,4,2,171558,171558,171560,0,2,2
48954,3,2,171561,171561,171563,0,2,1
48955,3,3,171564,171564,171567,0,3,1
48956,2,1,171566,171567,171568,1,2,0
48957,2,2,171568,171568,171570,0,2,0
48958,4,3,171572,171572,171575,0,3,2
48959,5,2,171577,171577,171579,0,2,2
48960,1,3,171578,171579,171582,1,4,0
48961,3,3,171581,171582,171585,1,4,0
48962,1,1,171582,171585,171586,3,4,0
48963,2,2,171584,171586,171588,2,4,0
48964,5,1,171589,171589,171590,0,1,1
48965,1,3,171590,171590,171593,0,3,0
48966,6,3,171596,171596,171599,0,3,3
48967,6,2,171602,171602,171604,0,2,3
48968,6,1,171608,171608,171609,0,1,4
48969,5,2,171613,171613,171615,0,2,4
48970,6,1,171619,171619,171620,0,1,4
48971,3,1,171622,171622,171623,0,1,2
48972,5,3,171627,171627,171630,0,3,4
48973,3,2,171630,171630,171632,0,2,0
48974,6,2,171636,171636,171638,0,2,4
48975,6,1,171642,171642,171643,0,1,4
48976,5,1,171647,171647,171648,0,1,4
48977,2,3,171649,171649,171652,0,3,1
48978,5,3,171654,171654,171657,0,3,2
48979,5,2,171659,171659,171661,0,2,2
48980,5,3,171664,171664,171667,0,3,3
48981,1,2,171665,171667,171669,2,4,0
48982,2,1,171667,171669,171670,2,3,0
48983,2,2,171669,171670,171672,1,3,0
48984,6,2,171675,171675,171677,0,2,3
48985,6,1,171681,171681,171682,0,1,4
48986,6,1,171687,171687,171688,0,1,5
48987,6,2,171693,171693,171695,0,2,5
48988,1,2,171694,171695,171697,1,3,0
48989,4,1,171698,171698,171699,0,1,1
48990,4,1,171702,171702,171703,0,1,3
48991,6,1,171708,171708,171709,0,1,5
48992,1,2,171709,171709,171711,0,2,0
48993,5,3,171714,171714,171717,0,3,3
48994,4,3,171718,171718,171721,0,3,1
48995,2,2,171720,171721,171723,1,3,0
48996,2,3,171722,171723,171726,1,4,0
48997,2,1,171724,171726,171727,2,3,0
48998,1,3,171725,171727,171730,2,5,0
48999,4,3,171729,171730,171733,1,4,0
49000,4,2,171733,171733,171735,0,2,0
49001,6,3,171739,171739,171742,0,3,4
49002,4,2,171743,171743,171745,0,2,1
49003,2,3,171745,171745,171748,0,3,0
49004,1,2,171746,171748,171750,2,4,0
49005,4,3,171750,171750,171753,0,3,0
49006,6,1,171756,171756,171757,0,1,3
49007,1,3,171757,171757,171760,0,3,0
49008,4,2,171761,171761,171763,0,2,1
49009,6,3,171767,171767,171770,0,3,4
49010,3,3,171770,171770,171773,0,3,0
49011,4,1,171774,171774,171775,0,1,1
49012,5,2,171779,171779,171781,0,2,4
49013,3,3,171782,171782,171785,0,3,1
49014,2,1,171784,171785,171786,1,2,0
49015,4,2,171788,171788,171790,0,2,2
49016,3,2,171791,171791,171793,0,2,1
49017,3,3,171794,171794,171797,0,3,1
49018,1,3,171795,171797,171800,2,5,0
49019,6,3,171801,171801,171804,0,3,1
49020,4,3,171805,171805,171808,0,3,1
49021,2,2,171807,171808,171810,1,3,0
49022,6,3,171813,171813,171816,0,3,3
49023,5,1,171818,171818,171819,0,1,2
49024,3,1,171821,171821,171822,0,1,2
49025,2,3,171823,171823,171826,0,3,1
49026,2,3,171825,171826,171829,1,4,0
49027,2,2,171827,171829,171831,2,4,0
49028,4,1,171831,171831,171832,0,1,0
49029,4,3,171835,171835,171838,0,3,3
49030,6,3,171841,171841,171844,0,3,3
49031,2,2,171843,171844,171846,1,3,0
49032,6,1,171849,171849,171850,0,1,3
49033,5,2,171854,171854,171856,0,2,4
49034,3,1,171857,171857,171858,0,1,1
49035,4,3,171861,171861,171864,0,3,3
49036,3,2,171864,171864,171866,0,2,0
49037,1,1,171865,171866,171867,1,2,0
49038,2,2,171867,171867,171869,0,2,0
49039,2,3,171869,171869,171872,0,3,0
49040,5,1,171874,171874,171875,0,1,2
49041,1,2,171875,171875,171877,0,2,0
49042,3,2,171878,171878,171880,0,2,1
49043,4,1,171882,171882,171883,0,1,2
49044,1,1,171883,171883,171884,0,1,0
49045,3,3,171886,171886,171889,0,3,2
49046,3,1,171889,171889,171890,0,1,0
49047,3,2,171892,171892,171894,0,2,2
49048,3,2,171895,171895,171897,0,2,1
49049,6,3,171901,171901,171904,0,3,4
49050,3,2,171904,171904,171906,0,2,0
49051,3,3,171907,171907,171910,0,3,1
49052,1,1,171908,171910,171911,2,3,0
49053,5,3,171913,171913,171916,0,3,2
49054,3,1,171916,171916,171917,0,1,0
49055,2,2,171918,171918,171920,0,2,1
49056,2,2,171920,171920,171922,0,2,0
49057,1,2,171921,171922,171924,1,3,0
49058,4,1,171925,171925,171926,0,1,1
49059,2,3,171927,171927,171930,0,3,1
49060,6,1,171933,171933,171934,0,1,3
49061,6,1,171939,171939,171940,0,1,5
49062,6,3,171945,171945,171948,0,3,5
49063,1,2,171946,171948,171950,2,4,0
49064,6,2,171952,171952,171954,0,2,2
49065,3,3,171955,171955,171958,0,3,1
49066,3,2,171958,171958,171960,0,2,0
49067,2,3,171960,171960,171963,0,3,0
49068,1,3,171961,171963,171966,2,5,0
49069,3,3,171964,171966,171969,2,5,0
49070,4,2,171968,171969,171971,1,3,0
49071,3,2,171971,171971,171973,0,2,0
49072,6,3,171977,171977,171980,0,3,4
49073,1,3,171978,171980,171983,2,5,0
49074,3,2,171981,171983,171985,2,4,0
49075,5,3,171986,171986,171989,0,3,1
49076,5,1,171991,171991,171992,0,1,2
49077,2,2,171993,171993,171995,0,2,1
49078,6,3,171999,171999,172002,0,3,4
49079,2,2,172001,172002,172004,1,3,0
49080,3,3,172004,172004,172007,0,3,0
49081,4,3,172008,172008,172011,0,3,1
49082,5,1,172013,172013,172014,0,1,2
49083,1,2,172014,172014,172016,0,2,0
49084,1,3,172015,172016,172019,1,4,0
49085,5,1,172020,172020,172021,0,1,1
49086,1,2,172021,172021,172023,0,2,0
49087,4,2,172025,172025,172027,0,2,2
49088,5,2,172030,172030,172032,0,2,3
49089,3,2,172033,172033,172035,0,2,1
49090,3,2,172036,172036,172038,0,2,1
49091,3,2,172039,172039,172041,0,2,1
49092,5,3,172044,172044,172047,0,3,3
49093,5,2,172049,172049,172051,0,2,2
49094,1,1,172050,172051,172052,1,2,0
49095,4,1,172054,172054,172055,0,1,2
49096,5,2,172059,172059,172061,0,2,4
49097,1,2,172060,172061,172063,1,3,0
49098,3,1,172063,172063,172064,0,1,0
49099,4,3,172067,172067,172070,0,3,3
49100,4,1,172071,172071,172072,0,1,1
49101,3,1,172074,172074,172075,0,1,2
49102,3,2,172077,172077,172079,0,2,2
49103,6,3,172083,172083,172086,0,3,4
49104,5,3,172088,172088,172091,0,3,2
49105,4,3,172092,172092,172095,0,3,1
49106,1,3,172093,172095,172098,2,5,0
49107,5,3,172098,172098,172101,0,3,0
49108,5,2,172103,172103,172105,0,2,2
49109,6,2,172109,172109,172111,0,2,4
49110,1,3,172110,172111,172114,1,4,0
49111,6,3,172116,172116,172119,0,3,2
49112,1,2,172117,172119,172121,2,4,0
49113,6,2,172123,172123,172125,0,2,2
49114,3,2,172126,172126,172128,0,2,1
49115,3,3,172129,172129,172132,0,3,1
49116,4,1,172133,172133,172134,0,1,1
49117,5,3,172138,172138,172141,0,3,4
49118,3,2,172141,172141,172143,0,2,0
49119,3,1,172144,172144,172145,0,1,1
49120,2,2,172146,172146,172148,0,2,1
49121,1,3,172147,172148,172151,1,4,0
49122,1,2,172148,172151,172153,3,5,0
49123,5,1,172153,172153,172154,0,1,0
49124,5,2,172158,172158,172160,0,2,4
49125,5,2,172163,172163,172165,0,2,3
49126,6,3,172169,172169,172172,0,3,4
49127,4,3,172173,172173,172176,0,3,1
49128,5,1,172178,172178,172179,0,1,2
49129,4,1,172182,172182,172183,0,1,3
49130,4,1,172186,172186,172187,0,1,3
49131,1,2,172187,172187,172189,0,2,0
49132,6,3,172193,172193,172196,0,3,4
49133,1,1,172194,172196,172197,2,3,0
49134,4,3,172198,172198,172201,0,3,1
49135,4,1,172202,172202,172203,0,1,1
49136,2,3,172204,172204,172207,0,3,1
49137,6,1,172210,172210,172211,0,1,3
49138,2,3,172212,172212,172215,0,3,1
49139,3,3,172215,172215,172218,0,3,0
49140,6,3,172221,172221,172224,0,3,3
49141,6,2,172227,172227,172229,0,2,3
49142,2,3,172229,172229,172232,0,3,0
49143,5,2,172234,172234,172236,0,2,2
49144,4,3,172238,172238,172241,0,3,2
49145,5,2,172243,172243,172245,0,2,2
49146,1,3,172244,172245,172248,1,4,0
49147,5,3,172249,172249,172252,0,3,1
49148,4,1,172253,172253,172254,0,1,1
49149,5,1,172258,172258,172259,0,1,4
49150,6,3,172264,172264,172267,0,3,5
49151,5,1,172269,172269,172270,0,1,2
49152,3,1,172272,172272,172273,0,1,2
49153,4,3,172276,172276,172279,0,3,3
49154,3,2,172279,172279,172281,0,2,0
49155,3,2,172282,172282,172284,0,2,1
49156,6,1,172288,172288,172289,0,1,4
49157,5,1,172293,172293,172294,0,1,4
49158,6,3,172299,172299,172302,0,3,5
49159,3,3,172302,172302,172305,0,3,0
49160,4,3,172306,172306,172309,0,3,1
49161,2,1,172308,172309,172310,1,2,0
49162,2,3,172310,172310,172313,0,3,0
49163,4,1,172314,172314,172315,0,1,1
49164,5,3,172319,172319,172322,0,3,4
49165,1,3,172320,172322,172325,2,5,0
49166,6,1,172326,172326,172327,0,1,1
49167,3,3,172329,172329,172332,0,3,2
49168,2,2,172331,172332,172334,1,3,0
49169,2,3,172333,172334,172337,1,4,0
49170,3,3,172336,172337,172340,1,4,0
49171,5,1,172341,172341,172342,0,1,1
49172,5,2,172346,172346,172348,0,2,4
49173,3,2,172349,172349,172351,0,2,1
49174,3,1,172352,172352,172353,0,1,1
49175,3,2,172355,172355,172357,0,2,2
49176,3,3,172358,172358,172361,0,3,1
49177,6,3,172364,172364,172367,0,3,3
49178,2,3,172366,172367,172370,1,4,0
49179,4,2,172370,172370,172372,0,2,0
49180,3,2,172373,172373,172375,0,2,1
49181,1,1,172374,172375,172376,1,2,0
49182,5,2,172379,172379,172381,0,2,3
49183,5,1,172384,172384,172385,0,1,3
49184,2,1,172386,172386,172387,0,1,1
49185,1,1,172387,172387,172388,0,1,0
49186,5,2,172392,172392,172394,0,2,4
49187,5,2,172397,172397,172399,0,2,3
49188,4,1,172401,172401,172402,0,1,2
49189,4,3,172405,172405,172408,0,3,3
49190,6,3,172411,172411,172414,0,3,3
49191,4,3,172415,172415,172418,0,3,1
49192,2,2,172417,172418,172420,1,3,0
49193,2,1,172419,172420,172421,1,2,0
49194,3,1,172422,172422,172423,0,1,1
49195,2,1,172424,172424,172425,0,1,1
49196,5,1,172429,172429,172430,0,1,4
49197,2,3,172431,172431,172434,0,3,1
49198,6,2,172437,172437,172439,0,2,3
49199,3,3,172440,172440,172443,0,3,1
49200,1,2,172441,172443,172445,2,4,0
49201,6,2,172447,172447,172449,0,2,2
49202,2,3,172449,172449,172452,0,3,0
49203,5,3,172454,172454,172457,0,3,2
49204,3,2,172457,172457,172459,0,2,0
49205,6,3,172463,172463,172466,0,3,4
49206,1,2,172464,172466,172468,2,4,0
49207,6,1,172470,172470,172471,0,1,2
49208,2,1,172472,172472,172473,0,1,1
49209,6,2,172478,172478,172480,0,2,5
49210,2,2,172480,172480,172482,0,2,0
49211,3,1,172483,172483,172484,0,1,1
49212,6,1,172489,172489,172490,0,1,5
49213,3,3,172492,172492,172495,0,3,2
49214,2,3,172494,172495,172498,1,4,0
49215,4,2,172498,172498,172500,0,2,0
49216,6,3,172504,172504,172507,0,3,4
49217,3,2,172507,172507,172509,0,2,0
49218,3,2,172510,172510,172512,0,2,1
49219,6,3,172516,172516,172519,0,3,4
49220,4,1,172520,172520,172521,0,1,1
49221,4,1,172524,172524,172525,0,1,3
49222,4,3,172528,172528,172531,0,3,3
49223,3,3,172531,172531,172534,0,3,0
49224,6,1,172537,172537,172538,0,1,3
49225,4,2,172541,172541,172543,0,2,3
49226,4,2,172545,172545,172547,0,2,2
49227,6,2,172551,172551,172553,0,2,4
49228,4,3,172555,172555,172558,0,3,2
49229,1,1,172556,172558,172559,2,3,0
49230,2,3,172558,172559,172562,1,4,0
49231,6,1,172564,172564,172565,0,1,2
49232,3,2,172567,172567,172569,0,2,2
49233,1,3,172568,172569,172572,1,4,0
49234,2,1,172570,172572,172573,2,3,0
49235,1,2,172571,172573,172575,2,4,0
49236,5,1,172576,172576,172577,0,1,1
49237,2,2,172578,172578,172580,0,2,1
49238,1,3,172579,172580,172583,1,4,0
49239,1,2,172580,172583,172585,3,5,0
49240,5,1,172585,172585,172586,0,1,0
49241,6,3,172591,172591,172594,0,3,5
49242,4,3,172595,172595,172598,0,3,1
49243,4,2,172599,172599,172601,0,2,1
49244,2,3,172601,172601,172604,0,3,0
49245,3,1,172604,172604,172605,0,1,0
49246,3,2,172607,172607,172609,0,2,2
49247,6,1,172613,172613,172614,0,1,4
49248,6,3,172619,172619,172622,0,3,5
49249,3,3,172622,172622,172625,0,3,0
49250,2,1,172624,172625,172626,1,2,0
49251,5,1,172629,172629,172630,0,1,3
49252,3,3,172632,172632,172635,0,3,2
49253,6,2,172638,172638,172640,0,2,3
49254,5,2,172643,172643,172645,0,2,3
49255,3,3,172646,172646,172649,0,3,1
49256,1,2,172647,172649,172651,2,4,0
49257,3,2,172650,172651,172653,1,3,0
49258,2,3,172652,172653,172656,1,4,0
49259,1,2,172653,172656,172658,3,5,0
49260,3,2,172656,172658,172660,2,4,0
49261,1,3,172657,172660,172663,3,6,0
49262,6,2,172663,172663,172665,0,2,0
49263,1,1,172664,172665,172666,1,2,0
49264,3,2,172667,172667,172669,0,2,1
49265,4,3,172671,172671,172674,0,3,2
49266,3,3,172674,172674,172677,0,3,0
49267,4,2,172678,172678,172680,0,2,1
49268,1,3,172679,172680,172683,1,4,0
49269,2,1,172681,172683,172684,2,3,0
49270,4,2,172685,172685,172687,0,2,1
49271,4,2,172689,172689,172691,0,2,2
49272,3,2,172692,172692,172694,0,2,1
49273,5,1,172697,172697,172698,0,1,3
49274,6,3,172703,172703,172706,0,3,5
49275,2,2,172705,172706,172708,1,3,0
49276,3,2,172708,172708,172710,0,2,0
49277,6,2,172714,172714,172716,0,2,4
49278,6,3,172720,172720,172723,0,3,4
49279,2,2,172722,172723,172725,1,3,0
49280,5,3,172727,172727,172730,0,3,2
49281,4,3,172731,172731,172734,0,3,1
49282,3,2,172734,172734,172736,0,2,0
49283,1,1,172735,172736,172737,1,2,0
49284,5,1,172740,172740,172741,0,1,3
49285,1,2,172741,172741,172743,0,2,0
49286,3,3,172744,172744,172747,0,3,1
49287,6,1,172750,172750,172751,0,1,3
49288,2,1,172752,172752,172753,0,1,1
49289,4,3,172756,172756,172759,0,3,3
49290,5,3,172761,172761,172764,0,3,2
49291,1,1,172762,172764,172765,2,3,0
49292,2,2,172764,172765,172767,1,3,0
49293,3,3,172767,172767,172770,0,3,0
49294,5,3,172772,172772,172775,0,3,2
49295,3,1,172775,172775,172776,0,1,0
49296,4,2,172779,172779,172781,0,2,3
49297,3,3,172782,172782,172785,0,3,1
49298,4,3,172786,172786,172789,0,3,1
49299,2,2,172788,172789,172791,1,3,0
49300,5,1,172793,172793,172794,0,1,2
49301,5,1,172798,172798,172799,0,1,4
49302,2,2,172800,172800,172802,0,2,1
49303,4,1,172804,172804,172805,0,1,2
49304,1,1,172805,172805,172806,0,1,0
49305,3,2,172808,172808,172810,0,2,2
49306,6,3,172814,172814,172817,0,3,4
49307,2,3,172816,172817,172820,1,4,0
49308,5,2,172821,172821,172823,0,2,1
49309,4,2,172825,172825,172827,0,2,2
49310,5,1,172830,172830,172831,0,1,3
49311,4,3,172834,172834,172837,0,3,3
49312,3,3,172837,172837,172840,0,3,0
49313,6,2,172843,172843,172845,0,2,3
49314,6,3,172849,172849,172852,0,3,4
49315,5,3,172854,172854,172857,0,3,2
49316,2,3,172856,172857,172860,1,4,0
49317,6,3,172862,172862,172865,0,3,2
49318,1,2,172863,172865,172867,2,4,0
49319,4,1,172867,172867,172868,0,1,0
49320,1,2,172868,172868,172870,0,2,0
49321,1,3,172869,172870,172873,1,4,0
49322,6,3,172875,172875,172878,0,3,2
49323,2,2,172877,172878,172880,1,3,0
49324,2,1,172879,172880,172881,1,2,0
49325,2,2,172881,172881,172883,0,2,0
49326,2,3,172883,172883,172886,0,3,0
49327,4,3,172887,172887,172890,0,3,1
49328,3,2,172890,172890,172892,0,2,0
49329,2,2,172892,172892,172894,0,2,0
49330,2,1,172894,172894,172895,0,1,0
49331,4,2,172898,172898,172900,0,2,3
49332,6,1,172904,172904,172905,0,1,4
49333,4,2,172908,172908,172910,0,2,3
49334,3,3,172911,172911,172914,0,3,1
49335,6,1,172917,172917,172918,0,1,3
49336,1,2,172918,172918,172920,0,2,0
49337,2,1,172920,172920,172921,0,1,0
49338,6,2,172926,172926,172928,0,2,5
49339,1,2,172927,172928,172930,1,3,0
49340,3,3,172930,172930,172933,0,3,0
49341,2,3,172932,172933,172936,1,4,0
49342,3,2,172935,172936,172938,1,3,0
49343,1,2,172936,172938,172940,2,4,0
49344,4,3,172940,172940,172943,0,3,0
49345,2,3,172942,172943,172946,1,4,0
49346,3,3,172945,172946,172949,1,4,0
49347,6,1,172951,172951,172952,0,1,2
49348,1,2,172952,172952,172954,0,2,0
49349,2,3,172954,172954,172957,0,3,0
49350,4,3,172958,172958,172961,0,3,1
49351,4,1,172962,172962,172963,0,1,1
49352,3,3,172965,172965,172968,0,3,2
49353,4,3,172969,172969,172972,0,3,1
49354,4,3,172973,172973,172976,0,3,1
49355,6,1,172979,172979,172980,0,1,3
49356,5,1,172984,172984,172985,0,1,4
49357,1,1,172985,172985,172986,0,1,0
49358,4,2,172989,172989,172991,0,2,3
49359,6,1,172995,172995,172996,0,1,4
49360,3,3,172998,172998,173001,0,3,2
49361,5,2,173003,173003,173005,0,2,2
49362,5,3,173008,173008,173011,0,3,3
49363,5,1,173013,173013,173014,0,1,2
49364,1,2,173014,173014,173016,0,2,0
49365,1,2,173015,173016,173018,1,3,0
49366,3,1,173018,173018,173019,0,1,0
49367,6,2,173024,173024,173026,0,2,5
49368,1,2,173025,173026,173028,1,3,0
49369,5,2,173030,173030,173032,0,2,2
49370,6,2,173036,173036,173038,0,2,4
49371,5,1,173041,173041,173042,0,1,3
49372,2,1,173043,173043,173044,0,1,1
49373,1,2,173044,173044,173046,0,2,0
49374,3,3,173047,173047,173050,0,3,1
49375,1,1,173048,173050,173051,2,3,0
49376,3,2,173051,173051,173053,0,2,0
49377,6,1,173057,173057,173058,0,1,4
49378,5,2,173062,173062,173064,0,2,4
49379,2,3,173064,173064,173067,0,3,0
49380,1,2,173065,173067,173069,2,4,0
49381,3,3,173068,173069,173072,1,4,0
49382,3,1,173071,173072,173073,1,2,0
49383,5,3,173076,173076,173079,0,3,3
49384,6,1,173082,173082,173083,0,1,3
49385,1,3,173083,173083,173086,0,3,0
49386,6,3,173089,173089,173092,0,3,3
49387,3,1,173092,173092,173093,0,1,0
49388,2,2,173094,173094,173096,0,2,1
49389,3,2,173097,173097,173099,0,2,1
49390,5,3,173102,173102,173105,0,3,3
49391,2,1,173104,173105,173106,1,2,0
49392,1,1,173105,173106,173107,1,2,0
49393,1,1,173106,173107,173108,1,2,0
49394,1,3,173107,173108,173111,1,4,0
49395,5,1,173112,173112,173113,0,1,1
49396,4,3,173116,173116,173119,0,3,3
49397,3,3,173119,173119,173122,0,3,0
49398,4,3,173123,173123,173126,0,3,1
49399,2,1,173125,173126,173127,1,2,0
49400,5,2,173130,173130,173132,0,2,3
49401,3,2,173133,173133,173135,0,2,1
49402,6,1,173139,173139,173140,0,1,4
49403,4,3,173143,173143,173146,0,3,3
49404,4,2,173147,173147,173149,0,2,1
49405,1,1,173148,173149,173150,1,2,0
49406,4,1,173152,173152,173153,0,1,2
49407,5,1,173157,173157,173158,0,1,4
49408,4,2,173161,173161,173163,0,2,3
49409,6,3,173167,173167,173170,0,3,4
49410,1,3,173168,173170,173173,2,5,0
49411,4,3,173172,173173,173176,1,4,0
49412,1,1,173173,173176,173177,3,4,0
49413,5,2,173178,173178,173180,0,2,1
49414,2,2,173180,173180,173182,0,2,0
49415,6,1,173186,173186,173187,0,1,4
49416,3,3,173189,173189,173192,0,3,2
49417,1,2,173190,173192,173194,2,4,0
49418,2,2,173192,173194,173196,2,4,0
49419,3,2,173195,173196,173198,1,3,0
49420,2,1,173197,173198,173199,1,2,0
49421,6,2,173203,173203,173205,0,2,4
49422,1,2,173204,173205,173207,1,3,0
49423,3,1,173207,173207,173208,0,1,0
49424,1,1,173208,173208,173209,0,1,0
49425,3,1,173211,173211,173212,0,1,2
49426,2,2,173213,173213,173215,0,2,1
49427,6,1,173219,173219,173220,0,1,4
49428,2,3,173221,173221,173224,0,3,1
49429,2,2,173223,173224,173226,1,3,0
49430,6,2,173229,173229,173231,0,2,3
49431,4,1,173233,173233,173234,0,1,2
49432,2,2,173235,173235,173237,0,2,1
49433,1,2,173236,173237,173239,1,3,0
49434,6,3,173242,173242,173245,0,3,3
49435,4,1,173246,173246,173247,0,1,1
49436,5,2,173251,173251,173253,0,2,4
49437,5,1,173256,173256,173257,0,1,3
49438,1,3,173257,173257,173260,0,3,0
49439,1,3,173258,173260,173263,2,5,0
49440,5,3,173263,173263,173266,0,3,0
49441,6,1,173269,173269,173270,0,1,3
49442,5,1,173274,173274,173275,0,1,4
49443,3,2,173277,173277,173279,0,2,2
49444,5,2,173282,173282,173284,0,2,3
49445,5,3,173287,173287,173290,0,3,3
49446,5,1,173292,173292,173293,0,1,2
49447,4,1,173296,173296,173297,0,1,3
49448,6,2,173302,173302,173304,0,2,5
49449,1,2,173303,173304,173306,1,3,0
49450,4,1,173307,173307,173308,0,1,1
49451,2,1,173309,173309,173310,0,1,1
49452,2,1,173311,173311,173312,0,1,1
49453,5,2,173316,173316,173318,0,2,4
49454,3,1,173319,173319,173320,0,1,1
49455,1,2,173320,173320,173322,0,2,0
49456,4,2,173324,173324,173326,0,2,2
49457,6,3,173330,173330,173333,0,3,4
49458,3,3,173333,173333,173336,0,3,0
49459,2,1,173335,173336,173337,1,2,0
49460,5,1,173340,173340,173341,0,1,3
49461,2,2,173342,173342,173344,0,2,1
49462,3,1,173345,173345,173346,0,1,1
49463,5,1,173350,173350,173351,0,1,4
49464,2,2,173352,173352,173354,0,2,1
49465,4,2,173356,173356,173358,0,2,2
49466,4,1,173360,173360,173361,0,1,2
49467,2,1,173362,173362,173363,0,1,1
49468,5,2,173367,173367,173369,0,2,4
49469,6,1,173373,173373,173374,0,1,4
49470,6,2,173379,173379,173381,0,2,5
49471,1,3,173380,173381,173384,1,4,0
49472,5,2,173385,173385,173387,0,2,1
49473,1,3,173386,173387,173390,1,4,0
49474,2,2,173388,173390,173392,2,4,0
49475,1,1,173389,173392,173393,3,4,0
49476,2,3,173391,173393,173396,2,5,0
49477,5,2,173396,173396,173398,0,2,0
49478,1,3,173397,173398,173401,1,4,0
49479,1,1,173398,173401,173402,3,4,0
49480,1,3,173399,173402,173405,3,6,0
49481,6,1,173405,173405,173406,0,1,0
49482,3,2,173408,173408,173410,0,2,2
49483,6,1,173414,173414,173415,0,1,4
49484,6,1,173420,173420,173421,0,1,5
49485,2,3,173422,173422,173425,0,3,1
49486,5,3,173427,173427,173430,0,3,2
49487,6,2,173433,173433,173435,0,2,3
49488,5,3,173438,173438,173441,0,3,3
49489,6,3,173444,173444,173447,0,3,3
49490,6,1,173450,173450,173451,0,1,3
49491,2,3,173452,173452,173455,0,3,1
49492,6,2,173458,173458,173460,0,2,3
49493,5,2,173463,173463,173465,0,2,3
49494,5,1,173468,173468,173469,0,1,3
49495,4,2,173472,173472,173474,0,2,3
49496,4,1,173476,173476,173477,0,1,2
49497,1,1,173477,173477,173478,0,1,0
49498,2,2,173479,173479,173481,0,2,1
49499,2,2,173481,173481,173483,0,2,0
49500,5,2,173486,173486,173488,0,2,3
49501,1,2,173487,173488,173490,1,3,0
49502,1,2,173488,173490,173492,2,4,0
49503,5,2,173493,173493,173495,0,2,1
49504,5,3,173498,173498,173501,0,3,3
49505,3,3,173501,173501,173504,0,3,0
49506,2,3,173503,173504,173507,1,4,0
49507,6,3,173509,173509,173512,0,3,2
49508,5,3,173514,173514,173517,0,3,2
49509,2,3,173516,173517,173520,1,4,0
49510,2,1,173518,173520,173521,2,3,0
49511,3,2,173521,173521,173523,0,2,0
49512,5,2,173526,173526,173528,0,2,3
49513,6,2,173532,173532,173534,0,2,4
49514,1,2,173533,173534,173536,1,3,0
49515,2,3,173535,173536,173539,1,4,0
49516,4,1,173539,173539,173540,0,1,0
49517,2,3,173541,173541,173544,0,3,1
49518,6,3,173547,173547,173550,0,3,3
49519,2,1,173549,173550,173551,1,2,0
49520,5,3,173554,173554,173557,0,3,3
49521,6,2,173560,173560,173562,0,2,3
49522,4,1,173564,173564,173565,0,1,2
49523,2,2,173566,173566,173568,0,2,1
49524,5,3,173571,173571,173574,0,3,3
49525,5,3,173576,173576,173579,0,3,2
49526,1,1,173577,173579,173580,2,3,0
49527,6,3,173583,173583,173586,0,3,3
49528,5,3,173588,173588,173591,0,3,2
49529,6,3,173594,173594,173597,0,3,3
49530,6,3,173600,173600,173603,0,3,3
49531,6,2,173606,173606,173608,0,2,3
49532,6,2,173612,173612,173614,0,2,4
49533,6,3,173618,173618,173621,0,3,4
49534,3,2,173621,173621,173623,0,2,0
49535,1,1,173622,173623,173624,1,2,0
49536,3,1,173625,173625,173626,0,1,1
49537,1,1,173626,173626,173627,0,1,0
49538,1,1,173627,173627,173628,0,1,0
49539,4,3,173631,173631,173634,0,3,3
49540,2,3,173633,173634,173637,1,4,0
49541,1,3,173634,173637,173640,3,6,0
49542,6,2,173640,173640,173642,0,2,0
49543,5,2,173645,173645,173647,0,2,3
49544,2,1,173647,173647,173648,0,1,0
49545,4,1,173651,173651,173652,0,1,3
49546,4,3,173655,173655,173658,0,3,3
49547,2,2,173657,173658,173660,1,3,0
49548,1,2,173658,173660,173662,2,4,0
49549,2,2,173660,173662,173664,2,4,0
49550,1,3,173661,173664,173667,3,6,0
49551,5,2,173666,173667,173669,1,3,0
49552,1,3,173667,173669,173672,2,5,0
49553,2,1,173669,173672,173673,3,4,0
49554,6,2,173675,173675,173677,0,2,2
49555,4,1,173679,173679,173680,0,1,2
49556,3,2,173682,173682,173684,0,2,2
49557,3,3,173685,173685,173688,0,3,1
49558,6,3,173691,173691,173694,0,3,3
49559,2,2,173693,173694,173696,1,3,0
49560,3,2,173696,173696,173698,0,2,0
49561,3,3,173699,173699,173702,0,3,1
49562,3,3,173702,173702,173705,0,3,0
49563,3,2,173705,173705,173707,0,2,0
49564,4,1,173709,173709,173710,0,1,2
49565,1,1,173710,173710,173711,0,1,0
49566,4,1,173714,173714,173715,0,1,3
49567,4,2,173718,173718,173720,0,2,3
49568,4,2,173722,173722,173724,0,2,2
49569,4,2,173726,173726,173728,0,2,2
49570,4,2,173730,173730,173732,0,2,2
49571,1,1,173731,173732,173733,1,2,0
49572,5,1,173736,173736,173737,0,1,3
49573,4,1,173740,173740,173741,0,1,3
49574,3,3,173743,173743,173746,0,3,2
49575,2,1,173745,173746,173747,1,2,0
49576,5,3,173750,173750,173753,0,3,3
49577,3,3,173753,173753,173756,0,3,0
49578,4,1,173757,173757,173758,0,1,1
49579,3,2,173760,173760,173762,0,2,2
49580,2,3,173762,173762,173765,0,3,0
49581,5,1,173767,173767,173768,0,1,2
49582,3,3,173770,173770,173773,0,3,2
49583,4,3,173774,173774,173777,0,3,1
49584,4,1,173778,173778,173779,0,1,1
49585,5,1,173783,173783,173784,0,1,4
49586,3,2,173786,173786,173788,0,2,2
49587,5,2,173791,173791,173793,0,2,3
49588,6,3,173797,173797,173800,0,3,4
49589,6,2,173803,173803,173805,0,2,3
49590,6,2,173809,173809,173811,0,2,4
49591,1,1,173810,173811,173812,1,2,0
49592,1,2,173811,173812,173814,1,3,0
49593,5,3,173816,173816,173819,0,3,2
49594,5,3,173821,173821,173824,0,3,2
49595,4,2,173825,173825,173827,0,2,1
49596,3,1,173828,173828,173829,0,1,1
49597,2,3,173830,173830,173833,0,3,1
49598,3,1,173833,173833,173834,0,1,0
49599,1,2,173834,173834,173836,0,2,0
49600,3,1,173837,173837,173838,0,1,1
49601,4,3,173841,173841,173844,0,3,3
49602,2,1,173843,173844,173845,1,2,0
49603,1,2,173844,173845,173847,1,3,0
49604,1,3,173845,173847,173850,2,5,0
49605,1,1,173846,173850,173851,4,5,0
49606,5,3,173851,173851,173854,0,3,0
49607,4,3,173855,173855,173858,0,3,1
49608,3,3,173858,173858,173861,0,3,0
49609,2,2,173860,173861,173863,1,3,0
49610,6,3,173866,173866,173869,0,3,3
49611,4,2,173870,173870,173872,0,2,1
49612,1,2,173871,173872,173874,1,3,0
49613,6,3,173877,173877,173880,0,3,3
49614,5,1,173882,173882,173883,0,1,2
49615,5,3,173887,173887,173890,0,3,4
49616,1,1,173888,173890,173891,2,3,0
49617,1,2,173889,173891,173893,2,4,0
49618,3,1,173892,173893,173894,1,2,0
49619,6,3,173898,173898,173901,0,3,4
49620,4,1,173902,173902,173903,0,1,1
49621,1,3,173903,173903,173906,0,3,0
49622,5,3,173908,173908,173911,0,3,2
49623,1,2,173909,173911,173913,2,4,0
49624,5,2,173914,173914,173916,0,2,1
49625,1,1,173915,173916,173917,1,2,0
49626,3,2,173918,173918,173920,0,2,1
49627,3,2,173921,173921,173923,0,2,1
49628,3,2,173924,173924,173926,0,2,1
49629,1,3,173925,173926,173929,1,4,0
49630,3,1,173928,173929,173930,1,2,0
49631,5,2,173933,173933,173935,0,2,3
49632,1,1,173934,173935,173936,1,2,0
49633,2,2,173936,173936,173938,0,2,0
49634,3,3,173939,173939,173942,0,3,1
49635,2,1,173941,173942,173943,1,2,0
49636,4,3,173945,173945,173948,0,3,2
49637,1,3,173946,173948,173951,2,5,0
49638,3,2,173949,173951,173953,2,4,0
49639,2,3,173951,173953,173956,2,5,0
49640,6,3,173957,173957,173960,0,3,1
49641,3,3,173960,173960,173963,0,3,0
49642,2,2,173962,173963,173965,1,3,0
49643,3,1,173965,173965,173966,0,1,0
49644,4,2,173969,173969,173971,0,2,3
49645,4,1,173973,173973,173974,0,1,2
49646,6,1,173979,173979,173980,0,1,5
49647,2,1,173981,173981,173982,0,1,1
49648,5,3,173986,173986,173989,0,3,4
49649,3,2,173989,173989,173991,0,2,0
49650,4,1,173993,173993,173994,0,1,2
49651,1,1,173994,173994,173995,0,1,0
49652,2,2,173996,173996,173998,0,2,1
49653,2,3,173998,173998,174001,0,3,0
49654,5,1,174003,174003,174004,0,1,2
49655,1,3,174004,174004,174007,0,3,0
49656,4,1,174008,174008,174009,0,1,1
49657,3,1,174011,174011,174012,0,1,2
49658,5,3,174016,174016,174019,0,3,4
49659,3,3,174019,174019,174022,0,3,0
49660,1,1,174020,174022,174023,2,3,0
49661,1,2,174021,174023,174025,2,4,0
49662,1,2,174022,174025,174027,3,5,0
49663,4,3,174026,174027,174030,1,4,0
49664,3,3,174029,174030,174033,1,4,0
49665,3,2,174032,174033,174035,1,3,0
49666,2,1,174034,174035,174036,1,2,0
49667,5,2,174039,174039,174041,0,2,3
49668,5,1,174044,174044,174045,0,1,3
49669,1,3,174045,174045,174048,0,3,0
49670,5,1,174050,174050,174051,0,1,2
49671,5,1,174055,174055,174056,0,1,4
49672,3,1,174058,174058,174059,0,1,2
49673,2,1,174060,174060,174061,0,1,1
49674,5,3,174065,174065,174068,0,3,4
49675,1,1,174066,174068,174069,2,3,0
49676,4,1,174070,174070,174071,0,1,1
49677,3,1,174073,174073,174074,0,1,2
49678,1,1,174074,174074,174075,0,1,0
49679,2,1,174076,174076,174077,0,1,1
49680,5,2,174081,174081,174083,0,2,4
49681,5,2,174086,174086,174088,0,2,3
49682,5,3,174091,174091,174094,0,3,3
49683,6,2,174097,174097,174099,0,2,3
49684,5,2,174102,174102,174104,0,2,3
49685,3,2,174105,174105,174107,0,2,1
49686,2,3,174107,174107,174110,0,3,0
49687,6,3,174113,174113,174116,0,3,3
49688,4,2,174117,174117,174119,0,2,1
49689,1,3,174118,174119,174122,1,4,0
49690,5,3,174123,174123,174126,0,3,1
49691,5,3,174128,174128,174131,0,3,2
49692,3,3,174131,174131,174134,0,3,0
49693,6,2,174137,174137,174139,0,2,3
49694,4,2,174141,174141,174143,0,2,2
49695,5,1,174146,174146,174147,0,1,3
49696,2,1,174148,174148,174149,0,1,1
49697,4,3,174152,174152,174155,0,3,3
49698,1,2,174153,174155,174157,2,4,0
49699,2,1,174155,174157,174158,2,3,0
49700,6,1,174161,174161,174162,0,1,3
49701,3,3,174164,174164,174167,0,3,2
49702,5,3,174169,174169,174172,0,3,2
49703,3,2,174172,174172,174174,0,2,0
49704,6,2,174178,174178,174180,0,2,4
49705,4,2,174182,174182,174184,0,2,2
49706,5,3,174187,174187,174190,0,3,3
49707,4,2,174191,174191,174193,0,2,1
49708,3,1,174194,174194,174195,0,1,1
49709,5,3,174199,174199,174202,0,3,4
49710,5,2,174204,174204,174206,0,2,2
49711,6,1,174210,174210,174211,0,1,4
49712,2,1,174212,174212,174213,0,1,1
49713,5,1,174217,174217,174218,0,1,4
49714,6,3,174223,174223,174226,0,3,5
49715,2,1,174225,174226,174227,1,2,0
49716,1,2,174226,174227,174229,1,3,0
49717,4,2,174230,174230,174232,0,2,1
49718,4,2,174234,174234,174236,0,2,2
49719,3,2,174237,174237,174239,0,2,1
49720,4,3,174241,174241,174244,0,3,2
49721,1,2,174242,174244,174246,2,4,0
49722,5,3,174247,174247,174250,0,3,1
49723,5,3,174252,174252,174255,0,3,2
49724,6,2,174258,174258,174260,0,2,3
49725,3,2,174261,174261,174263,0,2,1
49726,4,2,174265,174265,174267,0,2,2
49727,1,3,174266,174267,174270,1,4,0
49728,6,1,174272,174272,174273,0,1,2
49729,5,1,174277,174277,174278,0,1,4
49730,2,3,174279,174279,174282,0,3,1
49731,4,2,174283,174283,174285,0,2,1
49732,6,2,174289,174289,174291,0,2,4
49733,2,3,174291,174291,174294,0,3,0
49734,1,3,174292,174294,174297,2,5,0
49735,1,3,174293,174297,174300,4,7,0
49736,2,1,174295,174300,174301,5,6,0
49737,6,1,174301,174301,174302,0,1,0
49738,5,3,174306,174306,174309,0,3,4
49739,6,1,174312,174312,174313,0,1,3
49740,5,3,174317,174317,174320,0,3,4
49741,3,3,174320,174320,174323,0,3,0
49742,1,1,174321,174323,174324,2,3,0
49743,1,3,174322,174324,174327,2,5,0
49744,1,2,174323,174327,174329,4,6,0
49745,5,1,174328,174329,174330,1,2,0
49746,6,3,174334,174334,174337,0,3,4
49747,2,1,174336,174337,174338,1,2,0
49748,1,2,174337,174338,174340,1,3,0
49749,2,2,174339,174340,174342,1,3,0
49750,5,1,174344,174344,174345,0,1,2
49751,4,1,174348,174348,174349,0,1,3
49752,1,3,174349,174349,174352,0,3,0
49753,6,1,174355,174355,174356,0,1,3
49754,2,3,174357,174357,174360,0,3,1
49755,6,3,174363,174363,174366,0,3,3
49756,3,1,174366,174366,174367,0,1,0
49757,2,2,174368,174368,174370,0,2,1
49758,4,3,174372,174372,174375,0,3,2
49759,5,2,174377,174377,174379,0,2,2
49760,6,2,174383,174383,174385,0,2,4
49761,2,1,174385,174385,174386,0,1,0
49762,4,2,174389,174389,174391,0,2,3
49763,2,1,174391,174391,174392,0,1,0
49764,3,3,174394,174394,174397,0,3,2
49765,5,1,174399,174399,174400,0,1,2
49766,4,3,174403,174403,174406,0,3,3
49767,1,3,174404,174406,174409,2,5,0
49768,5,2,174409,174409,174411,0,2,0
49769,4,2,174413,174413,174415,0,2,2
49770,1,3,174414,174415,174418,1,4,0
49771,1,1,174415,174418,174419,3,4,0
49772,6,3,174421,174421,174424,0,3,2
49773,3,1,174424,174424,174425,0,1,0
49774,1,3,174425,174425,174428,0,3,0
49775,6,2,174431,174431,174433,0,2,3
49776,6,2,174437,174437,174439,0,2,4
49777,4,3,174441,174441,174444,0,3,2
49778,6,3,174447,174447,174450,0,3,3
49779,3,3,174450,174450,174453,0,3,0
49780,6,2,174456,174456,174458,0,2,3
49781,1,3,174457,174458,174461,1,4,0
49782,3,2,174460,174461,174463,1,3,0
49783,3,3,174463,174463,174466,0,3,0
49784,3,1,174466,174466,174467,0,1,0
49785,1,1,174467,174467,174468,0,1,0
49786,4,2,174471,174471,174473,0,2,3
49787,1,1,174472,174473,174474,1,2,0
49788,3,2,174475,174475,174477,0,2,1
49789,5,2,174480,174480,174482,0,2,3
49790,6,3,174486,174486,174489,0,3,4
49791,1,2,174487,174489,174491,2,4,0
49792,6,2,174493,174493,174495,0,2,2
49793,1,3,174494,174495,174498,1,4,0
49794,6,2,174500,174500,174502,0,2,2
49795,5,3,174505,174505,174508,0,3,3
49796,6,3,174511,174511,174514,0,3,3
49797,2,3,174513,174514,174517,1,4,0
49798,1,1,174514,174517,174518,3,4,0
49799,3,2,174517,174518,174520,1,3,0
49800,1,3,174518,174520,174523,2,5,0
49801,6,2,174524,174524,174526,0,2,1
49802,4,1,174528,174528,174529,0,1,2
49803,3,1,174531,174531,174532,0,1,2
49804,3,2,174534,174534,174536,0,2,2
49805,6,3,174540,174540,174543,0,3,4
49806,6,1,174546,174546,174547,0,1,3
49807,3,3,174549,174549,174552,0,3,2
49808,4,2,174553,174553,174555,0,2,1
49809,4,1,174557,174557,174558,0,1,2
49810,4,2,174561,174561,174563,0,2,3
49811,6,1,174567,174567,174568,0,1,4
49812,2,2,174569,174569,174571,0,2,1
49813,6,2,174575,174575,174577,0,2,4
49814,3,3,174578,174578,174581,0,3,1
49815,5,1,174583,174583,174584,0,1,2
49816,2,3,174585,174585,174588,0,3,1
49817,1,1,174586,174588,174589,2,3,0
49818,6,2,174592,174592,174594,0,2,3
49819,3,3,174595,174595,174598,0,3,1
49820,5,2,174600,174600,174602,0,2,2
49821,5,2,174605,174605,174607,0,2,3
49822,5,2,174610,174610,174612,0,2,3
49823,6,1,174616,174616,174617,0,1,4
49824,6,1,174622,174622,174623,0,1,5
49825,5,2,174627,174627,174629,0,2,4
49826,6,3,174633,174633,174636,0,3,4
49827,2,3,174635,174636,174639,1,4,0
49828,6,1,174641,174641,174642,0,1,2
49829,6,3,174647,174647,174650,0,3,5
49830,2,1,174649,174650,174651,1,2,0
49831,2,1,174651,174651,174652,0,1,0
49832,4,1,174655,174655,174656,0,1,3
49833,4,1,174659,174659,174660,0,1,3
49834,1,3,174660,174660,174663,0,3,0
49835,2,3,174662,174663,174666,1,4,0
49836,2,2,174664,174666,174668,2,4,0
49837,6,3,174670,174670,174673,0,3,2
49838,5,3,174675,174675,174678,0,3,2
49839,3,3,174678,174678,174681,0,3,0
49840,2,1,174680,174681,174682,1,2,0
49841,6,3,174686,174686,174689,0,3,4
49842,5,1,174691,174691,174692,0,1,2
49843,1,1,174692,174692,174693,0,1,0
49844,5,3,174697,174697,174700,0,3,4
49845,4,1,174701,174701,174702,0,1,1
49846,6,1,174707,174707,174708,0,1,5
49847,3,3,174710,174710,174713,0,3,2
49848,1,2,174711,174713,174715,2,4,0
49849,1,1,174712,174715,174716,3,4,0
49850,3,2,174715,174716,174718,1,3,0
49851,3,3,174718,174718,174721,0,3,0
49852,5,2,174723,174723,174725,0,2,2
49853,5,3,174728,174728,174731,0,3,3
49854,1,2,174729,174731,174733,2,4,0
49855,5,2,174734,174734,174736,0,2,1
49856,6,3,174740,174740,174743,0,3,4
49857,4,1,174744,174744,174745,0,1,1
49858,3,3,174747,174747,174750,0,3,2
49859,4,2,174751,174751,174753,0,2,1
49860,6,3,174757,174757,174760,0,3,4
49861,1,2,174758,174760,174762,2,4,0
49862,5,2,174763,174763,174765,0,2,1
49863,4,1,174767,174767,174768,0,1,2
49864,4,1,174771,174771,174772,0,1,3
49865,4,3,174775,174775,174778,0,3,3
49866,3,2,174778,174778,174780,0,2,0
49867,3,2,174781,174781,174783,0,2,1
49868,1,2,174782,174783,174785,1,3,0
49869,3,1,174785,174785,174786,0,1,0
49870,1,1,174786,174786,174787,0,1,0
49871,1,3,174787,174787,174790,0,3,0
49872,6,2,174793,174793,174795,0,2,3
49873,5,3,174798,174798,174801,0,3,3
49874,1,1,174799,174801,174802,2,3,0
49875,4,3,174803,174803,174806,0,3,1
49876,5,2,174808,174808,174810,0,2,2
49877,1,2,174809,174810,174812,1,3,0
49878,3,1,174812,174812,174813,0,1,0
49879,1,3,174813,174813,174816,0,3,0
49880,2,3,174815,174816,174819,1,4,0
49881,1,3,174816,174819,174822,3,6,0
49882,5,3,174821,174822,174825,1,4,0
49883,6,1,174827,174827,174828,0,1,2
49884,6,2,174833,174833,174835,0,2,5
49885,5,2,174838,174838,174840,0,2,3
49886,3,3,174841,174841,174844,0,3,1
49887,3,1,174844,174844,174845,0,1,0
49888,5,1,174849,174849,174850,0,1,4
49889,3,2,174852,174852,174854,0,2,2
49890,2,3,174854,174854,174857,0,3,0
49891,5,1,174859,174859,174860,0,1,2
49892,4,2,174863,174863,174865,0,2,3
49893,2,3,174865,174865,174868,0,3,0
49894,1,2,174866,174868,174870,2,4,0
49895,6,3,174872,174872,174875,0,3,2
49896,2,2,174874,174875,174877,1,3,0
49897,1,1,174875,174877,174878,2,3,0
49898,1,2,174876,174878,174880,2,4,0
49899,2,3,174878,174880,174883,2,5,0
49900,1,3,174879,174883,174886,4,7,0
49901,1,3,174880,174886,174889,6,9,0
49902,2,2,174882,174889,174891,7,9,0
49903,4,3,174886,174891,174894,5,8,0
49904,5,3,174891,174894,174897,3,6,0
49905,3,1,174894,174897,174898,3,4,0
49906,1,3,174895,174898,174901,3,6,0
49907,5,2,174900,174901,174903,1,3,0
49908,4,1,174904,174904,174905,0,1,1
49909,5,2,174909,174909,174911,0,2,4
49910,5,2,174914,174914,174916,0,2,3
49911,1,1,174915,174916,174917,1,2,0
49912,1,3,174916,174917,174920,1,4,0
49913,2,2,174918,174920,174922,2,4,0
49914,2,3,174920,174922,174925,2,5,0
49915,3,3,174923,174925,174928,2,5,0
49916,5,1,174928,174928,174929,0,1,0
49917,5,3,174933,174933,174936,0,3,4
49918,4,2,174937,174937,174939,0,2,1
49919,1,3,174938,174939,174942,1,4,0
49920,1,2,174939,174942,174944,3,5,0
49921,6,2,174945,174945,174947,0,2,1
49922,6,1,174951,174951,174952,0,1,4
49923,3,2,174954,174954,174956,0,2,2
49924,4,1,174958,174958,174959,0,1,2
49925,6,1,174964,174964,174965,0,1,5
49926,1,1,174965,174965,174966,0,1,0
49927,6,1,174971,174971,174972,0,1,5
49928,6,1,174977,174977,174978,0,1,5
49929,6,3,174983,174983,174986,0,3,5
49930,1,2,174984,174986,174988,2,4,0
49931,4,1,174988,174988,174989,0,1,0
49932,5,3,174993,174993,174996,0,3,4
49933,4,1,174997,174997,174998,0,1,1
49934,5,1,175002,175002,175003,0,1,4
49935,6,3,175008,175008,175011,0,3,5
49936,5,1,175013,175013,175014,0,1,2
49937,3,3,175016,175016,175019,0,3,2
49938,3,2,175019,175019,175021,0,2,0
49939,5,2,175024,175024,175026,0,2,3
49940,6,1,175030,175030,175031,0,1,4
49941,5,1,175035,175035,175036,0,1,4
49942,1,3,175036,175036,175039,0,3,0
49943,6,1,175042,175042,175043,0,1,3
49944,3,2,175045,175045,175047,0,2,2
49945,1,1,175046,175047,175048,1,2,0
49946,3,3,175049,175049,175052,0,3,1
49947,2,3,175051,175052,175055,1,4,0
49948,1,3,175052,175055,175058,3,6,0
49949,5,3,175057,175058,175061,1,4,0
49950,2,1,175059,175061,175062,2,3,0
49951,3,3,175062,175062,175065,0,3,0
49952,3,3,175065,175065,175068,0,3,0
49953,1,2,175066,175068,175070,2,4,0
49954,2,3,175068,175070,175073,2,5,0
49955,6,2,175074,175074,175076,0,2,1
49956,1,3,175075,175076,175079,1,4,0
49957,1,1,175076,175079,175080,3,4,0
49958,5,3,175081,175081,175084,0,3,1
49959,2,1,175083,175084,175085,1,2,0
49960,4,3,175087,175087,175090,0,3,2
49961,5,3,175092,175092,175095,0,3,2
49962,1,3,175093,175095,175098,2,5,0
49963,3,2,175096,175098,175100,2,4,0
49964,3,3,175099,175100,175103,1,4,0
49965,5,3,175104,175104,175107,0,3,1
49966,2,1,175106,175107,175108,1,2,0
49967,4,1,175110,175110,175111,0,1,2
49968,1,2,175111,175111,175113,0,2,0
49969,1,3,175112,175113,175116,1,4,0
49970,2,2,175114,175116,175118,2,4,0
49971,1,3,175115,175118,175121,3,6,0
49972,5,1,175120,175121,175122,1,2,0
49973,6,2,175126,175126,175128,0,2,4
49974,5,3,175131,175131,175134,0,3,3
49975,2,3,175133,175134,175137,1,4,0
49976,2,3,175135,175137,175140,2,5,0
49977,6,1,175141,175141,175142,0,1,1
49978,6,2,175147,175147,175149,0,2,5
49979,6,3,175153,175153,175156,0,3,4
49980,6,3,175159,175159,175162,0,3,3
49981,2,1,175161,175162,175163,1,2,0
49982,3,2,175164,175164,175166,0,2,1
49983,2,3,175166,175166,175169,0,3,0
49984,3,3,175169,175169,175172,0,3,0
49985,5,3,175174,175174,175177,0,3,2
49986,1,3,175175,175177,175180,2,5,0
49987,1,3,175176,175180,175183,4,7,0
49988,6,2,175182,175183,175185,1,3,0
49989,6,3,175188,175188,175191,0,3,3
49990,6,3,175194,175194,175197,0,3,3
49991,3,2,175197,175197,175199,0,2,0
49992,6,1,175203,175203,175204,0,1,4
49993,6,1,175209,175209,175210,0,1,5
49994,4,3,175213,175213,175216,0,3,3
49995,4,3,175217,175217,175220,0,3,1
49996,1,3,175218,175220,175223,2,5,0
49997,1,1,175219,175223,175224,4,5,0
49998,3,3,175222,175224,175227,2,5,0
49999,5,1,175227,175227,175228,0,1,0
50000,2,3,175229,175229,175232,0,3,1
50001,1,2,175230,175232,175234,2,4,0
50002,6,3,175236,175236,175239,0,3,2
50003,5,2,175241,175241,175243,0,2,2
50004,5,3,175246,175246,175249,0,3,3
50005,2,3,175248,175249,175252,1,4,0
50006,6,3,175254,175254,175257,0,3,2
50007,4,3,175258,175258,175261,0,3,1
50008,4,1,175262,175262,175263,0,1,1
50009,1,2,175263,175263,175265,0,2,0
50010,5,2,175268,175268,175270,0,2,3
50011,5,3,175273,175273,175276,0,3,3
50012,6,1,175279,175279,175280,0,1,3
50013,3,1,175282,175282,175283,0,1,2
50014,1,1,175283,175283,175284,0,1,0
50015,2,1,175285,175285,175286,0,1,1
50016,5,1,175290,175290,175291,0,1,4
50017,4,1,175294,175294,175295,0,1,3
50018,4,1,175298,175298,175299,0,1,3
50019,3,3,175301,175301,175304,0,3,2
50020,2,2,175303,175304,175306,1,3,0
50021,3,2,175306,175306,175308,0,2,0
50022,6,3,175312,175312,175315,0,3,4
50023,2,1,175314,175315,175316,1,2,0
50024,1,3,175315,175316,175319,1,4,0
50025,4,3,175319,175319,175322,0,3,0
50026,5,3,175324,175324,175327,0,3,2
50027,3,1,175327,175327,175328,0,1,0
50028,1,1,175328,175328,175329,0,1,0
50029,4,2,175332,175332,175334,0,2,3
50030,3,2,175335,175335,175337,0,2,1
50031,4,2,175339,175339,175341,0,2,2
50032,4,3,175343,175343,175346,0,3,2
50033,3,3,175346,175346,175349,0,3,0
50034,4,1,175350,175350,175351,0,1,1
50035,1,1,175351,175351,175352,0,1,0
50036,1,3,175352,175352,175355,0,3,0
50037,1,3,175353,175355,175358,2,5,0
50038,3,3,175356,175358,175361,2,5,0
50039,5,3,175361,175361,175364,0,3,0
50040,5,2,175366,175366,175368,0,2,2
50041,5,2,175371,175371,175373,0,2,3
50042,4,1,175375,175375,175376,0,1,2
50043,6,3,175381,175381,175384,0,3,5
50044,1,3,175382,175384,175387,2,5,0
50045,4,1,175386,175387,175388,1,2,0
50046,1,1,175387,175388,175389,1,2,0
50047,4,3,175391,175391,175394,0,3,2
50048,3,3,175394,175394,175397,0,3,0
50049,3,3,175397,175397,175400,0,3,0
50050,5,2,175402,175402,175404,0,2,2
50051,1,3,175403,175404,175407,1,4,0
50052,1,3,175404,175407,175410,3,6,0
50053,1,1,175405,175410,175411,5,6,0
50054,3,2,175408,175411,175413,3,5,0
50055,2,2,175410,175413,175415,3,5,0
50056,4,2,175414,175415,175417,1,3,0
50057,2,2,175416,175417,175419,1,3,0
50058,5,2,175421,175421,175423,0,2,2
50059,3,2,175424,175424,175426,0,2,1
50060,1,3,175425,175426,175429,1,4,0
50061,1,1,175426,175429,175430,3,4,0
50062,6,3,175432,175432,175435,0,3,2
50063,3,2,175435,175435,175437,0,2,0
50064,5,2,175440,175440,175442,0,2,3
50065,6,3,175446,175446,175449,0,3,4
50066,4,1,175450,175450,175451,0,1,1
50067,4,1,175454,175454,175455,0,1,3
50068,6,2,175460,175460,175462,0,2,5
50069,1,1,175461,175462,175463,1,2,0
50070,4,3,175465,175465,175468,0,3,2
50071,6,3,175471,175471,175474,0,3,3
50072,5,1,175476,175476,175477,0,1,2
50073,4,1,175480,175480,175481,0,1,3
50074,3,1,175483,175483,175484,0,1,2
50075,4,2,175487,175487,175489,0,2,3
50076,3,2,175490,175490,175492,0,2,1
50077,6,1,175496,175496,175497,0,1,4
50078,1,3,175497,175497,175500,0,3,0
50079,2,3,175499,175500,175503,1,4,0
50080,1,3,175500,175503,175506,3,6,0
50081,3,2,175503,175506,175508,3,5,0
50082,4,1,175507,175508,175509,1,2,0
50083,4,1,175511,175511,175512,0,1,2
50084,4,3,175515,175515,175518,0,3,3
50085,5,3,175520,175520,175523,0,3,2
50086,3,3,175523,175523,175526,0,3,0
50087,2,2,175525,175526,175528,1,3,0
50088,4,3,175529,175529,175532,0,3,1
50089,1,1,175530,175532,175533,2,3,0
50090,3,1,175533,175533,175534,0,1,0
50091,2,1,175535,175535,175536,0,1,1
50092,1,2,175536,175536,175538,0,2,0
50093,3,3,175539,175539,175542,0,3,1
50094,4,3,175543,175543,175546,0,3,1
50095,3,3,175546,175546,175549,0,3,0
50096,1,1,175547,175549,175550,2,3,0
50097,1,3,175548,175550,175553,2,5,0
50098,3,3,175551,175553,175556,2,5,0
50099,5,1,175556,175556,175557,0,1,0
50100,3,2,175559,175559,175561,0,2,2
50101,3,1,175562,175562,175563,0,1,1
50102,4,3,175566,175566,175569,0,3,3
50103,3,3,175569,175569,175572,0,3,0
50104,2,1,175571,175572,175573,1,2,0
50105,4,1,175575,175575,175576,0,1,2
50106,4,1,175579,175579,175580,0,1,3
50107,6,1,175585,175585,175586,0,1,5
50108,1,1,175586,175586,175587,0,1,0
50109,1,1,175587,175587,175588,0,1,0
50110,5,2,175592,175592,175594,0,2,4
50111,5,1,175597,175597,175598,0,1,3
50112,5,3,175602,175602,175605,0,3,4
50113,3,3,175605,175605,175608,0,3,0
50114,6,3,175611,175611,175614,0,3,3
50115,2,1,175613,175614,175615,1,2,0
50116,6,1,175619,175619,175620,0,1,4
50117,4,1,175623,175623,175624,0,1,3
50118,3,1,175626,175626,175627,0,1,2
50119,2,3,175628,175628,175631,0,3,1
50120,3,3,175631,175631,175634,0,3,0
50121,3,2,175634,175634,175636,0,2,0
50122,6,1,175640,175640,175641,0,1,4
50123,2,2,175642,175642,175644,0,2,1
50124,1,2,175643,175644,175646,1,3,0
50125,4,1,175647,175647,175648,0,1,1
50126,3,3,175650,175650,175653,0,3,2
50127,5,1,175655,175655,175656,0,1,2
50128,1,1,175656,175656,175657,0,1,0
50129,5,1,175661,175661,175662,0,1,4
50130,2,3,175663,175663,175666,0,3,1
50131,6,1,175669,175669,175670,0,1,3
50132,6,2,175675,175675,175677,0,2,5
50133,5,3,175680,175680,175683,0,3,3
50134,5,1,175685,175685,175686,0,1,2
50135,6,2,175691,175691,175693,0,2,5
50136,4,1,175695,175695,175696,0,1,2
50137,2,2,175697,175697,175699,0,2,1
50138,5,2,175702,175702,175704,0,2,3
50139,4,1,175706,175706,175707,0,1,2
50140,3,3,175709,175709,175712,0,3,2
50141,1,1,175710,175712,175713,2,3,0
50142,1,1,175711,175713,175714,2,3,0
50143,6,1,175717,175717,175718,0,1,3
50144,4,2,175721,175721,175723,0,2,3
50145,6,3,175727,175727,175730,0,3,4
50146,6,3,175733,175733,175736,0,3,3
50147,3,3,175736,175736,175739,0,3,0
50148,4,2,175740,175740,175742,0,2,1
50149,6,2,175746,175746,175748,0,2,4
50150,6,3,175752,175752,175755,0,3,4
50151,4,3,175756,175756,175759,0,3,1
50152,6,2,175762,175762,175764,0,2,3
50153,2,2,175764,175764,175766,0,2,0
50154,6,2,175770,175770,175772,0,2,4
50155,3,1,175773,175773,175774,0,1,1
50156,4,2,175777,175777,175779,0,2,3
50157,4,2,175781,175781,175783,0,2,2
50158,2,1,175783,175783,175784,0,1,0
50159,6,3,175789,175789,175792,0,3,5
50160,3,2,175792,175792,175794,0,2,0
50161,6,1,175798,175798,175799,0,1,4
50162,3,3,175801,175801,175804,0,3,2
50163,3,2,175804,175804,175806,0,2,0
50164,4,1,175808,175808,175809,0,1,2
50165,2,1,175810,175810,175811,0,1,1
50166,5,2,175815,175815,175817,0,2,4
50167,1,3,175816,175817,175820,1,4,0
50168,2,2,175818,175820,175822,2,4,0
50169,5,1,175823,175823,175824,0,1,1
50170,1,1,175824,175824,175825,0,1,0
50171,4,3,175828,175828,175831,0,3,3
50172,2,1,175830,175831,175832,1,2,0
50173,1,1,175831,175832,175833,1,2,0
50174,6,1,175837,175837,175838,0,1,4
50175,4,2,175841,175841,175843,0,2,3
50176,6,3,175847,175847,175850,0,3,4
50177,1,2,175848,175850,175852,2,4,0
50178,6,3,175854,175854,175857,0,3,2
50179,2,2,175856,175857,175859,1,3,0
50180,1,1,175857,175859,175860,2,3,0
50181,2,2,175859,175860,175862,1,3,0
50182,3,3,175862,175862,175865,0,3,0
50183,6,2,175868,175868,175870,0,2,3
50184,6,3,175874,175874,175877,0,3,4
50185,1,3,175875,175877,175880,2,5,0
50186,1,2,175876,175880,175882,4,6,0
50187,4,3,175880,175882,175885,2,5,0
50188,5,3,175885,175885,175888,0,3,0
50189,4,3,175889,175889,175892,0,3,1
50190,4,1,175893,175893,175894,0,1,1
50191,2,2,175895,175895,175897,0,2,1
50192,1,3,175896,175897,175900,1,4,0
50193,3,1,175899,175900,175901,1,2,0
50194,1,1,175900,175901,175902,1,2,0
50195,6,3,175906,175906,175909,0,3,4
50196,6,1,175912,175912,175913,0,1,3
50197,4,2,175916,175916,175918,0,2,3
50198,6,1,175922,175922,175923,0,1,4
50199,6,3,175928,175928,175931,0,3,5
50200,3,3,175931,175931,175934,0,3,0
50201,2,2,175933,175934,175936,1,3,0
50202,5,3,175938,175938,175941,0,3,2
50203,4,1,175942,175942,175943,0,1,1
50204,5,2,175947,175947,175949,0,2,4
50205,3,2,175950,175950,175952,0,2,1
50206,3,3,175953,175953,175956,0,3,1
50207,4,2,175957,175957,175959,0,2,1
50208,6,1,175963,175963,175964,0,1,4
50209,5,3,175968,175968,175971,0,3,4
50210,5,3,175973,175973,175976,0,3,2
50211,4,3,175977,175977,175980,0,3,1
50212,6,2,175983,175983,175985,0,2,3
50213,1,2,175984,175985,175987,1,3,0
50214,6,3,175990,175990,175993,0,3,3
50215,2,3,175992,175993,175996,1,4,0
50216,6,1,175998,175998,175999,0,1,2
50217,2,1,176000,176000,176001,0,1,1
50218,1,3,176001,176001,176004,0,3,0
50219,5,1,176006,176006,176007,0,1,2
50220,1,2,176007,176007,176009,0,2,0
50221,3,3,176010,176010,176013,0,3,1
50222,5,2,176015,176015,176017,0,2,2
50223,3,3,176018,176018,176021,0,3,1
50224,3,2,176021,176021,176023,0,2,0
50225,6,2,176027,176027,176029,0,2,4
50226,6,1,176033,176033,176034,0,1,4
50227,5,3,176038,176038,176041,0,3,4
50228,1,3,176039,176041,176044,2,5,0
50229,4,1,176043,176044,176045,1,2,0
50230,6,2,176049,176049,176051,0,2,4
50231,2,1,176051,176051,176052,0,1,0
50232,5,1,176056,176056,176057,0,1,4
50233,2,2,176058,176058,176060,0,2,1
50234,2,1,176060,176060,176061,0,1,0
50235,5,2,176065,176065,176067,0,2,4
50236,6,3,176071,176071,176074,0,3,4
50237,1,1,176072,176074,176075,2,3,0
50238,4,3,176076,176076,176079,0,3,1
50239,4,3,176080,176080,176083,0,3,1
50240,6,1,176086,176086,176087,0,1,3
50241,5,1,176091,176091,176092,0,1,4
50242,5,2,176096,176096,176098,0,2,4
50243,2,1,176098,176098,176099,0,1,0
50244,4,1,176102,176102,176103,0,1,3
50245,3,2,176105,176105,176107,0,2,2
50246,3,2,176108,176108,176110,0,2,1
50247,4,1,176112,176112,176113,0,1,2
50248,2,2,176114,176114,176116,0,2,1
50249,4,3,176118,176118,176121,0,3,2
50250,3,2,176121,176121,176123,0,2,0
50251,3,1,176124,176124,176125,0,1,1
50252,4,3,176128,176128,176131,0,3,3
50253,1,3,176129,176131,176134,2,5,0
50254,1,1,176130,176134,176135,4,5,0
50255,4,2,176134,176135,176137,1,3,0
50256,1,1,176135,176137,176138,2,3,0
50257,6,3,176141,176141,176144,0,3,3
50258,2,2,176143,176144,176146,1,3,0
50259,6,3,176149,176149,176152,0,3,3
50260,1,3,176150,176152,176155,2,5,0
50261,6,3,176156,176156,176159,0,3,1
50262,2,2,176158,176159,176161,1,3,0
50263,6,3,176164,176164,176167,0,3,3
50264,1,1,176165,176167,176168,2,3,0
50265,3,3,176168,176168,176171,0,3,0
50266,6,3,176174,176174,176177,0,3,3
50267,5,1,176179,176179,176180,0,1,2
50268,1,1,176180,176180,176181,0,1,0
50269,2,2,176182,176182,176184,0,2,1
50270,1,1,176183,176184,176185,1,2,0
50271,6,2,176189,176189,176191,0,2,4
50272,2,1,176191,176191,176192,0,1,0
50273,3,3,176194,176194,176197,0,3,2
50274,2,2,176196,176197,176199,1,3,0
50275,5,3,176201,176201,176204,0,3,2
50276,4,1,176205,176205,176206,0,1,1
50277,1,3,176206,176206,176209,0,3,0
50278,2,1,176208,176209,176210,1,2,0
50279,2,2,176210,176210,176212,0,2,0
50280,5,3,176215,176215,176218,0,3,3
50281,2,2,176217,176218,176220,1,3,0
50282,3,2,176220,176220,176222,0,2,0
50283,3,3,176223,176223,176226,0,3,1
50284,1,1,176224,176226,176227,2,3,0
50285,2,2,176226,176227,176229,1,3,0
50286,6,2,176232,176232,176234,0,2,3
50287,5,1,176237,176237,176238,0,1,3
50288,3,2,176240,176240,176242,0,2,2
50289,5,3,176245,176245,176248,0,3,3
50290,2,2,176247,176248,176250,1,3,0
50291,3,2,176250,176250,176252,0,2,0
50292,4,2,176254,176254,176256,0,2,2
50293,3,1,176257,176257,176258,0,1,1
50294,1,3,176258,176258,176261,0,3,0
50295,5,2,176263,176263,176265,0,2,2
50296,6,1,176269,176269,176270,0,1,4
50297,1,1,176270,176270,176271,0,1,0
50298,3,3,176273,176273,176276,0,3,2
50299,1,1,176274,176276,176277,2,3,0
50300,2,2,176276,176277,176279,1,3,0
50301,6,3,176282,176282,176285,0,3,3
50302,1,1,176283,176285,176286,2,3,0
50303,1,1,176284,176286,176287,2,3,0
50304,4,1,176288,176288,176289,0,1,1
50305,4,3,176292,176292,176295,0,3,3
50306,1,1,176293,176295,176296,2,3,0
50307,5,2,176298,176298,176300,0,2,2
50308,4,2,176302,176302,176304,0,2,2
50309,6,3,176308,176308,176311,0,3,4
50310,1,2,176309,176311,176313,2,4,0
50311,5,2,176314,176314,176316,0,2,1
50312,6,3,176320,176320,176323,0,3,4
50313,1,2,176321,176323,176325,2,4,0
50314,6,2,176327,176327,176329,0,2,2
50315,1,1,176328,176329,176330,1,2,0
50316,4,3,176332,176332,176335,0,3,2
50317,3,1,176335,176335,176336,0,1,0
50318,3,3,176338,176338,176341,0,3,2
50319,5,3,176343,176343,176346,0,3,2
50320,5,1,176348,176348,176349,0,1,2
50321,3,2,176351,176351,176353,0,2,2
50322,3,2,176354,176354,176356,0,2,1
50323,2,1,176356,176356,176357,0,1,0
50324,5,1,176361,176361,176362,0,1,4
50325,4,3,176365,176365,176368,0,3,3
50326,4,1,176369,176369,176370,0,1,1
50327,4,1,176373,176373,176374,0,1,3
50328,5,3,176378,176378,176381,0,3,4
50329,2,1,176380,176381,176382,1,2,0
50330,6,3,176386,176386,176389,0,3,4
50331,4,1,176390,176390,176391,0,1,1
50332,1,2,176391,176391,176393,0,2,0
50333,5,1,176396,176396,176397,0,1,3
50334,2,1,176398,176398,176399,0,1,1
50335,5,2,176403,176403,176405,0,2,4
50336,2,3,176405,176405,176408,0,3,0
50337,6,3,176411,176411,176414,0,3,3
50338,1,3,176412,176414,176417,2,5,0
50339,2,2,176414,176417,176419,3,5,0
50340,6,3,176420,176420,176423,0,3,1
50341,3,3,176423,176423,176426,0,3,0
50342,5,3,176428,176428,176431,0,3,2
50343,3,2,176431,176431,176433,0,2,0
50344,2,3,176433,176433,176436,0,3,0
50345,2,3,176435,176436,176439,1,4,0
50346,6,1,176441,176441,176442,0,1,2
50347,3,1,176444,176444,176445,0,1,2
50348,4,2,176448,176448,176450,0,2,3
50349,4,2,176452,176452,176454,0,2,2
50350,3,1,176455,176455,176456,0,1,1
50351,4,1,176459,176459,176460,0,1,3
50352,3,2,176462,176462,176464,0,2,2
50353,6,1,176468,176468,176469,0,1,4
50354,4,1,176472,176472,176473,0,1,3
50355,5,2,176477,176477,176479,0,2,4
50356,4,1,176481,176481,176482,0,1,2
50357,2,1,176483,176483,176484,0,1,1
50358,6,2,176489,176489,176491,0,2,5
50359,4,3,176493,176493,176496,0,3,2
50360,4,2,176497,176497,176499,0,2,1
50361,2,1,176499,176499,176500,0,1,0
50362,5,3,176504,176504,176507,0,3,4
50363,4,3,176508,176508,176511,0,3,1
50364,2,2,176510,176511,176513,1,3,0
50365,2,1,176512,176513,176514,1,2,0
50366,4,1,176516,176516,176517,0,1,2
50367,6,3,176522,176522,176525,0,3,5
50368,6,1,176528,176528,176529,0,1,3
50369,4,2,176532,176532,176534,0,2,3
50370,1,3,176533,176534,176537,1,4,0
50371,6,1,176539,176539,176540,0,1,2
50372,5,2,176544,176544,176546,0,2,4
50373,1,2,176545,176546,176548,1,3,0
50374,1,2,176546,176548,176550,2,4,0
50375,1,3,176547,176550,176553,3,6,0
50376,3,2,176550,176553,176555,3,5,0
50377,3,2,176553,176555,176557,2,4,0
50378,2,1,176555,176557,176558,2,3,0
50379,4,1,176559,176559,176560,0,1,1
50380,3,1,176562,176562,176563,0,1,2
50381,4,1,176566,176566,176567,0,1,3
50382,1,3,176567,176567,176570,0,3,0
50383,2,3,176569,176570,176573,1,4,0
50384,3,2,176572,176573,176575,1,3,0
50385,6,3,176578,176578,176581,0,3,3
50386,5,1,176583,176583,176584,0,1,2
50387,3,2,176586,176586,176588,0,2,2
50388,6,1,176592,176592,176593,0,1,4
50389,4,3,176596,176596,176599,0,3,3
50390,2,1,176598,176599,176600,1,2,0
50391,5,1,176603,176603,176604,0,1,3
50392,1,3,176604,176604,176607,0,3,0
50393,6,2,176610,176610,176612,0,2,3
50394,4,1,176614,176614,176615,0,1,2
50395,2,2,176616,176616,176618,0,2,1
50396,5,2,176621,176621,176623,0,2,3
50397,2,3,176623,176623,176626,0,3,0
50398,1,2,176624,176626,176628,2,4,0
50399,4,3,176628,176628,176631,0,3,0
50400,4,1,176632,176632,176633,0,1,1
50401,5,1,176637,176637,176638,0,1,4
50402,4,1,176641,176641,176642,0,1,3
50403,6,3,176647,176647,176650,0,3,5
50404,1,1,176648,176650,176651,2,3,0
50405,5,1,176653,176653,176654,0,1,2
50406,5,2,176658,176658,176660,0,2,4
50407,6,2,176664,176664,176666,0,2,4
50408,1,2,176665,176666,176668,1,3,0
50409,2,3,176667,176668,176671,1,4,0
50410,1,2,176668,176671,176673,3,5,0
50411,5,1,176673,176673,176674,0,1,0
50412,5,1,176678,176678,176679,0,1,4
50413,4,3,176682,176682,176685,0,3,3
50414,5,3,176687,176687,176690,0,3,2
50415,4,3,176691,176691,176694,0,3,1
50416,1,3,176692,176694,176697,2,5,0
50417,5,3,176697,176697,176700,0,3,0
50418,3,1,176700,176700,176701,0,1,0
50419,1,1,176701,176701,176702,0,1,0
50420,3,2,176704,176704,176706,0,2,2
50421,6,2,176710,176710,176712,0,2,4
50422,1,2,176711,176712,176714,1,3,0
50423,1,2,176712,176714,176716,2,4,0
50424,2,3,176714,176716,176719,2,5,0
50425,5,3,176719,176719,176722,0,3,0
50426,3,1,176722,176722,176723,0,1,0
50427,6,2,176728,176728,176730,0,2,5
50428,6,2,176734,176734,176736,0,2,4
50429,6,2,176740,176740,176742,0,2,4
50430,4,3,176744,176744,176747,0,3,2
50431,2,2,176746,176747,176749,1,3,0
50432,5,2,176751,176751,176753,0,2,2
50433,3,2,176754,176754,176756,0,2,1
50434,2,1,176756,176756,176757,0,1,0
50435,3,1,176759,176759,176760,0,1,2
50436,2,2,176761,176761,176763,0,2,1
50437,4,2,176765,176765,176767,0,2,2
50438,4,3,176769,176769,176772,0,3,2
50439,5,3,176774,176774,176777,0,3,2
50440,5,2,176779,176779,176781,0,2,2
50441,1,3,176780,176781,176784,1,4,0
50442,1,3,176781,176784,176787,3,6,0
50443,2,3,176783,176787,176790,4,7,0
50444,1,1,176784,176790,176791,6,7,0
50445,2,2,176786,176791,176793,5,7,0
50446,4,1,176790,176793,176794,3,4,0
50447,1,3,176791,176794,176797,3,6,0
50448,6,3,176797,176797,176800,0,3,0
50449,2,3,176799,176800,176803,1,4,0
50450,5,1,176804,176804,176805,0,1,1
50451,2,2,176806,176806,176808,0,2,1
50452,4,3,176810,176810,176813,0,3,2
50453,2,1,176812,176813,176814,1,2,0
50454,4,1,176816,176816,176817,0,1,2
50455,1,2,176817,176817,176819,0,2,0
50456,2,2,176819,176819,176821,0,2,0
50457,6,2,176825,176825,176827,0,2,4
50458,6,1,176831,176831,176832,0,1,4
50459,3,3,176834,176834,176837,0,3,2
50460,2,2,176836,176837,176839,1,3,0
50461,1,3,176837,176839,176842,2,5,0
50462,3,2,176840,176842,176844,2,4,0
50463,2,2,176842,176844,176846,2,4,0
50464,1,2,176843,176846,176848,3,5,0
50465,4,3,176847,176848,176851,1,4,0
50466,6,2,176853,176853,176855,0,2,2
50467,3,1,176856,176856,176857,0,1,1
50468,4,3,176860,176860,176863,0,3,3
50469,6,1,176866,176866,176867,0,1,3
50470,1,1,176867,176867,176868,0,1,0
50471,3,2,176870,176870,176872,0,2,2
50472,5,2,176875,176875,176877,0,2,3
50473,3,2,176878,176878,176880,0,2,1
50474,5,1,176883,176883,176884,0,1,3
50475,4,1,176887,176887,176888,0,1,3
50476,4,2,176891,176891,176893,0,2,3
50477,1,2,176892,176893,176895,1,3,0
50478,2,2,176894,176895,176897,1,3,0
50479,3,3,176897,176897,176900,0,3,0
50480,4,3,176901,176901,176904,0,3,1
50481,3,3,176904,176904,176907,0,3,0
50482,2,2,176906,176907,176909,1,3,0
50483,4,3,176910,176910,176913,0,3,1
50484,4,2,176914,176914,176916,0,2,1
50485,4,3,176918,176918,176921,0,3,2
50486,1,1,176919,176921,176922,2,3,0
50487,5,1,176924,176924,176925,0,1,2
50488,4,1,176928,176928,176929,0,1,3
50489,4,2,176932,176932,176934,0,2,3
50490,6,3,176938,176938,176941,0,3,4
50491,4,1,176942,176942,176943,0,1,1
50492,3,1,176945,176945,176946,0,1,2
50493,5,3,176950,176950,176953,0,3,4
50494,5,1,176955,176955,176956,0,1,2
50495,1,2,176956,176956,176958,0,2,0
50496,4,2,176960,176960,176962,0,2,2
50497,1,3,176961,176962,176965,1,4,0
50498,3,3,176964,176965,176968,1,4,0
50499,3,3,176967,176968,176971,1,4,0
50500,6,2,176973,176973,176975,0,2,2
50501,6,1,176979,176979,176980,0,1,4
50502,4,2,176983,176983,176985,0,2,3
50503,5,1,176988,176988,176989,0,1,3
50504,6,3,176994,176994,176997,0,3,5
50505,4,1,176998,176998,176999,0,1,1
50506,5,3,177003,177003,177006,0,3,4
50507,6,3,177009,177009,177012,0,3,3
50508,2,2,177011,177012,177014,1,3,0
50509,4,2,177015,177015,177017,0,2,1
50510,4,1,177019,177019,177020,0,1,2
50511,4,2,177023,177023,177025,0,2,3
50512,3,1,177026,177026,177027,0,1,1
50513,6,2,177032,177032,177034,0,2,5
50514,5,2,177037,177037,177039,0,2,3
50515,1,3,177038,177039,177042,1,4,0
50516,2,2,177040,177042,177044,2,4,0
50517,1,3,177041,177044,177047,3,6,0
50518,6,1,177047,177047,177048,0,1,0
50519,6,3,177053,177053,177056,0,3,5
50520,6,1,177059,177059,177060,0,1,3
50521,1,1,177060,177060,177061,0,1,0
50522,2,3,177062,177062,177065,0,3,1
50523,3,2,177065,177065,177067,0,2,0
50524,4,3,177069,177069,177072,0,3,2
50525,5,3,177074,177074,177077,0,3,2
50526,2,2,177076,177077,177079,1,3,0
50527,6,1,177082,177082,177083,0,1,3
50528,4,3,177086,177086,177089,0,3,3
50529,6,3,177092,177092,177095,0,3,3
50530,4,3,177096,177096,177099,0,3,1
50531,3,2,177099,177099,177101,0,2,0
50532,5,2,177104,177104,177106,0,2,3
50533,5,3,177109,177109,177112,0,3,3
50534,3,1,177112,177112,177113,0,1,0
50535,6,2,177118,177118,177120,0,2,5
50536,1,3,177119,177120,177123,1,4,0
50537,3,2,177122,177123,177125,1,3,0
50538,1,1,177123,177125,177126,2,3,0
50539,4,1,177127,177127,177128,0,1,1
50540,4,1,177131,177131,177132,0,1,3
50541,1,2,177132,177132,177134,0,2,0
50542,2,1,177134,177134,177135,0,1,0
50543,1,2,177135,177135,177137,0,2,0
50544,5,1,177140,177140,177141,0,1,3
50545,6,1,177146,177146,177147,0,1,5
50546,4,3,177150,177150,177153,0,3,3
50547,2,1,177152,177153,177154,1,2,0
50548,5,2,177157,177157,177159,0,2,3
50549,3,3,177160,177160,177163,0,3,1
50550,2,3,177162,177163,177166,1,4,0
50551,6,2,177168,177168,177170,0,2,2
50552,2,2,177170,177170,177172,0,2,0
50553,2,3,177172,177172,177175,0,3,0
50554,6,3,177178,177178,177181,0,3,3
50555,5,2,177183,177183,177185,0,2,2
50556,1,2,177184,177185,177187,1,3,0
50557,1,3,177185,177187,177190,2,5,0
50558,3,1,177188,177190,177191,2,3,0
50559,6,1,177194,177194,177195,0,1,3
50560,4,2,177198,177198,177200,0,2,3
50561,2,3,177200,177200,177203,0,3,0
50562,6,2,177206,177206,177208,0,2,3
50563,2,3,177208,177208,177211,0,3,0
50564,6,3,177214,177214,177217,0,3,3
50565,6,3,177220,177220,177223,0,3,3
50566,6,3,177226,177226,177229,0,3,3
50567,5,3,177231,177231,177234,0,3,2
50568,5,3,177236,177236,177239,0,3,2
50569,1,2,177237,177239,177241,2,4,0
50570,4,2,177241,177241,177243,0,2,0
50571,3,2,177244,177244,177246,0,2,1
50572,5,2,177249,177249,177251,0,2,3
50573,4,2,177253,177253,177255,0,2,2
50574,3,3,177256,177256,177259,0,3,1
50575,5,2,177261,177261,177263,0,2,2
50576,4,3,177265,177265,177268,0,3,2
50577,3,1,177268,177268,177269,0,1,0
50578,2,3,177270,177270,177273,0,3,1
50579,3,2,177273,177273,177275,0,2,0
50580,1,3,177274,177275,177278,1,4,0
50581,3,1,177277,177278,177279,1,2,0
50582,1,1,177278,177279,177280,1,2,0
50583,2,2,177280,177280,177282,0,2,0
50584,5,1,177285,177285,177286,0,1,3
50585,4,1,177289,177289,177290,0,1,3
50586,4,3,177293,177293,177296,0,3,3
50587,3,1,177296,177296,177297,0,1,0
50588,1,3,177297,177297,177300,0,3,0
50589,6,1,177303,177303,177304,0,1,3
50590,1,3,177304,177304,177307,0,3,0
50591,6,3,177310,177310,177313,0,3,3
50592,1,2,177311,177313,177315,2,4,0
50593,1,3,177312,177315,177318,3,6,0
50594,2,1,177314,177318,177319,4,5,0
50595,5,1,177319,177319,177320,0,1,0
50596,1,2,177320,177320,177322,0,2,0
50597,1,3,177321,177322,177325,1,4,0
50598,5,1,177326,177326,177327,0,1,1
50599,1,3,177327,177327,177330,0,3,0
50600,3,3,177330,177330,177333,0,3,0
50601,1,3,177331,177333,177336,2,5,0
50602,5,1,177336,177336,177337,0,1,0
50603,1,3,177337,177337,177340,0,3,0
50604,3,3,177340,177340,177343,0,3,0
50605,3,1,177343,177343,177344,0,1,0
50606,5,2,177348,177348,177350,0,2,4
50607,6,1,177354,177354,177355,0,1,4
50608,3,3,177357,177357,177360,0,3,2
50609,5,3,177362,177362,177365,0,3,2
50610,5,1,177367,177367,177368,0,1,2
50611,6,1,177373,177373,177374,0,1,5
50612,1,1,177374,177374,177375,0,1,0
50613,4,3,177378,177378,177381,0,3,3
50614,5,2,177383,177383,177385,0,2,2
50615,5,3,177388,177388,177391,0,3,3
50616,2,2,177390,177391,177393,1,3,0
50617,3,3,177393,177393,177396,0,3,0
50618,3,3,177396,177396,177399,0,3,0
50619,3,3,177399,177399,177402,0,3,0
50620,6,2,177405,177405,177407,0,2,3
50621,5,2,177410,177410,177412,0,2,3
50622,5,1,177415,177415,177416,0,1,3
50623,3,3,177418,177418,177421,0,3,2
50624,2,2,177420,177421,177423,1,3,0
50625,2,1,177422,177423,177424,1,2,0
50626,6,1,177428,177428,177429,0,1,4
50627,2,2,177430,177430,177432,0,2,1
50628,2,1,177432,177432,177433,0,1,0
50629,1,2,177433,177433,177435,0,2,0
50630,3,1,177436,177436,177437,0,1,1
50631,5,1,177441,177441,177442,0,1,4
50632,1,1,177442,177442,177443,0,1,0
50633,1,1,177443,177443,177444,0,1,0
50634,4,1,177447,177447,177448,0,1,3
50635,6,2,177453,177453,177455,0,2,5
50636,4,2,177457,177457,177459,0,2,2
50637,1,2,177458,177459,177461,1,3,0
50638,3,1,177461,177461,177462,0,1,0
50639,4,1,177465,177465,177466,0,1,3
50640,6,2,177471,177471,177473,0,2,5
50641,3,1,177474,177474,177475,0,1,1
50642,4,1,177478,177478,177479,0,1,3
50643,4,3,177482,177482,177485,0,3,3
50644,2,3,177484,177485,177488,1,4,0
50645,3,3,177487,177488,177491,1,4,0
50646,4,3,177491,177491,177494,0,3,0
50647,5,1,177496,177496,177497,0,1,2
50648,1,2,177497,177497,177499,0,2,0
50649,2,3,177499,177499,177502,0,3,0
50650,4,1,177503,177503,177504,0,1,1
50651,5,2,177508,177508,177510,0,2,4
50652,2,2,177510,177510,177512,0,2,0
50653,4,3,177514,177514,177517,0,3,2
50654,6,3,177520,177520,177523,0,3,3
50655,1,1,177521,177523,177524,2,3,0
50656,5,2,177526,177526,177528,0,2,2
50657,5,3,177531,177531,177534,0,3,3
50658,3,3,177534,177534,177537,0,3,0
50659,1,2,177535,177537,177539,2,4,0
50660,6,3,177541,177541,177544,0,3,2
50661,2,1,177543,177544,177545,1,2,0
50662,4,1,177547,177547,177548,0,1,2
50663,3,1,177550,177550,177551,0,1,2
50664,5,2,177555,177555,177557,0,2,4
50665,6,3,177561,177561,177564,0,3,4
50666,6,1,177567,177567,177568,0,1,3
50667,6,3,177573,177573,177576,0,3,5
50668,2,2,177575,177576,177578,1,3,0
50669,1,3,177576,177578,177581,2,5,0
50670,6,2,177582,177582,177584,0,2,1
50671,2,2,177584,177584,177586,0,2,0
50672,4,3,177588,177588,177591,0,3,2
50673,4,2,177592,177592,177594,0,2,1
50674,2,2,177594,177594,177596,0,2,0
50675,5,1,177599,177599,177600,0,1,3
50676,4,2,177603,177603,177605,0,2,3
50677,2,2,177605,177605,177607,0,2,0
50678,1,1,177606,177607,177608,1,2,0
50679,4,1,177610,177610,177611,0,1,2
50680,5,3,177615,177615,177618,0,3,4
50681,3,2,177618,177618,177620,0,2,0
50682,1,3,177619,177620,177623,1,4,0
50683,4,1,177623,177623,177624,0,1,0
50684,1,3,177624,177624,177627,0,3,0
50685,4,2,177628,177628,177630,0,2,1
50686,3,3,177631,177631,177634,0,3,1
50687,4,2,177635,177635,177637,0,2,1
50688,6,3,177641,177641,177644,0,3,4
50689,6,2,177647,177647,177649,0,2,3
50690,4,3,177651,177651,177654,0,3,2
50691,5,2,177656,177656,177658,0,2,2
50692,2,1,177658,177658,177659,0,1,0
50693,5,2,177663,177663,177665,0,2,4
50694,5,1,177668,177668,177669,0,1,3
50695,5,2,177673,177673,177675,0,2,4
50696,1,1,177674,177675,177676,1,2,0
50697,3,3,177677,177677,177680,0,3,1
50698,1,2,177678,177680,177682,2,4,0
50699,4,1,177682,177682,177683,0,1,0
50700,1,2,177683,177683,177685,0,2,0
50701,2,2,177685,177685,177687,0,2,0
50702,4,3,177689,177689,177692,0,3,2
50703,4,1,177693,177693,177694,0,1,1
50704,3,3,177696,177696,177699,0,3,2
50705,3,3,177699,177699,177702,0,3,0
50706,4,3,177703,177703,177706,0,3,1
50707,5,2,177708,177708,177710,0,2,2
50708,2,1,177710,177710,177711,0,1,0
50709,5,2,177715,177715,177717,0,2,4
50710,4,2,177719,177719,177721,0,2,2
50711,2,1,177721,177721,177722,0,1,0
50712,4,1,177725,177725,177726,0,1,3
50713,3,1,177728,177728,177729,0,1,2
50714,1,1,177729,177729,177730,0,1,0
50715,1,2,177730,177730,177732,0,2,0
50716,2,1,177732,177732,177733,0,1,0
50717,3,3,177735,177735,177738,0,3,2
50718,3,3,177738,177738,177741,0,3,0
50719,1,3,177739,177741,177744,2,5,0
50720,4,2,177743,177744,177746,1,3,0
50721,1,2,177744,177746,177748,2,4,0
50722,6,1,177750,177750,177751,0,1,2
50723,2,3,177752,177752,177755,0,3,1
50724,5,2,177757,177757,177759,0,2,2
50725,3,3,177760,177760,177763,0,3,1
50726,6,1,177766,177766,177767,0,1,3
50727,6,3,177772,177772,177775,0,3,5
50728,2,3,177774,177775,177778,1,4,0
50729,3,1,177777,177778,177779,1,2,0
50730,5,1,177782,177782,177783,0,1,3
50731,1,3,177783,177783,177786,0,3,0
50732,4,1,177787,177787,177788,0,1,1
50733,3,2,177790,177790,177792,0,2,2
50734,1,1,177791,177792,177793,1,2,0
50735,3,2,177794,177794,177796,0,2,1
50736,3,1,177797,177797,177798,0,1,1
50737,6,1,177803,177803,177804,0,1,5
50738,3,2,177806,177806,177808,0,2,2
50739,6,3,177812,177812,177815,0,3,4
50740,5,3,177817,177817,177820,0,3,2
50741,5,2,177822,177822,177824,0,2,2
50742,5,3,177827,177827,177830,0,3,3
50743,2,2,177829,177830,177832,1,3,0
50744,3,3,177832,177832,177835,0,3,0
50745,2,3,177834,177835,177838,1,4,0
50746,1,3,177835,177838,177841,3,6,0
50747,1,2,177836,177841,177843,5,7,0
50748,4,2,177840,177843,177845,3,5,0
50749,6,1,177846,177846,177847,0,1,1
50750,1,1,177847,177847,177848,0,1,0
50751,4,3,177851,177851,177854,0,3,3
50752,5,2,177856,177856,177858,0,2,2
50753,2,3,177858,177858,177861,0,3,0
50754,6,2,177864,177864,177866,0,2,3
50755,5,2,177869,177869,177871,0,2,3
50756,6,3,177875,177875,177878,0,3,4
50757,5,2,177880,177880,177882,0,2,2
50758,2,3,177882,177882,177885,0,3,0
50759,5,1,177887,177887,177888,0,1,2
50760,2,1,177889,177889,177890,0,1,1
50761,3,1,177892,177892,177893,0,1,2
50762,2,3,177894,177894,177897,0,3,1
50763,1,2,177895,177897,177899,2,4,0
50764,1,2,177896,177899,177901,3,5,0
50765,5,1,177901,177901,177902,0,1,0
50766,5,3,177906,177906,177909,0,3,4
50767,2,1,177908,177909,177910,1,2,0
50768,5,3,177913,177913,177916,0,3,3
50769,4,1,177917,177917,177918,0,1,1
50770,5,2,177922,177922,177924,0,2,4
50771,1,2,177923,177924,177926,1,3,0
50772,4,2,177927,177927,177929,0,2,1
50773,1,1,177928,177929,177930,1,2,0
50774,5,1,177933,177933,177934,0,1,3
50775,6,3,177939,177939,177942,0,3,5
50776,6,2,177945,177945,177947,0,2,3
50777,2,1,177947,177947,177948,0,1,0
50778,2,1,177949,177949,177950,0,1,1
50779,3,3,177952,177952,177955,0,3,2
50780,1,3,177953,177955,177958,2,5,0
50781,2,3,177955,177958,177961,3,6,0
50782,4,3,177959,177961,177964,2,5,0
50783,4,2,177963,177964,177966,1,3,0
50784,4,2,177967,177967,177969,0,2,1
50785,2,1,177969,177969,177970,0,1,0
50786,6,2,177975,177975,177977,0,2,5
50787,3,1,177978,177978,177979,0,1,1
50788,4,2,177982,177982,177984,0,2,3
50789,5,1,177987,177987,177988,0,1,3
50790,5,3,177992,177992,177995,0,3,4
50791,5,1,177997,177997,177998,0,1,2
50792,3,3,178000,178000,178003,0,3,2
50793,5,2,178005,178005,178007,0,2,2
50794,2,2,178007,178007,178009,0,2,0
50795,6,1,178013,178013,178014,0,1,4
50796,3,1,178016,178016,178017,0,1,2
50797,4,2,178020,178020,178022,0,2,3
50798,3,1,178023,178023,178024,0,1,1
50799,6,3,178029,178029,178032,0,3,5
50800,3,2,178032,178032,178034,0,2,0
50801,3,2,178035,178035,178037,0,2,1
50802,5,1,178040,178040,178041,0,1,3
50803,2,1,178042,178042,178043,0,1,1
50804,6,3,178048,178048,178051,0,3,5
50805,6,1,178054,178054,178055,0,1,3
50806,4,3,178058,178058,178061,0,3,3
50807,3,3,178061,178061,178064,0,3,0
50808,3,3,178064,178064,178067,0,3,0
50809,4,2,178068,178068,178070,0,2,1
50810,5,3,178073,178073,178076,0,3,3
50811,4,2,178077,178077,178079,0,2,1
50812,1,2,178078,178079,178081,1,3,0
50813,3,2,178081,178081,178083,0,2,0
50814,6,2,178087,178087,178089,0,2,4
50815,2,3,178089,178089,178092,0,3,0
50816,1,2,178090,178092,178094,2,4,0
50817,2,2,178092,178094,178096,2,4,0
50818,6,1,178098,178098,178099,0,1,2
50819,6,1,178104,178104,178105,0,1,5
50820,5,3,178109,178109,178112,0,3,4
50821,5,2,178114,178114,178116,0,2,2
50822,1,1,178115,178116,178117,1,2,0
50823,2,2,178117,178117,178119,0,2,0
50824,2,3,178119,178119,178122,0,3,0
50825,3,2,178122,178122,178124,0,2,0
50826,1,2,178123,178124,178126,1,3,0
50827,2,2,178125,178126,178128,1,3,0
50828,5,2,178130,178130,178132,0,2,2
50829,4,1,178134,178134,178135,0,1,2
50830,1,1,178135,178135,178136,0,1,0
50831,4,3,178139,178139,178142,0,3,3
50832,4,3,178143,178143,178146,0,3,1
50833,4,2,178147,178147,178149,0,2,1
50834,4,1,178151,178151,178152,0,1,2
50835,3,1,178154,178154,178155,0,1,2
50836,2,2,178156,178156,178158,0,2,1
50837,6,3,178162,178162,178165,0,3,4
50838,3,1,178165,178165,178166,0,1,0
50839,4,2,178169,178169,178171,0,2,3
50840,2,1,178171,178171,178172,0,1,0
50841,4,1,178175,178175,178176,0,1,3
50842,6,2,178181,178181,178183,0,2,5
50843,2,2,178183,178183,178185,0,2,0
50844,6,1,178189,178189,178190,0,1,4
50845,2,2,178191,178191,178193,0,2,1
50846,5,1,178196,178196,178197,0,1,3
50847,1,3,178197,178197,178200,0,3,0
50848,4,2,178201,178201,178203,0,2,1
50849,2,2,178203,178203,178205,0,2,0
50850,3,2,178206,178206,178208,0,2,1
50851,6,1,178212,178212,178213,0,1,4
50852,4,1,178216,178216,178217,0,1,3
50853,5,1,178221,178221,178222,0,1,4
50854,5,2,178226,178226,178228,0,2,4
50855,2,3,178228,178228,178231,0,3,0
50856,3,1,178231,178231,178232,0,1,0
50857,5,1,178236,178236,178237,0,1,4
50858,6,2,178242,178242,178244,0,2,5
50859,4,1,178246,178246,178247,0,1,2
50860,5,3,178251,178251,178254,0,3,4
50861,2,3,178253,178254,178257,1,4,0
50862,4,1,178257,178257,178258,0,1,0
50863,3,1,178260,178260,178261,0,1,2
50864,6,1,178266,178266,178267,0,1,5
50865,4,2,178270,178270,178272,0,2,3
50866,2,1,178272,178272,178273,0,1,0
50867,2,2,178274,178274,178276,0,2,1
50868,3,3,178277,178277,178280,0,3,1
50869,3,1,178280,178280,178281,0,1,0
50870,6,1,178286,178286,178287,0,1,5
50871,5,3,178291,178291,178294,0,3,4
50872,1,3,178292,178294,178297,2,5,0
50873,2,1,178294,178297,178298,3,4,0
50874,4,2,178298,178298,178300,0,2,0
50875,1,1,178299,178300,178301,1,2,0
50876,3,1,178302,178302,178303,0,1,1
50877,6,1,178308,178308,178309,0,1,5
50878,5,3,178313,178313,178316,0,3,4
50879,3,2,178316,178316,178318,0,2,0
50880,3,2,178319,178319,178321,0,2,1
50881,1,3,178320,178321,178324,1,4,0
50882,2,1,178322,178324,178325,2,3,0
50883,5,2,178327,178327,178329,0,2,2
50884,6,3,178333,178333,178336,0,3,4
50885,5,2,178338,178338,178340,0,2,2
50886,3,2,178341,178341,178343,0,2,1
50887,2,3,178343,178343,178346,0,3,0
50888,6,3,178349,178349,178352,0,3,3
50889,5,3,178354,178354,178357,0,3,2
50890,6,3,178360,178360,178363,0,3,3
50891,2,2,178362,178363,178365,1,3,0
50892,2,3,178364,178365,178368,1,4,0
50893,6,1,178370,178370,178371,0,1,2
50894,5,3,178375,178375,178378,0,3,4
50895,5,1,178380,178380,178381,0,1,2
50896,1,2,178381,178381,178383,0,2,0
50897,5,1,178386,178386,178387,0,1,3
50898,6,3,178392,178392,178395,0,3,5
50899,5,1,178397,178397,178398,0,1,2
50900,5,2,178402,178402,178404,0,2,4
50901,5,1,178407,178407,178408,0,1,3
50902,4,2,178411,178411,178413,0,2,3
50903,1,2,178412,178413,178415,1,3,0
50904,6,2,178418,178418,178420,0,2,3
50905,2,1,178420,178420,178421,0,1,0
50906,6,1,178426,178426,178427,0,1,5
50907,1,2,178427,178427,178429,0,2,0
50908,5,1,178432,178432,178433,0,1,3
50909,6,2,178438,178438,178440,0,2,5
50910,2,1,178440,178440,178441,0,1,0
50911,5,2,178445,178445,178447,0,2,4
50912,6,1,178451,178451,178452,0,1,4
50913,6,2,178457,178457,178459,0,2,5
50914,6,2,178463,178463,178465,0,2,4
50915,3,2,178466,178466,178468,0,2,1
50916,1,2,178467,178468,178470,1,3,0
50917,2,2,178469,178470,178472,1,3,0
50918,5,3,178474,178474,178477,0,3,2
50919,1,2,178475,178477,178479,2,4,0
50920,1,2,178476,178479,178481,3,5,0
50921,5,1,178481,178481,178482,0,1,0
50922,5,2,178486,178486,178488,0,2,4
50923,2,1,178488,178488,178489,0,1,0
50924,4,3,178492,178492,178495,0,3,3
50925,2,1,178494,178495,178496,1,2,0
50926,3,3,178497,178497,178500,0,3,1
50927,4,3,178501,178501,178504,0,3,1
50928,2,2,178503,178504,178506,1,3,0
50929,5,3,178508,178508,178511,0,3,2
50930,4,2,178512,178512,178514,0,2,1
50931,5,2,178517,178517,178519,0,2,3
50932,5,2,178522,178522,178524,0,2,3
50933,4,3,178526,178526,178529,0,3,2
50934,4,3,178530,178530,178533,0,3,1
50935,4,1,178534,178534,178535,0,1,1
50936,3,2,178537,178537,178539,0,2,2
50937,6,1,178543,178543,178544,0,1,4
50938,2,1,178545,178545,178546,0,1,1
50939,1,1,178546,178546,178547,0,1,0
50940,3,1,178549,178549,178550,0,1,2
50941,5,3,178554,178554,178557,0,3,4
50942,3,3,178557,178557,178560,0,3,0
50943,1,1,178558,178560,178561,2,3,0
50944,6,3,178564,178564,178567,0,3,3
50945,5,2,178569,178569,178571,0,2,2
50946,3,1,178572,178572,178573,0,1,1
50947,5,2,178577,178577,178579,0,2,4
50948,2,1,178579,178579,178580,0,1,0
50949,4,3,178583,178583,178586,0,3,3
50950,5,2,178588,178588,178590,0,2,2
50951,5,1,178593,178593,178594,0,1,3
50952,6,1,178599,178599,178600,0,1,5
50953,6,3,178605,178605,178608,0,3,5
50954,6,1,178611,178611,178612,0,1,3
50955,1,1,178612,178612,178613,0,1,0
50956,1,2,178613,178613,178615,0,2,0
50957,4,2,178617,178617,178619,0,2,2
50958,4,3,178621,178621,178624,0,3,2
50959,1,1,178622,178624,178625,2,3,0
50960,4,1,178626,178626,178627,0,1,1
50961,3,3,178629,178629,178632,0,3,2
50962,2,3,178631,178632,178635,1,4,0
50963,2,2,178633,178635,178637,2,4,0
50964,2,3,178635,178637,178640,2,5,0
50965,3,2,178638,178640,178642,2,4,0
50966,4,2,178642,178642,178644,0,2,0
50967,5,3,178647,178647,178650,0,3,3
50968,5,3,178652,178652,178655,0,3,2
50969,6,2,178658,178658,178660,0,2,3
50970,5,2,178663,178663,178665,0,2,3
50971,5,2,178668,178668,178670,0,2,3
50972,5,1,178673,178673,178674,0,1,3
50973,3,1,178676,178676,178677,0,1,2
50974,3,1,178679,178679,178680,0,1,2
50975,3,2,178682,178682,178684,0,2,2
50976,3,2,178685,178685,178687,0,2,1
50977,4,3,178689,178689,178692,0,3,2
50978,2,2,178691,178692,178694,1,3,0
50979,2,3,178693,178694,178697,1,4,0
50980,5,1,178698,178698,178699,0,1,1
50981,2,3,178700,178700,178703,0,3,1
50982,1,3,178701,178703,178706,2,5,0
50983,1,3,178702,178706,178709,4,7,0
50984,6,1,178708,178709,178710,1,2,0
50985,1,2,178709,178710,178712,1,3,0
50986,5,3,178714,178714,178717,0,3,2
50987,6,1,178720,178720,178721,0,1,3
50988,2,2,178722,178722,178724,0,2,1
50989,2,1,178724,178724,178725,0,1,0
50990,5,2,178729,178729,178731,0,2,4
50991,6,2,178735,178735,178737,0,2,4
50992,6,3,178741,178741,178744,0,3,4
50993,3,2,178744,178744,178746,0,2,0
50994,2,1,178746,178746,178747,0,1,0
50995,2,2,178748,178748,178750,0,2,1
50996,1,1,178749,178750,178751,1,2,0
50997,6,1,178755,178755,178756,0,1,4
50998,5,1,178760,178760,178761,0,1,4
50999,4,1,178764,178764,178765,0,1,3
51000,5,2,178769,178769,178771,0,2,4
51001,2,1,178771,178771,178772,0,1,0
51002,4,2,178775,178775,178777,0,2,3
51003,6,3,178781,178781,178784,0,3,4
51004,2,1,178783,178784,178785,1,2,0
51005,1,2,178784,178785,178787,1,3,0
51006,1,3,178785,178787,178790,2,5,0
51007,2,3,178787,178790,178793,3,6,0
51008,2,1,178789,178793,178794,4,5,0
51009,6,1,178795,178795,178796,0,1,1
51010,6,2,178801,178801,178803,0,2,5
51011,3,1,178804,178804,178805,0,1,1
51012,4,1,178808,178808,178809,0,1,3
51013,5,2,178813,178813,178815,0,2,4
51014,2,1,178815,178815,178816,0,1,0
51015,5,3,178820,178820,178823,0,3,4
51016,5,1,178825,178825,178826,0,1,2
51017,3,3,178828,178828,178831,0,3,2
51018,3,1,178831,178831,178832,0,1,0
51019,5,2,178836,178836,178838,0,2,4
51020,2,3,178838,178838,178841,0,3,0
51021,3,3,178841,178841,178844,0,3,0
51022,5,2,178846,178846,178848,0,2,2
51023,4,1,178850,178850,178851,0,1,2
51024,3,3,178853,178853,178856,0,3,2
51025,4,3,178857,178857,178860,0,3,1
51026,1,1,178858,178860,178861,2,3,0
51027,3,3,178861,178861,178864,0,3,0
51028,4,1,178865,178865,178866,0,1,1
51029,3,2,178868,178868,178870,0,2,2
51030,5,2,178873,178873,178875,0,2,3
51031,2,3,178875,178875,178878,0,3,0
51032,4,3,178879,178879,178882,0,3,1
51033,5,2,178884,178884,178886,0,2,2
51034,5,1,178889,178889,178890,0,1,3
51035,6,1,178895,178895,178896,0,1,5
51036,3,2,178898,178898,178900,0,2,2
51037,3,2,178901,178901,178903,0,2,1
51038,1,2,178902,178903,178905,1,3,0
51039,1,3,178903,178905,178908,2,5,0
51040,6,2,178909,178909,178911,0,2,1
51041,3,1,178912,178912,178913,0,1,1
51042,5,2,178917,178917,178919,0,2,4
51043,1,3,178918,178919,178922,1,4,0
51044,4,3,178922,178922,178925,0,3,0
51045,4,2,178926,178926,178928,0,2,1
51046,5,3,178931,178931,178934,0,3,3
51047,5,2,178936,178936,178938,0,2,2
51048,4,3,178940,178940,178943,0,3,2
51049,5,2,178945,178945,178947,0,2,2
51050,5,2,178950,178950,178952,0,2,3
51051,4,3,178954,178954,178957,0,3,2
51052,3,2,178957,178957,178959,0,2,0
51053,6,3,178963,178963,178966,0,3,4
51054,4,1,178967,178967,178968,0,1,1
51055,3,1,178970,178970,178971,0,1,2
51056,2,2,178972,178972,178974,0,2,1
51057,6,3,178978,178978,178981,0,3,4
51058,5,2,178983,178983,178985,0,2,2
51059,3,3,178986,178986,178989,0,3,1
51060,2,2,178988,178989,178991,1,3,0
51061,2,3,178990,178991,178994,1,4,0
51062,6,3,178996,178996,178999,0,3,2
51063,5,1,179001,179001,179002,0,1,2
51064,4,1,179005,179005,179006,0,1,3
51065,6,3,179011,179011,179014,0,3,5
51066,1,3,179012,179014,179017,2,5,0
51067,2,2,179014,179017,179019,3,5,0
51068,3,2,179017,179019,179021,2,4,0
51069,1,3,179018,179021,179024,3,6,0
51070,2,2,179020,179024,179026,4,6,0
51071,3,3,179023,179026,179029,3,6,0
51072,1,3,179024,179029,179032,5,8,0
51073,1,3,179025,179032,179035,7,10,0
51074,6,2,179031,179035,179037,4,6,0
51075,1,3,179032,179037,179040,5,8,0
51076,5,3,179037,179040,179043,3,6,0
51077,3,3,179040,179043,179046,3,6,0
51078,4,3,179044,179046,179049,2,5,0
51079,1,2,179045,179049,179051,4,6,0
51080,3,1,179048,179051,179052,3,4,0
51081,1,2,179049,179052,179054,3,5,0
51082,4,1,179053,179054,179055,1,2,0
51083,4,2,179057,179057,179059,0,2,2
51084,2,1,179059,179059,179060,0,1,0
51085,1,1,179060,179060,179061,0,1,0
51086,5,1,179065,179065,179066,0,1,4
51087,2,3,179067,179067,179070,0,3,1
51088,4,3,179071,179071,179074,0,3,1
51089,3,1,179074,179074,179075,0,1,0
51090,4,3,179078,179078,179081,0,3,3
51091,3,1,179081,179081,179082,0,1,0
51092,1,3,179082,179082,179085,0,3,0
51093,2,2,179084,179085,179087,1,3,0
51094,3,3,179087,179087,179090,0,3,0
51095,1,3,179088,179090,179093,2,5,0
51096,2,2,179090,179093,179095,3,5,0
51097,1,1,179091,179095,179096,4,5,0
51098,4,2,179095,179096,179098,1,3,0
51099,6,2,179101,179101,179103,0,2,3
51100,4,1,179105,179105,179106,0,1,2
51101,1,3,179106,179106,179109,0,3,0
51102,2,1,179108,179109,179110,1,2,0
51103,1,1,179109,179110,179111,1,2,0
51104,4,3,179113,179113,179116,0,3,2
51105,6,3,179119,179119,179122,0,3,3
51106,1,1,179120,179122,179123,2,3,0
51107,6,3,179126,179126,179129,0,3,3
51108,2,2,179128,179129,179131,1,3,0
51109,4,3,179132,179132,179135,0,3,1
51110,3,3,179135,179135,179138,0,3,0
51111,1,1,179136,179138,179139,2,3,0
51112,4,3,179140,179140,179143,0,3,1
51113,4,3,179144,179144,179147,0,3,1
51114,1,3,179145,179147,179150,2,5,0
51115,3,1,179148,179150,179151,2,3,0
51116,6,1,179154,179154,179155,0,1,3
51117,5,2,179159,179159,179161,0,2,4
51118,1,2,179160,179161,179163,1,3,0
51119,3,1,179163,179163,179164,0,1,0
51120,1,3,179164,179164,179167,0,3,0
51121,4,2,179168,179168,179170,0,2,1
51122,2,1,179170,179170,179171,0,1,0
51123,3,2,179173,179173,179175,0,2,2
51124,5,1,179178,179178,179179,0,1,3
51125,5,3,179183,179183,179186,0,3,4
51126,1,3,179184,179186,179189,2,5,0
51127,5,2,179189,179189,179191,0,2,0
51128,4,3,179193,179193,179196,0,3,2
51129,1,2,179194,179196,179198,2,4,0
51130,1,3,179195,179198,179201,3,6,0
51131,6,3,179201,179201,179204,0,3,0
51132,6,2,179207,179207,179209,0,2,3
51133,5,1,179212,179212,179213,0,1,3
51134,5,3,179217,179217,179220,0,3,4
51135,4,2,179221,179221,179223,0,2,1
51136,2,3,179223,179223,179226,0,3,0
51137,4,1,179227,179227,179228,0,1,1
51138,2,3,179229,179229,179232,0,3,1
51139,5,2,179234,179234,179236,0,2,2
51140,4,1,179238,179238,179239,0,1,2
51141,2,1,179240,179240,179241,0,1,1
51142,4,2,179244,179244,179246,0,2,3
51143,4,3,179248,179248,179251,0,3,2
51144,4,2,179252,179252,179254,0,2,1
51145,2,2,179254,179254,179256,0,2,0
51146,3,2,179257,179257,179259,0,2,1
51147,5,2,179262,179262,179264,0,2,3
51148,3,2,179265,179265,179267,0,2,1
51149,6,1,179271,179271,179272,0,1,4
51150,6,2,179277,179277,179279,0,2,5
51151,5,3,179282,179282,179285,0,3,3
51152,5,1,179287,179287,179288,0,1,2
51153,4,1,179291,179291,179292,0,1,3
51154,1,1,179292,179292,179293,0,1,0
51155,2,2,179294,179294,179296,0,2,1
51156,1,3,179295,179296,179299,1,4,0
51157,4,3,179299,179299,179302,0,3,0
51158,2,2,179301,179302,179304,1,3,0
51159,5,3,179306,179306,179309,0,3,2
51160,4,3,179310,179310,179313,0,3,1
51161,5,1,179315,179315,179316,0,1,2
51162,1,2,179316,179316,179318,0,2,0
51163,6,3,179322,179322,179325,0,3,4
51164,5,2,179327,179327,179329,0,2,2
51165,4,3,179331,179331,179334,0,3,2
51166,1,1,179332,179334,179335,2,3,0
51167,5,3,179337,179337,179340,0,3,2
51168,2,1,179339,179340,179341,1,2,0
51169,6,3,179345,179345,179348,0,3,4
51170,2,1,179347,179348,179349,1,2,0
51171,3,2,179350,179350,179352,0,2,1
51172,4,3,179354,179354,179357,0,3,2
51173,5,1,179359,179359,179360,0,1,2
51174,3,1,179362,179362,179363,0,1,2
51175,6,1,179368,179368,179369,0,1,5
51176,3,2,179371,179371,179373,0,2,2
51177,5,2,179376,179376,179378,0,2,3
51178,6,1,179382,179382,179383,0,1,4
51179,5,2,179387,179387,179389,0,2,4
51180,3,1,179390,179390,179391,0,1,1
51181,2,2,179392,179392,179394,0,2,1
51182,3,3,179395,179395,179398,0,3,1
51183,5,2,179400,179400,179402,0,2,2
51184,5,2,179405,179405,179407,0,2,3
51185,4,2,179409,179409,179411,0,2,2
51186,3,2,179412,179412,179414,0,2,1
51187,3,3,179415,179415,179418,0,3,1
51188,4,3,179419,179419,179422,0,3,1
51189,5,3,179424,179424,179427,0,3,2
51190,1,2,179425,179427,179429,2,4,0
51191,3,1,179428,179429,179430,1,2,0
51192,4,3,179432,179432,179435,0,3,2
51193,4,2,179436,179436,179438,0,2,1
51194,6,2,179442,179442,179444,0,2,4
51195,6,1,179448,179448,179449,0,1,4
51196,1,2,179449,179449,179451,0,2,0
51197,2,2,179451,179451,179453,0,2,0
51198,4,3,179455,179455,179458,0,3,2
51199,4,1,179459,179459,179460,0,1,1
51200,4,2,179463,179463,179465,0,2,3
51201,2,3,179465,179465,179468,0,3,0
51202,1,3,179466,179468,179471,2,5,0
51203,3,2,179469,179471,179473,2,4,0
51204,6,1,179475,179475,179476,0,1,2
51205,6,2,179481,179481,179483,0,2,5
51206,4,2,179485,179485,179487,0,2,2
51207,4,2,179489,179489,179491,0,2,2
51208,3,1,179492,179492,179493,0,1,1
51209,6,3,179498,179498,179501,0,3,5
51210,5,1,179503,179503,179504,0,1,2
51211,3,1,179506,179506,179507,0,1,2
51212,5,2,179511,179511,179513,0,2,4
51213,3,2,179514,179514,179516,0,2,1
51214,4,2,179518,179518,179520,0,2,2
51215,3,3,179521,179521,179524,0,3,1
51216,5,3,179526,179526,179529,0,3,2
51217,3,1,179529,179529,179530,0,1,0
51218,6,2,179535,179535,179537,0,2,5
51219,3,1,179538,179538,179539,0,1,1
51220,6,2,179544,179544,179546,0,2,5
51221,6,1,179550,179550,179551,0,1,4
51222,3,3,179553,179553,179556,0,3,2
51223,2,3,179555,179556,179559,1,4,0
51224,3,1,179558,179559,179560,1,2,0
51225,4,3,179562,179562,179565,0,3,2
51226,6,3,179568,179568,179571,0,3,3
51227,5,1,179573,179573,179574,0,1,2
51228,3,1,179576,179576,179577,0,1,2
51229,4,1,179580,179580,179581,0,1,3
51230,1,3,179581,179581,179584,0,3,0
51231,1,1,179582,179584,179585,2,3,0
51232,5,2,179587,179587,179589,0,2,2
51233,3,2,179590,179590,179592,0,2,1
51234,4,2,179594,179594,179596,0,2,2
51235,5,3,179599,179599,179602,0,3,3
51236,1,3,179600,179602,179605,2,5,0
51237,5,2,179605,179605,179607,0,2,0
51238,6,1,179611,179611,179612,0,1,4
51239,6,2,179617,179617,179619,0,2,5
51240,6,3,179623,179623,179626,0,3,4
51241,5,1,179628,179628,179629,0,1,2
51242,5,2,179633,179633,179635,0,2,4
51243,6,3,179639,179639,179642,0,3,4
51244,2,3,179641,179642,179645,1,4,0
51245,2,3,179643,179645,179648,2,5,0
51246,1,2,179644,179648,179650,4,6,0
51247,1,3,179645,179650,179653,5,8,0
51248,1,2,179646,179653,179655,7,9,0
51249,6,2,179652,179655,179657,3,5,0
51250,5,3,179657,179657,179660,0,3,0
51251,3,3,179660,179660,179663,0,3,0
51252,5,3,179665,179665,179668,0,3,2
51253,5,1,179670,179670,179671,0,1,2
51254,3,2,179673,179673,179675,0,2,2
51255,3,2,179676,179676,179678,0,2,1
51256,2,2,179678,179678,179680,0,2,0
51257,1,1,179679,179680,179681,1,2,0
51258,5,3,179684,179684,179687,0,3,3
51259,6,1,179690,179690,179691,0,1,3
51260,4,1,179694,179694,179695,0,1,3
51261,1,3,179695,179695,179698,0,3,0
51262,3,1,179698,179698,179699,0,1,0
51263,6,1,179704,179704,179705,0,1,5
51264,5,1,179709,179709,179710,0,1,4
51265,1,1,179710,179710,179711,0,1,0
51266,4,1,179714,179714,179715,0,1,3
51267,4,1,179718,179718,179719,0,1,3
51268,3,2,179721,179721,179723,0,2,2
51269,1,1,179722,179723,179724,1,2,0
51270,1,3,179723,179724,179727,1,4,0
51271,5,3,179728,179728,179731,0,3,1
51272,5,3,179733,179733,179736,0,3,2
51273,6,2,179739,179739,179741,0,2,3
51274,5,3,179744,179744,179747,0,3,3
51275,2,2,179746,179747,179749,1,3,0
51276,1,1,179747,179749,179750,2,3,0
51277,6,1,179753,179753,179754,0,1,3
51278,5,2,179758,179758,179760,0,2,4
51279,2,1,179760,179760,179761,0,1,0
51280,5,2,179765,179765,179767,0,2,4
51281,3,3,179768,179768,179771,0,3,1
51282,3,2,179771,179771,179773,0,2,0
51283,6,1,179777,179777,179778,0,1,4
51284,1,3,179778,179778,179781,0,3,0
51285,6,3,179784,179784,179787,0,3,3
51286,3,2,179787,179787,179789,0,2,0
51287,2,2,179789,179789,179791,0,2,0
51288,2,1,179791,179791,179792,0,1,0
51289,5,2,179796,179796,179798,0,2,4
51290,3,3,179799,179799,179802,0,3,1
51291,4,1,179803,179803,179804,0,1,1
51292,6,1,179809,179809,179810,0,1,5
51293,5,2,179814,179814,179816,0,2,4
51294,2,1,179816,179816,179817,0,1,0
51295,6,2,179822,179822,179824,0,2,5
51296,4,1,179826,179826,179827,0,1,2
51297,5,3,179831,179831,179834,0,3,4
51298,4,1,179835,179835,179836,0,1,1
51299,6,1,179841,179841,179842,0,1,5
51300,2,3,179843,179843,179846,0,3,1
51301,5,2,179848,179848,179850,0,2,2
51302,3,3,179851,179851,179854,0,3,1
51303,5,1,179856,179856,179857,0,1,2
51304,6,2,179862,179862,179864,0,2,5
51305,6,1,179868,179868,179869,0,1,4
51306,6,2,179874,179874,179876,0,2,5
51307,4,3,179878,179878,179881,0,3,2
51308,1,1,179879,179881,179882,2,3,0
51309,1,2,179880,179882,179884,2,4,0
51310,1,3,179881,179884,179887,3,6,0
51311,1,3,179882,179887,179890,5,8,0
51312,4,3,179886,179890,179893,4,7,0
51313,4,3,179890,179893,179896,3,6,0
51314,6,3,179896,179896,179899,0,3,0
51315,2,1,179898,179899,179900,1,2,0
51316,6,1,179904,179904,179905,0,1,4
51317,4,1,179908,179908,179909,0,1,3
51318,4,3,179912,179912,179915,0,3,3
51319,4,2,179916,179916,179918,0,2,1
51320,1,1,179917,179918,179919,1,2,0
51321,5,1,179922,179922,179923,0,1,3
51322,4,1,179926,179926,179927,0,1,3
51323,2,2,179928,179928,179930,0,2,1
51324,5,3,179933,179933,179936,0,3,3
51325,3,3,179936,179936,179939,0,3,0
51326,1,1,179937,179939,179940,2,3,0
51327,2,2,179939,179940,179942,1,3,0
51328,3,2,179942,179942,179944,0,2,0
51329,5,1,179947,179947,179948,0,1,3
51330,1,3,179948,179948,179951,0,3,0
51331,3,1,179951,179951,179952,0,1,0
51332,4,2,179955,179955,179957,0,2,3
51333,4,1,179959,179959,179960,0,1,2
51334,4,2,179963,179963,179965,0,2,3
51335,3,3,179966,179966,179969,0,3,1
51336,1,2,179967,179969,179971,2,4,0
51337,2,3,179969,179971,179974,2,5,0
51338,4,1,179973,179974,179975,1,2,0
51339,6,3,179979,179979,179982,0,3,4
51340,1,2,179980,179982,179984,2,4,0
51341,1,1,179981,179984,179985,3,4,0
51342,3,1,179984,179985,179986,1,2,0
51343,3,1,179987,179987,179988,0,1,1
51344,3,2,179990,179990,179992,0,2,2
51345,1,2,179991,179992,179994,1,3,0
51346,6,2,179997,179997,179999,0,2,3
51347,2,3,179999,179999,180002,0,3,0
51348,5,2,180004,180004,180006,0,2,2
51349,3,1,180007,180007,180008,0,1,1
51350,5,1,180012,180012,180013,0,1,4
51351,4,3,180016,180016,180019,0,3,3
51352,3,3,180019,180019,180022,0,3,0
51353,2,2,180021,180022,180024,1,3,0
51354,1,2,180022,180024,180026,2,4,0
51355,5,2,180027,180027,180029,0,2,1
51356,2,1,180029,180029,180030,0,1,0
51357,4,1,180033,180033,180034,0,1,3
51358,1,3,180034,180034,180037,0,3,0
51359,6,2,180040,180040,180042,0,2,3
51360,3,3,180043,180043,180046,0,3,1
51361,3,2,180046,180046,180048,0,2,0
51362,6,2,180052,180052,180054,0,2,4
51363,2,1,180054,180054,180055,0,1,0
51364,4,2,180058,180058,180060,0,2,3
51365,2,3,180060,180060,180063,0,3,0
51366,5,1,180065,180065,180066,0,1,2
51367,5,3,180070,180070,180073,0,3,4
51368,5,3,180075,180075,180078,0,3,2
51369,3,3,180078,180078,180081,0,3,0
51370,1,2,180079,180081,180083,2,4,0
51371,3,1,180082,180083,180084,1,2,0
51372,6,1,180088,180088,180089,0,1,4
51373,1,3,180089,180089,180092,0,3,0
51374,4,3,180093,180093,180096,0,3,1
51375,5,1,180098,180098,180099,0,1,2
51376,5,2,180103,180103,180105,0,2,4
51377,1,1,180104,180105,180106,1,2,0
51378,3,3,180107,180107,180110,0,3,1
51379,5,1,180112,180112,180113,0,1,2
51380,1,2,180113,180113,180115,0,2,0
51381,2,2,180115,180115,180117,0,2,0
51382,4,2,180119,180119,180121,0,2,2
51383,2,2,180121,180121,180123,0,2,0
51384,5,3,180126,180126,180129,0,3,3
51385,6,1,180132,180132,180133,0,1,3
51386,1,3,180133,180133,180136,0,3,0
51387,5,1,180138,180138,180139,0,1,2
51388,3,3,180141,180141,180144,0,3,2
51389,1,1,180142,180144,180145,2,3,0
51390,1,3,180143,180145,180148,2,5,0
51391,3,2,180146,180148,180150,2,4,0
51392,1,2,180147,180150,180152,3,5,0
51393,5,3,180152,180152,180155,0,3,0
51394,6,2,180158,180158,180160,0,2,3
51395,4,3,180162,180162,180165,0,3,2
51396,6,2,180168,180168,180170,0,2,3
51397,2,2,180170,180170,180172,0,2,0
51398,1,1,180171,180172,180173,1,2,0
51399,6,3,180177,180177,180180,0,3,4
51400,6,2,180183,180183,180185,0,2,3
51401,5,2,180188,180188,180190,0,2,3
51402,2,2,180190,180190,180192,0,2,0
51403,3,2,180193,180193,180195,0,2,1
51404,5,3,180198,180198,180201,0,3,3
51405,1,1,180199,180201,180202,2,3,0
51406,2,2,180201,180202,180204,1,3,0
51407,1,1,180202,180204,180205,2,3,0
51408,5,3,180207,180207,180210,0,3,2
51409,4,3,180211,180211,180214,0,3,1
51410,5,2,180216,180216,180218,0,2,2
51411,1,1,180217,180218,180219,1,2,0
51412,6,2,180223,180223,180225,0,2,4
51413,4,3,180227,180227,180230,0,3,2
51414,4,2,180231,180231,180233,0,2,1
51415,6,1,180237,180237,180238,0,1,4
51416,3,3,180240,180240,180243,0,3,2
51417,3,3,180243,180243,180246,0,3,0
51418,1,3,180244,180246,180249,2,5,0
51419,5,2,180249,180249,180251,0,2,0
51420,1,2,180250,180251,180253,1,3,0
51421,3,3,180253,180253,180256,0,3,0
51422,6,1,180259,180259,180260,0,1,3
51423,2,2,180261,180261,180263,0,2,1
51424,6,1,180267,180267,180268,0,1,4
51425,6,1,180273,180273,180274,0,1,5
51426,3,2,180276,180276,180278,0,2,2
51427,1,1,180277,180278,180279,1,2,0
51428,5,1,180282,180282,180283,0,1,3
51429,6,3,180288,180288,180291,0,3,5
51430,3,1,180291,180291,180292,0,1,0
51431,4,3,180295,180295,180298,0,3,3
51432,3,2,180298,180298,180300,0,2,0
51433,6,1,180304,180304,180305,0,1,4
51434,2,3,180306,180306,180309,0,3,1
51435,5,3,180311,180311,180314,0,3,2
51436,3,2,180314,180314,180316,0,2,0
51437,1,3,180315,180316,180319,1,4,0
51438,3,3,180318,180319,180322,1,4,0
51439,2,3,180320,180322,180325,2,5,0
51440,5,2,180325,180325,180327,0,2,0
51441,6,2,180331,180331,180333,0,2,4
51442,1,1,180332,180333,180334,1,2,0
51443,4,2,180336,180336,180338,0,2,2
51444,5,2,180341,180341,180343,0,2,3
51445,4,1,180345,180345,180346,0,1,2
51446,3,2,180348,180348,180350,0,2,2
51447,2,1,180350,180350,180351,0,1,0
51448,5,3,180355,180355,180358,0,3,4
51449,4,3,180359,180359,180362,0,3,1
51450,2,2,180361,180362,180364,1,3,0
51451,5,3,180366,180366,180369,0,3,2
51452,6,3,180372,180372,180375,0,3,3
51453,5,2,180377,180377,180379,0,2,2
51454,2,1,180379,180379,180380,0,1,0
51455,1,2,180380,180380,180382,0,2,0
51456,4,3,180384,180384,180387,0,3,2
51457,3,2,180387,180387,180389,0,2,0
51458,5,2,180392,180392,180394,0,2,3
51459,2,3,180394,180394,180397,0,3,0
51460,3,3,180397,180397,180400,0,3,0
51461,6,2,180403,180403,180405,0,2,3
51462,1,1,180404,180405,180406,1,2,0
51463,1,2,180405,180406,180408,1,3,0
51464,2,1,180407,180408,180409,1,2,0
51465,2,1,180409,180409,180410,0,1,0
51466,6,2,180415,180415,180417,0,2,5
51467,5,1,180420,180420,180421,0,1,3
51468,1,1,180421,180421,180422,0,1,0
51469,4,1,180425,180425,180426,0,1,3
51470,3,2,180428,180428,180430,0,2,2
51471,3,2,180431,180431,180433,0,2,1
51472,1,1,180432,180433,180434,1,2,0
51473,6,1,180438,180438,180439,0,1,4
51474,6,1,180444,180444,180445,0,1,5
51475,2,1,180446,180446,180447,0,1,1
51476,3,2,180449,180449,180451,0,2,2
51477,6,1,180455,180455,180456,0,1,4
51478,5,2,180460,180460,180462,0,2,4
51479,3,3,180463,180463,180466,0,3,1
51480,2,3,180465,180466,180469,1,4,0
51481,4,3,180469,180469,180472,0,3,0
51482,4,2,180473,180473,180475,0,2,1
51483,4,2,180477,180477,180479,0,2,2
51484,2,2,180479,180479,180481,0,2,0
51485,4,2,180483,180483,180485,0,2,2
51486,1,2,180484,180485,180487,1,3,0
51487,6,2,180490,180490,180492,0,2,3
51488,4,2,180494,180494,180496,0,2,2
51489,1,3,180495,180496,180499,1,4,0
51490,5,2,180500,180500,180502,0,2,1
51491,5,2,180505,180505,180507,0,2,3
51492,2,3,180507,180507,180510,0,3,0
51493,1,1,180508,180510,180511,2,3,0
51494,4,1,180512,180512,180513,0,1,1
51495,6,1,180518,180518,180519,0,1,5
51496,2,3,180520,180520,180523,0,3,1
51497,4,3,180524,180524,180527,0,3,1
51498,2,2,180526,180527,180529,1,3,0
51499,1,3,180527,180529,180532,2,5,0
51500,4,3,180531,180532,180535,1,4,0
51501,6,3,180537,180537,180540,0,3,2
51502,4,2,180541,180541,180543,0,2,1
51503,6,2,180547,180547,180549,0,2,4
51504,3,3,180550,180550,180553,0,3,1
51505,6,2,180556,180556,180558,0,2,3
51506,6,3,180562,180562,180565,0,3,4
51507,6,3,180568,180568,180571,0,3,3
51508,6,1,180574,180574,180575,0,1,3
51509,6,1,180580,180580,180581,0,1,5
51510,5,1,180585,180585,180586,0,1,4
51511,1,1,180586,180586,180587,0,1,0
51512,6,3,180592,180592,180595,0,3,5
51513,4,3,180596,180596,180599,0,3,1
51514,3,1,180599,180599,180600,0,1,0
51515,1,3,180600,180600,180603,0,3,0
51516,4,1,180604,180604,180605,0,1,1
51517,6,3,180610,180610,180613,0,3,5
51518,4,1,180614,180614,180615,0,1,1
51519,5,1,180619,180619,180620,0,1,4
51520,6,2,180625,180625,180627,0,2,5
51521,2,3,180627,180627,180630,0,3,0
51522,3,1,180630,180630,180631,0,1,0
51523,3,3,180633,180633,180636,0,3,2
51524,6,1,180639,180639,180640,0,1,3
51525,4,3,180643,180643,180646,0,3,3
51526,6,3,180649,180649,180652,0,3,3
51527,2,2,180651,180652,180654,1,3,0
51528,2,3,180653,180654,180657,1,4,0
51529,2,3,180655,180657,180660,2,5,0
51530,4,2,180659,180660,180662,1,3,0
51531,2,1,180661,180662,180663,1,2,0
51532,5,1,180666,180666,180667,0,1,3
51533,4,1,180670,180670,180671,0,1,3
51534,5,3,180675,180675,180678,0,3,4
51535,6,3,180681,180681,180684,0,3,3
51536,6,1,180687,180687,180688,0,1,3
51537,5,3,180692,180692,180695,0,3,4
51538,4,3,180696,180696,180699,0,3,1
51539,3,3,180699,180699,180702,0,3,0
51540,4,2,180703,180703,180705,0,2,1
51541,3,1,180706,180706,180707,0,1,1
51542,3,3,180709,180709,180712,0,3,2
51543,1,3,180710,180712,180715,2,5,0
51544,1,1,180711,180715,180716,4,5,0
51545,5,1,180716,180716,180717,0,1,0
51546,3,2,180719,180719,180721,0,2,2
51547,3,2,180722,180722,180724,0,2,1
51548,4,1,180726,180726,180727,0,1,2
51549,5,1,180731,180731,180732,0,1,4
51550,5,1,180736,180736,180737,0,1,4
51551,4,1,180740,180740,180741,0,1,3
51552,5,1,180745,180745,180746,0,1,4
51553,2,1,180747,180747,180748,0,1,1
51554,6,1,180753,180753,180754,0,1,5
51555,6,1,180759,180759,180760,0,1,5
51556,6,3,180765,180765,180768,0,3,5
51557,4,3,180769,180769,180772,0,3,1
51558,2,1,180771,180772,180773,1,2,0
51559,4,3,180775,180775,180778,0,3,2
51560,4,1,180779,180779,180780,0,1,1
51561,2,1,180781,180781,180782,0,1,1
51562,2,2,180783,180783,180785,0,2,1
51563,2,1,180785,180785,180786,0,1,0
51564,1,3,180786,180786,180789,0,3,0
51565,2,2,180788,180789,180791,1,3,0
51566,2,3,180790,180791,180794,1,4,0
51567,3,2,180793,180794,180796,1,3,0
51568,5,2,180798,180798,180800,0,2,2
51569,2,1,180800,180800,180801,0,1,0
51570,1,2,180801,180801,180803,0,2,0
51571,2,1,180803,180803,180804,0,1,0
51572,6,1,180809,180809,180810,0,1,5
51573,6,1,180815,180815,180816,0,1,5
51574,6,2,180821,180821,180823,0,2,5
51575,5,2,180826,180826,180828,0,2,3
51576,4,1,180830,180830,180831,0,1,2
51577,3,2,180833,180833,180835,0,2,2
51578,3,3,180836,180836,180839,0,3,1
51579,4,2,180840,180840,180842,0,2,1
51580,5,3,180845,180845,180848,0,3,3
51581,3,1,180848,180848,180849,0,1,0
51582,3,2,180851,180851,180853,0,2,2
51583,6,3,180857,180857,180860,0,3,4
51584,6,1,180863,180863,180864,0,1,3
51585,1,2,180864,180864,180866,0,2,0
51586,5,1,180869,180869,180870,0,1,3
51587,5,2,180874,180874,180876,0,2,4
51588,5,3,180879,180879,180882,0,3,3
51589,3,3,180882,180882,180885,0,3,0
51590,1,3,180883,180885,180888,2,5,0
51591,2,1,180885,180888,180889,3,4,0
51592,2,2,180887,180889,180891,2,4,0
51593,6,1,180893,180893,180894,0,1,2
51594,5,1,180898,180898,180899,0,1,4
51595,5,2,180903,180903,180905,0,2,4
51596,4,3,180907,180907,180910,0,3,2
51597,6,3,180913,180913,180916,0,3,3
51598,3,2,180916,180916,180918,0,2,0
51599,6,3,180922,180922,180925,0,3,4
51600,3,1,180925,180925,180926,0,1,0
51601,1,3,180926,180926,180929,0,3,0
51602,5,3,180931,180931,180934,0,3,2
51603,1,1,180932,180934,180935,2,3,0
51604,2,2,180934,180935,180937,1,3,0
51605,3,2,180937,180937,180939,0,2,0
51606,6,2,180943,180943,180945,0,2,4
51607,5,2,180948,180948,180950,0,2,3
51608,6,3,180954,180954,180957,0,3,4
51609,1,1,180955,180957,180958,2,3,0
51610,5,3,180960,180960,180963,0,3,2
51611,3,2,180963,180963,180965,0,2,0
51612,4,2,180967,180967,180969,0,2,2
51613,3,3,180970,180970,180973,0,3,1
51614,1,3,180971,180973,180976,2,5,0
51615,5,1,180976,180976,180977,0,1,0
51616,3,1,180979,180979,180980,0,1,2
51617,5,2,180984,180984,180986,0,2,4
51618,6,1,180990,180990,180991,0,1,4
51619,5,2,180995,180995,180997,0,2,4
51620,6,3,181001,181001,181004,0,3,4
51621,6,3,181007,181007,181010,0,3,3
51622,1,1,181008,181010,181011,2,3,0
51623,4,1,181012,181012,181013,0,1,1
51624,5,2,181017,181017,181019,0,2,4
51625,2,2,181019,181019,181021,0,2,0
51626,1,2,181020,181021,181023,1,3,0
51627,3,3,181023,181023,181026,0,3,0
51628,5,2,181028,181028,181030,0,2,2
51629,2,1,181030,181030,181031,0,1,0
51630,5,3,181035,181035,181038,0,3,4
51631,4,2,181039,181039,181041,0,2,1
51632,3,3,181042,181042,181045,0,3,1
51633,4,1,181046,181046,181047,0,1,1
51634,3,1,181049,181049,181050,0,1,2
51635,1,2,181050,181050,181052,0,2,0
51636,1,1,181051,181052,181053,1,2,0
51637,1,2,181052,181053,181055,1,3,0
51638,6,3,181058,181058,181061,0,3,3
51639,5,3,181063,181063,181066,0,3,2
51640,4,1,181067,181067,181068,0,1,1
51641,6,2,181073,181073,181075,0,2,5
51642,5,3,181078,181078,181081,0,3,3
51643,1,3,181079,181081,181084,2,5,0
51644,6,3,181085,181085,181088,0,3,1
51645,5,3,181090,181090,181093,0,3,2
51646,4,2,181094,181094,181096,0,2,1
51647,6,1,181100,181100,181101,0,1,4
51648,4,2,181104,181104,181106,0,2,3
51649,1,3,181105,181106,181109,1,4,0
51650,1,2,181106,181109,181111,3,5,0
51651,3,3,181109,181111,181114,2,5,0
51652,1,2,181110,181114,181116,4,6,0
51653,2,3,181112,181116,181119,4,7,0
51654,6,1,181118,181119,181120,1,2,0
51655,6,1,181124,181124,181125,0,1,4
51656,3,2,181127,181127,181129,0,2,2
51657,2,2,181129,181129,181131,0,2,0
51658,2,2,181131,181131,181133,0,2,0
51659,4,1,181135,181135,181136,0,1,2
51660,3,2,181138,181138,181140,0,2,2
51661,1,1,181139,181140,181141,1,2,0
51662,4,1,181143,181143,181144,0,1,2
51663,2,2,181145,181145,181147,0,2,1
51664,3,3,181148,181148,181151,0,3,1
51665,5,1,181153,181153,181154,0,1,2
51666,2,1,181155,181155,181156,0,1,1
51667,3,2,181158,181158,181160,0,2,2
51668,6,2,181164,181164,181166,0,2,4
51669,4,2,181168,181168,181170,0,2,2
51670,5,3,181173,181173,181176,0,3,3
51671,2,3,181175,181176,181179,1,4,0
51672,6,1,181181,181181,181182,0,1,2
51673,2,2,181183,181183,181185,0,2,1
51674,6,2,181189,181189,181191,0,2,4
51675,4,3,181193,181193,181196,0,3,2
51676,4,1,181197,181197,181198,0,1,1
51677,3,1,181200,181200,181201,0,1,2
51678,6,2,181206,181206,181208,0,2,5
51679,6,2,181212,181212,181214,0,2,4
51680,2,2,181214,181214,181216,0,2,0
51681,3,1,181217,181217,181218,0,1,1
51682,2,3,181219,181219,181222,0,3,1
51683,5,2,181224,181224,181226,0,2,2
51684,5,1,181229,181229,181230,0,1,3
51685,6,3,181235,181235,181238,0,3,5
51686,1,2,181236,181238,181240,2,4,0
51687,1,1,181237,181240,181241,3,4,0
51688,3,1,181240,181241,181242,1,2,0
51689,4,3,181244,181244,181247,0,3,2
51690,2,2,181246,181247,181249,1,3,0
51691,4,1,181250,181250,181251,0,1,1
51692,2,1,181252,181252,181253,0,1,1
51693,5,2,181257,181257,181259,0,2,4
51694,6,1,181263,181263,181264,0,1,4
51695,4,1,181267,181267,181268,0,1,3
51696,6,3,181273,181273,181276,0,3,5
51697,4,1,181277,181277,181278,0,1,1
51698,2,1,181279,181279,181280,0,1,1
51699,3,2,181282,181282,181284,0,2,2
51700,5,2,181287,181287,181289,0,2,3
51701,2,1,181289,181289,181290,0,1,0
51702,4,2,181293,181293,181295,0,2,3
51703,6,2,181299,181299,181301,0,2,4
51704,6,1,181305,181305,181306,0,1,4
51705,4,1,181309,181309,181310,0,1,3
51706,6,3,181315,181315,181318,0,3,5
51707,4,2,181319,181319,181321,0,2,1
51708,4,1,181323,181323,181324,0,1,2
51709,2,1,181325,181325,181326,0,1,1
51710,2,3,181327,181327,181330,0,3,1
51711,4,2,181331,181331,181333,0,2,1
51712,1,1,181332,181333,181334,1,2,0
51713,4,1,181336,181336,181337,0,1,2
51714,6,3,181342,181342,181345,0,3,5
51715,5,2,181347,181347,181349,0,2,2
51716,4,3,181351,181351,181354,0,3,2
51717,4,3,181355,181355,181358,0,3,1
51718,3,2,181358,181358,181360,0,2,0
51719,2,1,181360,181360,181361,0,1,0
51720,3,1,181363,181363,181364,0,1,2
51721,2,2,181365,181365,181367,0,2,1
51722,6,2,181371,181371,181373,0,2,4
51723,1,1,181372,181373,181374,1,2,0
51724,1,3,181373,181374,181377,1,4,0
51725,6,2,181379,181379,181381,0,2,2
51726,6,2,181385,181385,181387,0,2,4
51727,2,1,181387,181387,181388,0,1,0
51728,2,3,181389,181389,181392,0,3,1
51729,1,1,181390,181392,181393,2,3,0
51730,1,3,181391,181393,181396,2,5,0
51731,4,3,181395,181396,181399,1,4,0
51732,1,1,181396,181399,181400,3,4,0
51733,6,2,181402,181402,181404,0,2,2
51734,1,1,181403,181404,181405,1,2,0
51735,4,2,181407,181407,181409,0,2,2
51736,2,1,181409,181409,181410,0,1,0
51737,5,1,181414,181414,181415,0,1,4
51738,3,1,181417,181417,181418,0,1,2
51739,4,1,181421,181421,181422,0,1,3
51740,4,3,181425,181425,181428,0,3,3
51741,6,3,181431,181431,181434,0,3,3
51742,3,1,181434,181434,181435,0,1,0
51743,6,1,181440,181440,181441,0,1,5
51744,4,1,181444,181444,181445,0,1,3
51745,6,1,181450,181450,181451,0,1,5
51746,1,3,181451,181451,181454,0,3,0
51747,1,1,181452,181454,181455,2,3,0
51748,3,1,181455,181455,181456,0,1,0
51749,6,1,181461,181461,181462,0,1,5
51750,4,3,181465,181465,181468,0,3,3
51751,5,2,181470,181470,181472,0,2,2
51752,1,3,181471,181472,181475,1,4,0
51753,1,1,181472,181475,181476,3,4,0
51754,6,1,181478,181478,181479,0,1,2
51755,1,2,181479,181479,181481,0,2,0
51756,4,3,181483,181483,181486,0,3,2
51757,3,3,181486,181486,181489,0,3,0
51758,5,1,181491,181491,181492,0,1,2
51759,2,3,181493,181493,181496,0,3,1
51760,2,3,181495,181496,181499,1,4,0
51761,3,1,181498,181499,181500,1,2,0
51762,2,3,181500,181500,181503,0,3,0
51763,6,2,181506,181506,181508,0,2,3
51764,6,3,181512,181512,181515,0,3,4
51765,3,3,181515,181515,181518,0,3,0
51766,2,3,181517,181518,181521,1,4,0
51767,4,1,181521,181521,181522,0,1,0
51768,1,2,181522,181522,181524,0,2,0
51769,4,1,181526,181526,181527,0,1,2
51770,1,2,181527,181527,181529,0,2,0
51771,4,3,181531,181531,181534,0,3,2
51772,4,3,181535,181535,181538,0,3,1
51773,1,2,181536,181538,181540,2,4,0
51774,3,1,181539,181540,181541,1,2,0
51775,3,3,181542,181542,181545,0,3,1
51776,4,2,181546,181546,181548,0,2,1
51777,1,1,181547,181548,181549,1,2,0
51778,1,3,181548,181549,181552,1,4,0
51779,3,2,181551,181552,181554,1,3,0
51780,5,1,181556,181556,181557,0,1,2
51781,6,2,181562,181562,181564,0,2,5
51782,6,3,181568,181568,181571,0,3,4
51783,4,3,181572,181572,181575,0,3,1
51784,3,1,181575,181575,181576,0,1,0
51785,1,1,181576,181576,181577,0,1,0
51786,6,1,181582,181582,181583,0,1,5
51787,1,1,181583,181583,181584,0,1,0
51788,3,1,181586,181586,181587,0,1,2
51789,2,1,181588,181588,181589,0,1,1
51790,6,3,181594,181594,181597,0,3,5
51791,5,3,181599,181599,181602,0,3,2
51792,6,2,181605,181605,181607,0,2,3
51793,1,1,181606,181607,181608,1,2,0
51794,1,2,181607,181608,181610,1,3,0
51795,4,1,181611,181611,181612,0,1,1
51796,6,3,181617,181617,181620,0,3,5
51797,1,3,181618,181620,181623,2,5,0
51798,4,3,181622,181623,181626,1,4,0
51799,6,1,181628,181628,181629,0,1,2
51800,2,3,181630,181630,181633,0,3,1
51801,3,1,181633,181633,181634,0,1,0
51802,6,1,181639,181639,181640,0,1,5
51803,5,1,181644,181644,181645,0,1,4
51804,6,2,181650,181650,181652,0,2,5
51805,4,2,181654,181654,181656,0,2,2
51806,5,2,181659,181659,181661,0,2,3
51807,4,2,181663,181663,181665,0,2,2
51808,1,1,181664,181665,181666,1,2,0
51809,1,2,181665,181666,181668,1,3,0
51810,1,2,181666,181668,181670,2,4,0
51811,6,1,181672,181672,181673,0,1,2
51812,1,1,181673,181673,181674,0,1,0
51813,6,2,181679,181679,181681,0,2,5
51814,2,3,181681,181681,181684,0,3,0
51815,2,1,181683,181684,181685,1,2,0
51816,3,2,181686,181686,181688,0,2,1
51817,6,1,181692,181692,181693,0,1,4
51818,2,3,181694,181694,181697,0,3,1
51819,4,1,181698,181698,181699,0,1,1
51820,3,3,181701,181701,181704,0,3,2
51821,4,1,181705,181705,181706,0,1,1
51822,6,1,181711,181711,181712,0,1,5
51823,5,2,181716,181716,181718,0,2,4
51824,1,2,181717,181718,181720,1,3,0
51825,4,2,181721,181721,181723,0,2,1
51826,6,2,181727,181727,181729,0,2,4
51827,1,2,181728,181729,181731,1,3,0
51828,5,1,181733,181733,181734,0,1,2
51829,1,2,181734,181734,181736,0,2,0
51830,3,1,181737,181737,181738,0,1,1
51831,1,2,181738,181738,181740,0,2,0
51832,2,3,181740,181740,181743,0,3,0
51833,4,1,181744,181744,181745,0,1,1
51834,2,3,181746,181746,181749,0,3,1
51835,1,1,181747,181749,181750,2,3,0
51836,2,3,181749,181750,181753,1,4,0
51837,3,1,181752,181753,181754,1,2,0
51838,4,2,181756,181756,181758,0,2,2
51839,4,2,181760,181760,181762,0,2,2
51840,2,3,181762,181762,181765,0,3,0
51841,4,2,181766,181766,181768,0,2,1
51842,3,2,181769,181769,181771,0,2,1
51843,6,1,181775,181775,181776,0,1,4
51844,6,2,181781,181781,181783,0,2,5
51845,2,1,181783,181783,181784,0,1,0
51846,3,2,181786,181786,181788,0,2,2
51847,1,2,181787,181788,181790,1,3,0
51848,6,1,181793,181793,181794,0,1,3
51849,4,1,181797,181797,181798,0,1,3
51850,3,1,181800,181800,181801,0,1,2
51851,5,2,181805,181805,181807,0,2,4
51852,6,3,181811,181811,181814,0,3,4
51853,4,3,181815,181815,181818,0,3,1
51854,1,1,181816,181818,181819,2,3,0
51855,4,1,181820,181820,181821,0,1,1
51856,5,2,181825,181825,181827,0,2,4
51857,6,2,181831,181831,181833,0,2,4
51858,5,2,181836,181836,181838,0,2,3
51859,1,1,181837,181838,181839,1,2,0
51860,3,1,181840,181840,181841,0,1,1
51861,1,3,181841,181841,181844,0,3,0
51862,4,3,181845,181845,181848,0,3,1
51863,5,1,181850,181850,181851,0,1,2
51864,6,3,181856,181856,181859,0,3,5
51865,6,1,181862,181862,181863,0,1,3
51866,3,2,181865,181865,181867,0,2,2
51867,4,3,181869,181869,181872,0,3,2
51868,2,1,181871,181872,181873,1,2,0
51869,4,1,181875,181875,181876,0,1,2
51870,1,1,181876,181876,181877,0,1,0
51871,2,3,181878,181878,181881,0,3,1
51872,4,3,181882,181882,181885,0,3,1
51873,4,1,181886,181886,181887,0,1,1
51874,4,1,181890,181890,181891,0,1,3
51875,2,3,181892,181892,181895,0,3,1
51876,2,2,181894,181895,181897,1,3,0
51877,6,1,181900,181900,181901,0,1,3
51878,6,2,181906,181906,181908,0,2,5
51879,4,2,181910,181910,181912,0,2,2
51880,3,2,181913,181913,181915,0,2,1
51881,6,2,181919,181919,181921,0,2,4
51882,2,2,181921,181921,181923,0,2,0
51883,6,3,181927,181927,181930,0,3,4
51884,2,1,181929,181930,181931,1,2,0
51885,6,1,181935,181935,181936,0,1,4
51886,4,1,181939,181939,181940,0,1,3
51887,4,3,181943,181943,181946,0,3,3
51888,1,1,181944,181946,181947,2,3,0
51889,1,2,181945,181947,181949,2,4,0
51890,6,3,181951,181951,181954,0,3,2
51891,2,3,181953,181954,181957,1,4,0
51892,6,1,181959,181959,181960,0,1,2
51893,1,2,181960,181960,181962,0,2,0
51894,4,3,181964,181964,181967,0,3,2
51895,4,1,181968,181968,181969,0,1,1
51896,2,1,181970,181970,181971,0,1,1
51897,3,3,181973,181973,181976,0,3,2
51898,2,2,181975,181976,181978,1,3,0
51899,6,3,181981,181981,181984,0,3,3
51900,4,3,181985,181985,181988,0,3,1
51901,6,1,181991,181991,181992,0,1,3
51902,2,3,181993,181993,181996,0,3,1
51903,5,2,181998,181998,182000,0,2,2
51904,2,1,182000,182000,182001,0,1,0
51905,1,3,182001,182001,182004,0,3,0
51906,1,1,182002,182004,182005,2,3,0
51907,3,1,182005,182005,182006,0,1,0
51908,3,2,182008,182008,182010,0,2,2
51909,4,1,182012,182012,182013,0,1,2
51910,1,2,182013,182013,182015,0,2,0
51911,4,3,182017,182017,182020,0,3,2
51912,5,2,182022,182022,182024,0,2,2
51913,1,1,182023,182024,182025,1,2,0
51914,3,3,182026,182026,182029,0,3,1
51915,1,1,182027,182029,182030,2,3,0
51916,3,3,182030,182030,182033,0,3,0
51917,2,1,182032,182033,182034,1,2,0
51918,1,3,182033,182034,182037,1,4,0
51919,1,2,182034,182037,182039,3,5,0
51920,6,3,182040,182040,182043,0,3,1
51921,4,3,182044,182044,182047,0,3,1
51922,2,2,182046,182047,182049,1,3,0
51923,3,2,182049,182049,182051,0,2,0
51924,6,1,182055,182055,182056,0,1,4
51925,4,1,182059,182059,182060,0,1,3
51926,1,3,182060,182060,182063,0,3,0
51927,5,3,182065,182065,182068,0,3,2
51928,2,3,182067,182068,182071,1,4,0
51929,6,3,182073,182073,182076,0,3,2
51930,5,3,182078,182078,182081,0,3,2
51931,5,3,182083,182083,182086,0,3,2
51932,2,3,182085,182086,182089,1,4,0
51933,6,3,182091,182091,182094,0,3,2
51934,4,3,182095,182095,182098,0,3,1
51935,5,2,182100,182100,182102,0,2,2
51936,5,2,182105,182105,182107,0,2,3
51937,6,3,182111,182111,182114,0,3,4
51938,1,2,182112,182114,182116,2,4,0
51939,6,3,182118,182118,182121,0,3,2
51940,1,1,182119,182121,182122,2,3,0
51941,3,3,182122,182122,182125,0,3,0
51942,3,2,182125,182125,182127,0,2,0
51943,5,2,182130,182130,182132,0,2,3
51944,4,3,182134,182134,182137,0,3,2
51945,5,2,182139,182139,182141,0,2,2
51946,5,1,182144,182144,182145,0,1,3
51947,4,2,182148,182148,182150,0,2,3
51948,5,1,182153,182153,182154,0,1,3
51949,5,3,182158,182158,182161,0,3,4
51950,1,1,182159,182161,182162,2,3,0
51951,4,3,182163,182163,182166,0,3,1
51952,6,2,182169,182169,182171,0,2,3
51953,3,1,182172,182172,182173,0,1,1
51954,5,3,182177,182177,182180,0,3,4
51955,3,1,182180,182180,182181,0,1,0
51956,5,1,182185,182185,182186,0,1,4
51957,1,2,182186,182186,182188,0,2,0
51958,6,1,182192,182192,182193,0,1,4
51959,5,1,182197,182197,182198,0,1,4
51960,6,2,182203,182203,182205,0,2,5
51961,3,3,182206,182206,182209,0,3,1
51962,2,3,182208,182209,182212,1,4,0
51963,6,2,182214,182214,182216,0,2,2
51964,2,2,182216,182216,182218,0,2,0
51965,2,2,182218,182218,182220,0,2,0
51966,2,2,182220,182220,182222,0,2,0
51967,5,3,182225,182225,182228,0,3,3
51968,2,3,182227,182228,182231,1,4,0
51969,1,1,182228,182231,182232,3,4,0
51970,4,2,182232,182232,182234,0,2,0
51971,1,2,182233,182234,182236,1,3,0
51972,1,3,182234,182236,182239,2,5,0
51973,4,2,182238,182239,182241,1,3,0
51974,2,1,182240,182241,182242,1,2,0
51975,4,1,182244,182244,182245,0,1,2
51976,6,3,182250,182250,182253,0,3,5
51977,1,2,182251,182253,182255,2,4,0
51978,2,2,182253,182255,182257,2,4,0
51979,4,1,182257,182257,182258,0,1,0
51980,2,1,182259,182259,182260,0,1,1
51981,2,3,182261,182261,182264,0,3,1
51982,1,3,182262,182264,182267,2,5,0
51983,4,1,182266,182267,182268,1,2,0
51984,3,3,182269,182269,182272,0,3,1
51985,2,2,182271,182272,182274,1,3,0
51986,2,2,182273,182274,182276,1,3,0
51987,3,3,182276,182276,182279,0,3,0
51988,5,2,182281,182281,182283,0,2,2
51989,1,3,182282,182283,182286,1,4,0
51990,6,1,182288,182288,182289,0,1,2
51991,6,3,182294,182294,182297,0,3,5
51992,6,3,182300,182300,182303,0,3,3
51993,3,3,182303,182303,182306,0,3,0
51994,5,2,182308,182308,182310,0,2,2
51995,2,3,182310,182310,182313,0,3,0
51996,1,3,182311,182313,182316,2,5,0
51997,1,1,182312,182316,182317,4,5,0
51998,3,3,182315,182317,182320,2,5,0
51999,5,3,182320,182320,182323,0,3,0
52000,3,3,182323,182323,182326,0,3,0
52001,3,3,182326,182326,182329,0,3,0
52002,2,3,182328,182329,182332,1,4,0
52003,2,1,182330,182332,182333,2,3,0
52004,1,2,182331,182333,182335,2,4,0
52005,2,2,182333,182335,182337,2,4,0
52006,5,2,182338,182338,182340,0,2,1
52007,3,2,182341,182341,182343,0,2,1
52008,3,2,182344,182344,182346,0,2,1
52009,3,3,182347,182347,182350,0,3,1
52010,1,2,182348,182350,182352,2,4,0
52011,6,3,182354,182354,182357,0,3,2
52012,6,2,182360,182360,182362,0,2,3
52013,2,3,182362,182362,182365,0,3,0
52014,1,1,182363,182365,182366,2,3,0
52015,3,2,182366,182366,182368,0,2,0
52016,3,1,182369,182369,182370,0,1,1
52017,4,2,182373,182373,182375,0,2,3
52018,2,3,182375,182375,182378,0,3,0
52019,6,3,182381,182381,182384,0,3,3
52020,3,2,182384,182384,182386,0,2,0
52021,5,1,182389,182389,182390,0,1,3
52022,6,1,182395,182395,182396,0,1,5
52023,4,2,182399,182399,182401,0,2,3
52024,2,3,182401,182401,182404,0,3,0
52025,6,1,182407,182407,182408,0,1,3
52026,3,2,182410,182410,182412,0,2,2
52027,5,2,182415,182415,182417,0,2,3
52028,2,2,182417,182417,182419,0,2,0
52029,1,1,182418,182419,182420,1,2,0
52030,2,3,182420,182420,182423,0,3,0
52031,5,3,182425,182425,182428,0,3,2
52032,3,3,182428,182428,182431,0,3,0
52033,6,2,182434,182434,182436,0,2,3
52034,4,2,182438,182438,182440,0,2,2
52035,2,2,182440,182440,182442,0,2,0
52036,2,3,182442,182442,182445,0,3,0
52037,4,2,182446,182446,182448,0,2,1
52038,2,2,182448,182448,182450,0,2,0
52039,1,2,182449,182450,182452,1,3,0
52040,6,1,182455,182455,182456,0,1,3
52041,6,1,182461,182461,182462,0,1,5
52042,3,2,182464,182464,182466,0,2,2
52043,3,1,182467,182467,182468,0,1,1
52044,5,2,182472,182472,182474,0,2,4
52045,6,3,182478,182478,182481,0,3,4
52046,5,2,182483,182483,182485,0,2,2
52047,6,1,182489,182489,182490,0,1,4
52048,2,3,182491,182491,182494,0,3,1
52049,1,2,182492,182494,182496,2,4,0
52050,4,1,182496,182496,182497,0,1,0
52051,6,1,182502,182502,182503,0,1,5
52052,5,3,182507,182507,182510,0,3,4
52053,5,1,182512,182512,182513,0,1,2
52054,3,1,182515,182515,182516,0,1,2
52055,6,2,182521,182521,182523,0,2,5
52056,6,2,182527,182527,182529,0,2,4
52057,3,2,182530,182530,182532,0,2,1
52058,2,2,182532,182532,182534,0,2,0
52059,5,1,182537,182537,182538,0,1,3
52060,5,2,182542,182542,182544,0,2,4
52061,3,3,182545,182545,182548,0,3,1
52062,4,2,182549,182549,182551,0,2,1
52063,5,2,182554,182554,182556,0,2,3
52064,2,1,182556,182556,182557,0,1,0
52065,1,2,182557,182557,182559,0,2,0
52066,2,3,182559,182559,182562,0,3,0
52067,1,1,182560,182562,182563,2,3,0
52068,4,2,182564,182564,182566,0,2,1
52069,2,1,182566,182566,182567,0,1,0
52070,1,2,182567,182567,182569,0,2,0
52071,4,3,182571,182571,182574,0,3,2
52072,2,1,182573,182574,182575,1,2,0
52073,4,3,182577,182577,182580,0,3,2
52074,3,3,182580,182580,182583,0,3,0
52075,3,1,182583,182583,182584,0,1,0
52076,6,3,182589,182589,182592,0,3,5
52077,2,3,182591,182592,182595,1,4,0
52078,4,3,182595,182595,182598,0,3,0
52079,4,1,182599,182599,182600,0,1,1
52080,5,2,182604,182604,182606,0,2,4
52081,1,3,182605,182606,182609,1,4,0
52082,4,3,182609,182609,182612,0,3,0
52083,3,2,182612,182612,182614,0,2,0
52084,2,2,182614,182614,182616,0,2,0
52085,1,1,182615,182616,182617,1,2,0
52086,6,3,182621,182621,182624,0,3,4
52087,2,2,182623,182624,182626,1,3,0
52088,4,3,182627,182627,182630,0,3,1
52089,5,3,182632,182632,182635,0,3,2
52090,4,2,182636,182636,182638,0,2,1
52091,3,3,182639,182639,182642,0,3,1
52092,6,3,182645,182645,182648,0,3,3
52093,1,3,182646,182648,182651,2,5,0
52094,2,3,182648,182651,182654,3,6,0
52095,1,3,182649,182654,182657,5,8,0
52096,6,3,182655,182657,182660,2,5,0
52097,5,1,182660,182660,182661,0,1,0
52098,6,1,182666,182666,182667,0,1,5
52099,4,3,182670,182670,182673,0,3,3
52100,6,3,182676,182676,182679,0,3,3
52101,1,3,182677,182679,182682,2,5,0
52102,3,2,182680,182682,182684,2,4,0
52103,4,3,182684,182684,182687,0,3,0
52104,4,1,182688,182688,182689,0,1,1
52105,3,2,182691,182691,182693,0,2,2
52106,2,2,182693,182693,182695,0,2,0
52107,1,1,182694,182695,182696,1,2,0
52108,3,2,182697,182697,182699,0,2,1
52109,3,1,182700,182700,182701,0,1,1
52110,3,2,182703,182703,182705,0,2,2
52111,2,1,182705,182705,182706,0,1,0
52112,2,1,182707,182707,182708,0,1,1
52113,6,3,182713,182713,182716,0,3,5
52114,1,2,182714,182716,182718,2,4,0
52115,2,3,182716,182718,182721,2,5,0
52116,6,3,182722,182722,182725,0,3,1
52117,4,2,182726,182726,182728,0,2,1
52118,5,3,182731,182731,182734,0,3,3
52119,6,3,182737,182737,182740,0,3,3
52120,3,1,182740,182740,182741,0,1,0
52121,6,3,182746,182746,182749,0,3,5
52122,3,3,182749,182749,182752,0,3,0
52123,5,3,182754,182754,182757,0,3,2
52124,3,3,182757,182757,182760,0,3,0
52125,6,3,182763,182763,182766,0,3,3
52126,6,2,182769,182769,182771,0,2,3
52127,5,1,182774,182774,182775,0,1,3
52128,2,1,182776,182776,182777,0,1,1
52129,4,3,182780,182780,182783,0,3,3
52130,4,3,182784,182784,182787,0,3,1
52131,6,2,182790,182790,182792,0,2,3
52132,5,2,182795,182795,182797,0,2,3
52133,6,2,182801,182801,182803,0,2,4
52134,3,1,182804,182804,182805,0,1,1
52135,5,3,182809,182809,182812,0,3,4
52136,6,3,182815,182815,182818,0,3,3
52137,2,2,182817,182818,182820,1,3,0
52138,2,1,182819,182820,182821,1,2,0
52139,3,1,182822,182822,182823,0,1,1
52140,2,1,182824,182824,182825,0,1,1
52141,6,1,182830,182830,182831,0,1,5
52142,3,1,182833,182833,182834,0,1,2
52143,4,2,182837,182837,182839,0,2,3
52144,6,3,182843,182843,182846,0,3,4
52145,1,3,182844,182846,182849,2,5,0
52146,5,3,182849,182849,182852,0,3,0
52147,5,3,182854,182854,182857,0,3,2
52148,6,2,182860,182860,182862,0,2,3
52149,5,1,182865,182865,182866,0,1,3
52150,1,2,182866,182866,182868,0,2,0
52151,2,1,182868,182868,182869,0,1,0
52152,6,2,182874,182874,182876,0,2,5
52153,2,2,182876,182876,182878,0,2,0
52154,2,2,182878,182878,182880,0,2,0
52155,6,3,182884,182884,182887,0,3,4
52156,2,1,182886,182887,182888,1,2,0
52157,5,1,182891,182891,182892,0,1,3
52158,5,3,182896,182896,182899,0,3,4
52159,1,1,182897,182899,182900,2,3,0
52160,5,3,182902,182902,182905,0,3,2
52161,4,1,182906,182906,182907,0,1,1
52162,1,1,182907,182907,182908,0,1,0
52163,3,1,182910,182910,182911,0,1,2
52164,4,1,182914,182914,182915,0,1,3
52165,6,1,182920,182920,182921,0,1,5
52166,6,2,182926,182926,182928,0,2,5
52167,6,2,182932,182932,182934,0,2,4
52168,4,2,182936,182936,182938,0,2,2
52169,4,3,182940,182940,182943,0,3,2
52170,3,2,182943,182943,182945,0,2,0
52171,3,1,182946,182946,182947,0,1,1
52172,6,1,182952,182952,182953,0,1,5
52173,3,2,182955,182955,182957,0,2,2
52174,5,1,182960,182960,182961,0,1,3
52175,1,1,182961,182961,182962,0,1,0
52176,3,2,182964,182964,182966,0,2,2
52177,4,2,182968,182968,182970,0,2,2
52178,1,2,182969,182970,182972,1,3,0
52179,2,1,182971,182972,182973,1,2,0
52180,2,3,182973,182973,182976,0,3,0
52181,2,3,182975,182976,182979,1,4,0
52182,2,3,182977,182979,182982,2,5,0
52183,5,1,182982,182982,182983,0,1,0
52184,2,3,182984,182984,182987,0,3,1
52185,1,2,182985,182987,182989,2,4,0
52186,2,3,182987,182989,182992,2,5,0
52187,1,3,182988,182992,182995,4,7,0
52188,6,3,182994,182995,182998,1,4,0
52189,3,3,182997,182998,183001,1,4,0
52190,6,1,183003,183003,183004,0,1,2
52191,3,3,183006,183006,183009,0,3,2
52192,3,1,183009,183009,183010,0,1,0
52193,6,2,183015,183015,183017,0,2,5
52194,6,3,183021,183021,183024,0,3,4
52195,4,2,183025,183025,183027,0,2,1
52196,1,1,183026,183027,183028,1,2,0
52197,6,3,183032,183032,183035,0,3,4
52198,4,2,183036,183036,183038,0,2,1
52199,1,3,183037,183038,183041,1,4,0
52200,4,2,183041,183041,183043,0,2,0
52201,5,2,183046,183046,183048,0,2,3
52202,2,2,183048,183048,183050,0,2,0
52203,1,3,183049,183050,183053,1,4,0
52204,4,3,183053,183053,183056,0,3,0
52205,1,1,183054,183056,183057,2,3,0
52206,4,2,183058,183058,183060,0,2,1
52207,6,3,183064,183064,183067,0,3,4
52208,2,1,183066,183067,183068,1,2,0
52209,2,3,183068,183068,183071,0,3,0
52210,1,3,183069,183071,183074,2,5,0
52211,3,1,183072,183074,183075,2,3,0
52212,5,3,183077,183077,183080,0,3,2
52213,5,2,183082,183082,183084,0,2,2
52214,1,1,183083,183084,183085,1,2,0
52215,1,3,183084,183085,183088,1,4,0
52216,5,1,183089,183089,183090,0,1,1
52217,3,3,183092,183092,183095,0,3,2
52218,3,1,183095,183095,183096,0,1,0
52219,2,2,183097,183097,183099,0,2,1
52220,5,2,183102,183102,183104,0,2,3
52221,5,2,183107,183107,183109,0,2,3
52222,5,3,183112,183112,183115,0,3,3
52223,6,1,183118,183118,183119,0,1,3
52224,1,3,183119,183119,183122,0,3,0
52225,5,2,183124,183124,183126,0,2,2
52226,4,2,183128,183128,183130,0,2,2
52227,3,2,183131,183131,183133,0,2,1
52228,5,2,183136,183136,183138,0,2,3
52229,1,2,183137,183138,183140,1,3,0
52230,1,3,183138,183140,183143,2,5,0
52231,4,3,183142,183143,183146,1,4,0
52232,1,3,183143,183146,183149,3,6,0
52233,6,3,183149,183149,183152,0,3,0
52234,1,3,183150,183152,183155,2,5,0
52235,1,2,183151,183155,183157,4,6,0
52236,5,3,183156,183157,183160,1,4,0
52237,5,2,183161,183161,183163,0,2,1
52238,3,3,183164,183164,183167,0,3,1
52239,1,3,183165,183167,183170,2,5,0
52240,5,3,183170,183170,183173,0,3,0
52241,3,2,183173,183173,183175,0,2,0
52242,6,2,183179,183179,183181,0,2,4
52243,4,2,183183,183183,183185,0,2,2
52244,6,1,183189,183189,183190,0,1,4
52245,2,3,183191,183191,183194,0,3,1
52246,2,1,183193,183194,183195,1,2,0
52247,1,3,183194,183195,183198,1,4,0
52248,4,3,183198,183198,183201,0,3,0
52249,3,3,183201,183201,183204,0,3,0
52250,2,2,183203,183204,183206,1,3,0
52251,1,3,183204,183206,183209,2,5,0
52252,3,1,183207,183209,183210,2,3,0
52253,5,1,183212,183212,183213,0,1,2
52254,2,1,183214,183214,183215,0,1,1
52255,6,1,183220,183220,183221,0,1,5
52256,5,2,183225,183225,183227,0,2,4
52257,5,3,183230,183230,183233,0,3,3
52258,6,1,183236,183236,183237,0,1,3
52259,3,2,183239,183239,183241,0,2,2
52260,1,3,183240,183241,183244,1,4,0
52261,3,1,183243,183244,183245,1,2,0
52262,1,3,183244,183245,183248,1,4,0
52263,3,1,183247,183248,183249,1,2,0
52264,2,3,183249,183249,183252,0,3,0
52265,6,3,183255,183255,183258,0,3,3
52266,2,3,183257,183258,183261,1,4,0
52267,1,1,183258,183261,183262,3,4,0
52268,5,3,183263,183263,183266,0,3,1
52269,6,2,183269,183269,183271,0,2,3
52270,3,3,183272,183272,183275,0,3,1
52271,1,3,183273,183275,183278,2,5,0
52272,1,1,183274,183278,183279,4,5,0
52273,3,3,183277,183279,183282,2,5,0
52274,6,2,183283,183283,183285,0,2,1
52275,4,3,183287,183287,183290,0,3,2
52276,2,3,183289,183290,183293,1,4,0
52277,5,1,183294,183294,183295,0,1,1
52278,5,3,183299,183299,183302,0,3,4
52279,3,3,183302,183302,183305,0,3,0
52280,6,2,183308,183308,183310,0,2,3
52281,2,2,183310,183310,183312,0,2,0
52282,6,1,183316,183316,183317,0,1,4
52283,1,1,183317,183317,183318,0,1,0
52284,2,2,183319,183319,183321,0,2,1
52285,2,2,183321,183321,183323,0,2,0
52286,1,2,183322,183323,183325,1,3,0
52287,1,2,183323,183325,183327,2,4,0
52288,4,3,183327,183327,183330,0,3,0
52289,4,1,183331,183331,183332,0,1,1
52290,1,3,183332,183332,183335,0,3,0
52291,4,3,183336,183336,183339,0,3,1
52292,3,3,183339,183339,183342,0,3,0
52293,2,3,183341,183342,183345,1,4,0
52294,2,2,183343,183345,183347,2,4,0
52295,1,2,183344,183347,183349,3,5,0
52296,5,2,183349,183349,183351,0,2,0
52297,2,2,183351,183351,183353,0,2,0
52298,3,3,183354,183354,183357,0,3,1
52299,2,2,183356,183357,183359,1,3,0
52300,4,2,183360,183360,183362,0,2,1
52301,6,2,183366,183366,183368,0,2,4
52302,2,2,183368,183368,183370,0,2,0
52303,4,1,183372,183372,183373,0,1,2
52304,3,2,183375,183375,183377,0,2,2
52305,5,1,183380,183380,183381,0,1,3
52306,3,2,183383,183383,183385,0,2,2
52307,4,2,183387,183387,183389,0,2,2
52308,6,1,183393,183393,183394,0,1,4
52309,2,3,183395,183395,183398,0,3,1
52310,3,2,183398,183398,183400,0,2,0
52311,1,2,183399,183400,183402,1,3,0
52312,6,2,183405,183405,183407,0,2,3
52313,3,2,183408,183408,183410,0,2,1
52314,6,2,183414,183414,183416,0,2,4
52315,2,3,183416,183416,183419,0,3,0
52316,4,1,183420,183420,183421,0,1,1
52317,1,3,183421,183421,183424,0,3,0
52318,6,2,183427,183427,183429,0,2,3
52319,4,1,183431,183431,183432,0,1,2
52320,2,3,183433,183433,183436,0,3,1
52321,5,2,183438,183438,183440,0,2,2
52322,4,1,183442,183442,183443,0,1,2
52323,2,1,183444,183444,183445,0,1,1
52324,4,3,183448,183448,183451,0,3,3
52325,3,3,183451,183451,183454,0,3,0
52326,5,2,183456,183456,183458,0,2,2
52327,3,1,183459,183459,183460,0,1,1
52328,2,1,183461,183461,183462,0,1,1
52329,6,3,183467,183467,183470,0,3,5
52330,6,1,183473,183473,183474,0,1,3
52331,4,2,183477,183477,183479,0,2,3
52332,1,1,183478,183479,183480,1,2,0
52333,1,3,183479,183480,183483,1,4,0
52334,6,1,183485,183485,183486,0,1,2
52335,3,2,183488,183488,183490,0,2,2
52336,2,2,183490,183490,183492,0,2,0
52337,1,3,183491,183492,183495,1,4,0
52338,5,2,183496,183496,183498,0,2,1
52339,3,2,183499,183499,183501,0,2,1
52340,2,3,183501,183501,183504,0,3,0
52341,2,1,183503,183504,183505,1,2,0
52342,6,2,183509,183509,183511,0,2,4
52343,6,1,183515,183515,183516,0,1,4
52344,6,3,183521,183521,183524,0,3,5
52345,4,1,183525,183525,183526,0,1,1
52346,2,1,183527,183527,183528,0,1,1
52347,2,1,183529,183529,183530,0,1,1
52348,2,3,183531,183531,183534,0,3,1
52349,3,3,183534,183534,183537,0,3,0
52350,5,2,183539,183539,183541,0,2,2
52351,1,3,183540,183541,183544,1,4,0
52352,3,3,183543,183544,183547,1,4,0
52353,4,3,183547,183547,183550,0,3,0
52354,6,1,183553,183553,183554,0,1,3
52355,3,1,183556,183556,183557,0,1,2
52356,2,1,183558,183558,183559,0,1,1
52357,5,3,183563,183563,183566,0,3,4
52358,6,3,183569,183569,183572,0,3,3
52359,1,1,183570,183572,183573,2,3,0
52360,6,2,183576,183576,183578,0,2,3
52361,1,2,183577,183578,183580,1,3,0
52362,5,1,183582,183582,183583,0,1,2
52363,4,3,183586,183586,183589,0,3,3
52364,2,1,183588,183589,183590,1,2,0
52365,6,3,183594,183594,183597,0,3,4
52366,3,3,183597,183597,183600,0,3,0
52367,4,3,183601,183601,183604,0,3,1
52368,4,3,183605,183605,183608,0,3,1
52369,4,2,183609,183609,183611,0,2,1
52370,1,1,183610,183611,183612,1,2,0
52371,5,2,183615,183615,183617,0,2,3
52372,2,2,183617,183617,183619,0,2,0
52373,3,1,183620,183620,183621,0,1,1
52374,5,3,183625,183625,183628,0,3,4
52375,5,3,183630,183630,183633,0,3,2
52376,1,2,183631,183633,183635,2,4,0
52377,4,1,183635,183635,183636,0,1,0
52378,1,3,183636,183636,183639,0,3,0
52379,6,3,183642,183642,183645,0,3,3
52380,4,3,183646,183646,183649,0,3,1
52381,1,2,183647,183649,183651,2,4,0
52382,3,1,183650,183651,183652,1,2,0
52383,6,3,183656,183656,183659,0,3,4
52384,6,3,183662,183662,183665,0,3,3
52385,5,1,183667,183667,183668,0,1,2
52386,1,1,183668,183668,183669,0,1,0
52387,6,3,183674,183674,183677,0,3,5
52388,6,2,183680,183680,183682,0,2,3
52389,6,1,183686,183686,183687,0,1,4
52390,6,3,183692,183692,183695,0,3,5
52391,6,3,183698,183698,183701,0,3,3
52392,6,1,183704,183704,183705,0,1,3
52393,4,1,183708,183708,183709,0,1,3
52394,2,3,183710,183710,183713,0,3,1
52395,2,2,183712,183713,183715,1,3,0
52396,2,3,183714,183715,183718,1,4,0
52397,1,3,183715,183718,183721,3,6,0
52398,2,1,183717,183721,183722,4,5,0
52399,3,2,183720,183722,183724,2,4,0
52400,2,1,183722,183724,183725,2,3,0
52401,6,1,183728,183728,183729,0,1,3
52402,6,1,183734,183734,183735,0,1,5
52403,6,3,183740,183740,183743,0,3,5
52404,2,2,183742,183743,183745,1,3,0
52405,3,2,183745,183745,183747,0,2,0
52406,2,2,183747,183747,183749,0,2,0
52407,5,3,183752,183752,183755,0,3,3
52408,6,1,183758,183758,183759,0,1,3
52409,6,3,183764,183764,183767,0,3,5
52410,6,1,183770,183770,183771,0,1,3
52411,4,3,183774,183774,183777,0,3,3
52412,3,2,183777,183777,183779,0,2,0
52413,4,1,183781,183781,183782,0,1,2
52414,5,2,183786,183786,183788,0,2,4
52415,3,3,183789,183789,183792,0,3,1
52416,1,1,183790,183792,183793,2,3,0
52417,4,1,183794,183794,183795,0,1,1
52418,1,1,183795,183795,183796,0,1,0
52419,3,2,183798,183798,183800,0,2,2
52420,1,3,183799,183800,183803,1,4,0
52421,6,2,183805,183805,183807,0,2,2
52422,3,1,183808,183808,183809,0,1,1
52423,1,3,183809,183809,183812,0,3,0
52424,6,3,183815,183815,183818,0,3,3
52425,5,2,183820,183820,183822,0,2,2
52426,5,2,183825,183825,183827,0,2,3
52427,6,3,183831,183831,183834,0,3,4
52428,2,3,183833,183834,183837,1,4,0
52429,1,2,183834,183837,183839,3,5,0
52430,2,1,183836,183839,183840,3,4,0
52431,5,3,183841,183841,183844,0,3,1
52432,2,3,183843,183844,183847,1,4,0
52433,5,3,183848,183848,183851,0,3,1
52434,4,1,183852,183852,183853,0,1,1
52435,1,3,183853,183853,183856,0,3,0
52436,5,1,183858,183858,183859,0,1,2
52437,6,2,183864,183864,183866,0,2,5
52438,6,2,183870,183870,183872,0,2,4
52439,2,3,183872,183872,183875,0,3,0
52440,4,2,183876,183876,183878,0,2,1
52441,3,3,183879,183879,183882,0,3,1
52442,2,2,183881,183882,183884,1,3,0
52443,3,3,183884,183884,183887,0,3,0
52444,6,2,183890,183890,183892,0,2,3
52445,2,2,183892,183892,183894,0,2,0
52446,5,1,183897,183897,183898,0,1,3
52447,4,2,183901,183901,183903,0,2,3
52448,3,3,183904,183904,183907,0,3,1
52449,5,3,183909,183909,183912,0,3,2
52450,2,1,183911,183912,183913,1,2,0
52451,4,1,183915,183915,183916,0,1,2
52452,2,1,183917,183917,183918,0,1,1
52453,5,1,183922,183922,183923,0,1,4
52454,4,2,183926,183926,183928,0,2,3
52455,3,3,183929,183929,183932,0,3,1
52456,4,1,183933,183933,183934,0,1,1
52457,3,3,183936,183936,183939,0,3,2
52458,4,2,183940,183940,183942,0,2,1
52459,3,1,183943,183943,183944,0,1,1
52460,6,1,183949,183949,183950,0,1,5
52461,2,3,183951,183951,183954,0,3,1
52462,3,3,183954,183954,183957,0,3,0
52463,2,2,183956,183957,183959,1,3,0
52464,2,3,183958,183959,183962,1,4,0
52465,1,3,183959,183962,183965,3,6,0
52466,6,1,183965,183965,183966,0,1,0
52467,6,1,183971,183971,183972,0,1,5
52468,6,2,183977,183977,183979,0,2,5
52469,2,1,183979,183979,183980,0,1,0
52470,4,2,183983,183983,183985,0,2,3
52471,3,2,183986,183986,183988,0,2,1
52472,4,2,183990,183990,183992,0,2,2
52473,2,3,183992,183992,183995,0,3,0
52474,3,3,183995,183995,183998,0,3,0
52475,6,1,184001,184001,184002,0,1,3
52476,4,3,184005,184005,184008,0,3,3
52477,6,3,184011,184011,184014,0,3,3
52478,2,1,184013,184014,184015,1,2,0
52479,2,3,184015,184015,184018,0,3,0
52480,2,3,184017,184018,184021,1,4,0
52481,5,1,184022,184022,184023,0,1,1
52482,6,3,184028,184028,184031,0,3,5
52483,6,3,184034,184034,184037,0,3,3
52484,1,1,184035,184037,184038,2,3,0
52485,6,2,184041,184041,184043,0,2,3
52486,2,3,184043,184043,184046,0,3,0
52487,5,1,184048,184048,184049,0,1,2
52488,3,2,184051,184051,184053,0,2,2
52489,4,2,184055,184055,184057,0,2,2
52490,1,3,184056,184057,184060,1,4,0
52491,5,2,184061,184061,184063,0,2,1
52492,3,2,184064,184064,184066,0,2,1
52493,5,3,184069,184069,184072,0,3,3
52494,3,2,184072,184072,184074,0,2,0
52495,4,1,184076,184076,184077,0,1,2
52496,1,2,184077,184077,184079,0,2,0
52497,2,3,184079,184079,184082,0,3,0
52498,5,2,184084,184084,184086,0,2,2
52499,3,2,184087,184087,184089,0,2,1
52500,6,3,184093,184093,184096,0,3,4
52501,3,1,184096,184096,184097,0,1,0
52502,6,1,184102,184102,184103,0,1,5
52503,6,1,184108,184108,184109,0,1,5
52504,5,1,184113,184113,184114,0,1,4
52505,2,3,184115,184115,184118,0,3,1
52506,4,2,184119,184119,184121,0,2,1
52507,2,3,184121,184121,184124,0,3,0
52508,1,1,184122,184124,184125,2,3,0
52509,3,1,184125,184125,184126,0,1,0
52510,1,2,184126,184126,184128,0,2,0
52511,2,1,184128,184128,184129,0,1,0
52512,4,2,184132,184132,184134,0,2,3
52513,1,2,184133,184134,184136,1,3,0
52514,6,1,184139,184139,184140,0,1,3
52515,3,1,184142,184142,184143,0,1,2
52516,3,3,184145,184145,184148,0,3,2
52517,3,1,184148,184148,184149,0,1,0
52518,2,3,184150,184150,184153,0,3,1
52519,2,2,184152,184153,184155,1,3,0
52520,6,3,184158,184158,184161,0,3,3
52521,6,2,184164,184164,184166,0,2,3
52522,6,1,184170,184170,184171,0,1,4
52523,4,1,184174,184174,184175,0,1,3
52524,4,3,184178,184178,184181,0,3,3
52525,6,1,184184,184184,184185,0,1,3
52526,4,2,184188,184188,184190,0,2,3
52527,3,1,184191,184191,184192,0,1,1
52528,3,3,184194,184194,184197,0,3,2
52529,4,2,184198,184198,184200,0,2,1
52530,5,2,184203,184203,184205,0,2,3
52531,3,3,184206,184206,184209,0,3,1
52532,6,3,184212,184212,184215,0,3,3
52533,2,3,184214,184215,184218,1,4,0
52534,2,3,184216,184218,184221,2,5,0
52535,4,2,184220,184221,184223,1,3,0
52536,3,2,184223,184223,184225,0,2,0
52537,1,2,184224,184225,184227,1,3,0
52538,3,2,184227,184227,184229,0,2,0
52539,2,2,184229,184229,184231,0,2,0
52540,1,1,184230,184231,184232,1,2,0
52541,4,2,184234,184234,184236,0,2,2
52542,2,2,184236,184236,184238,0,2,0
52543,3,2,184239,184239,184241,0,2,1
52544,1,2,184240,184241,184243,1,3,0
52545,3,1,184243,184243,184244,0,1,0
52546,2,3,184245,184245,184248,0,3,1
52547,3,2,184248,184248,184250,0,2,0
52548,1,1,184249,184250,184251,1,2,0
52549,4,1,184253,184253,184254,0,1,2
52550,3,1,184256,184256,184257,0,1,2
52551,5,1,184261,184261,184262,0,1,4
52552,3,3,184264,184264,184267,0,3,2
52553,4,1,184268,184268,184269,0,1,1
52554,4,1,184272,184272,184273,0,1,3
52555,5,2,184277,184277,184279,0,2,4
52556,1,1,184278,184279,184280,1,2,0
52557,6,2,184284,184284,184286,0,2,4
52558,5,3,184289,184289,184292,0,3,3
52559,4,1,184293,184293,184294,0,1,1
52560,6,1,184299,184299,184300,0,1,5
52561,1,3,184300,184300,184303,0,3,0
52562,5,3,184305,184305,184308,0,3,2
52563,1,2,184306,184308,184310,2,4,0
52564,3,2,184309,184310,184312,1,3,0
52565,2,3,184311,184312,184315,1,4,0
52566,3,1,184314,184315,184316,1,2,0
52567,6,3,184320,184320,184323,0,3,4
52568,1,2,184321,184323,184325,2,4,0
52569,5,3,184326,184326,184329,0,3,1
52570,3,2,184329,184329,184331,0,2,0
52571,5,1,184334,184334,184335,0,1,3
52572,3,1,184337,184337,184338,0,1,2
52573,4,1,184341,184341,184342,0,1,3
52574,5,1,184346,184346,184347,0,1,4
52575,4,2,184350,184350,184352,0,2,3
52576,4,3,184354,184354,184357,0,3,2
52577,5,1,184359,184359,184360,0,1,2
52578,4,2,184363,184363,184365,0,2,3
52579,4,2,184367,184367,184369,0,2,2
52580,3,2,184370,184370,184372,0,2,1
52581,4,1,184374,184374,184375,0,1,2
52582,1,3,184375,184375,184378,0,3,0
52583,1,2,184376,184378,184380,2,4,0
52584,1,2,184377,184380,184382,3,5,0
52585,3,2,184380,184382,184384,2,4,0
52586,1,1,184381,184384,184385,3,4,0
52587,6,3,184387,184387,184390,0,3,2
52588,3,1,184390,184390,184391,0,1,0
52589,3,3,184393,184393,184396,0,3,2
52590,2,3,184395,184396,184399,1,4,0
52591,4,1,184399,184399,184400,0,1,0
52592,2,3,184401,184401,184404,0,3,1
52593,2,1,184403,184404,184405,1,2,0
52594,3,1,184406,184406,184407,0,1,1
52595,4,1,184410,184410,184411,0,1,3
52596,1,3,184411,184411,184414,0,3,0
52597,4,2,184415,184415,184417,0,2,1
52598,3,3,184418,184418,184421,0,3,1
52599,5,3,184423,184423,184426,0,3,2
52600,3,3,184426,184426,184429,0,3,0
52601,5,3,184431,184431,184434,0,3,2
52602,6,3,184437,184437,184440,0,3,3
52603,2,2,184439,184440,184442,1,3,0
52604,1,2,184440,184442,184444,2,4,0
52605,6,3,184446,184446,184449,0,3,2
52606,4,1,184450,184450,184451,0,1,1
52607,1,1,184451,184451,184452,0,1,0
52608,4,2,184455,184455,184457,0,2,3
52609,3,1,184458,184458,184459,0,1,1
52610,1,2,184459,184459,184461,0,2,0
52611,4,1,184463,184463,184464,0,1,2
52612,4,1,184467,184467,184468,0,1,3
52613,4,1,184471,184471,184472,0,1,3
52614,5,2,184476,184476,184478,0,2,4
52615,5,3,184481,184481,184484,0,3,3
52616,3,2,184484,184484,184486,0,2,0
52617,1,2,184485,184486,184488,1,3,0
52618,5,1,184490,184490,184491,0,1,2
52619,4,3,184494,184494,184497,0,3,3
52620,6,3,184500,184500,184503,0,3,3
52621,2,3,184502,184503,184506,1,4,0
52622,4,2,184506,184506,184508,0,2,0
52623,2,1,184508,184508,184509,0,1,0
52624,2,3,184510,184510,184513,0,3,1
52625,4,1,184514,184514,184515,0,1,1
52626,5,1,184519,184519,184520,0,1,4
52627,3,2,184522,184522,184524,0,2,2
52628,5,1,184527,184527,184528,0,1,3
52629,3,2,184530,184530,184532,0,2,2
52630,2,1,184532,184532,184533,0,1,0
52631,2,2,184534,184534,184536,0,2,1
52632,5,3,184539,184539,184542,0,3,3
52633,3,1,184542,184542,184543,0,1,0
52634,2,3,184544,184544,184547,0,3,1
52635,1,1,184545,184547,184548,2,3,0
52636,2,3,184547,184548,184551,1,4,0
52637,3,1,184550,184551,184552,1,2,0
52638,2,2,184552,184552,184554,0,2,0
52639,2,2,184554,184554,184556,0,2,0
52640,1,1,184555,184556,184557,1,2,0
52641,3,2,184558,184558,184560,0,2,1
52642,3,3,184561,184561,184564,0,3,1
52643,3,2,184564,184564,184566,0,2,0
52644,2,1,184566,184566,184567,0,1,0
52645,4,2,184570,184570,184572,0,2,3
52646,2,2,184572,184572,184574,0,2,0
52647,6,1,184578,184578,184579,0,1,4
52648,3,1,184581,184581,184582,0,1,2
52649,6,3,184587,184587,184590,0,3,5
52650,2,1,184589,184590,184591,1,2,0
52651,4,1,184593,184593,184594,0,1,2
52652,5,1,184598,184598,184599,0,1,4
52653,4,1,184602,184602,184603,0,1,3
52654,1,1,184603,184603,184604,0,1,0
52655,1,3,184604,184604,184607,0,3,0
52656,2,1,184606,184607,184608,1,2,0
52657,4,2,184610,184610,184612,0,2,2
52658,4,2,184614,184614,184616,0,2,2
52659,3,2,184617,184617,184619,0,2,1
52660,4,1,184621,184621,184622,0,1,2
52661,5,3,184626,184626,184629,0,3,4
52662,6,2,184632,184632,184634,0,2,3
52663,4,1,184636,184636,184637,0,1,2
52664,1,3,184637,184637,184640,0,3,0
52665,2,2,184639,184640,184642,1,3,0
52666,5,2,184644,184644,184646,0,2,2
52667,1,1,184645,184646,184647,1,2,0
52668,3,1,184648,184648,184649,0,1,1
52669,2,2,184650,184650,184652,0,2,1
52670,6,2,184656,184656,184658,0,2,4
52671,6,3,184662,184662,184665,0,3,4
52672,2,1,184664,184665,184666,1,2,0
52673,1,2,184665,184666,184668,1,3,0
52674,2,2,184667,184668,184670,1,3,0
52675,5,1,184672,184672,184673,0,1,2
52676,4,2,184676,184676,184678,0,2,3
52677,4,2,184680,184680,184682,0,2,2
52678,6,3,184686,184686,184689,0,3,4
52679,1,1,184687,184689,184690,2,3,0
52680,6,3,184693,184693,184696,0,3,3
52681,2,1,184695,184696,184697,1,2,0
52682,1,2,184696,184697,184699,1,3,0
52683,6,2,184702,184702,184704,0,2,3
52684,4,2,184706,184706,184708,0,2,2
52685,4,3,184710,184710,184713,0,3,2
52686,6,1,184716,184716,184717,0,1,3
52687,6,3,184722,184722,184725,0,3,5
52688,5,3,184727,184727,184730,0,3,2
52689,3,2,184730,184730,184732,0,2,0
52690,3,3,184733,184733,184736,0,3,1
52691,4,2,184737,184737,184739,0,2,1
52692,5,1,184742,184742,184743,0,1,3
52693,1,3,184743,184743,184746,0,3,0
52694,3,3,184746,184746,184749,0,3,0
52695,1,2,184747,184749,184751,2,4,0
52696,6,2,184753,184753,184755,0,2,2
52697,3,1,184756,184756,184757,0,1,1
52698,3,3,184759,184759,184762,0,3,2
52699,4,2,184763,184763,184765,0,2,1
52700,6,2,184769,184769,184771,0,2,4
52701,4,3,184773,184773,184776,0,3,2
52702,5,1,184778,184778,184779,0,1,2
52703,1,2,184779,184779,184781,0,2,0
52704,5,3,184784,184784,184787,0,3,3
52705,6,1,184790,184790,184791,0,1,3
52706,2,1,184792,184792,184793,0,1,1
52707,2,3,184794,184794,184797,0,3,1
52708,1,1,184795,184797,184798,2,3,0
52709,5,1,184800,184800,184801,0,1,2
52710,6,2,184806,184806,184808,0,2,5
52711,5,3,184811,184811,184814,0,3,3
52712,4,1,184815,184815,184816,0,1,1
52713,4,1,184819,184819,184820,0,1,3
52714,5,1,184824,184824,184825,0,1,4
52715,4,2,184828,184828,184830,0,2,3
52716,3,2,184831,184831,184833,0,2,1
52717,2,3,184833,184833,184836,0,3,0
52718,5,3,184838,184838,184841,0,3,2
52719,4,3,184842,184842,184845,0,3,1
52720,5,2,184847,184847,184849,0,2,2
52721,1,1,184848,184849,184850,1,2,0
52722,2,2,184850,184850,184852,0,2,0
52723,6,1,184856,184856,184857,0,1,4
52724,1,1,184857,184857,184858,0,1,0
52725,3,2,184860,184860,184862,0,2,2
52726,6,2,184866,184866,184868,0,2,4
52727,4,1,184870,184870,184871,0,1,2
52728,2,1,184872,184872,184873,0,1,1
52729,1,3,184873,184873,184876,0,3,0
52730,1,2,184874,184876,184878,2,4,0
52731,5,3,184879,184879,184882,0,3,1
52732,4,2,184883,184883,184885,0,2,1
52733,3,3,184886,184886,184889,0,3,1
52734,5,2,184891,184891,184893,0,2,2
52735,2,2,184893,184893,184895,0,2,0
52736,4,1,184897,184897,184898,0,1,2
52737,4,3,184901,184901,184904,0,3,3
52738,3,2,184904,184904,184906,0,2,0
52739,5,3,184909,184909,184912,0,3,3
52740,2,3,184911,184912,184915,1,4,0
52741,4,3,184915,184915,184918,0,3,0
52742,4,3,184919,184919,184922,0,3,1
52743,1,3,184920,184922,184925,2,5,0
52744,4,1,184924,184925,184926,1,2,0
52745,6,2,184930,184930,184932,0,2,4
52746,2,1,184932,184932,184933,0,1,0
52747,3,2,184935,184935,184937,0,2,2
52748,2,2,184937,184937,184939,0,2,0
52749,6,3,184943,184943,184946,0,3,4
52750,1,1,184944,184946,184947,2,3,0
52751,5,1,184949,184949,184950,0,1,2
52752,3,1,184952,184952,184953,0,1,2
52753,1,1,184953,184953,184954,0,1,0
52754,4,2,184957,184957,184959,0,2,3
52755,2,3,184959,184959,184962,0,3,0
52756,2,2,184961,184962,184964,1,3,0
52757,3,2,184964,184964,184966,0,2,0
52758,5,2,184969,184969,184971,0,2,3
52759,3,1,184972,184972,184973,0,1,1
52760,5,2,184977,184977,184979,0,2,4
52761,1,3,184978,184979,184982,1,4,0
52762,5,2,184983,184983,184985,0,2,1
52763,5,2,184988,184988,184990,0,2,3
52764,2,1,184990,184990,184991,0,1,0
52765,2,2,184992,184992,184994,0,2,1
52766,6,3,184998,184998,185001,0,3,4
52767,3,2,185001,185001,185003,0,2,0
52768,1,1,185002,185003,185004,1,2,0
52769,5,3,185007,185007,185010,0,3,3
52770,6,3,185013,185013,185016,0,3,3
52771,6,1,185019,185019,185020,0,1,3
52772,3,1,185022,185022,185023,0,1,2
52773,6,2,185028,185028,185030,0,2,5
52774,1,1,185029,185030,185031,1,2,0
52775,1,2,185030,185031,185033,1,3,0
52776,5,3,185035,185035,185038,0,3,2
52777,5,1,185040,185040,185041,0,1,2
52778,2,1,185042,185042,185043,0,1,1
52779,2,3,185044,185044,185047,0,3,1
52780,3,2,185047,185047,185049,0,2,0
52781,2,3,185049,185049,185052,0,3,0
52782,3,2,185052,185052,185054,0,2,0
52783,1,1,185053,185054,185055,1,2,0
52784,2,3,185055,185055,185058,0,3,0
52785,2,2,185057,185058,185060,1,3,0
52786,5,3,185062,185062,185065,0,3,2
52787,6,3,185068,185068,185071,0,3,3
52788,1,3,185069,185071,185074,2,5,0
52789,6,1,185075,185075,185076,0,1,1
52790,5,2,185080,185080,185082,0,2,4
52791,4,2,185084,185084,185086,0,2,2
52792,1,1,185085,185086,185087,1,2,0
52793,5,2,185090,185090,185092,0,2,3
52794,3,2,185093,185093,185095,0,2,1
52795,6,1,185099,185099,185100,0,1,4
52796,3,2,185102,185102,185104,0,2,2
52797,5,1,185107,185107,185108,0,1,3
52798,4,2,185111,185111,185113,0,2,3
52799,2,3,185113,185113,185116,0,3,0
52800,5,1,185118,185118,185119,0,1,2
52801,4,1,185122,185122,185123,0,1,3
52802,1,3,185123,185123,185126,0,3,0
52803,4,1,185127,185127,185128,0,1,1
52804,4,2,185131,185131,185133,0,2,3
52805,6,1,185137,185137,185138,0,1,4
52806,1,2,185138,185138,185140,0,2,0
52807,4,2,185142,185142,185144,0,2,2
52808,5,3,185147,185147,185150,0,3,3
52809,2,2,185149,185150,185152,1,3,0
52810,1,2,185150,185152,185154,2,4,0
52811,1,2,185151,185154,185156,3,5,0
52812,3,2,185154,185156,185158,2,4,0
52813,6,3,185160,185160,185163,0,3,2
52814,2,1,185162,185163,185164,1,2,0
52815,6,1,185168,185168,185169,0,1,4
52816,1,1,185169,185169,185170,0,1,0
52817,3,1,185172,185172,185173,0,1,2
52818,5,1,185177,185177,185178,0,1,4
52819,5,2,185182,185182,185184,0,2,4
52820,6,1,185188,185188,185189,0,1,4
52821,4,1,185192,185192,185193,0,1,3
52822,4,2,185196,185196,185198,0,2,3
52823,2,1,185198,185198,185199,0,1,0
52824,3,2,185201,185201,185203,0,2,2
52825,3,2,185204,185204,185206,0,2,1
52826,1,3,185205,185206,185209,1,4,0
52827,3,2,185208,185209,185211,1,3,0
52828,5,3,185213,185213,185216,0,3,2
52829,1,2,185214,185216,185218,2,4,0
52830,6,3,185220,185220,185223,0,3,2
52831,4,2,185224,185224,185226,0,2,1
52832,5,3,185229,185229,185232,0,3,3
52833,6,3,185235,185235,185238,0,3,3
52834,2,2,185237,185238,185240,1,3,0
52835,3,3,185240,185240,185243,0,3,0
52836,2,1,185242,185243,185244,1,2,0
52837,1,2,185243,185244,185246,1,3,0
52838,4,1,185247,185247,185248,0,1,1
52839,2,3,185249,185249,185252,0,3,1
52840,6,3,185255,185255,185258,0,3,3
52841,2,3,185257,185258,185261,1,4,0
52842,3,2,185260,185261,185263,1,3,0
52843,4,1,185264,185264,185265,0,1,1
52844,2,1,185266,185266,185267,0,1,1
52845,2,2,185268,185268,185270,0,2,1
52846,6,3,185274,185274,185277,0,3,4
52847,4,3,185278,185278,185281,0,3,1
52848,2,2,185280,185281,185283,1,3,0
52849,2,1,185282,185283,185284,1,2,0
52850,2,3,185284,185284,185287,0,3,0
52851,6,2,185290,185290,185292,0,2,3
52852,1,3,185291,185292,185295,1,4,0
52853,1,2,185292,185295,185297,3,5,0
52854,5,1,185297,185297,185298,0,1,0
52855,6,1,185303,185303,185304,0,1,5
52856,3,3,185306,185306,185309,0,3,2
52857,3,3,185309,185309,185312,0,3,0
52858,2,1,185311,185312,185313,1,2,0
52859,1,2,185312,185313,185315,1,3,0
52860,6,2,185318,185318,185320,0,2,3
52861,1,2,185319,185320,185322,1,3,0
52862,1,2,185320,185322,185324,2,4,0
52863,1,1,185321,185324,185325,3,4,0
52864,3,2,185324,185325,185327,1,3,0
52865,2,3,185326,185327,185330,1,4,0
52866,3,3,185329,185330,185333,1,4,0
52867,4,1,185333,185333,185334,0,1,0
52868,5,3,185338,185338,185341,0,3,4
52869,3,3,185341,185341,185344,0,3,0
52870,1,2,185342,185344,185346,2,4,0
52871,2,3,185344,185346,185349,2,5,0
52872,2,3,185346,185349,185352,3,6,0
52873,2,3,185348,185352,185355,4,7,0
52874,5,3,185353,185355,185358,2,5,0
52875,2,1,185355,185358,185359,3,4,0
52876,5,3,185360,185360,185363,0,3,1
52877,5,2,185365,185365,185367,0,2,2
52878,4,2,185369,185369,185371,0,2,2
52879,2,1,185371,185371,185372,0,1,0
52880,5,2,185376,185376,185378,0,2,4
52881,3,2,185379,185379,185381,0,2,1
52882,4,3,185383,185383,185386,0,3,2
52883,4,2,185387,185387,185389,0,2,1
52884,2,3,185389,185389,185392,0,3,0
52885,6,3,185395,185395,185398,0,3,3
52886,4,3,185399,185399,185402,0,3,1
52887,5,1,185404,185404,185405,0,1,2
52888,5,3,185409,185409,185412,0,3,4
52889,1,2,185410,185412,185414,2,4,0
52890,1,2,185411,185414,185416,3,5,0
52891,4,1,185415,185416,185417,1,2,0
52892,5,3,185420,185420,185423,0,3,3
52893,6,3,185426,185426,185429,0,3,3
52894,4,3,185430,185430,185433,0,3,1
52895,5,2,185435,185435,185437,0,2,2
52896,2,2,185437,185437,185439,0,2,0
52897,3,3,185440,185440,185443,0,3,1
52898,3,3,185443,185443,185446,0,3,0
52899,3,2,185446,185446,185448,0,2,0
52900,5,3,185451,185451,185454,0,3,3
52901,3,1,185454,185454,185455,0,1,0
52902,3,2,185457,185457,185459,0,2,2
52903,5,3,185462,185462,185465,0,3,3
52904,4,1,185466,185466,185467,0,1,1
52905,4,3,185470,185470,185473,0,3,3
52906,5,3,185475,185475,185478,0,3,2
52907,1,3,185476,185478,185481,2,5,0
52908,3,3,185479,185481,185484,2,5,0
52909,3,1,185482,185484,185485,2,3,0
52910,5,2,185487,185487,185489,0,2,2
52911,5,2,185492,185492,185494,0,2,3
52912,2,2,185494,185494,185496,0,2,0
52913,4,3,185498,185498,185501,0,3,2
52914,5,3,185503,185503,185506,0,3,2
52915,2,1,185505,185506,185507,1,2,0
52916,2,1,185507,185507,185508,0,1,0
52917,6,3,185513,185513,185516,0,3,5
52918,3,2,185516,185516,185518,0,2,0
52919,2,3,185518,185518,185521,0,3,0
52920,4,1,185522,185522,185523,0,1,1
52921,1,3,185523,185523,185526,0,3,0
52922,6,1,185529,185529,185530,0,1,3
52923,1,2,185530,185530,185532,0,2,0
52924,6,3,185536,185536,185539,0,3,4
52925,1,3,185537,185539,185542,2,5,0
52926,6,1,185543,185543,185544,0,1,1
52927,2,2,185545,185545,185547,0,2,1
52928,6,1,185551,185551,185552,0,1,4
52929,4,2,185555,185555,185557,0,2,3
52930,5,3,185560,185560,185563,0,3,3
52931,2,2,185562,185563,185565,1,3,0
52932,3,3,185565,185565,185568,0,3,0
52933,3,2,185568,185568,185570,0,2,0
52934,3,1,185571,185571,185572,0,1,1
52935,6,2,185577,185577,185579,0,2,5
52936,4,2,185581,185581,185583,0,2,2
52937,4,2,185585,185585,185587,0,2,2
52938,5,2,185590,185590,185592,0,2,3
52939,2,3,185592,185592,185595,0,3,0
52940,6,3,185598,185598,185601,0,3,3
52941,1,2,185599,185601,185603,2,4,0
52942,4,1,185603,185603,185604,0,1,0
52943,3,3,185606,185606,185609,0,3,2
52944,1,3,185607,185609,185612,2,5,0
52945,4,1,185611,185612,185613,1,2,0
52946,3,2,185614,185614,185616,0,2,1
52947,6,2,185620,185620,185622,0,2,4
52948,1,2,185621,185622,185624,1,3,0
52949,5,2,185626,185626,185628,0,2,2
52950,6,2,185632,185632,185634,0,2,4
52951,2,3,185634,185634,185637,0,3,0
52952,1,2,185635,185637,185639,2,4,0
52953,4,1,185639,185639,185640,0,1,0
52954,4,2,185643,185643,185645,0,2,3
52955,3,3,185646,185646,185649,0,3,1
52956,5,1,185651,185651,185652,0,1,2
52957,5,3,185656,185656,185659,0,3,4
52958,2,2,185658,185659,185661,1,3,0
52959,6,2,185664,185664,185666,0,2,3
52960,5,2,185669,185669,185671,0,2,3
52961,4,3,185673,185673,185676,0,3,2
52962,5,1,185678,185678,185679,0,1,2
52963,3,3,185681,185681,185684,0,3,2
52964,4,2,185685,185685,185687,0,2,1
52965,3,3,185688,185688,185691,0,3,1
52966,5,2,185693,185693,185695,0,2,2
52967,4,2,185697,185697,185699,0,2,2
52968,2,2,185699,185699,185701,0,2,0
52969,2,3,185701,185701,185704,0,3,0
52970,5,1,185706,185706,185707,0,1,2
52971,6,3,185712,185712,185715,0,3,5
52972,3,1,185715,185715,185716,0,1,0
52973,6,1,185721,185721,185722,0,1,5
52974,6,3,185727,185727,185730,0,3,5
52975,3,3,185730,185730,185733,0,3,0
52976,4,2,185734,185734,185736,0,2,1
52977,2,3,185736,185736,185739,0,3,0
52978,4,3,185740,185740,185743,0,3,1
52979,4,3,185744,185744,185747,0,3,1
52980,2,3,185746,185747,185750,1,4,0
52981,6,3,185752,185752,185755,0,3,2
52982,5,3,185757,185757,185760,0,3,2
52983,2,1,185759,185760,185761,1,2,0
52984,2,3,185761,185761,185764,0,3,0
52985,4,3,185765,185765,185768,0,3,1
52986,2,1,185767,185768,185769,1,2,0
52987,5,2,185772,185772,185774,0,2,3
52988,2,2,185774,185774,185776,0,2,0
52989,5,3,185779,185779,185782,0,3,3
52990,5,2,185784,185784,185786,0,2,2
52991,5,1,185789,185789,185790,0,1,3
52992,3,2,185792,185792,185794,0,2,2
52993,2,2,185794,185794,185796,0,2,0
52994,1,2,185795,185796,185798,1,3,0
52995,4,3,185799,185799,185802,0,3,1
52996,2,3,185801,185802,185805,1,4,0
52997,2,2,185803,185805,185807,2,4,0
52998,4,2,185807,185807,185809,0,2,0
52999,6,3,185813,185813,185816,0,3,4
53000,6,1,185819,185819,185820,0,1,3
53001,4,3,185823,185823,185826,0,3,3
53002,5,1,185828,185828,185829,0,1,2
53003,1,3,185829,185829,185832,0,3,0
53004,4,3,185833,185833,185836,0,3,1
53005,4,3,185837,185837,185840,0,3,1
53006,4,2,185841,185841,185843,0,2,1
53007,3,3,185844,185844,185847,0,3,1
53008,4,2,185848,185848,185850,0,2,1
53009,4,1,185852,185852,185853,0,1,2
53010,5,2,185857,185857,185859,0,2,4
53011,4,3,185861,185861,185864,0,3,2
53012,3,3,185864,185864,185867,0,3,0
53013,1,2,185865,185867,185869,2,4,0
53014,1,1,185866,185869,185870,3,4,0
53015,6,2,185872,185872,185874,0,2,2
53016,6,2,185878,185878,185880,0,2,4
53017,1,1,185879,185880,185881,1,2,0
53018,1,2,185880,185881,185883,1,3,0
53019,4,2,185884,185884,185886,0,2,1
53020,5,3,185889,185889,185892,0,3,3
53021,6,1,185895,185895,185896,0,1,3
53022,5,2,185900,185900,185902,0,2,4
53023,3,2,185903,185903,185905,0,2,1
53024,6,1,185909,185909,185910,0,1,4
53025,3,3,185912,185912,185915,0,3,2
53026,5,1,185917,185917,185918,0,1,2
53027,3,2,185920,185920,185922,0,2,2
53028,3,1,185923,185923,185924,0,1,1
53029,4,3,185927,185927,185930,0,3,3
53030,3,2,185930,185930,185932,0,2,0
53031,6,2,185936,185936,185938,0,2,4
53032,3,2,185939,185939,185941,0,2,1
53033,1,2,185940,185941,185943,1,3,0
53034,1,1,185941,185943,185944,2,3,0
53035,5,1,185946,185946,185947,0,1,2
53036,6,1,185952,185952,185953,0,1,5
53037,1,2,185953,185953,185955,0,2,0
53038,3,3,185956,185956,185959,0,3,1
53039,1,1,185957,185959,185960,2,3,0
53040,1,3,185958,185960,185963,2,5,0
53041,3,3,185961,185963,185966,2,5,0
53042,6,2,185967,185967,185969,0,2,1
53043,6,2,185973,185973,185975,0,2,4
53044,5,2,185978,185978,185980,0,2,3
53045,4,2,185982,185982,185984,0,2,2
53046,5,1,185987,185987,185988,0,1,3
53047,2,3,185989,185989,185992,0,3,1
53048,5,1,185994,185994,185995,0,1,2
53049,3,2,185997,185997,185999,0,2,2
53050,3,3,186000,186000,186003,0,3,1
53051,2,1,186002,186003,186004,1,2,0
53052,4,1,186006,186006,186007,0,1,2
53053,6,2,186012,186012,186014,0,2,5
53054,3,2,186015,186015,186017,0,2,1
53055,6,2,186021,186021,186023,0,2,4
53056,3,3,186024,186024,186027,0,3,1
53057,5,2,186029,186029,186031,0,2,2
53058,2,2,186031,186031,186033,0,2,0
53059,1,3,186032,186033,186036,1,4,0
53060,6,3,186038,186038,186041,0,3,2
53061,6,2,186044,186044,186046,0,2,3
53062,6,2,186050,186050,186052,0,2,4
53063,5,3,186055,186055,186058,0,3,3
53064,6,2,186061,186061,186063,0,2,3
53065,5,2,186066,186066,186068,0,2,3
53066,3,3,186069,186069,186072,0,3,1
53067,6,1,186075,186075,186076,0,1,3
53068,6,3,186081,186081,186084,0,3,5
53069,4,3,186085,186085,186088,0,3,1
53070,6,3,186091,186091,186094,0,3,3
53071,3,3,186094,186094,186097,0,3,0
53072,4,3,186098,186098,186101,0,3,1
53073,1,3,186099,186101,186104,2,5,0
53074,6,3,186105,186105,186108,0,3,1
53075,5,2,186110,186110,186112,0,2,2
53076,6,2,186116,186116,186118,0,2,4
53077,3,1,186119,186119,186120,0,1,1
53078,5,3,186124,186124,186127,0,3,4
53079,4,1,186128,186128,186129,0,1,1
53080,5,3,186133,186133,186136,0,3,4
53081,5,1,186138,186138,186139,0,1,2
53082,5,2,186143,186143,186145,0,2,4
53083,1,1,186144,186145,186146,1,2,0
53084,2,2,186146,186146,186148,0,2,0
53085,2,3,186148,186148,186151,0,3,0
53086,2,3,186150,186151,186154,1,4,0
53087,6,2,186156,186156,186158,0,2,2
53088,6,3,186162,186162,186165,0,3,4
53089,5,1,186167,186167,186168,0,1,2
53090,4,1,186171,186171,186172,0,1,3
53091,4,2,186175,186175,186177,0,2,3
53092,1,1,186176,186177,186178,1,2,0
53093,6,2,186182,186182,186184,0,2,4
53094,2,1,186184,186184,186185,0,1,0
53095,6,2,186190,186190,186192,0,2,5
53096,4,2,186194,186194,186196,0,2,2
53097,5,1,186199,186199,186200,0,1,3
53098,4,1,186203,186203,186204,0,1,3
53099,3,2,186206,186206,186208,0,2,2
53100,5,1,186211,186211,186212,0,1,3
53101,5,1,186216,186216,186217,0,1,4
53102,3,2,186219,186219,186221,0,2,2
53103,2,2,186221,186221,186223,0,2,0
53104,6,1,186227,186227,186228,0,1,4
53105,3,2,186230,186230,186232,0,2,2
53106,4,3,186234,186234,186237,0,3,2
53107,3,2,186237,186237,186239,0,2,0
53108,6,2,186243,186243,186245,0,2,4
53109,3,1,186246,186246,186247,0,1,1
53110,5,3,186251,186251,186254,0,3,4
53111,3,2,186254,186254,186256,0,2,0
53112,5,1,186259,186259,186260,0,1,3
53113,1,3,186260,186260,186263,0,3,0
53114,3,3,186263,186263,186266,0,3,0
53115,5,3,186268,186268,186271,0,3,2
53116,5,3,186273,186273,186276,0,3,2
53117,4,2,186277,186277,186279,0,2,1
53118,4,3,186281,186281,186284,0,3,2
53119,3,1,186284,186284,186285,0,1,0
53120,2,3,186286,186286,186289,0,3,1
53121,1,2,186287,186289,186291,2,4,0
53122,6,1,186293,186293,186294,0,1,2
53123,1,3,186294,186294,186297,0,3,0
53124,3,2,186297,186297,186299,0,2,0
53125,6,2,186303,186303,186305,0,2,4
53126,5,1,186308,186308,186309,0,1,3
53127,6,3,186314,186314,186317,0,3,5
53128,5,1,186319,186319,186320,0,1,2
53129,6,1,186325,186325,186326,0,1,5
53130,3,3,186328,186328,186331,0,3,2
53131,3,1,186331,186331,186332,0,1,0
53132,6,2,186337,186337,186339,0,2,5
53133,1,3,186338,186339,186342,1,4,0
53134,1,3,186339,186342,186345,3,6,0
53135,1,2,186340,186345,186347,5,7,0
53136,6,1,186346,186347,186348,1,2,0
53137,6,2,186352,186352,186354,0,2,4
53138,1,3,186353,186354,186357,1,4,0
53139,3,3,186356,186357,186360,1,4,0
53140,4,3,186360,186360,186363,0,3,0
53141,5,2,186365,186365,186367,0,2,2
53142,2,2,186367,186367,186369,0,2,0
53143,2,3,186369,186369,186372,0,3,0
53144,1,2,186370,186372,186374,2,4,0
53145,2,2,186372,186374,186376,2,4,0
53146,6,1,186378,186378,186379,0,1,2
53147,3,2,186381,186381,186383,0,2,2
53148,5,2,186386,186386,186388,0,2,3
53149,1,3,186387,186388,186391,1,4,0
53150,4,3,186391,186391,186394,0,3,0
53151,5,2,186396,186396,186398,0,2,2
53152,4,3,186400,186400,186403,0,3,2
53153,1,1,186401,186403,186404,2,3,0
53154,2,1,186403,186404,186405,1,2,0
53155,4,1,186407,186407,186408,0,1,2
53156,1,1,186408,186408,186409,0,1,0
53157,6,2,186414,186414,186416,0,2,5
53158,4,2,186418,186418,186420,0,2,2
53159,2,2,186420,186420,186422,0,2,0
53160,4,1,186424,186424,186425,0,1,2
53161,2,1,186426,186426,186427,0,1,1
53162,6,3,186432,186432,186435,0,3,5
53163,3,3,186435,186435,186438,0,3,0
53164,4,1,186439,186439,186440,0,1,1
53165,2,3,186441,186441,186444,0,3,1
53166,2,1,186443,186444,186445,1,2,0
53167,3,3,186446,186446,186449,0,3,1
53168,2,3,186448,186449,186452,1,4,0
53169,5,3,186453,186453,186456,0,3,1
53170,5,1,186458,186458,186459,0,1,2
53171,2,1,186460,186460,186461,0,1,1
53172,4,3,186464,186464,186467,0,3,3
53173,6,1,186470,186470,186471,0,1,3
53174,3,2,186473,186473,186475,0,2,2
53175,2,1,186475,186475,186476,0,1,0
53176,1,3,186476,186476,186479,0,3,0
53177,5,3,186481,186481,186484,0,3,2
53178,2,3,186483,186484,186487,1,4,0
53179,3,3,186486,186487,186490,1,4,0
53180,4,1,186490,186490,186491,0,1,0
53181,4,2,186494,186494,186496,0,2,3
53182,3,3,186497,186497,186500,0,3,1
53183,3,1,186500,186500,186501,0,1,0
53184,4,3,186504,186504,186507,0,3,3
53185,6,3,186510,186510,186513,0,3,3
53186,5,2,186515,186515,186517,0,2,2
53187,1,2,186516,186517,186519,1,3,0
53188,2,3,186518,186519,186522,1,4,0
53189,4,1,186522,186522,186523,0,1,0
53190,6,1,186528,186528,186529,0,1,5
53191,3,2,186531,186531,186533,0,2,2
53192,1,1,186532,186533,186534,1,2,0
53193,2,2,186534,186534,186536,0,2,0
53194,2,2,186536,186536,186538,0,2,0
53195,1,2,186537,186538,186540,1,3,0
53196,2,3,186539,186540,186543,1,4,0
53197,1,3,186540,186543,186546,3,6,0
53198,2,1,186542,186546,186547,4,5,0
53199,4,3,186546,186547,186550,1,4,0
53200,1,2,186547,186550,186552,3,5,0
53201,3,3,186550,186552,186555,2,5,0
53202,2,3,186552,186555,186558,3,6,0
53203,5,2,186557,186558,186560,1,3,0
53204,5,3,186562,186562,186565,0,3,2
53205,5,3,186567,186567,186570,0,3,2
53206,2,1,186569,186570,186571,1,2,0
53207,2,1,186571,186571,186572,0,1,0
53208,2,1,186573,186573,186574,0,1,1
53209,2,1,186575,186575,186576,0,1,1
53210,4,2,186579,186579,186581,0,2,3
53211,1,3,186580,186581,186584,1,4,0
53212,3,1,186583,186584,186585,1,2,0
53213,1,1,186584,186585,186586,1,2,0
53214,4,2,186588,186588,186590,0,2,2
53215,1,1,186589,186590,186591,1,2,0
53216,6,3,186595,186595,186598,0,3,4
53217,1,1,186596,186598,186599,2,3,0
53218,3,3,186599,186599,186602,0,3,0
53219,6,3,186605,186605,186608,0,3,3
53220,5,3,186610,186610,186613,0,3,2
53221,1,3,186611,186613,186616,2,5,0
53222,2,1,186613,186616,186617,3,4,0
53223,6,2,186619,186619,186621,0,2,2
53224,6,2,186625,186625,186627,0,2,4
53225,3,2,186628,186628,186630,0,2,1
53226,5,1,186633,186633,186634,0,1,3
53227,1,1,186634,186634,186635,0,1,0
53228,3,1,186637,186637,186638,0,1,2
53229,1,1,186638,186638,186639,0,1,0
53230,2,1,186640,186640,186641,0,1,1
53231,5,2,186645,186645,186647,0,2,4
53232,4,3,186649,186649,186652,0,3,2
53233,5,2,186654,186654,186656,0,2,2
53234,4,1,186658,186658,186659,0,1,2
53235,6,1,186664,186664,186665,0,1,5
53236,3,3,186667,186667,186670,0,3,2
53237,4,3,186671,186671,186674,0,3,1
53238,4,1,186675,186675,186676,0,1,1
53239,1,2,186676,186676,186678,0,2,0
53240,3,1,186679,186679,186680,0,1,1
53241,2,1,186681,186681,186682,0,1,1
53242,3,2,186684,186684,186686,0,2,2
53243,6,1,186690,186690,186691,0,1,4
53244,5,1,186695,186695,186696,0,1,4
53245,4,3,186699,186699,186702,0,3,3
53246,1,1,186700,186702,186703,2,3,0
53247,5,1,186705,186705,186706,0,1,2
53248,6,2,186711,186711,186713,0,2,5
53249,4,1,186715,186715,186716,0,1,2
53250,5,3,186720,186720,186723,0,3,4
53251,5,3,186725,186725,186728,0,3,2
53252,3,2,186728,186728,186730,0,2,0
53253,4,1,186732,186732,186733,0,1,2
53254,3,2,186735,186735,186737,0,2,2
53255,2,2,186737,186737,186739,0,2,0
53256,3,1,186740,186740,186741,0,1,1
53257,6,2,186746,186746,186748,0,2,5
53258,5,1,186751,186751,186752,0,1,3
53259,5,3,186756,186756,186759,0,3,4
53260,3,2,186759,186759,186761,0,2,0
53261,5,3,186764,186764,186767,0,3,3
53262,6,3,186770,186770,186773,0,3,3
53263,1,1,186771,186773,186774,2,3,0
53264,2,2,186773,186774,186776,1,3,0
53265,5,2,186778,186778,186780,0,2,2
53266,1,2,186779,186780,186782,1,3,0
53267,2,1,186781,186782,186783,1,2,0
53268,6,2,186787,186787,186789,0,2,4
53269,6,3,186793,186793,186796,0,3,4
53270,6,2,186799,186799,186801,0,2,3
53271,3,1,186802,186802,186803,0,1,1
53272,5,1,186807,186807,186808,0,1,4
53273,6,3,186813,186813,186816,0,3,5
53274,4,1,186817,186817,186818,0,1,1
53275,4,1,186821,186821,186822,0,1,3
53276,6,3,186827,186827,186830,0,3,5
53277,6,1,186833,186833,186834,0,1,3
53278,4,2,186837,186837,186839,0,2,3
53279,6,2,186843,186843,186845,0,2,4
53280,5,1,186848,186848,186849,0,1,3
53281,3,3,186851,186851,186854,0,3,2
53282,4,3,186855,186855,186858,0,3,1
53283,3,3,186858,186858,186861,0,3,0
53284,6,1,186864,186864,186865,0,1,3
53285,3,3,186867,186867,186870,0,3,2
53286,6,3,186873,186873,186876,0,3,3
53287,4,1,186877,186877,186878,0,1,1
53288,5,3,186882,186882,186885,0,3,4
53289,5,3,186887,186887,186890,0,3,2
53290,5,1,186892,186892,186893,0,1,2
53291,2,1,186894,186894,186895,0,1,1
53292,1,1,186895,186895,186896,0,1,0
53293,3,3,186898,186898,186901,0,3,2
53294,1,3,186899,186901,186904,2,5,0
53295,4,2,186903,186904,186906,1,3,0
53296,3,3,186906,186906,186909,0,3,0
53297,4,2,186910,186910,186912,0,2,1
53298,3,3,186913,186913,186916,0,3,1
53299,4,3,186917,186917,186920,0,3,1
53300,5,2,186922,186922,186924,0,2,2
53301,4,2,186926,186926,186928,0,2,2
53302,6,1,186932,186932,186933,0,1,4
53303,1,2,186933,186933,186935,0,2,0
53304,1,3,186934,186935,186938,1,4,0
53305,2,1,186936,186938,186939,2,3,0
53306,1,3,186937,186939,186942,2,5,0
53307,3,3,186940,186942,186945,2,5,0
53308,2,1,186942,186945,186946,3,4,0
53309,6,1,186948,186948,186949,0,1,2
53310,2,1,186950,186950,186951,0,1,1
53311,2,1,186952,186952,186953,0,1,1
53312,5,2,186957,186957,186959,0,2,4
53313,6,1,186963,186963,186964,0,1,4
53314,6,3,186969,186969,186972,0,3,5
53315,5,1,186974,186974,186975,0,1,2
53316,4,3,186978,186978,186981,0,3,3
53317,3,3,186981,186981,186984,0,3,0
53318,3,2,186984,186984,186986,0,2,0
53319,1,2,186985,186986,186988,1,3,0
53320,1,1,186986,186988,186989,2,3,0
53321,3,3,186989,186989,186992,0,3,0
53322,4,1,186993,186993,186994,0,1,1
53323,2,3,186995,186995,186998,0,3,1
53324,5,1,187000,187000,187001,0,1,2
53325,2,1,187002,187002,187003,0,1,1
53326,3,3,187005,187005,187008,0,3,2
53327,1,1,187006,187008,187009,2,3,0
53328,3,2,187009,187009,187011,0,2,0
53329,1,3,187010,187011,187014,1,4,0
53330,2,1,187012,187014,187015,2,3,0
53331,4,1,187016,187016,187017,0,1,1
53332,3,2,187019,187019,187021,0,2,2
53333,3,2,187022,187022,187024,0,2,1
53334,6,1,187028,187028,187029,0,1,4
53335,5,3,187033,187033,187036,0,3,4
53336,3,3,187036,187036,187039,0,3,0
53337,1,3,187037,187039,187042,2,5,0
53338,5,3,187042,187042,187045,0,3,0
53339,2,3,187044,187045,187048,1,4,0
53340,3,3,187047,187048,187051,1,4,0
53341,4,2,187051,187051,187053,0,2,0
53342,3,3,187054,187054,187057,0,3,1
53343,4,3,187058,187058,187061,0,3,1
53344,6,1,187064,187064,187065,0,1,3
53345,2,2,187066,187066,187068,0,2,1
53346,2,2,187068,187068,187070,0,2,0
53347,4,2,187072,187072,187074,0,2,2
53348,2,2,187074,187074,187076,0,2,0
53349,4,2,187078,187078,187080,0,2,2
53350,2,2,187080,187080,187082,0,2,0
53351,5,3,187085,187085,187088,0,3,3
53352,1,1,187086,187088,187089,2,3,0
53353,1,3,187087,187089,187092,2,5,0
53354,6,3,187093,187093,187096,0,3,1
53355,6,1,187099,187099,187100,0,1,3
53356,3,1,187102,187102,187103,0,1,2
53357,4,1,187106,187106,187107,0,1,3
53358,4,2,187110,187110,187112,0,2,3
53359,4,1,187114,187114,187115,0,1,2
53360,3,1,187117,187117,187118,0,1,2
53361,5,1,187122,187122,187123,0,1,4
53362,1,3,187123,187123,187126,0,3,0
53363,1,1,187124,187126,187127,2,3,0
53364,2,3,187126,187127,187130,1,4,0
53365,3,1,187129,187130,187131,1,2,0
53366,2,2,187131,187131,187133,0,2,0
53367,4,2,187135,187135,187137,0,2,2
53368,1,1,187136,187137,187138,1,2,0
53369,2,3,187138,187138,187141,0,3,0
53370,6,1,187144,187144,187145,0,1,3
53371,5,2,187149,187149,187151,0,2,4
53372,2,2,187151,187151,187153,0,2,0
53373,6,3,187157,187157,187160,0,3,4
53374,4,2,187161,187161,187163,0,2,1
53375,5,2,187166,187166,187168,0,2,3
53376,3,2,187169,187169,187171,0,2,1
53377,1,1,187170,187171,187172,1,2,0
53378,2,1,187172,187172,187173,0,1,0
53379,2,1,187174,187174,187175,0,1,1
53380,1,3,187175,187175,187178,0,3,0
53381,5,2,187180,187180,187182,0,2,2
53382,2,3,187182,187182,187185,0,3,0
53383,4,3,187186,187186,187189,0,3,1
53384,2,3,187188,187189,187192,1,4,0
53385,6,2,187194,187194,187196,0,2,2
53386,3,1,187197,187197,187198,0,1,1
53387,5,3,187202,187202,187205,0,3,4
53388,2,1,187204,187205,187206,1,2,0
53389,1,2,187205,187206,187208,1,3,0
53390,3,2,187208,187208,187210,0,2,0
53391,5,2,187213,187213,187215,0,2,3
53392,2,2,187215,187215,187217,0,2,0
53393,4,3,187219,187219,187222,0,3,2
53394,6,2,187225,187225,187227,0,2,3
53395,6,2,187231,187231,187233,0,2,4
53396,6,1,187237,187237,187238,0,1,4
53397,5,1,187242,187242,187243,0,1,4
53398,5,3,187247,187247,187250,0,3,4
53399,2,3,187249,187250,187253,1,4,0
53400,1,1,187250,187253,187254,3,4,0
53401,6,3,187256,187256,187259,0,3,2
53402,5,2,187261,187261,187263,0,2,2
53403,1,2,187262,187263,187265,1,3,0
53404,5,2,187267,187267,187269,0,2,2
53405,5,1,187272,187272,187273,0,1,3
53406,2,1,187274,187274,187275,0,1,1
53407,2,3,187276,187276,187279,0,3,1
53408,1,2,187277,187279,187281,2,4,0
53409,4,1,187281,187281,187282,0,1,0
53410,3,1,187284,187284,187285,0,1,2
53411,6,1,187290,187290,187291,0,1,5
53412,5,3,187295,187295,187298,0,3,4
53413,4,1,187299,187299,187300,0,1,1
53414,5,1,187304,187304,187305,0,1,4
53415,3,1,187307,187307,187308,0,1,2
53416,3,3,187310,187310,187313,0,3,2
53417,1,1,187311,187313,187314,2,3,0
53418,1,1,187312,187314,187315,2,3,0
53419,3,3,187315,187315,187318,0,3,0
53420,1,1,187316,187318,187319,2,3,0
53421,5,3,187321,187321,187324,0,3,2
53422,3,1,187324,187324,187325,0,1,0
53423,3,1,187327,187327,187328,0,1,2
53424,4,1,187331,187331,187332,0,1,3
53425,4,1,187335,187335,187336,0,1,3
53426,5,1,187340,187340,187341,0,1,4
53427,5,3,187345,187345,187348,0,3,4
53428,6,2,187351,187351,187353,0,2,3
53429,4,3,187355,187355,187358,0,3,2
53430,2,3,187357,187358,187361,1,4,0
53431,6,3,187363,187363,187366,0,3,2
53432,3,3,187366,187366,187369,0,3,0
53433,5,3,187371,187371,187374,0,3,2
53434,3,2,187374,187374,187376,0,2,0
53435,2,2,187376,187376,187378,0,2,0
53436,2,1,187378,187378,187379,0,1,0
53437,5,2,187383,187383,187385,0,2,4
53438,2,2,187385,187385,187387,0,2,0
53439,2,2,187387,187387,187389,0,2,0
53440,3,3,187390,187390,187393,0,3,1
53441,3,2,187393,187393,187395,0,2,0
53442,1,2,187394,187395,187397,1,3,0
53443,4,3,187398,187398,187401,0,3,1
53444,6,3,187404,187404,187407,0,3,3
53445,4,2,187408,187408,187410,0,2,1
53446,2,3,187410,187410,187413,0,3,0
53447,2,1,187412,187413,187414,1,2,0
53448,2,3,187414,187414,187417,0,3,0
53449,1,3,187415,187417,187420,2,5,0
53450,6,3,187421,187421,187424,0,3,1
53451,4,2,187425,187425,187427,0,2,1
53452,5,1,187430,187430,187431,0,1,3
53453,3,3,187433,187433,187436,0,3,2
53454,3,1,187436,187436,187437,0,1,0
53455,6,2,187442,187442,187444,0,2,5
53456,1,1,187443,187444,187445,1,2,0
53457,1,3,187444,187445,187448,1,4,0
53458,3,3,187447,187448,187451,1,4,0
53459,6,1,187453,187453,187454,0,1,2
53460,1,2,187454,187454,187456,0,2,0
53461,4,2,187458,187458,187460,0,2,2
53462,5,1,187463,187463,187464,0,1,3
53463,2,3,187465,187465,187468,0,3,1
53464,3,1,187468,187468,187469,0,1,0
53465,4,2,187472,187472,187474,0,2,3
53466,5,1,187477,187477,187478,0,1,3
53467,5,2,187482,187482,187484,0,2,4
53468,4,2,187486,187486,187488,0,2,2
53469,4,1,187490,187490,187491,0,1,2
53470,6,2,187496,187496,187498,0,2,5
53471,6,1,187502,187502,187503,0,1,4
53472,3,3,187505,187505,187508,0,3,2
53473,2,2,187507,187508,187510,1,3,0
53474,3,1,187510,187510,187511,0,1,0
53475,3,3,187513,187513,187516,0,3,2
53476,3,2,187516,187516,187518,0,2,0
53477,4,3,187520,187520,187523,0,3,2
53478,3,2,187523,187523,187525,0,2,0
53479,5,1,187528,187528,187529,0,1,3
53480,1,1,187529,187529,187530,0,1,0
53481,3,1,187532,187532,187533,0,1,2
53482,1,2,187533,187533,187535,0,2,0
53483,2,1,187535,187535,187536,0,1,0
53484,3,3,187538,187538,187541,0,3,2
53485,6,2,187544,187544,187546,0,2,3
53486,4,2,187548,187548,187550,0,2,2
53487,5,3,187553,187553,187556,0,3,3
53488,2,2,187555,187556,187558,1,3,0
53489,2,1,187557,187558,187559,1,2,0
53490,4,1,187561,187561,187562,0,1,2
53491,5,3,187566,187566,187569,0,3,4
53492,1,1,187567,187569,187570,2,3,0
53493,2,1,187569,187570,187571,1,2,0
53494,1,3,187570,187571,187574,1,4,0
53495,5,3,187575,187575,187578,0,3,1
53496,5,1,187580,187580,187581,0,1,2
53497,3,2,187583,187583,187585,0,2,2
53498,2,1,187585,187585,187586,0,1,0
53499,5,2,187590,187590,187592,0,2,4
53500,3,3,187593,187593,187596,0,3,1
53501,6,1,187599,187599,187600,0,1,3
53502,6,1,187605,187605,187606,0,1,5
53503,2,3,187607,187607,187610,0,3,1
53504,1,3,187608,187610,187613,2,5,0
53505,4,3,187612,187613,187616,1,4,0
53506,3,2,187615,187616,187618,1,3,0
53507,2,1,187617,187618,187619,1,2,0
53508,5,2,187622,187622,187624,0,2,3
53509,1,2,187623,187624,187626,1,3,0
53510,1,3,187624,187626,187629,2,5,0
53511,3,2,187627,187629,187631,2,4,0
53512,5,1,187632,187632,187633,0,1,1
53513,2,3,187634,187634,187637,0,3,1
53514,4,2,187638,187638,187640,0,2,1
53515,5,2,187643,187643,187645,0,2,3
53516,6,3,187649,187649,187652,0,3,4
53517,1,2,187650,187652,187654,2,4,0
53518,3,1,187653,187654,187655,1,2,0
53519,6,3,187659,187659,187662,0,3,4
53520,2,1,187661,187662,187663,1,2,0
53521,6,3,187667,187667,187670,0,3,4
53522,1,1,187668,187670,187671,2,3,0
53523,3,3,187671,187671,187674,0,3,0
53524,4,1,187675,187675,187676,0,1,1
53525,3,3,187678,187678,187681,0,3,2
53526,2,2,187680,187681,187683,1,3,0
53527,4,2,187684,187684,187686,0,2,1
53528,1,3,187685,187686,187689,1,4,0
53529,5,1,187690,187690,187691,0,1,1
53530,2,2,187692,187692,187694,0,2,1
53531,5,2,187697,187697,187699,0,2,3
53532,5,2,187702,187702,187704,0,2,3
53533,6,2,187708,187708,187710,0,2,4
53534,3,3,187711,187711,187714,0,3,1
53535,6,1,187717,187717,187718,0,1,3
53536,2,1,187719,187719,187720,0,1,1
53537,3,2,187722,187722,187724,0,2,2
53538,5,2,187727,187727,187729,0,2,3
53539,6,1,187733,187733,187734,0,1,4
53540,6,2,187739,187739,187741,0,2,5
53541,6,3,187745,187745,187748,0,3,4
53542,3,3,187748,187748,187751,0,3,0
53543,4,2,187752,187752,187754,0,2,1
53544,3,2,187755,187755,187757,0,2,1
53545,1,3,187756,187757,187760,1,4,0
53546,3,3,187759,187760,187763,1,4,0
53547,2,2,187761,187763,187765,2,4,0
53548,3,3,187764,187765,187768,1,4,0
53549,4,3,187768,187768,187771,0,3,0
53550,4,1,187772,187772,187773,0,1,1
53551,1,2,187773,187773,187775,0,2,0
53552,2,2,187775,187775,187777,0,2,0
53553,6,2,187781,187781,187783,0,2,4
53554,4,3,187785,187785,187788,0,3,2
53555,1,1,187786,187788,187789,2,3,0
53556,2,3,187788,187789,187792,1,4,0
53557,5,2,187793,187793,187795,0,2,1
53558,2,2,187795,187795,187797,0,2,0
53559,4,1,187799,187799,187800,0,1,2
53560,4,3,187803,187803,187806,0,3,3
53561,5,1,187808,187808,187809,0,1,2
53562,2,2,187810,187810,187812,0,2,1
53563,4,1,187814,187814,187815,0,1,2
53564,2,2,187816,187816,187818,0,2,1
53565,2,1,187818,187818,187819,0,1,0
53566,4,2,187822,187822,187824,0,2,3
53567,3,2,187825,187825,187827,0,2,1
53568,6,1,187831,187831,187832,0,1,4
53569,1,1,187832,187832,187833,0,1,0
53570,2,3,187834,187834,187837,0,3,1
53571,2,2,187836,187837,187839,1,3,0
53572,4,1,187840,187840,187841,0,1,1
53573,6,3,187846,187846,187849,0,3,5
53574,5,3,187851,187851,187854,0,3,2
53575,2,3,187853,187854,187857,1,4,0
53576,5,2,187858,187858,187860,0,2,1
53577,6,3,187864,187864,187867,0,3,4
53578,6,1,187870,187870,187871,0,1,3
53579,6,2,187876,187876,187878,0,2,5
53580,3,1,187879,187879,187880,0,1,1
53581,3,3,187882,187882,187885,0,3,2
53582,3,1,187885,187885,187886,0,1,0
53583,5,3,187890,187890,187893,0,3,4
53584,2,2,187892,187893,187895,1,3,0
53585,6,2,187898,187898,187900,0,2,3
53586,6,1,187904,187904,187905,0,1,4
53587,1,1,187905,187905,187906,0,1,0
53588,2,1,187907,187907,187908,0,1,1
53589,6,3,187913,187913,187916,0,3,5
53590,5,1,187918,187918,187919,0,1,2
53591,3,2,187921,187921,187923,0,2,2
53592,6,1,187927,187927,187928,0,1,4
53593,6,3,187933,187933,187936,0,3,5
53594,5,3,187938,187938,187941,0,3,2
53595,4,3,187942,187942,187945,0,3,1
53596,4,2,187946,187946,187948,0,2,1
53597,6,3,187952,187952,187955,0,3,4
53598,4,3,187956,187956,187959,0,3,1
53599,4,2,187960,187960,187962,0,2,1
53600,3,1,187963,187963,187964,0,1,1
53601,3,1,187966,187966,187967,0,1,2
53602,2,1,187968,187968,187969,0,1,1
53603,2,2,187970,187970,187972,0,2,1
53604,5,2,187975,187975,187977,0,2,3
53605,6,1,187981,187981,187982,0,1,4
53606,1,2,187982,187982,187984,0,2,0
53607,6,1,187988,187988,187989,0,1,4
53608,4,2,187992,187992,187994,0,2,3
53609,5,3,187997,187997,188000,0,3,3
53610,2,3,187999,188000,188003,1,4,0
53611,2,3,188001,188003,188006,2,5,0
53612,1,2,188002,188006,188008,4,6,0
53613,4,2,188006,188008,188010,2,4,0
53614,5,1,188011,188011,188012,0,1,1
53615,1,3,188012,188012,188015,0,3,0
53616,5,1,188017,188017,188018,0,1,2
53617,1,3,188018,188018,188021,0,3,0
53618,2,2,188020,188021,188023,1,3,0
53619,2,1,188022,188023,188024,1,2,0
53620,5,2,188027,188027,188029,0,2,3
53621,1,2,188028,188029,188031,1,3,0
53622,2,3,188030,188031,188034,1,4,0
53623,6,3,188036,188036,188039,0,3,2
53624,6,3,188042,188042,188045,0,3,3
53625,1,3,188043,188045,188048,2,5,0
53626,4,1,188047,188048,188049,1,2,0
53627,6,1,188053,188053,188054,0,1,4
53628,1,2,188054,188054,188056,0,2,0
53629,1,1,188055,188056,188057,1,2,0
53630,5,3,188060,188060,188063,0,3,3
53631,5,2,188065,188065,188067,0,2,2
53632,5,3,188070,188070,188073,0,3,3
53633,1,1,188071,188073,188074,2,3,0
53634,3,2,188074,188074,188076,0,2,0
53635,1,2,188075,188076,188078,1,3,0
53636,1,1,188076,188078,188079,2,3,0
53637,5,3,188081,188081,188084,0,3,2
53638,2,2,188083,188084,188086,1,3,0
53639,3,2,188086,188086,188088,0,2,0
53640,3,1,188089,188089,188090,0,1,1
53641,5,3,188094,188094,188097,0,3,4
53642,6,1,188100,188100,188101,0,1,3
53643,6,3,188106,188106,188109,0,3,5
53644,4,2,188110,188110,188112,0,2,1
53645,6,3,188116,188116,188119,0,3,4
53646,6,1,188122,188122,188123,0,1,3
53647,2,1,188124,188124,188125,0,1,1
53648,4,3,188128,188128,188131,0,3,3
53649,6,3,188134,188134,188137,0,3,3
53650,1,2,188135,188137,188139,2,4,0
53651,3,1,188138,188139,188140,1,2,0
53652,3,1,188141,188141,188142,0,1,1
53653,5,2,188146,188146,188148,0,2,4
53654,2,2,188148,188148,188150,0,2,0
53655,2,1,188150,188150,188151,0,1,0
53656,1,2,188151,188151,188153,0,2,0
53657,4,1,188155,188155,188156,0,1,2
53658,2,1,188157,188157,188158,0,1,1
53659,3,1,188160,188160,188161,0,1,2
53660,1,3,188161,188161,188164,0,3,0
53661,1,3,188162,188164,188167,2,5,0
53662,3,3,188165,188167,188170,2,5,0
53663,1,3,188166,188170,188173,4,7,0
53664,6,1,188172,188173,188174,1,2,0
53665,6,1,188178,188178,188179,0,1,4
53666,4,2,188182,188182,188184,0,2,3
53667,2,2,188184,188184,188186,0,2,0
53668,1,2,188185,188186,188188,1,3,0
53669,6,1,188191,188191,188192,0,1,3
53670,5,3,188196,188196,188199,0,3,4
53671,6,3,188202,188202,188205,0,3,3
53672,2,1,188204,188205,188206,1,2,0
53673,3,3,188207,188207,188210,0,3,1
53674,5,3,188212,188212,188215,0,3,2
53675,4,3,188216,188216,188219,0,3,1
53676,4,1,188220,188220,188221,0,1,1
53677,2,3,188222,188222,188225,0,3,1
53678,1,1,188223,188225,188226,2,3,0
53679,2,1,188225,188226,188227,1,2,0
53680,6,1,188231,188231,188232,0,1,4
53681,3,3,188234,188234,188237,0,3,2
53682,6,1,188240,188240,188241,0,1,3
53683,5,2,188245,188245,188247,0,2,4
53684,2,1,188247,188247,188248,0,1,0
53685,6,2,188253,188253,188255,0,2,5
53686,4,3,188257,188257,188260,0,3,2
53687,2,3,188259,188260,188263,1,4,0
53688,6,3,188265,188265,188268,0,3,2
53689,6,2,188271,188271,188273,0,2,3
53690,1,1,188272,188273,188274,1,2,0
53691,1,2,188273,188274,188276,1,3,0
53692,5,2,188278,188278,188280,0,2,2
53693,4,1,188282,188282,188283,0,1,2
53694,4,1,188286,188286,188287,0,1,3
53695,3,2,188289,188289,188291,0,2,2
53696,2,1,188291,188291,188292,0,1,0
53697,4,2,188295,188295,188297,0,2,3
53698,5,3,188300,188300,188303,0,3,3
53699,6,1,188306,188306,188307,0,1,3
53700,1,1,188307,188307,188308,0,1,0
53701,3,1,188310,188310,188311,0,1,2
53702,6,3,188316,188316,188319,0,3,5
53703,1,3,188317,188319,188322,2,5,0
53704,1,3,188318,188322,188325,4,7,0
53705,6,2,188324,188325,188327,1,3,0
53706,3,1,188327,188327,188328,0,1,0
53707,2,1,188329,188329,188330,0,1,1
53708,6,3,188335,188335,188338,0,3,5
53709,5,1,188340,188340,188341,0,1,2
53710,2,2,188342,188342,188344,0,2,1
53711,4,1,188346,188346,188347,0,1,2
53712,4,2,188350,188350,188352,0,2,3
53713,3,3,188353,188353,188356,0,3,1
53714,6,3,188359,188359,188362,0,3,3
53715,5,3,188364,188364,188367,0,3,2
53716,5,1,188369,188369,188370,0,1,2
53717,4,1,188373,188373,188374,0,1,3
53718,4,3,188377,188377,188380,0,3,3
53719,5,1,188382,188382,188383,0,1,2
53720,2,2,188384,188384,188386,0,2,1
53721,1,1,188385,188386,188387,1,2,0
53722,5,1,188390,188390,188391,0,1,3
53723,3,3,188393,188393,188396,0,3,2
53724,6,2,188399,188399,188401,0,2,3
53725,2,3,188401,188401,188404,0,3,0
53726,2,1,188403,188404,188405,1,2,0
53727,5,1,188408,188408,188409,0,1,3
53728,4,1,188412,188412,188413,0,1,3
53729,1,1,188413,188413,188414,0,1,0
53730,2,3,188415,188415,188418,0,3,1
53731,3,3,188418,188418,188421,0,3,0
53732,1,1,188419,188421,188422,2,3,0
53733,6,3,188425,188425,188428,0,3,3
53734,3,3,188428,188428,188431,0,3,0
53735,4,3,188432,188432,188435,0,3,1
53736,2,3,188434,188435,188438,1,4,0
53737,3,2,188437,188438,188440,1,3,0
53738,4,3,188441,188441,188444,0,3,1
53739,1,1,188442,188444,188445,2,3,0
53740,1,1,188443,188445,188446,2,3,0
53741,3,3,188446,188446,188449,0,3,0
53742,1,2,188447,188449,188451,2,4,0
53743,6,1,188453,188453,188454,0,1,2
53744,4,3,188457,188457,188460,0,3,3
53745,2,3,188459,188460,188463,1,4,0
53746,1,3,188460,188463,188466,3,6,0
53747,5,2,188465,188466,188468,1,3,0
53748,5,3,188470,188470,188473,0,3,2
53749,2,2,188472,188473,188475,1,3,0
53750,3,3,188475,188475,188478,0,3,0
53751,1,2,188476,188478,188480,2,4,0
53752,3,1,188479,188480,188481,1,2,0
53753,2,2,188481,188481,188483,0,2,0
53754,1,2,188482,188483,188485,1,3,0
53755,2,3,188484,188485,188488,1,4,0
53756,3,1,188487,188488,188489,1,2,0
53757,2,1,188489,188489,188490,0,1,0
53758,5,1,188494,188494,188495,0,1,4
53759,1,2,188495,188495,188497,0,2,0
53760,1,2,188496,188497,188499,1,3,0
53761,1,2,188497,188499,188501,2,4,0
53762,3,3,188500,188501,188504,1,4,0
53763,5,2,188505,188505,188507,0,2,1
53764,4,3,188509,188509,188512,0,3,2
53765,6,1,188515,188515,188516,0,1,3
53766,3,2,188518,188518,188520,0,2,2
53767,6,2,188524,188524,188526,0,2,4
53768,1,3,188525,188526,188529,1,4,0
53769,5,2,188530,188530,188532,0,2,1
53770,4,3,188534,188534,188537,0,3,2
53771,6,2,188540,188540,188542,0,2,3
53772,3,2,188543,188543,188545,0,2,1
53773,1,2,188544,188545,188547,1,3,0
53774,6,3,188550,188550,188553,0,3,3
53775,3,2,188553,188553,188555,0,2,0
53776,5,1,188558,188558,188559,0,1,3
53777,2,2,188560,188560,188562,0,2,1
53778,4,3,188564,188564,188567,0,3,2
53779,5,1,188569,188569,188570,0,1,2
53780,5,2,188574,188574,188576,0,2,4
53781,2,3,188576,188576,188579,0,3,0
53782,2,1,188578,188579,188580,1,2,0
53783,1,3,188579,188580,188583,1,4,0
53784,5,2,188584,188584,188586,0,2,1
53785,1,2,188585,188586,188588,1,3,0
53786,1,2,188586,188588,188590,2,4,0
53787,5,2,188591,188591,188593,0,2,1
53788,6,1,188597,188597,188598,0,1,4
53789,3,1,188600,188600,188601,0,1,2
53790,4,3,188604,188604,188607,0,3,3
53791,3,3,188607,188607,188610,0,3,0
53792,1,1,188608,188610,188611,2,3,0
53793,6,2,188614,188614,188616,0,2,3
53794,1,1,188615,188616,188617,1,2,0
53795,3,2,188618,188618,188620,0,2,1
53796,4,2,188622,188622,188624,0,2,2
53797,1,1,188623,188624,188625,1,2,0
53798,5,1,188628,188628,188629,0,1,3
53799,2,3,188630,188630,188633,0,3,1
53800,1,3,188631,188633,188636,2,5,0
53801,6,1,188637,188637,188638,0,1,1
53802,4,2,188641,188641,188643,0,2,3
53803,1,3,188642,188643,188646,1,4,0
53804,3,1,188645,188646,188647,1,2,0
53805,4,2,188649,188649,188651,0,2,2
53806,2,2,188651,188651,188653,0,2,0
53807,2,2,188653,188653,188655,0,2,0
53808,4,3,188657,188657,188660,0,3,2
53809,2,3,188659,188660,188663,1,4,0
53810,2,3,188661,188663,188666,2,5,0
53811,4,2,188665,188666,188668,1,3,0
53812,4,3,188669,188669,188672,0,3,1
53813,2,2,188671,188672,188674,1,3,0
53814,4,1,188675,188675,188676,0,1,1
53815,6,2,188681,188681,188683,0,2,5
53816,4,2,188685,188685,188687,0,2,2
53817,2,3,188687,188687,188690,0,3,0
53818,3,2,188690,188690,188692,0,2,0
53819,1,1,188691,188692,188693,1,2,0
53820,6,1,188697,188697,188698,0,1,4
53821,5,2,188702,188702,188704,0,2,4
53822,3,2,188705,188705,188707,0,2,1
53823,4,2,188709,188709,188711,0,2,2
53824,5,1,188714,188714,188715,0,1,3
53825,5,3,188719,188719,188722,0,3,4
53826,6,3,188725,188725,188728,0,3,3
53827,3,1,188728,188728,188729,0,1,0
53828,3,1,188731,188731,188732,0,1,2
53829,2,2,188733,188733,188735,0,2,1
53830,3,3,188736,188736,188739,0,3,1
53831,6,3,188742,188742,188745,0,3,3
53832,4,3,188746,188746,188749,0,3,1
53833,5,1,188751,188751,188752,0,1,2
53834,6,2,188757,188757,188759,0,2,5
53835,5,1,188762,188762,188763,0,1,3
53836,6,2,188768,188768,188770,0,2,5
53837,5,1,188773,188773,188774,0,1,3
53838,3,2,188776,188776,188778,0,2,2
53839,2,1,188778,188778,188779,0,1,0
53840,3,1,188781,188781,188782,0,1,2
53841,6,2,188787,188787,188789,0,2,5
53842,3,3,188790,188790,188793,0,3,1
53843,4,2,188794,188794,188796,0,2,1
53844,3,1,188797,188797,188798,0,1,1
53845,1,3,188798,188798,188801,0,3,0
53846,1,1,188799,188801,188802,2,3,0
53847,5,1,188804,188804,188805,0,1,2
53848,1,1,188805,188805,188806,0,1,0
53849,2,1,188807,188807,188808,0,1,1
53850,4,1,188811,188811,188812,0,1,3
53851,2,2,188813,188813,188815,0,2,1
53852,2,1,188815,188815,188816,0,1,0
53853,6,2,188821,188821,188823,0,2,5
53854,4,1,188825,188825,188826,0,1,2
53855,6,1,188831,188831,188832,0,1,5
53856,2,1,188833,188833,188834,0,1,1
53857,2,1,188835,188835,188836,0,1,1
53858,4,2,188839,188839,188841,0,2,3
53859,2,2,188841,188841,188843,0,2,0
53860,5,2,188846,188846,188848,0,2,3
53861,2,1,188848,188848,188849,0,1,0
53862,1,1,188849,188849,188850,0,1,0
53863,1,2,188850,188850,188852,0,2,0
53864,1,3,188851,188852,188855,1,4,0
53865,2,1,188853,188855,188856,2,3,0
53866,3,1,188856,188856,188857,0,1,0
53867,3,2,188859,188859,188861,0,2,2
53868,1,2,188860,188861,188863,1,3,0
53869,4,2,188864,188864,188866,0,2,1
53870,2,1,188866,188866,188867,0,1,0
53871,1,2,188867,188867,188869,0,2,0
53872,5,2,188872,188872,188874,0,2,3
53873,3,2,188875,188875,188877,0,2,1
53874,2,1,188877,188877,188878,0,1,0
53875,6,3,188883,188883,188886,0,3,5
53876,5,3,188888,188888,188891,0,3,2
53877,1,1,188889,188891,188892,2,3,0
53878,2,1,188891,188892,188893,1,2,0
53879,6,2,188897,188897,188899,0,2,4
53880,3,1,188900,188900,188901,0,1,1
53881,1,3,188901,188901,188904,0,3,0
53882,4,3,188905,188905,188908,0,3,1
53883,2,1,188907,188908,188909,1,2,0
53884,6,1,188913,188913,188914,0,1,4
53885,6,2,188919,188919,188921,0,2,5
53886,2,1,188921,188921,188922,0,1,0
53887,3,2,188924,188924,188926,0,2,2
53888,3,1,188927,188927,188928,0,1,1
53889,5,3,188932,188932,188935,0,3,4
53890,5,3,188937,188937,188940,0,3,2
53891,1,1,188938,188940,188941,2,3,0
53892,1,2,188939,188941,188943,2,4,0
53893,2,3,188941,188943,188946,2,5,0
53894,5,1,188946,188946,188947,0,1,0
53895,4,2,188950,188950,188952,0,2,3
53896,4,2,188954,188954,188956,0,2,2
53897,4,2,188958,188958,188960,0,2,2
53898,4,1,188962,188962,188963,0,1,2
53899,5,2,188967,188967,188969,0,2,4
53900,6,1,188973,188973,188974,0,1,4
53901,4,1,188977,188977,188978,0,1,3
53902,4,3,188981,188981,188984,0,3,3
53903,2,1,188983,188984,188985,1,2,0
53904,2,1,188985,188985,188986,0,1,0
53905,5,3,188990,188990,188993,0,3,4
53906,1,2,188991,188993,188995,2,4,0
53907,3,2,188994,188995,188997,1,3,0
53908,2,1,188996,188997,188998,1,2,0
53909,6,2,189002,189002,189004,0,2,4
53910,2,1,189004,189004,189005,0,1,0
53911,3,1,189007,189007,189008,0,1,2
53912,4,1,189011,189011,189012,0,1,3
53913,5,3,189016,189016,189019,0,3,4
53914,4,3,189020,189020,189023,0,3,1
53915,3,1,189023,189023,189024,0,1,0
53916,1,2,189024,189024,189026,0,2,0
53917,3,1,189027,189027,189028,0,1,1
53918,5,1,189032,189032,189033,0,1,4
53919,5,3,189037,189037,189040,0,3,4
53920,2,1,189039,189040,189041,1,2,0
53921,4,3,189043,189043,189046,0,3,2
53922,5,3,189048,189048,189051,0,3,2
53923,5,3,189053,189053,189056,0,3,2
53924,3,1,189056,189056,189057,0,1,0
53925,5,3,189061,189061,189064,0,3,4
53926,3,1,189064,189064,189065,0,1,0
53927,5,2,189069,189069,189071,0,2,4
53928,4,2,189073,189073,189075,0,2,2
53929,5,2,189078,189078,189080,0,2,3
53930,1,3,189079,189080,189083,1,4,0
53931,4,3,189083,189083,189086,0,3,0
53932,3,1,189086,189086,189087,0,1,0
53933,1,3,189087,189087,189090,0,3,0
53934,1,1,189088,189090,189091,2,3,0
53935,2,2,189090,189091,189093,1,3,0
53936,1,3,189091,189093,189096,2,5,0
53937,4,3,189095,189096,189099,1,4,0
53938,6,2,189101,189101,189103,0,2,2
53939,2,2,189103,189103,189105,0,2,0
53940,1,1,189104,189105,189106,1,2,0
53941,4,2,189108,189108,189110,0,2,2
53942,6,1,189114,189114,189115,0,1,4
53943,5,1,189119,189119,189120,0,1,4
53944,3,1,189122,189122,189123,0,1,2
53945,5,1,189127,189127,189128,0,1,4
53946,4,3,189131,189131,189134,0,3,3
53947,1,1,189132,189134,189135,2,3,0
53948,2,2,189134,189135,189137,1,3,0
53949,3,2,189137,189137,189139,0,2,0
53950,4,1,189141,189141,189142,0,1,2
53951,4,2,189145,189145,189147,0,2,3
53952,4,2,189149,189149,189151,0,2,2
53953,1,1,189150,189151,189152,1,2,0
53954,6,2,189156,189156,189158,0,2,4
53955,3,1,189159,189159,189160,0,1,1
53956,5,3,189164,189164,189167,0,3,4
53957,1,2,189165,189167,189169,2,4,0
53958,3,2,189168,189169,189171,1,3,0
53959,4,3,189172,189172,189175,0,3,1
53960,6,2,189178,189178,189180,0,2,3
53961,2,1,189180,189180,189181,0,1,0
53962,5,2,189185,189185,189187,0,2,4
53963,1,3,189186,189187,189190,1,4,0
53964,6,1,189192,189192,189193,0,1,2
53965,5,1,189197,189197,189198,0,1,4
53966,2,2,189199,189199,189201,0,2,1
53967,5,3,189204,189204,189207,0,3,3
53968,3,2,189207,189207,189209,0,2,0
53969,1,3,189208,189209,189212,1,4,0
53970,5,3,189213,189213,189216,0,3,1
53971,4,1,189217,189217,189218,0,1,1
53972,2,1,189219,189219,189220,0,1,1
53973,2,2,189221,189221,189223,0,2,1
53974,3,1,189224,189224,189225,0,1,1
53975,3,3,189227,189227,189230,0,3,2
53976,6,3,189233,189233,189236,0,3,3
53977,2,2,189235,189236,189238,1,3,0
53978,5,3,189240,189240,189243,0,3,2
53979,1,2,189241,189243,189245,2,4,0
53980,4,2,189245,189245,189247,0,2,0
53981,1,3,189246,189247,189250,1,4,0
53982,3,1,189249,189250,189251,1,2,0
53983,1,1,189250,189251,189252,1,2,0
53984,1,1,189251,189252,189253,1,2,0
53985,4,3,189255,189255,189258,0,3,2
53986,6,1,189261,189261,189262,0,1,3
53987,1,2,189262,189262,189264,0,2,0
53988,1,3,189263,189264,189267,1,4,0
53989,6,2,189269,189269,189271,0,2,2
53990,2,3,189271,189271,189274,0,3,0
53991,6,2,189277,189277,189279,0,2,3
53992,5,3,189282,189282,189285,0,3,3
53993,4,3,189286,189286,189289,0,3,1
53994,2,1,189288,189289,189290,1,2,0
53995,6,1,189294,189294,189295,0,1,4
53996,3,1,189297,189297,189298,0,1,2
53997,5,2,189302,189302,189304,0,2,4
53998,6,1,189308,189308,189309,0,1,4
53999,4,1,189312,189312,189313,0,1,3
54000,4,3,189316,189316,189319,0,3,3
54001,5,3,189321,189321,189324,0,3,2
54002,3,2,189324,189324,189326,0,2,0
54003,1,1,189325,189326,189327,1,2,0
54004,3,3,189328,189328,189331,0,3,1
54005,3,1,189331,189331,189332,0,1,0
54006,3,3,189334,189334,189337,0,3,2
54007,2,2,189336,189337,189339,1,3,0
54008,3,2,189339,189339,189341,0,2,0
54009,6,3,189345,189345,189348,0,3,4
54010,4,1,189349,189349,189350,0,1,1
54011,4,3,189353,189353,189356,0,3,3
54012,4,1,189357,189357,189358,0,1,1
54013,6,2,189363,189363,189365,0,2,5
54014,4,3,189367,189367,189370,0,3,2
54015,6,3,189373,189373,189376,0,3,3
54016,2,1,189375,189376,189377,1,2,0
54017,5,3,189380,189380,189383,0,3,3
54018,5,1,189385,189385,189386,0,1,2
54019,3,1,189388,189388,189389,0,1,2
54020,6,2,189394,189394,189396,0,2,5
54021,2,2,189396,189396,189398,0,2,0
54022,6,1,189402,189402,189403,0,1,4
54023,4,2,189406,189406,189408,0,2,3
54024,4,3,189410,189410,189413,0,3,2
54025,5,1,189415,189415,189416,0,1,2
54026,6,2,189421,189421,189423,0,2,5
54027,3,2,189424,189424,189426,0,2,1
54028,1,1,189425,189426,189427,1,2,0
54029,3,2,189428,189428,189430,0,2,1
54030,2,3,189430,189430,189433,0,3,0
54031,3,3,189433,189433,189436,0,3,0
54032,4,3,189437,189437,189440,0,3,1
54033,6,1,189443,189443,189444,0,1,3
54034,2,3,189445,189445,189448,0,3,1
54035,5,3,189450,189450,189453,0,3,2
54036,5,3,189455,189455,189458,0,3,2
54037,6,3,189461,189461,189464,0,3,3
54038,4,1,189465,189465,189466,0,1,1
54039,2,3,189467,189467,189470,0,3,1
54040,2,3,189469,189470,189473,1,4,0
54041,1,2,189470,189473,189475,3,5,0
54042,6,3,189476,189476,189479,0,3,1
54043,1,2,189477,189479,189481,2,4,0
54044,2,1,189479,189481,189482,2,3,0
54045,4,3,189483,189483,189486,0,3,1
54046,4,1,189487,189487,189488,0,1,1
54047,5,2,189492,189492,189494,0,2,4
54048,5,1,189497,189497,189498,0,1,3
54049,5,1,189502,189502,189503,0,1,4
54050,3,2,189505,189505,189507,0,2,2
54051,1,1,189506,189507,189508,1,2,0
54052,6,3,189512,189512,189515,0,3,4
54053,4,2,189516,189516,189518,0,2,1
54054,3,3,189519,189519,189522,0,3,1
54055,1,1,189520,189522,189523,2,3,0
54056,6,1,189526,189526,189527,0,1,3
54057,2,1,189528,189528,189529,0,1,1
54058,1,3,189529,189529,189532,0,3,0
54059,1,2,189530,189532,189534,2,4,0
54060,6,3,189536,189536,189539,0,3,2
54061,2,3,189538,189539,189542,1,4,0
54062,4,3,189542,189542,189545,0,3,0
54063,5,3,189547,189547,189550,0,3,2
54064,1,3,189548,189550,189553,2,5,0
54065,3,1,189551,189553,189554,2,3,0
54066,4,3,189555,189555,189558,0,3,1
54067,5,1,189560,189560,189561,0,1,2
54068,6,3,189566,189566,189569,0,3,5
54069,3,3,189569,189569,189572,0,3,0
54070,5,1,189574,189574,189575,0,1,2
54071,1,2,189575,189575,189577,0,2,0
54072,1,2,189576,189577,189579,1,3,0
54073,6,1,189582,189582,189583,0,1,3
54074,5,3,189587,189587,189590,0,3,4
54075,2,2,189589,189590,189592,1,3,0
54076,6,1,189595,189595,189596,0,1,3
54077,1,3,189596,189596,189599,0,3,0
54078,3,2,189599,189599,189601,0,2,0
54079,5,3,189604,189604,189607,0,3,3
54080,5,2,189609,189609,189611,0,2,2
54081,4,1,189613,189613,189614,0,1,2
54082,5,3,189618,189618,189621,0,3,4
54083,4,2,189622,189622,189624,0,2,1
54084,3,2,189625,189625,189627,0,2,1
54085,6,3,189631,189631,189634,0,3,4
54086,6,2,189637,189637,189639,0,2,3
54087,6,1,189643,189643,189644,0,1,4
54088,5,1,189648,189648,189649,0,1,4
54089,6,2,189654,189654,189656,0,2,5
54090,5,2,189659,189659,189661,0,2,3
54091,4,3,189663,189663,189666,0,3,2
54092,4,1,189667,189667,189668,0,1,1
54093,5,3,189672,189672,189675,0,3,4
54094,3,1,189675,189675,189676,0,1,0
54095,5,3,189680,189680,189683,0,3,4
54096,5,2,189685,189685,189687,0,2,2
54097,4,1,189689,189689,189690,0,1,2
54098,2,3,189691,189691,189694,0,3,1
54099,1,1,189692,189694,189695,2,3,0
54100,2,3,189694,189695,189698,1,4,0
54101,2,2,189696,189698,189700,2,4,0
54102,6,3,189702,189702,189705,0,3,2
54103,3,3,189705,189705,189708,0,3,0
54104,4,2,189709,189709,189711,0,2,1
54105,4,1,189713,189713,189714,0,1,2
54106,4,1,189717,189717,189718,0,1,3
54107,6,3,189723,189723,189726,0,3,5
54108,6,2,189729,189729,189731,0,2,3
54109,5,1,189734,189734,189735,0,1,3
54110,6,2,189740,189740,189742,0,2,5
54111,6,2,189746,189746,189748,0,2,4
54112,2,2,189748,189748,189750,0,2,0
54113,4,3,189752,189752,189755,0,3,2
54114,4,3,189756,189756,189759,0,3,1
54115,2,3,189758,189759,189762,1,4,0
54116,3,2,189761,189762,189764,1,3,0
54117,4,3,189765,189765,189768,0,3,1
54118,4,1,189769,189769,189770,0,1,1
54119,1,2,189770,189770,189772,0,2,0
54120,3,2,189773,189773,189775,0,2,1
54121,3,3,189776,189776,189779,0,3,1
54122,2,2,189778,189779,189781,1,3,0
54123,4,2,189782,189782,189784,0,2,1
54124,5,2,189787,189787,189789,0,2,3
54125,6,1,189793,189793,189794,0,1,4
54126,6,2,189799,189799,189801,0,2,5
54127,4,2,189803,189803,189805,0,2,2
54128,5,3,189808,189808,189811,0,3,3
54129,6,2,189814,189814,189816,0,2,3
54130,4,1,189818,189818,189819,0,1,2
54131,3,1,189821,189821,189822,0,1,2
54132,3,2,189824,189824,189826,0,2,2
54133,1,3,189825,189826,189829,1,4,0
54134,5,1,189830,189830,189831,0,1,1
54135,2,2,189832,189832,189834,0,2,1
54136,6,1,189838,189838,189839,0,1,4
54137,4,3,189842,189842,189845,0,3,3
54138,4,2,189846,189846,189848,0,2,1
54139,2,2,189848,189848,189850,0,2,0
54140,1,2,189849,189850,189852,1,3,0
54141,4,3,189853,189853,189856,0,3,1
54142,2,1,189855,189856,189857,1,2,0
54143,2,3,189857,189857,189860,0,3,0
54144,2,1,189859,189860,189861,1,2,0
54145,1,3,189860,189861,189864,1,4,0
54146,6,2,189866,189866,189868,0,2,2
54147,1,3,189867,189868,189871,1,4,0
54148,3,2,189870,189871,189873,1,3,0
54149,4,1,189874,189874,189875,0,1,1
54150,2,1,189876,189876,189877,0,1,1
54151,5,2,189881,189881,189883,0,2,4
54152,3,2,189884,189884,189886,0,2,1
54153,3,1,189887,189887,189888,0,1,1
54154,2,2,189889,189889,189891,0,2,1
54155,5,2,189894,189894,189896,0,2,3
54156,3,3,189897,189897,189900,0,3,1
54157,4,3,189901,189901,189904,0,3,1
54158,2,3,189903,189904,189907,1,4,0
54159,3,1,189906,189907,189908,1,2,0
54160,1,3,189907,189908,189911,1,4,0
54161,1,3,189908,189911,189914,3,6,0
54162,1,2,189909,189914,189916,5,7,0
54163,2,2,189911,189916,189918,5,7,0
54164,3,3,189914,189918,189921,4,7,0
54165,3,2,189917,189921,189923,4,6,0
54166,2,2,189919,189923,189925,4,6,0
54167,6,1,189925,189925,189926,0,1,0
54168,1,2,189926,189926,189928,0,2,0
54169,4,2,189930,189930,189932,0,2,2
54170,6,2,189936,189936,189938,0,2,4
54171,1,3,189937,189938,189941,1,4,0
54172,1,3,189938,189941,189944,3,6,0
54173,2,1,189940,189944,189945,4,5,0
54174,3,1,189943,189945,189946,2,3,0
54175,3,2,189946,189946,189948,0,2,0
54176,5,2,189951,189951,189953,0,2,3
54177,5,1,189956,189956,189957,0,1,3
54178,2,2,189958,189958,189960,0,2,1
54179,2,1,189960,189960,189961,0,1,0
54180,4,1,189964,189964,189965,0,1,3
54181,6,1,189970,189970,189971,0,1,5
54182,3,1,189973,189973,189974,0,1,2
54183,3,1,189976,189976,189977,0,1,2
54184,2,2,189978,189978,189980,0,2,1
54185,2,3,189980,189980,189983,0,3,0
54186,3,2,189983,189983,189985,0,2,0
54187,5,1,189988,189988,189989,0,1,3
54188,1,2,189989,189989,189991,0,2,0
54189,3,1,189992,189992,189993,0,1,1
54190,6,3,189998,189998,190001,0,3,5
54191,3,3,190001,190001,190004,0,3,0
54192,4,3,190005,190005,190008,0,3,1
54193,4,1,190009,190009,190010,0,1,1
54194,1,2,190010,190010,190012,0,2,0
54195,6,1,190016,190016,190017,0,1,4
54196,5,3,190021,190021,190024,0,3,4
54197,2,2,190023,190024,190026,1,3,0
54198,4,1,190027,190027,190028,0,1,1
54199,2,2,190029,190029,190031,0,2,1
54200,6,3,190035,190035,190038,0,3,4
54201,4,3,190039,190039,190042,0,3,1
54202,1,1,190040,190042,190043,2,3,0
54203,3,3,190043,190043,190046,0,3,0
54204,4,1,190047,190047,190048,0,1,1
54205,4,1,190051,190051,190052,0,1,3
54206,2,3,190053,190053,190056,0,3,1
54207,3,1,190056,190056,190057,0,1,0
54208,1,3,190057,190057,190060,0,3,0
54209,4,1,190061,190061,190062,0,1,1
54210,4,1,190065,190065,190066,0,1,3
54211,1,2,190066,190066,190068,0,2,0
54212,3,3,190069,190069,190072,0,3,1
54213,4,2,190073,190073,190075,0,2,1
54214,4,2,190077,190077,190079,0,2,2
54215,5,1,190082,190082,190083,0,1,3
54216,2,2,190084,190084,190086,0,2,1
54217,5,1,190089,190089,190090,0,1,3
54218,1,2,190090,190090,190092,0,2,0
54219,6,3,190096,190096,190099,0,3,4
54220,6,1,190102,190102,190103,0,1,3
54221,5,2,190107,190107,190109,0,2,4
54222,3,1,190110,190110,190111,0,1,1
54223,3,1,190113,190113,190114,0,1,2
54224,5,2,190118,190118,190120,0,2,4
54225,6,2,190124,190124,190126,0,2,4
54226,2,3,190126,190126,190129,0,3,0
54227,4,1,190130,190130,190131,0,1,1
54228,4,1,190134,190134,190135,0,1,3
54229,2,3,190136,190136,190139,0,3,1
54230,3,2,190139,190139,190141,0,2,0
54231,3,3,190142,190142,190145,0,3,1
54232,6,2,190148,190148,190150,0,2,3
54233,2,2,190150,190150,190152,0,2,0
54234,6,3,190156,190156,190159,0,3,4
54235,5,3,190161,190161,190164,0,3,2
54236,6,1,190167,190167,190168,0,1,3
54237,3,3,190170,190170,190173,0,3,2
54238,2,3,190172,190173,190176,1,4,0
54239,5,1,190177,190177,190178,0,1,1
54240,2,2,190179,190179,190181,0,2,1
54241,5,2,190184,190184,190186,0,2,3
54242,2,1,190186,190186,190187,0,1,0
54243,4,2,190190,190190,190192,0,2,3
54244,3,2,190193,190193,190195,0,2,1
54245,5,3,190198,190198,190201,0,3,3
54246,6,2,190204,190204,190206,0,2,3
54247,4,1,190208,190208,190209,0,1,2
54248,5,3,190213,190213,190216,0,3,4
54249,1,2,190214,190216,190218,2,4,0
54250,4,3,190218,190218,190221,0,3,0
54251,3,1,190221,190221,190222,0,1,0
54252,6,1,190227,190227,190228,0,1,5
54253,3,3,190230,190230,190233,0,3,2
54254,3,3,190233,190233,190236,0,3,0
54255,1,1,190234,190236,190237,2,3,0
54256,2,1,190236,190237,190238,1,2,0
54257,2,2,190238,190238,190240,0,2,0
54258,2,2,190240,190240,190242,0,2,0
54259,3,2,190243,190243,190245,0,2,1
54260,4,3,190247,190247,190250,0,3,2
54261,4,2,190251,190251,190253,0,2,1
54262,2,2,190253,190253,190255,0,2,0
54263,1,1,190254,190255,190256,1,2,0
54264,4,3,190258,190258,190261,0,3,2
54265,1,2,190259,190261,190263,2,4,0
54266,1,1,190260,190263,190264,3,4,0
54267,3,3,190263,190264,190267,1,4,0
54268,4,1,190267,190267,190268,0,1,0
54269,6,2,190273,190273,190275,0,2,5
54270,2,2,190275,190275,190277,0,2,0
54271,1,3,190276,190277,190280,1,4,0
54272,5,2,190281,190281,190283,0,2,1
54273,6,3,190287,190287,190290,0,3,4
54274,6,1,190293,190293,190294,0,1,3
54275,1,1,190294,190294,190295,0,1,0
54276,2,2,190296,190296,190298,0,2,1
54277,4,2,190300,190300,190302,0,2,2
54278,6,2,190306,190306,190308,0,2,4
54279,5,3,190311,190311,190314,0,3,3
54280,4,2,190315,190315,190317,0,2,1
54281,2,3,190317,190317,190320,0,3,0
54282,2,2,190319,190320,190322,1,3,0
54283,3,2,190322,190322,190324,0,2,0
54284,4,3,190326,190326,190329,0,3,2
54285,3,1,190329,190329,190330,0,1,0
54286,4,1,190333,190333,190334,0,1,3
54287,4,2,190337,190337,190339,0,2,3
54288,5,2,190342,190342,190344,0,2,3
54289,6,2,190348,190348,190350,0,2,4
54290,4,1,190352,190352,190353,0,1,2
54291,1,2,190353,190353,190355,0,2,0
54292,1,1,190354,190355,190356,1,2,0
54293,5,3,190359,190359,190362,0,3,3
54294,4,2,190363,190363,190365,0,2,1
54295,2,2,190365,190365,190367,0,2,0
54296,4,3,190369,190369,190372,0,3,2
54297,2,2,190371,190372,190374,1,3,0
54298,1,1,190372,190374,190375,2,3,0
54299,3,2,190375,190375,190377,0,2,0
54300,3,2,190378,190378,190380,0,2,1
54301,6,1,190384,190384,190385,0,1,4
54302,1,2,190385,190385,190387,0,2,0
54303,4,3,190389,190389,190392,0,3,2
54304,4,1,190393,190393,190394,0,1,1
54305,5,3,190398,190398,190401,0,3,4
54306,2,1,190400,190401,190402,1,2,0
54307,5,2,190405,190405,190407,0,2,3
54308,2,3,190407,190407,190410,0,3,0
54309,3,2,190410,190410,190412,0,2,0
54310,3,2,190413,190413,190415,0,2,1
54311,1,3,190414,190415,190418,1,4,0
54312,1,1,190415,190418,190419,3,4,0
54313,2,1,190417,190419,190420,2,3,0
54314,1,1,190418,190420,190421,2,3,0
54315,2,1,190420,190421,190422,1,2,0
54316,2,2,190422,190422,190424,0,2,0
54317,3,1,190425,190425,190426,0,1,1
54318,1,3,190426,190426,190429,0,3,0
54319,3,2,190429,190429,190431,0,2,0
54320,5,1,190434,190434,190435,0,1,3
54321,4,1,190438,190438,190439,0,1,3
54322,3,1,190441,190441,190442,0,1,2
54323,5,2,190446,190446,190448,0,2,4
54324,6,3,190452,190452,190455,0,3,4
54325,2,2,190454,190455,190457,1,3,0
54326,6,1,190460,190460,190461,0,1,3
54327,6,3,190466,190466,190469,0,3,5
54328,4,1,190470,190470,190471,0,1,1
54329,3,1,190473,190473,190474,0,1,2
54330,6,3,190479,190479,190482,0,3,5
54331,1,3,190480,190482,190485,2,5,0
54332,6,1,190486,190486,190487,0,1,1
54333,2,3,190488,190488,190491,0,3,1
54334,1,1,190489,190491,190492,2,3,0
54335,4,2,190493,190493,190495,0,2,1
54336,3,2,190496,190496,190498,0,2,1
54337,2,2,190498,190498,190500,0,2,0
54338,2,2,190500,190500,190502,0,2,0
54339,2,1,190502,190502,190503,0,1,0
54340,1,3,190503,190503,190506,0,3,0
54341,3,2,190506,190506,190508,0,2,0
54342,1,2,190507,190508,190510,1,3,0
54343,6,2,190513,190513,190515,0,2,3
54344,3,2,190516,190516,190518,0,2,1
54345,2,2,190518,190518,190520,0,2,0
54346,1,2,190519,190520,190522,1,3,0
54347,3,1,190522,190522,190523,0,1,0
54348,5,2,190527,190527,190529,0,2,4
54349,2,2,190529,190529,190531,0,2,0
54350,6,1,190535,190535,190536,0,1,4
54351,3,3,190538,190538,190541,0,3,2
54352,5,3,190543,190543,190546,0,3,2
54353,1,2,190544,190546,190548,2,4,0
54354,2,1,190546,190548,190549,2,3,0
54355,1,3,190547,190549,190552,2,5,0
54356,2,2,190549,190552,190554,3,5,0
54357,5,1,190554,190554,190555,0,1,0
54358,4,1,190558,190558,190559,0,1,3
54359,4,2,190562,190562,190564,0,2,3
54360,1,1,190563,190564,190565,1,2,0
54361,3,1,190566,190566,190567,0,1,1
54362,3,1,190569,190569,190570,0,1,2
54363,4,2,190573,190573,190575,0,2,3
54364,3,2,190576,190576,190578,0,2,1
54365,1,1,190577,190578,190579,1,2,0
54366,4,3,190581,190581,190584,0,3,2
54367,4,2,190585,190585,190587,0,2,1
54368,3,3,190588,190588,190591,0,3,1
54369,3,1,190591,190591,190592,0,1,0
54370,6,3,190597,190597,190600,0,3,5
54371,5,1,190602,190602,190603,0,1,2
54372,2,2,190604,190604,190606,0,2,1
54373,6,1,190610,190610,190611,0,1,4
54374,5,2,190615,190615,190617,0,2,4
54375,1,2,190616,190617,190619,1,3,0
54376,4,3,190620,190620,190623,0,3,1
54377,3,1,190623,190623,190624,0,1,0
54378,2,2,190625,190625,190627,0,2,1
54379,4,1,190629,190629,190630,0,1,2
54380,6,2,190635,190635,190637,0,2,5
54381,2,3,190637,190637,190640,0,3,0
54382,3,2,190640,190640,190642,0,2,0
54383,5,1,190645,190645,190646,0,1,3
54384,3,2,190648,190648,190650,0,2,2
54385,2,3,190650,190650,190653,0,3,0
54386,5,1,190655,190655,190656,0,1,2
54387,3,3,190658,190658,190661,0,3,2
54388,1,2,190659,190661,190663,2,4,0
54389,1,1,190660,190663,190664,3,4,0
54390,6,3,190666,190666,190669,0,3,2
54391,2,1,190668,190669,190670,1,2,0
54392,3,2,190671,190671,190673,0,2,1
54393,1,1,190672,190673,190674,1,2,0
54394,4,1,190676,190676,190677,0,1,2
54395,6,2,190682,190682,190684,0,2,5
54396,6,3,190688,190688,190691,0,3,4
54397,3,3,190691,190691,190694,0,3,0
54398,6,2,190697,190697,190699,0,2,3
54399,5,1,190702,190702,190703,0,1,3
54400,6,2,190708,190708,190710,0,2,5
54401,2,1,190710,190710,190711,0,1,0
54402,2,2,190712,190712,190714,0,2,1
54403,5,1,190717,190717,190718,0,1,3
54404,2,3,190719,190719,190722,0,3,1
54405,5,1,190724,190724,190725,0,1,2
54406,5,3,190729,190729,190732,0,3,4
54407,1,3,190730,190732,190735,2,5,0
54408,4,2,190734,190735,190737,1,3,0
54409,3,1,190737,190737,190738,0,1,0
54410,3,3,190740,190740,190743,0,3,2
54411,1,1,190741,190743,190744,2,3,0
54412,6,2,190747,190747,190749,0,2,3
54413,3,1,190750,190750,190751,0,1,1
54414,6,2,190756,190756,190758,0,2,5
54415,6,1,190762,190762,190763,0,1,4
54416,5,1,190767,190767,190768,0,1,4
54417,6,3,190773,190773,190776,0,3,5
54418,6,2,190779,190779,190781,0,2,3
54419,1,2,190780,190781,190783,1,3,0
54420,4,1,190784,190784,190785,0,1,1
54421,5,2,190789,190789,190791,0,2,4
54422,5,3,190794,190794,190797,0,3,3
54423,6,1,190800,190800,190801,0,1,3
54424,6,2,190806,190806,190808,0,2,5
54425,2,2,190808,190808,190810,0,2,0
54426,4,1,190812,190812,190813,0,1,2
54427,6,3,190818,190818,190821,0,3,5
54428,4,3,190822,190822,190825,0,3,1
54429,3,1,190825,190825,190826,0,1,0
54430,3,2,190828,190828,190830,0,2,2
54431,2,2,190830,190830,190832,0,2,0
54432,1,3,190831,190832,190835,1,4,0
54433,2,1,190833,190835,190836,2,3,0
54434,1,3,190834,190836,190839,2,5,0
54435,6,2,190840,190840,190842,0,2,1
54436,3,2,190843,190843,190845,0,2,1
54437,1,3,190844,190845,190848,1,4,0
54438,5,1,190849,190849,190850,0,1,1
54439,2,3,190851,190851,190854,0,3,1
54440,5,2,190856,190856,190858,0,2,2
54441,4,2,190860,190860,190862,0,2,2
54442,4,2,190864,190864,190866,0,2,2
54443,4,2,190868,190868,190870,0,2,2
54444,4,1,190872,190872,190873,0,1,2
54445,3,2,190875,190875,190877,0,2,2
54446,5,1,190880,190880,190881,0,1,3
54447,6,2,190886,190886,190888,0,2,5
54448,4,2,190890,190890,190892,0,2,2
54449,1,3,190891,190892,190895,1,4,0
54450,2,3,190893,190895,190898,2,5,0
54451,1,2,190894,190898,190900,4,6,0
54452,3,1,190897,190900,190901,3,4,0
54453,2,1,190899,190901,190902,2,3,0
54454,5,3,190904,190904,190907,0,3,2
54455,5,2,190909,190909,190911,0,2,2
54456,4,1,190913,190913,190914,0,1,2
54457,5,2,190918,190918,190920,0,2,4
54458,3,3,190921,190921,190924,0,3,1
54459,5,1,190926,190926,190927,0,1,2
54460,4,3,190930,190930,190933,0,3,3
54461,3,3,190933,190933,190936,0,3,0
54462,2,3,190935,190936,190939,1,4,0
54463,4,2,190939,190939,190941,0,2,0
54464,3,2,190942,190942,190944,0,2,1
54465,4,2,190946,190946,190948,0,2,2
54466,3,3,190949,190949,190952,0,3,1
54467,5,1,190954,190954,190955,0,1,2
54468,6,2,190960,190960,190962,0,2,5
54469,5,3,190965,190965,190968,0,3,3
54470,2,1,190967,190968,190969,1,2,0
54471,3,3,190970,190970,190973,0,3,1
54472,4,2,190974,190974,190976,0,2,1
54473,1,3,190975,190976,190979,1,4,0
54474,2,3,190977,190979,190982,2,5,0
54475,2,2,190979,190982,190984,3,5,0
54476,5,2,190984,190984,190986,0,2,0
54477,4,1,190988,190988,190989,0,1,2
54478,6,2,190994,190994,190996,0,2,5
54479,3,2,190997,190997,190999,0,2,1
54480,2,2,190999,190999,191001,0,2,0
54481,2,2,191001,191001,191003,0,2,0
54482,5,3,191006,191006,191009,0,3,3
54483,1,2,191007,191009,191011,2,4,0
54484,5,3,191012,191012,191015,0,3,1
54485,5,3,191017,191017,191020,0,3,2
54486,6,1,191023,191023,191024,0,1,3
54487,2,3,191025,191025,191028,0,3,1
54488,1,3,191026,191028,191031,2,5,0
54489,3,1,191029,191031,191032,2,3,0
54490,2,2,191031,191032,191034,1,3,0
54491,5,1,191036,191036,191037,0,1,2
54492,6,2,191042,191042,191044,0,2,5
54493,1,3,191043,191044,191047,1,4,0
54494,5,1,191048,191048,191049,0,1,1
54495,3,3,191051,191051,191054,0,3,2
54496,4,2,191055,191055,191057,0,2,1
54497,6,2,191061,191061,191063,0,2,4
54498,5,3,191066,191066,191069,0,3,3
54499,4,1,191070,191070,191071,0,1,1
54500,3,2,191073,191073,191075,0,2,2
54501,6,2,191079,191079,191081,0,2,4
54502,3,2,191082,191082,191084,0,2,1
54503,5,2,191087,191087,191089,0,2,3
54504,5,3,191092,191092,191095,0,3,3
54505,6,2,191098,191098,191100,0,2,3
54506,4,3,191102,191102,191105,0,3,2
54507,6,2,191108,191108,191110,0,2,3
54508,1,1,191109,191110,191111,1,2,0
54509,6,2,191115,191115,191117,0,2,4
54510,2,3,191117,191117,191120,0,3,0
54511,1,1,191118,191120,191121,2,3,0
54512,5,2,191123,191123,191125,0,2,2
54513,1,2,191124,191125,191127,1,3,0
54514,5,2,191129,191129,191131,0,2,2
54515,3,1,191132,191132,191133,0,1,1
54516,6,2,191138,191138,191140,0,2,5
54517,3,1,191141,191141,191142,0,1,1
54518,2,1,191143,191143,191144,0,1,1
54519,6,1,191149,191149,191150,0,1,5
54520,3,2,191152,191152,191154,0,2,2
54521,4,3,191156,191156,191159,0,3,2
54522,1,1,191157,191159,191160,2,3,0
54523,1,2,191158,191160,191162,2,4,0
54524,2,3,191160,191162,191165,2,5,0
54525,5,2,191165,191165,191167,0,2,0
54526,5,1,191170,191170,191171,0,1,3
54527,1,2,191171,191171,191173,0,2,0
54528,5,3,191176,191176,191179,0,3,3
54529,4,1,191180,191180,191181,0,1,1
54530,3,2,191183,191183,191185,0,2,2
54531,4,2,191187,191187,191189,0,2,2
54532,2,2,191189,191189,191191,0,2,0
54533,1,1,191190,191191,191192,1,2,0
54534,4,3,191194,191194,191197,0,3,2
54535,4,3,191198,191198,191201,0,3,1
54536,5,2,191203,191203,191205,0,2,2
54537,6,3,191209,191209,191212,0,3,4
54538,1,1,191210,191212,191213,2,3,0
54539,2,2,191212,191213,191215,1,3,0
54540,3,2,191215,191215,191217,0,2,0
54541,4,1,191219,191219,191220,0,1,2
54542,3,3,191222,191222,191225,0,3,2
54543,2,1,191224,191225,191226,1,2,0
54544,6,2,191230,191230,191232,0,2,4
54545,1,3,191231,191232,191235,1,4,0
54546,4,1,191235,191235,191236,0,1,0
54547,5,2,191240,191240,191242,0,2,4
54548,3,3,191243,191243,191246,0,3,1
54549,2,1,191245,191246,191247,1,2,0
54550,2,3,191247,191247,191250,0,3,0
54551,1,2,191248,191250,191252,2,4,0
54552,2,2,191250,191252,191254,2,4,0
54553,1,1,191251,191254,191255,3,4,0
54554,3,1,191254,191255,191256,1,2,0
54555,2,1,191256,191256,191257,0,1,0
54556,6,2,191262,191262,191264,0,2,5
54557,5,3,191267,191267,191270,0,3,3
54558,4,3,191271,191271,191274,0,3,1
54559,1,2,191272,191274,191276,2,4,0
54560,4,3,191276,191276,191279,0,3,0
54561,4,3,191280,191280,191283,0,3,1
54562,6,1,191286,191286,191287,0,1,3
54563,3,3,191289,191289,191292,0,3,2
54564,1,1,191290,191292,191293,2,3,0
54565,4,1,191294,191294,191295,0,1,1
54566,3,2,191297,191297,191299,0,2,2
54567,1,1,191298,191299,191300,1,2,0
54568,4,1,191302,191302,191303,0,1,2
54569,4,3,191306,191306,191309,0,3,3
54570,2,3,191308,191309,191312,1,4,0
54571,2,1,191310,191312,191313,2,3,0
54572,2,2,191312,191313,191315,1,3,0
54573,5,3,191317,191317,191320,0,3,2
54574,6,2,191323,191323,191325,0,2,3
54575,5,1,191328,191328,191329,0,1,3
54576,6,3,191334,191334,191337,0,3,5
54577,6,3,191340,191340,191343,0,3,3
54578,5,2,191345,191345,191347,0,2,2
54579,3,1,191348,191348,191349,0,1,1
54580,1,2,191349,191349,191351,0,2,0
54581,3,2,191352,191352,191354,0,2,1
54582,6,2,191358,191358,191360,0,2,4
54583,4,1,191362,191362,191363,0,1,2
54584,3,2,191365,191365,191367,0,2,2
54585,3,3,191368,191368,191371,0,3,1
54586,5,1,191373,191373,191374,0,1,2
54587,6,2,191379,191379,191381,0,2,5
54588,5,2,191384,191384,191386,0,2,3
54589,5,2,191389,191389,191391,0,2,3
54590,1,1,191390,191391,191392,1,2,0
54591,6,2,191396,191396,191398,0,2,4
54592,6,3,191402,191402,191405,0,3,4
54593,4,1,191406,191406,191407,0,1,1
54594,3,3,191409,191409,191412,0,3,2
54595,2,3,191411,191412,191415,1,4,0
54596,3,3,191414,191415,191418,1,4,0
54597,4,3,191418,191418,191421,0,3,0
54598,1,1,191419,191421,191422,2,3,0
54599,3,3,191422,191422,191425,0,3,0
54600,5,1,191427,191427,191428,0,1,2
54601,2,3,191429,191429,191432,0,3,1
54602,5,3,191434,191434,191437,0,3,2
54603,1,3,191435,191437,191440,2,5,0
54604,5,1,191440,191440,191441,0,1,0
54605,6,1,191446,191446,191447,0,1,5
54606,1,3,191447,191447,191450,0,3,0
54607,6,3,191453,191453,191456,0,3,3
54608,4,2,191457,191457,191459,0,2,1
54609,6,1,191463,191463,191464,0,1,4
54610,4,1,191467,191467,191468,0,1,3
54611,1,2,191468,191468,191470,0,2,0
54612,5,3,191473,191473,191476,0,3,3
54613,3,3,191476,191476,191479,0,3,0
54614,1,1,191477,191479,191480,2,3,0
54615,3,3,191480,191480,191483,0,3,0
54616,3,2,191483,191483,191485,0,2,0
54617,3,2,191486,191486,191488,0,2,1
54618,6,2,191492,191492,191494,0,2,4
54619,2,1,191494,191494,191495,0,1,0
54620,2,1,191496,191496,191497,0,1,1
54621,6,3,191502,191502,191505,0,3,5
54622,3,1,191505,191505,191506,0,1,0
54623,5,1,191510,191510,191511,0,1,4
54624,1,2,191511,191511,191513,0,2,0
54625,5,3,191516,191516,191519,0,3,3
54626,3,3,191519,191519,191522,0,3,0
54627,5,2,191524,191524,191526,0,2,2
54628,2,2,191526,191526,191528,0,2,0
54629,6,2,191532,191532,191534,0,2,4
54630,6,2,191538,191538,191540,0,2,4
54631,3,2,191541,191541,191543,0,2,1
54632,1,3,191542,191543,191546,1,4,0
54633,1,2,191543,191546,191548,3,5,0
54634,6,3,191549,191549,191552,0,3,1
54635,3,3,191552,191552,191555,0,3,0
54636,3,3,191555,191555,191558,0,3,0
54637,2,1,191557,191558,191559,1,2,0
54638,1,2,191558,191559,191561,1,3,0
54639,1,3,191559,191561,191564,2,5,0
54640,1,2,191560,191564,191566,4,6,0
54641,2,2,191562,191566,191568,4,6,0
54642,2,3,191564,191568,191571,4,7,0
54643,4,1,191568,191571,191572,3,4,0
54644,2,2,191570,191572,191574,2,4,0
54645,1,1,191571,191574,191575,3,4,0
54646,2,3,191573,191575,191578,2,5,0
54647,3,2,191576,191578,191580,2,4,0
54648,1,2,191577,191580,191582,3,5,0
54649,1,3,191578,191582,191585,4,7,0
54650,1,2,191579,191585,191587,6,8,0
54651,4,1,191583,191587,191588,4,5,0
54652,4,2,191587,191588,191590,1,3,0
54653,3,2,191590,191590,191592,0,2,0
54654,3,2,191593,191593,191595,0,2,1
54655,4,3,191597,191597,191600,0,3,2
54656,5,1,191602,191602,191603,0,1,2
54657,4,3,191606,191606,191609,0,3,3
54658,3,2,191609,191609,191611,0,2,0
54659,6,2,191615,191615,191617,0,2,4
54660,6,3,191621,191621,191624,0,3,4
54661,4,3,191625,191625,191628,0,3,1
54662,1,3,191626,191628,191631,2,5,0
54663,1,1,191627,191631,191632,4,5,0
54664,1,3,191628,191632,191635,4,7,0
54665,5,2,191633,191635,191637,2,4,0
54666,1,1,191634,191637,191638,3,4,0
54667,6,2,191640,191640,191642,0,2,2
54668,2,2,191642,191642,191644,0,2,0
54669,1,1,191643,191644,191645,1,2,0
54670,6,3,191649,191649,191652,0,3,4
54671,3,2,191652,191652,191654,0,2,0
54672,5,2,191657,191657,191659,0,2,3
54673,3,3,191660,191660,191663,0,3,1
54674,2,1,191662,191663,191664,1,2,0
54675,3,1,191665,191665,191666,0,1,1
54676,6,1,191671,191671,191672,0,1,5
54677,6,3,191677,191677,191680,0,3,5
54678,5,2,191682,191682,191684,0,2,2
54679,2,3,191684,191684,191687,0,3,0
54680,6,2,191690,191690,191692,0,2,3
54681,2,1,191692,191692,191693,0,1,0
54682,5,1,191697,191697,191698,0,1,4
54683,6,1,191703,191703,191704,0,1,5
54684,1,1,191704,191704,191705,0,1,0
54685,1,1,191705,191705,191706,0,1,0
54686,3,3,191708,191708,191711,0,3,2
54687,4,2,191712,191712,191714,0,2,1
54688,6,1,191718,191718,191719,0,1,4
54689,5,1,191723,191723,191724,0,1,4
54690,4,1,191727,191727,191728,0,1,3
54691,1,2,191728,191728,191730,0,2,0
54692,2,2,191730,191730,191732,0,2,0
54693,4,2,191734,191734,191736,0,2,2
54694,5,1,191739,191739,191740,0,1,3
54695,5,1,191744,191744,191745,0,1,4
54696,3,1,191747,191747,191748,0,1,2
54697,6,2,191753,191753,191755,0,2,5
54698,1,3,191754,191755,191758,1,4,0
54699,1,3,191755,191758,191761,3,6,0
54700,4,1,191759,191761,191762,2,3,0
54701,6,1,191765,191765,191766,0,1,3
54702,2,1,191767,191767,191768,0,1,1
54703,2,3,191769,191769,191772,0,3,1
54704,6,2,191775,191775,191777,0,2,3
54705,5,1,191780,191780,191781,0,1,3
54706,2,1,191782,191782,191783,0,1,1
54707,6,3,191788,191788,191791,0,3,5
54708,3,2,191791,191791,191793,0,2,0
54709,5,3,191796,191796,191799,0,3,3
54710,6,2,191802,191802,191804,0,2,3
54711,4,3,191806,191806,191809,0,3,2
54712,3,1,191809,191809,191810,0,1,0
54713,5,2,191814,191814,191816,0,2,4
54714,3,3,191817,191817,191820,0,3,1
54715,6,2,191823,191823,191825,0,2,3
54716,4,2,191827,191827,191829,0,2,2
54717,6,2,191833,191833,191835,0,2,4
54718,1,3,191834,191835,191838,1,4,0
54719,2,1,191836,191838,191839,2,3,0
54720,5,3,191841,191841,191844,0,3,2
54721,6,2,191847,191847,191849,0,2,3
54722,2,1,191849,191849,191850,0,1,0
54723,6,2,191855,191855,191857,0,2,5
54724,4,2,191859,191859,191861,0,2,2
54725,4,3,191863,191863,191866,0,3,2
54726,6,3,191869,191869,191872,0,3,3
54727,2,2,191871,191872,191874,1,3,0
54728,5,2,191876,191876,191878,0,2,2
54729,4,2,191880,191880,191882,0,2,2
54730,2,2,191882,191882,191884,0,2,0
54731,4,3,191886,191886,191889,0,3,2
54732,3,1,191889,191889,191890,0,1,0
54733,2,1,191891,191891,191892,0,1,1
54734,1,3,191892,191892,191895,0,3,0
54735,2,3,191894,191895,191898,1,4,0
54736,4,1,191898,191898,191899,0,1,0
54737,4,2,191902,191902,191904,0,2,3
54738,6,3,191908,191908,191911,0,3,4
54739,4,2,191912,191912,191914,0,2,1
54740,4,3,191916,191916,191919,0,3,2
54741,4,3,191920,191920,191923,0,3,1
54742,5,3,191925,191925,191928,0,3,2
54743,4,3,191929,191929,191932,0,3,1
54744,6,3,191935,191935,191938,0,3,3
54745,2,3,191937,191938,191941,1,4,0
54746,1,1,191938,191941,191942,3,4,0
54747,4,2,191942,191942,191944,0,2,0
54748,5,3,191947,191947,191950,0,3,3
54749,5,1,191952,191952,191953,0,1,2
54750,1,2,191953,191953,191955,0,2,0
54751,1,2,191954,191955,191957,1,3,0
54752,6,1,191960,191960,191961,0,1,3
54753,1,3,191961,191961,191964,0,3,0
54754,4,1,191965,191965,191966,0,1,1
54755,5,1,191970,191970,191971,0,1,4
54756,2,3,191972,191972,191975,0,3,1
54757,4,2,191976,191976,191978,0,2,1
54758,3,2,191979,191979,191981,0,2,1
54759,6,1,191985,191985,191986,0,1,4
54760,2,1,191987,191987,191988,0,1,1
54761,2,1,191989,191989,191990,0,1,1
54762,6,3,191995,191995,191998,0,3,5
54763,3,3,191998,191998,192001,0,3,0
54764,4,3,192002,192002,192005,0,3,1
54765,4,1,192006,192006,192007,0,1,1
54766,5,2,192011,192011,192013,0,2,4
54767,6,2,192017,192017,192019,0,2,4
54768,3,1,192020,192020,192021,0,1,1
54769,3,2,192023,192023,192025,0,2,2
54770,4,3,192027,192027,192030,0,3,2
54771,2,2,192029,192030,192032,1,3,0
54772,1,3,192030,192032,192035,2,5,0
54773,2,2,192032,192035,192037,3,5,0
54774,2,1,192034,192037,192038,3,4,0
54775,2,3,192036,192038,192041,2,5,0
54776,4,3,192040,192041,192044,1,4,0
54777,5,3,192045,192045,192048,0,3,1
54778,6,2,192051,192051,192053,0,2,3
54779,5,2,192056,192056,192058,0,2,3
54780,6,3,192062,192062,192065,0,3,4
54781,6,2,192068,192068,192070,0,2,3
54782,3,1,192071,192071,192072,0,1,1
54783,5,2,192076,192076,192078,0,2,4
54784,4,3,192080,192080,192083,0,3,2
54785,1,3,192081,192083,192086,2,5,0
54786,2,2,192083,192086,192088,3,5,0
54787,1,1,192084,192088,192089,4,5,0
54788,3,1,192087,192089,192090,2,3,0
54789,3,3,192090,192090,192093,0,3,0
54790,4,3,192094,192094,192097,0,3,1
54791,2,3,192096,192097,192100,1,4,0
54792,5,1,192101,192101,192102,0,1,1
54793,6,1,192107,192107,192108,0,1,5
54794,5,1,192112,192112,192113,0,1,4
54795,5,1,192117,192117,192118,0,1,4
54796,3,2,192120,192120,192122,0,2,2
54797,1,3,192121,192122,192125,1,4,0
54798,1,1,192122,192125,192126,3,4,0
54799,3,2,192125,192126,192128,1,3,0
54800,1,3,192126,192128,192131,2,5,0
54801,6,3,192132,192132,192135,0,3,1
54802,2,1,192134,192135,192136,1,2,0
54803,1,2,192135,192136,192138,1,3,0
54804,4,3,192139,192139,192142,0,3,1
54805,5,1,192144,192144,192145,0,1,2
54806,1,1,192145,192145,192146,0,1,0
54807,2,1,192147,192147,192148,0,1,1
54808,4,3,192151,192151,192154,0,3,3
54809,6,3,192157,192157,192160,0,3,3
54810,4,1,192161,192161,192162,0,1,1
54811,4,1,192165,192165,192166,0,1,3
54812,2,3,192167,192167,192170,0,3,1
54813,1,1,192168,192170,192171,2,3,0
54814,2,1,192170,192171,192172,1,2,0
54815,4,2,192174,192174,192176,0,2,2
54816,2,2,192176,192176,192178,0,2,0
54817,6,3,192182,192182,192185,0,3,4
54818,5,2,192187,192187,192189,0,2,2
54819,2,3,192189,192189,192192,0,3,0
54820,6,3,192195,192195,192198,0,3,3
54821,5,1,192200,192200,192201,0,1,2
54822,3,3,192203,192203,192206,0,3,2
54823,1,2,192204,192206,192208,2,4,0
54824,6,1,192210,192210,192211,0,1,2
54825,4,3,192214,192214,192217,0,3,3
54826,4,2,192218,192218,192220,0,2,1
54827,5,2,192223,192223,192225,0,2,3
54828,2,2,192225,192225,192227,0,2,0
54829,5,3,192230,192230,192233,0,3,3
54830,5,1,192235,192235,192236,0,1,2
54831,5,3,192240,192240,192243,0,3,4
54832,3,3,192243,192243,192246,0,3,0
54833,3,3,192246,192246,192249,0,3,0
54834,4,3,192250,192250,192253,0,3,1
54835,6,2,192256,192256,192258,0,2,3
54836,4,3,192260,192260,192263,0,3,2
54837,3,3,192263,192263,192266,0,3,0
54838,1,3,192264,192266,192269,2,5,0
54839,1,3,192265,192269,192272,4,7,0
54840,5,3,192270,192272,192275,2,5,0
54841,6,3,192276,192276,192279,0,3,1
54842,3,3,192279,192279,192282,0,3,0
54843,1,2,192280,192282,192284,2,4,0
54844,3,3,192283,192284,192287,1,4,0
54845,6,1,192289,192289,192290,0,1,2
54846,5,3,192294,192294,192297,0,3,4
54847,4,1,192298,192298,192299,0,1,1
54848,1,1,192299,192299,192300,0,1,0
54849,3,3,192302,192302,192305,0,3,2
54850,1,1,192303,192305,192306,2,3,0
54851,5,3,192308,192308,192311,0,3,2
54852,6,3,192314,192314,192317,0,3,3
54853,2,3,192316,192317,192320,1,4,0
54854,2,3,192318,192320,192323,2,5,0
54855,3,2,192321,192323,192325,2,4,0
54856,6,3,192327,192327,192330,0,3,2
54857,5,1,192332,192332,192333,0,1,2
54858,3,2,192335,192335,192337,0,2,2
54859,6,3,192341,192341,192344,0,3,4
54860,5,2,192346,192346,192348,0,2,2
54861,3,1,192349,192349,192350,0,1,1
54862,2,1,192351,192351,192352,0,1,1
54863,4,2,192355,192355,192357,0,2,3
54864,4,1,192359,192359,192360,0,1,2
54865,2,1,192361,192361,192362,0,1,1
54866,3,1,192364,192364,192365,0,1,2
54867,1,3,192365,192365,192368,0,3,0
54868,1,3,192366,192368,192371,2,5,0
54869,3,1,192369,192371,192372,2,3,0
54870,5,1,192374,192374,192375,0,1,2
54871,6,3,192380,192380,192383,0,3,5
54872,2,3,192382,192383,192386,1,4,0
54873,6,1,192388,192388,192389,0,1,2
54874,6,2,192394,192394,192396,0,2,5
54875,3,2,192397,192397,192399,0,2,1
54876,2,1,192399,192399,192400,0,1,0
54877,1,3,192400,192400,192403,0,3,0
54878,4,3,192404,192404,192407,0,3,1
54879,6,1,192410,192410,192411,0,1,3
54880,1,3,192411,192411,192414,0,3,0
54881,2,3,192413,192414,192417,1,4,0
54882,3,2,192416,192417,192419,1,3,0
54883,1,1,192417,192419,192420,2,3,0
54884,4,1,192421,192421,192422,0,1,1
54885,1,1,192422,192422,192423,0,1,0
54886,5,2,192427,192427,192429,0,2,4
54887,3,2,192430,192430,192432,0,2,1
54888,3,3,192433,192433,192436,0,3,1
54889,2,1,192435,192436,192437,1,2,0
54890,4,3,192439,192439,192442,0,3,2
54891,6,1,192445,192445,192446,0,1,3
54892,5,2,192450,192450,192452,0,2,4
54893,2,3,192452,192452,192455,0,3,0
54894,3,1,192455,192455,192456,0,1,0
54895,6,3,192461,192461,192464,0,3,5
54896,2,1,192463,192464,192465,1,2,0
54897,1,1,192464,192465,192466,1,2,0
54898,2,2,192466,192466,192468,0,2,0
54899,2,3,192468,192468,192471,0,3,0
54900,6,1,192474,192474,192475,0,1,3
54901,1,3,192475,192475,192478,0,3,0
54902,3,2,192478,192478,192480,0,2,0
54903,4,2,192482,192482,192484,0,2,2
54904,5,3,192487,192487,192490,0,3,3
54905,1,2,192488,192490,192492,2,4,0
54906,2,3,192490,192492,192495,2,5,0
54907,5,3,192495,192495,192498,0,3,0
54908,2,1,192497,192498,192499,1,2,0
54909,5,1,192502,192502,192503,0,1,3
54910,1,1,192503,192503,192504,0,1,0
54911,5,2,192508,192508,192510,0,2,4
54912,5,3,192513,192513,192516,0,3,3
54913,3,1,192516,192516,192517,0,1,0
54914,4,1,192520,192520,192521,0,1,3
54915,4,3,192524,192524,192527,0,3,3
54916,4,1,192528,192528,192529,0,1,1
54917,2,3,192530,192530,192533,0,3,1
54918,1,1,192531,192533,192534,2,3,0
54919,1,2,192532,192534,192536,2,4,0
54920,5,3,192537,192537,192540,0,3,1
54921,5,2,192542,192542,192544,0,2,2
54922,5,2,192547,192547,192549,0,2,3
54923,4,1,192551,192551,192552,0,1,2
54924,1,2,192552,192552,192554,0,2,0
54925,1,2,192553,192554,192556,1,3,0
54926,1,3,192554,192556,192559,2,5,0
54927,2,3,192556,192559,192562,3,6,0
54928,4,3,192560,192562,192565,2,5,0
54929,3,2,192563,192565,192567,2,4,0
54930,1,2,192564,192567,192569,3,5,0
54931,4,3,192568,192569,192572,1,4,0
54932,2,2,192570,192572,192574,2,4,0
54933,5,2,192575,192575,192577,0,2,1
54934,3,2,192578,192578,192580,0,2,1
54935,6,1,192584,192584,192585,0,1,4
54936,6,3,192590,192590,192593,0,3,5
54937,6,1,192596,192596,192597,0,1,3
54938,1,3,192597,192597,192600,0,3,0
54939,4,3,192601,192601,192604,0,3,1
54940,1,1,192602,192604,192605,2,3,0
54941,3,2,192605,192605,192607,0,2,0
54942,2,1,192607,192607,192608,0,1,0
54943,1,2,192608,192608,192610,0,2,0
54944,4,3,192612,192612,192615,0,3,2
54945,2,3,192614,192615,192618,1,4,0
54946,1,1,192615,192618,192619,3,4,0
54947,5,2,192620,192620,192622,0,2,1
54948,5,2,192625,192625,192627,0,2,3
54949,6,3,192631,192631,192634,0,3,4
54950,3,3,192634,192634,192637,0,3,0
54951,4,2,192638,192638,192640,0,2,1
54952,6,2,192644,192644,192646,0,2,4
54953,1,3,192645,192646,192649,1,4,0
54954,5,1,192650,192650,192651,0,1,1
54955,3,2,192653,192653,192655,0,2,2
54956,3,3,192656,192656,192659,0,3,1
54957,6,2,192662,192662,192664,0,2,3
54958,1,1,192663,192664,192665,1,2,0
54959,6,2,192669,192669,192671,0,2,4
54960,2,3,192671,192671,192674,0,3,0
54961,4,2,192675,192675,192677,0,2,1
54962,1,1,192676,192677,192678,1,2,0
54963,2,3,192678,192678,192681,0,3,0
54964,4,1,192682,192682,192683,0,1,1
54965,1,3,192683,192683,192686,0,3,0
54966,6,1,192689,192689,192690,0,1,3
54967,5,1,192694,192694,192695,0,1,4
54968,5,3,192699,192699,192702,0,3,4
54969,2,2,192701,192702,192704,1,3,0
54970,4,2,192705,192705,192707,0,2,1
54971,3,2,192708,192708,192710,0,2,1
54972,2,2,192710,192710,192712,0,2,0
54973,6,1,192716,192716,192717,0,1,4
54974,2,1,192718,192718,192719,0,1,1
54975,6,2,192724,192724,192726,0,2,5
54976,4,3,192728,192728,192731,0,3,2
54977,2,3,192730,192731,192734,1,4,0
54978,4,1,192734,192734,192735,0,1,0
54979,6,1,192740,192740,192741,0,1,5
54980,3,3,192743,192743,192746,0,3,2
54981,6,2,192749,192749,192751,0,2,3
54982,6,1,192755,192755,192756,0,1,4
54983,2,2,192757,192757,192759,0,2,1
54984,2,2,192759,192759,192761,0,2,0
54985,1,3,192760,192761,192764,1,4,0
54986,4,3,192764,192764,192767,0,3,0
54987,3,3,192767,192767,192770,0,3,0
54988,2,2,192769,192770,192772,1,3,0
54989,6,2,192775,192775,192777,0,2,3
54990,3,1,192778,192778,192779,0,1,1
54991,1,3,192779,192779,192782,0,3,0
54992,1,3,192780,192782,192785,2,5,0
54993,5,1,192785,192785,192786,0,1,0
54994,5,3,192790,192790,192793,0,3,4
54995,4,3,192794,192794,192797,0,3,1
54996,5,1,192799,192799,192800,0,1,2
54997,6,1,192805,192805,192806,0,1,5
54998,2,1,192807,192807,192808,0,1,1
54999,1,3,192808,192808,192811,0,3,0
55000,6,1,192814,192814,192815,0,1,3
55001,6,3,192820,192820,192823,0,3,5
55002,3,1,192823,192823,192824,0,1,0
55003,4,1,192827,192827,192828,0,1,3
55004,4,1,192831,192831,192832,0,1,3
55005,3,1,192834,192834,192835,0,1,2
55006,1,1,192835,192835,192836,0,1,0
55007,1,3,192836,192836,192839,0,3,0
55008,1,2,192837,192839,192841,2,4,0
55009,5,2,192842,192842,192844,0,2,1
55010,3,3,192845,192845,192848,0,3,1
55011,6,1,192851,192851,192852,0,1,3
55012,4,3,192855,192855,192858,0,3,3
55013,6,3,192861,192861,192864,0,3,3
55014,3,2,192864,192864,192866,0,2,0
55015,2,3,192866,192866,192869,0,3,0
55016,4,3,192870,192870,192873,0,3,1
55017,3,1,192873,192873,192874,0,1,0
55018,5,3,192878,192878,192881,0,3,4
55019,2,2,192880,192881,192883,1,3,0
55020,6,3,192886,192886,192889,0,3,3
55021,1,2,192887,192889,192891,2,4,0
55022,1,3,192888,192891,192894,3,6,0
55023,3,3,192891,192894,192897,3,6,0
55024,4,3,192895,192897,192900,2,5,0
55025,5,1,192900,192900,192901,0,1,0
55026,3,3,192903,192903,192906,0,3,2
55027,6,3,192909,192909,192912,0,3,3
55028,5,1,192914,192914,192915,0,1,2
55029,1,3,192915,192915,192918,0,3,0
55030,2,2,192917,192918,192920,1,3,0
55031,3,3,192920,192920,192923,0,3,0
55032,4,1,192924,192924,192925,0,1,1
55033,6,2,192930,192930,192932,0,2,5
55034,6,3,192936,192936,192939,0,3,4
55035,1,2,192937,192939,192941,2,4,0
55036,4,3,192941,192941,192944,0,3,0
55037,1,3,192942,192944,192947,2,5,0
55038,2,1,192944,192947,192948,3,4,0
55039,3,3,192947,192948,192951,1,4,0
55040,3,2,192950,192951,192953,1,3,0
55041,4,1,192954,192954,192955,0,1,1
55042,6,3,192960,192960,192963,0,3,5
55043,2,1,192962,192963,192964,1,2,0
55044,5,2,192967,192967,192969,0,2,3
55045,4,1,192971,192971,192972,0,1,2
55046,2,1,192973,192973,192974,0,1,1
55047,1,2,192974,192974,192976,0,2,0
55048,6,1,192980,192980,192981,0,1,4
55049,6,3,192986,192986,192989,0,3,5
55050,6,3,192992,192992,192995,0,3,3
55051,5,3,192997,192997,193000,0,3,2
55052,1,2,192998,193000,193002,2,4,0
55053,6,3,193004,193004,193007,0,3,2
55054,1,3,193005,193007,193010,2,5,0
55055,5,1,193010,193010,193011,0,1,0
55056,2,2,193012,193012,193014,0,2,1
55057,5,2,193017,193017,193019,0,2,3
55058,1,2,193018,193019,193021,1,3,0
55059,5,1,193023,193023,193024,0,1,2
55060,1,1,193024,193024,193025,0,1,0
55061,6,1,193030,193030,193031,0,1,5
55062,4,1,193034,193034,193035,0,1,3
55063,5,1,193039,193039,193040,0,1,4
55064,1,1,193040,193040,193041,0,1,0
55065,6,3,193046,193046,193049,0,3,5
55066,4,1,193050,193050,193051,0,1,1
55067,4,2,193054,193054,193056,0,2,3
55068,2,3,193056,193056,193059,0,3,0
55069,4,3,193060,193060,193063,0,3,1
55070,2,3,193062,193063,193066,1,4,0
55071,4,1,193066,193066,193067,0,1,0
55072,6,3,193072,193072,193075,0,3,5
55073,6,3,193078,193078,193081,0,3,3
55074,3,3,193081,193081,193084,0,3,0
55075,6,3,193087,193087,193090,0,3,3
55076,4,1,193091,193091,193092,0,1,1
55077,3,2,193094,193094,193096,0,2,2
55078,2,2,193096,193096,193098,0,2,0
55079,1,2,193097,193098,193100,1,3,0
55080,4,2,193101,193101,193103,0,2,1
55081,2,3,193103,193103,193106,0,3,0
55082,6,3,193109,193109,193112,0,3,3
55083,6,3,193115,193115,193118,0,3,3
55084,3,3,193118,193118,193121,0,3,0
55085,6,1,193124,193124,193125,0,1,3
55086,6,2,193130,193130,193132,0,2,5
55087,6,2,193136,193136,193138,0,2,4
55088,3,3,193139,193139,193142,0,3,1
55089,3,3,193142,193142,193145,0,3,0
55090,5,3,193147,193147,193150,0,3,2
55091,3,2,193150,193150,193152,0,2,0
55092,5,1,193155,193155,193156,0,1,3
55093,4,2,193159,193159,193161,0,2,3
55094,3,3,193162,193162,193165,0,3,1
55095,1,3,193163,193165,193168,2,5,0
55096,1,2,193164,193168,193170,4,6,0
55097,2,2,193166,193170,193172,4,6,0
55098,5,1,193171,193172,193173,1,2,0
55099,1,3,193172,193173,193176,1,4,0
55100,3,3,193175,193176,193179,1,4,0
55101,5,1,193180,193180,193181,0,1,1
55102,2,3,193182,193182,193185,0,3,1
55103,5,3,193187,193187,193190,0,3,2
55104,3,2,193190,193190,193192,0,2,0
55105,3,1,193193,193193,193194,0,1,1
55106,3,2,193196,193196,193198,0,2,2
55107,3,2,193199,193199,193201,0,2,1
55108,1,2,193200,193201,193203,1,3,0
55109,2,3,193202,193203,193206,1,4,0
55110,2,2,193204,193206,193208,2,4,0
55111,6,3,193210,193210,193213,0,3,2
55112,4,3,193214,193214,193217,0,3,1
55113,2,2,193216,193217,193219,1,3,0
55114,6,2,193222,193222,193224,0,2,3
55115,3,1,193225,193225,193226,0,1,1
55116,1,2,193226,193226,193228,0,2,0
55117,1,3,193227,193228,193231,1,4,0
55118,4,1,193231,193231,193232,0,1,0
55119,5,3,193236,193236,193239,0,3,4
55120,1,3,193237,193239,193242,2,5,0
55121,2,1,193239,193242,193243,3,4,0
55122,6,2,193245,193245,193247,0,2,2
55123,5,3,193250,193250,193253,0,3,3
55124,2,1,193252,193253,193254,1,2,0
55125,5,2,193257,193257,193259,0,2,3
55126,4,2,193261,193261,193263,0,2,2
55127,3,3,193264,193264,193267,0,3,1
55128,6,3,193270,193270,193273,0,3,3
55129,4,2,193274,193274,193276,0,2,1
55130,6,3,193280,193280,193283,0,3,4
55131,4,1,193284,193284,193285,0,1,1
55132,3,2,193287,193287,193289,0,2,2
55133,6,2,193293,193293,193295,0,2,4
55134,3,2,193296,193296,193298,0,2,1
55135,6,1,193302,193302,193303,0,1,4
55136,2,1,193304,193304,193305,0,1,1
55137,1,1,193305,193305,193306,0,1,0
55138,3,2,193308,193308,193310,0,2,2
55139,6,1,193314,193314,193315,0,1,4
55140,3,3,193317,193317,193320,0,3,2
55141,3,3,193320,193320,193323,0,3,0
55142,3,1,193323,193323,193324,0,1,0
55143,4,2,193327,193327,193329,0,2,3
55144,3,1,193330,193330,193331,0,1,1
55145,5,3,193335,193335,193338,0,3,4
55146,6,1,193341,193341,193342,0,1,3
55147,2,1,193343,193343,193344,0,1,1
55148,2,3,193345,193345,193348,0,3,1
55149,4,3,193349,193349,193352,0,3,1
55150,6,1,193355,193355,193356,0,1,3
55151,1,2,193356,193356,193358,0,2,0
55152,3,1,193359,193359,193360,0,1,1
55153,1,1,193360,193360,193361,0,1,0
55154,5,1,193365,193365,193366,0,1,4
55155,4,3,193369,193369,193372,0,3,3
55156,6,3,193375,193375,193378,0,3,3
55157,4,1,193379,193379,193380,0,1,1
55158,6,3,193385,193385,193388,0,3,5
55159,6,3,193391,193391,193394,0,3,3
55160,4,3,193395,193395,193398,0,3,1
55161,3,2,193398,193398,193400,0,2,0
55162,4,2,193402,193402,193404,0,2,2
55163,6,3,193408,193408,193411,0,3,4
55164,3,1,193411,193411,193412,0,1,0
55165,3,1,193414,193414,193415,0,1,2
55166,5,3,193419,193419,193422,0,3,4
55167,3,2,193422,193422,193424,0,2,0
55168,5,1,193427,193427,193428,0,1,3
55169,3,3,193430,193430,193433,0,3,2
55170,5,2,193435,193435,193437,0,2,2
55171,5,1,193440,193440,193441,0,1,3
55172,4,1,193444,193444,193445,0,1,3
55173,2,3,193446,193446,193449,0,3,1
55174,6,1,193452,193452,193453,0,1,3
55175,5,1,193457,193457,193458,0,1,4
55176,4,3,193461,193461,193464,0,3,3
55177,2,2,193463,193464,193466,1,3,0
55178,3,3,193466,193466,193469,0,3,0
55179,5,1,193471,193471,193472,0,1,2
55180,4,2,193475,193475,193477,0,2,3
55181,3,3,193478,193478,193481,0,3,1
55182,6,1,193484,193484,193485,0,1,3
55183,2,2,193486,193486,193488,0,2,1
55184,3,3,193489,193489,193492,0,3,1
55185,4,2,193493,193493,193495,0,2,1
55186,2,1,193495,193495,193496,0,1,0
55187,5,2,193500,193500,193502,0,2,4
55188,2,1,193502,193502,193503,0,1,0
55189,5,1,193507,193507,193508,0,1,4
55190,5,2,193512,193512,193514,0,2,4
55191,3,1,193515,193515,193516,0,1,1
55192,6,1,193521,193521,193522,0,1,5
55193,5,2,193526,193526,193528,0,2,4
55194,6,3,193532,193532,193535,0,3,4
55195,5,2,193537,193537,193539,0,2,2
55196,3,2,193540,193540,193542,0,2,1
55197,4,2,193544,193544,193546,0,2,2
55198,2,1,193546,193546,193547,0,1,0
55199,3,1,193549,193549,193550,0,1,2
55200,2,1,193551,193551,193552,0,1,1
55201,1,1,193552,193552,193553,0,1,0
55202,3,2,193555,193555,193557,0,2,2
55203,6,3,193561,193561,193564,0,3,4
55204,3,3,193564,193564,193567,0,3,0
55205,4,3,193568,193568,193571,0,3,1
55206,2,1,193570,193571,193572,1,2,0
55207,3,2,193573,193573,193575,0,2,1
55208,3,1,193576,193576,193577,0,1,1
55209,4,1,193580,193580,193581,0,1,3
55210,1,1,193581,193581,193582,0,1,0
55211,1,3,193582,193582,193585,0,3,0
55212,2,1,193584,193585,193586,1,2,0
55213,3,3,193587,193587,193590,0,3,1
55214,6,3,193593,193593,193596,0,3,3
55215,1,1,193594,193596,193597,2,3,0
55216,5,2,193599,193599,193601,0,2,2
55217,6,3,193605,193605,193608,0,3,4
55218,1,3,193606,193608,193611,2,5,0
55219,4,2,193610,193611,193613,1,3,0
55220,5,3,193615,193615,193618,0,3,2
55221,1,2,193616,193618,193620,2,4,0
55222,6,1,193622,193622,193623,0,1,2
55223,5,2,193627,193627,193629,0,2,4
55224,6,2,193633,193633,193635,0,2,4
55225,6,1,193639,193639,193640,0,1,4
55226,6,1,193645,193645,193646,0,1,5
55227,2,1,193647,193647,193648,0,1,1
55228,1,2,193648,193648,193650,0,2,0
55229,2,1,193650,193650,193651,0,1,0
55230,4,1,193654,193654,193655,0,1,3
55231,6,2,193660,193660,193662,0,2,5
55232,1,2,193661,193662,193664,1,3,0
55233,6,2,193667,193667,193669,0,2,3
55234,4,3,193671,193671,193674,0,3,2
55235,5,2,193676,193676,193678,0,2,2
55236,4,3,193680,193680,193683,0,3,2
55237,2,2,193682,193683,193685,1,3,0
55238,5,1,193687,193687,193688,0,1,2
55239,1,2,193688,193688,193690,0,2,0
55240,1,3,193689,193690,193693,1,4,0
55241,2,3,193691,193693,193696,2,5,0
55242,6,2,193697,193697,193699,0,2,1
55243,4,3,193701,193701,193704,0,3,2
55244,6,1,193707,193707,193708,0,1,3
55245,1,1,193708,193708,193709,0,1,0
55246,4,1,193712,193712,193713,0,1,3
55247,6,3,193718,193718,193721,0,3,5
55248,2,2,193720,193721,193723,1,3,0
55249,4,1,193724,193724,193725,0,1,1
55250,6,2,193730,193730,193732,0,2,5
55251,2,1,193732,193732,193733,0,1,0
55252,5,1,193737,193737,193738,0,1,4
55253,6,1,193743,193743,193744,0,1,5
55254,4,2,193747,193747,193749,0,2,3
55255,6,2,193753,193753,193755,0,2,4
55256,1,2,193754,193755,193757,1,3,0
55257,3,2,193757,193757,193759,0,2,0
55258,1,1,193758,193759,193760,1,2,0
55259,4,3,193762,193762,193765,0,3,2
55260,5,3,193767,193767,193770,0,3,2
55261,1,3,193768,193770,193773,2,5,0
55262,3,2,193771,193773,193775,2,4,0
55263,6,1,193777,193777,193778,0,1,2
55264,5,3,193782,193782,193785,0,3,4
55265,1,3,193783,193785,193788,2,5,0
55266,5,1,193788,193788,193789,0,1,0
55267,3,2,193791,193791,193793,0,2,2
55268,3,2,193794,193794,193796,0,2,1
55269,4,3,193798,193798,193801,0,3,2
55270,3,1,193801,193801,193802,0,1,0
55271,4,2,193805,193805,193807,0,2,3
55272,6,3,193811,193811,193814,0,3,4
55273,1,1,193812,193814,193815,2,3,0
55274,6,2,193818,193818,193820,0,2,3
55275,1,2,193819,193820,193822,1,3,0
55276,1,2,193820,193822,193824,2,4,0
55277,4,2,193824,193824,193826,0,2,0
55278,5,1,193829,193829,193830,0,1,3
55279,6,1,193835,193835,193836,0,1,5
55280,6,1,193841,193841,193842,0,1,5
55281,3,2,193844,193844,193846,0,2,2
55282,5,1,193849,193849,193850,0,1,3
55283,1,2,193850,193850,193852,0,2,0
55284,4,2,193854,193854,193856,0,2,2
55285,2,2,193856,193856,193858,0,2,0
55286,6,3,193862,193862,193865,0,3,4
55287,3,1,193865,193865,193866,0,1,0
55288,2,1,193867,193867,193868,0,1,1
55289,2,2,193869,193869,193871,0,2,1
55290,2,2,193871,193871,193873,0,2,0
55291,2,3,193873,193873,193876,0,3,0
55292,3,2,193876,193876,193878,0,2,0
55293,2,1,193878,193878,193879,0,1,0
55294,3,3,193881,193881,193884,0,3,2
55295,1,2,193882,193884,193886,2,4,0
55296,1,2,193883,193886,193888,3,5,0
55297,3,3,193886,193888,193891,2,5,0
55298,5,3,193891,193891,193894,0,3,0
55299,6,1,193897,193897,193898,0,1,3
55300,6,2,193903,193903,193905,0,2,5
55301,4,2,193907,193907,193909,0,2,2
55302,1,1,193908,193909,193910,1,2,0
55303,4,2,193912,193912,193914,0,2,2
55304,6,1,193918,193918,193919,0,1,4
55305,6,2,193924,193924,193926,0,2,5
55306,6,3,193930,193930,193933,0,3,4
55307,2,1,193932,193933,193934,1,2,0
55308,2,2,193934,193934,193936,0,2,0
55309,1,3,193935,193936,193939,1,4,0
55310,5,2,193940,193940,193942,0,2,1
55311,1,1,193941,193942,193943,1,2,0
55312,6,2,193947,193947,193949,0,2,4
55313,5,1,193952,193952,193953,0,1,3
55314,1,2,193953,193953,193955,0,2,0
55315,4,2,193957,193957,193959,0,2,2
55316,1,2,193958,193959,193961,1,3,0
55317,3,3,193961,193961,193964,0,3,0
55318,2,3,193963,193964,193967,1,4,0
55319,1,2,193964,193967,193969,3,5,0
55320,3,2,193967,193969,193971,2,4,0
55321,6,2,193973,193973,193975,0,2,2
55322,5,3,193978,193978,193981,0,3,3
55323,2,1,193980,193981,193982,1,2,0
55324,3,1,193983,193983,193984,0,1,1
55325,3,1,193986,193986,193987,0,1,2
55326,6,3,193992,193992,193995,0,3,5
55327,4,1,193996,193996,193997,0,1,1
55328,5,3,194001,194001,194004,0,3,4
55329,2,2,194003,194004,194006,1,3,0
55330,1,1,194004,194006,194007,2,3,0
55331,4,3,194008,194008,194011,0,3,1
55332,6,3,194014,194014,194017,0,3,3
55333,3,2,194017,194017,194019,0,2,0
55334,4,2,194021,194021,194023,0,2,2
55335,1,1,194022,194023,194024,1,2,0
55336,3,3,194025,194025,194028,0,3,1
55337,6,1,194031,194031,194032,0,1,3
55338,4,2,194035,194035,194037,0,2,3
55339,2,1,194037,194037,194038,0,1,0
55340,2,3,194039,194039,194042,0,3,1
55341,1,1,194040,194042,194043,2,3,0
55342,3,1,194043,194043,194044,0,1,0
55343,6,3,194049,194049,194052,0,3,5
55344,3,2,194052,194052,194054,0,2,0
55345,5,3,194057,194057,194060,0,3,3
55346,2,1,194059,194060,194061,1,2,0
55347,5,1,194064,194064,194065,0,1,3
55348,6,1,194070,194070,194071,0,1,5
55349,1,2,194071,194071,194073,0,2,0
55350,6,1,194077,194077,194078,0,1,4
55351,2,1,194079,194079,194080,0,1,1
55352,1,2,194080,194080,194082,0,2,0
55353,6,1,194086,194086,194087,0,1,4
55354,3,1,194089,194089,194090,0,1,2
55355,5,3,194094,194094,194097,0,3,4
55356,2,1,194096,194097,194098,1,2,0
55357,5,2,194101,194101,194103,0,2,3
55358,6,2,194107,194107,194109,0,2,4
55359,6,2,194113,194113,194115,0,2,4
55360,2,2,194115,194115,194117,0,2,0
55361,1,2,194116,194117,194119,1,3,0
55362,4,2,194120,194120,194122,0,2,1
55363,1,2,194121,194122,194124,1,3,0
55364,3,2,194124,194124,194126,0,2,0
55365,2,3,194126,194126,194129,0,3,0
55366,2,2,194128,194129,194131,1,3,0
55367,6,1,194134,194134,194135,0,1,3
55368,2,1,194136,194136,194137,0,1,1
55369,6,3,194142,194142,194145,0,3,5
55370,4,3,194146,194146,194149,0,3,1
55371,3,1,194149,194149,194150,0,1,0
55372,1,3,194150,194150,194153,0,3,0
55373,6,3,194156,194156,194159,0,3,3
55374,4,1,194160,194160,194161,0,1,1
55375,1,3,194161,194161,194164,0,3,0
55376,6,1,194167,194167,194168,0,1,3
55377,1,2,194168,194168,194170,0,2,0
55378,6,3,194174,194174,194177,0,3,4
55379,3,1,194177,194177,194178,0,1,0
55380,4,3,194181,194181,194184,0,3,3
55381,3,3,194184,194184,194187,0,3,0
55382,2,1,194186,194187,194188,1,2,0
55383,6,1,194192,194192,194193,0,1,4
55384,1,1,194193,194193,194194,0,1,0
55385,1,1,194194,194194,194195,0,1,0
55386,1,2,194195,194195,194197,0,2,0
55387,4,2,194199,194199,194201,0,2,2
55388,4,3,194203,194203,194206,0,3,2
55389,6,1,194209,194209,194210,0,1,3
55390,2,3,194211,194211,194214,0,3,1
55391,6,3,194217,194217,194220,0,3,3
55392,1,2,194218,194220,194222,2,4,0
55393,1,2,194219,194222,194224,3,5,0
55394,2,1,194221,194224,194225,3,4,0
55395,2,1,194223,194225,194226,2,3,0
55396,3,2,194226,194226,194228,0,2,0
55397,5,3,194231,194231,194234,0,3,3
55398,4,1,194235,194235,194236,0,1,1
55399,4,3,194239,194239,194242,0,3,3
55400,3,1,194242,194242,194243,0,1,0
55401,1,1,194243,194243,194244,0,1,0
55402,3,3,194246,194246,194249,0,3,2
55403,5,2,194251,194251,194253,0,2,2
55404,6,3,194257,194257,194260,0,3,4
55405,3,3,194260,194260,194263,0,3,0
55406,2,1,194262,194263,194264,1,2,0
55407,1,1,194263,194264,194265,1,2,0
55408,4,1,194267,194267,194268,0,1,2
55409,4,1,194271,194271,194272,0,1,3
55410,1,1,194272,194272,194273,0,1,0
55411,1,2,194273,194273,194275,0,2,0
55412,1,2,194274,194275,194277,1,3,0
55413,4,1,194278,194278,194279,0,1,1
55414,5,1,194283,194283,194284,0,1,4
55415,2,2,194285,194285,194287,0,2,1
55416,4,2,194289,194289,194291,0,2,2
55417,3,1,194292,194292,194293,0,1,1
55418,2,2,194294,194294,194296,0,2,1
55419,2,1,194296,194296,194297,0,1,0
55420,1,2,194297,194297,194299,0,2,0
55421,3,3,194300,194300,194303,0,3,1
55422,5,2,194305,194305,194307,0,2,2
55423,1,2,194306,194307,194309,1,3,0
55424,1,2,194307,194309,194311,2,4,0
55425,2,1,194309,194311,194312,2,3,0
55426,5,1,194314,194314,194315,0,1,2
55427,3,1,194317,194317,194318,0,1,2
55428,1,3,194318,194318,194321,0,3,0
55429,6,1,194324,194324,194325,0,1,3
55430,6,3,194330,194330,194333,0,3,5
55431,6,2,194336,194336,194338,0,2,3
55432,4,3,194340,194340,194343,0,3,2
55433,3,1,194343,194343,194344,0,1,0
55434,1,2,194344,194344,194346,0,2,0
55435,3,1,194347,194347,194348,0,1,1
55436,1,2,194348,194348,194350,0,2,0
55437,2,1,194350,194350,194351,0,1,0
55438,2,3,194352,194352,194355,0,3,1
55439,5,3,194357,194357,194360,0,3,2
55440,2,3,194359,194360,194363,1,4,0
55441,3,3,194362,194363,194366,1,4,0
55442,1,3,194363,194366,194369,3,6,0
55443,1,1,194364,194369,194370,5,6,0
55444,5,3,194369,194370,194373,1,4,0
55445,3,2,194372,194373,194375,1,3,0
55446,4,3,194376,194376,194379,0,3,1
55447,6,1,194382,194382,194383,0,1,3
55448,1,3,194383,194383,194386,0,3,0
55449,5,2,194388,194388,194390,0,2,2
55450,2,2,194390,194390,194392,0,2,0
55451,3,1,194393,194393,194394,0,1,1
55452,1,1,194394,194394,194395,0,1,0
55453,4,2,194398,194398,194400,0,2,3
55454,2,2,194400,194400,194402,0,2,0
55455,6,1,194406,194406,194407,0,1,4
55456,5,3,194411,194411,194414,0,3,4
55457,2,2,194413,194414,194416,1,3,0
55458,1,2,194414,194416,194418,2,4,0
55459,3,1,194417,194418,194419,1,2,0
55460,3,2,194420,194420,194422,0,2,1
55461,1,3,194421,194422,194425,1,4,0
55462,6,2,194427,194427,194429,0,2,2
55463,4,1,194431,194431,194432,0,1,2
55464,3,2,194434,194434,194436,0,2,2
55465,6,3,194440,194440,194443,0,3,4
55466,3,2,194443,194443,194445,0,2,0
55467,2,3,194445,194445,194448,0,3,0
55468,6,2,194451,194451,194453,0,2,3
55469,3,2,194454,194454,194456,0,2,1
55470,2,3,194456,194456,194459,0,3,0
55471,6,2,194462,194462,194464,0,2,3
55472,1,2,194463,194464,194466,1,3,0
55473,5,1,194468,194468,194469,0,1,2
55474,6,1,194474,194474,194475,0,1,5
55475,6,2,194480,194480,194482,0,2,5
55476,4,2,194484,194484,194486,0,2,2
55477,6,1,194490,194490,194491,0,1,4
55478,3,3,194493,194493,194496,0,3,2
55479,4,3,194497,194497,194500,0,3,1
55480,2,3,194499,194500,194503,1,4,0
55481,5,3,194504,194504,194507,0,3,1
55482,5,3,194509,194509,194512,0,3,2
55483,3,1,194512,194512,194513,0,1,0
55484,5,3,194517,194517,194520,0,3,4
55485,3,3,194520,194520,194523,0,3,0
55486,5,3,194525,194525,194528,0,3,2
55487,3,1,194528,194528,194529,0,1,0
55488,5,3,194533,194533,194536,0,3,4
55489,1,3,194534,194536,194539,2,5,0
55490,3,2,194537,194539,194541,2,4,0
55491,6,3,194543,194543,194546,0,3,2
55492,1,1,194544,194546,194547,2,3,0
55493,5,1,194549,194549,194550,0,1,2
55494,6,2,194555,194555,194557,0,2,5
55495,3,1,194558,194558,194559,0,1,1
55496,3,3,194561,194561,194564,0,3,2
55497,5,3,194566,194566,194569,0,3,2
55498,4,2,194570,194570,194572,0,2,1
55499,4,2,194574,194574,194576,0,2,2
55500,6,2,194580,194580,194582,0,2,4
55501,4,2,194584,194584,194586,0,2,2
55502,4,2,194588,194588,194590,0,2,2
55503,2,2,194590,194590,194592,0,2,0
55504,5,3,194595,194595,194598,0,3,3
55505,5,3,194600,194600,194603,0,3,2
55506,3,1,194603,194603,194604,0,1,0
55507,4,2,194607,194607,194609,0,2,3
55508,3,2,194610,194610,194612,0,2,1
55509,1,2,194611,194612,194614,1,3,0
55510,2,3,194613,194614,194617,1,4,0
55511,3,3,194616,194617,194620,1,4,0
55512,5,3,194621,194621,194624,0,3,1
55513,6,1,194627,194627,194628,0,1,3
55514,6,3,194633,194633,194636,0,3,5
55515,5,1,194638,194638,194639,0,1,2
55516,2,3,194640,194640,194643,0,3,1
55517,6,2,194646,194646,194648,0,2,3
55518,3,1,194649,194649,194650,0,1,1
55519,6,1,194655,194655,194656,0,1,5
55520,5,2,194660,194660,194662,0,2,4
55521,4,1,194664,194664,194665,0,1,2
55522,2,3,194666,194666,194669,0,3,1
55523,4,1,194670,194670,194671,0,1,1
55524,2,2,194672,194672,194674,0,2,1
55525,6,1,194678,194678,194679,0,1,4
55526,2,3,194680,194680,194683,0,3,1
55527,6,2,194686,194686,194688,0,2,3
55528,1,2,194687,194688,194690,1,3,0
55529,3,3,194690,194690,194693,0,3,0
55530,6,2,194696,194696,194698,0,2,3
55531,1,3,194697,194698,194701,1,4,0
55532,6,1,194703,194703,194704,0,1,2
55533,2,2,194705,194705,194707,0,2,1
55534,3,1,194708,194708,194709,0,1,1
55535,1,3,194709,194709,194712,0,3,0
55536,1,3,194710,194712,194715,2,5,0
55537,3,2,194713,194715,194717,2,4,0
55538,2,1,194715,194717,194718,2,3,0
55539,3,3,194718,194718,194721,0,3,0
55540,2,1,194720,194721,194722,1,2,0
55541,3,3,194723,194723,194726,0,3,1
55542,4,3,194727,194727,194730,0,3,1
55543,1,3,194728,194730,194733,2,5,0
55544,5,1,194733,194733,194734,0,1,0
55545,5,3,194738,194738,194741,0,3,4
55546,3,2,194741,194741,194743,0,2,0
55547,1,3,194742,194743,194746,1,4,0
55548,5,3,194747,194747,194750,0,3,1
55549,4,1,194751,194751,194752,0,1,1
55550,5,2,194756,194756,194758,0,2,4
55551,1,1,194757,194758,194759,1,2,0
55552,4,3,194761,194761,194764,0,3,2
55553,2,2,194763,194764,194766,1,3,0
55554,3,3,194766,194766,194769,0,3,0
55555,5,1,194771,194771,194772,0,1,2
55556,2,2,194773,194773,194775,0,2,1
55557,4,1,194777,194777,194778,0,1,2
55558,4,3,194781,194781,194784,0,3,3
55559,6,1,194787,194787,194788,0,1,3
55560,3,2,194790,194790,194792,0,2,2
55561,5,1,194795,194795,194796,0,1,3
55562,3,2,194798,194798,194800,0,2,2
55563,1,2,194799,194800,194802,1,3,0
55564,1,3,194800,194802,194805,2,5,0
55565,4,1,194804,194805,194806,1,2,0
55566,4,2,194808,194808,194810,0,2,2
55567,2,1,194810,194810,194811,0,1,0
55568,3,3,194813,194813,194816,0,3,2
55569,4,1,194817,194817,194818,0,1,1
55570,4,3,194821,194821,194824,0,3,3
55571,3,3,194824,194824,194827,0,3,0
55572,5,1,194829,194829,194830,0,1,2
55573,2,2,194831,194831,194833,0,2,1
55574,5,3,194836,194836,194839,0,3,3
55575,3,1,194839,194839,194840,0,1,0
55576,4,3,194843,194843,194846,0,3,3
55577,1,3,194844,194846,194849,2,5,0
55578,1,3,194845,194849,194852,4,7,0
55579,4,1,194849,194852,194853,3,4,0
55580,4,3,194853,194853,194856,0,3,0
55581,5,1,194858,194858,194859,0,1,2
55582,3,1,194861,194861,194862,0,1,2
55583,6,2,194867,194867,194869,0,2,5
55584,1,1,194868,194869,194870,1,2,0
55585,5,1,194873,194873,194874,0,1,3
55586,5,3,194878,194878,194881,0,3,4
55587,3,2,194881,194881,194883,0,2,0
55588,6,3,194887,194887,194890,0,3,4
55589,3,1,194890,194890,194891,0,1,0
55590,4,2,194894,194894,194896,0,2,3
55591,3,3,194897,194897,194900,0,3,1
55592,6,2,194903,194903,194905,0,2,3
55593,3,3,194906,194906,194909,0,3,1
55594,4,2,194910,194910,194912,0,2,1
55595,2,3,194912,194912,194915,0,3,0
55596,2,1,194914,194915,194916,1,2,0
55597,6,1,194920,194920,194921,0,1,4
55598,3,2,194923,194923,194925,0,2,2
55599,3,3,194926,194926,194929,0,3,1
55600,4,2,194930,194930,194932,0,2,1
55601,5,2,194935,194935,194937,0,2,3
55602,1,2,194936,194937,194939,1,3,0
55603,6,2,194942,194942,194944,0,2,3
55604,4,1,194946,194946,194947,0,1,2
55605,1,1,194947,194947,194948,0,1,0
55606,2,2,194949,194949,194951,0,2,1
55607,6,3,194955,194955,194958,0,3,4
55608,1,3,194956,194958,194961,2,5,0
55609,5,1,194961,194961,194962,0,1,0
55610,2,1,194963,194963,194964,0,1,1
55611,5,1,194968,194968,194969,0,1,4
55612,2,1,194970,194970,194971,0,1,1
55613,4,2,194974,194974,194976,0,2,3
55614,4,1,194978,194978,194979,0,1,2
55615,3,2,194981,194981,194983,0,2,2
55616,1,2,194982,194983,194985,1,3,0
55617,6,1,194988,194988,194989,0,1,3
55618,4,1,194992,194992,194993,0,1,3
55619,1,1,194993,194993,194994,0,1,0
55620,4,1,194997,194997,194998,0,1,3
55621,3,2,195000,195000,195002,0,2,2
55622,1,1,195001,195002,195003,1,2,0
55623,4,1,195005,195005,195006,0,1,2
55624,1,1,195006,195006,195007,0,1,0
55625,2,1,195008,195008,195009,0,1,1
55626,3,2,195011,195011,195013,0,2,2
55627,3,2,195014,195014,195016,0,2,1
55628,4,1,195018,195018,195019,0,1,2
55629,2,1,195020,195020,195021,0,1,1
55630,1,3,195021,195021,195024,0,3,0
55631,3,3,195024,195024,195027,0,3,0
55632,2,3,195026,195027,195030,1,4,0
55633,5,1,195031,195031,195032,0,1,1
55634,6,1,195037,195037,195038,0,1,5
55635,1,2,195038,195038,195040,0,2,0
55636,6,1,195044,195044,195045,0,1,4
55637,5,3,195049,195049,195052,0,3,4
55638,4,2,195053,195053,195055,0,2,1
55639,2,1,195055,195055,195056,0,1,0
55640,6,2,195061,195061,195063,0,2,5
55641,6,1,195067,195067,195068,0,1,4
55642,5,2,195072,195072,195074,0,2,4
55643,5,3,195077,195077,195080,0,3,3
55644,6,3,195083,195083,195086,0,3,3
55645,6,1,195089,195089,195090,0,1,3
55646,3,3,195092,195092,195095,0,3,2
55647,5,2,195097,195097,195099,0,2,2
55648,6,1,195103,195103,195104,0,1,4
55649,6,3,195109,195109,195112,0,3,5
55650,6,3,195115,195115,195118,0,3,3
55651,1,2,195116,195118,195120,2,4,0
55652,2,1,195118,195120,195121,2,3,0
55653,3,2,195121,195121,195123,0,2,0
55654,4,1,195125,195125,195126,0,1,2
55655,5,1,195130,195130,195131,0,1,4
55656,3,1,195133,195133,195134,0,1,2
55657,4,1,195137,195137,195138,0,1,3
55658,3,2,195140,195140,195142,0,2,2
55659,1,3,195141,195142,195145,1,4,0
55660,1,1,195142,195145,195146,3,4,0
55661,4,3,195146,195146,195149,0,3,0
55662,3,3,195149,195149,195152,0,3,0
55663,6,1,195155,195155,195156,0,1,3
55664,1,2,195156,195156,195158,0,2,0
55665,5,3,195161,195161,195164,0,3,3
55666,4,1,195165,195165,195166,0,1,1
55667,5,3,195170,195170,195173,0,3,4
55668,2,3,195172,195173,195176,1,4,0
55669,4,1,195176,195176,195177,0,1,0
55670,3,1,195179,195179,195180,0,1,2
55671,2,3,195181,195181,195184,0,3,1
55672,1,2,195182,195184,195186,2,4,0
55673,3,1,195185,195186,195187,1,2,0
55674,2,2,195187,195187,195189,0,2,0
55675,1,3,195188,195189,195192,1,4,0
55676,5,3,195193,195193,195196,0,3,1
55677,6,1,195199,195199,195200,0,1,3
55678,4,1,195203,195203,195204,0,1,3
55679,5,2,195208,195208,195210,0,2,4
55680,4,3,195212,195212,195215,0,3,2
55681,4,2,195216,195216,195218,0,2,1
55682,3,3,195219,195219,195222,0,3,1
55683,5,2,195224,195224,195226,0,2,2
55684,2,2,195226,195226,195228,0,2,0
55685,4,1,195230,195230,195231,0,1,2
55686,5,3,195235,195235,195238,0,3,4
55687,5,1,195240,195240,195241,0,1,2
55688,4,2,195244,195244,195246,0,2,3
55689,4,1,195248,195248,195249,0,1,2
55690,2,1,195250,195250,195251,0,1,1
55691,6,1,195256,195256,195257,0,1,5
55692,4,1,195260,195260,195261,0,1,3
55693,1,3,195261,195261,195264,0,3,0
55694,4,2,195265,195265,195267,0,2,1
55695,3,2,195268,195268,195270,0,2,1
55696,2,3,195270,195270,195273,0,3,0
55697,6,3,195276,195276,195279,0,3,3
55698,5,3,195281,195281,195284,0,3,2
55699,3,3,195284,195284,195287,0,3,0
55700,1,3,195285,195287,195290,2,5,0
55701,5,2,195290,195290,195292,0,2,0
55702,3,3,195293,195293,195296,0,3,1
55703,6,2,195299,195299,195301,0,2,3
55704,3,2,195302,195302,195304,0,2,1
55705,3,3,195305,195305,195308,0,3,1
55706,6,2,195311,195311,195313,0,2,3
55707,2,1,195313,195313,195314,0,1,0
55708,3,2,195316,195316,195318,0,2,2
55709,4,1,195320,195320,195321,0,1,2
55710,5,3,195325,195325,195328,0,3,4
55711,6,2,195331,195331,195333,0,2,3
55712,6,2,195337,195337,195339,0,2,4
55713,2,2,195339,195339,195341,0,2,0
55714,2,1,195341,195341,195342,0,1,0
55715,6,3,195347,195347,195350,0,3,5
55716,1,3,195348,195350,195353,2,5,0
55717,1,3,195349,195353,195356,4,7,0
55718,4,3,195353,195356,195359,3,6,0
55719,4,3,195357,195359,195362,2,5,0
55720,6,2,195363,195363,195365,0,2,1
55721,5,1,195368,195368,195369,0,1,3
55722,4,2,195372,195372,195374,0,2,3
55723,3,3,195375,195375,195378,0,3,1
55724,3,3,195378,195378,195381,0,3,0
55725,2,1,195380,195381,195382,1,2,0
55726,6,1,195386,195386,195387,0,1,4
55727,1,1,195387,195387,195388,0,1,0
55728,4,1,195391,195391,195392,0,1,3
55729,5,1,195396,195396,195397,0,1,4
55730,6,2,195402,195402,195404,0,2,5
55731,1,1,195403,195404,195405,1,2,0
55732,5,3,195408,195408,195411,0,3,3
55733,4,1,195412,195412,195413,0,1,1
55734,4,2,195416,195416,195418,0,2,3
55735,2,2,195418,195418,195420,0,2,0
55736,2,1,195420,195420,195421,0,1,0
55737,2,2,195422,195422,195424,0,2,1
55738,6,2,195428,195428,195430,0,2,4
55739,1,1,195429,195430,195431,1,2,0
55740,3,2,195432,195432,195434,0,2,1
55741,6,1,195438,195438,195439,0,1,4
55742,1,1,195439,195439,195440,0,1,0
55743,2,1,195441,195441,195442,0,1,1
55744,5,1,195446,195446,195447,0,1,4
55745,2,3,195448,195448,195451,0,3,1
55746,4,1,195452,195452,195453,0,1,1
55747,5,2,195457,195457,195459,0,2,4
55748,3,2,195460,195460,195462,0,2,1
55749,3,3,195463,195463,195466,0,3,1
55750,4,3,195467,195467,195470,0,3,1
55751,3,2,195470,195470,195472,0,2,0
55752,4,1,195474,195474,195475,0,1,2
55753,5,1,195479,195479,195480,0,1,4
55754,6,3,195485,195485,195488,0,3,5
55755,6,3,195491,195491,195494,0,3,3
55756,3,1,195494,195494,195495,0,1,0
55757,6,3,195500,195500,195503,0,3,5
55758,6,3,195506,195506,195509,0,3,3
55759,6,2,195512,195512,195514,0,2,3
55760,2,1,195514,195514,195515,0,1,0
55761,6,3,195520,195520,195523,0,3,5
55762,1,1,195521,195523,195524,2,3,0
55763,4,1,195525,195525,195526,0,1,1
55764,4,1,195529,195529,195530,0,1,3
55765,4,3,195533,195533,195536,0,3,3
55766,1,2,195534,195536,195538,2,4,0
55767,4,2,195538,195538,195540,0,2,0
55768,4,2,195542,195542,195544,0,2,2
55769,2,3,195544,195544,195547,0,3,0
55770,3,1,195547,195547,195548,0,1,0
55771,4,2,195551,195551,195553,0,2,3
55772,4,3,195555,195555,195558,0,3,2
55773,4,2,195559,195559,195561,0,2,1
55774,5,1,195564,195564,195565,0,1,3
55775,4,1,195568,195568,195569,0,1,3
55776,2,1,195570,195570,195571,0,1,1
55777,3,3,195573,195573,195576,0,3,2
55778,5,2,195578,195578,195580,0,2,2
55779,4,3,195582,195582,195585,0,3,2
55780,5,2,195587,195587,195589,0,2,2
55781,1,1,195588,195589,195590,1,2,0
55782,5,2,195593,195593,195595,0,2,3
55783,2,3,195595,195595,195598,0,3,0
55784,6,1,195601,195601,195602,0,1,3
55785,4,2,195605,195605,195607,0,2,3
55786,4,2,195609,195609,195611,0,2,2
55787,5,3,195614,195614,195617,0,3,3
55788,6,3,195620,195620,195623,0,3,3
55789,1,1,195621,195623,195624,2,3,0
55790,4,2,195625,195625,195627,0,2,1
55791,3,1,195628,195628,195629,0,1,1
55792,2,2,195630,195630,195632,0,2,1
55793,1,3,195631,195632,195635,1,4,0
55794,3,2,195634,195635,195637,1,3,0
55795,3,1,195637,195637,195638,0,1,0
55796,2,1,195639,195639,195640,0,1,1
55797,3,3,195642,195642,195645,0,3,2
55798,5,1,195647,195647,195648,0,1,2
55799,2,3,195649,195649,195652,0,3,1
55800,5,3,195654,195654,195657,0,3,2
55801,2,1,195656,195657,195658,1,2,0
55802,3,3,195659,195659,195662,0,3,1
55803,5,1,195664,195664,195665,0,1,2
55804,5,3,195669,195669,195672,0,3,4
55805,4,2,195673,195673,195675,0,2,1
55806,3,2,195676,195676,195678,0,2,1
55807,1,1,195677,195678,195679,1,2,0
55808,1,2,195678,195679,195681,1,3,0
55809,6,3,195684,195684,195687,0,3,3
55810,2,3,195686,195687,195690,1,4,0
55811,5,1,195691,195691,195692,0,1,1
55812,3,2,195694,195694,195696,0,2,2
55813,6,1,195700,195700,195701,0,1,4
55814,6,1,195706,195706,195707,0,1,5
55815,5,2,195711,195711,195713,0,2,4
55816,2,1,195713,195713,195714,0,1,0
55817,4,1,195717,195717,195718,0,1,3
55818,2,2,195719,195719,195721,0,2,1
55819,6,3,195725,195725,195728,0,3,4
55820,3,2,195728,195728,195730,0,2,0
55821,2,1,195730,195730,195731,0,1,0
55822,4,3,195734,195734,195737,0,3,3
55823,2,2,195736,195737,195739,1,3,0
55824,3,2,195739,195739,195741,0,2,0
55825,2,3,195741,195741,195744,0,3,0
55826,6,2,195747,195747,195749,0,2,3
55827,3,1,195750,195750,195751,0,1,1
55828,1,3,195751,195751,195754,0,3,0
55829,5,1,195756,195756,195757,0,1,2
55830,4,2,195760,195760,195762,0,2,3
55831,1,1,195761,195762,195763,1,2,0
55832,2,1,195763,195763,195764,0,1,0
55833,4,1,195767,195767,195768,0,1,3
55834,4,1,195771,195771,195772,0,1,3
55835,2,3,195773,195773,195776,0,3,1
55836,2,2,195775,195776,195778,1,3,0
55837,6,1,195781,195781,195782,0,1,3
55838,4,1,195785,195785,195786,0,1,3
55839,5,3,195790,195790,195793,0,3,4
55840,4,3,195794,195794,195797,0,3,1
55841,6,3,195800,195800,195803,0,3,3
55842,5,1,195805,195805,195806,0,1,2
55843,6,3,195811,195811,195814,0,3,5
55844,3,2,195814,195814,195816,0,2,0
55845,6,1,195820,195820,195821,0,1,4
55846,5,2,195825,195825,195827,0,2,4
55847,6,1,195831,195831,195832,0,1,4
55848,2,3,195833,195833,195836,0,3,1
55849,5,2,195838,195838,195840,0,2,2
55850,5,2,195843,195843,195845,0,2,3
55851,6,1,195849,195849,195850,0,1,4
55852,1,3,195850,195850,195853,0,3,0
55853,2,1,195852,195853,195854,1,2,0
55854,3,1,195855,195855,195856,0,1,1
55855,1,2,195856,195856,195858,0,2,0
55856,2,2,195858,195858,195860,0,2,0
55857,5,1,195863,195863,195864,0,1,3
55858,1,3,195864,195864,195867,0,3,0
55859,4,3,195868,195868,195871,0,3,1
55860,4,1,195872,195872,195873,0,1,1
55861,3,2,195875,195875,195877,0,2,2
55862,3,1,195878,195878,195879,0,1,1
55863,1,1,195879,195879,195880,0,1,0
55864,2,1,195881,195881,195882,0,1,1
55865,3,2,195884,195884,195886,0,2,2
55866,4,1,195888,195888,195889,0,1,2
55867,1,1,195889,195889,195890,0,1,0
55868,3,3,195892,195892,195895,0,3,2
55869,1,3,195893,195895,195898,2,5,0
55870,5,3,195898,195898,195901,0,3,0
55871,3,1,195901,195901,195902,0,1,0
55872,1,1,195902,195902,195903,0,1,0
55873,2,1,195904,195904,195905,0,1,1
55874,4,2,195908,195908,195910,0,2,3
55875,6,2,195914,195914,195916,0,2,4
55876,1,2,195915,195916,195918,1,3,0
55877,4,2,195919,195919,195921,0,2,1
55878,5,1,195924,195924,195925,0,1,3
55879,6,3,195930,195930,195933,0,3,5
55880,2,1,195932,195933,195934,1,2,0
55881,5,3,195937,195937,195940,0,3,3
55882,4,3,195941,195941,195944,0,3,1
55883,4,2,195945,195945,195947,0,2,1
55884,5,3,195950,195950,195953,0,3,3
55885,4,1,195954,195954,195955,0,1,1
55886,5,1,195959,195959,195960,0,1,4
55887,4,2,195963,195963,195965,0,2,3
55888,5,1,195968,195968,195969,0,1,3
55889,4,2,195972,195972,195974,0,2,3
55890,5,2,195977,195977,195979,0,2,3
55891,2,1,195979,195979,195980,0,1,0
55892,4,3,195983,195983,195986,0,3,3
55893,6,2,195989,195989,195991,0,2,3
55894,1,3,195990,195991,195994,1,4,0
55895,1,1,195991,195994,195995,3,4,0
55896,4,1,195995,195995,195996,0,1,0
55897,1,1,195996,195996,195997,0,1,0
55898,5,2,196001,196001,196003,0,2,4
55899,5,2,196006,196006,196008,0,2,3
55900,2,3,196008,196008,196011,0,3,0
55901,3,1,196011,196011,196012,0,1,0
55902,2,1,196013,196013,196014,0,1,1
55903,3,3,196016,196016,196019,0,3,2
55904,2,2,196018,196019,196021,1,3,0
55905,6,2,196024,196024,196026,0,2,3
55906,2,3,196026,196026,196029,0,3,0
55907,6,2,196032,196032,196034,0,2,3
55908,1,2,196033,196034,196036,1,3,0
55909,5,2,196038,196038,196040,0,2,2
55910,5,3,196043,196043,196046,0,3,3
55911,2,2,196045,196046,196048,1,3,0
55912,4,2,196049,196049,196051,0,2,1
55913,3,3,196052,196052,196055,0,3,1
55914,2,2,196054,196055,196057,1,3,0
55915,4,1,196058,196058,196059,0,1,1
55916,6,2,196064,196064,196066,0,2,5
55917,5,1,196069,196069,196070,0,1,3
55918,2,3,196071,196071,196074,0,3,1
55919,4,3,196075,196075,196078,0,3,1
55920,2,3,196077,196078,196081,1,4,0
55921,2,3,196079,196081,196084,2,5,0
55922,4,2,196083,196084,196086,1,3,0
55923,1,3,196084,196086,196089,2,5,0
55924,2,3,196086,196089,196092,3,6,0
55925,6,3,196092,196092,196095,0,3,0
55926,2,3,196094,196095,196098,1,4,0
55927,5,3,196099,196099,196102,0,3,1
55928,2,3,196101,196102,196105,1,4,0
55929,2,2,196103,196105,196107,2,4,0
55930,5,1,196108,196108,196109,0,1,1
55931,2,1,196110,196110,196111,0,1,1
55932,2,3,196112,196112,196115,0,3,1
55933,5,1,196117,196117,196118,0,1,2
55934,4,2,196121,196121,196123,0,2,3
55935,4,2,196125,196125,196127,0,2,2
55936,2,2,196127,196127,196129,0,2,0
55937,6,1,196133,196133,196134,0,1,4
55938,5,2,196138,196138,196140,0,2,4
55939,3,1,196141,196141,196142,0,1,1
55940,5,2,196146,196146,196148,0,2,4
55941,4,2,196150,196150,196152,0,2,2
55942,4,3,196154,196154,196157,0,3,2
55943,2,3,196156,196157,196160,1,4,0
55944,1,2,196157,196160,196162,3,5,0
55945,6,3,196163,196163,196166,0,3,1
55946,4,3,196167,196167,196170,0,3,1
55947,5,2,196172,196172,196174,0,2,2
55948,2,1,196174,196174,196175,0,1,0
55949,2,1,196176,196176,196177,0,1,1
55950,6,3,196182,196182,196185,0,3,5
55951,2,2,196184,196185,196187,1,3,0
55952,4,3,196188,196188,196191,0,3,1
55953,6,3,196194,196194,196197,0,3,3
55954,2,1,196196,196197,196198,1,2,0
55955,6,2,196202,196202,196204,0,2,4
55956,2,1,196204,196204,196205,0,1,0
55957,4,2,196208,196208,196210,0,2,3
55958,2,1,196210,196210,196211,0,1,0
55959,4,3,196214,196214,196217,0,3,3
55960,3,1,196217,196217,196218,0,1,0
55961,6,2,196223,196223,196225,0,2,5
55962,2,1,196225,196225,196226,0,1,0
55963,3,3,196228,196228,196231,0,3,2
55964,4,1,196232,196232,196233,0,1,1
55965,6,2,196238,196238,196240,0,2,5
55966,3,3,196241,196241,196244,0,3,1
55967,2,3,196243,196244,196247,1,4,0
55968,2,3,196245,196247,196250,2,5,0
55969,3,3,196248,196250,196253,2,5,0
55970,2,3,196250,196253,196256,3,6,0
55971,6,3,196256,196256,196259,0,3,0
55972,5,3,196261,196261,196264,0,3,2
55973,5,2,196266,196266,196268,0,2,2
55974,1,1,196267,196268,196269,1,2,0
55975,4,1,196271,196271,196272,0,1,2
55976,5,2,196276,196276,196278,0,2,4
55977,2,2,196278,196278,196280,0,2,0
55978,6,1,196284,196284,196285,0,1,4
55979,2,1,196286,196286,196287,0,1,1
55980,5,2,196291,196291,196293,0,2,4
55981,6,1,196297,196297,196298,0,1,4
55982,2,1,196299,196299,196300,0,1,1
55983,4,2,196303,196303,196305,0,2,3
55984,6,3,196309,196309,196312,0,3,4
55985,5,1,196314,196314,196315,0,1,2
55986,1,1,196315,196315,196316,0,1,0
55987,6,3,196321,196321,196324,0,3,5
55988,2,3,196323,196324,196327,1,4,0
55989,4,2,196327,196327,196329,0,2,0
55990,4,1,196331,196331,196332,0,1,2
55991,4,1,196335,196335,196336,0,1,3
55992,4,2,196339,196339,196341,0,2,3
55993,1,2,196340,196341,196343,1,3,0
55994,2,1,196342,196343,196344,1,2,0
55995,3,3,196345,196345,196348,0,3,1
55996,2,1,196347,196348,196349,1,2,0
55997,3,3,196350,196350,196353,0,3,1
55998,3,1,196353,196353,196354,0,1,0
55999,6,2,196359,196359,196361,0,2,5
56000,3,2,196362,196362,196364,0,2,1
56001,3,1,196365,196365,196366,0,1,1
56002,1,3,196366,196366,196369,0,3,0
56003,3,2,196369,196369,196371,0,2,0
56004,2,2,196371,196371,196373,0,2,0
56005,3,2,196374,196374,196376,0,2,1
56006,1,3,196375,196376,196379,1,4,0
56007,6,1,196381,196381,196382,0,1,2
56008,4,1,196385,196385,196386,0,1,3
56009,4,3,196389,196389,196392,0,3,3
56010,6,3,196395,196395,196398,0,3,3
56011,5,3,196400,196400,196403,0,3,2
56012,1,2,196401,196403,196405,2,4,0
56013,2,1,196403,196405,196406,2,3,0
56014,3,2,196406,196406,196408,0,2,0
56015,6,3,196412,196412,196415,0,3,4
56016,5,1,196417,196417,196418,0,1,2
56017,3,1,196420,196420,196421,0,1,2
56018,2,3,196422,196422,196425,0,3,1
56019,2,3,196424,196425,196428,1,4,0
56020,1,2,196425,196428,196430,3,5,0
56021,1,2,196426,196430,196432,4,6,0
56022,6,2,196432,196432,196434,0,2,0
56023,2,3,196434,196434,196437,0,3,0
56024,5,1,196439,196439,196440,0,1,2
56025,1,2,196440,196440,196442,0,2,0
56026,6,3,196446,196446,196449,0,3,4
56027,2,3,196448,196449,196452,1,4,0
56028,3,1,196451,196452,196453,1,2,0
56029,3,1,196454,196454,196455,0,1,1
56030,6,1,196460,196460,196461,0,1,5
56031,4,1,196464,196464,196465,0,1,3
56032,4,3,196468,196468,196471,0,3,3
56033,2,1,196470,196471,196472,1,2,0
56034,6,2,196476,196476,196478,0,2,4
56035,1,2,196477,196478,196480,1,3,0
56036,6,1,196483,196483,196484,0,1,3
56037,6,3,196489,196489,196492,0,3,5
56038,5,1,196494,196494,196495,0,1,2
56039,2,3,196496,196496,196499,0,3,1
56040,3,3,196499,196499,196502,0,3,0
56041,3,3,196502,196502,196505,0,3,0
56042,1,3,196503,196505,196508,2,5,0
56043,4,2,196507,196508,196510,1,3,0
56044,4,2,196511,196511,196513,0,2,1
56045,4,2,196515,196515,196517,0,2,2
56046,1,3,196516,196517,196520,1,4,0
56047,3,3,196519,196520,196523,1,4,0
56048,4,2,196523,196523,196525,0,2,0
56049,5,1,196528,196528,196529,0,1,3
56050,1,3,196529,196529,196532,0,3,0
56051,6,2,196535,196535,196537,0,2,3
56052,3,1,196538,196538,196539,0,1,1
56053,3,3,196541,196541,196544,0,3,2
56054,5,2,196546,196546,196548,0,2,2
56055,1,3,196547,196548,196551,1,4,0
56056,5,3,196552,196552,196555,0,3,1
56057,4,1,196556,196556,196557,0,1,1
56058,3,1,196559,196559,196560,0,1,2
56059,4,3,196563,196563,196566,0,3,3
56060,4,3,196567,196567,196570,0,3,1
56061,5,3,196572,196572,196575,0,3,2
56062,4,1,196576,196576,196577,0,1,1
56063,3,3,196579,196579,196582,0,3,2
56064,1,1,196580,196582,196583,2,3,0
56065,5,1,196585,196585,196586,0,1,2
56066,2,1,196587,196587,196588,0,1,1
56067,1,3,196588,196588,196591,0,3,0
56068,6,1,196594,196594,196595,0,1,3
56069,2,2,196596,196596,196598,0,2,1
56070,2,1,196598,196598,196599,0,1,0
56071,6,3,196604,196604,196607,0,3,5
56072,6,1,196610,196610,196611,0,1,3
56073,1,2,196611,196611,196613,0,2,0
56074,5,1,196616,196616,196617,0,1,3
56075,4,1,196620,196620,196621,0,1,3
56076,6,2,196626,196626,196628,0,2,5
56077,5,2,196631,196631,196633,0,2,3
56078,4,2,196635,196635,196637,0,2,2
56079,2,2,196637,196637,196639,0,2,0
56080,5,3,196642,196642,196645,0,3,3
56081,4,1,196646,196646,196647,0,1,1
56082,1,2,196647,196647,196649,0,2,0
56083,2,3,196649,196649,196652,0,3,0
56084,1,2,196650,196652,196654,2,4,0
56085,3,3,196653,196654,196657,1,4,0
56086,5,1,196658,196658,196659,0,1,1
56087,6,1,196664,196664,196665,0,1,5
56088,4,2,196668,196668,196670,0,2,3
56089,5,2,196673,196673,196675,0,2,3
56090,4,1,196677,196677,196678,0,1,2
56091,1,3,196678,196678,196681,0,3,0
56092,4,3,196682,196682,196685,0,3,1
56093,4,1,196686,196686,196687,0,1,1
56094,1,2,196687,196687,196689,0,2,0
56095,1,3,196688,196689,196692,1,4,0
56096,6,2,196694,196694,196696,0,2,2
56097,3,1,196697,196697,196698,0,1,1
56098,6,2,196703,196703,196705,0,2,5
56099,2,3,196705,196705,196708,0,3,0
56100,3,3,196708,196708,196711,0,3,0
56101,2,2,196710,196711,196713,1,3,0
56102,2,2,196712,196713,196715,1,3,0
56103,4,2,196716,196716,196718,0,2,1
56104,4,3,196720,196720,196723,0,3,2
56105,6,3,196726,196726,196729,0,3,3
56106,2,2,196728,196729,196731,1,3,0
56107,3,1,196731,196731,196732,0,1,0
56108,5,2,196736,196736,196738,0,2,4
56109,3,2,196739,196739,196741,0,2,1
56110,2,2,196741,196741,196743,0,2,0
56111,3,1,196744,196744,196745,0,1,1
56112,2,1,196746,196746,196747,0,1,1
56113,3,1,196749,196749,196750,0,1,2
56114,2,2,196751,196751,196753,0,2,1
56115,6,1,196757,196757,196758,0,1,4
56116,2,3,196759,196759,196762,0,3,1
56117,3,2,196762,196762,196764,0,2,0
56118,4,3,196766,196766,196769,0,3,2
56119,2,2,196768,196769,196771,1,3,0
56120,2,3,196770,196771,196774,1,4,0
56121,2,2,196772,196774,196776,2,4,0
56122,4,1,196776,196776,196777,0,1,0
56123,5,3,196781,196781,196784,0,3,4
56124,6,3,196787,196787,196790,0,3,3
56125,5,1,196792,196792,196793,0,1,2
56126,6,2,196798,196798,196800,0,2,5
56127,2,3,196800,196800,196803,0,3,0
56128,5,2,196805,196805,196807,0,2,2
56129,5,3,196810,196810,196813,0,3,3
56130,4,2,196814,196814,196816,0,2,1
56131,4,1,196818,196818,196819,0,1,2
56132,5,2,196823,196823,196825,0,2,4
56133,5,1,196828,196828,196829,0,1,3
56134,1,3,196829,196829,196832,0,3,0
56135,1,1,196830,196832,196833,2,3,0
56136,5,3,196835,196835,196838,0,3,2
56137,6,3,196841,196841,196844,0,3,3
56138,5,2,196846,196846,196848,0,2,2
56139,6,2,196852,196852,196854,0,2,4
56140,5,2,196857,196857,196859,0,2,3
56141,1,1,196858,196859,196860,1,2,0
56142,3,2,196861,196861,196863,0,2,1
56143,4,3,196865,196865,196868,0,3,2
56144,5,2,196870,196870,196872,0,2,2
56145,5,3,196875,196875,196878,0,3,3
56146,5,1,196880,196880,196881,0,1,2
56147,3,2,196883,196883,196885,0,2,2
56148,2,2,196885,196885,196887,0,2,0
56149,1,1,196886,196887,196888,1,2,0
56150,1,2,196887,196888,196890,1,3,0
56151,5,3,196892,196892,196895,0,3,2
56152,3,2,196895,196895,196897,0,2,0
56153,6,1,196901,196901,196902,0,1,4
56154,4,2,196905,196905,196907,0,2,3
56155,2,2,196907,196907,196909,0,2,0
56156,6,1,196913,196913,196914,0,1,4
56157,3,2,196916,196916,196918,0,2,2
56158,5,1,196921,196921,196922,0,1,3
56159,2,2,196923,196923,196925,0,2,1
56160,2,2,196925,196925,196927,0,2,0
56161,4,2,196929,196929,196931,0,2,2
56162,4,3,196933,196933,196936,0,3,2
56163,3,3,196936,196936,196939,0,3,0
56164,5,2,196941,196941,196943,0,2,2
56165,3,1,196944,196944,196945,0,1,1
56166,4,3,196948,196948,196951,0,3,3
56167,4,3,196952,196952,196955,0,3,1
56168,1,3,196953,196955,196958,2,5,0
56169,1,3,196954,196958,196961,4,7,0
56170,2,2,196956,196961,196963,5,7,0
56171,1,1,196957,196963,196964,6,7,0
56172,2,3,196959,196964,196967,5,8,0
56173,4,2,196963,196967,196969,4,6,0
56174,2,1,196965,196969,196970,4,5,0
56175,4,1,196969,196970,196971,1,2,0
56176,1,1,196970,196971,196972,1,2,0
56177,6,2,196976,196976,196978,0,2,4
56178,1,3,196977,196978,196981,1,4,0
56179,2,1,196979,196981,196982,2,3,0
56180,2,2,196981,196982,196984,1,3,0
56181,4,1,196985,196985,196986,0,1,1
56182,2,2,196987,196987,196989,0,2,1
56183,2,2,196989,196989,196991,0,2,0
56184,1,2,196990,196991,196993,1,3,0
56185,5,2,196995,196995,196997,0,2,2
56186,4,1,196999,196999,197000,0,1,2
56187,5,2,197004,197004,197006,0,2,4
56188,4,3,197008,197008,197011,0,3,2
56189,2,1,197010,197011,197012,1,2,0
56190,1,1,197011,197012,197013,1,2,0
56191,2,2,197013,197013,197015,0,2,0
56192,1,3,197014,197015,197018,1,4,0
56193,5,2,197019,197019,197021,0,2,1
56194,6,3,197025,197025,197028,0,3,4
56195,4,3,197029,197029,197032,0,3,1
56196,2,1,197031,197032,197033,1,2,0
56197,1,3,197032,197033,197036,1,4,0
56198,2,2,197034,197036,197038,2,4,0
56199,1,1,197035,197038,197039,3,4,0
56200,1,2,197036,197039,197041,3,5,0
56201,5,1,197041,197041,197042,0,1,0
56202,4,1,197045,197045,197046,0,1,3
56203,6,1,197051,197051,197052,0,1,5
56204,4,3,197055,197055,197058,0,3,3
56205,1,2,197056,197058,197060,2,4,0
56206,4,2,197060,197060,197062,0,2,0
56207,5,3,197065,197065,197068,0,3,3
56208,6,2,197071,197071,197073,0,2,3
56209,6,3,197077,197077,197080,0,3,4
56210,5,3,197082,197082,197085,0,3,2
56211,2,3,197084,197085,197088,1,4,0
56212,4,1,197088,197088,197089,0,1,0
56213,2,3,197090,197090,197093,0,3,1
56214,6,2,197096,197096,197098,0,2,3
56215,5,2,197101,197101,197103,0,2,3
56216,6,2,197107,197107,197109,0,2,4
56217,2,3,197109,197109,197112,0,3,0
56218,5,1,197114,197114,197115,0,1,2
56219,4,1,197118,197118,197119,0,1,3
56220,1,3,197119,197119,197122,0,3,0
56221,4,1,197123,197123,197124,0,1,1
56222,5,2,197128,197128,197130,0,2,4
56223,4,3,197132,197132,197135,0,3,2
56224,1,2,197133,197135,197137,2,4,0
56225,6,2,197139,197139,197141,0,2,2
56226,6,3,197145,197145,197148,0,3,4
56227,5,2,197150,197150,197152,0,2,2
56228,2,1,197152,197152,197153,0,1,0
56229,3,2,197155,197155,197157,0,2,2
56230,6,1,197161,197161,197162,0,1,4
56231,2,3,197163,197163,197166,0,3,1
56232,4,3,197167,197167,197170,0,3,1
56233,3,3,197170,197170,197173,0,3,0
56234,3,2,197173,197173,197175,0,2,0
56235,4,2,197177,197177,197179,0,2,2
56236,2,3,197179,197179,197182,0,3,0
56237,1,2,197180,197182,197184,2,4,0
56238,1,1,197181,197184,197185,3,4,0
56239,6,3,197187,197187,197190,0,3,2
56240,3,1,197190,197190,197191,0,1,0
56241,3,1,197193,197193,197194,0,1,2
56242,6,3,197199,197199,197202,0,3,5
56243,2,2,197201,197202,197204,1,3,0
56244,1,2,197202,197204,197206,2,4,0
56245,2,1,197204,197206,197207,2,3,0
56246,1,2,197205,197207,197209,2,4,0
56247,1,1,197206,197209,197210,3,4,0
56248,4,1,197210,197210,197211,0,1,0
56249,3,2,197213,197213,197215,0,2,2
56250,3,2,197216,197216,197218,0,2,1
56251,3,1,197219,197219,197220,0,1,1
56252,2,1,197221,197221,197222,0,1,1
56253,3,3,197224,197224,197227,0,3,2
56254,1,2,197225,197227,197229,2,4,0
56255,2,1,197227,197229,197230,2,3,0
56256,3,2,197230,197230,197232,0,2,0
56257,1,3,197231,197232,197235,1,4,0
56258,2,3,197233,197235,197238,2,5,0
56259,4,3,197237,197238,197241,1,4,0
56260,5,1,197242,197242,197243,0,1,1
56261,5,3,197247,197247,197250,0,3,4
56262,3,1,197250,197250,197251,0,1,0
56263,1,3,197251,197251,197254,0,3,0
56264,3,1,197254,197254,197255,0,1,0
56265,1,1,197255,197255,197256,0,1,0
56266,1,3,197256,197256,197259,0,3,0
56267,6,2,197262,197262,197264,0,2,3
56268,3,3,197265,197265,197268,0,3,1
56269,6,2,197271,197271,197273,0,2,3
56270,1,2,197272,197273,197275,1,3,0
56271,1,1,197273,197275,197276,2,3,0
56272,3,3,197276,197276,197279,0,3,0
56273,4,1,197280,197280,197281,0,1,1
56274,6,3,197286,197286,197289,0,3,5
56275,3,1,197289,197289,197290,0,1,0
56276,1,3,197290,197290,197293,0,3,0
56277,3,1,197293,197293,197294,0,1,0
56278,4,3,197297,197297,197300,0,3,3
56279,5,2,197302,197302,197304,0,2,2
56280,1,2,197303,197304,197306,1,3,0
56281,3,2,197306,197306,197308,0,2,0
56282,2,1,197308,197308,197309,0,1,0
56283,4,2,197312,197312,197314,0,2,3
56284,6,3,197318,197318,197321,0,3,4
56285,3,2,197321,197321,197323,0,2,0
56286,4,3,197325,197325,197328,0,3,2
56287,4,2,197329,197329,197331,0,2,1
56288,5,2,197334,197334,197336,0,2,3
56289,3,3,197337,197337,197340,0,3,1
56290,6,3,197343,197343,197346,0,3,3
56291,5,2,197348,197348,197350,0,2,2
56292,3,3,197351,197351,197354,0,3,1
56293,4,3,197355,197355,197358,0,3,1
56294,5,3,197360,197360,197363,0,3,2
56295,3,3,197363,197363,197366,0,3,0
56296,6,2,197369,197369,197371,0,2,3
56297,6,1,197375,197375,197376,0,1,4
56298,6,1,197381,197381,197382,0,1,5
56299,6,1,197387,197387,197388,0,1,5
56300,2,1,197389,197389,197390,0,1,1
56301,4,1,197393,197393,197394,0,1,3
56302,3,1,197396,197396,197397,0,1,2
56303,1,3,197397,197397,197400,0,3,0
56304,1,1,197398,197400,197401,2,3,0
56305,4,3,197402,197402,197405,0,3,1
56306,2,1,197404,197405,197406,1,2,0
56307,4,2,197408,197408,197410,0,2,2
56308,5,3,197413,197413,197416,0,3,3
56309,1,3,197414,197416,197419,2,5,0
56310,6,1,197420,197420,197421,0,1,1
56311,1,1,197421,197421,197422,0,1,0
56312,5,3,197426,197426,197429,0,3,4
56313,2,3,197428,197429,197432,1,4,0
56314,1,3,197429,197432,197435,3,6,0
56315,4,3,197433,197435,197438,2,5,0
56316,5,2,197438,197438,197440,0,2,0
56317,1,2,197439,197440,197442,1,3,0
56318,2,2,197441,197442,197444,1,3,0
56319,1,2,197442,197444,197446,2,4,0
56320,3,3,197445,197446,197449,1,4,0
56321,3,1,197448,197449,197450,1,2,0
56322,2,1,197450,197450,197451,0,1,0
56323,3,1,197453,197453,197454,0,1,2
56324,5,3,197458,197458,197461,0,3,4
56325,2,2,197460,197461,197463,1,3,0
56326,3,2,197463,197463,197465,0,2,0
56327,4,1,197467,197467,197468,0,1,2
56328,4,2,197471,197471,197473,0,2,3
56329,6,1,197477,197477,197478,0,1,4
56330,5,2,197482,197482,197484,0,2,4
56331,6,1,197488,197488,197489,0,1,4
56332,5,3,197493,197493,197496,0,3,4
56333,3,1,197496,197496,197497,0,1,0
56334,2,1,197498,197498,197499,0,1,1
56335,3,3,197501,197501,197504,0,3,2
56336,1,3,197502,197504,197507,2,5,0
56337,5,2,197507,197507,197509,0,2,0
56338,4,1,197511,197511,197512,0,1,2
56339,6,1,197517,197517,197518,0,1,5
56340,4,2,197521,197521,197523,0,2,3
56341,4,1,197525,197525,197526,0,1,2
56342,5,1,197530,197530,197531,0,1,4
56343,2,2,197532,197532,197534,0,2,1
56344,4,2,197536,197536,197538,0,2,2
56345,1,1,197537,197538,197539,1,2,0
56346,5,3,197542,197542,197545,0,3,3
56347,1,2,197543,197545,197547,2,4,0
56348,4,1,197547,197547,197548,0,1,0
56349,5,3,197552,197552,197555,0,3,4
56350,1,1,197553,197555,197556,2,3,0
56351,6,1,197559,197559,197560,0,1,3
56352,4,3,197563,197563,197566,0,3,3
56353,2,1,197565,197566,197567,1,2,0
56354,6,1,197571,197571,197572,0,1,4
56355,5,1,197576,197576,197577,0,1,4
56356,6,2,197582,197582,197584,0,2,5
56357,3,1,197585,197585,197586,0,1,1
56358,3,1,197588,197588,197589,0,1,2
56359,6,1,197594,197594,197595,0,1,5
56360,4,2,197598,197598,197600,0,2,3
56361,6,3,197604,197604,197607,0,3,4
56362,2,2,197606,197607,197609,1,3,0
56363,6,2,197612,197612,197614,0,2,3
56364,2,3,197614,197614,197617,0,3,0
56365,6,3,197620,197620,197623,0,3,3
56366,3,3,197623,197623,197626,0,3,0
56367,6,3,197629,197629,197632,0,3,3
56368,2,1,197631,197632,197633,1,2,0
56369,3,2,197634,197634,197636,0,2,1
56370,5,1,197639,197639,197640,0,1,3
56371,6,3,197645,197645,197648,0,3,5
56372,6,2,197651,197651,197653,0,2,3
56373,5,2,197656,197656,197658,0,2,3
56374,2,3,197658,197658,197661,0,3,0
56375,2,2,197660,197661,197663,1,3,0
56376,1,2,197661,197663,197665,2,4,0
56377,5,3,197666,197666,197669,0,3,1
56378,4,1,197670,197670,197671,0,1,1
56379,1,1,197671,197671,197672,0,1,0
56380,2,1,197673,197673,197674,0,1,1
56381,2,3,197675,197675,197678,0,3,1
56382,5,2,197680,197680,197682,0,2,2
56383,5,2,197685,197685,197687,0,2,3
56384,5,3,197690,197690,197693,0,3,3
56385,4,1,197694,197694,197695,0,1,1
56386,3,2,197697,197697,197699,0,2,2
56387,2,3,197699,197699,197702,0,3,0
56388,3,2,197702,197702,197704,0,2,0
56389,6,2,197708,197708,197710,0,2,4
56390,4,3,197712,197712,197715,0,3,2
56391,5,1,197717,197717,197718,0,1,2
56392,1,1,197718,197718,197719,0,1,0
56393,3,2,197721,197721,197723,0,2,2
56394,3,3,197724,197724,197727,0,3,1
56395,3,3,197727,197727,197730,0,3,0
56396,5,3,197732,197732,197735,0,3,2
56397,1,3,197733,197735,197738,2,5,0
56398,5,1,197738,197738,197739,0,1,0
56399,4,1,197742,197742,197743,0,1,3
56400,1,2,197743,197743,197745,0,2,0
56401,4,3,197747,197747,197750,0,3,2
56402,6,3,197753,197753,197756,0,3,3
56403,2,3,197755,197756,197759,1,4,0
56404,2,1,197757,197759,197760,2,3,0
56405,4,1,197761,197761,197762,0,1,1
56406,3,3,197764,197764,197767,0,3,2
56407,5,1,197769,197769,197770,0,1,2
56408,4,3,197773,197773,197776,0,3,3
56409,1,2,197774,197776,197778,2,4,0
56410,1,3,197775,197778,197781,3,6,0
56411,5,2,197780,197781,197783,1,3,0
56412,5,3,197785,197785,197788,0,3,2
56413,1,3,197786,197788,197791,2,5,0
56414,5,2,197791,197791,197793,0,2,0
56415,4,1,197795,197795,197796,0,1,2
56416,5,2,197800,197800,197802,0,2,4
56417,4,3,197804,197804,197807,0,3,2
56418,5,1,197809,197809,197810,0,1,2
56419,3,1,197812,197812,197813,0,1,2
56420,3,3,197815,197815,197818,0,3,2
56421,2,2,197817,197818,197820,1,3,0
56422,2,3,197819,197820,197823,1,4,0
56423,3,2,197822,197823,197825,1,3,0
56424,2,2,197824,197825,197827,1,3,0
56425,4,3,197828,197828,197831,0,3,1
56426,1,2,197829,197831,197833,2,4,0
56427,1,3,197830,197833,197836,3,6,0
56428,6,2,197836,197836,197838,0,2,0
56429,3,1,197839,197839,197840,0,1,1
56430,6,3,197845,197845,197848,0,3,5
56431,4,2,197849,197849,197851,0,2,1
56432,3,1,197852,197852,197853,0,1,1
56433,1,2,197853,197853,197855,0,2,0
56434,1,2,197854,197855,197857,1,3,0
56435,6,2,197860,197860,197862,0,2,3
56436,2,2,197862,197862,197864,0,2,0
56437,5,2,197867,197867,197869,0,2,3
56438,3,3,197870,197870,197873,0,3,1
56439,1,3,197871,197873,197876,2,5,0
56440,5,1,197876,197876,197877,0,1,0
56441,3,2,197879,197879,197881,0,2,2
56442,3,3,197882,197882,197885,0,3,1
56443,2,1,197884,197885,197886,1,2,0
56444,1,1,197885,197886,197887,1,2,0
56445,5,1,197890,197890,197891,0,1,3
56446,4,2,197894,197894,197896,0,2,3
56447,6,3,197900,197900,197903,0,3,4
56448,1,3,197901,197903,197906,2,5,0
56449,4,3,197905,197906,197909,1,4,0
56450,5,3,197910,197910,197913,0,3,1
56451,1,1,197911,197913,197914,2,3,0
56452,3,3,197914,197914,197917,0,3,0
56453,2,1,197916,197917,197918,1,2,0
56454,5,2,197921,197921,197923,0,2,3
56455,4,3,197925,197925,197928,0,3,2
56456,1,3,197926,197928,197931,2,5,0
56457,3,1,197929,197931,197932,2,3,0
56458,4,3,197933,197933,197936,0,3,1
56459,3,3,197936,197936,197939,0,3,0
56460,2,1,197938,197939,197940,1,2,0
56461,4,3,197942,197942,197945,0,3,2
56462,3,2,197945,197945,197947,0,2,0
56463,3,1,197948,197948,197949,0,1,1
56464,2,3,197950,197950,197953,0,3,1
56465,6,2,197956,197956,197958,0,2,3
56466,4,3,197960,197960,197963,0,3,2
56467,4,3,197964,197964,197967,0,3,1
56468,4,2,197968,197968,197970,0,2,1
56469,3,1,197971,197971,197972,0,1,1
56470,2,1,197973,197973,197974,0,1,1
56471,6,2,197979,197979,197981,0,2,5
56472,1,1,197980,197981,197982,1,2,0
56473,3,1,197983,197983,197984,0,1,1
56474,1,2,197984,197984,197986,0,2,0
56475,6,2,197990,197990,197992,0,2,4
56476,4,1,197994,197994,197995,0,1,2
56477,1,2,197995,197995,197997,0,2,0
56478,2,3,197997,197997,198000,0,3,0
56479,2,3,197999,198000,198003,1,4,0
56480,5,1,198004,198004,198005,0,1,1
56481,1,3,198005,198005,198008,0,3,0
56482,2,1,198007,198008,198009,1,2,0
56483,5,3,198012,198012,198015,0,3,3
56484,5,1,198017,198017,198018,0,1,2
56485,5,1,198022,198022,198023,0,1,4
56486,1,2,198023,198023,198025,0,2,0
56487,2,2,198025,198025,198027,0,2,0
56488,1,3,198026,198027,198030,1,4,0
56489,2,1,198028,198030,198031,2,3,0
56490,6,1,198034,198034,198035,0,1,3
56491,5,2,198039,198039,198041,0,2,4
56492,1,2,198040,198041,198043,1,3,0
56493,4,1,198044,198044,198045,0,1,1
56494,2,1,198046,198046,198047,0,1,1
56495,2,1,198048,198048,198049,0,1,1
56496,5,3,198053,198053,198056,0,3,4
56497,3,1,198056,198056,198057,0,1,0
56498,6,3,198062,198062,198065,0,3,5
56499,4,2,198066,198066,198068,0,2,1
56500,1,1,198067,198068,198069,1,2,0
56501,4,1,198071,198071,198072,0,1,2
56502,6,2,198077,198077,198079,0,2,5
56503,2,3,198079,198079,198082,0,3,0
56504,5,2,198084,198084,198086,0,2,2
56505,6,2,198090,198090,198092,0,2,4
56506,6,1,198096,198096,198097,0,1,4
56507,2,3,198098,198098,198101,0,3,1
56508,4,3,198102,198102,198105,0,3,1
56509,1,1,198103,198105,198106,2,3,0
56510,1,1,198104,198106,198107,2,3,0
56511,4,1,198108,198108,198109,0,1,1
56512,5,1,198113,198113,198114,0,1,4
56513,5,1,198118,198118,198119,0,1,4
56514,3,1,198121,198121,198122,0,1,2
56515,1,3,198122,198122,198125,0,3,0
56516,5,3,198127,198127,198130,0,3,2
56517,2,3,198129,198130,198133,1,4,0
56518,3,2,198132,198133,198135,1,3,0
56519,1,3,198133,198135,198138,2,5,0
56520,6,2,198139,198139,198141,0,2,1
56521,2,3,198141,198141,198144,0,3,0
56522,5,3,198146,198146,198149,0,3,2
56523,6,3,198152,198152,198155,0,3,3
56524,6,2,198158,198158,198160,0,2,3
56525,4,2,198162,198162,198164,0,2,2
56526,1,2,198163,198164,198166,1,3,0
56527,4,3,198167,198167,198170,0,3,1
56528,5,1,198172,198172,198173,0,1,2
56529,3,1,198175,198175,198176,0,1,2
56530,2,1,198177,198177,198178,0,1,1
56531,3,2,198180,198180,198182,0,2,2
56532,5,3,198185,198185,198188,0,3,3
56533,2,1,198187,198188,198189,1,2,0
56534,5,3,198192,198192,198195,0,3,3
56535,2,3,198194,198195,198198,1,4,0
56536,5,2,198199,198199,198201,0,2,1
56537,2,3,198201,198201,198204,0,3,0
56538,6,2,198207,198207,198209,0,2,3
56539,6,3,198213,198213,198216,0,3,4
56540,2,1,198215,198216,198217,1,2,0
56541,4,3,198219,198219,198222,0,3,2
56542,1,1,198220,198222,198223,2,3,0
56543,1,2,198221,198223,198225,2,4,0
56544,3,3,198224,198225,198228,1,4,0
56545,4,1,198228,198228,198229,0,1,0
56546,4,3,198232,198232,198235,0,3,3
56547,3,3,198235,198235,198238,0,3,0
56548,3,3,198238,198238,198241,0,3,0
56549,1,3,198239,198241,198244,2,5,0
56550,3,3,198242,198244,198247,2,5,0
56551,5,2,198247,198247,198249,0,2,0
56552,3,3,198250,198250,198253,0,3,1
56553,5,3,198255,198255,198258,0,3,2
56554,3,1,198258,198258,198259,0,1,0
56555,2,1,198260,198260,198261,0,1,1
56556,5,2,198265,198265,198267,0,2,4
56557,1,1,198266,198267,198268,1,2,0
56558,6,2,198272,198272,198274,0,2,4
56559,4,1,198276,198276,198277,0,1,2
56560,3,1,198279,198279,198280,0,1,2
56561,1,2,198280,198280,198282,0,2,0
56562,4,3,198284,198284,198287,0,3,2
56563,6,3,198290,198290,198293,0,3,3
56564,3,3,198293,198293,198296,0,3,0
56565,2,1,198295,198296,198297,1,2,0
56566,5,1,198300,198300,198301,0,1,3
56567,3,1,198303,198303,198304,0,1,2
56568,4,3,198307,198307,198310,0,3,3
56569,3,1,198310,198310,198311,0,1,0
56570,5,1,198315,198315,198316,0,1,4
56571,4,3,198319,198319,198322,0,3,3
56572,1,2,198320,198322,198324,2,4,0
56573,1,3,198321,198324,198327,3,6,0
56574,1,2,198322,198327,198329,5,7,0
56575,3,2,198325,198329,198331,4,6,0
56576,5,2,198330,198331,198333,1,3,0
56577,1,2,198331,198333,198335,2,4,0
56578,2,1,198333,198335,198336,2,3,0
56579,3,1,198336,198336,198337,0,1,0
56580,6,2,198342,198342,198344,0,2,5
56581,6,2,198348,198348,198350,0,2,4
56582,4,1,198352,198352,198353,0,1,2
56583,1,1,198353,198353,198354,0,1,0
56584,4,3,198357,198357,198360,0,3,3
56585,4,3,198361,198361,198364,0,3,1
56586,1,3,198362,198364,198367,2,5,0
56587,1,2,198363,198367,198369,4,6,0
56588,4,2,198367,198369,198371,2,4,0
56589,3,2,198370,198371,198373,1,3,0
56590,3,1,198373,198373,198374,0,1,0
56591,2,3,198375,198375,198378,0,3,1
56592,6,1,198381,198381,198382,0,1,3
56593,5,2,198386,198386,198388,0,2,4
56594,2,1,198388,198388,198389,0,1,0
56595,2,1,198390,198390,198391,0,1,1
56596,3,3,198393,198393,198396,0,3,2
56597,4,3,198397,198397,198400,0,3,1
56598,4,2,198401,198401,198403,0,2,1
56599,3,3,198404,198404,198407,0,3,1
56600,3,2,198407,198407,198409,0,2,0
56601,4,2,198411,198411,198413,0,2,2
56602,6,3,198417,198417,198420,0,3,4
56603,5,1,198422,198422,198423,0,1,2
56604,3,1,198425,198425,198426,0,1,2
56605,5,2,198430,198430,198432,0,2,4
56606,6,2,198436,198436,198438,0,2,4
56607,5,1,198441,198441,198442,0,1,3
56608,3,1,198444,198444,198445,0,1,2
56609,2,2,198446,198446,198448,0,2,1
56610,1,2,198447,198448,198450,1,3,0
56611,6,3,198453,198453,198456,0,3,3
56612,5,3,198458,198458,198461,0,3,2
56613,5,2,198463,198463,198465,0,2,2
56614,1,1,198464,198465,198466,1,2,0
56615,4,2,198468,198468,198470,0,2,2
56616,2,3,198470,198470,198473,0,3,0
56617,2,3,198472,198473,198476,1,4,0
56618,2,2,198474,198476,198478,2,4,0
56619,3,3,198477,198478,198481,1,4,0
56620,3,2,198480,198481,198483,1,3,0
56621,5,3,198485,198485,198488,0,3,2
56622,2,3,198487,198488,198491,1,4,0
56623,3,1,198490,198491,198492,1,2,0
56624,2,1,198492,198492,198493,0,1,0
56625,3,2,198495,198495,198497,0,2,2
56626,2,1,198497,198497,198498,0,1,0
56627,6,3,198503,198503,198506,0,3,5
56628,6,3,198509,198509,198512,0,3,3
56629,4,2,198513,198513,198515,0,2,1
56630,3,1,198516,198516,198517,0,1,1
56631,4,2,198520,198520,198522,0,2,3
56632,5,3,198525,198525,198528,0,3,3
56633,3,1,198528,198528,198529,0,1,0
56634,2,2,198530,198530,198532,0,2,1
56635,5,3,198535,198535,198538,0,3,3
56636,4,2,198539,198539,198541,0,2,1
56637,4,3,198543,198543,198546,0,3,2
56638,1,1,198544,198546,198547,2,3,0
56639,2,3,198546,198547,198550,1,4,0
56640,5,3,198551,198551,198554,0,3,1
56641,2,2,198553,198554,198556,1,3,0
56642,3,1,198556,198556,198557,0,1,0
56643,4,3,198560,198560,198563,0,3,3
56644,2,1,198562,198563,198564,1,2,0
56645,6,1,198568,198568,198569,0,1,4
56646,6,2,198574,198574,198576,0,2,5
56647,4,3,198578,198578,198581,0,3,2
56648,2,1,198580,198581,198582,1,2,0
56649,5,3,198585,198585,198588,0,3,3
56650,2,1,198587,198588,198589,1,2,0
56651,3,3,198590,198590,198593,0,3,1
56652,3,3,198593,198593,198596,0,3,0
56653,1,3,198594,198596,198599,2,5,0
56654,4,2,198598,198599,198601,1,3,0
56655,2,2,198600,198601,198603,1,3,0
56656,4,2,198604,198604,198606,0,2,1
56657,5,2,198609,198609,198611,0,2,3
56658,4,2,198613,198613,198615,0,2,2
56659,1,2,198614,198615,198617,1,3,0
56660,2,1,198616,198617,198618,1,2,0
56661,4,3,198620,198620,198623,0,3,2
56662,1,2,198621,198623,198625,2,4,0
56663,2,3,198623,198625,198628,2,5,0
56664,6,2,198629,198629,198631,0,2,1
56665,1,2,198630,198631,198633,1,3,0
56666,3,3,198633,198633,198636,0,3,0
56667,3,1,198636,198636,198637,0,1,0
56668,1,3,198637,198637,198640,0,3,0
56669,2,2,198639,198640,198642,1,3,0
56670,4,2,198643,198643,198645,0,2,1
56671,5,1,198648,198648,198649,0,1,3
56672,6,1,198654,198654,198655,0,1,5
56673,1,2,198655,198655,198657,0,2,0
56674,4,3,198659,198659,198662,0,3,2
56675,2,3,198661,198662,198665,1,4,0
56676,1,1,198662,198665,198666,3,4,0
56677,2,3,198664,198666,198669,2,5,0
56678,5,2,198669,198669,198671,0,2,0
56679,4,1,198673,198673,198674,0,1,2
56680,3,1,198676,198676,198677,0,1,2
56681,4,3,198680,198680,198683,0,3,3
56682,2,1,198682,198683,198684,1,2,0
56683,3,3,198685,198685,198688,0,3,1
56684,5,3,198690,198690,198693,0,3,2
56685,1,3,198691,198693,198696,2,5,0
56686,6,3,198697,198697,198700,0,3,1
56687,5,2,198702,198702,198704,0,2,2
56688,5,3,198707,198707,198710,0,3,3
56689,6,3,198713,198713,198716,0,3,3
56690,4,1,198717,198717,198718,0,1,1
56691,5,2,198722,198722,198724,0,2,4
56692,3,1,198725,198725,198726,0,1,1
56693,3,3,198728,198728,198731,0,3,2
56694,2,3,198730,198731,198734,1,4,0
56695,2,2,198732,198734,198736,2,4,0
56696,1,3,198733,198736,198739,3,6,0
56697,3,3,198736,198739,198742,3,6,0
56698,6,3,198742,198742,198745,0,3,0
56699,5,3,198747,198747,198750,0,3,2
56700,6,1,198753,198753,198754,0,1,3
56701,3,3,198756,198756,198759,0,3,2
56702,2,2,198758,198759,198761,1,3,0
56703,2,2,198760,198761,198763,1,3,0
56704,5,2,198765,198765,198767,0,2,2
56705,2,1,198767,198767,198768,0,1,0
56706,4,1,198771,198771,198772,0,1,3
56707,1,2,198772,198772,198774,0,2,0
56708,5,2,198777,198777,198779,0,2,3
56709,6,1,198783,198783,198784,0,1,4
56710,5,1,198788,198788,198789,0,1,4
56711,1,1,198789,198789,198790,0,1,0
56712,1,1,198790,198790,198791,0,1,0
56713,6,2,198796,198796,198798,0,2,5
56714,4,1,198800,198800,198801,0,1,2
56715,2,2,198802,198802,198804,0,2,1
56716,5,3,198807,198807,198810,0,3,3
56717,3,1,198810,198810,198811,0,1,0
56718,2,1,198812,198812,198813,0,1,1
56719,3,3,198815,198815,198818,0,3,2
56720,3,1,198818,198818,198819,0,1,0
56721,2,1,198820,198820,198821,0,1,1
56722,2,2,198822,198822,198824,0,2,1
56723,4,1,198826,198826,198827,0,1,2
56724,5,3,198831,198831,198834,0,3,4
56725,2,3,198833,198834,198837,1,4,0
56726,1,2,198834,198837,198839,3,5,0
56727,2,1,198836,198839,198840,3,4,0
56728,6,1,198842,198842,198843,0,1,2
56729,2,1,198844,198844,198845,0,1,1
56730,5,3,198849,198849,198852,0,3,4
56731,2,3,198851,198852,198855,1,4,0
56732,3,2,198854,198855,198857,1,3,0
56733,1,2,198855,198857,198859,2,4,0
56734,4,3,198859,198859,198862,0,3,0
56735,2,3,198861,198862,198865,1,4,0
56736,6,1,198867,198867,198868,0,1,2
56737,3,1,198870,198870,198871,0,1,2
56738,5,3,198875,198875,198878,0,3,4
56739,3,3,198878,198878,198881,0,3,0
56740,3,1,198881,198881,198882,0,1,0
56741,6,3,198887,198887,198890,0,3,5
56742,2,2,198889,198890,198892,1,3,0
56743,5,2,198894,198894,198896,0,2,2
56744,5,2,198899,198899,198901,0,2,3
56745,3,2,198902,198902,198904,0,2,1
56746,4,1,198906,198906,198907,0,1,2
56747,4,3,198910,198910,198913,0,3,3
56748,4,1,198914,198914,198915,0,1,1
56749,5,2,198919,198919,198921,0,2,4
56750,4,3,198923,198923,198926,0,3,2
56751,6,3,198929,198929,198932,0,3,3
56752,2,3,198931,198932,198935,1,4,0
56753,5,2,198936,198936,198938,0,2,1
56754,3,1,198939,198939,198940,0,1,1
56755,1,1,198940,198940,198941,0,1,0
56756,2,3,198942,198942,198945,0,3,1
56757,5,1,198947,198947,198948,0,1,2
56758,5,2,198952,198952,198954,0,2,4
56759,5,2,198957,198957,198959,0,2,3
56760,4,2,198961,198961,198963,0,2,2
56761,2,1,198963,198963,198964,0,1,0
56762,2,1,198965,198965,198966,0,1,1
56763,5,3,198970,198970,198973,0,3,4
56764,5,2,198975,198975,198977,0,2,2
56765,6,1,198981,198981,198982,0,1,4
56766,1,3,198982,198982,198985,0,3,0
56767,6,1,198988,198988,198989,0,1,3
56768,5,1,198993,198993,198994,0,1,4
56769,4,2,198997,198997,198999,0,2,3
56770,6,1,199003,199003,199004,0,1,4
56771,4,3,199007,199007,199010,0,3,3
56772,1,1,199008,199010,199011,2,3,0
56773,1,2,199009,199011,199013,2,4,0
56774,3,1,199012,199013,199014,1,2,0
56775,4,2,199016,199016,199018,0,2,2
56776,4,3,199020,199020,199023,0,3,2
56777,6,1,199026,199026,199027,0,1,3
56778,6,2,199032,199032,199034,0,2,5
56779,3,2,199035,199035,199037,0,2,1
56780,3,1,199038,199038,199039,0,1,1
56781,2,2,199040,199040,199042,0,2,1
56782,5,1,199045,199045,199046,0,1,3
56783,1,3,199046,199046,199049,0,3,0
56784,1,2,199047,199049,199051,2,4,0
56785,6,2,199053,199053,199055,0,2,2
56786,3,1,199056,199056,199057,0,1,1
56787,5,3,199061,199061,199064,0,3,4
56788,6,1,199067,199067,199068,0,1,3
56789,5,1,199072,199072,199073,0,1,4
56790,5,1,199077,199077,199078,0,1,4
56791,1,1,199078,199078,199079,0,1,0
56792,5,3,199083,199083,199086,0,3,4
56793,4,1,199087,199087,199088,0,1,1
56794,4,2,199091,199091,199093,0,2,3
56795,5,1,199096,199096,199097,0,1,3
56796,4,1,199100,199100,199101,0,1,3
56797,2,3,199102,199102,199105,0,3,1
56798,6,2,199108,199108,199110,0,2,3
56799,4,3,199112,199112,199115,0,3,2
56800,6,1,199118,199118,199119,0,1,3
56801,3,3,199121,199121,199124,0,3,2
56802,2,3,199123,199124,199127,1,4,0
56803,6,2,199129,199129,199131,0,2,2
56804,4,2,199133,199133,199135,0,2,2
56805,6,3,199139,199139,199142,0,3,4
56806,3,2,199142,199142,199144,0,2,0
56807,3,3,199145,199145,199148,0,3,1
56808,1,2,199146,199148,199150,2,4,0
56809,3,3,199149,199150,199153,1,4,0
56810,4,2,199153,199153,199155,0,2,0
56811,2,1,199155,199155,199156,0,1,0
56812,6,3,199161,199161,199164,0,3,5
56813,4,1,199165,199165,199166,0,1,1
56814,2,3,199167,199167,199170,0,3,1
56815,1,1,199168,199170,199171,2,3,0
56816,1,3,199169,199171,199174,2,5,0
56817,2,2,199171,199174,199176,3,5,0
56818,4,3,199175,199176,199179,1,4,0
56819,4,1,199179,199179,199180,0,1,0
56820,6,1,199185,199185,199186,0,1,5
56821,4,3,199189,199189,199192,0,3,3
56822,2,3,199191,199192,199195,1,4,0
56823,5,1,199196,199196,199197,0,1,1
56824,1,2,199197,199197,199199,0,2,0
56825,2,1,199199,199199,199200,0,1,0
56826,3,3,199202,199202,199205,0,3,2
56827,3,1,199205,199205,199206,0,1,0
56828,5,2,199210,199210,199212,0,2,4
56829,3,1,199213,199213,199214,0,1,1
56830,4,2,199217,199217,199219,0,2,3
56831,6,1,199223,199223,199224,0,1,4
56832,3,2,199226,199226,199228,0,2,2
56833,1,2,199227,199228,199230,1,3,0
56834,4,1,199231,199231,199232,0,1,1
56835,2,1,199233,199233,199234,0,1,1
56836,1,2,199234,199234,199236,0,2,0
56837,4,3,199238,199238,199241,0,3,2
56838,3,2,199241,199241,199243,0,2,0
56839,4,3,199245,199245,199248,0,3,2
56840,2,2,199247,199248,199250,1,3,0
56841,4,3,199251,199251,199254,0,3,1
56842,4,3,199255,199255,199258,0,3,1
56843,2,2,199257,199258,199260,1,3,0
56844,4,3,199261,199261,199264,0,3,1
56845,4,2,199265,199265,199267,0,2,1
56846,2,1,199267,199267,199268,0,1,0
56847,2,1,199269,199269,199270,0,1,1
56848,5,2,199274,199274,199276,0,2,4
56849,6,3,199280,199280,199283,0,3,4
56850,6,1,199286,199286,199287,0,1,3
56851,1,1,199287,199287,199288,0,1,0
56852,5,3,199292,199292,199295,0,3,4
56853,5,2,199297,199297,199299,0,2,2
56854,5,2,199302,199302,199304,0,2,3
56855,5,3,199307,199307,199310,0,3,3
56856,6,2,199313,199313,199315,0,2,3
56857,1,1,199314,199315,199316,1,2,0
56858,3,1,199317,199317,199318,0,1,1
56859,6,1,199323,199323,199324,0,1,5
56860,1,1,199324,199324,199325,0,1,0
56861,6,1,199330,199330,199331,0,1,5
56862,2,3,199332,199332,199335,0,3,1
56863,3,3,199335,199335,199338,0,3,0
56864,3,2,199338,199338,199340,0,2,0
56865,3,2,199341,199341,199343,0,2,1
56866,4,2,199345,199345,199347,0,2,2
56867,4,2,199349,199349,199351,0,2,2
56868,6,2,199355,199355,199357,0,2,4
56869,2,2,199357,199357,199359,0,2,0
56870,5,1,199362,199362,199363,0,1,3
56871,4,2,199366,199366,199368,0,2,3
56872,2,2,199368,199368,199370,0,2,0
56873,1,2,199369,199370,199372,1,3,0
56874,3,3,199372,199372,199375,0,3,0
56875,3,1,199375,199375,199376,0,1,0
56876,4,3,199379,199379,199382,0,3,3
56877,4,2,199383,199383,199385,0,2,1
56878,6,3,199389,199389,199392,0,3,4
56879,6,2,199395,199395,199397,0,2,3
56880,1,2,199396,199397,199399,1,3,0
56881,6,2,199402,199402,199404,0,2,3
56882,4,2,199406,199406,199408,0,2,2
56883,6,2,199412,199412,199414,0,2,4
56884,5,2,199417,199417,199419,0,2,3
56885,3,1,199420,199420,199421,0,1,1
56886,5,1,199425,199425,199426,0,1,4
56887,1,1,199426,199426,199427,0,1,0
56888,4,3,199430,199430,199433,0,3,3
56889,3,1,199433,199433,199434,0,1,0
56890,4,2,199437,199437,199439,0,2,3
56891,4,3,199441,199441,199444,0,3,2
56892,4,2,199445,199445,199447,0,2,1
56893,2,1,199447,199447,199448,0,1,0
56894,1,1,199448,199448,199449,0,1,0
56895,4,3,199452,199452,199455,0,3,3
56896,2,1,199454,199455,199456,1,2,0
56897,3,3,199457,199457,199460,0,3,1
56898,6,1,199463,199463,199464,0,1,3
56899,6,3,199469,199469,199472,0,3,5
56900,1,3,199470,199472,199475,2,5,0
56901,3,2,199473,199475,199477,2,4,0
56902,2,2,199475,199477,199479,2,4,0
56903,2,3,199477,199479,199482,2,5,0
56904,2,3,199479,199482,199485,3,6,0
56905,5,1,199484,199485,199486,1,2,0
56906,3,2,199487,199487,199489,0,2,1
56907,6,2,199493,199493,199495,0,2,4
56908,6,1,199499,199499,199500,0,1,4
56909,6,2,199505,199505,199507,0,2,5
56910,4,1,199509,199509,199510,0,1,2
56911,6,1,199515,199515,199516,0,1,5
56912,5,3,199520,199520,199523,0,3,4
56913,5,2,199525,199525,199527,0,2,2
56914,6,2,199531,199531,199533,0,2,4
56915,6,2,199537,199537,199539,0,2,4
56916,2,1,199539,199539,199540,0,1,0
56917,5,3,199544,199544,199547,0,3,4
56918,5,1,199549,199549,199550,0,1,2
56919,3,2,199552,199552,199554,0,2,2
56920,4,1,199556,199556,199557,0,1,2
56921,1,1,199557,199557,199558,0,1,0
56922,3,2,199560,199560,199562,0,2,2
56923,3,1,199563,199563,199564,0,1,1
56924,2,3,199565,199565,199568,0,3,1
56925,5,1,199570,199570,199571,0,1,2
56926,2,1,199572,199572,199573,0,1,1
56927,1,3,199573,199573,199576,0,3,0
56928,5,3,199578,199578,199581,0,3,2
56929,2,2,199580,199581,199583,1,3,0
56930,2,3,199582,199583,199586,1,4,0
56931,1,2,199583,199586,199588,3,5,0
56932,1,3,199584,199588,199591,4,7,0
56933,6,3,199590,199591,199594,1,4,0
56934,5,3,199595,199595,199598,0,3,1
56935,3,1,199598,199598,199599,0,1,0
56936,3,1,199601,199601,199602,0,1,2
56937,5,3,199606,199606,199609,0,3,4
56938,2,1,199608,199609,199610,1,2,0
56939,5,2,199613,199613,199615,0,2,3
56940,6,2,199619,199619,199621,0,2,4
56941,5,2,199624,199624,199626,0,2,3
56942,2,2,199626,199626,199628,0,2,0
56943,5,2,199631,199631,199633,0,2,3
56944,2,1,199633,199633,199634,0,1,0
56945,4,1,199637,199637,199638,0,1,3
56946,1,1,199638,199638,199639,0,1,0
56947,3,2,199641,199641,199643,0,2,2
56948,5,2,199646,199646,199648,0,2,3
56949,6,1,199652,199652,199653,0,1,4
56950,4,3,199656,199656,199659,0,3,3
56951,1,3,199657,199659,199662,2,5,0
56952,1,1,199658,199662,199663,4,5,0
56953,1,1,199659,199663,199664,4,5,0
56954,2,1,199661,199664,199665,3,4,0
56955,1,1,199662,199665,199666,3,4,0
56956,1,1,199663,199666,199667,3,4,0
56957,5,2,199668,199668,199670,0,2,1
56958,3,2,199671,199671,199673,0,2,1
56959,4,3,199675,199675,199678,0,3,2
56960,2,3,199677,199678,199681,1,4,0
56961,6,2,199683,199683,199685,0,2,2
56962,6,1,199689,199689,199690,0,1,4
56963,4,2,199693,199693,199695,0,2,3
56964,3,1,199696,199696,199697,0,1,1
56965,5,1,199701,199701,199702,0,1,4
56966,6,1,199707,199707,199708,0,1,5
56967,2,3,199709,199709,199712,0,3,1
56968,5,3,199714,199714,199717,0,3,2
56969,1,1,199715,199717,199718,2,3,0
56970,1,2,199716,199718,199720,2,4,0
56971,1,1,199717,199720,199721,3,4,0
56972,6,1,199723,199723,199724,0,1,2
56973,2,3,199725,199725,199728,0,3,1
56974,4,1,199729,199729,199730,0,1,1
56975,6,3,199735,199735,199738,0,3,5
56976,4,2,199739,199739,199741,0,2,1
56977,2,3,199741,199741,199744,0,3,0
56978,6,3,199747,199747,199750,0,3,3
56979,5,3,199752,199752,199755,0,3,2
56980,5,3,199757,199757,199760,0,3,2
56981,6,1,199763,199763,199764,0,1,3
56982,2,1,199765,199765,199766,0,1,1
56983,1,3,199766,199766,199769,0,3,0
56984,2,2,199768,199769,199771,1,3,0
56985,6,2,199774,199774,199776,0,2,3
56986,2,2,199776,199776,199778,0,2,0
56987,3,2,199779,199779,199781,0,2,1
56988,1,2,199780,199781,199783,1,3,0
56989,6,2,199786,199786,199788,0,2,3
56990,4,3,199790,199790,199793,0,3,2
56991,3,1,199793,199793,199794,0,1,0
56992,2,3,199795,199795,199798,0,3,1
56993,1,1,199796,199798,199799,2,3,0
56994,4,3,199800,199800,199803,0,3,1
56995,2,1,199802,199803,199804,1,2,0
56996,6,1,199808,199808,199809,0,1,4
56997,5,3,199813,199813,199816,0,3,4
56998,1,2,199814,199816,199818,2,4,0
56999,2,2,199816,199818,199820,2,4,0
57000,4,2,199820,199820,199822,0,2,0
57001,4,1,199824,199824,199825,0,1,2
57002,3,2,199827,199827,199829,0,2,2
57003,2,2,199829,199829,199831,0,2,0
57004,3,3,199832,199832,199835,0,3,1
57005,1,1,199833,199835,199836,2,3,0
57006,5,1,199838,199838,199839,0,1,2
57007,4,1,199842,199842,199843,0,1,3
57008,5,2,199847,199847,199849,0,2,4
57009,1,1,199848,199849,199850,1,2,0
57010,1,3,199849,199850,199853,1,4,0
57011,4,2,199853,199853,199855,0,2,0
57012,6,3,199859,199859,199862,0,3,4
57013,2,1,199861,199862,199863,1,2,0
57014,5,2,199866,199866,199868,0,2,3
57015,2,3,199868,199868,199871,0,3,0
57016,4,3,199872,199872,199875,0,3,1
57017,4,2,199876,199876,199878,0,2,1
57018,5,3,199881,199881,199884,0,3,3
57019,2,2,199883,199884,199886,1,3,0
57020,2,3,199885,199886,199889,1,4,0
57021,4,1,199889,199889,199890,0,1,0
57022,4,2,199893,199893,199895,0,2,3
57023,6,2,199899,199899,199901,0,2,4
57024,6,1,199905,199905,199906,0,1,4
57025,1,1,199906,199906,199907,0,1,0
57026,4,1,199910,199910,199911,0,1,3
57027,6,1,199916,199916,199917,0,1,5
57028,4,3,199920,199920,199923,0,3,3
57029,1,1,199921,199923,199924,2,3,0
57030,3,3,199924,199924,199927,0,3,0
57031,3,1,199927,199927,199928,0,1,0
57032,6,1,199933,199933,199934,0,1,5
57033,2,2,199935,199935,199937,0,2,1
57034,2,2,199937,199937,199939,0,2,0
57035,4,1,199941,199941,199942,0,1,2
57036,1,1,199942,199942,199943,0,1,0
57037,1,1,199943,199943,199944,0,1,0
57038,4,2,199947,199947,199949,0,2,3
57039,2,3,199949,199949,199952,0,3,0
57040,2,3,199951,199952,199955,1,4,0
57041,5,1,199956,199956,199957,0,1,1
57042,2,2,199958,199958,199960,0,2,1
57043,4,2,199962,199962,199964,0,2,2
57044,4,1,199966,199966,199967,0,1,2
57045,3,3,199969,199969,199972,0,3,2
57046,5,3,199974,199974,199977,0,3,2
57047,1,2,199975,199977,199979,2,4,0
57048,4,2,199979,199979,199981,0,2,0
57049,4,3,199983,199983,199986,0,3,2
57050,3,2,199986,199986,199988,0,2,0
57051,1,3,199987,199988,199991,1,4,0
57052,1,1,199988,199991,199992,3,4,0
57053,6,1,199994,199994,199995,0,1,2
57054,1,3,199995,199995,199998,0,3,0
57055,6,3,200001,200001,200004,0,3,3
57056,4,2,200005,200005,200007,0,2,1
57057,3,1,200008,200008,200009,0,1,1
57058,4,3,200012,200012,200015,0,3,3
57059,3,2,200015,200015,200017,0,2,0
57060,1,2,200016,200017,200019,1,3,0
57061,4,1,200020,200020,200021,0,1,1
57062,2,2,200022,200022,200024,0,2,1
57063,3,3,200025,200025,200028,0,3,1
57064,1,2,200026,200028,200030,2,4,0
57065,4,3,200030,200030,200033,0,3,0
57066,2,2,200032,200033,200035,1,3,0
57067,3,1,200035,200035,200036,0,1,0
57068,1,1,200036,200036,200037,0,1,0
57069,2,3,200038,200038,200041,0,3,1
57070,6,3,200044,200044,200047,0,3,3
57071,3,2,200047,200047,200049,0,2,0
57072,3,3,200050,200050,200053,0,3,1
57073,1,1,200051,200053,200054,2,3,0
57074,2,1,200053,200054,200055,1,2,0
57075,3,1,200056,200056,200057,0,1,1
57076,1,1,200057,200057,200058,0,1,0
57077,3,3,200060,200060,200063,0,3,2
57078,6,2,200066,200066,200068,0,2,3
57079,2,1,200068,200068,200069,0,1,0
57080,1,3,200069,200069,200072,0,3,0
57081,2,1,200071,200072,200073,1,2,0
57082,3,3,200074,200074,200077,0,3,1
57083,6,3,200080,200080,200083,0,3,3
57084,1,1,200081,200083,200084,2,3,0
57085,6,3,200087,200087,200090,0,3,3
57086,1,1,200088,200090,200091,2,3,0
57087,6,1,200094,200094,200095,0,1,3
57088,1,1,200095,200095,200096,0,1,0
57089,2,3,200097,200097,200100,0,3,1
57090,4,1,200101,200101,200102,0,1,1
57091,4,3,200105,200105,200108,0,3,3
57092,2,3,200107,200108,200111,1,4,0
57093,6,3,200113,200113,200116,0,3,2
57094,1,3,200114,200116,200119,2,5,0
57095,5,2,200119,200119,200121,0,2,0
57096,6,2,200125,200125,200127,0,2,4
57097,4,3,200129,200129,200132,0,3,2
57098,2,3,200131,200132,200135,1,4,0
57099,2,3,200133,200135,200138,2,5,0
57100,2,2,200135,200138,200140,3,5,0
57101,1,3,200136,200140,200143,4,7,0
57102,1,2,200137,200143,200145,6,8,0
57103,6,3,200143,200145,200148,2,5,0
57104,6,3,200149,200149,200152,0,3,1
57105,3,3,200152,200152,200155,0,3,0
57106,6,2,200158,200158,200160,0,2,3
57107,6,1,200164,200164,200165,0,1,4
57108,4,3,200168,200168,200171,0,3,3
57109,4,2,200172,200172,200174,0,2,1
57110,6,3,200178,200178,200181,0,3,4
57111,5,1,200183,200183,200184,0,1,2
57112,5,3,200188,200188,200191,0,3,4
57113,6,2,200194,200194,200196,0,2,3
57114,5,2,200199,200199,200201,0,2,3
57115,6,2,200205,200205,200207,0,2,4
57116,6,1,200211,200211,200212,0,1,4
57117,5,1,200216,200216,200217,0,1,4
57118,6,2,200222,200222,200224,0,2,5
57119,1,1,200223,200224,200225,1,2,0
57120,5,2,200228,200228,200230,0,2,3
57121,2,2,200230,200230,200232,0,2,0
57122,6,3,200236,200236,200239,0,3,4
57123,4,3,200240,200240,200243,0,3,1
57124,5,2,200245,200245,200247,0,2,2
57125,3,2,200248,200248,200250,0,2,1
57126,1,2,200249,200250,200252,1,3,0
57127,6,1,200255,200255,200256,0,1,3
57128,2,3,200257,200257,200260,0,3,1
57129,2,3,200259,200260,200263,1,4,0
57130,4,2,200263,200263,200265,0,2,0
57131,2,3,200265,200265,200268,0,3,0
57132,4,2,200269,200269,200271,0,2,1
57133,4,1,200273,200273,200274,0,1,2
57134,2,2,200275,200275,200277,0,2,1
57135,4,3,200279,200279,200282,0,3,2
57136,1,3,200280,200282,200285,2,5,0
57137,4,2,200284,200285,200287,1,3,0
57138,1,2,200285,200287,200289,2,4,0
57139,1,2,200286,200289,200291,3,5,0
57140,4,3,200290,200291,200294,1,4,0
57141,3,1,200293,200294,200295,1,2,0
57142,3,3,200296,200296,200299,0,3,1
57143,4,3,200300,200300,200303,0,3,1
57144,2,2,200302,200303,200305,1,3,0
57145,4,2,200306,200306,200308,0,2,1
57146,6,1,200312,200312,200313,0,1,4
57147,6,1,200318,200318,200319,0,1,5
57148,1,2,200319,200319,200321,0,2,0
57149,2,1,200321,200321,200322,0,1,0
57150,4,1,200325,200325,200326,0,1,3
57151,4,2,200329,200329,200331,0,2,3
57152,4,3,200333,200333,200336,0,3,2
57153,5,2,200338,200338,200340,0,2,2
57154,5,2,200343,200343,200345,0,2,3
57155,2,2,200345,200345,200347,0,2,0
57156,3,3,200348,200348,200351,0,3,1
57157,3,1,200351,200351,200352,0,1,0
57158,4,2,200355,200355,200357,0,2,3
57159,1,1,200356,200357,200358,1,2,0
57160,1,2,200357,200358,200360,1,3,0
57161,6,1,200363,200363,200364,0,1,3
57162,5,2,200368,200368,200370,0,2,4
57163,4,2,200372,200372,200374,0,2,2
57164,6,1,200378,200378,200379,0,1,4
57165,1,2,200379,200379,200381,0,2,0
57166,4,3,200383,200383,200386,0,3,2
57167,1,2,200384,200386,200388,2,4,0
57168,1,2,200385,200388,200390,3,5,0
57169,2,2,200387,200390,200392,3,5,0
57170,2,2,200389,200392,200394,3,5,0
57171,3,3,200392,200394,200397,2,5,0
57172,1,2,200393,200397,200399,4,6,0
57173,4,1,200397,200399,200400,2,3,0
57174,1,3,200398,200400,200403,2,5,0
57175,3,3,200401,200403,200406,2,5,0
57176,6,2,200407,200407,200409,0,2,1
57177,5,2,200412,200412,200414,0,2,3
57178,3,2,200415,200415,200417,0,2,1
57179,6,2,200421,200421,200423,0,2,4
57180,3,2,200424,200424,200426,0,2,1
57181,2,1,200426,200426,200427,0,1,0
57182,5,2,200431,200431,200433,0,2,4
57183,6,3,200437,200437,200440,0,3,4
57184,6,2,200443,200443,200445,0,2,3
57185,1,1,200444,200445,200446,1,2,0
57186,5,3,200449,200449,200452,0,3,3
57187,2,3,200451,200452,200455,1,4,0
57188,6,2,200457,200457,200459,0,2,2
57189,3,3,200460,200460,200463,0,3,1
57190,3,1,200463,200463,200464,0,1,0
57191,1,3,200464,200464,200467,0,3,0
57192,6,2,200470,200470,200472,0,2,3
57193,2,2,200472,200472,200474,0,2,0
57194,4,3,200476,200476,200479,0,3,2
57195,5,2,200481,200481,200483,0,2,2
57196,4,2,200485,200485,200487,0,2,2
57197,4,3,200489,200489,200492,0,3,2
57198,5,1,200494,200494,200495,0,1,2
57199,4,3,200498,200498,200501,0,3,3
57200,1,2,200499,200501,200503,2,4,0
57201,5,1,200504,200504,200505,0,1,1
57202,4,1,200508,200508,200509,0,1,3
57203,4,3,200512,200512,200515,0,3,3
57204,3,2,200515,200515,200517,0,2,0
57205,4,1,200519,200519,200520,0,1,2
57206,3,2,200522,200522,200524,0,2,2
57207,2,2,200524,200524,200526,0,2,0
57208,4,3,200528,200528,200531,0,3,2
57209,2,2,200530,200531,200533,1,3,0
57210,6,3,200536,200536,200539,0,3,3
57211,6,1,200542,200542,200543,0,1,3
57212,5,2,200547,200547,200549,0,2,4
57213,2,3,200549,200549,200552,0,3,0
57214,4,1,200553,200553,200554,0,1,1
57215,4,3,200557,200557,200560,0,3,3
57216,5,2,200562,200562,200564,0,2,2
57217,5,1,200567,200567,200568,0,1,3
57218,2,3,200569,200569,200572,0,3,1
57219,3,3,200572,200572,200575,0,3,0
57220,1,3,200573,200575,200578,2,5,0
57221,4,2,200577,200578,200580,1,3,0
57222,2,3,200579,200580,200583,1,4,0
57223,1,2,200580,200583,200585,3,5,0
57224,3,3,200583,200585,200588,2,5,0
57225,4,1,200587,200588,200589,1,2,0
57226,1,1,200588,200589,200590,1,2,0
57227,6,2,200594,200594,200596,0,2,4
57228,2,2,200596,200596,200598,0,2,0
57229,5,1,200601,200601,200602,0,1,3
57230,4,1,200605,200605,200606,0,1,3
57231,4,3,200609,200609,200612,0,3,3
57232,6,2,200615,200615,200617,0,2,3
57233,3,2,200618,200618,200620,0,2,1
57234,2,1,200620,200620,200621,0,1,0
57235,2,3,200622,200622,200625,0,3,1
57236,2,2,200624,200625,200627,1,3,0
57237,6,2,200630,200630,200632,0,2,3
57238,6,3,200636,200636,200639,0,3,4
57239,2,1,200638,200639,200640,1,2,0
57240,1,2,200639,200640,200642,1,3,0
57241,3,2,200642,200642,200644,0,2,0
57242,2,3,200644,200644,200647,0,3,0
57243,5,1,200649,200649,200650,0,1,2
57244,1,1,200650,200650,200651,0,1,0
57245,2,2,200652,200652,200654,0,2,1
57246,3,3,200655,200655,200658,0,3,1
57247,2,2,200657,200658,200660,1,3,0
57248,6,1,200663,200663,200664,0,1,3
57249,1,2,200664,200664,200666,0,2,0
57250,5,2,200669,200669,200671,0,2,3
57251,2,2,200671,200671,200673,0,2,0
57252,1,3,200672,200673,200676,1,4,0
57253,1,3,200673,200676,200679,3,6,0
57254,4,3,200677,200679,200682,2,5,0
57255,1,2,200678,200682,200684,4,6,0
57256,5,2,200683,200684,200686,1,3,0
57257,5,3,200688,200688,200691,0,3,2
57258,3,2,200691,200691,200693,0,2,0
57259,6,2,200697,200697,200699,0,2,4
57260,5,3,200702,200702,200705,0,3,3
57261,4,1,200706,200706,200707,0,1,1
57262,3,1,200709,200709,200710,0,1,2
57263,5,1,200714,200714,200715,0,1,4
57264,4,2,200718,200718,200720,0,2,3
57265,4,3,200722,200722,200725,0,3,2
57266,4,3,200726,200726,200729,0,3,1
57267,4,2,200730,200730,200732,0,2,1
57268,4,1,200734,200734,200735,0,1,2
57269,1,3,200735,200735,200738,0,3,0
57270,5,1,200740,200740,200741,0,1,2
57271,6,3,200746,200746,200749,0,3,5
57272,1,3,200747,200749,200752,2,5,0
57273,1,2,200748,200752,200754,4,6,0
57274,5,2,200753,200754,200756,1,3,0
57275,1,2,200754,200756,200758,2,4,0
57276,4,3,200758,200758,200761,0,3,0
57277,2,1,200760,200761,200762,1,2,0
57278,1,1,200761,200762,200763,1,2,0
57279,5,1,200766,200766,200767,0,1,3
57280,3,1,200769,200769,200770,0,1,2
57281,2,2,200771,200771,200773,0,2,1
57282,1,2,200772,200773,200775,1,3,0
57283,6,3,200778,200778,200781,0,3,3
57284,2,2,200780,200781,200783,1,3,0
57285,1,3,200781,200783,200786,2,5,0
57286,3,1,200784,200786,200787,2,3,0
57287,4,1,200788,200788,200789,0,1,1
57288,1,2,200789,200789,200791,0,2,0
57289,3,3,200792,200792,200795,0,3,1
57290,4,3,200796,200796,200799,0,3,1
57291,3,1,200799,200799,200800,0,1,0
57292,2,3,200801,200801,200804,0,3,1
57293,6,2,200807,200807,200809,0,2,3
57294,6,3,200813,200813,200816,0,3,4
57295,4,2,200817,200817,200819,0,2,1
57296,1,1,200818,200819,200820,1,2,0
57297,4,2,200822,200822,200824,0,2,2
57298,5,3,200827,200827,200830,0,3,3
57299,1,1,200828,200830,200831,2,3,0
57300,6,3,200834,200834,200837,0,3,3
57301,5,1,200839,200839,200840,0,1,2
57302,2,2,200841,200841,200843,0,2,1
57303,4,3,200845,200845,200848,0,3,2
57304,6,3,200851,200851,200854,0,3,3
57305,1,1,200852,200854,200855,2,3,0
57306,6,3,200858,200858,200861,0,3,3
57307,1,1,200859,200861,200862,2,3,0
57308,6,2,200865,200865,200867,0,2,3
57309,6,1,200871,200871,200872,0,1,4
57310,4,3,200875,200875,200878,0,3,3
57311,6,2,200881,200881,200883,0,2,3
57312,4,1,200885,200885,200886,0,1,2
57313,1,2,200886,200886,200888,0,2,0
57314,5,2,200891,200891,200893,0,2,3
57315,2,3,200893,200893,200896,0,3,0
57316,2,3,200895,200896,200899,1,4,0
57317,2,2,200897,200899,200901,2,4,0
57318,5,2,200902,200902,200904,0,2,1
57319,3,1,200905,200905,200906,0,1,1
57320,6,2,200911,200911,200913,0,2,5
57321,3,2,200914,200914,200916,0,2,1
57322,6,1,200920,200920,200921,0,1,4
57323,4,2,200924,200924,200926,0,2,3
57324,1,3,200925,200926,200929,1,4,0
57325,5,1,200930,200930,200931,0,1,1
57326,1,2,200931,200931,200933,0,2,0
57327,4,3,200935,200935,200938,0,3,2
57328,6,1,200941,200941,200942,0,1,3
57329,4,3,200945,200945,200948,0,3,3
57330,4,1,200949,200949,200950,0,1,1
57331,3,2,200952,200952,200954,0,2,2
57332,3,2,200955,200955,200957,0,2,1
57333,6,2,200961,200961,200963,0,2,4
57334,4,2,200965,200965,200967,0,2,2
57335,5,2,200970,200970,200972,0,2,3
57336,5,2,200975,200975,200977,0,2,3
57337,6,3,200981,200981,200984,0,3,4
57338,6,2,200987,200987,200989,0,2,3
57339,3,1,200990,200990,200991,0,1,1
57340,4,1,200994,200994,200995,0,1,3
57341,1,2,200995,200995,200997,0,2,0
57342,2,2,200997,200997,200999,0,2,0
57343,5,2,201002,201002,201004,0,2,3
57344,1,2,201003,201004,201006,1,3,0
57345,1,2,201004,201006,201008,2,4,0
57346,3,2,201007,201008,201010,1,3,0
57347,6,3,201013,201013,201016,0,3,3
57348,4,1,201017,201017,201018,0,1,1
57349,1,1,201018,201018,201019,0,1,0
57350,6,2,201024,201024,201026,0,2,5
57351,1,1,201025,201026,201027,1,2,0
57352,6,1,201031,201031,201032,0,1,4
57353,6,1,201037,201037,201038,0,1,5
57354,2,3,201039,201039,201042,0,3,1
57355,5,1,201044,201044,201045,0,1,2
57356,4,2,201048,201048,201050,0,2,3
57357,5,1,201053,201053,201054,0,1,3
57358,6,2,201059,201059,201061,0,2,5
57359,2,2,201061,201061,201063,0,2,0
57360,4,1,201065,201065,201066,0,1,2
57361,6,1,201071,201071,201072,0,1,5
57362,3,1,201074,201074,201075,0,1,2
57363,6,3,201080,201080,201083,0,3,5
57364,3,3,201083,201083,201086,0,3,0
57365,5,1,201088,201088,201089,0,1,2
57366,3,3,201091,201091,201094,0,3,2
57367,4,3,201095,201095,201098,0,3,1
57368,5,1,201100,201100,201101,0,1,2
57369,1,2,201101,201101,201103,0,2,0
57370,6,1,201107,201107,201108,0,1,4
57371,2,2,201109,201109,201111,0,2,1
57372,1,3,201110,201111,201114,1,4,0
57373,1,1,201111,201114,201115,3,4,0
57374,4,3,201115,201115,201118,0,3,0
57375,5,2,201120,201120,201122,0,2,2
57376,1,3,201121,201122,201125,1,4,0
57377,5,1,201126,201126,201127,0,1,1
57378,6,3,201132,201132,201135,0,3,5
57379,1,1,201133,201135,201136,2,3,0
57380,2,1,201135,201136,201137,1,2,0
57381,5,1,201140,201140,201141,0,1,3
57382,4,2,201144,201144,201146,0,2,3
57383,3,1,201147,201147,201148,0,1,1
57384,4,3,201151,201151,201154,0,3,3
57385,1,1,201152,201154,201155,2,3,0
57386,3,3,201155,201155,201158,0,3,0
57387,2,3,201157,201158,201161,1,4,0
57388,1,3,201158,201161,201164,3,6,0
57389,6,1,201164,201164,201165,0,1,0
57390,6,3,201170,201170,201173,0,3,5
57391,5,2,201175,201175,201177,0,2,2
57392,4,2,201179,201179,201181,0,2,2
57393,4,2,201183,201183,201185,0,2,2
57394,2,1,201185,201185,201186,0,1,0
57395,6,3,201191,201191,201194,0,3,5
57396,3,3,201194,201194,201197,0,3,0
57397,6,1,201200,201200,201201,0,1,3
57398,4,1,201204,201204,201205,0,1,3
57399,3,1,201207,201207,201208,0,1,2
57400,5,3,201212,201212,201215,0,3,4
57401,2,3,201214,201215,201218,1,4,0
57402,1,2,201215,201218,201220,3,5,0
57403,2,1,201217,201220,201221,3,4,0
57404,6,1,201223,201223,201224,0,1,2
57405,6,3,201229,201229,201232,0,3,5
57406,4,2,201233,201233,201235,0,2,1
57407,4,2,201237,201237,201239,0,2,2
57408,4,3,201241,201241,201244,0,3,2
57409,5,1,201246,201246,201247,0,1,2
57410,2,2,201248,201248,201250,0,2,1
57411,4,3,201252,201252,201255,0,3,2
57412,6,3,201258,201258,201261,0,3,3
57413,4,2,201262,201262,201264,0,2,1
57414,1,2,201263,201264,201266,1,3,0
57415,2,2,201265,201266,201268,1,3,0
57416,6,2,201271,201271,201273,0,2,3
57417,2,2,201273,201273,201275,0,2,0
57418,2,3,201275,201275,201278,0,3,0
57419,4,1,201279,201279,201280,0,1,1
57420,4,3,201283,201283,201286,0,3,3
57421,2,1,201285,201286,201287,1,2,0
57422,3,1,201288,201288,201289,0,1,1
57423,4,2,201292,201292,201294,0,2,3
57424,1,3,201293,201294,201297,1,4,0
57425,6,1,201299,201299,201300,0,1,2
57426,2,1,201301,201301,201302,0,1,1
57427,2,2,201303,201303,201305,0,2,1
57428,3,2,201306,201306,201308,0,2,1
57429,5,1,201311,201311,201312,0,1,3
57430,2,2,201313,201313,201315,0,2,1
57431,5,3,201318,201318,201321,0,3,3
57432,4,1,201322,201322,201323,0,1,1
57433,6,3,201328,201328,201331,0,3,5
57434,5,1,201333,201333,201334,0,1,2
57435,2,3,201335,201335,201338,0,3,1
57436,4,1,201339,201339,201340,0,1,1
57437,5,3,201344,201344,201347,0,3,4
57438,1,1,201345,201347,201348,2,3,0
57439,5,1,201350,201350,201351,0,1,2
57440,6,1,201356,201356,201357,0,1,5
57441,2,3,201358,201358,201361,0,3,1
57442,4,1,201362,201362,201363,0,1,1
57443,3,1,201365,201365,201366,0,1,2
57444,4,2,201369,201369,201371,0,2,3
57445,1,1,201370,201371,201372,1,2,0
57446,1,2,201371,201372,201374,1,3,0
57447,6,2,201377,201377,201379,0,2,3
57448,4,1,201381,201381,201382,0,1,2
57449,6,1,201387,201387,201388,0,1,5
57450,5,3,201392,201392,201395,0,3,4
57451,2,2,201394,201395,201397,1,3,0
57452,6,2,201400,201400,201402,0,2,3
57453,5,1,201405,201405,201406,0,1,3
57454,6,1,201411,201411,201412,0,1,5
57455,6,3,201417,201417,201420,0,3,5
57456,4,3,201421,201421,201424,0,3,1
57457,6,2,201427,201427,201429,0,2,3
57458,2,1,201429,201429,201430,0,1,0
57459,4,3,201433,201433,201436,0,3,3
57460,4,3,201437,201437,201440,0,3,1
57461,4,2,201441,201441,201443,0,2,1
57462,1,2,201442,201443,201445,1,3,0
57463,3,3,201445,201445,201448,0,3,0
57464,5,3,201450,201450,201453,0,3,2
57465,6,3,201456,201456,201459,0,3,3
57466,6,3,201462,201462,201465,0,3,3
57467,2,3,201464,201465,201468,1,4,0
57468,2,3,201466,201468,201471,2,5,0
57469,3,3,201469,201471,201474,2,5,0
57470,1,3,201470,201474,201477,4,7,0
57471,3,2,201473,201477,201479,4,6,0
57472,5,1,201478,201479,201480,1,2,0
57473,6,3,201484,201484,201487,0,3,4
57474,2,1,201486,201487,201488,1,2,0
57475,4,3,201490,201490,201493,0,3,2
57476,6,3,201496,201496,201499,0,3,3
57477,4,1,201500,201500,201501,0,1,1
57478,6,2,201506,201506,201508,0,2,5
57479,5,2,201511,201511,201513,0,2,3
57480,4,1,201515,201515,201516,0,1,2
57481,5,2,201520,201520,201522,0,2,4
57482,6,1,201526,201526,201527,0,1,4
57483,4,1,201530,201530,201531,0,1,3
57484,4,1,201534,201534,201535,0,1,3
57485,3,3,201537,201537,201540,0,3,2
57486,3,1,201540,201540,201541,0,1,0
57487,2,3,201542,201542,201545,0,3,1
57488,5,2,201547,201547,201549,0,2,2
57489,6,3,201553,201553,201556,0,3,4
57490,3,1,201556,201556,201557,0,1,0
57491,4,2,201560,201560,201562,0,2,3
57492,3,2,201563,201563,201565,0,2,1
57493,2,3,201565,201565,201568,0,3,0
57494,1,2,201566,201568,201570,2,4,0
57495,1,3,201567,201570,201573,3,6,0
57496,4,2,201571,201573,201575,2,4,0
57497,2,2,201573,201575,201577,2,4,0
57498,4,1,201577,201577,201578,0,1,0
57499,5,3,201582,201582,201585,0,3,4
57500,2,3,201584,201585,201588,1,4,0
57501,1,2,201585,201588,201590,3,5,0
57502,3,1,201588,201590,201591,2,3,0
57503,4,1,201592,201592,201593,0,1,1
57504,1,1,201593,201593,201594,0,1,0
57505,5,2,201598,201598,201600,0,2,4
57506,4,3,201602,201602,201605,0,3,2
57507,3,1,201605,201605,201606,0,1,0
57508,4,2,201609,201609,201611,0,2,3
57509,4,1,201613,201613,201614,0,1,2
57510,2,1,201615,201615,201616,0,1,1
57511,4,1,201619,201619,201620,0,1,3
57512,5,1,201624,201624,201625,0,1,4
57513,6,3,201630,201630,201633,0,3,5
57514,3,3,201633,201633,201636,0,3,0
57515,6,2,201639,201639,201641,0,2,3
57516,4,1,201643,201643,201644,0,1,2
57517,2,3,201645,201645,201648,0,3,1
57518,4,2,201649,201649,201651,0,2,1
57519,3,3,201652,201652,201655,0,3,1
57520,4,1,201656,201656,201657,0,1,1
57521,5,3,201661,201661,201664,0,3,4
57522,2,1,201663,201664,201665,1,2,0
57523,1,2,201664,201665,201667,1,3,0
57524,4,2,201668,201668,201670,0,2,1
57525,3,1,201671,201671,201672,0,1,1
57526,6,1,201677,201677,201678,0,1,5
57527,1,2,201678,201678,201680,0,2,0
57528,2,3,201680,201680,201683,0,3,0
57529,2,2,201682,201683,201685,1,3,0
57530,1,1,201683,201685,201686,2,3,0
57531,2,2,201685,201686,201688,1,3,0
57532,6,3,201691,201691,201694,0,3,3
57533,2,1,201693,201694,201695,1,2,0
57534,1,3,201694,201695,201698,1,4,0
57535,3,1,201697,201698,201699,1,2,0
57536,5,3,201702,201702,201705,0,3,3
57537,3,1,201705,201705,201706,0,1,0
57538,1,3,201706,201706,201709,0,3,0
57539,6,3,201712,201712,201715,0,3,3
57540,4,3,201716,201716,201719,0,3,1
57541,6,3,201722,201722,201725,0,3,3
57542,1,3,201723,201725,201728,2,5,0
57543,2,2,201725,201728,201730,3,5,0
57544,2,3,201727,201730,201733,3,6,0
57545,1,2,201728,201733,201735,5,7,0
57546,5,2,201733,201735,201737,2,4,0
57547,3,1,201736,201737,201738,1,2,0
57548,5,3,201741,201741,201744,0,3,3
57549,6,1,201747,201747,201748,0,1,3
57550,5,2,201752,201752,201754,0,2,4
57551,1,1,201753,201754,201755,1,2,0
57552,3,2,201756,201756,201758,0,2,1
57553,1,2,201757,201758,201760,1,3,0
57554,1,2,201758,201760,201762,2,4,0
57555,2,3,201760,201762,201765,2,5,0
57556,2,3,201762,201765,201768,3,6,0
57557,2,2,201764,201768,201770,4,6,0
57558,1,3,201765,201770,201773,5,8,0
57559,6,3,201771,201773,201776,2,5,0
57560,4,3,201775,201776,201779,1,4,0
57561,4,1,201779,201779,201780,0,1,0
57562,1,2,201780,201780,201782,0,2,0
57563,6,3,201786,201786,201789,0,3,4
57564,5,2,201791,201791,201793,0,2,2
57565,2,1,201793,201793,201794,0,1,0
57566,4,3,201797,201797,201800,0,3,3
57567,3,1,201800,201800,201801,0,1,0
57568,1,2,201801,201801,201803,0,2,0
57569,4,2,201805,201805,201807,0,2,2
57570,6,1,201811,201811,201812,0,1,4
57571,2,1,201813,201813,201814,0,1,1
57572,3,3,201816,201816,201819,0,3,2
57573,1,2,201817,201819,201821,2,4,0
57574,4,1,201821,201821,201822,0,1,0
57575,2,3,201823,201823,201826,0,3,1
57576,2,2,201825,201826,201828,1,3,0
57577,1,3,201826,201828,201831,2,5,0
57578,6,1,201832,201832,201833,0,1,1
57579,6,1,201838,201838,201839,0,1,5
57580,2,2,201840,201840,201842,0,2,1
57581,5,1,201845,201845,201846,0,1,3
57582,4,1,201849,201849,201850,0,1,3
57583,6,2,201855,201855,201857,0,2,5
57584,3,1,201858,201858,201859,0,1,1
57585,1,2,201859,201859,201861,0,2,0
57586,5,1,201864,201864,201865,0,1,3
57587,1,2,201865,201865,201867,0,2,0
57588,3,1,201868,201868,201869,0,1,1
57589,1,1,201869,201869,201870,0,1,0
57590,4,2,201873,201873,201875,0,2,3
57591,2,3,201875,201875,201878,0,3,0
57592,1,2,201876,201878,201880,2,4,0
57593,2,1,201878,201880,201881,2,3,0
57594,5,1,201883,201883,201884,0,1,2
57595,1,2,201884,201884,201886,0,2,0
57596,6,2,201890,201890,201892,0,2,4
57597,2,3,201892,201892,201895,0,3,0
57598,5,3,201897,201897,201900,0,3,2
57599,6,1,201903,201903,201904,0,1,3
57600,1,1,201904,201904,201905,0,1,0
57601,3,1,201907,201907,201908,0,1,2
57602,5,3,201912,201912,201915,0,3,4
57603,1,1,201913,201915,201916,2,3,0
57604,5,1,201918,201918,201919,0,1,2
57605,1,2,201919,201919,201921,0,2,0
57606,2,2,201921,201921,201923,0,2,0
57607,3,1,201924,201924,201925,0,1,1
57608,4,1,201928,201928,201929,0,1,3
57609,2,2,201930,201930,201932,0,2,1
57610,3,3,201933,201933,201936,0,3,1
57611,3,1,201936,201936,201937,0,1,0
57612,4,1,201940,201940,201941,0,1,3
57613,6,3,201946,201946,201949,0,3,5
57614,5,1,201951,201951,201952,0,1,2
57615,1,3,201952,201952,201955,0,3,0
57616,3,3,201955,201955,201958,0,3,0
57617,5,1,201960,201960,201961,0,1,2
57618,3,3,201963,201963,201966,0,3,2
57619,3,1,201966,201966,201967,0,1,0
57620,1,3,201967,201967,201970,0,3,0
57621,3,3,201970,201970,201973,0,3,0
57622,3,1,201973,201973,201974,0,1,0
57623,1,3,201974,201974,201977,0,3,0
57624,6,2,201980,201980,201982,0,2,3
57625,5,2,201985,201985,201987,0,2,3
57626,4,1,201989,201989,201990,0,1,2
57627,4,1,201993,201993,201994,0,1,3
57628,4,2,201997,201997,201999,0,2,3
57629,2,3,201999,201999,202002,0,3,0
57630,5,3,202004,202004,202007,0,3,2
57631,6,3,202010,202010,202013,0,3,3
57632,5,3,202015,202015,202018,0,3,2
57633,2,1,202017,202018,202019,1,2,0
57634,1,1,202018,202019,202020,1,2,0
57635,6,2,202024,202024,202026,0,2,4
57636,3,2,202027,202027,202029,0,2,1
57637,2,2,202029,202029,202031,0,2,0
57638,6,1,202035,202035,202036,0,1,4
57639,1,1,202036,202036,202037,0,1,0
57640,5,3,202041,202041,202044,0,3,4
57641,1,3,202042,202044,202047,2,5,0
57642,4,3,202046,202047,202050,1,4,0
57643,6,2,202052,202052,202054,0,2,2
57644,5,2,202057,202057,202059,0,2,3
57645,1,2,202058,202059,202061,1,3,0
57646,4,1,202062,202062,202063,0,1,1
57647,2,1,202064,202064,202065,0,1,1
57648,2,2,202066,202066,202068,0,2,1
57649,3,2,202069,202069,202071,0,2,1
57650,3,1,202072,202072,202073,0,1,1
57651,4,3,202076,202076,202079,0,3,3
57652,5,1,202081,202081,202082,0,1,2
57653,1,2,202082,202082,202084,0,2,0
57654,1,3,202083,202084,202087,1,4,0
57655,6,1,202089,202089,202090,0,1,2
57656,1,2,202090,202090,202092,0,2,0
57657,4,1,202094,202094,202095,0,1,2
57658,4,1,202098,202098,202099,0,1,3
57659,6,2,202104,202104,202106,0,2,5
57660,1,3,202105,202106,202109,1,4,0
57661,6,1,202111,202111,202112,0,1,2
57662,5,1,202116,202116,202117,0,1,4
57663,6,1,202122,202122,202123,0,1,5
57664,4,3,202126,202126,202129,0,3,3
57665,3,1,202129,202129,202130,0,1,0
57666,6,2,202135,202135,202137,0,2,5
57667,3,3,202138,202138,202141,0,3,1
57668,3,3,202141,202141,202144,0,3,0
57669,2,3,202143,202144,202147,1,4,0
57670,6,3,202149,202149,202152,0,3,2
57671,6,2,202155,202155,202157,0,2,3
57672,3,2,202158,202158,202160,0,2,1
57673,5,2,202163,202163,202165,0,2,3
57674,5,1,202168,202168,202169,0,1,3
57675,1,3,202169,202169,202172,0,3,0
57676,2,3,202171,202172,202175,1,4,0
57677,6,2,202177,202177,202179,0,2,2
57678,5,3,202182,202182,202185,0,3,3
57679,5,2,202187,202187,202189,0,2,2
57680,4,3,202191,202191,202194,0,3,2
57681,5,2,202196,202196,202198,0,2,2
57682,4,3,202200,202200,202203,0,3,2
57683,6,3,202206,202206,202209,0,3,3
57684,6,2,202212,202212,202214,0,2,3
57685,3,3,202215,202215,202218,0,3,1
57686,3,1,202218,202218,202219,0,1,0
57687,4,2,202222,202222,202224,0,2,3
57688,6,3,202228,202228,202231,0,3,4
57689,2,2,202230,202231,202233,1,3,0
57690,3,3,202233,202233,202236,0,3,0
57691,6,2,202239,202239,202241,0,2,3
57692,5,3,202244,202244,202247,0,3,3
57693,6,1,202250,202250,202251,0,1,3
57694,6,1,202256,202256,202257,0,1,5
57695,3,3,202259,202259,202262,0,3,2
57696,2,2,202261,202262,202264,1,3,0
57697,2,1,202263,202264,202265,1,2,0
57698,3,3,202266,202266,202269,0,3,1
57699,3,1,202269,202269,202270,0,1,0
57700,6,1,202275,202275,202276,0,1,5
57701,2,3,202277,202277,202280,0,3,1
57702,3,3,202280,202280,202283,0,3,0
57703,5,1,202285,202285,202286,0,1,2
57704,6,3,202291,202291,202294,0,3,5
57705,3,1,202294,202294,202295,0,1,0
57706,3,1,202297,202297,202298,0,1,2
57707,2,1,202299,202299,202300,0,1,1
57708,5,3,202304,202304,202307,0,3,4
57709,3,2,202307,202307,202309,0,2,0
57710,1,1,202308,202309,202310,1,2,0
57711,1,3,202309,202310,202313,1,4,0
57712,6,1,202315,202315,202316,0,1,2
57713,3,2,202318,202318,202320,0,2,2
57714,5,1,202323,202323,202324,0,1,3
57715,2,2,202325,202325,202327,0,2,1
57716,2,1,202327,202327,202328,0,1,0
57717,3,1,202330,202330,202331,0,1,2
57718,2,1,202332,202332,202333,0,1,1
57719,5,2,202337,202337,202339,0,2,4
57720,5,2,202342,202342,202344,0,2,3
57721,4,3,202346,202346,202349,0,3,2
57722,2,2,202348,202349,202351,1,3,0
57723,5,1,202353,202353,202354,0,1,2
57724,4,3,202357,202357,202360,0,3,3
57725,4,2,202361,202361,202363,0,2,1
57726,5,2,202366,202366,202368,0,2,3
57727,1,2,202367,202368,202370,1,3,0
57728,2,1,202369,202370,202371,1,2,0
57729,3,2,202372,202372,202374,0,2,1
57730,3,1,202375,202375,202376,0,1,1
57731,6,2,202381,202381,202383,0,2,5
57732,3,3,202384,202384,202387,0,3,1
57733,6,1,202390,202390,202391,0,1,3
57734,5,2,202395,202395,202397,0,2,4
57735,4,1,202399,202399,202400,0,1,2
57736,5,2,202404,202404,202406,0,2,4
57737,5,2,202409,202409,202411,0,2,3
57738,3,1,202412,202412,202413,0,1,1
57739,5,1,202417,202417,202418,0,1,4
57740,2,2,202419,202419,202421,0,2,1
57741,3,3,202422,202422,202425,0,3,1
57742,6,3,202428,202428,202431,0,3,3
57743,3,2,202431,202431,202433,0,2,0
57744,4,2,202435,202435,202437,0,2,2
57745,5,1,202440,202440,202441,0,1,3
57746,4,3,202444,202444,202447,0,3,3
57747,6,1,202450,202450,202451,0,1,3
57748,5,1,202455,202455,202456,0,1,4
57749,6,1,202461,202461,202462,0,1,5
57750,3,2,202464,202464,202466,0,2,2
57751,2,2,202466,202466,202468,0,2,0
57752,1,1,202467,202468,202469,1,2,0
57753,5,1,202472,202472,202473,0,1,3
57754,4,3,202476,202476,202479,0,3,3
57755,2,1,202478,202479,202480,1,2,0
57756,2,1,202480,202480,202481,0,1,0
57757,4,1,202484,202484,202485,0,1,3
57758,6,1,202490,202490,202491,0,1,5
57759,2,3,202492,202492,202495,0,3,1
57760,3,2,202495,202495,202497,0,2,0
57761,2,1,202497,202497,202498,0,1,0
57762,3,1,202500,202500,202501,0,1,2
57763,1,1,202501,202501,202502,0,1,0
57764,1,1,202502,202502,202503,0,1,0
57765,5,1,202507,202507,202508,0,1,4
57766,6,3,202513,202513,202516,0,3,5
57767,2,3,202515,202516,202519,1,4,0
57768,2,2,202517,202519,202521,2,4,0
57769,6,2,202523,202523,202525,0,2,2
57770,5,1,202528,202528,202529,0,1,3
57771,6,2,202534,202534,202536,0,2,5
57772,4,1,202538,202538,202539,0,1,2
57773,5,1,202543,202543,202544,0,1,4
57774,6,2,202549,202549,202551,0,2,5
57775,6,1,202555,202555,202556,0,1,4
57776,3,1,202558,202558,202559,0,1,2
57777,2,3,202560,202560,202563,0,3,1
57778,3,1,202563,202563,202564,0,1,0
57779,4,1,202567,202567,202568,0,1,3
57780,6,2,202573,202573,202575,0,2,5
57781,6,3,202579,202579,202582,0,3,4
57782,6,2,202585,202585,202587,0,2,3
57783,2,2,202587,202587,202589,0,2,0
57784,3,2,202590,202590,202592,0,2,1
57785,2,2,202592,202592,202594,0,2,0
57786,4,1,202596,202596,202597,0,1,2
57787,3,2,202599,202599,202601,0,2,2
57788,1,1,202600,202601,202602,1,2,0
57789,6,3,202606,202606,202609,0,3,4
57790,3,3,202609,202609,202612,0,3,0
57791,3,2,202612,202612,202614,0,2,0
57792,3,2,202615,202615,202617,0,2,1
57793,3,2,202618,202618,202620,0,2,1
57794,1,1,202619,202620,202621,1,2,0
57795,2,1,202621,202621,202622,0,1,0
57796,5,3,202626,202626,202629,0,3,4
57797,5,2,202631,202631,202633,0,2,2
57798,4,1,202635,202635,202636,0,1,2
57799,6,1,202641,202641,202642,0,1,5
57800,2,2,202643,202643,202645,0,2,1
57801,1,2,202644,202645,202647,1,3,0
57802,2,3,202646,202647,202650,1,4,0
57803,5,2,202651,202651,202653,0,2,1
57804,1,2,202652,202653,202655,1,3,0
57805,1,2,202653,202655,202657,2,4,0
57806,2,3,202655,202657,202660,2,5,0
57807,1,3,202656,202660,202663,4,7,0
57808,4,3,202660,202663,202666,3,6,0
57809,6,1,202666,202666,202667,0,1,0
57810,6,1,202672,202672,202673,0,1,5
57811,2,1,202674,202674,202675,0,1,1
57812,4,2,202678,202678,202680,0,2,3
57813,1,3,202679,202680,202683,1,4,0
57814,2,2,202681,202683,202685,2,4,0
57815,2,2,202683,202685,202687,2,4,0
57816,4,3,202687,202687,202690,0,3,0
57817,3,2,202690,202690,202692,0,2,0
57818,1,3,202691,202692,202695,1,4,0
57819,3,2,202694,202695,202697,1,3,0
57820,1,2,202695,202697,202699,2,4,0
57821,1,1,202696,202699,202700,3,4,0
57822,3,1,202699,202700,202701,1,2,0
57823,3,2,202702,202702,202704,0,2,1
57824,2,1,202704,202704,202705,0,1,0
57825,4,2,202708,202708,202710,0,2,3
57826,6,1,202714,202714,202715,0,1,4
57827,1,1,202715,202715,202716,0,1,0
57828,5,1,202720,202720,202721,0,1,4
57829,3,2,202723,202723,202725,0,2,2
57830,1,3,202724,202725,202728,1,4,0
57831,4,3,202728,202728,202731,0,3,0
57832,3,3,202731,202731,202734,0,3,0
57833,1,2,202732,202734,202736,2,4,0
57834,3,2,202735,202736,202738,1,3,0
57835,3,3,202738,202738,202741,0,3,0
57836,1,3,202739,202741,202744,2,5,0
57837,2,3,202741,202744,202747,3,6,0
57838,5,3,202746,202747,202750,1,4,0
57839,5,2,202751,202751,202753,0,2,1
57840,5,1,202756,202756,202757,0,1,3
57841,2,2,202758,202758,202760,0,2,1
57842,5,2,202763,202763,202765,0,2,3
57843,1,3,202764,202765,202768,1,4,0
57844,1,2,202765,202768,202770,3,5,0
57845,3,2,202768,202770,202772,2,4,0
57846,2,1,202770,202772,202773,2,3,0
57847,5,3,202775,202775,202778,0,3,2
57848,4,3,202779,202779,202782,0,3,1
57849,6,1,202785,202785,202786,0,1,3
57850,6,2,202791,202791,202793,0,2,5
57851,4,3,202795,202795,202798,0,3,2
57852,3,2,202798,202798,202800,0,2,0
57853,5,1,202803,202803,202804,0,1,3
57854,2,1,202805,202805,202806,0,1,1
57855,6,2,202811,202811,202813,0,2,5
57856,6,1,202817,202817,202818,0,1,4
57857,3,3,202820,202820,202823,0,3,2
57858,4,2,202824,202824,202826,0,2,1
57859,1,1,202825,202826,202827,1,2,0
57860,4,3,202829,202829,202832,0,3,2
57861,6,2,202835,202835,202837,0,2,3
57862,5,3,202840,202840,202843,0,3,3
57863,1,3,202841,202843,202846,2,5,0
57864,1,2,202842,202846,202848,4,6,0
57865,3,1,202845,202848,202849,3,4,0
57866,1,3,202846,202849,202852,3,6,0
57867,4,2,202850,202852,202854,2,4,0
57868,6,1,202856,202856,202857,0,1,2
57869,3,3,202859,202859,202862,0,3,2
57870,1,2,202860,202862,202864,2,4,0
57871,3,2,202863,202864,202866,1,3,0
57872,4,1,202867,202867,202868,0,1,1
57873,6,1,202873,202873,202874,0,1,5
57874,5,2,202878,202878,202880,0,2,4
57875,4,1,202882,202882,202883,0,1,2
57876,1,2,202883,202883,202885,0,2,0
57877,4,2,202887,202887,202889,0,2,2
57878,2,3,202889,202889,202892,0,3,0
57879,4,2,202893,202893,202895,0,2,1
57880,1,3,202894,202895,202898,1,4,0
57881,6,2,202900,202900,202902,0,2,2
57882,2,2,202902,202902,202904,0,2,0
57883,6,3,202908,202908,202911,0,3,4
57884,5,3,202913,202913,202916,0,3,2
57885,4,2,202917,202917,202919,0,2,1
57886,6,3,202923,202923,202926,0,3,4
57887,1,1,202924,202926,202927,2,3,0
57888,4,1,202928,202928,202929,0,1,1
57889,1,2,202929,202929,202931,0,2,0
57890,5,1,202934,202934,202935,0,1,3
57891,1,1,202935,202935,202936,0,1,0
57892,4,2,202939,202939,202941,0,2,3
57893,1,3,202940,202941,202944,1,4,0
57894,1,2,202941,202944,202946,3,5,0
57895,3,2,202944,202946,202948,2,4,0
57896,3,2,202947,202948,202950,1,3,0
57897,3,1,202950,202950,202951,0,1,0
57898,2,2,202952,202952,202954,0,2,1
57899,2,2,202954,202954,202956,0,2,0
57900,1,3,202955,202956,202959,1,4,0
57901,4,3,202959,202959,202962,0,3,0
57902,3,2,202962,202962,202964,0,2,0
57903,5,1,202967,202967,202968,0,1,3
57904,1,1,202968,202968,202969,0,1,0
57905,6,1,202974,202974,202975,0,1,5
57906,2,2,202976,202976,202978,0,2,1
57907,2,2,202978,202978,202980,0,2,0
57908,4,2,202982,202982,202984,0,2,2
57909,5,1,202987,202987,202988,0,1,3
57910,2,2,202989,202989,202991,0,2,1
57911,4,2,202993,202993,202995,0,2,2
57912,6,3,202999,202999,203002,0,3,4
57913,5,1,203004,203004,203005,0,1,2
57914,4,1,203008,203008,203009,0,1,3
57915,1,1,203009,203009,203010,0,1,0
57916,1,3,203010,203010,203013,0,3,0
57917,2,2,203012,203013,203015,1,3,0
57918,1,1,203013,203015,203016,2,3,0
57919,1,3,203014,203016,203019,2,5,0
57920,6,3,203020,203020,203023,0,3,1
57921,4,2,203024,203024,203026,0,2,1
57922,2,1,203026,203026,203027,0,1,0
57923,5,1,203031,203031,203032,0,1,4
57924,3,3,203034,203034,203037,0,3,2
57925,2,1,203036,203037,203038,1,2,0
57926,6,3,203042,203042,203045,0,3,4
57927,1,1,203043,203045,203046,2,3,0
57928,1,3,203044,203046,203049,2,5,0
57929,5,1,203049,203049,203050,0,1,0
57930,2,1,203051,203051,203052,0,1,1
57931,4,3,203055,203055,203058,0,3,3
57932,5,3,203060,203060,203063,0,3,2
57933,3,3,203063,203063,203066,0,3,0
57934,4,3,203067,203067,203070,0,3,1
57935,3,2,203070,203070,203072,0,2,0
57936,6,1,203076,203076,203077,0,1,4
57937,2,2,203078,203078,203080,0,2,1
57938,2,1,203080,203080,203081,0,1,0
57939,2,1,203082,203082,203083,0,1,1
57940,1,1,203083,203083,203084,0,1,0
57941,5,1,203088,203088,203089,0,1,4
57942,2,1,203090,203090,203091,0,1,1
57943,3,1,203093,203093,203094,0,1,2
57944,6,2,203099,203099,203101,0,2,5
57945,6,2,203105,203105,203107,0,2,4
57946,2,3,203107,203107,203110,0,3,0
57947,3,3,203110,203110,203113,0,3,0
57948,2,3,203112,203113,203116,1,4,0
57949,5,1,203117,203117,203118,0,1,1
57950,6,1,203123,203123,203124,0,1,5
57951,1,3,203124,203124,203127,0,3,0
57952,2,2,203126,203127,203129,1,3,0
57953,4,3,203130,203130,203133,0,3,1
57954,4,3,203134,203134,203137,0,3,1
57955,1,1,203135,203137,203138,2,3,0
57956,3,3,203138,203138,203141,0,3,0
57957,4,1,203142,203142,203143,0,1,1
57958,1,2,203143,203143,203145,0,2,0
57959,3,2,203146,203146,203148,0,2,1
57960,1,3,203147,203148,203151,1,4,0
57961,4,1,203151,203151,203152,0,1,0
57962,6,1,203157,203157,203158,0,1,5
57963,3,1,203160,203160,203161,0,1,2
57964,4,2,203164,203164,203166,0,2,3
57965,1,2,203165,203166,203168,1,3,0
57966,5,1,203170,203170,203171,0,1,2
57967,4,2,203174,203174,203176,0,2,3
57968,2,3,203176,203176,203179,0,3,0
57969,5,3,203181,203181,203184,0,3,2
57970,3,3,203184,203184,203187,0,3,0
57971,1,2,203185,203187,203189,2,4,0
57972,1,3,203186,203189,203192,3,6,0
57973,5,3,203191,203192,203195,1,4,0
57974,1,1,203192,203195,203196,3,4,0
57975,1,2,203193,203196,203198,3,5,0
57976,1,1,203194,203198,203199,4,5,0
57977,6,1,203200,203200,203201,0,1,1
57978,5,1,203205,203205,203206,0,1,4
57979,3,3,203208,203208,203211,0,3,2
57980,1,3,203209,203211,203214,2,5,0
57981,1,2,203210,203214,203216,4,6,0
57982,3,1,203213,203216,203217,3,4,0
57983,3,1,203216,203217,203218,1,2,0
57984,5,1,203221,203221,203222,0,1,3
57985,4,2,203225,203225,203227,0,2,3
57986,6,3,203231,203231,203234,0,3,4
57987,4,3,203235,203235,203238,0,3,1
57988,1,3,203236,203238,203241,2,5,0
57989,1,3,203237,203241,203244,4,7,0
57990,5,1,203242,203244,203245,2,3,0
57991,3,1,203245,203245,203246,0,1,0
57992,5,3,203250,203250,203253,0,3,4
57993,1,2,203251,203253,203255,2,4,0
57994,6,2,203257,203257,203259,0,2,2
57995,6,2,203263,203263,203265,0,2,4
57996,1,1,203264,203265,203266,1,2,0
57997,2,3,203266,203266,203269,0,3,0
57998,2,2,203268,203269,203271,1,3,0
57999,5,1,203273,203273,203274,0,1,2
58000,6,3,203279,203279,203282,0,3,5
58001,1,2,203280,203282,203284,2,4,0
58002,1,2,203281,203284,203286,3,5,0
58003,6,1,203287,203287,203288,0,1,1
58004,5,1,203292,203292,203293,0,1,4
58005,5,3,203297,203297,203300,0,3,4
58006,6,3,203303,203303,203306,0,3,3
58007,1,3,203304,203306,203309,2,5,0
58008,2,2,203306,203309,203311,3,5,0
58009,1,1,203307,203311,203312,4,5,0
58010,4,3,203311,203312,203315,1,4,0
58011,1,3,203312,203315,203318,3,6,0
58012,2,2,203314,203318,203320,4,6,0
58013,5,2,203319,203320,203322,1,3,0
58014,6,2,203325,203325,203327,0,2,3
58015,6,2,203331,203331,203333,0,2,4
58016,6,2,203337,203337,203339,0,2,4
58017,1,1,203338,203339,203340,1,2,0
58018,3,3,203341,203341,203344,0,3,1
58019,5,1,203346,203346,203347,0,1,2
58020,6,3,203352,203352,203355,0,3,5
58021,4,1,203356,203356,203357,0,1,1
58022,2,1,203358,203358,203359,0,1,1
58023,6,3,203364,203364,203367,0,3,5
58024,5,2,203369,203369,203371,0,2,2
58025,4,2,203373,203373,203375,0,2,2
58026,4,2,203377,203377,203379,0,2,2
58027,6,1,203383,203383,203384,0,1,4
58028,4,2,203387,203387,203389,0,2,3
58029,1,2,203388,203389,203391,1,3,0
58030,5,2,203393,203393,203395,0,2,2
58031,2,3,203395,203395,203398,0,3,0
58032,3,1,203398,203398,203399,0,1,0
58033,5,1,203403,203403,203404,0,1,4
58034,6,3,203409,203409,203412,0,3,5
58035,2,1,203411,203412,203413,1,2,0
58036,4,2,203415,203415,203417,0,2,2
58037,4,2,203419,203419,203421,0,2,2
58038,4,1,203423,203423,203424,0,1,2
58039,2,2,203425,203425,203427,0,2,1
58040,2,3,203427,203427,203430,0,3,0
58041,1,1,203428,203430,203431,2,3,0
58042,2,2,203430,203431,203433,1,3,0
58043,3,3,203433,203433,203436,0,3,0
58044,4,1,203437,203437,203438,0,1,1
58045,3,1,203440,203440,203441,0,1,2
58046,2,2,203442,203442,203444,0,2,1
58047,4,3,203446,203446,203449,0,3,2
58048,2,2,203448,203449,203451,1,3,0
58049,5,2,203453,203453,203455,0,2,2
58050,5,1,203458,203458,203459,0,1,3
58051,6,3,203464,203464,203467,0,3,5
58052,6,1,203470,203470,203471,0,1,3
58053,1,1,203471,203471,203472,0,1,0
58054,4,3,203475,203475,203478,0,3,3
58055,3,1,203478,203478,203479,0,1,0
58056,5,3,203483,203483,203486,0,3,4
58057,5,1,203488,203488,203489,0,1,2
58058,2,2,203490,203490,203492,0,2,1
58059,4,1,203494,203494,203495,0,1,2
58060,6,3,203500,203500,203503,0,3,5
58061,5,2,203505,203505,203507,0,2,2
58062,2,3,203507,203507,203510,0,3,0
58063,3,2,203510,203510,203512,0,2,0
58064,3,1,203513,203513,203514,0,1,1
58065,3,1,203516,203516,203517,0,1,2
58066,4,2,203520,203520,203522,0,2,3
58067,1,1,203521,203522,203523,1,2,0
58068,5,1,203526,203526,203527,0,1,3
58069,6,1,203532,203532,203533,0,1,5
58070,5,2,203537,203537,203539,0,2,4
58071,5,2,203542,203542,203544,0,2,3
58072,5,1,203547,203547,203548,0,1,3
58073,2,2,203549,203549,203551,0,2,1
58074,5,1,203554,203554,203555,0,1,3
58075,1,1,203555,203555,203556,0,1,0
58076,2,3,203557,203557,203560,0,3,1
58077,1,2,203558,203560,203562,2,4,0
58078,1,2,203559,203562,203564,3,5,0
58079,5,1,203564,203564,203565,0,1,0
58080,3,2,203567,203567,203569,0,2,2
58081,6,3,203573,203573,203576,0,3,4
58082,3,1,203576,203576,203577,0,1,0
58083,2,3,203578,203578,203581,0,3,1
58084,5,2,203583,203583,203585,0,2,2
58085,1,1,203584,203585,203586,1,2,0
58086,5,2,203589,203589,203591,0,2,3
58087,1,1,203590,203591,203592,1,2,0
58088,3,2,203593,203593,203595,0,2,1
58089,3,3,203596,203596,203599,0,3,1
58090,1,1,203597,203599,203600,2,3,0
58091,2,2,203599,203600,203602,1,3,0
58092,1,1,203600,203602,203603,2,3,0
58093,3,2,203603,203603,203605,0,2,0
58094,1,3,203604,203605,203608,1,4,0
58095,1,2,203605,203608,203610,3,5,0
58096,4,3,203609,203610,203613,1,4,0
58097,3,3,203612,203613,203616,1,4,0
58098,5,1,203617,203617,203618,0,1,1
58099,6,3,203623,203623,203626,0,3,5
58100,2,2,203625,203626,203628,1,3,0
58101,2,2,203627,203628,203630,1,3,0
58102,2,1,203629,203630,203631,1,2,0
58103,4,3,203633,203633,203636,0,3,2
58104,6,3,203639,203639,203642,0,3,3
58105,6,1,203645,203645,203646,0,1,3
58106,4,2,203649,203649,203651,0,2,3
58107,3,2,203652,203652,203654,0,2,1
58108,2,2,203654,203654,203656,0,2,0
58109,3,2,203657,203657,203659,0,2,1
58110,2,3,203659,203659,203662,0,3,0
58111,3,2,203662,203662,203664,0,2,0
58112,3,3,203665,203665,203668,0,3,1
58113,5,3,203670,203670,203673,0,3,2
58114,6,2,203676,203676,203678,0,2,3
58115,5,1,203681,203681,203682,0,1,3
58116,4,1,203685,203685,203686,0,1,3
58117,1,1,203686,203686,203687,0,1,0
58118,3,2,203689,203689,203691,0,2,2
58119,1,3,203690,203691,203694,1,4,0
58120,3,2,203693,203694,203696,1,3,0
58121,2,3,203695,203696,203699,1,4,0
58122,1,3,203696,203699,203702,3,6,0
58123,6,1,203702,203702,203703,0,1,0
58124,1,2,203703,203703,203705,0,2,0
58125,2,1,203705,203705,203706,0,1,0
58126,3,1,203708,203708,203709,0,1,2
58127,2,1,203710,203710,203711,0,1,1
58128,2,1,203712,203712,203713,0,1,1
58129,4,2,203716,203716,203718,0,2,3
58130,3,2,203719,203719,203721,0,2,1
58131,6,3,203725,203725,203728,0,3,4
58132,2,3,203727,203728,203731,1,4,0
58133,4,2,203731,203731,203733,0,2,0
58134,3,3,203734,203734,203737,0,3,1
58135,2,3,203736,203737,203740,1,4,0
58136,1,3,203737,203740,203743,3,6,0
58137,3,3,203740,203743,203746,3,6,0
58138,3,1,203743,203746,203747,3,4,0
58139,6,3,203749,203749,203752,0,3,2
58140,2,1,203751,203752,203753,1,2,0
58141,3,2,203754,203754,203756,0,2,1
58142,6,2,203760,203760,203762,0,2,4
58143,5,3,203765,203765,203768,0,3,3
58144,1,1,203766,203768,203769,2,3,0
58145,2,2,203768,203769,203771,1,3,0
58146,6,1,203774,203774,203775,0,1,3
58147,3,1,203777,203777,203778,0,1,2
58148,2,3,203779,203779,203782,0,3,1
58149,4,1,203783,203783,203784,0,1,1
58150,2,2,203785,203785,203787,0,2,1
58151,4,2,203789,203789,203791,0,2,2
58152,5,2,203794,203794,203796,0,2,3
58153,4,2,203798,203798,203800,0,2,2
58154,5,1,203803,203803,203804,0,1,3
58155,4,2,203807,203807,203809,0,2,3
58156,3,3,203810,203810,203813,0,3,1
58157,6,2,203816,203816,203818,0,2,3
58158,2,1,203818,203818,203819,0,1,0
58159,2,1,203820,203820,203821,0,1,1
58160,5,3,203825,203825,203828,0,3,4
58161,1,3,203826,203828,203831,2,5,0
58162,3,3,203829,203831,203834,2,5,0
58163,5,1,203834,203834,203835,0,1,0
58164,1,2,203835,203835,203837,0,2,0
58165,4,3,203839,203839,203842,0,3,2
58166,2,2,203841,203842,203844,1,3,0
58167,3,2,203844,203844,203846,0,2,0
58168,2,1,203846,203846,203847,0,1,0
58169,5,3,203851,203851,203854,0,3,4
58170,5,2,203856,203856,203858,0,2,2
58171,6,1,203862,203862,203863,0,1,4
58172,2,2,203864,203864,203866,0,2,1
58173,4,2,203868,203868,203870,0,2,2
58174,2,3,203870,203870,203873,0,3,0
58175,1,2,203871,203873,203875,2,4,0
58176,3,1,203874,203875,203876,1,2,0
58177,2,3,203876,203876,203879,0,3,0
58178,4,1,203880,203880,203881,0,1,1
58179,1,3,203881,203881,203884,0,3,0
58180,2,3,203883,203884,203887,1,4,0
58181,6,3,203889,203889,203892,0,3,2
58182,2,2,203891,203892,203894,1,3,0
58183,5,1,203896,203896,203897,0,1,2
58184,6,2,203902,203902,203904,0,2,5
58185,1,3,203903,203904,203907,1,4,0
58186,2,1,203905,203907,203908,2,3,0
58187,1,1,203906,203908,203909,2,3,0
58188,2,1,203908,203909,203910,1,2,0
58189,1,2,203909,203910,203912,1,3,0
58190,4,3,203913,203913,203916,0,3,1
58191,2,1,203915,203916,203917,1,2,0
58192,4,3,203919,203919,203922,0,3,2
58193,3,2,203922,203922,203924,0,2,0
58194,5,3,203927,203927,203930,0,3,3
58195,3,3,203930,203930,203933,0,3,0
58196,3,1,203933,203933,203934,0,1,0
58197,2,3,203935,203935,203938,0,3,1
58198,1,3,203936,203938,203941,2,5,0
58199,1,3,203937,203941,203944,4,7,0
58200,5,2,203942,203944,203946,2,4,0
58201,3,1,203945,203946,203947,1,2,0
58202,4,1,203949,203949,203950,0,1,2
58203,6,1,203955,203955,203956,0,1,5
58204,6,2,203961,203961,203963,0,2,5
58205,3,1,203964,203964,203965,0,1,1
58206,3,2,203967,203967,203969,0,2,2
58207,5,2,203972,203972,203974,0,2,3
58208,1,3,203973,203974,203977,1,4,0
58209,1,1,203974,203977,203978,3,4,0
58210,2,1,203976,203978,203979,2,3,0
58211,2,3,203978,203979,203982,1,4,0
58212,5,2,203983,203983,203985,0,2,1
58213,1,1,203984,203985,203986,1,2,0
58214,1,1,203985,203986,203987,1,2,0
58215,2,2,203987,203987,203989,0,2,0
58216,6,1,203993,203993,203994,0,1,4
58217,3,3,203996,203996,203999,0,3,2
58218,2,1,203998,203999,204000,1,2,0
58219,5,1,204003,204003,204004,0,1,3
58220,3,1,204006,204006,204007,0,1,2
58221,1,2,204007,204007,204009,0,2,0
58222,6,3,204013,204013,204016,0,3,4
58223,2,2,204015,204016,204018,1,3,0
58224,1,2,204016,204018,204020,2,4,0
58225,4,3,204020,204020,204023,0,3,0
58226,1,2,204021,204023,204025,2,4,0
58227,1,3,204022,204025,204028,3,6,0
58228,1,3,204023,204028,204031,5,8,0
58229,1,1,204024,204031,204032,7,8,0
58230,3,2,204027,204032,204034,5,7,0
58231,5,2,204032,204034,204036,2,4,0
58232,4,3,204036,204036,204039,0,3,0
58233,4,1,204040,204040,204041,0,1,1
58234,6,1,204046,204046,204047,0,1,5
58235,5,2,204051,204051,204053,0,2,4
58236,6,2,204057,204057,204059,0,2,4
58237,5,2,204062,204062,204064,0,2,3
58238,6,1,204068,204068,204069,0,1,4
58239,3,2,204071,204071,204073,0,2,2
58240,6,1,204077,204077,204078,0,1,4
58241,2,1,204079,204079,204080,0,1,1
58242,3,3,204082,204082,204085,0,3,2
58243,5,2,204087,204087,204089,0,2,2
58244,6,1,204093,204093,204094,0,1,4
58245,6,1,204099,204099,204100,0,1,5
58246,6,3,204105,204105,204108,0,3,5
58247,6,1,204111,204111,204112,0,1,3
58248,2,3,204113,204113,204116,0,3,1
58249,5,2,204118,204118,204120,0,2,2
58250,4,1,204122,204122,204123,0,1,2
58251,6,2,204128,204128,204130,0,2,5
58252,5,3,204133,204133,204136,0,3,3
58253,5,2,204138,204138,204140,0,2,2
58254,5,2,204143,204143,204145,0,2,3
58255,4,3,204147,204147,204150,0,3,2
58256,5,2,204152,204152,204154,0,2,2
58257,5,3,204157,204157,204160,0,3,3
58258,3,2,204160,204160,204162,0,2,0
58259,3,2,204163,204163,204165,0,2,1
58260,1,1,204164,204165,204166,1,2,0
58261,3,1,204167,204167,204168,0,1,1
58262,2,2,204169,204169,204171,0,2,1
58263,1,2,204170,204171,204173,1,3,0
58264,5,2,204175,204175,204177,0,2,2
58265,5,2,204180,204180,204182,0,2,3
58266,6,3,204186,204186,204189,0,3,4
58267,6,2,204192,204192,204194,0,2,3
58268,5,3,204197,204197,204200,0,3,3
58269,3,1,204200,204200,204201,0,1,0
58270,2,3,204202,204202,204205,0,3,1
58271,5,3,204207,204207,204210,0,3,2
58272,2,3,204209,204210,204213,1,4,0
58273,1,2,204210,204213,204215,3,5,0
58274,5,3,204215,204215,204218,0,3,0
58275,4,3,204219,204219,204222,0,3,1
58276,2,2,204221,204222,204224,1,3,0
58277,5,2,204226,204226,204228,0,2,2
58278,1,3,204227,204228,204231,1,4,0
58279,5,1,204232,204232,204233,0,1,1
58280,3,1,204235,204235,204236,0,1,2
58281,1,3,204236,204236,204239,0,3,0
58282,1,2,204237,204239,204241,2,4,0
58283,3,3,204240,204241,204244,1,4,0
58284,4,1,204244,204244,204245,0,1,0
58285,6,3,204250,204250,204253,0,3,5
58286,4,2,204254,204254,204256,0,2,1
58287,4,2,204258,204258,204260,0,2,2
58288,5,3,204263,204263,204266,0,3,3
58289,1,2,204264,204266,204268,2,4,0
58290,1,1,204265,204268,204269,3,4,0
58291,5,2,204270,204270,204272,0,2,1
58292,6,1,204276,204276,204277,0,1,4
58293,6,3,204282,204282,204285,0,3,5
58294,1,2,204283,204285,204287,2,4,0
58295,1,3,204284,204287,204290,3,6,0
58296,3,2,204287,204290,204292,3,5,0
58297,3,2,204290,204292,204294,2,4,0
58298,2,1,204292,204294,204295,2,3,0
58299,4,3,204296,204296,204299,0,3,1
58300,2,3,204298,204299,204302,1,4,0
58301,1,3,204299,204302,204305,3,6,0
58302,1,2,204300,204305,204307,5,7,0
58303,2,2,204302,204307,204309,5,7,0
58304,5,3,204307,204309,204312,2,5,0
58305,3,3,204310,204312,204315,2,5,0
58306,5,1,204315,204315,204316,0,1,0
58307,2,3,204317,204317,204320,0,3,1
58308,4,1,204321,204321,204322,0,1,1
58309,1,3,204322,204322,204325,0,3,0
58310,2,2,204324,204325,204327,1,3,0
58311,5,2,204329,204329,204331,0,2,2
58312,2,1,204331,204331,204332,0,1,0
58313,5,2,204336,204336,204338,0,2,4
58314,6,2,204342,204342,204344,0,2,4
58315,2,3,204344,204344,204347,0,3,0
58316,2,2,204346,204347,204349,1,3,0
58317,2,1,204348,204349,204350,1,2,0
58318,4,1,204352,204352,204353,0,1,2
58319,4,3,204356,204356,204359,0,3,3
58320,5,2,204361,204361,204363,0,2,2
58321,2,3,204363,204363,204366,0,3,0
58322,2,1,204365,204366,204367,1,2,0
58323,1,2,204366,204367,204369,1,3,0
58324,3,1,204369,204369,204370,0,1,0
58325,4,3,204373,204373,204376,0,3,3
58326,4,1,204377,204377,204378,0,1,1
58327,4,2,204381,204381,204383,0,2,3
58328,6,1,204387,204387,204388,0,1,4
58329,6,3,204393,204393,204396,0,3,5
58330,5,1,204398,204398,204399,0,1,2
58331,4,2,204402,204402,204404,0,2,3
58332,2,3,204404,204404,204407,0,3,0
58333,2,2,204406,204407,204409,1,3,0
58334,1,3,204407,204409,204412,2,5,0
58335,4,2,204411,204412,204414,1,3,0
58336,1,1,204412,204414,204415,2,3,0
58337,5,1,204417,204417,204418,0,1,2
58338,1,3,204418,204418,204421,0,3,0
58339,2,1,204420,204421,204422,1,2,0
58340,3,1,204423,204423,204424,0,1,1
58341,3,2,204426,204426,204428,0,2,2
58342,6,1,204432,204432,204433,0,1,4
58343,6,2,204438,204438,204440,0,2,5
58344,3,2,204441,204441,204443,0,2,1
58345,4,2,204445,204445,204447,0,2,2
58346,4,1,204449,204449,204450,0,1,2
58347,4,3,204453,204453,204456,0,3,3
58348,4,2,204457,204457,204459,0,2,1
58349,5,3,204462,204462,204465,0,3,3
58350,4,1,204466,204466,204467,0,1,1
58351,5,1,204471,204471,204472,0,1,4
58352,5,1,204476,204476,204477,0,1,4
58353,3,1,204479,204479,204480,0,1,2
58354,2,2,204481,204481,204483,0,2,1
58355,3,1,204484,204484,204485,0,1,1
58356,2,3,204486,204486,204489,0,3,1
58357,4,3,204490,204490,204493,0,3,1
58358,6,2,204496,204496,204498,0,2,3
58359,5,1,204501,204501,204502,0,1,3
58360,1,1,204502,204502,204503,0,1,0
58361,1,1,204503,204503,204504,0,1,0
58362,6,2,204509,204509,204511,0,2,5
58363,5,2,204514,204514,204516,0,2,3
58364,2,1,204516,204516,204517,0,1,0
58365,2,3,204518,204518,204521,0,3,1
58366,6,1,204524,204524,204525,0,1,3
58367,5,3,204529,204529,204532,0,3,4
58368,2,2,204531,204532,204534,1,3,0
58369,5,1,204536,204536,204537,0,1,2
58370,4,2,204540,204540,204542,0,2,3
58371,6,3,204546,204546,204549,0,3,4
58372,6,3,204552,204552,204555,0,3,3
58373,4,3,204556,204556,204559,0,3,1
58374,4,3,204560,204560,204563,0,3,1
58375,2,2,204562,204563,204565,1,3,0
58376,3,1,204565,204565,204566,0,1,0
58377,6,2,204571,204571,204573,0,2,5
58378,4,1,204575,204575,204576,0,1,2
58379,4,2,204579,204579,204581,0,2,3
58380,1,2,204580,204581,204583,1,3,0
58381,6,3,204586,204586,204589,0,3,3
58382,1,3,204587,204589,204592,2,5,0
58383,5,1,204592,204592,204593,0,1,0
58384,3,3,204595,204595,204598,0,3,2
58385,3,3,204598,204598,204601,0,3,0
58386,5,3,204603,204603,204606,0,3,2
58387,4,1,204607,204607,204608,0,1,1
58388,5,3,204612,204612,204615,0,3,4
58389,6,2,204618,204618,204620,0,2,3
58390,4,1,204622,204622,204623,0,1,2
58391,5,3,204627,204627,204630,0,3,4
58392,1,3,204628,204630,204633,2,5,0
58393,4,1,204632,204633,204634,1,2,0
58394,6,1,204638,204638,204639,0,1,4
58395,5,1,204643,204643,204644,0,1,4
58396,1,3,204644,204644,204647,0,3,0
58397,1,3,204645,204647,204650,2,5,0
58398,6,3,204651,204651,204654,0,3,1
58399,6,2,204657,204657,204659,0,2,3
58400,1,2,204658,204659,204661,1,3,0
58401,3,1,204661,204661,204662,0,1,0
58402,6,3,204667,204667,204670,0,3,5
58403,4,2,204671,204671,204673,0,2,1
58404,6,3,204677,204677,204680,0,3,4
58405,2,2,204679,204680,204682,1,3,0
58406,1,2,204680,204682,204684,2,4,0
58407,6,1,204686,204686,204687,0,1,2
58408,1,3,204687,204687,204690,0,3,0
58409,5,1,204692,204692,204693,0,1,2
58410,1,1,204693,204693,204694,0,1,0
58411,4,2,204697,204697,204699,0,2,3
58412,3,1,204700,204700,204701,0,1,1
58413,2,3,204702,204702,204705,0,3,1
58414,4,1,204706,204706,204707,0,1,1
58415,4,1,204710,204710,204711,0,1,3
58416,1,1,204711,204711,204712,0,1,0
58417,2,2,204713,204713,204715,0,2,1
58418,5,1,204718,204718,204719,0,1,3
58419,5,3,204723,204723,204726,0,3,4
58420,4,1,204727,204727,204728,0,1,1
58421,4,2,204731,204731,204733,0,2,3
58422,4,2,204735,204735,204737,0,2,2
58423,3,2,204738,204738,204740,0,2,1
58424,5,3,204743,204743,204746,0,3,3
58425,6,1,204749,204749,204750,0,1,3
58426,6,2,204755,204755,204757,0,2,5
58427,3,1,204758,204758,204759,0,1,1
58428,5,1,204763,204763,204764,0,1,4
58429,3,1,204766,204766,204767,0,1,2
58430,4,1,204770,204770,204771,0,1,3
58431,1,2,204771,204771,204773,0,2,0
58432,4,1,204775,204775,204776,0,1,2
58433,5,2,204780,204780,204782,0,2,4
58434,1,2,204781,204782,204784,1,3,0
58435,1,1,204782,204784,204785,2,3,0
58436,5,2,204787,204787,204789,0,2,2
58437,1,1,204788,204789,204790,1,2,0
58438,2,2,204790,204790,204792,0,2,0
58439,5,2,204795,204795,204797,0,2,3
58440,4,3,204799,204799,204802,0,3,2
58441,6,1,204805,204805,204806,0,1,3
58442,3,1,204808,204808,204809,0,1,2
58443,6,1,204814,204814,204815,0,1,5
58444,5,2,204819,204819,204821,0,2,4
58445,6,1,204825,204825,204826,0,1,4
58446,4,2,204829,204829,204831,0,2,3
58447,1,3,204830,204831,204834,1,4,0
58448,4,2,204834,204834,204836,0,2,0
58449,6,1,204840,204840,204841,0,1,4
58450,1,2,204841,204841,204843,0,2,0
58451,5,2,204846,204846,204848,0,2,3
58452,4,2,204850,204850,204852,0,2,2
58453,1,3,204851,204852,204855,1,4,0
58454,5,1,204856,204856,204857,0,1,1
58455,6,2,204862,204862,204864,0,2,5
58456,1,2,204863,204864,204866,1,3,0
58457,1,1,204864,204866,204867,2,3,0
58458,6,3,204870,204870,204873,0,3,3
58459,3,1,204873,204873,204874,0,1,0
58460,2,3,204875,204875,204878,0,3,1
58461,6,1,204881,204881,204882,0,1,3
58462,6,2,204887,204887,204889,0,2,5
58463,1,2,204888,204889,204891,1,3,0
58464,6,3,204894,204894,204897,0,3,3
58465,3,2,204897,204897,204899,0,2,0
58466,2,3,204899,204899,204902,0,3,0
58467,5,1,204904,204904,204905,0,1,2
58468,5,1,204909,204909,204910,0,1,4
58469,5,3,204914,204914,204917,0,3,4
58470,5,2,204919,204919,204921,0,2,2
58471,4,2,204923,204923,204925,0,2,2
58472,4,1,204927,204927,204928,0,1,2
58473,3,3,204930,204930,204933,0,3,2
58474,4,1,204934,204934,204935,0,1,1
58475,2,2,204936,204936,204938,0,2,1
58476,2,2,204938,204938,204940,0,2,0
58477,1,3,204939,204940,204943,1,4,0
58478,4,2,204943,204943,204945,0,2,0
58479,6,2,204949,204949,204951,0,2,4
58480,3,2,204952,204952,204954,0,2,1
58481,1,3,204953,204954,204957,1,4,0
58482,3,1,204956,204957,204958,1,2,0
58483,1,3,204957,204958,204961,1,4,0
58484,6,3,204963,204963,204966,0,3,2
58485,2,2,204965,204966,204968,1,3,0
58486,6,3,204971,204971,204974,0,3,3
58487,3,2,204974,204974,204976,0,2,0
58488,1,3,204975,204976,204979,1,4,0
58489,2,2,204977,204979,204981,2,4,0
58490,1,1,204978,204981,204982,3,4,0
58491,4,1,204982,204982,204983,0,1,0
58492,1,2,204983,204983,204985,0,2,0
58493,2,3,204985,204985,204988,0,3,0
58494,6,3,204991,204991,204994,0,3,3
58495,1,2,204992,204994,204996,2,4,0
58496,6,2,204998,204998,205000,0,2,2
58497,6,3,205004,205004,205007,0,3,4
58498,6,1,205010,205010,205011,0,1,3
58499,2,3,205012,205012,205015,0,3,1
58500,2,1,205014,205015,205016,1,2,0
58501,3,3,205017,205017,205020,0,3,1
58502,5,3,205022,205022,205025,0,3,2
58503,5,2,205027,205027,205029,0,2,2
58504,5,2,205032,205032,205034,0,2,3
58505,3,2,205035,205035,205037,0,2,1
58506,6,3,205041,205041,205044,0,3,4
58507,6,2,205047,205047,205049,0,2,3
58508,1,1,205048,205049,205050,1,2,0
58509,3,1,205051,205051,205052,0,1,1
58510,2,2,205053,205053,205055,0,2,1
58511,3,1,205056,205056,205057,0,1,1
58512,1,1,205057,205057,205058,0,1,0
58513,6,3,205063,205063,205066,0,3,5
58514,1,3,205064,205066,205069,2,5,0
58515,2,1,205066,205069,205070,3,4,0
58516,6,1,205072,205072,205073,0,1,2
58517,1,2,205073,205073,205075,0,2,0
58518,5,1,205078,205078,205079,0,1,3
58519,3,3,205081,205081,205084,0,3,2
58520,3,3,205084,205084,205087,0,3,0
58521,1,2,205085,205087,205089,2,4,0
58522,6,3,205091,205091,205094,0,3,2
58523,4,1,205095,205095,205096,0,1,1
58524,3,3,205098,205098,205101,0,3,2
58525,2,2,205100,205101,205103,1,3,0
58526,4,1,205104,205104,205105,0,1,1
58527,6,1,205110,205110,205111,0,1,5
58528,5,3,205115,205115,205118,0,3,4
58529,5,3,205120,205120,205123,0,3,2
58530,3,3,205123,205123,205126,0,3,0
58531,4,3,205127,205127,205130,0,3,1
58532,1,1,205128,205130,205131,2,3,0
58533,5,2,205133,205133,205135,0,2,2
58534,1,2,205134,205135,205137,1,3,0
58535,6,3,205140,205140,205143,0,3,3
58536,2,2,205142,205143,205145,1,3,0
58537,6,3,205148,205148,205151,0,3,3
58538,3,2,205151,205151,205153,0,2,0
58539,6,2,205157,205157,205159,0,2,4
58540,5,3,205162,205162,205165,0,3,3
58541,5,3,205167,205167,205170,0,3,2
58542,3,1,205170,205170,205171,0,1,0
58543,6,2,205176,205176,205178,0,2,5
58544,4,2,205180,205180,205182,0,2,2
58545,3,2,205183,205183,205185,0,2,1
58546,3,1,205186,205186,205187,0,1,1
58547,5,3,205191,205191,205194,0,3,4
58548,5,1,205196,205196,205197,0,1,2
58549,4,2,205200,205200,205202,0,2,3
58550,3,1,205203,205203,205204,0,1,1
58551,5,2,205208,205208,205210,0,2,4
58552,1,3,205209,205210,205213,1,4,0
58553,5,3,205214,205214,205217,0,3,1
58554,4,2,205218,205218,205220,0,2,1
58555,2,3,205220,205220,205223,0,3,0
58556,3,1,205223,205223,205224,0,1,0
58557,6,1,205229,205229,205230,0,1,5
58558,4,3,205233,205233,205236,0,3,3
58559,3,3,205236,205236,205239,0,3,0
58560,6,3,205242,205242,205245,0,3,3
58561,2,1,205244,205245,205246,1,2,0
58562,2,2,205246,205246,205248,0,2,0
58563,2,1,205248,205248,205249,0,1,0
58564,1,1,205249,205249,205250,0,1,0
58565,4,3,205253,205253,205256,0,3,3
58566,4,1,205257,205257,205258,0,1,1
58567,3,3,205260,205260,205263,0,3,2
58568,2,2,205262,205263,205265,1,3,0
58569,4,2,205266,205266,205268,0,2,1
58570,6,3,205272,205272,205275,0,3,4
58571,6,3,205278,205278,205281,0,3,3
58572,2,1,205280,205281,205282,1,2,0
58573,1,2,205281,205282,205284,1,3,0
58574,2,2,205283,205284,205286,1,3,0
58575,3,2,205286,205286,205288,0,2,0
58576,2,2,205288,205288,205290,0,2,0
58577,2,1,205290,205290,205291,0,1,0
58578,6,1,205296,205296,205297,0,1,5
58579,1,2,205297,205297,205299,0,2,0
58580,4,2,205301,205301,205303,0,2,2
58581,1,3,205302,205303,205306,1,4,0
58582,2,1,205304,205306,205307,2,3,0
58583,2,3,205306,205307,205310,1,4,0
58584,1,3,205307,205310,205313,3,6,0
58585,5,2,205312,205313,205315,1,3,0
58586,1,2,205313,205315,205317,2,4,0
58587,3,2,205316,205317,205319,1,3,0
58588,2,1,205318,205319,205320,1,2,0
58589,5,1,205323,205323,205324,0,1,3
58590,1,3,205324,205324,205327,0,3,0
58591,6,2,205330,205330,205332,0,2,3
58592,5,1,205335,205335,205336,0,1,3
58593,1,2,205336,205336,205338,0,2,0
58594,4,3,205340,205340,205343,0,3,2
58595,6,3,205346,205346,205349,0,3,3
58596,1,2,205347,205349,205351,2,4,0
58597,6,1,205353,205353,205354,0,1,2
58598,3,1,205356,205356,205357,0,1,2
58599,5,1,205361,205361,205362,0,1,4
58600,6,3,205367,205367,205370,0,3,5
58601,1,3,205368,205370,205373,2,5,0
58602,5,3,205373,205373,205376,0,3,0
58603,3,2,205376,205376,205378,0,2,0
58604,1,1,205377,205378,205379,1,2,0
58605,3,2,205380,205380,205382,0,2,1
58606,5,3,205385,205385,205388,0,3,3
58607,3,2,205388,205388,205390,0,2,0
58608,2,1,205390,205390,205391,0,1,0
58609,6,2,205396,205396,205398,0,2,5
58610,3,3,205399,205399,205402,0,3,1
58611,1,2,205400,205402,205404,2,4,0
58612,3,3,205403,205404,205407,1,4,0
58613,1,3,205404,205407,205410,3,6,0
58614,4,3,205408,205410,205413,2,5,0
58615,3,3,205411,205413,205416,2,5,0
58616,4,1,205415,205416,205417,1,2,0
58617,4,1,205419,205419,205420,0,1,2
58618,4,3,205423,205423,205426,0,3,3
58619,1,3,205424,205426,205429,2,5,0
58620,3,2,205427,205429,205431,2,4,0
58621,3,1,205430,205431,205432,1,2,0
58622,5,1,205435,205435,205436,0,1,3
58623,2,3,205437,205437,205440,0,3,1
58624,6,1,205443,205443,205444,0,1,3
58625,6,3,205449,205449,205452,0,3,5
58626,3,3,205452,205452,205455,0,3,0
58627,3,3,205455,205455,205458,0,3,0
58628,3,3,205458,205458,205461,0,3,0
58629,2,2,205460,205461,205463,1,3,0
58630,4,1,205464,205464,205465,0,1,1
58631,3,1,205467,205467,205468,0,1,2
58632,4,1,205471,205471,205472,0,1,3
58633,5,2,205476,205476,205478,0,2,4
58634,4,1,205480,205480,205481,0,1,2
58635,4,3,205484,205484,205487,0,3,3
58636,4,3,205488,205488,205491,0,3,1
58637,2,2,205490,205491,205493,1,3,0
58638,4,1,205494,205494,205495,0,1,1
58639,3,1,205497,205497,205498,0,1,2
58640,3,1,205500,205500,205501,0,1,2
58641,6,2,205506,205506,205508,0,2,5
58642,2,3,205508,205508,205511,0,3,0
58643,6,2,205514,205514,205516,0,2,3
58644,3,1,205517,205517,205518,0,1,1
58645,2,1,205519,205519,205520,0,1,1
58646,4,1,205523,205523,205524,0,1,3
58647,5,3,205528,205528,205531,0,3,4
58648,2,1,205530,205531,205532,1,2,0
58649,3,1,205533,205533,205534,0,1,1
58650,5,2,205538,205538,205540,0,2,4
58651,5,3,205543,205543,205546,0,3,3
58652,6,3,205549,205549,205552,0,3,3
58653,4,1,205553,205553,205554,0,1,1
58654,3,1,205556,205556,205557,0,1,2
58655,1,1,205557,205557,205558,0,1,0
58656,1,1,205558,205558,205559,0,1,0
58657,5,2,205563,205563,205565,0,2,4
58658,5,2,205568,205568,205570,0,2,3
58659,4,1,205572,205572,205573,0,1,2
58660,6,2,205578,205578,205580,0,2,5
58661,3,1,205581,205581,205582,0,1,1
58662,3,1,205584,205584,205585,0,1,2
58663,5,2,205589,205589,205591,0,2,4
58664,3,2,205592,205592,205594,0,2,1
58665,6,2,205598,205598,205600,0,2,4
58666,3,3,205601,205601,205604,0,3,1
58667,4,2,205605,205605,205607,0,2,1
58668,1,3,205606,205607,205610,1,4,0
58669,6,1,205612,205612,205613,0,1,2
58670,6,2,205618,205618,205620,0,2,5
58671,2,2,205620,205620,205622,0,2,0
58672,3,3,205623,205623,205626,0,3,1
58673,2,3,205625,205626,205629,1,4,0
58674,4,2,205629,205629,205631,0,2,0
58675,3,1,205632,205632,205633,0,1,1
58676,3,1,205635,205635,205636,0,1,2
58677,6,2,205641,205641,205643,0,2,5
58678,1,3,205642,205643,205646,1,4,0
58679,4,2,205646,205646,205648,0,2,0
58680,4,1,205650,205650,205651,0,1,2
58681,4,3,205654,205654,205657,0,3,3
58682,5,3,205659,205659,205662,0,3,2
58683,2,3,205661,205662,205665,1,4,0
58684,5,2,205666,205666,205668,0,2,1
58685,4,3,205670,205670,205673,0,3,2
58686,6,1,205676,205676,205677,0,1,3
58687,1,1,205677,205677,205678,0,1,0
58688,5,2,205682,205682,205684,0,2,4
58689,3,2,205685,205685,205687,0,2,1
58690,6,3,205691,205691,205694,0,3,4
58691,4,2,205695,205695,205697,0,2,1
58692,1,3,205696,205697,205700,1,4,0
58693,6,2,205702,205702,205704,0,2,2
58694,4,2,205706,205706,205708,0,2,2
58695,4,2,205710,205710,205712,0,2,2
58696,3,1,205713,205713,205714,0,1,1
58697,2,3,205715,205715,205718,0,3,1
58698,2,2,205717,205718,205720,1,3,0
58699,6,1,205723,205723,205724,0,1,3
58700,4,3,205727,205727,205730,0,3,3
58701,1,1,205728,205730,205731,2,3,0
58702,3,1,205731,205731,205732,0,1,0
58703,4,1,205735,205735,205736,0,1,3
58704,4,1,205739,205739,205740,0,1,3
58705,2,1,205741,205741,205742,0,1,1
58706,6,3,205747,205747,205750,0,3,5
58707,4,1,205751,205751,205752,0,1,1
58708,1,3,205752,205752,205755,0,3,0
58709,1,2,205753,205755,205757,2,4,0
58710,3,2,205756,205757,205759,1,3,0
58711,5,1,205761,205761,205762,0,1,2
58712,5,3,205766,205766,205769,0,3,4
58713,6,1,205772,205772,205773,0,1,3
58714,3,3,205775,205775,205778,0,3,2
58715,2,2,205777,205778,205780,1,3,0
58716,2,3,205779,205780,205783,1,4,0
58717,5,1,205784,205784,205785,0,1,1
58718,3,1,205787,205787,205788,0,1,2
58719,4,1,205791,205791,205792,0,1,3
58720,5,2,205796,205796,205798,0,2,4
58721,5,2,205801,205801,205803,0,2,3
58722,3,1,205804,205804,205805,0,1,1
58723,1,1,205805,205805,205806,0,1,0
58724,2,1,205807,205807,205808,0,1,1
58725,2,3,205809,205809,205812,0,3,1
58726,5,1,205814,205814,205815,0,1,2
58727,2,2,205816,205816,205818,0,2,1
58728,1,1,205817,205818,205819,1,2,0
58729,2,2,205819,205819,205821,0,2,0
58730,2,2,205821,205821,205823,0,2,0
58731,4,3,205825,205825,205828,0,3,2
58732,6,1,205831,205831,205832,0,1,3
58733,2,2,205833,205833,205835,0,2,1
58734,1,3,205834,205835,205838,1,4,0
58735,4,1,205838,205838,205839,0,1,0
58736,1,3,205839,205839,205842,0,3,0
58737,5,2,205844,205844,205846,0,2,2
58738,1,3,205845,205846,205849,1,4,0
58739,2,3,205847,205849,205852,2,5,0
58740,3,2,205850,205852,205854,2,4,0
58741,2,1,205852,205854,205855,2,3,0
58742,6,2,205858,205858,205860,0,2,3
58743,2,3,205860,205860,205863,0,3,0
58744,5,2,205865,205865,205867,0,2,2
58745,3,3,205868,205868,205871,0,3,1
58746,6,2,205874,205874,205876,0,2,3
58747,4,3,205878,205878,205881,0,3,2
58748,4,1,205882,205882,205883,0,1,1
58749,3,2,205885,205885,205887,0,2,2
58750,6,3,205891,205891,205894,0,3,4
58751,6,1,205897,205897,205898,0,1,3
58752,4,1,205901,205901,205902,0,1,3
58753,6,3,205907,205907,205910,0,3,5
58754,4,1,205911,205911,205912,0,1,1
58755,5,1,205916,205916,205917,0,1,4
58756,6,3,205922,205922,205925,0,3,5
58757,6,3,205928,205928,205931,0,3,3
58758,4,3,205932,205932,205935,0,3,1
58759,3,1,205935,205935,205936,0,1,0
58760,6,2,205941,205941,205943,0,2,5
58761,3,1,205944,205944,205945,0,1,1
58762,4,3,205948,205948,205951,0,3,3
58763,5,3,205953,205953,205956,0,3,2
58764,2,1,205955,205956,205957,1,2,0
58765,3,3,205958,205958,205961,0,3,1
58766,5,1,205963,205963,205964,0,1,2
58767,5,2,205968,205968,205970,0,2,4
58768,6,2,205974,205974,205976,0,2,4
58769,2,1,205976,205976,205977,0,1,0
58770,5,2,205981,205981,205983,0,2,4
58771,6,1,205987,205987,205988,0,1,4
58772,5,2,205992,205992,205994,0,2,4
58773,3,2,205995,205995,205997,0,2,1
58774,4,2,205999,205999,206001,0,2,2
58775,4,2,206003,206003,206005,0,2,2
58776,3,1,206006,206006,206007,0,1,1
58777,6,2,206012,206012,206014,0,2,5
58778,1,2,206013,206014,206016,1,3,0
58779,4,2,206017,206017,206019,0,2,1
58780,3,3,206020,206020,206023,0,3,1
58781,1,1,206021,206023,206024,2,3,0
58782,1,1,206022,206024,206025,2,3,0
58783,6,1,206028,206028,206029,0,1,3
58784,2,1,206030,206030,206031,0,1,1
58785,5,2,206035,206035,206037,0,2,4
58786,2,2,206037,206037,206039,0,2,0
58787,2,1,206039,206039,206040,0,1,0
58788,3,1,206042,206042,206043,0,1,2
58789,2,3,206044,206044,206047,0,3,1
58790,2,2,206046,206047,206049,1,3,0
58791,6,3,206052,206052,206055,0,3,3
58792,6,2,206058,206058,206060,0,2,3
58793,5,1,206063,206063,206064,0,1,3
58794,1,3,206064,206064,206067,0,3,0
58795,6,1,206070,206070,206071,0,1,3
58796,1,1,206071,206071,206072,0,1,0
58797,3,2,206074,206074,206076,0,2,2
58798,1,2,206075,206076,206078,1,3,0
58799,1,2,206076,206078,206080,2,4,0
58800,4,2,206080,206080,206082,0,2,0
58801,4,1,206084,206084,206085,0,1,2
58802,2,3,206086,206086,206089,0,3,1
58803,6,3,206092,206092,206095,0,3,3
58804,5,3,206097,206097,206100,0,3,2
58805,4,2,206101,206101,206103,0,2,1
58806,5,1,206106,206106,206107,0,1,3
58807,6,3,206112,206112,206115,0,3,5
58808,3,1,206115,206115,206116,0,1,0
58809,3,1,206118,206118,206119,0,1,2
58810,5,2,206123,206123,206125,0,2,4
58811,5,2,206128,206128,206130,0,2,3
58812,4,2,206132,206132,206134,0,2,2
58813,4,1,206136,206136,206137,0,1,2
58814,5,1,206141,206141,206142,0,1,4
58815,6,3,206147,206147,206150,0,3,5
58816,1,3,206148,206150,206153,2,5,0
58817,1,3,206149,206153,206156,4,7,0
58818,4,1,206153,206156,206157,3,4,0
58819,4,1,206157,206157,206158,0,1,0
58820,1,2,206158,206158,206160,0,2,0
58821,3,2,206161,206161,206163,0,2,1
58822,2,2,206163,206163,206165,0,2,0
58823,5,3,206168,206168,206171,0,3,3
58824,4,3,206172,206172,206175,0,3,1
58825,5,3,206177,206177,206180,0,3,2
58826,4,2,206181,206181,206183,0,2,1
58827,2,1,206183,206183,206184,0,1,0
58828,2,1,206185,206185,206186,0,1,1
58829,1,1,206186,206186,206187,0,1,0
58830,1,2,206187,206187,206189,0,2,0
58831,6,2,206193,206193,206195,0,2,4
58832,2,3,206195,206195,206198,0,3,0
58833,6,1,206201,206201,206202,0,1,3
58834,1,2,206202,206202,206204,0,2,0
58835,1,1,206203,206204,206205,1,2,0
58836,2,3,206205,206205,206208,0,3,0
58837,5,2,206210,206210,206212,0,2,2
58838,4,1,206214,206214,206215,0,1,2
58839,1,3,206215,206215,206218,0,3,0
58840,5,3,206220,206220,206223,0,3,2
58841,5,2,206225,206225,206227,0,2,2
58842,5,2,206230,206230,206232,0,2,3
58843,6,3,206236,206236,206239,0,3,4
58844,4,2,206240,206240,206242,0,2,1
58845,1,1,206241,206242,206243,1,2,0
58846,4,2,206245,206245,206247,0,2,2
58847,1,2,206246,206247,206249,1,3,0
58848,3,2,206249,206249,206251,0,2,0
58849,4,1,206253,206253,206254,0,1,2
58850,5,1,206258,206258,206259,0,1,4
58851,5,2,206263,206263,206265,0,2,4
58852,5,1,206268,206268,206269,0,1,3
58853,5,3,206273,206273,206276,0,3,4
58854,4,1,206277,206277,206278,0,1,1
58855,6,1,206283,206283,206284,0,1,5
58856,6,3,206289,206289,206292,0,3,5
58857,1,1,206290,206292,206293,2,3,0
58858,2,2,206292,206293,206295,1,3,0
58859,5,2,206297,206297,206299,0,2,2
58860,5,1,206302,206302,206303,0,1,3
58861,2,3,206304,206304,206307,0,3,1
58862,6,2,206310,206310,206312,0,2,3
58863,6,3,206316,206316,206319,0,3,4
58864,6,2,206322,206322,206324,0,2,3
58865,3,1,206325,206325,206326,0,1,1
58866,6,3,206331,206331,206334,0,3,5
58867,3,1,206334,206334,206335,0,1,0
58868,1,1,206335,206335,206336,0,1,0
58869,3,1,206338,206338,206339,0,1,2
58870,2,1,206340,206340,206341,0,1,1
58871,2,3,206342,206342,206345,0,3,1
58872,1,1,206343,206345,206346,2,3,0
58873,6,1,206349,206349,206350,0,1,3
58874,1,2,206350,206350,206352,0,2,0
58875,1,2,206351,206352,206354,1,3,0
58876,2,1,206353,206354,206355,1,2,0
58877,3,1,206356,206356,206357,0,1,1
58878,1,3,206357,206357,206360,0,3,0
58879,3,1,206360,206360,206361,0,1,0
58880,6,3,206366,206366,206369,0,3,5
58881,2,3,206368,206369,206372,1,4,0
58882,3,2,206371,206372,206374,1,3,0
58883,4,1,206375,206375,206376,0,1,1
58884,4,1,206379,206379,206380,0,1,3
58885,3,2,206382,206382,206384,0,2,2
58886,2,2,206384,206384,206386,0,2,0
58887,6,2,206390,206390,206392,0,2,4
58888,1,2,206391,206392,206394,1,3,0
58889,3,2,206394,206394,206396,0,2,0
58890,1,2,206395,206396,206398,1,3,0
58891,3,1,206398,206398,206399,0,1,0
58892,4,2,206402,206402,206404,0,2,3
58893,6,1,206408,206408,206409,0,1,4
58894,2,2,206410,206410,206412,0,2,1
58895,6,3,206416,206416,206419,0,3,4
58896,1,2,206417,206419,206421,2,4,0
58897,2,3,206419,206421,206424,2,5,0
58898,1,2,206420,206424,206426,4,6,0
58899,1,3,206421,206426,206429,5,8,0
58900,4,3,206425,206429,206432,4,7,0
58901,2,3,206427,206432,206435,5,8,0
58902,3,3,206430,206435,206438,5,8,0
58903,1,1,206431,206438,206439,7,8,0
58904,5,1,206436,206439,206440,3,4,0
58905,3,2,206439,206440,206442,1,3,0
58906,3,3,206442,206442,206445,0,3,0
58907,1,2,206443,206445,206447,2,4,0
58908,1,1,206444,206447,206448,3,4,0
58909,2,1,206446,206448,206449,2,3,0
58910,2,3,206448,206449,206452,1,4,0
58911,1,3,206449,206452,206455,3,6,0
58912,6,1,206455,206455,206456,0,1,0
58913,3,3,206458,206458,206461,0,3,2
58914,3,3,206461,206461,206464,0,3,0
58915,5,2,206466,206466,206468,0,2,2
58916,4,3,206470,206470,206473,0,3,2
58917,5,2,206475,206475,206477,0,2,2
58918,1,1,206476,206477,206478,1,2,0
58919,4,3,206480,206480,206483,0,3,2
58920,3,2,206483,206483,206485,0,2,0
58921,1,1,206484,206485,206486,1,2,0
58922,2,1,206486,206486,206487,0,1,0
58923,4,2,206490,206490,206492,0,2,3
58924,4,1,206494,206494,206495,0,1,2
58925,6,2,206500,206500,206502,0,2,5
58926,1,2,206501,206502,206504,1,3,0
58927,6,1,206507,206507,206508,0,1,3
58928,5,1,206512,206512,206513,0,1,4
58929,1,1,206513,206513,206514,0,1,0
58930,4,2,206517,206517,206519,0,2,3
58931,4,1,206521,206521,206522,0,1,2
58932,4,3,206525,206525,206528,0,3,3
58933,4,2,206529,206529,206531,0,2,1
58934,5,1,206534,206534,206535,0,1,3
58935,3,1,206537,206537,206538,0,1,2
58936,1,2,206538,206538,206540,0,2,0
58937,5,2,206543,206543,206545,0,2,3
58938,1,2,206544,206545,206547,1,3,0
58939,5,3,206549,206549,206552,0,3,2
58940,2,3,206551,206552,206555,1,4,0
58941,1,3,206552,206555,206558,3,6,0
58942,4,1,206556,206558,206559,2,3,0
58943,3,3,206559,206559,206562,0,3,0
58944,4,1,206563,206563,206564,0,1,1
58945,4,1,206567,206567,206568,0,1,3
58946,1,3,206568,206568,206571,0,3,0
58947,5,3,206573,206573,206576,0,3,2
58948,6,1,206579,206579,206580,0,1,3
58949,1,1,206580,206580,206581,0,1,0
58950,4,3,206584,206584,206587,0,3,3
58951,3,2,206587,206587,206589,0,2,0
58952,3,1,206590,206590,206591,0,1,1
58953,1,3,206591,206591,206594,0,3,0
58954,3,1,206594,206594,206595,0,1,0
58955,6,3,206600,206600,206603,0,3,5
58956,1,3,206601,206603,206606,2,5,0
58957,3,3,206604,206606,206609,2,5,0
58958,2,2,206606,206609,206611,3,5,0
58959,5,2,206611,206611,206613,0,2,0
58960,5,1,206616,206616,206617,0,1,3
58961,3,1,206619,206619,206620,0,1,2
58962,1,2,206620,206620,206622,0,2,0
58963,2,1,206622,206622,206623,0,1,0
58964,4,3,206626,206626,206629,0,3,3
58965,3,3,206629,206629,206632,0,3,0
58966,5,1,206634,206634,206635,0,1,2
58967,6,1,206640,206640,206641,0,1,5
58968,3,2,206643,206643,206645,0,2,2
58969,5,1,206648,206648,206649,0,1,3
58970,6,3,206654,206654,206657,0,3,5
58971,4,2,206658,206658,206660,0,2,1
58972,3,1,206661,206661,206662,0,1,1
58973,5,3,206666,206666,206669,0,3,4
58974,4,3,206670,206670,206673,0,3,1
58975,2,3,206672,206673,206676,1,4,0
58976,4,2,206676,206676,206678,0,2,0
58977,3,2,206679,206679,206681,0,2,1
58978,5,3,206684,206684,206687,0,3,3
58979,4,2,206688,206688,206690,0,2,1
58980,1,2,206689,206690,206692,1,3,0
58981,5,2,206694,206694,206696,0,2,2
58982,5,3,206699,206699,206702,0,3,3
58983,1,3,206700,206702,206705,2,5,0
58984,5,2,206705,206705,206707,0,2,0
58985,2,1,206707,206707,206708,0,1,0
58986,1,3,206708,206708,206711,0,3,0
58987,5,1,206713,206713,206714,0,1,2
58988,1,1,206714,206714,206715,0,1,0
58989,1,3,206715,206715,206718,0,3,0
58990,3,1,206718,206718,206719,0,1,0
58991,3,3,206721,206721,206724,0,3,2
58992,3,1,206724,206724,206725,0,1,0
58993,4,2,206728,206728,206730,0,2,3
58994,6,2,206734,206734,206736,0,2,4
58995,4,3,206738,206738,206741,0,3,2
58996,6,2,206744,206744,206746,0,2,3
58997,1,2,206745,206746,206748,1,3,0
58998,3,2,206748,206748,206750,0,2,0
58999,6,1,206754,206754,206755,0,1,4
59000,6,3,206760,206760,206763,0,3,5
59001,2,3,206762,206763,206766,1,4,0
59002,2,1,206764,206766,206767,2,3,0
59003,2,1,206766,206767,206768,1,2,0
59004,4,3,206770,206770,206773,0,3,2
59005,3,2,206773,206773,206775,0,2,0
59006,5,3,206778,206778,206781,0,3,3
59007,4,1,206782,206782,206783,0,1,1
59008,4,1,206786,206786,206787,0,1,3
59009,2,1,206788,206788,206789,0,1,1
59010,3,1,206791,206791,206792,0,1,2
59011,5,3,206796,206796,206799,0,3,4
59012,4,2,206800,206800,206802,0,2,1
59013,4,3,206804,206804,206807,0,3,2
59014,4,2,206808,206808,206810,0,2,1
59015,5,3,206813,206813,206816,0,3,3
59016,5,1,206818,206818,206819,0,1,2
59017,5,1,206823,206823,206824,0,1,4
59018,4,1,206827,206827,206828,0,1,3
59019,6,3,206833,206833,206836,0,3,5
59020,2,2,206835,206836,206838,1,3,0
59021,1,1,206836,206838,206839,2,3,0
59022,1,3,206837,206839,206842,2,5,0
59023,3,3,206840,206842,206845,2,5,0
59024,4,3,206844,206845,206848,1,4,0
59025,4,1,206848,206848,206849,0,1,0
59026,5,2,206853,206853,206855,0,2,4
59027,1,2,206854,206855,206857,1,3,0
59028,5,3,206859,206859,206862,0,3,2
59029,4,1,206863,206863,206864,0,1,1
59030,2,1,206865,206865,206866,0,1,1
59031,6,3,206871,206871,206874,0,3,5
59032,5,3,206876,206876,206879,0,3,2
59033,1,3,206877,206879,206882,2,5,0
59034,4,2,206881,206882,206884,1,3,0
59035,3,1,206884,206884,206885,0,1,0
59036,5,3,206889,206889,206892,0,3,4
59037,1,1,206890,206892,206893,2,3,0
59038,3,2,206893,206893,206895,0,2,0
59039,1,1,206894,206895,206896,1,2,0
59040,2,1,206896,206896,206897,0,1,0
59041,4,1,206900,206900,206901,0,1,3
59042,6,1,206906,206906,206907,0,1,5
59043,1,1,206907,206907,206908,0,1,0
59044,1,1,206908,206908,206909,0,1,0
59045,6,3,206914,206914,206917,0,3,5
59046,3,1,206917,206917,206918,0,1,0
59047,5,1,206922,206922,206923,0,1,4
59048,3,2,206925,206925,206927,0,2,2
59049,6,2,206931,206931,206933,0,2,4
59050,2,2,206933,206933,206935,0,2,0
59051,1,3,206934,206935,206938,1,4,0
59052,2,3,206936,206938,206941,2,5,0
59053,1,3,206937,206941,206944,4,7,0
59054,2,1,206939,206944,206945,5,6,0
59055,3,3,206942,206945,206948,3,6,0
59056,2,3,206944,206948,206951,4,7,0
59057,5,2,206949,206951,206953,2,4,0
59058,6,1,206955,206955,206956,0,1,2
59059,2,1,206957,206957,206958,0,1,1
59060,3,3,206960,206960,206963,0,3,2
59061,3,3,206963,206963,206966,0,3,0
59062,2,2,206965,206966,206968,1,3,0
59063,5,1,206970,206970,206971,0,1,2
59064,4,2,206974,206974,206976,0,2,3
59065,1,3,206975,206976,206979,1,4,0
59066,6,1,206981,206981,206982,0,1,2
59067,5,2,206986,206986,206988,0,2,4
59068,1,2,206987,206988,206990,1,3,0
59069,2,1,206989,206990,206991,1,2,0
59070,4,2,206993,206993,206995,0,2,2
59071,5,2,206998,206998,207000,0,2,3
59072,4,2,207002,207002,207004,0,2,2
59073,2,1,207004,207004,207005,0,1,0
59074,4,3,207008,207008,207011,0,3,3
59075,3,3,207011,207011,207014,0,3,0
59076,6,1,207017,207017,207018,0,1,3
59077,6,1,207023,207023,207024,0,1,5
59078,1,2,207024,207024,207026,0,2,0
59079,4,3,207028,207028,207031,0,3,2
59080,6,3,207034,207034,207037,0,3,3
59081,4,2,207038,207038,207040,0,2,1
59082,3,1,207041,207041,207042,0,1,1
59083,5,2,207046,207046,207048,0,2,4
59084,3,2,207049,207049,207051,0,2,1
59085,4,3,207053,207053,207056,0,3,2
59086,4,1,207057,207057,207058,0,1,1
59087,3,3,207060,207060,207063,0,3,2
59088,5,1,207065,207065,207066,0,1,2
59089,3,1,207068,207068,207069,0,1,2
59090,3,1,207071,207071,207072,0,1,2
59091,1,1,207072,207072,207073,0,1,0
59092,1,3,207073,207073,207076,0,3,0
59093,1,1,207074,207076,207077,2,3,0
59094,5,2,207079,207079,207081,0,2,2
59095,3,3,207082,207082,207085,0,3,1
59096,6,2,207088,207088,207090,0,2,3
59097,3,2,207091,207091,207093,0,2,1
59098,3,1,207094,207094,207095,0,1,1
59099,6,3,207100,207100,207103,0,3,5
59100,1,3,207101,207103,207106,2,5,0
59101,1,2,207102,207106,207108,4,6,0
59102,4,2,207106,207108,207110,2,4,0
59103,3,3,207109,207110,207113,1,4,0
59104,3,1,207112,207113,207114,1,2,0
59105,2,1,207114,207114,207115,0,1,0
59106,2,3,207116,207116,207119,0,3,1
59107,1,2,207117,207119,207121,2,4,0
59108,2,2,207119,207121,207123,2,4,0
59109,3,1,207122,207123,207124,1,2,0
59110,5,1,207127,207127,207128,0,1,3
59111,4,1,207131,207131,207132,0,1,3
59112,4,1,207135,207135,207136,0,1,3
59113,1,2,207136,207136,207138,0,2,0
59114,6,2,207142,207142,207144,0,2,4
59115,5,2,207147,207147,207149,0,2,3
59116,5,3,207152,207152,207155,0,3,3
59117,2,2,207154,207155,207157,1,3,0
59118,2,2,207156,207157,207159,1,3,0
59119,6,3,207162,207162,207165,0,3,3
59120,2,3,207164,207165,207168,1,4,0
59121,6,3,207170,207170,207173,0,3,2
59122,6,2,207176,207176,207178,0,2,3
59123,1,2,207177,207178,207180,1,3,0
59124,3,1,207180,207180,207181,0,1,0
59125,2,3,207182,207182,207185,0,3,1
59126,3,1,207185,207185,207186,0,1,0
59127,2,2,207187,207187,207189,0,2,1
59128,4,1,207191,207191,207192,0,1,2
59129,5,1,207196,207196,207197,0,1,4
59130,4,2,207200,207200,207202,0,2,3
59131,5,1,207205,207205,207206,0,1,3
59132,4,1,207209,207209,207210,0,1,3
59133,6,3,207215,207215,207218,0,3,5
59134,3,1,207218,207218,207219,0,1,0
59135,6,2,207224,207224,207226,0,2,5
59136,2,2,207226,207226,207228,0,2,0
59137,5,3,207231,207231,207234,0,3,3
59138,5,2,207236,207236,207238,0,2,2
59139,5,2,207241,207241,207243,0,2,3
59140,1,2,207242,207243,207245,1,3,0
59141,3,1,207245,207245,207246,0,1,0
59142,1,2,207246,207246,207248,0,2,0
59143,1,1,207247,207248,207249,1,2,0
59144,6,2,207253,207253,207255,0,2,4
59145,4,2,207257,207257,207259,0,2,2
59146,1,2,207258,207259,207261,1,3,0
59147,6,2,207264,207264,207266,0,2,3
59148,4,2,207268,207268,207270,0,2,2
59149,2,2,207270,207270,207272,0,2,0
59150,2,2,207272,207272,207274,0,2,0
59151,2,3,207274,207274,207277,0,3,0
59152,1,3,207275,207277,207280,2,5,0
59153,4,2,207279,207280,207282,1,3,0
59154,1,2,207280,207282,207284,2,4,0
59155,2,2,207282,207284,207286,2,4,0
59156,3,3,207285,207286,207289,1,4,0
59157,1,1,207286,207289,207290,3,4,0
59158,4,1,207290,207290,207291,0,1,0
59159,5,1,207295,207295,207296,0,1,4
59160,5,2,207300,207300,207302,0,2,4
59161,6,2,207306,207306,207308,0,2,4
59162,6,2,207312,207312,207314,0,2,4
59163,6,2,207318,207318,207320,0,2,4
59164,5,3,207323,207323,207326,0,3,3
59165,1,1,207324,207326,207327,2,3,0
59166,6,1,207330,207330,207331,0,1,3
59167,2,2,207332,207332,207334,0,2,1
59168,1,2,207333,207334,207336,1,3,0
59169,4,1,207337,207337,207338,0,1,1
59170,5,3,207342,207342,207345,0,3,4
59171,1,2,207343,207345,207347,2,4,0
59172,5,1,207348,207348,207349,0,1,1
59173,5,1,207353,207353,207354,0,1,4
59174,1,1,207354,207354,207355,0,1,0
59175,1,2,207355,207355,207357,0,2,0
59176,3,3,207358,207358,207361,0,3,1
59177,6,2,207364,207364,207366,0,2,3
59178,4,2,207368,207368,207370,0,2,2
59179,3,3,207371,207371,207374,0,3,1
59180,3,2,207374,207374,207376,0,2,0
59181,6,1,207380,207380,207381,0,1,4
59182,5,1,207385,207385,207386,0,1,4
59183,3,3,207388,207388,207391,0,3,2
59184,4,1,207392,207392,207393,0,1,1
59185,2,3,207394,207394,207397,0,3,1
59186,1,1,207395,207397,207398,2,3,0
59187,1,1,207396,207398,207399,2,3,0
59188,5,3,207401,207401,207404,0,3,2
59189,1,3,207402,207404,207407,2,5,0
59190,5,1,207407,207407,207408,0,1,0
59191,4,2,207411,207411,207413,0,2,3
59192,4,3,207415,207415,207418,0,3,2
59193,6,2,207421,207421,207423,0,2,3
59194,1,1,207422,207423,207424,1,2,0
59195,4,3,207426,207426,207429,0,3,2
59196,1,1,207427,207429,207430,2,3,0
59197,2,1,207429,207430,207431,1,2,0
59198,2,3,207431,207431,207434,0,3,0
59199,4,1,207435,207435,207436,0,1,1
59200,4,2,207439,207439,207441,0,2,3
59201,4,3,207443,207443,207446,0,3,2
59202,4,3,207447,207447,207450,0,3,1
59203,5,1,207452,207452,207453,0,1,2
59204,2,2,207454,207454,207456,0,2,1
59205,3,1,207457,207457,207458,0,1,1
59206,1,3,207458,207458,207461,0,3,0
59207,5,3,207463,207463,207466,0,3,2
59208,1,3,207464,207466,207469,2,5,0
59209,6,1,207470,207470,207471,0,1,1
59210,4,2,207474,207474,207476,0,2,3
59211,3,3,207477,207477,207480,0,3,1
59212,1,2,207478,207480,207482,2,4,0
59213,5,1,207483,207483,207484,0,1,1
59214,4,2,207487,207487,207489,0,2,3
59215,1,1,207488,207489,207490,1,2,0
59216,2,3,207490,207490,207493,0,3,0
59217,1,2,207491,207493,207495,2,4,0
59218,6,3,207497,207497,207500,0,3,2
59219,2,3,207499,207500,207503,1,4,0
59220,4,3,207503,207503,207506,0,3,0
59221,1,3,207504,207506,207509,2,5,0
59222,2,3,207506,207509,207512,3,6,0
59223,6,1,207512,207512,207513,0,1,0
59224,5,2,207517,207517,207519,0,2,4
59225,4,1,207521,207521,207522,0,1,2
59226,3,1,207524,207524,207525,0,1,2
59227,6,1,207530,207530,207531,0,1,5
59228,4,3,207534,207534,207537,0,3,3
59229,1,2,207535,207537,207539,2,4,0
59230,1,3,207536,207539,207542,3,6,0
59231,1,2,207537,207542,207544,5,7,0
59232,4,1,207541,207544,207545,3,4,0
59233,2,3,207543,207545,207548,2,5,0
59234,6,2,207549,207549,207551,0,2,1
59235,4,1,207553,207553,207554,0,1,2
59236,5,2,207558,207558,207560,0,2,4
59237,5,3,207563,207563,207566,0,3,3
59238,5,3,207568,207568,207571,0,3,2
59239,2,2,207570,207571,207573,1,3,0
59240,1,3,207571,207573,207576,2,5,0
59241,3,1,207574,207576,207577,2,3,0
59242,2,3,207576,207577,207580,1,4,0
59243,3,3,207579,207580,207583,1,4,0
59244,1,1,207580,207583,207584,3,4,0
59245,1,2,207581,207584,207586,3,5,0
59246,6,3,207587,207587,207590,0,3,1
59247,5,3,207592,207592,207595,0,3,2
59248,6,3,207598,207598,207601,0,3,3
59249,4,3,207602,207602,207605,0,3,1
59250,1,2,207603,207605,207607,2,4,0
59251,1,3,207604,207607,207610,3,6,0
59252,5,3,207609,207610,207613,1,4,0
59253,3,1,207612,207613,207614,1,2,0
59254,2,1,207614,207614,207615,0,1,0
59255,1,3,207615,207615,207618,0,3,0
59256,4,3,207619,207619,207622,0,3,1
59257,6,3,207625,207625,207628,0,3,3
59258,5,1,207630,207630,207631,0,1,2
59259,4,1,207634,207634,207635,0,1,3
59260,1,3,207635,207635,207638,0,3,0
59261,1,3,207636,207638,207641,2,5,0
59262,1,1,207637,207641,207642,4,5,0
59263,1,3,207638,207642,207645,4,7,0
59264,1,3,207639,207645,207648,6,9,0
59265,4,1,207643,207648,207649,5,6,0
59266,6,3,207649,207649,207652,0,3,0
59267,5,1,207654,207654,207655,0,1,2
59268,6,2,207660,207660,207662,0,2,5
59269,4,3,207664,207664,207667,0,3,2
59270,4,2,207668,207668,207670,0,2,1
59271,5,3,207673,207673,207676,0,3,3
59272,4,3,207677,207677,207680,0,3,1
59273,6,1,207683,207683,207684,0,1,3
59274,4,1,207687,207687,207688,0,1,3
59275,6,2,207693,207693,207695,0,2,5
59276,2,3,207695,207695,207698,0,3,0
59277,3,3,207698,207698,207701,0,3,0
59278,1,1,207699,207701,207702,2,3,0
59279,2,1,207701,207702,207703,1,2,0
59280,1,1,207702,207703,207704,1,2,0
59281,4,1,207706,207706,207707,0,1,2
59282,4,2,207710,207710,207712,0,2,3
59283,3,2,207713,207713,207715,0,2,1
59284,5,2,207718,207718,207720,0,2,3
59285,1,3,207719,207720,207723,1,4,0
59286,2,1,207721,207723,207724,2,3,0
59287,6,3,207727,207727,207730,0,3,3
59288,4,1,207731,207731,207732,0,1,1
59289,4,3,207735,207735,207738,0,3,3
59290,2,2,207737,207738,207740,1,3,0
59291,2,1,207739,207740,207741,1,2,0
59292,5,3,207744,207744,207747,0,3,3
59293,5,3,207749,207749,207752,0,3,2
59294,1,2,207750,207752,207754,2,4,0
59295,6,2,207756,207756,207758,0,2,2
59296,6,2,207762,207762,207764,0,2,4
59297,4,1,207766,207766,207767,0,1,2
59298,2,1,207768,207768,207769,0,1,1
59299,4,2,207772,207772,207774,0,2,3
59300,3,2,207775,207775,207777,0,2,1
59301,1,1,207776,207777,207778,1,2,0
59302,2,3,207778,207778,207781,0,3,0
59303,6,1,207784,207784,207785,0,1,3
59304,4,3,207788,207788,207791,0,3,3
59305,3,3,207791,207791,207794,0,3,0
59306,1,3,207792,207794,207797,2,5,0
59307,1,2,207793,207797,207799,4,6,0
59308,3,2,207796,207799,207801,3,5,0
59309,1,2,207797,207801,207803,4,6,0
59310,3,2,207800,207803,207805,3,5,0
59311,2,1,207802,207805,207806,3,4,0
59312,6,2,207808,207808,207810,0,2,2
59313,6,3,207814,207814,207817,0,3,4
59314,1,3,207815,207817,207820,2,5,0
59315,4,2,207819,207820,207822,1,3,0
59316,5,2,207824,207824,207826,0,2,2
59317,2,3,207826,207826,207829,0,3,0
59318,1,2,207827,207829,207831,2,4,0
59319,5,3,207832,207832,207835,0,3,1
59320,5,2,207837,207837,207839,0,2,2
59321,2,2,207839,207839,207841,0,2,0
59322,3,3,207842,207842,207845,0,3,1
59323,5,1,207847,207847,207848,0,1,2
59324,6,2,207853,207853,207855,0,2,5
59325,5,1,207858,207858,207859,0,1,3
59326,1,1,207859,207859,207860,0,1,0
59327,6,2,207865,207865,207867,0,2,5
59328,1,2,207866,207867,207869,1,3,0
59329,2,2,207868,207869,207871,1,3,0
59330,4,3,207872,207872,207875,0,3,1
59331,4,3,207876,207876,207879,0,3,1
59332,1,1,207877,207879,207880,2,3,0
59333,2,1,207879,207880,207881,1,2,0
59334,2,2,207881,207881,207883,0,2,0
59335,6,1,207887,207887,207888,0,1,4
59336,6,1,207893,207893,207894,0,1,5
59337,2,1,207895,207895,207896,0,1,1
59338,6,3,207901,207901,207904,0,3,5
59339,3,3,207904,207904,207907,0,3,0
59340,4,3,207908,207908,207911,0,3,1
59341,4,2,207912,207912,207914,0,2,1
59342,5,3,207917,207917,207920,0,3,3
59343,2,3,207919,207920,207923,1,4,0
59344,2,2,207921,207923,207925,2,4,0
59345,4,3,207925,207925,207928,0,3,0
59346,6,1,207931,207931,207932,0,1,3
59347,3,3,207934,207934,207937,0,3,2
59348,6,3,207940,207940,207943,0,3,3
59349,5,1,207945,207945,207946,0,1,2
59350,6,1,207951,207951,207952,0,1,5
59351,4,3,207955,207955,207958,0,3,3
59352,2,2,207957,207958,207960,1,3,0
59353,4,2,207961,207961,207963,0,2,1
59354,4,1,207965,207965,207966,0,1,2
59355,2,2,207967,207967,207969,0,2,1
59356,4,2,207971,207971,207973,0,2,2
59357,2,2,207973,207973,207975,0,2,0
59358,5,3,207978,207978,207981,0,3,3
59359,3,3,207981,207981,207984,0,3,0
59360,2,2,207983,207984,207986,1,3,0
59361,6,3,207989,207989,207992,0,3,3
59362,3,3,207992,207992,207995,0,3,0
59363,6,3,207998,207998,208001,0,3,3
59364,3,1,208001,208001,208002,0,1,0
59365,5,1,208006,208006,208007,0,1,4
59366,2,3,208008,208008,208011,0,3,1
59367,6,3,208014,208014,208017,0,3,3
59368,1,2,208015,208017,208019,2,4,0
59369,5,1,208020,208020,208021,0,1,1
59370,4,3,208024,208024,208027,0,3,3
59371,4,2,208028,208028,208030,0,2,1
59372,5,1,208033,208033,208034,0,1,3
59373,3,2,208036,208036,208038,0,2,2
59374,5,2,208041,208041,208043,0,2,3
59375,6,1,208047,208047,208048,0,1,4
59376,2,1,208049,208049,208050,0,1,1
59377,4,2,208053,208053,208055,0,2,3
59378,4,3,208057,208057,208060,0,3,2
59379,1,1,208058,208060,208061,2,3,0
59380,5,1,208063,208063,208064,0,1,2
59381,2,2,208065,208065,208067,0,2,1
59382,5,3,208070,208070,208073,0,3,3
59383,4,3,208074,208074,208077,0,3,1
59384,2,2,208076,208077,208079,1,3,0
59385,6,3,208082,208082,208085,0,3,3
59386,2,1,208084,208085,208086,1,2,0
59387,1,1,208085,208086,208087,1,2,0
59388,2,3,208087,208087,208090,0,3,0
59389,1,3,208088,208090,208093,2,5,0
59390,3,3,208091,208093,208096,2,5,0
59391,3,2,208094,208096,208098,2,4,0
59392,3,1,208097,208098,208099,1,2,0
59393,2,2,208099,208099,208101,0,2,0
59394,5,1,208104,208104,208105,0,1,3
59395,3,2,208107,208107,208109,0,2,2
59396,4,2,208111,208111,208113,0,2,2
59397,3,1,208114,208114,208115,0,1,1
59398,3,2,208117,208117,208119,0,2,2
59399,5,3,208122,208122,208125,0,3,3
59400,1,3,208123,208125,208128,2,5,0
59401,3,3,208126,208128,208131,2,5,0
59402,2,1,208128,208131,208132,3,4,0
59403,1,2,208129,208132,208134,3,5,0
59404,1,3,208130,208134,208137,4,7,0
59405,6,3,208136,208137,208140,1,4,0
59406,4,2,208140,208140,208142,0,2,0
59407,5,3,208145,208145,208148,0,3,3
59408,2,3,208147,208148,208151,1,4,0
59409,6,1,208153,208153,208154,0,1,2
59410,5,2,208158,208158,208160,0,2,4
59411,4,3,208162,208162,208165,0,3,2
59412,3,1,208165,208165,208166,0,1,0
59413,1,2,208166,208166,208168,0,2,0
59414,1,3,208167,208168,208171,1,4,0
59415,6,2,208173,208173,208175,0,2,2
59416,1,3,208174,208175,208178,1,4,0
59417,2,1,208176,208178,208179,2,3,0
59418,4,2,208180,208180,208182,0,2,1
59419,2,2,208182,208182,208184,0,2,0
59420,1,3,208183,208184,208187,1,4,0
59421,3,2,208186,208187,208189,1,3,0
59422,3,1,208189,208189,208190,0,1,0
59423,2,1,208191,208191,208192,0,1,1
59424,3,3,208194,208194,208197,0,3,2
59425,2,3,208196,208197,208200,1,4,0
59426,2,3,208198,208200,208203,2,5,0
59427,1,1,208199,208203,208204,4,5,0
59428,6,3,208205,208205,208208,0,3,1
59429,5,3,208210,208210,208213,0,3,2
59430,6,3,208216,208216,208219,0,3,3
59431,6,2,208222,208222,208224,0,2,3
59432,2,3,208224,208224,208227,0,3,0
59433,4,1,208228,208228,208229,0,1,1
59434,1,3,208229,208229,208232,0,3,0
59435,2,1,208231,208232,208233,1,2,0
59436,2,1,208233,208233,208234,0,1,0
59437,2,2,208235,208235,208237,0,2,1
59438,6,2,208241,208241,208243,0,2,4
59439,3,1,208244,208244,208245,0,1,1
59440,3,2,208247,208247,208249,0,2,2
59441,2,3,208249,208249,208252,0,3,0
59442,6,3,208255,208255,208258,0,3,3
59443,4,1,208259,208259,208260,0,1,1
59444,6,1,208265,208265,208266,0,1,5
59445,5,3,208270,208270,208273,0,3,4
59446,6,3,208276,208276,208279,0,3,3
59447,3,3,208279,208279,208282,0,3,0
59448,2,2,208281,208282,208284,1,3,0
59449,4,3,208285,208285,208288,0,3,1
59450,3,1,208288,208288,208289,0,1,0
59451,5,3,208293,208293,208296,0,3,4
59452,4,3,208297,208297,208300,0,3,1
59453,4,1,208301,208301,208302,0,1,1
59454,4,3,208305,208305,208308,0,3,3
59455,3,1,208308,208308,208309,0,1,0
59456,2,3,208310,208310,208313,0,3,1
59457,2,3,208312,208313,208316,1,4,0
59458,5,2,208317,208317,208319,0,2,1
59459,5,3,208322,208322,208325,0,3,3
59460,3,2,208325,208325,208327,0,2,0
59461,5,3,208330,208330,208333,0,3,3
59462,6,1,208336,208336,208337,0,1,3
59463,6,1,208342,208342,208343,0,1,5
59464,6,2,208348,208348,208350,0,2,5
59465,2,3,208350,208350,208353,0,3,0
59466,4,3,208354,208354,208357,0,3,1
59467,4,1,208358,208358,208359,0,1,1
59468,2,3,208360,208360,208363,0,3,1
59469,5,2,208365,208365,208367,0,2,2
59470,3,2,208368,208368,208370,0,2,1
59471,1,1,208369,208370,208371,1,2,0
59472,5,1,208374,208374,208375,0,1,3
59473,3,1,208377,208377,208378,0,1,2
59474,1,1,208378,208378,208379,0,1,0
59475,3,2,208381,208381,208383,0,2,2
59476,6,1,208387,208387,208388,0,1,4
59477,1,2,208388,208388,208390,0,2,0
59478,1,3,208389,208390,208393,1,4,0
59479,2,2,208391,208393,208395,2,4,0
59480,6,1,208397,208397,208398,0,1,2
59481,6,2,208403,208403,208405,0,2,5
59482,1,3,208404,208405,208408,1,4,0
59483,5,3,208409,208409,208412,0,3,1
59484,5,1,208414,208414,208415,0,1,2
59485,5,3,208419,208419,208422,0,3,4
59486,1,3,208420,208422,208425,2,5,0
59487,5,1,208425,208425,208426,0,1,0
59488,5,1,208430,208430,208431,0,1,4
59489,6,1,208436,208436,208437,0,1,5
59490,2,3,208438,208438,208441,0,3,1
59491,4,1,208442,208442,208443,0,1,1
59492,5,3,208447,208447,208450,0,3,4
59493,4,3,208451,208451,208454,0,3,1
59494,6,1,208457,208457,208458,0,1,3
59495,1,3,208458,208458,208461,0,3,0
59496,4,1,208462,208462,208463,0,1,1
59497,4,2,208466,208466,208468,0,2,3
59498,1,2,208467,208468,208470,1,3,0
59499,5,2,208472,208472,208474,0,2,2
59500,6,1,208478,208478,208479,0,1,4
59501,3,1,208481,208481,208482,0,1,2
59502,2,1,208483,208483,208484,0,1,1
59503,1,1,208484,208484,208485,0,1,0
59504,1,1,208485,208485,208486,0,1,0
59505,5,1,208490,208490,208491,0,1,4
59506,4,3,208494,208494,208497,0,3,3
59507,6,1,208500,208500,208501,0,1,3
59508,5,1,208505,208505,208506,0,1,4
59509,2,1,208507,208507,208508,0,1,1
59510,6,1,208513,208513,208514,0,1,5
59511,2,3,208515,208515,208518,0,3,1
59512,1,2,208516,208518,208520,2,4,0
59513,1,2,208517,208520,208522,3,5,0
59514,4,1,208521,208522,208523,1,2,0
59515,1,2,208522,208523,208525,1,3,0
59516,4,2,208526,208526,208528,0,2,1
59517,5,1,208531,208531,208532,0,1,3
59518,3,3,208534,208534,208537,0,3,2
59519,2,2,208536,208537,208539,1,3,0
59520,4,1,208540,208540,208541,0,1,1
59521,2,3,208542,208542,208545,0,3,1
59522,5,1,208547,208547,208548,0,1,2
59523,4,2,208551,208551,208553,0,2,3
59524,6,1,208557,208557,208558,0,1,4
59525,6,1,208563,208563,208564,0,1,5
59526,5,3,208568,208568,208571,0,3,4
59527,2,1,208570,208571,208572,1,2,0
59528,6,1,208576,208576,208577,0,1,4
59529,4,1,208580,208580,208581,0,1,3
59530,6,3,208586,208586,208589,0,3,5
59531,6,1,208592,208592,208593,0,1,3
59532,2,2,208594,208594,208596,0,2,1
59533,5,2,208599,208599,208601,0,2,3
59534,1,3,208600,208601,208604,1,4,0
59535,2,3,208602,208604,208607,2,5,0
59536,6,2,208608,208608,208610,0,2,1
59537,3,1,208611,208611,208612,0,1,1
59538,1,2,208612,208612,208614,0,2,0
59539,1,3,208613,208614,208617,1,4,0
59540,5,3,208618,208618,208621,0,3,1
59541,6,2,208624,208624,208626,0,2,3
59542,5,2,208629,208629,208631,0,2,3
59543,5,1,208634,208634,208635,0,1,3
59544,5,1,208639,208639,208640,0,1,4
59545,3,1,208642,208642,208643,0,1,2
59546,5,2,208647,208647,208649,0,2,4
59547,4,1,208651,208651,208652,0,1,2
59548,6,1,208657,208657,208658,0,1,5
59549,6,2,208663,208663,208665,0,2,5
59550,5,2,208668,208668,208670,0,2,3
59551,5,3,208673,208673,208676,0,3,3
59552,4,3,208677,208677,208680,0,3,1
59553,4,2,208681,208681,208683,0,2,1
59554,5,1,208686,208686,208687,0,1,3
59555,2,1,208688,208688,208689,0,1,1
59556,4,1,208692,208692,208693,0,1,3
59557,1,3,208693,208693,208696,0,3,0
59558,5,3,208698,208698,208701,0,3,2
59559,1,2,208699,208701,208703,2,4,0
59560,5,1,208704,208704,208705,0,1,1
59561,5,1,208709,208709,208710,0,1,4
59562,3,3,208712,208712,208715,0,3,2
59563,6,2,208718,208718,208720,0,2,3
59564,2,1,208720,208720,208721,0,1,0
59565,1,3,208721,208721,208724,0,3,0
59566,1,3,208722,208724,208727,2,5,0
59567,5,2,208727,208727,208729,0,2,0
59568,5,1,208732,208732,208733,0,1,3
59569,2,1,208734,208734,208735,0,1,1
59570,4,1,208738,208738,208739,0,1,3
59571,1,2,208739,208739,208741,0,2,0
59572,6,1,208745,208745,208746,0,1,4
59573,1,2,208746,208746,208748,0,2,0
59574,1,3,208747,208748,208751,1,4,0
59575,3,2,208750,208751,208753,1,3,0
59576,3,2,208753,208753,208755,0,2,0
59577,1,2,208754,208755,208757,1,3,0
59578,5,1,208759,208759,208760,0,1,2
59579,3,2,208762,208762,208764,0,2,2
59580,4,3,208766,208766,208769,0,3,2
59581,1,3,208767,208769,208772,2,5,0
59582,2,3,208769,208772,208775,3,6,0
59583,6,3,208775,208775,208778,0,3,0
59584,2,1,208777,208778,208779,1,2,0
59585,1,3,208778,208779,208782,1,4,0
59586,4,3,208782,208782,208785,0,3,0
59587,1,2,208783,208785,208787,2,4,0
59588,1,3,208784,208787,208790,3,6,0
59589,2,2,208786,208790,208792,4,6,0
59590,1,3,208787,208792,208795,5,8,0
59591,4,1,208791,208795,208796,4,5,0
59592,3,3,208794,208796,208799,2,5,0
59593,5,1,208799,208799,208800,0,1,0
59594,4,3,208803,208803,208806,0,3,3
59595,5,1,208808,208808,208809,0,1,2
59596,1,1,208809,208809,208810,0,1,0
59597,3,3,208812,208812,208815,0,3,2
59598,6,3,208818,208818,208821,0,3,3
59599,2,3,208820,208821,208824,1,4,0
59600,2,3,208822,208824,208827,2,5,0
59601,2,3,208824,208827,208830,3,6,0
59602,1,2,208825,208830,208832,5,7,0
59603,1,1,208826,208832,208833,6,7,0
59604,6,2,208832,208833,208835,1,3,0
59605,5,1,208837,208837,208838,0,1,2
59606,1,1,208838,208838,208839,0,1,0
59607,5,3,208843,208843,208846,0,3,4
59608,2,1,208845,208846,208847,1,2,0
59609,5,1,208850,208850,208851,0,1,3
59610,4,3,208854,208854,208857,0,3,3
59611,3,1,208857,208857,208858,0,1,0
59612,3,3,208860,208860,208863,0,3,2
59613,6,2,208866,208866,208868,0,2,3
59614,6,3,208872,208872,208875,0,3,4
59615,4,1,208876,208876,208877,0,1,1
59616,5,3,208881,208881,208884,0,3,4
59617,5,3,208886,208886,208889,0,3,2
59618,4,1,208890,208890,208891,0,1,1
59619,6,3,208896,208896,208899,0,3,5
59620,3,3,208899,208899,208902,0,3,0
59621,6,3,208905,208905,208908,0,3,3
59622,4,3,208909,208909,208912,0,3,1
59623,3,2,208912,208912,208914,0,2,0
59624,3,3,208915,208915,208918,0,3,1
59625,4,3,208919,208919,208922,0,3,1
59626,2,2,208921,208922,208924,1,3,0
59627,1,2,208922,208924,208926,2,4,0
59628,4,1,208926,208926,208927,0,1,0
59629,4,3,208930,208930,208933,0,3,3
59630,1,1,208931,208933,208934,2,3,0
59631,4,3,208935,208935,208938,0,3,1
59632,2,2,208937,208938,208940,1,3,0
59633,1,1,208938,208940,208941,2,3,0
59634,3,2,208941,208941,208943,0,2,0
59635,1,1,208942,208943,208944,1,2,0
59636,3,2,208945,208945,208947,0,2,1
59637,1,1,208946,208947,208948,1,2,0
59638,5,1,208951,208951,208952,0,1,3
59639,3,1,208954,208954,208955,0,1,2
59640,1,2,208955,208955,208957,0,2,0
59641,4,3,208959,208959,208962,0,3,2
59642,5,2,208964,208964,208966,0,2,2
59643,6,2,208970,208970,208972,0,2,4
59644,2,1,208972,208972,208973,0,1,0
59645,1,1,208973,208973,208974,0,1,0
59646,6,1,208979,208979,208980,0,1,5
59647,2,3,208981,208981,208984,0,3,1
59648,5,1,208986,208986,208987,0,1,2
59649,5,2,208991,208991,208993,0,2,4
59650,4,2,208995,208995,208997,0,2,2
59651,5,2,209000,209000,209002,0,2,3
59652,4,2,209004,209004,209006,0,2,2
59653,4,3,209008,209008,209011,0,3,2
59654,4,1,209012,209012,209013,0,1,1
59655,4,1,209016,209016,209017,0,1,3
59656,4,2,209020,209020,209022,0,2,3
59657,5,1,209025,209025,209026,0,1,3
59658,4,3,209029,209029,209032,0,3,3
59659,4,1,209033,209033,209034,0,1,1
59660,3,1,209036,209036,209037,0,1,2
59661,4,2,209040,209040,209042,0,2,3
59662,5,2,209045,209045,209047,0,2,3
59663,4,1,209049,209049,209050,0,1,2
59664,6,2,209055,209055,209057,0,2,5
59665,6,3,209061,209061,209064,0,3,4
59666,2,2,209063,209064,209066,1,3,0
59667,4,2,209067,209067,209069,0,2,1
59668,2,1,209069,209069,209070,0,1,0
59669,6,2,209075,209075,209077,0,2,5
59670,6,3,209081,209081,209084,0,3,4
59671,3,1,209084,209084,209085,0,1,0
59672,1,3,209085,209085,209088,0,3,0
59673,1,1,209086,209088,209089,2,3,0
59674,6,3,209092,209092,209095,0,3,3
59675,6,1,209098,209098,209099,0,1,3
59676,1,1,209099,209099,209100,0,1,0
59677,5,3,209104,209104,209107,0,3,4
59678,2,3,209106,209107,209110,1,4,0
59679,1,3,209107,209110,209113,3,6,0
59680,6,2,209113,209113,209115,0,2,0
59681,6,2,209119,209119,209121,0,2,4
59682,3,2,209122,209122,209124,0,2,1
59683,4,1,209126,209126,209127,0,1,2
59684,2,2,209128,209128,209130,0,2,1
59685,5,2,209133,209133,209135,0,2,3
59686,5,2,209138,209138,209140,0,2,3
59687,6,2,209144,209144,209146,0,2,4
59688,5,3,209149,209149,209152,0,3,3
59689,6,3,209155,209155,209158,0,3,3
59690,1,3,209156,209158,209161,2,5,0
59691,2,1,209158,209161,209162,3,4,0
59692,4,1,209162,209162,209163,0,1,0
59693,2,1,209164,209164,209165,0,1,1
59694,1,2,209165,209165,209167,0,2,0
59695,1,1,209166,209167,209168,1,2,0
59696,4,3,209170,209170,209173,0,3,2
59697,1,3,209171,209173,209176,2,5,0
59698,3,2,209174,209176,209178,2,4,0
59699,2,2,209176,209178,209180,2,4,0
59700,3,2,209179,209180,209182,1,3,0
59701,4,2,209183,209183,209185,0,2,1
59702,1,3,209184,209185,209188,1,4,0
59703,3,1,209187,209188,209189,1,2,0
59704,1,1,209188,209189,209190,1,2,0
59705,1,3,209189,209190,209193,1,4,0
59706,2,1,209191,209193,209194,2,3,0
59707,4,1,209195,209195,209196,0,1,1
59708,5,2,209200,209200,209202,0,2,4
59709,2,1,209202,209202,209203,0,1,0
59710,2,1,209204,209204,209205,0,1,1
59711,4,1,209208,209208,209209,0,1,3
59712,1,2,209209,209209,209211,0,2,0
59713,1,1,209210,209211,209212,1,2,0
59714,5,1,209215,209215,209216,0,1,3
59715,3,2,209218,209218,209220,0,2,2
59716,6,1,209224,209224,209225,0,1,4
59717,4,3,209228,209228,209231,0,3,3
59718,4,1,209232,209232,209233,0,1,1
59719,1,1,209233,209233,209234,0,1,0
59720,5,1,209238,209238,209239,0,1,4
59721,1,1,209239,209239,209240,0,1,0
59722,1,3,209240,209240,209243,0,3,0
59723,4,3,209244,209244,209247,0,3,1
59724,1,1,209245,209247,209248,2,3,0
59725,3,2,209248,209248,209250,0,2,0
59726,5,1,209253,209253,209254,0,1,3
59727,3,1,209256,209256,209257,0,1,2
59728,1,3,209257,209257,209260,0,3,0
59729,3,3,209260,209260,209263,0,3,0
59730,6,3,209266,209266,209269,0,3,3
59731,2,3,209268,209269,209272,1,4,0
59732,2,1,209270,209272,209273,2,3,0
59733,4,2,209274,209274,209276,0,2,1
59734,1,2,209275,209276,209278,1,3,0
59735,1,3,209276,209278,209281,2,5,0
59736,4,1,209280,209281,209282,1,2,0
59737,6,1,209286,209286,209287,0,1,4
59738,6,2,209292,209292,209294,0,2,5
59739,5,1,209297,209297,209298,0,1,3
59740,1,2,209298,209298,209300,0,2,0
59741,5,2,209303,209303,209305,0,2,3
59742,1,3,209304,209305,209308,1,4,0
59743,1,3,209305,209308,209311,3,6,0
59744,4,1,209309,209311,209312,2,3,0
59745,6,2,209315,209315,209317,0,2,3
59746,6,1,209321,209321,209322,0,1,4
59747,6,1,209327,209327,209328,0,1,5
59748,3,3,209330,209330,209333,0,3,2
59749,6,2,209336,209336,209338,0,2,3
59750,4,1,209340,209340,209341,0,1,2
59751,2,2,209342,209342,209344,0,2,1
59752,5,1,209347,209347,209348,0,1,3
59753,5,1,209352,209352,209353,0,1,4
59754,5,1,209357,209357,209358,0,1,4
59755,2,2,209359,209359,209361,0,2,1
59756,2,3,209361,209361,209364,0,3,0
59757,3,2,209364,209364,209366,0,2,0
59758,2,1,209366,209366,209367,0,1,0
59759,3,3,209369,209369,209372,0,3,2
59760,4,2,209373,209373,209375,0,2,1
59761,1,1,209374,209375,209376,1,2,0
59762,3,1,209377,209377,209378,0,1,1
59763,2,1,209379,209379,209380,0,1,1
59764,1,1,209380,209380,209381,0,1,0
59765,5,3,209385,209385,209388,0,3,4
59766,5,3,209390,209390,209393,0,3,2
59767,1,3,209391,209393,209396,2,5,0
59768,4,1,209395,209396,209397,1,2,0
59769,2,3,209397,209397,209400,0,3,0
59770,1,1,209398,209400,209401,2,3,0
59771,5,1,209403,209403,209404,0,1,2
59772,1,2,209404,209404,209406,0,2,0
59773,6,1,209410,209410,209411,0,1,4
59774,1,1,209411,209411,209412,0,1,0
59775,5,1,209416,209416,209417,0,1,4
59776,2,2,209418,209418,209420,0,2,1
59777,4,1,209422,209422,209423,0,1,2
59778,1,3,209423,209423,209426,0,3,0
59779,4,1,209427,209427,209428,0,1,1
59780,6,1,209433,209433,209434,0,1,5
59781,3,2,209436,209436,209438,0,2,2
59782,1,2,209437,209438,209440,1,3,0
59783,1,1,209438,209440,209441,2,3,0
59784,5,2,209443,209443,209445,0,2,2
59785,2,1,209445,209445,209446,0,1,0
59786,6,1,209451,209451,209452,0,1,5
59787,2,2,209453,209453,209455,0,2,1
59788,1,2,209454,209455,209457,1,3,0
59789,1,3,209455,209457,209460,2,5,0
59790,2,3,209457,209460,209463,3,6,0
59791,1,3,209458,209463,209466,5,8,0
59792,1,3,209459,209466,209469,7,10,0
59793,5,2,209464,209469,209471,5,7,0
59794,5,1,209469,209471,209472,2,3,0
59795,4,2,209473,209473,209475,0,2,1
59796,4,3,209477,209477,209480,0,3,2
59797,6,1,209483,209483,209484,0,1,3
59798,5,3,209488,209488,209491,0,3,4
59799,6,1,209494,209494,209495,0,1,3
59800,2,2,209496,209496,209498,0,2,1
59801,1,2,209497,209498,209500,1,3,0
59802,4,3,209501,209501,209504,0,3,1
59803,6,3,209507,209507,209510,0,3,3
59804,2,2,209509,209510,209512,1,3,0
59805,4,2,209513,209513,209515,0,2,1
59806,5,2,209518,209518,209520,0,2,3
59807,6,1,209524,209524,209525,0,1,4
59808,2,1,209526,209526,209527,0,1,1
59809,2,3,209528,209528,209531,0,3,1
59810,5,2,209533,209533,209535,0,2,2
59811,3,3,209536,209536,209539,0,3,1
59812,3,1,209539,209539,209540,0,1,0
59813,1,3,209540,209540,209543,0,3,0
59814,4,3,209544,209544,209547,0,3,1
59815,6,1,209550,209550,209551,0,1,3
59816,1,1,209551,209551,209552,0,1,0
59817,6,2,209557,209557,209559,0,2,5
59818,3,3,209560,209560,209563,0,3,1
59819,6,1,209566,209566,209567,0,1,3
59820,3,1,209569,209569,209570,0,1,2
59821,3,1,209572,209572,209573,0,1,2
59822,6,1,209578,209578,209579,0,1,5
59823,5,2,209583,209583,209585,0,2,4
59824,4,3,209587,209587,209590,0,3,2
59825,2,3,209589,209590,209593,1,4,0
59826,6,3,209595,209595,209598,0,3,2
59827,6,3,209601,209601,209604,0,3,3
59828,6,1,209607,209607,209608,0,1,3
59829,4,2,209611,209611,209613,0,2,3
59830,5,1,209616,209616,209617,0,1,3
59831,4,3,209620,209620,209623,0,3,3
59832,1,2,209621,209623,209625,2,4,0
59833,1,2,209622,209625,209627,3,5,0
59834,1,2,209623,209627,209629,4,6,0
59835,1,2,209624,209629,209631,5,7,0
59836,3,3,209627,209631,209634,4,7,0
59837,1,2,209628,209634,209636,6,8,0
59838,3,1,209631,209636,209637,5,6,0
59839,3,3,209634,209637,209640,3,6,0
59840,1,3,209635,209640,209643,5,8,0
59841,4,1,209639,209643,209644,4,5,0
59842,1,2,209640,209644,209646,4,6,0
59843,2,1,209642,209646,209647,4,5,0
59844,3,3,209645,209647,209650,2,5,0
59845,2,2,209647,209650,209652,3,5,0
59846,2,3,209649,209652,209655,3,6,0
59847,5,1,209654,209655,209656,1,2,0
59848,4,2,209658,209658,209660,0,2,2
59849,4,3,209662,209662,209665,0,3,2
59850,1,2,209663,209665,209667,2,4,0
59851,5,2,209668,209668,209670,0,2,1
59852,4,2,209672,209672,209674,0,2,2
59853,6,1,209678,209678,209679,0,1,4
59854,4,2,209682,209682,209684,0,2,3
59855,1,1,209683,209684,209685,1,2,0
59856,5,2,209688,209688,209690,0,2,3
59857,3,3,209691,209691,209694,0,3,1
59858,1,2,209692,209694,209696,2,4,0
59859,1,2,209693,209696,209698,3,5,0
59860,4,3,209697,209698,209701,1,4,0
59861,5,2,209702,209702,209704,0,2,1
59862,5,3,209707,209707,209710,0,3,3
59863,2,3,209709,209710,209713,1,4,0
59864,6,2,209715,209715,209717,0,2,2
59865,2,2,209717,209717,209719,0,2,0
59866,5,3,209722,209722,209725,0,3,3
59867,3,3,209725,209725,209728,0,3,0
59868,5,1,209730,209730,209731,0,1,2
59869,2,3,209732,209732,209735,0,3,1
59870,6,1,209738,209738,209739,0,1,3
59871,1,2,209739,209739,209741,0,2,0
59872,3,1,209742,209742,209743,0,1,1
59873,5,2,209747,209747,209749,0,2,4
59874,4,3,209751,209751,209754,0,3,2
59875,3,2,209754,209754,209756,0,2,0
59876,1,2,209755,209756,209758,1,3,0
59877,5,3,209760,209760,209763,0,3,2
59878,1,1,209761,209763,209764,2,3,0
59879,3,2,209764,209764,209766,0,2,0
59880,2,3,209766,209766,209769,0,3,0
59881,2,2,209768,209769,209771,1,3,0
59882,4,2,209772,209772,209774,0,2,1
59883,1,2,209773,209774,209776,1,3,0
59884,6,2,209779,209779,209781,0,2,3
59885,5,3,209784,209784,209787,0,3,3
59886,1,1,209785,209787,209788,2,3,0
59887,4,1,209789,209789,209790,0,1,1
59888,4,3,209793,209793,209796,0,3,3
59889,6,2,209799,209799,209801,0,2,3
59890,4,1,209803,209803,209804,0,1,2
59891,2,3,209805,209805,209808,0,3,1
59892,3,3,209808,209808,209811,0,3,0
59893,2,2,209810,209811,209813,1,3,0
59894,6,1,209816,209816,209817,0,1,3
59895,2,2,209818,209818,209820,0,2,1
59896,6,3,209824,209824,209827,0,3,4
59897,2,1,209826,209827,209828,1,2,0
59898,5,3,209831,209831,209834,0,3,3
59899,5,1,209836,209836,209837,0,1,2
59900,4,3,209840,209840,209843,0,3,3
59901,1,2,209841,209843,209845,2,4,0
59902,3,3,209844,209845,209848,1,4,0
59903,2,2,209846,209848,209850,2,4,0
59904,6,1,209852,209852,209853,0,1,2
59905,6,3,209858,209858,209861,0,3,5
59906,1,3,209859,209861,209864,2,5,0
59907,6,3,209865,209865,209868,0,3,1
59908,2,2,209867,209868,209870,1,3,0
59909,1,3,209868,209870,209873,2,5,0
59910,5,1,209873,209873,209874,0,1,0
59911,6,3,209879,209879,209882,0,3,5
59912,4,1,209883,209883,209884,0,1,1
59913,1,2,209884,209884,209886,0,2,0
59914,4,2,209888,209888,209890,0,2,2
59915,1,3,209889,209890,209893,1,4,0
59916,4,1,209893,209893,209894,0,1,0
59917,1,2,209894,209894,209896,0,2,0
59918,6,2,209900,209900,209902,0,2,4
59919,1,1,209901,209902,209903,1,2,0
59920,1,1,209902,209903,209904,1,2,0
59921,4,3,209906,209906,209909,0,3,2
59922,5,2,209911,209911,209913,0,2,2
59923,6,1,209917,209917,209918,0,1,4
59924,6,1,209923,209923,209924,0,1,5
59925,1,1,209924,209924,209925,0,1,0
59926,3,1,209927,209927,209928,0,1,2
59927,6,3,209933,209933,209936,0,3,5
59928,1,3,209934,209936,209939,2,5,0
59929,3,3,209937,209939,209942,2,5,0
59930,3,1,209940,209942,209943,2,3,0
59931,5,3,209945,209945,209948,0,3,2
59932,3,3,209948,209948,209951,0,3,0
59933,3,1,209951,209951,209952,0,1,0
59934,4,3,209955,209955,209958,0,3,3
59935,2,3,209957,209958,209961,1,4,0
59936,4,2,209961,209961,209963,0,2,0
59937,6,3,209967,209967,209970,0,3,4
59938,3,3,209970,209970,209973,0,3,0
59939,6,1,209976,209976,209977,0,1,3
59940,3,2,209979,209979,209981,0,2,2
59941,4,1,209983,209983,209984,0,1,2
59942,3,2,209986,209986,209988,0,2,2
59943,6,1,209992,209992,209993,0,1,4
59944,4,2,209996,209996,209998,0,2,3
59945,4,2,210000,210000,210002,0,2,2
59946,3,2,210003,210003,210005,0,2,1
59947,1,3,210004,210005,210008,1,4,0
59948,6,1,210010,210010,210011,0,1,2
59949,1,1,210011,210011,210012,0,1,0
59950,4,1,210015,210015,210016,0,1,3
59951,1,3,210016,210016,210019,0,3,0
59952,3,3,210019,210019,210022,0,3,0
59953,1,1,210020,210022,210023,2,3,0
59954,3,3,210023,210023,210026,0,3,0
59955,6,2,210029,210029,210031,0,2,3
59956,3,2,210032,210032,210034,0,2,1
59957,4,1,210036,210036,210037,0,1,2
59958,3,1,210039,210039,210040,0,1,2
59959,3,1,210042,210042,210043,0,1,2
59960,4,1,210046,210046,210047,0,1,3
59961,6,3,210052,210052,210055,0,3,5
59962,3,3,210055,210055,210058,0,3,0
59963,5,1,210060,210060,210061,0,1,2
59964,5,2,210065,210065,210067,0,2,4
59965,1,2,210066,210067,210069,1,3,0
59966,5,1,210071,210071,210072,0,1,2
59967,3,2,210074,210074,210076,0,2,2
59968,5,2,210079,210079,210081,0,2,3
59969,4,2,210083,210083,210085,0,2,2
59970,1,3,210084,210085,210088,1,4,0
59971,5,3,210089,210089,210092,0,3,1
59972,4,3,210093,210093,210096,0,3,1
59973,5,1,210098,210098,210099,0,1,2
59974,3,2,210101,210101,210103,0,2,2
59975,3,2,210104,210104,210106,0,2,1
59976,3,1,210107,210107,210108,0,1,1
59977,2,3,210109,210109,210112,0,3,1
59978,4,3,210113,210113,210116,0,3,1
59979,5,3,210118,210118,210121,0,3,2
59980,2,2,210120,210121,210123,1,3,0
59981,1,2,210121,210123,210125,2,4,0
59982,3,3,210124,210125,210128,1,4,0
59983,5,3,210129,210129,210132,0,3,1
59984,1,3,210130,210132,210135,2,5,0
59985,4,3,210134,210135,210138,1,4,0
59986,1,1,210135,210138,210139,3,4,0
59987,4,3,210139,210139,210142,0,3,0
59988,6,2,210145,210145,210147,0,2,3
59989,5,2,210150,210150,210152,0,2,3
59990,5,1,210155,210155,210156,0,1,3
59991,4,1,210159,210159,210160,0,1,3
59992,5,2,210164,210164,210166,0,2,4
59993,2,3,210166,210166,210169,0,3,0
59994,1,2,210167,210169,210171,2,4,0
59995,3,2,210170,210171,210173,1,3,0
59996,6,2,210176,210176,210178,0,2,3
59997,2,3,210178,210178,210181,0,3,0
59998,3,2,210181,210181,210183,0,2,0
59999,2,2,210183,210183,210185,0,2,0
60000,5,2,210188,210188,210190,0,2,3
60001,6,1,210194,210194,210195,0,1,4
60002,4,3,210198,210198,210201,0,3,3
60003,2,2,210200,210201,210203,1,3,0
60004,3,2,210203,210203,210205,0,2,0
60005,6,1,210209,210209,210210,0,1,4
60006,3,3,210212,210212,210215,0,3,2
60007,3,1,210215,210215,210216,0,1,0
60008,5,1,210220,210220,210221,0,1,4
60009,3,2,210223,210223,210225,0,2,2
60010,6,3,210229,210229,210232,0,3,4
60011,5,1,210234,210234,210235,0,1,2
60012,5,2,210239,210239,210241,0,2,4
60013,6,1,210245,210245,210246,0,1,4
60014,4,3,210249,210249,210252,0,3,3
60015,4,3,210253,210253,210256,0,3,1
60016,6,1,210259,210259,210260,0,1,3
60017,1,1,210260,210260,210261,0,1,0
60018,2,1,210262,210262,210263,0,1,1
60019,5,2,210267,210267,210269,0,2,4
60020,3,3,210270,210270,210273,0,3,1
60021,1,2,210271,210273,210275,2,4,0
60022,1,2,210272,210275,210277,3,5,0
60023,5,1,210277,210277,210278,0,1,0
60024,5,2,210282,210282,210284,0,2,4
60025,2,3,210284,210284,210287,0,3,0
60026,2,3,210286,210287,210290,1,4,0
60027,4,1,210290,210290,210291,0,1,0
60028,5,3,210295,210295,210298,0,3,4
60029,6,2,210301,210301,210303,0,2,3
60030,2,3,210303,210303,210306,0,3,0
60031,6,1,210309,210309,210310,0,1,3
60032,3,2,210312,210312,210314,0,2,2
60033,1,1,210313,210314,210315,1,2,0
60034,6,3,210319,210319,210322,0,3,4
60035,2,1,210321,210322,210323,1,2,0
60036,1,2,210322,210323,210325,1,3,0
60037,4,3,210326,210326,210329,0,3,1
60038,4,3,210330,210330,210333,0,3,1
60039,5,1,210335,210335,210336,0,1,2
60040,2,1,210337,210337,210338,0,1,1
60041,6,2,210343,210343,210345,0,2,5
60042,6,2,210349,210349,210351,0,2,4
60043,5,3,210354,210354,210357,0,3,3
60044,1,3,210355,210357,210360,2,5,0
60045,1,1,210356,210360,210361,4,5,0
60046,2,2,210358,210361,210363,3,5,0
60047,6,3,210364,210364,210367,0,3,1
60048,4,3,210368,210368,210371,0,3,1
60049,5,1,210373,210373,210374,0,1,2
60050,6,2,210379,210379,210381,0,2,5
60051,1,1,210380,210381,210382,1,2,0
60052,4,3,210384,210384,210387,0,3,2
60053,6,2,210390,210390,210392,0,2,3
60054,4,2,210394,210394,210396,0,2,2
60055,4,1,210398,210398,210399,0,1,2
60056,2,2,210400,210400,210402,0,2,1
60057,3,2,210403,210403,210405,0,2,1
60058,5,3,210408,210408,210411,0,3,3
60059,1,1,210409,210411,210412,2,3,0
60060,2,1,210411,210412,210413,1,2,0
60061,5,2,210416,210416,210418,0,2,3
60062,3,2,210419,210419,210421,0,2,1
60063,6,3,210425,210425,210428,0,3,4
60064,1,1,210426,210428,210429,2,3,0
60065,4,2,210430,210430,210432,0,2,1
60066,2,3,210432,210432,210435,0,3,0
60067,2,1,210434,210435,210436,1,2,0
60068,1,3,210435,210436,210439,1,4,0
60069,3,3,210438,210439,210442,1,4,0
60070,3,3,210441,210442,210445,1,4,0
60071,4,2,210445,210445,210447,0,2,0
60072,4,1,210449,210449,210450,0,1,2
60073,6,2,210455,210455,210457,0,2,5
60074,3,3,210458,210458,210461,0,3,1
60075,6,3,210464,210464,210467,0,3,3
60076,4,2,210468,210468,210470,0,2,1
60077,4,1,210472,210472,210473,0,1,2
60078,4,1,210476,210476,210477,0,1,3
60079,3,1,210479,210479,210480,0,1,2
60080,4,3,210483,210483,210486,0,3,3
60081,6,3,210489,210489,210492,0,3,3
60082,5,1,210494,210494,210495,0,1,2
60083,2,1,210496,210496,210497,0,1,1
60084,2,2,210498,210498,210500,0,2,1
60085,3,1,210501,210501,210502,0,1,1
60086,3,3,210504,210504,210507,0,3,2
60087,1,3,210505,210507,210510,2,5,0
60088,6,2,210511,210511,210513,0,2,1
60089,5,2,210516,210516,210518,0,2,3
60090,1,3,210517,210518,210521,1,4,0
60091,1,3,210518,210521,210524,3,6,0
60092,2,1,210520,210524,210525,4,5,0
60093,4,2,210524,210525,210527,1,3,0
60094,6,3,210530,210530,210533,0,3,3
60095,3,3,210533,210533,210536,0,3,0
60096,4,2,210537,210537,210539,0,2,1
60097,1,3,210538,210539,210542,1,4,0
60098,5,1,210543,210543,210544,0,1,1
60099,3,2,210546,210546,210548,0,2,2
60100,1,2,210547,210548,210550,1,3,0
60101,6,1,210553,210553,210554,0,1,3
60102,2,1,210555,210555,210556,0,1,1
60103,5,2,210560,210560,210562,0,2,4
60104,1,3,210561,210562,210565,1,4,0
60105,2,2,210563,210565,210567,2,4,0
60106,3,1,210566,210567,210568,1,2,0
60107,1,2,210567,210568,210570,1,3,0
60108,6,2,210573,210573,210575,0,2,3
60109,4,3,210577,210577,210580,0,3,2
60110,2,2,210579,210580,210582,1,3,0
60111,6,1,210585,210585,210586,0,1,3
60112,5,1,210590,210590,210591,0,1,4
60113,5,3,210595,210595,210598,0,3,4
60114,2,2,210597,210598,210600,1,3,0
60115,3,1,210600,210600,210601,0,1,0
60116,3,1,210603,210603,210604,0,1,2
60117,1,3,210604,210604,210607,0,3,0
60118,6,3,210610,210610,210613,0,3,3
60119,2,1,210612,210613,210614,1,2,0
60120,6,1,210618,210618,210619,0,1,4
60121,3,1,210621,210621,210622,0,1,2
60122,4,1,210625,210625,210626,0,1,3
60123,4,3,210629,210629,210632,0,3,3
60124,5,1,210634,210634,210635,0,1,2
60125,2,3,210636,210636,210639,0,3,1
60126,5,1,210641,210641,210642,0,1,2
60127,6,1,210647,210647,210648,0,1,5
60128,4,2,210651,210651,210653,0,2,3
60129,3,3,210654,210654,210657,0,3,1
60130,3,2,210657,210657,210659,0,2,0
60131,2,3,210659,210659,210662,0,3,0
60132,3,2,210662,210662,210664,0,2,0
60133,5,3,210667,210667,210670,0,3,3
60134,3,1,210670,210670,210671,0,1,0
60135,3,2,210673,210673,210675,0,2,2
60136,4,3,210677,210677,210680,0,3,2
60137,3,1,210680,210680,210681,0,1,0
60138,3,1,210683,210683,210684,0,1,2
60139,4,2,210687,210687,210689,0,2,3
60140,5,3,210692,210692,210695,0,3,3
60141,3,3,210695,210695,210698,0,3,0
60142,4,3,210699,210699,210702,0,3,1
60143,1,3,210700,210702,210705,2,5,0
60144,6,2,210706,210706,210708,0,2,1
60145,1,3,210707,210708,210711,1,4,0
60146,2,2,210709,210711,210713,2,4,0
60147,3,3,210712,210713,210716,1,4,0
60148,6,2,210718,210718,210720,0,2,2
60149,2,2,210720,210720,210722,0,2,0
60150,4,1,210724,210724,210725,0,1,2
60151,6,2,210730,210730,210732,0,2,5
60152,6,1,210736,210736,210737,0,1,4
60153,1,3,210737,210737,210740,0,3,0
60154,5,3,210742,210742,210745,0,3,2
60155,1,3,210743,210745,210748,2,5,0
60156,1,2,210744,210748,210750,4,6,0
60157,3,2,210747,210750,210752,3,5,0
60158,6,2,210753,210753,210755,0,2,1
60159,6,1,210759,210759,210760,0,1,4
60160,3,1,210762,210762,210763,0,1,2
60161,3,3,210765,210765,210768,0,3,2
60162,4,3,210769,210769,210772,0,3,1
60163,6,2,210775,210775,210777,0,2,3
60164,5,1,210780,210780,210781,0,1,3
60165,5,3,210785,210785,210788,0,3,4
60166,3,2,210788,210788,210790,0,2,0
60167,2,2,210790,210790,210792,0,2,0
60168,5,3,210795,210795,210798,0,3,3
60169,3,2,210798,210798,210800,0,2,0
60170,1,2,210799,210800,210802,1,3,0
60171,1,1,210800,210802,210803,2,3,0
60172,3,2,210803,210803,210805,0,2,0
60173,1,2,210804,210805,210807,1,3,0
60174,3,1,210807,210807,210808,0,1,0
60175,1,3,210808,210808,210811,0,3,0
60176,3,1,210811,210811,210812,0,1,0
60177,4,2,210815,210815,210817,0,2,3
60178,1,2,210816,210817,210819,1,3,0
60179,5,3,210821,210821,210824,0,3,2
60180,1,2,210822,210824,210826,2,4,0
60181,3,1,210825,210826,210827,1,2,0
60182,6,3,210831,210831,210834,0,3,4
60183,4,3,210835,210835,210838,0,3,1
60184,1,3,210836,210838,210841,2,5,0
60185,1,1,210837,210841,210842,4,5,0
60186,3,3,210840,210842,210845,2,5,0
60187,4,3,210844,210845,210848,1,4,0
60188,5,3,210849,210849,210852,0,3,1
60189,2,1,210851,210852,210853,1,2,0
60190,3,3,210854,210854,210857,0,3,1
60191,5,3,210859,210859,210862,0,3,2
60192,4,1,210863,210863,210864,0,1,1
60193,5,3,210868,210868,210871,0,3,4
60194,6,2,210874,210874,210876,0,2,3
60195,6,2,210880,210880,210882,0,2,4
60196,4,3,210884,210884,210887,0,3,2
60197,3,2,210887,210887,210889,0,2,0
60198,3,2,210890,210890,210892,0,2,1
60199,3,1,210893,210893,210894,0,1,1
60200,5,1,210898,210898,210899,0,1,4
60201,3,1,210901,210901,210902,0,1,2
60202,2,3,210903,210903,210906,0,3,1
60203,6,3,210909,210909,210912,0,3,3
60204,4,1,210913,210913,210914,0,1,1
60205,2,2,210915,210915,210917,0,2,1
60206,2,1,210917,210917,210918,0,1,0
60207,2,1,210919,210919,210920,0,1,1
60208,5,2,210924,210924,210926,0,2,4
60209,5,1,210929,210929,210930,0,1,3
60210,2,1,210931,210931,210932,0,1,1
60211,5,3,210936,210936,210939,0,3,4
60212,4,1,210940,210940,210941,0,1,1
60213,5,1,210945,210945,210946,0,1,4
60214,4,1,210949,210949,210950,0,1,3
60215,1,3,210950,210950,210953,0,3,0
60216,3,1,210953,210953,210954,0,1,0
60217,2,1,210955,210955,210956,0,1,1
60218,4,2,210959,210959,210961,0,2,3
60219,5,1,210964,210964,210965,0,1,3
60220,5,1,210969,210969,210970,0,1,4
60221,2,3,210971,210971,210974,0,3,1
60222,3,1,210974,210974,210975,0,1,0
60223,6,3,210980,210980,210983,0,3,5
60224,4,3,210984,210984,210987,0,3,1
60225,6,1,210990,210990,210991,0,1,3
60226,5,3,210995,210995,210998,0,3,4
60227,3,1,210998,210998,210999,0,1,0
60228,5,2,211003,211003,211005,0,2,4
60229,3,1,211006,211006,211007,0,1,1
60230,1,1,211007,211007,211008,0,1,0
60231,6,2,211013,211013,211015,0,2,5
60232,2,2,211015,211015,211017,0,2,0
60233,1,3,211016,211017,211020,1,4,0
60234,2,2,211018,211020,211022,2,4,0
60235,4,1,211022,211022,211023,0,1,0
60236,2,1,211024,211024,211025,0,1,1
60237,4,2,211028,211028,211030,0,2,3
60238,2,1,211030,211030,211031,0,1,0
60239,2,2,211032,211032,211034,0,2,1
60240,3,3,211035,211035,211038,0,3,1
60241,4,1,211039,211039,211040,0,1,1
60242,2,1,211041,211041,211042,0,1,1
60243,3,1,211044,211044,211045,0,1,2
60244,4,3,211048,211048,211051,0,3,3
60245,3,3,211051,211051,211054,0,3,0
60246,2,2,211053,211054,211056,1,3,0
60247,4,1,211057,211057,211058,0,1,1
60248,3,3,211060,211060,211063,0,3,2
60249,6,1,211066,211066,211067,0,1,3
60250,1,2,211067,211067,211069,0,2,0
60251,6,3,211073,211073,211076,0,3,4
60252,2,2,211075,211076,211078,1,3,0
60253,1,3,211076,211078,211081,2,5,0
60254,5,1,211081,211081,211082,0,1,0
60255,6,3,211087,211087,211090,0,3,5
60256,4,2,211091,211091,211093,0,2,1
60257,4,3,211095,211095,211098,0,3,2
60258,3,1,211098,211098,211099,0,1,0
60259,4,1,211102,211102,211103,0,1,3
60260,1,2,211103,211103,211105,0,2,0
60261,2,1,211105,211105,211106,0,1,0
60262,5,1,211110,211110,211111,0,1,4
60263,6,2,211116,211116,211118,0,2,5
60264,3,3,211119,211119,211122,0,3,1
60265,3,2,211122,211122,211124,0,2,0
60266,6,2,211128,211128,211130,0,2,4
60267,1,3,211129,211130,211133,1,4,0
60268,4,2,211133,211133,211135,0,2,0
60269,6,2,211139,211139,211141,0,2,4
60270,1,2,211140,211141,211143,1,3,0
60271,4,3,211144,211144,211147,0,3,1
60272,5,2,211149,211149,211151,0,2,2
60273,3,2,211152,211152,211154,0,2,1
60274,3,1,211155,211155,211156,0,1,1
60275,3,3,211158,211158,211161,0,3,2
60276,5,2,211163,211163,211165,0,2,2
60277,1,1,211164,211165,211166,1,2,0
60278,3,2,211167,211167,211169,0,2,1
60279,1,1,211168,211169,211170,1,2,0
60280,4,2,211172,211172,211174,0,2,2
60281,3,1,211175,211175,211176,0,1,1
60282,5,3,211180,211180,211183,0,3,4
60283,2,1,211182,211183,211184,1,2,0
60284,4,1,211186,211186,211187,0,1,2
60285,4,1,211190,211190,211191,0,1,3
60286,3,2,211193,211193,211195,0,2,2
60287,1,2,211194,211195,211197,1,3,0
60288,5,2,211199,211199,211201,0,2,2
60289,4,3,211203,211203,211206,0,3,2
60290,4,3,211207,211207,211210,0,3,1
60291,4,3,211211,211211,211214,0,3,1
60292,2,3,211213,211214,211217,1,4,0
60293,4,2,211217,211217,211219,0,2,0
60294,1,2,211218,211219,211221,1,3,0
60295,6,2,211224,211224,211226,0,2,3
60296,6,2,211230,211230,211232,0,2,4
60297,6,3,211236,211236,211239,0,3,4
60298,5,2,211241,211241,211243,0,2,2
60299,4,1,211245,211245,211246,0,1,2
60300,6,3,211251,211251,211254,0,3,5
60301,2,2,211253,211254,211256,1,3,0
60302,2,1,211255,211256,211257,1,2,0
60303,1,2,211256,211257,211259,1,3,0
60304,3,2,211259,211259,211261,0,2,0
60305,2,1,211261,211261,211262,0,1,0
60306,1,1,211262,211262,211263,0,1,0
60307,6,1,211268,211268,211269,0,1,5
60308,6,1,211274,211274,211275,0,1,5
60309,2,1,211276,211276,211277,0,1,1
60310,3,1,211279,211279,211280,0,1,2
60311,1,3,211280,211280,211283,0,3,0
60312,1,2,211281,211283,211285,2,4,0
60313,6,2,211287,211287,211289,0,2,2
60314,2,2,211289,211289,211291,0,2,0
60315,1,1,211290,211291,211292,1,2,0
60316,2,3,211292,211292,211295,0,3,0
60317,6,3,211298,211298,211301,0,3,3
60318,3,3,211301,211301,211304,0,3,0
60319,1,1,211302,211304,211305,2,3,0
60320,2,1,211304,211305,211306,1,2,0
60321,5,3,211309,211309,211312,0,3,3
60322,4,2,211313,211313,211315,0,2,1
60323,1,3,211314,211315,211318,1,4,0
60324,4,1,211318,211318,211319,0,1,0
60325,2,1,211320,211320,211321,0,1,1
60326,2,3,211322,211322,211325,0,3,1
60327,6,2,211328,211328,211330,0,2,3
60328,2,2,211330,211330,211332,0,2,0
60329,6,2,211336,211336,211338,0,2,4
60330,3,1,211339,211339,211340,0,1,1
60331,5,1,211344,211344,211345,0,1,4
60332,4,2,211348,211348,211350,0,2,3
60333,4,2,211352,211352,211354,0,2,2
60334,5,2,211357,211357,211359,0,2,3
60335,2,2,211359,211359,211361,0,2,0
60336,2,2,211361,211361,211363,0,2,0
60337,4,1,211365,211365,211366,0,1,2
60338,1,1,211366,211366,211367,0,1,0
60339,4,2,211370,211370,211372,0,2,3
60340,4,1,211374,211374,211375,0,1,2
60341,4,1,211378,211378,211379,0,1,3
60342,4,3,211382,211382,211385,0,3,3
60343,2,1,211384,211385,211386,1,2,0
60344,5,2,211389,211389,211391,0,2,3
60345,2,2,211391,211391,211393,0,2,0
60346,3,1,211394,211394,211395,0,1,1
60347,1,2,211395,211395,211397,0,2,0
60348,6,2,211401,211401,211403,0,2,4
60349,6,2,211407,211407,211409,0,2,4
60350,3,3,211410,211410,211413,0,3,1
60351,6,3,211416,211416,211419,0,3,3
60352,5,2,211421,211421,211423,0,2,2
60353,4,1,211425,211425,211426,0,1,2
60354,4,3,211429,211429,211432,0,3,3
60355,4,2,211433,211433,211435,0,2,1
60356,3,1,211436,211436,211437,0,1,1
60357,4,2,211440,211440,211442,0,2,3
60358,5,1,211445,211445,211446,0,1,3
60359,1,2,211446,211446,211448,0,2,0
60360,4,3,211450,211450,211453,0,3,2
60361,1,1,211451,211453,211454,2,3,0
60362,1,3,211452,211454,211457,2,5,0
60363,3,2,211455,211457,211459,2,4,0
60364,3,2,211458,211459,211461,1,3,0
60365,3,2,211461,211461,211463,0,2,0
60366,2,3,211463,211463,211466,0,3,0
60367,1,1,211464,211466,211467,2,3,0
60368,5,3,211469,211469,211472,0,3,2
60369,4,2,211473,211473,211475,0,2,1
60370,1,3,211474,211475,211478,1,4,0
60371,4,2,211478,211478,211480,0,2,0
60372,2,2,211480,211480,211482,0,2,0
60373,4,3,211484,211484,211487,0,3,2
60374,3,3,211487,211487,211490,0,3,0
60375,1,1,211488,211490,211491,2,3,0
60376,5,3,211493,211493,211496,0,3,2
60377,1,3,211494,211496,211499,2,5,0
60378,5,2,211499,211499,211501,0,2,0
60379,1,3,211500,211501,211504,1,4,0
60380,6,1,211506,211506,211507,0,1,2
60381,2,3,211508,211508,211511,0,3,1
60382,5,2,211513,211513,211515,0,2,2
60383,5,1,211518,211518,211519,0,1,3
60384,5,1,211523,211523,211524,0,1,4
60385,2,3,211525,211525,211528,0,3,1
60386,5,1,211530,211530,211531,0,1,2
60387,3,1,211533,211533,211534,0,1,2
60388,4,3,211537,211537,211540,0,3,3
60389,3,1,211540,211540,211541,0,1,0
60390,2,1,211542,211542,211543,0,1,1
60391,2,1,211544,211544,211545,0,1,1
60392,4,1,211548,211548,211549,0,1,3
60393,1,3,211549,211549,211552,0,3,0
60394,3,1,211552,211552,211553,0,1,0
60395,6,1,211558,211558,211559,0,1,5
60396,5,3,211563,211563,211566,0,3,4
60397,3,2,211566,211566,211568,0,2,0
60398,6,1,211572,211572,211573,0,1,4
60399,5,1,211577,211577,211578,0,1,4
60400,5,1,211582,211582,211583,0,1,4
60401,6,2,211588,211588,211590,0,2,5
60402,5,1,211593,211593,211594,0,1,3
60403,1,2,211594,211594,211596,0,2,0
60404,5,2,211599,211599,211601,0,2,3
60405,1,2,211600,211601,211603,1,3,0
60406,3,2,211603,211603,211605,0,2,0
60407,4,1,211607,211607,211608,0,1,2
60408,1,3,211608,211608,211611,0,3,0
60409,5,1,211613,211613,211614,0,1,2
60410,4,1,211617,211617,211618,0,1,3
60411,1,1,211618,211618,211619,0,1,0
60412,4,3,211622,211622,211625,0,3,3
60413,4,2,211626,211626,211628,0,2,1
60414,3,2,211629,211629,211631,0,2,1
60415,2,3,211631,211631,211634,0,3,0
60416,1,2,211632,211634,211636,2,4,0
60417,6,3,211638,211638,211641,0,3,2
60418,5,3,211643,211643,211646,0,3,2
60419,2,2,211645,211646,211648,1,3,0
60420,6,3,211651,211651,211654,0,3,3
60421,6,3,211657,211657,211660,0,3,3
60422,1,1,211658,211660,211661,2,3,0
60423,4,2,211662,211662,211664,0,2,1
60424,4,2,211666,211666,211668,0,2,2
60425,4,2,211670,211670,211672,0,2,2
60426,1,1,211671,211672,211673,1,2,0
60427,1,1,211672,211673,211674,1,2,0
60428,2,2,211674,211674,211676,0,2,0
60429,5,3,211679,211679,211682,0,3,3
60430,4,2,211683,211683,211685,0,2,1
60431,4,1,211687,211687,211688,0,1,2
60432,4,1,211691,211691,211692,0,1,3
60433,5,3,211696,211696,211699,0,3,4
60434,5,2,211701,211701,211703,0,2,2
60435,5,1,211706,211706,211707,0,1,3
60436,2,1,211708,211708,211709,0,1,1
60437,2,3,211710,211710,211713,0,3,1
60438,2,2,211712,211713,211715,1,3,0
60439,4,2,211716,211716,211718,0,2,1
60440,1,1,211717,211718,211719,1,2,0
60441,5,1,211722,211722,211723,0,1,3
60442,5,1,211727,211727,211728,0,1,4
60443,1,2,211728,211728,211730,0,2,0
60444,5,1,211733,211733,211734,0,1,3
60445,3,1,211736,211736,211737,0,1,2
60446,3,3,211739,211739,211742,0,3,2
60447,3,2,211742,211742,211744,0,2,0
60448,5,2,211747,211747,211749,0,2,3
60449,3,3,211750,211750,211753,0,3,1
60450,5,2,211755,211755,211757,0,2,2
60451,1,1,211756,211757,211758,1,2,0
60452,1,1,211757,211758,211759,1,2,0
60453,3,3,211760,211760,211763,0,3,1
60454,1,3,211761,211763,211766,2,5,0
60455,1,2,211762,211766,211768,4,6,0
60456,4,1,211766,211768,211769,2,3,0
60457,5,2,211771,211771,211773,0,2,2
60458,2,2,211773,211773,211775,0,2,0
60459,1,2,211774,211775,211777,1,3,0
60460,5,2,211779,211779,211781,0,2,2
60461,3,2,211782,211782,211784,0,2,1
60462,1,2,211783,211784,211786,1,3,0
60463,5,3,211788,211788,211791,0,3,2
60464,5,2,211793,211793,211795,0,2,2
60465,4,2,211797,211797,211799,0,2,2
60466,5,2,211802,211802,211804,0,2,3
60467,2,2,211804,211804,211806,0,2,0
60468,5,3,211809,211809,211812,0,3,3
60469,5,2,211814,211814,211816,0,2,2
60470,1,3,211815,211816,211819,1,4,0
60471,1,3,211816,211819,211822,3,6,0
60472,2,1,211818,211822,211823,4,5,0
60473,4,1,211822,211823,211824,1,2,0
60474,6,1,211828,211828,211829,0,1,4
60475,2,3,211830,211830,211833,0,3,1
60476,4,1,211834,211834,211835,0,1,1
60477,6,1,211840,211840,211841,0,1,5
60478,5,2,211845,211845,211847,0,2,4
60479,6,3,211851,211851,211854,0,3,4
60480,6,1,211857,211857,211858,0,1,3
60481,3,1,211860,211860,211861,0,1,2
60482,4,2,211864,211864,211866,0,2,3
60483,4,3,211868,211868,211871,0,3,2
60484,2,1,211870,211871,211872,1,2,0
60485,6,2,211876,211876,211878,0,2,4
60486,1,3,211877,211878,211881,1,4,0
60487,3,2,211880,211881,211883,1,3,0
60488,3,3,211883,211883,211886,0,3,0
60489,1,3,211884,211886,211889,2,5,0
60490,5,3,211889,211889,211892,0,3,0
60491,3,1,211892,211892,211893,0,1,0
60492,3,2,211895,211895,211897,0,2,2
60493,2,3,211897,211897,211900,0,3,0
60494,4,3,211901,211901,211904,0,3,1
60495,3,2,211904,211904,211906,0,2,0
60496,5,2,211909,211909,211911,0,2,3
60497,4,1,211913,211913,211914,0,1,2
60498,4,2,211917,211917,211919,0,2,3
60499,1,3,211918,211919,211922,1,4,0
60500,1,1,211919,211922,211923,3,4,0
60501,4,3,211923,211923,211926,0,3,0
60502,5,3,211928,211928,211931,0,3,2
60503,2,1,211930,211931,211932,1,2,0
60504,2,2,211932,211932,211934,0,2,0
60505,2,1,211934,211934,211935,0,1,0
60506,2,3,211936,211936,211939,0,3,1
60507,4,3,211940,211940,211943,0,3,1
60508,5,2,211945,211945,211947,0,2,2
60509,4,2,211949,211949,211951,0,2,2
60510,1,1,211950,211951,211952,1,2,0
60511,5,2,211955,211955,211957,0,2,3
60512,4,3,211959,211959,211962,0,3,2
60513,3,2,211962,211962,211964,0,2,0
60514,2,3,211964,211964,211967,0,3,0
60515,4,1,211968,211968,211969,0,1,1
60516,4,3,211972,211972,211975,0,3,3
60517,6,3,211978,211978,211981,0,3,3
60518,2,1,211980,211981,211982,1,2,0
60519,1,2,211981,211982,211984,1,3,0
60520,5,1,211986,211986,211987,0,1,2
60521,6,3,211992,211992,211995,0,3,5
60522,1,2,211993,211995,211997,2,4,0
60523,6,1,211999,211999,212000,0,1,2
60524,1,3,212000,212000,212003,0,3,0
60525,3,3,212003,212003,212006,0,3,0
60526,6,2,212009,212009,212011,0,2,3
60527,5,1,212014,212014,212015,0,1,3
60528,3,2,212017,212017,212019,0,2,2
60529,3,3,212020,212020,212023,0,3,1
60530,2,3,212022,212023,212026,1,4,0
60531,5,1,212027,212027,212028,0,1,1
60532,6,2,212033,212033,212035,0,2,5
60533,6,1,212039,212039,212040,0,1,4
60534,3,1,212042,212042,212043,0,1,2
60535,3,2,212045,212045,212047,0,2,2
60536,1,1,212046,212047,212048,1,2,0
60537,6,1,212052,212052,212053,0,1,4
60538,4,1,212056,212056,212057,0,1,3
60539,6,3,212062,212062,212065,0,3,5
60540,4,2,212066,212066,212068,0,2,1
60541,2,1,212068,212068,212069,0,1,0
60542,5,1,212073,212073,212074,0,1,4
60543,3,3,212076,212076,212079,0,3,2
60544,1,1,212077,212079,212080,2,3,0
60545,2,2,212079,212080,212082,1,3,0
60546,1,3,212080,212082,212085,2,5,0
60547,6,1,212086,212086,212087,0,1,1
60548,5,2,212091,212091,212093,0,2,4
60549,1,3,212092,212093,212096,1,4,0
60550,1,1,212093,212096,212097,3,4,0
60551,4,1,212097,212097,212098,0,1,0
60552,6,3,212103,212103,212106,0,3,5
60553,5,1,212108,212108,212109,0,1,2
60554,1,1,212109,212109,212110,0,1,0
60555,6,3,212115,212115,212118,0,3,5
60556,6,1,212121,212121,212122,0,1,3
60557,4,3,212125,212125,212128,0,3,3
60558,5,2,212130,212130,212132,0,2,2
60559,5,2,212135,212135,212137,0,2,3
60560,1,1,212136,212137,212138,1,2,0
60561,3,2,212139,212139,212141,0,2,1
60562,2,3,212141,212141,212144,0,3,0
60563,5,1,212146,212146,212147,0,1,2
60564,4,1,212150,212150,212151,0,1,3
60565,5,3,212155,212155,212158,0,3,4
60566,4,3,212159,212159,212162,0,3,1
60567,4,3,212163,212163,212166,0,3,1
60568,4,3,212167,212167,212170,0,3,1
60569,1,3,212168,212170,212173,2,5,0
60570,3,3,212171,212173,212176,2,5,0
60571,2,1,212173,212176,212177,3,4,0
60572,5,2,212178,212178,212180,0,2,1
60573,4,2,212182,212182,212184,0,2,2
60574,1,3,212183,212184,212187,1,4,0
60575,6,2,212189,212189,212191,0,2,2
60576,1,2,212190,212191,212193,1,3,0
60577,4,1,212194,212194,212195,0,1,1
60578,3,2,212197,212197,212199,0,2,2
60579,2,1,212199,212199,212200,0,1,0
60580,1,3,212200,212200,212203,0,3,0
60581,6,1,212206,212206,212207,0,1,3
60582,6,1,212212,212212,212213,0,1,5
60583,4,2,212216,212216,212218,0,2,3
60584,3,1,212219,212219,212220,0,1,1
60585,6,3,212225,212225,212228,0,3,5
60586,5,3,212230,212230,212233,0,3,2
60587,1,1,212231,212233,212234,2,3,0
60588,3,2,212234,212234,212236,0,2,0
60589,5,1,212239,212239,212240,0,1,3
60590,5,2,212244,212244,212246,0,2,4
60591,1,1,212245,212246,212247,1,2,0
60592,2,3,212247,212247,212250,0,3,0
60593,1,3,212248,212250,212253,2,5,0
60594,4,1,212252,212253,212254,1,2,0
60595,5,1,212257,212257,212258,0,1,3
60596,3,3,212260,212260,212263,0,3,2
60597,5,2,212265,212265,212267,0,2,2
60598,2,1,212267,212267,212268,0,1,0
60599,5,3,212272,212272,212275,0,3,4
60600,1,2,212273,212275,212277,2,4,0
60601,2,1,212275,212277,212278,2,3,0
60602,4,1,212279,212279,212280,0,1,1
60603,2,1,212281,212281,212282,0,1,1
60604,1,1,212282,212282,212283,0,1,0
60605,2,3,212284,212284,212287,0,3,1
60606,5,1,212289,212289,212290,0,1,2
60607,3,1,212292,212292,212293,0,1,2
60608,3,1,212295,212295,212296,0,1,2
60609,3,2,212298,212298,212300,0,2,2
60610,6,1,212304,212304,212305,0,1,4
60611,1,2,212305,212305,212307,0,2,0
60612,5,2,212310,212310,212312,0,2,3
60613,2,3,212312,212312,212315,0,3,0
60614,3,3,212315,212315,212318,0,3,0
60615,5,2,212320,212320,212322,0,2,2
60616,6,3,212326,212326,212329,0,3,4
60617,2,2,212328,212329,212331,1,3,0
60618,3,2,212331,212331,212333,0,2,0
60619,6,2,212337,212337,212339,0,2,4
60620,4,3,212341,212341,212344,0,3,2
60621,5,3,212346,212346,212349,0,3,2
60622,5,1,212351,212351,212352,0,1,2
60623,6,1,212357,212357,212358,0,1,5
60624,5,1,212362,212362,212363,0,1,4
60625,4,3,212366,212366,212369,0,3,3
60626,1,3,212367,212369,212372,2,5,0
60627,5,3,212372,212372,212375,0,3,0
60628,6,2,212378,212378,212380,0,2,3
60629,6,2,212384,212384,212386,0,2,4
60630,5,3,212389,212389,212392,0,3,3
60631,4,3,212393,212393,212396,0,3,1
60632,4,3,212397,212397,212400,0,3,1
60633,5,3,212402,212402,212405,0,3,2
60634,5,1,212407,212407,212408,0,1,2
60635,4,2,212411,212411,212413,0,2,3
60636,5,3,212416,212416,212419,0,3,3
60637,4,1,212420,212420,212421,0,1,1
60638,4,2,212424,212424,212426,0,2,3
60639,4,1,212428,212428,212429,0,1,2
60640,4,1,212432,212432,212433,0,1,3
60641,2,1,212434,212434,212435,0,1,1
60642,2,3,212436,212436,212439,0,3,1
60643,5,1,212441,212441,212442,0,1,2
60644,5,2,212446,212446,212448,0,2,4
60645,6,2,212452,212452,212454,0,2,4
60646,6,3,212458,212458,212461,0,3,4
60647,1,1,212459,212461,212462,2,3,0
60648,2,2,212461,212462,212464,1,3,0
60649,3,2,212464,212464,212466,0,2,0
60650,2,2,212466,212466,212468,0,2,0
60651,2,1,212468,212468,212469,0,1,0
60652,4,1,212472,212472,212473,0,1,3
60653,6,1,212478,212478,212479,0,1,5
60654,3,2,212481,212481,212483,0,2,2
60655,1,3,212482,212483,212486,1,4,0
60656,4,1,212486,212486,212487,0,1,0
60657,5,1,212491,212491,212492,0,1,4
60658,5,3,212496,212496,212499,0,3,4
60659,2,1,212498,212499,212500,1,2,0
60660,1,3,212499,212500,212503,1,4,0
60661,2,1,212501,212503,212504,2,3,0
60662,5,1,212506,212506,212507,0,1,2
60663,1,2,212507,212507,212509,0,2,0
60664,3,3,212510,212510,212513,0,3,1
60665,6,1,212516,212516,212517,0,1,3
60666,3,2,212519,212519,212521,0,2,2
60667,2,1,212521,212521,212522,0,1,0
60668,3,3,212524,212524,212527,0,3,2
60669,6,1,212530,212530,212531,0,1,3
60670,3,1,212533,212533,212534,0,1,2
60671,1,2,212534,212534,212536,0,2,0
60672,2,3,212536,212536,212539,0,3,0
60673,1,3,212537,212539,212542,2,5,0
60674,6,2,212543,212543,212545,0,2,1
60675,6,1,212549,212549,212550,0,1,4
60676,6,2,212555,212555,212557,0,2,5
60677,1,3,212556,212557,212560,1,4,0
60678,5,3,212561,212561,212564,0,3,1
60679,4,1,212565,212565,212566,0,1,1
60680,3,2,212568,212568,212570,0,2,2
60681,1,3,212569,212570,212573,1,4,0
60682,5,2,212574,212574,212576,0,2,1
60683,4,1,212578,212578,212579,0,1,2
60684,6,1,212584,212584,212585,0,1,5
60685,5,2,212589,212589,212591,0,2,4
60686,2,3,212591,212591,212594,0,3,0
60687,6,3,212597,212597,212600,0,3,3
60688,4,1,212601,212601,212602,0,1,1
60689,5,2,212606,212606,212608,0,2,4
60690,6,2,212612,212612,212614,0,2,4
60691,3,2,212615,212615,212617,0,2,1
60692,4,3,212619,212619,212622,0,3,2
60693,3,3,212622,212622,212625,0,3,0
60694,5,2,212627,212627,212629,0,2,2
60695,3,2,212630,212630,212632,0,2,1
60696,4,1,212634,212634,212635,0,1,2
60697,4,2,212638,212638,212640,0,2,3
60698,2,1,212640,212640,212641,0,1,0
60699,6,2,212646,212646,212648,0,2,5
60700,4,2,212650,212650,212652,0,2,2
60701,2,3,212652,212652,212655,0,3,0
60702,2,3,212654,212655,212658,1,4,0
60703,2,1,212656,212658,212659,2,3,0
60704,5,2,212661,212661,212663,0,2,2
60705,2,3,212663,212663,212666,0,3,0
60706,4,2,212667,212667,212669,0,2,1
60707,3,3,212670,212670,212673,0,3,1
60708,3,2,212673,212673,212675,0,2,0
60709,1,1,212674,212675,212676,1,2,0
60710,5,1,212679,212679,212680,0,1,3
60711,4,2,212683,212683,212685,0,2,3
60712,2,1,212685,212685,212686,0,1,0
60713,5,1,212690,212690,212691,0,1,4
60714,1,3,212691,212691,212694,0,3,0
60715,6,3,212697,212697,212700,0,3,3
60716,4,2,212701,212701,212703,0,2,1
60717,3,2,212704,212704,212706,0,2,1
60718,4,3,212708,212708,212711,0,3,2
60719,3,3,212711,212711,212714,0,3,0
60720,4,3,212715,212715,212718,0,3,1
60721,2,1,212717,212718,212719,1,2,0
60722,5,2,212722,212722,212724,0,2,3
60723,6,2,212728,212728,212730,0,2,4
60724,6,1,212734,212734,212735,0,1,4
60725,3,3,212737,212737,212740,0,3,2
60726,4,2,212741,212741,212743,0,2,1
60727,5,2,212746,212746,212748,0,2,3
60728,1,3,212747,212748,212751,1,4,0
60729,5,3,212752,212752,212755,0,3,1
60730,6,2,212758,212758,212760,0,2,3
60731,4,3,212762,212762,212765,0,3,2
60732,1,1,212763,212765,212766,2,3,0
60733,1,1,212764,212766,212767,2,3,0
60734,3,3,212767,212767,212770,0,3,0
60735,1,3,212768,212770,212773,2,5,0
60736,5,2,212773,212773,212775,0,2,0
60737,6,1,212779,212779,212780,0,1,4
60738,6,3,212785,212785,212788,0,3,5
60739,6,2,212791,212791,212793,0,2,3
60740,6,3,212797,212797,212800,0,3,4
60741,1,1,212798,212800,212801,2,3,0
60742,6,1,212804,212804,212805,0,1,3
60743,5,1,212809,212809,212810,0,1,4
60744,2,1,212811,212811,212812,0,1,1
60745,3,1,212814,212814,212815,0,1,2
60746,4,1,212818,212818,212819,0,1,3
60747,4,3,212822,212822,212825,0,3,3
60748,1,1,212823,212825,212826,2,3,0
60749,6,1,212829,212829,212830,0,1,3
60750,3,2,212832,212832,212834,0,2,2
60751,5,2,212837,212837,212839,0,2,3
60752,5,2,212842,212842,212844,0,2,3
60753,5,2,212847,212847,212849,0,2,3
60754,4,1,212851,212851,212852,0,1,2
60755,2,1,212853,212853,212854,0,1,1
60756,2,3,212855,212855,212858,0,3,1
60757,3,3,212858,212858,212861,0,3,0
60758,5,2,212863,212863,212865,0,2,2
60759,4,3,212867,212867,212870,0,3,2
60760,6,2,212873,212873,212875,0,2,3
60761,6,1,212879,212879,212880,0,1,4
60762,1,3,212880,212880,212883,0,3,0
60763,4,3,212884,212884,212887,0,3,1
60764,3,2,212887,212887,212889,0,2,0
60765,4,1,212891,212891,212892,0,1,2
60766,4,2,212895,212895,212897,0,2,3
60767,3,1,212898,212898,212899,0,1,1
60768,2,1,212900,212900,212901,0,1,1
60769,1,3,212901,212901,212904,0,3,0
60770,6,1,212907,212907,212908,0,1,3
60771,1,3,212908,212908,212911,0,3,0
60772,5,1,212913,212913,212914,0,1,2
60773,5,1,212918,212918,212919,0,1,4
60774,1,2,212919,212919,212921,0,2,0
60775,2,3,212921,212921,212924,0,3,0
60776,1,1,212922,212924,212925,2,3,0
60777,5,1,212927,212927,212928,0,1,2
60778,1,3,212928,212928,212931,0,3,0
60779,1,1,212929,212931,212932,2,3,0
60780,5,3,212934,212934,212937,0,3,2
60781,4,1,212938,212938,212939,0,1,1
60782,6,1,212944,212944,212945,0,1,5
60783,6,2,212950,212950,212952,0,2,5
60784,2,2,212952,212952,212954,0,2,0
60785,2,1,212954,212954,212955,0,1,0
60786,5,2,212959,212959,212961,0,2,4
60787,4,2,212963,212963,212965,0,2,2
60788,6,1,212969,212969,212970,0,1,4
60789,5,3,212974,212974,212977,0,3,4
60790,2,2,212976,212977,212979,1,3,0
60791,4,3,212980,212980,212983,0,3,1
60792,5,3,212985,212985,212988,0,3,2
60793,4,3,212989,212989,212992,0,3,1
60794,4,3,212993,212993,212996,0,3,1
60795,4,2,212997,212997,212999,0,2,1
60796,4,2,213001,213001,213003,0,2,2
60797,6,1,213007,213007,213008,0,1,4
60798,5,2,213012,213012,213014,0,2,4
60799,5,2,213017,213017,213019,0,2,3
60800,4,2,213021,213021,213023,0,2,2
60801,4,3,213025,213025,213028,0,3,2
60802,3,2,213028,213028,213030,0,2,0
60803,2,2,213030,213030,213032,0,2,0
60804,1,1,213031,213032,213033,1,2,0
60805,2,2,213033,213033,213035,0,2,0
60806,1,2,213034,213035,213037,1,3,0
60807,4,2,213038,213038,213040,0,2,1
60808,5,1,213043,213043,213044,0,1,3
60809,4,2,213047,213047,213049,0,2,3
60810,3,1,213050,213050,213051,0,1,1
60811,4,2,213054,213054,213056,0,2,3
60812,2,1,213056,213056,213057,0,1,0
60813,4,3,213060,213060,213063,0,3,3
60814,1,3,213061,213063,213066,2,5,0
60815,6,3,213067,213067,213070,0,3,1
60816,1,1,213068,213070,213071,2,3,0
60817,5,1,213073,213073,213074,0,1,2
60818,4,2,213077,213077,213079,0,2,3
60819,4,3,213081,213081,213084,0,3,2
60820,2,2,213083,213084,213086,1,3,0
60821,4,3,213087,213087,213090,0,3,1
60822,2,2,213089,213090,213092,1,3,0
60823,6,3,213095,213095,213098,0,3,3
60824,4,3,213099,213099,213102,0,3,1
60825,6,3,213105,213105,213108,0,3,3
60826,1,3,213106,213108,213111,2,5,0
60827,6,3,213112,213112,213115,0,3,1
60828,6,2,213118,213118,213120,0,2,3
60829,1,1,213119,213120,213121,1,2,0
60830,2,3,213121,213121,213124,0,3,0
60831,4,2,213125,213125,213127,0,2,1
60832,5,1,213130,213130,213131,0,1,3
60833,3,2,213133,213133,213135,0,2,2
60834,2,2,213135,213135,213137,0,2,0
60835,4,3,213139,213139,213142,0,3,2
60836,4,3,213143,213143,213146,0,3,1
60837,3,2,213146,213146,213148,0,2,0
60838,6,3,213152,213152,213155,0,3,4
60839,2,1,213154,213155,213156,1,2,0
60840,5,3,213159,213159,213162,0,3,3
60841,2,1,213161,213162,213163,1,2,0
60842,4,1,213165,213165,213166,0,1,2
60843,1,2,213166,213166,213168,0,2,0
60844,3,2,213169,213169,213171,0,2,1
60845,2,2,213171,213171,213173,0,2,0
60846,5,2,213176,213176,213178,0,2,3
60847,2,2,213178,213178,213180,0,2,0
60848,4,3,213182,213182,213185,0,3,2
60849,6,3,213188,213188,213191,0,3,3
60850,4,1,213192,213192,213193,0,1,1
60851,2,2,213194,213194,213196,0,2,1
60852,5,3,213199,213199,213202,0,3,3
60853,5,3,213204,213204,213207,0,3,2
60854,5,2,213209,213209,213211,0,2,2
60855,5,2,213214,213214,213216,0,2,3
60856,5,1,213219,213219,213220,0,1,3
60857,3,2,213222,213222,213224,0,2,2
60858,1,2,213223,213224,213226,1,3,0
60859,2,2,213225,213226,213228,1,3,0
60860,6,1,213231,213231,213232,0,1,3
60861,3,3,213234,213234,213237,0,3,2
60862,2,1,213236,213237,213238,1,2,0
60863,4,2,213240,213240,213242,0,2,2
60864,1,2,213241,213242,213244,1,3,0
60865,3,1,213244,213244,213245,0,1,0
60866,4,1,213248,213248,213249,0,1,3
60867,2,3,213250,213250,213253,0,3,1
60868,3,2,213253,213253,213255,0,2,0
60869,6,1,213259,213259,213260,0,1,4
60870,5,1,213264,213264,213265,0,1,4
60871,5,1,213269,213269,213270,0,1,4
60872,1,2,213270,213270,213272,0,2,0
60873,5,2,213275,213275,213277,0,2,3
60874,4,1,213279,213279,213280,0,1,2
60875,2,1,213281,213281,213282,0,1,1
60876,6,3,213287,213287,213290,0,3,5
60877,6,1,213293,213293,213294,0,1,3
60878,1,3,213294,213294,213297,0,3,0
60879,4,2,213298,213298,213300,0,2,1
60880,4,1,213302,213302,213303,0,1,2
60881,6,1,213308,213308,213309,0,1,5
60882,5,1,213313,213313,213314,0,1,4
60883,3,2,213316,213316,213318,0,2,2
60884,6,2,213322,213322,213324,0,2,4
60885,6,2,213328,213328,213330,0,2,4
60886,6,2,213334,213334,213336,0,2,4
60887,6,3,213340,213340,213343,0,3,4
60888,1,2,213341,213343,213345,2,4,0
60889,5,3,213346,213346,213349,0,3,1
60890,2,3,213348,213349,213352,1,4,0
60891,4,3,213352,213352,213355,0,3,0
60892,5,3,213357,213357,213360,0,3,2
60893,1,2,213358,213360,213362,2,4,0
60894,2,3,213360,213362,213365,2,5,0
60895,3,2,213363,213365,213367,2,4,0
60896,6,1,213369,213369,213370,0,1,2
60897,2,2,213371,213371,213373,0,2,1
60898,3,3,213374,213374,213377,0,3,1
60899,4,2,213378,213378,213380,0,2,1
60900,3,2,213381,213381,213383,0,2,1
60901,2,1,213383,213383,213384,0,1,0
60902,4,2,213387,213387,213389,0,2,3
60903,5,1,213392,213392,213393,0,1,3
60904,2,3,213394,213394,213397,0,3,1
60905,3,2,213397,213397,213399,0,2,0
60906,5,1,213402,213402,213403,0,1,3
60907,1,2,213403,213403,213405,0,2,0
60908,2,1,213405,213405,213406,0,1,0
60909,1,3,213406,213406,213409,0,3,0
60910,5,3,213411,213411,213414,0,3,2
60911,3,1,213414,213414,213415,0,1,0
60912,2,2,213416,213416,213418,0,2,1
60913,2,1,213418,213418,213419,0,1,0
60914,6,2,213424,213424,213426,0,2,5
60915,2,3,213426,213426,213429,0,3,0
60916,5,2,213431,213431,213433,0,2,2
60917,2,3,213433,213433,213436,0,3,0
60918,5,2,213438,213438,213440,0,2,2
60919,2,1,213440,213440,213441,0,1,0
60920,3,3,213443,213443,213446,0,3,2
60921,4,2,213447,213447,213449,0,2,1
60922,1,3,213448,213449,213452,1,4,0
60923,6,1,213454,213454,213455,0,1,2
60924,6,3,213460,213460,213463,0,3,5
60925,5,1,213465,213465,213466,0,1,2
60926,6,1,213471,213471,213472,0,1,5
60927,2,1,213473,213473,213474,0,1,1
60928,3,1,213476,213476,213477,0,1,2
60929,3,1,213479,213479,213480,0,1,2
60930,1,1,213480,213480,213481,0,1,0
60931,6,2,213486,213486,213488,0,2,5
60932,4,2,213490,213490,213492,0,2,2
60933,4,1,213494,213494,213495,0,1,2
60934,4,2,213498,213498,213500,0,2,3
60935,6,2,213504,213504,213506,0,2,4
60936,3,1,213507,213507,213508,0,1,1
60937,5,1,213512,213512,213513,0,1,4
60938,1,1,213513,213513,213514,0,1,0
60939,4,2,213517,213517,213519,0,2,3
60940,6,2,213523,213523,213525,0,2,4
60941,5,1,213528,213528,213529,0,1,3
60942,5,2,213533,213533,213535,0,2,4
60943,5,2,213538,213538,213540,0,2,3
60944,6,1,213544,213544,213545,0,1,4
60945,3,1,213547,213547,213548,0,1,2
60946,1,3,213548,213548,213551,0,3,0
60947,1,1,213549,213551,213552,2,3,0
60948,1,1,213550,213552,213553,2,3,0
60949,5,3,213555,213555,213558,0,3,2
60950,5,1,213560,213560,213561,0,1,2
60951,4,2,213564,213564,213566,0,2,3
60952,3,1,213567,213567,213568,0,1,1
60953,4,2,213571,213571,213573,0,2,3
60954,5,1,213576,213576,213577,0,1,3
60955,4,3,213580,213580,213583,0,3,3
60956,5,3,213585,213585,213588,0,3,2
60957,6,2,213591,213591,213593,0,2,3
60958,3,1,213594,213594,213595,0,1,1
60959,4,1,213598,213598,213599,0,1,3
60960,1,2,213599,213599,213601,0,2,0
60961,2,1,213601,213601,213602,0,1,0
60962,1,1,213602,213602,213603,0,1,0
60963,2,3,213604,213604,213607,0,3,1
60964,6,3,213610,213610,213613,0,3,3
60965,5,2,213615,213615,213617,0,2,2
60966,5,3,213620,213620,213623,0,3,3
60967,4,1,213624,213624,213625,0,1,1
60968,6,3,213630,213630,213633,0,3,5
60969,6,1,213636,213636,213637,0,1,3
60970,3,3,213639,213639,213642,0,3,2
60971,3,2,213642,213642,213644,0,2,0
60972,4,3,213646,213646,213649,0,3,2
60973,6,3,213652,213652,213655,0,3,3
60974,2,2,213654,213655,213657,1,3,0
60975,4,2,213658,213658,213660,0,2,1
60976,5,2,213663,213663,213665,0,2,3
60977,1,3,213664,213665,213668,1,4,0
60978,3,2,213667,213668,213670,1,3,0
60979,5,1,213672,213672,213673,0,1,2
60980,6,2,213678,213678,213680,0,2,5
60981,4,2,213682,213682,213684,0,2,2
60982,1,2,213683,213684,213686,1,3,0
60983,6,3,213689,213689,213692,0,3,3
60984,6,2,213695,213695,213697,0,2,3
60985,5,2,213700,213700,213702,0,2,3
60986,4,1,213704,213704,213705,0,1,2
60987,2,2,213706,213706,213708,0,2,1
60988,1,2,213707,213708,213710,1,3,0
60989,6,3,213713,213713,213716,0,3,3
60990,5,1,213718,213718,213719,0,1,2
60991,1,2,213719,213719,213721,0,2,0
60992,6,2,213725,213725,213727,0,2,4
60993,5,3,213730,213730,213733,0,3,3
60994,1,1,213731,213733,213734,2,3,0
60995,1,3,213732,213734,213737,2,5,0
60996,5,3,213737,213737,213740,0,3,0
60997,1,2,213738,213740,213742,2,4,0
60998,4,1,213742,213742,213743,0,1,0
60999,1,1,213743,213743,213744,0,1,0
61000,6,3,213749,213749,213752,0,3,5
61001,5,2,213754,213754,213756,0,2,2
61002,6,2,213760,213760,213762,0,2,4
61003,1,1,213761,213762,213763,1,2,0
61004,6,3,213767,213767,213770,0,3,4
61005,3,2,213770,213770,213772,0,2,0
61006,2,2,213772,213772,213774,0,2,0
61007,2,1,213774,213774,213775,0,1,0
61008,1,3,213775,213775,213778,0,3,0
61009,4,1,213779,213779,213780,0,1,1
61010,6,2,213785,213785,213787,0,2,5
61011,3,2,213788,213788,213790,0,2,1
61012,3,1,213791,213791,213792,0,1,1
61013,4,1,213795,213795,213796,0,1,3
61014,6,1,213801,213801,213802,0,1,5
61015,4,3,213805,213805,213808,0,3,3
61016,3,2,213808,213808,213810,0,2,0
61017,3,3,213811,213811,213814,0,3,1
61018,3,2,213814,213814,213816,0,2,0
61019,3,1,213817,213817,213818,0,1,1
61020,3,2,213820,213820,213822,0,2,2
61021,3,2,213823,213823,213825,0,2,1
61022,6,1,213829,213829,213830,0,1,4
61023,4,1,213833,213833,213834,0,1,3
61024,1,3,213834,213834,213837,0,3,0
61025,3,1,213837,213837,213838,0,1,0
61026,4,1,213841,213841,213842,0,1,3
61027,2,2,213843,213843,213845,0,2,1
61028,5,1,213848,213848,213849,0,1,3
61029,2,2,213850,213850,213852,0,2,1
61030,1,3,213851,213852,213855,1,4,0
61031,3,1,213854,213855,213856,1,2,0
61032,1,2,213855,213856,213858,1,3,0
61033,3,2,213858,213858,213860,0,2,0
61034,2,2,213860,213860,213862,0,2,0
61035,4,2,213864,213864,213866,0,2,2
61036,6,2,213870,213870,213872,0,2,4
61037,5,3,213875,213875,213878,0,3,3
61038,3,1,213878,213878,213879,0,1,0
61039,1,1,213879,213879,213880,0,1,0
61040,3,3,213882,213882,213885,0,3,2
61041,5,2,213887,213887,213889,0,2,2
61042,4,2,213891,213891,213893,0,2,2
61043,3,1,213894,213894,213895,0,1,1
61044,6,1,213900,213900,213901,0,1,5
61045,6,2,213906,213906,213908,0,2,5
61046,3,1,213909,213909,213910,0,1,1
61047,1,2,213910,213910,213912,0,2,0
61048,1,2,213911,213912,213914,1,3,0
61049,2,2,213913,213914,213916,1,3,0
61050,1,1,213914,213916,213917,2,3,0
61051,2,1,213916,213917,213918,1,2,0
61052,3,2,213919,213919,213921,0,2,1
61053,3,1,213922,213922,213923,0,1,1
61054,3,2,213925,213925,213927,0,2,2
61055,6,3,213931,213931,213934,0,3,4
61056,6,1,213937,213937,213938,0,1,3
61057,2,1,213939,213939,213940,0,1,1
61058,6,2,213945,213945,213947,0,2,5
61059,1,2,213946,213947,213949,1,3,0
61060,5,3,213951,213951,213954,0,3,2
61061,6,2,213957,213957,213959,0,2,3
61062,3,2,213960,213960,213962,0,2,1
61063,1,2,213961,213962,213964,1,3,0
61064,4,1,213965,213965,213966,0,1,1
61065,4,1,213969,213969,213970,0,1,3
61066,5,3,213974,213974,213977,0,3,4
61067,6,3,213980,213980,213983,0,3,3
61068,5,1,213985,213985,213986,0,1,2
61069,6,1,213991,213991,213992,0,1,5
61070,4,2,213995,213995,213997,0,2,3
61071,3,3,213998,213998,214001,0,3,1
61072,3,2,214001,214001,214003,0,2,0
61073,6,2,214007,214007,214009,0,2,4
61074,1,3,214008,214009,214012,1,4,0
61075,5,1,214013,214013,214014,0,1,1
61076,1,3,214014,214014,214017,0,3,0
61077,4,2,214018,214018,214020,0,2,1
61078,6,3,214024,214024,214027,0,3,4
61079,5,1,214029,214029,214030,0,1,2
61080,3,2,214032,214032,214034,0,2,2
61081,2,2,214034,214034,214036,0,2,0
61082,1,3,214035,214036,214039,1,4,0
61083,3,3,214038,214039,214042,1,4,0
61084,5,2,214043,214043,214045,0,2,1
61085,4,3,214047,214047,214050,0,3,2
61086,2,3,214049,214050,214053,1,4,0
61087,5,3,214054,214054,214057,0,3,1
61088,2,1,214056,214057,214058,1,2,0
61089,2,3,214058,214058,214061,0,3,0
61090,2,2,214060,214061,214063,1,3,0
61091,1,3,214061,214063,214066,2,5,0
61092,4,3,214065,214066,214069,1,4,0
61093,3,1,214068,214069,214070,1,2,0
61094,6,3,214074,214074,214077,0,3,4
61095,5,2,214079,214079,214081,0,2,2
61096,5,3,214084,214084,214087,0,3,3
61097,1,1,214085,214087,214088,2,3,0
61098,5,2,214090,214090,214092,0,2,2
61099,6,1,214096,214096,214097,0,1,4
61100,2,3,214098,214098,214101,0,3,1
61101,6,1,214104,214104,214105,0,1,3
61102,6,1,214110,214110,214111,0,1,5
61103,5,1,214115,214115,214116,0,1,4
61104,4,1,214119,214119,214120,0,1,3
61105,5,3,214124,214124,214127,0,3,4
61106,3,2,214127,214127,214129,0,2,0
61107,4,1,214131,214131,214132,0,1,2
61108,2,2,214133,214133,214135,0,2,1
61109,5,3,214138,214138,214141,0,3,3
61110,5,3,214143,214143,214146,0,3,2
61111,5,2,214148,214148,214150,0,2,2
61112,3,2,214151,214151,214153,0,2,1
61113,3,1,214154,214154,214155,0,1,1
61114,4,2,214158,214158,214160,0,2,3
61115,3,1,214161,214161,214162,0,1,1
61116,1,1,214162,214162,214163,0,1,0
61117,2,3,214164,214164,214167,0,3,1
61118,5,3,214169,214169,214172,0,3,2
61119,5,1,214174,214174,214175,0,1,2
61120,2,1,214176,214176,214177,0,1,1
61121,2,3,214178,214178,214181,0,3,1
61122,4,1,214182,214182,214183,0,1,1
61123,2,2,214184,214184,214186,0,2,1
61124,6,1,214190,214190,214191,0,1,4
61125,6,3,214196,214196,214199,0,3,5
61126,3,2,214199,214199,214201,0,2,0
61127,6,3,214205,214205,214208,0,3,4
61128,2,3,214207,214208,214211,1,4,0
61129,4,2,214211,214211,214213,0,2,0
61130,2,2,214213,214213,214215,0,2,0
61131,3,2,214216,214216,214218,0,2,1
61132,2,3,214218,214218,214221,0,3,0
61133,3,1,214221,214221,214222,0,1,0
61134,6,1,214227,214227,214228,0,1,5
61135,2,2,214229,214229,214231,0,2,1
61136,6,1,214235,214235,214236,0,1,4
61137,2,1,214237,214237,214238,0,1,1
61138,1,3,214238,214238,214241,0,3,0
61139,6,1,214244,214244,214245,0,1,3
61140,2,3,214246,214246,214249,0,3,1
61141,4,2,214250,214250,214252,0,2,1
61142,5,1,214255,214255,214256,0,1,3
61143,3,3,214258,214258,214261,0,3,2
61144,4,2,214262,214262,214264,0,2,1
61145,3,2,214265,214265,214267,0,2,1
61146,4,1,214269,214269,214270,0,1,2
61147,6,2,214275,214275,214277,0,2,5
61148,3,1,214278,214278,214279,0,1,1
61149,3,2,214281,214281,214283,0,2,2
61150,2,2,214283,214283,214285,0,2,0
61151,3,3,214286,214286,214289,0,3,1
61152,3,3,214289,214289,214292,0,3,0
61153,3,3,214292,214292,214295,0,3,0
61154,6,1,214298,214298,214299,0,1,3
61155,4,2,214302,214302,214304,0,2,3
61156,5,2,214307,214307,214309,0,2,3
61157,6,2,214313,214313,214315,0,2,4
61158,3,3,214316,214316,214319,0,3,1
61159,1,3,214317,214319,214322,2,5,0
61160,1,2,214318,214322,214324,4,6,0
61161,3,1,214321,214324,214325,3,4,0
61162,4,3,214325,214325,214328,0,3,0
61163,3,3,214328,214328,214331,0,3,0
61164,4,1,214332,214332,214333,0,1,1
61165,2,2,214334,214334,214336,0,2,1
61166,5,3,214339,214339,214342,0,3,3
61167,2,2,214341,214342,214344,1,3,0
61168,1,2,214342,214344,214346,2,4,0
61169,6,3,214348,214348,214351,0,3,2
61170,2,2,214350,214351,214353,1,3,0
61171,1,3,214351,214353,214356,2,5,0
61172,1,2,214352,214356,214358,4,6,0
61173,5,2,214357,214358,214360,1,3,0
61174,5,2,214362,214362,214364,0,2,2
61175,1,2,214363,214364,214366,1,3,0
61176,6,1,214369,214369,214370,0,1,3
61177,5,3,214374,214374,214377,0,3,4
61178,3,3,214377,214377,214380,0,3,0
61179,4,3,214381,214381,214384,0,3,1
61180,2,3,214383,214384,214387,1,4,0
61181,1,2,214384,214387,214389,3,5,0
61182,2,1,214386,214389,214390,3,4,0
61183,4,1,214390,214390,214391,0,1,0
61184,2,3,214392,214392,214395,0,3,1
61185,3,3,214395,214395,214398,0,3,0
61186,6,1,214401,214401,214402,0,1,3
61187,3,2,214404,214404,214406,0,2,2
61188,6,2,214410,214410,214412,0,2,4
61189,6,1,214416,214416,214417,0,1,4
61190,2,2,214418,214418,214420,0,2,1
61191,3,3,214421,214421,214424,0,3,1
61192,1,1,214422,214424,214425,2,3,0
61193,6,2,214428,214428,214430,0,2,3
61194,4,3,214432,214432,214435,0,3,2
61195,4,2,214436,214436,214438,0,2,1
61196,6,3,214442,214442,214445,0,3,4
61197,6,2,214448,214448,214450,0,2,3
61198,5,2,214453,214453,214455,0,2,3
61199,6,3,214459,214459,214462,0,3,4
61200,6,1,214465,214465,214466,0,1,3
61201,2,2,214467,214467,214469,0,2,1
61202,5,1,214472,214472,214473,0,1,3
61203,1,3,214473,214473,214476,0,3,0
61204,5,2,214478,214478,214480,0,2,2
61205,6,1,214484,214484,214485,0,1,4
61206,6,3,214490,214490,214493,0,3,5
61207,6,3,214496,214496,214499,0,3,3
61208,1,2,214497,214499,214501,2,4,0
61209,6,1,214503,214503,214504,0,1,2
61210,1,1,214504,214504,214505,0,1,0
61211,4,1,214508,214508,214509,0,1,3
61212,2,2,214510,214510,214512,0,2,1
61213,6,2,214516,214516,214518,0,2,4
61214,6,1,214522,214522,214523,0,1,4
61215,2,2,214524,214524,214526,0,2,1
61216,6,3,214530,214530,214533,0,3,4
61217,4,2,214534,214534,214536,0,2,1
61218,3,1,214537,214537,214538,0,1,1
61219,3,3,214540,214540,214543,0,3,2
61220,2,1,214542,214543,214544,1,2,0
61221,5,3,214547,214547,214550,0,3,3
61222,6,1,214553,214553,214554,0,1,3
61223,3,2,214556,214556,214558,0,2,2
61224,1,3,214557,214558,214561,1,4,0
61225,5,3,214562,214562,214565,0,3,1
61226,4,3,214566,214566,214569,0,3,1
61227,1,3,214567,214569,214572,2,5,0
61228,3,1,214570,214572,214573,2,3,0
61229,2,2,214572,214573,214575,1,3,0
61230,1,2,214573,214575,214577,2,4,0
61231,4,2,214577,214577,214579,0,2,0
61232,4,3,214581,214581,214584,0,3,2
61233,3,2,214584,214584,214586,0,2,0
61234,6,3,214590,214590,214593,0,3,4
61235,2,2,214592,214593,214595,1,3,0
61236,4,1,214596,214596,214597,0,1,1
61237,3,3,214599,214599,214602,0,3,2
61238,2,3,214601,214602,214605,1,4,0
61239,5,2,214606,214606,214608,0,2,1
61240,6,3,214612,214612,214615,0,3,4
61241,2,1,214614,214615,214616,1,2,0
61242,6,3,214620,214620,214623,0,3,4
61243,1,2,214621,214623,214625,2,4,0
61244,1,3,214622,214625,214628,3,6,0
61245,3,1,214625,214628,214629,3,4,0
61246,6,3,214631,214631,214634,0,3,2
61247,1,2,214632,214634,214636,2,4,0
61248,4,2,214636,214636,214638,0,2,0
61249,3,2,214639,214639,214641,0,2,1
61250,6,1,214645,214645,214646,0,1,4
61251,2,1,214647,214647,214648,0,1,1
61252,6,2,214653,214653,214655,0,2,5
61253,2,3,214655,214655,214658,0,3,0
61254,2,3,214657,214658,214661,1,4,0
61255,4,3,214661,214661,214664,0,3,0
61256,2,1,214663,214664,214665,1,2,0
61257,5,3,214668,214668,214671,0,3,3
61258,1,1,214669,214671,214672,2,3,0
61259,5,1,214674,214674,214675,0,1,2
61260,3,1,214677,214677,214678,0,1,2
61261,5,1,214682,214682,214683,0,1,4
61262,1,1,214683,214683,214684,0,1,0
61263,2,3,214685,214685,214688,0,3,1
61264,6,3,214691,214691,214694,0,3,3
61265,3,3,214694,214694,214697,0,3,0
61266,6,2,214700,214700,214702,0,2,3
61267,2,1,214702,214702,214703,0,1,0
61268,2,1,214704,214704,214705,0,1,1
61269,5,2,214709,214709,214711,0,2,4
61270,2,1,214711,214711,214712,0,1,0
61271,2,3,214713,214713,214716,0,3,1
61272,3,3,214716,214716,214719,0,3,0
61273,3,3,214719,214719,214722,0,3,0
61274,2,3,214721,214722,214725,1,4,0
61275,2,2,214723,214725,214727,2,4,0
61276,2,3,214725,214727,214730,2,5,0
61277,6,1,214731,214731,214732,0,1,1
61278,1,2,214732,214732,214734,0,2,0
61279,6,2,214738,214738,214740,0,2,4
61280,6,1,214744,214744,214745,0,1,4
61281,3,3,214747,214747,214750,0,3,2
61282,4,3,214751,214751,214754,0,3,1
61283,3,3,214754,214754,214757,0,3,0
61284,2,2,214756,214757,214759,1,3,0
61285,6,1,214762,214762,214763,0,1,3
61286,4,3,214766,214766,214769,0,3,3
61287,1,1,214767,214769,214770,2,3,0
61288,2,2,214769,214770,214772,1,3,0
61289,4,3,214773,214773,214776,0,3,1
61290,5,2,214778,214778,214780,0,2,2
61291,5,1,214783,214783,214784,0,1,3
61292,2,3,214785,214785,214788,0,3,1
61293,1,2,214786,214788,214790,2,4,0
61294,1,1,214787,214790,214791,3,4,0
61295,4,2,214791,214791,214793,0,2,0
61296,5,3,214796,214796,214799,0,3,3
61297,1,2,214797,214799,214801,2,4,0
61298,3,2,214800,214801,214803,1,3,0
61299,2,2,214802,214803,214805,1,3,0
61300,3,2,214805,214805,214807,0,2,0
61301,2,2,214807,214807,214809,0,2,0
61302,1,3,214808,214809,214812,1,4,0
61303,5,2,214813,214813,214815,0,2,1
61304,5,3,214818,214818,214821,0,3,3
61305,6,3,214824,214824,214827,0,3,3
61306,4,2,214828,214828,214830,0,2,1
61307,3,1,214831,214831,214832,0,1,1
61308,4,3,214835,214835,214838,0,3,3
61309,3,3,214838,214838,214841,0,3,0
61310,3,2,214841,214841,214843,0,2,0
61311,5,2,214846,214846,214848,0,2,3
61312,5,1,214851,214851,214852,0,1,3
61313,6,3,214857,214857,214860,0,3,5
61314,5,3,214862,214862,214865,0,3,2
61315,5,2,214867,214867,214869,0,2,2
61316,3,3,214870,214870,214873,0,3,1
61317,2,2,214872,214873,214875,1,3,0
61318,6,2,214878,214878,214880,0,2,3
61319,4,3,214882,214882,214885,0,3,2
61320,1,1,214883,214885,214886,2,3,0
61321,4,1,214887,214887,214888,0,1,1
61322,1,1,214888,214888,214889,0,1,0
61323,4,1,214892,214892,214893,0,1,3
61324,1,2,214893,214893,214895,0,2,0
61325,3,3,214896,214896,214899,0,3,1
61326,3,2,214899,214899,214901,0,2,0
61327,2,3,214901,214901,214904,0,3,0
61328,5,2,214906,214906,214908,0,2,2
61329,6,2,214912,214912,214914,0,2,4
61330,6,3,214918,214918,214921,0,3,4
61331,2,1,214920,214921,214922,1,2,0
61332,4,3,214924,214924,214927,0,3,2
61333,2,3,214926,214927,214930,1,4,0
61334,6,3,214932,214932,214935,0,3,2
61335,2,1,214934,214935,214936,1,2,0
61336,4,2,214938,214938,214940,0,2,2
61337,3,2,214941,214941,214943,0,2,1
61338,3,3,214944,214944,214947,0,3,1
61339,5,1,214949,214949,214950,0,1,2
61340,2,1,214951,214951,214952,0,1,1
61341,2,3,214953,214953,214956,0,3,1
61342,3,2,214956,214956,214958,0,2,0
61343,2,2,214958,214958,214960,0,2,0
61344,5,2,214963,214963,214965,0,2,3
61345,5,1,214968,214968,214969,0,1,3
61346,4,1,214972,214972,214973,0,1,3
61347,6,3,214978,214978,214981,0,3,5
61348,5,3,214983,214983,214986,0,3,2
61349,1,3,214984,214986,214989,2,5,0
61350,1,1,214985,214989,214990,4,5,0
61351,6,2,214991,214991,214993,0,2,1
61352,3,2,214994,214994,214996,0,2,1
61353,6,1,215000,215000,215001,0,1,4
61354,3,2,215003,215003,215005,0,2,2
61355,4,1,215007,215007,215008,0,1,2
61356,6,1,215013,215013,215014,0,1,5
61357,6,1,215019,215019,215020,0,1,5
61358,3,1,215022,215022,215023,0,1,2
61359,5,1,215027,215027,215028,0,1,4
61360,5,2,215032,215032,215034,0,2,4
61361,5,1,215037,215037,215038,0,1,3
61362,2,2,215039,215039,215041,0,2,1
61363,1,3,215040,215041,215044,1,4,0
61364,4,2,215044,215044,215046,0,2,0
61365,4,2,215048,215048,215050,0,2,2
61366,4,1,215052,215052,215053,0,1,2
61367,5,1,215057,215057,215058,0,1,4
61368,5,3,215062,215062,215065,0,3,4
61369,4,1,215066,215066,215067,0,1,1
61370,5,1,215071,215071,215072,0,1,4
61371,6,2,215077,215077,215079,0,2,5
61372,1,2,215078,215079,215081,1,3,0
61373,2,3,215080,215081,215084,1,4,0
61374,6,2,215086,215086,215088,0,2,2
61375,1,1,215087,215088,215089,1,2,0
61376,5,3,215092,215092,215095,0,3,3
61377,3,2,215095,215095,215097,0,2,0
61378,5,3,215100,215100,215103,0,3,3
61379,3,1,215103,215103,215104,0,1,0
61380,6,1,215109,215109,215110,0,1,5
61381,5,1,215114,215114,215115,0,1,4
61382,6,1,215120,215120,215121,0,1,5
61383,3,2,215123,215123,215125,0,2,2
61384,2,1,215125,215125,215126,0,1,0
61385,2,3,215127,215127,215130,0,3,1
61386,1,2,215128,215130,215132,2,4,0
61387,1,3,215129,215132,215135,3,6,0
61388,3,1,215132,215135,215136,3,4,0
61389,3,1,215135,215136,215137,1,2,0
61390,2,2,215137,215137,215139,0,2,0
61391,5,3,215142,215142,215145,0,3,3
61392,3,3,215145,215145,215148,0,3,0
61393,2,1,215147,215148,215149,1,2,0
61394,3,1,215150,215150,215151,0,1,1
61395,2,3,215152,215152,215155,0,3,1
61396,4,2,215156,215156,215158,0,2,1
61397,1,2,215157,215158,215160,1,3,0
61398,2,2,215159,215160,215162,1,3,0
61399,1,2,215160,215162,215164,2,4,0
61400,2,2,215162,215164,215166,2,4,0
61401,4,3,215166,215166,215169,0,3,0
61402,1,1,215167,215169,215170,2,3,0
61403,4,2,215171,215171,215173,0,2,1
61404,5,3,215176,215176,215179,0,3,3
61405,6,2,215182,215182,215184,0,2,3
61406,3,3,215185,215185,215188,0,3,1
61407,3,3,215188,215188,215191,0,3,0
61408,6,3,215194,215194,215197,0,3,3
61409,2,3,215196,215197,215200,1,4,0
61410,6,1,215202,215202,215203,0,1,2
61411,5,3,215207,215207,215210,0,3,4
61412,3,2,215210,215210,215212,0,2,0
61413,1,1,215211,215212,215213,1,2,0
61414,2,3,215213,215213,215216,0,3,0
61415,1,2,215214,215216,215218,2,4,0
61416,3,3,215217,215218,215221,1,4,0
61417,4,2,215221,215221,215223,0,2,0
61418,5,2,215226,215226,215228,0,2,3
61419,5,1,215231,215231,215232,0,1,3
61420,3,1,215234,215234,215235,0,1,2
61421,2,1,215236,215236,215237,0,1,1
61422,2,1,215238,215238,215239,0,1,1
61423,4,3,215242,215242,215245,0,3,3
61424,3,3,215245,215245,215248,0,3,0
61425,5,3,215250,215250,215253,0,3,2
61426,5,1,215255,215255,215256,0,1,2
61427,2,2,215257,215257,215259,0,2,1
61428,3,1,215260,215260,215261,0,1,1
61429,1,3,215261,215261,215264,0,3,0
61430,3,2,215264,215264,215266,0,2,0
61431,5,2,215269,215269,215271,0,2,3
61432,4,3,215273,215273,215276,0,3,2
61433,1,2,215274,215276,215278,2,4,0
61434,6,1,215280,215280,215281,0,1,2
61435,5,3,215285,215285,215288,0,3,4
61436,1,2,215286,215288,215290,2,4,0
61437,3,1,215289,215290,215291,1,2,0
61438,1,1,215290,215291,215292,1,2,0
61439,3,3,215293,215293,215296,0,3,1
61440,1,2,215294,215296,215298,2,4,0
61441,2,2,215296,215298,215300,2,4,0
61442,5,2,215301,215301,215303,0,2,1
61443,3,1,215304,215304,215305,0,1,1
61444,2,1,215306,215306,215307,0,1,1
61445,2,2,215308,215308,215310,0,2,1
61446,6,1,215314,215314,215315,0,1,4
61447,6,3,215320,215320,215323,0,3,5
61448,1,2,215321,215323,215325,2,4,0
61449,4,1,215325,215325,215326,0,1,0
61450,2,1,215327,215327,215328,0,1,1
61451,5,1,215332,215332,215333,0,1,4
61452,2,3,215334,215334,215337,0,3,1
61453,2,3,215336,215337,215340,1,4,0
61454,5,2,215341,215341,215343,0,2,1
61455,4,3,215345,215345,215348,0,3,2
61456,4,2,215349,215349,215351,0,2,1
61457,5,1,215354,215354,215355,0,1,3
61458,6,1,215360,215360,215361,0,1,5
61459,5,3,215365,215365,215368,0,3,4
61460,5,1,215370,215370,215371,0,1,2
61461,6,2,215376,215376,215378,0,2,5
61462,3,2,215379,215379,215381,0,2,1
61463,2,2,215381,215381,215383,0,2,0
61464,6,1,215387,215387,215388,0,1,4
61465,1,3,215388,215388,215391,0,3,0
61466,1,3,215389,215391,215394,2,5,0
61467,3,2,215392,215394,215396,2,4,0
61468,4,1,215396,215396,215397,0,1,0
61469,6,3,215402,215402,215405,0,3,5
61470,4,2,215406,215406,215408,0,2,1
61471,2,3,215408,215408,215411,0,3,0
61472,2,3,215410,215411,215414,1,4,0
61473,5,1,215415,215415,215416,0,1,1
61474,5,1,215420,215420,215421,0,1,4
61475,1,1,215421,215421,215422,0,1,0
61476,3,3,215424,215424,215427,0,3,2
61477,4,1,215428,215428,215429,0,1,1
61478,1,2,215429,215429,215431,0,2,0
61479,3,3,215432,215432,215435,0,3,1
61480,3,1,215435,215435,215436,0,1,0
61481,1,3,215436,215436,215439,0,3,0
61482,1,1,215437,215439,215440,2,3,0
61483,5,3,215442,215442,215445,0,3,2
61484,1,2,215443,215445,215447,2,4,0
61485,1,2,215444,215447,215449,3,5,0
61486,2,1,215446,215449,215450,3,4,0
61487,5,1,215451,215451,215452,0,1,1
61488,3,3,215454,215454,215457,0,3,2
61489,4,2,215458,215458,215460,0,2,1
61490,6,1,215464,215464,215465,0,1,4
61491,5,3,215469,215469,215472,0,3,4
61492,5,2,215474,215474,215476,0,2,2
61493,5,3,215479,215479,215482,0,3,3
61494,2,2,215481,215482,215484,1,3,0
61495,1,2,215482,215484,215486,2,4,0
61496,2,3,215484,215486,215489,2,5,0
61497,3,3,215487,215489,215492,2,5,0
61498,2,1,215489,215492,215493,3,4,0
61499,6,1,215495,215495,215496,0,1,2
61500,1,2,215496,215496,215498,0,2,0
61501,5,3,215501,215501,215504,0,3,3
61502,1,2,215502,215504,215506,2,4,0
61503,5,3,215507,215507,215510,0,3,1
61504,4,2,215511,215511,215513,0,2,1
61505,6,3,215517,215517,215520,0,3,4
61506,1,2,215518,215520,215522,2,4,0
61507,6,1,215524,215524,215525,0,1,2
61508,4,2,215528,215528,215530,0,2,3
61509,5,2,215533,215533,215535,0,2,3
61510,1,1,215534,215535,215536,1,2,0
61511,3,2,215537,215537,215539,0,2,1
61512,4,2,215541,215541,215543,0,2,2
61513,3,2,215544,215544,215546,0,2,1
61514,4,3,215548,215548,215551,0,3,2
61515,6,2,215554,215554,215556,0,2,3
61516,6,2,215560,215560,215562,0,2,4
61517,4,1,215564,215564,215565,0,1,2
61518,6,1,215570,215570,215571,0,1,5
61519,5,1,215575,215575,215576,0,1,4
61520,4,3,215579,215579,215582,0,3,3
61521,3,1,215582,215582,215583,0,1,0
61522,1,3,215583,215583,215586,0,3,0
61523,1,1,215584,215586,215587,2,3,0
61524,2,1,215586,215587,215588,1,2,0
61525,4,3,215590,215590,215593,0,3,2
61526,1,3,215591,215593,215596,2,5,0
61527,3,2,215594,215596,215598,2,4,0
61528,3,2,215597,215598,215600,1,3,0
61529,2,1,215599,215600,215601,1,2,0
61530,1,1,215600,215601,215602,1,2,0
61531,3,2,215603,215603,215605,0,2,1
61532,6,3,215609,215609,215612,0,3,4
61533,3,3,215612,215612,215615,0,3,0
61534,2,3,215614,215615,215618,1,4,0
61535,1,1,215615,215618,215619,3,4,0
61536,4,1,215619,215619,215620,0,1,0
61537,3,2,215622,215622,215624,0,2,2
61538,2,3,215624,215624,215627,0,3,0
61539,3,2,215627,215627,215629,0,2,0
61540,6,3,215633,215633,215636,0,3,4
61541,1,1,215634,215636,215637,2,3,0
61542,2,1,215636,215637,215638,1,2,0
61543,5,3,215641,215641,215644,0,3,3
61544,5,3,215646,215646,215649,0,3,2
61545,6,2,215652,215652,215654,0,2,3
61546,2,2,215654,215654,215656,0,2,0
61547,6,3,215660,215660,215663,0,3,4
61548,5,3,215665,215665,215668,0,3,2
61549,2,3,215667,215668,215671,1,4,0
61550,1,2,215668,215671,215673,3,5,0
61551,3,3,215671,215673,215676,2,5,0
61552,6,1,215677,215677,215678,0,1,1
61553,2,2,215679,215679,215681,0,2,1
61554,3,1,215682,215682,215683,0,1,1
61555,4,1,215686,215686,215687,0,1,3
61556,1,2,215687,215687,215689,0,2,0
61557,2,3,215689,215689,215692,0,3,0
61558,3,3,215692,215692,215695,0,3,0
61559,2,2,215694,215695,215697,1,3,0
61560,4,3,215698,215698,215701,0,3,1
61561,2,1,215700,215701,215702,1,2,0
61562,3,1,215703,215703,215704,0,1,1
61563,3,3,215706,215706,215709,0,3,2
61564,1,2,215707,215709,215711,2,4,0
61565,2,1,215709,215711,215712,2,3,0
61566,3,1,215712,215712,215713,0,1,0
61567,2,3,215714,215714,215717,0,3,1
61568,2,2,215716,215717,215719,1,3,0
61569,6,1,215722,215722,215723,0,1,3
61570,5,3,215727,215727,215730,0,3,4
61571,3,3,215730,215730,215733,0,3,0
61572,5,1,215735,215735,215736,0,1,2
61573,5,2,215740,215740,215742,0,2,4
61574,4,2,215744,215744,215746,0,2,2
61575,5,2,215749,215749,215751,0,2,3
61576,1,1,215750,215751,215752,1,2,0
61577,3,2,215753,215753,215755,0,2,1
61578,1,3,215754,215755,215758,1,4,0
61579,2,2,215756,215758,215760,2,4,0
61580,3,1,215759,215760,215761,1,2,0
61581,1,3,215760,215761,215764,1,4,0
61582,4,3,215764,215764,215767,0,3,0
61583,6,2,215770,215770,215772,0,2,3
61584,2,2,215772,215772,215774,0,2,0
61585,3,2,215775,215775,215777,0,2,1
61586,6,2,215781,215781,215783,0,2,4
61587,6,3,215787,215787,215790,0,3,4
61588,6,2,215793,215793,215795,0,2,3
61589,2,2,215795,215795,215797,0,2,0
61590,2,2,215797,215797,215799,0,2,0
61591,4,2,215801,215801,215803,0,2,2
61592,5,1,215806,215806,215807,0,1,3
61593,5,1,215811,215811,215812,0,1,4
61594,1,2,215812,215812,215814,0,2,0
61595,6,1,215818,215818,215819,0,1,4
61596,2,2,215820,215820,215822,0,2,1
61597,3,2,215823,215823,215825,0,2,1
61598,1,1,215824,215825,215826,1,2,0
61599,1,2,215825,215826,215828,1,3,0
61600,5,3,215830,215830,215833,0,3,2
61601,5,3,215835,215835,215838,0,3,2
61602,2,1,215837,215838,215839,1,2,0
61603,1,2,215838,215839,215841,1,3,0
61604,4,3,215842,215842,215845,0,3,1
61605,6,2,215848,215848,215850,0,2,3
61606,4,3,215852,215852,215855,0,3,2
61607,3,1,215855,215855,215856,0,1,0
61608,6,2,215861,215861,215863,0,2,5
61609,6,1,215867,215867,215868,0,1,4
61610,3,1,215870,215870,215871,0,1,2
61611,1,2,215871,215871,215873,0,2,0
61612,3,2,215874,215874,215876,0,2,1
61613,4,3,215878,215878,215881,0,3,2
61614,5,2,215883,215883,215885,0,2,2
61615,6,1,215889,215889,215890,0,1,4
61616,4,3,215893,215893,215896,0,3,3
61617,4,3,215897,215897,215900,0,3,1
61618,3,2,215900,215900,215902,0,2,0
61619,4,1,215904,215904,215905,0,1,2
61620,6,2,215910,215910,215912,0,2,5
61621,1,3,215911,215912,215915,1,4,0
61622,1,1,215912,215915,215916,3,4,0
61623,4,1,215916,215916,215917,0,1,0
61624,3,2,215919,215919,215921,0,2,2
61625,3,1,215922,215922,215923,0,1,1
61626,4,2,215926,215926,215928,0,2,3
61627,4,2,215930,215930,215932,0,2,2
61628,4,3,215934,215934,215937,0,3,2
61629,2,1,215936,215937,215938,1,2,0
61630,5,2,215941,215941,215943,0,2,3
61631,4,1,215945,215945,215946,0,1,2
61632,5,1,215950,215950,215951,0,1,4
61633,5,3,215955,215955,215958,0,3,4
61634,5,1,215960,215960,215961,0,1,2
61635,5,2,215965,215965,215967,0,2,4
61636,1,2,215966,215967,215969,1,3,0
61637,1,2,215967,215969,215971,2,4,0
61638,3,1,215970,215971,215972,1,2,0
61639,3,3,215973,215973,215976,0,3,1
61640,5,2,215978,215978,215980,0,2,2
61641,3,3,215981,215981,215984,0,3,1
61642,1,3,215982,215984,215987,2,5,0
61643,2,3,215984,215987,215990,3,6,0
61644,4,3,215988,215990,215993,2,5,0
61645,6,1,215994,215994,215995,0,1,1
61646,3,2,215997,215997,215999,0,2,2
61647,3,3,216000,216000,216003,0,3,1
61648,1,3,216001,216003,216006,2,5,0
61649,6,2,216007,216007,216009,0,2,1
61650,5,1,216012,216012,216013,0,1,3
61651,2,3,216014,216014,216017,0,3,1
61652,2,2,216016,216017,216019,1,3,0
61653,1,1,216017,216019,216020,2,3,0
61654,1,3,216018,216020,216023,2,5,0
61655,5,1,216023,216023,216024,0,1,0
61656,3,3,216026,216026,216029,0,3,2
61657,4,3,216030,216030,216033,0,3,1
61658,1,1,216031,216033,216034,2,3,0
61659,6,3,216037,216037,216040,0,3,3
61660,4,2,216041,216041,216043,0,2,1
61661,1,2,216042,216043,216045,1,3,0
61662,6,1,216048,216048,216049,0,1,3
61663,5,1,216053,216053,216054,0,1,4
61664,4,2,216057,216057,216059,0,2,3
61665,6,2,216063,216063,216065,0,2,4
61666,2,1,216065,216065,216066,0,1,0
61667,4,3,216069,216069,216072,0,3,3
61668,5,3,216074,216074,216077,0,3,2
61669,5,1,216079,216079,216080,0,1,2
61670,1,3,216080,216080,216083,0,3,0
61671,6,2,216086,216086,216088,0,2,3
61672,3,2,216089,216089,216091,0,2,1
61673,6,1,216095,216095,216096,0,1,4
61674,6,3,216101,216101,216104,0,3,5
61675,2,2,216103,216104,216106,1,3,0
61676,3,3,216106,216106,216109,0,3,0
61677,1,3,216107,216109,216112,2,5,0
61678,5,1,216112,216112,216113,0,1,0
61679,2,1,216114,216114,216115,0,1,1
61680,2,3,216116,216116,216119,0,3,1
61681,3,3,216119,216119,216122,0,3,0
61682,3,2,216122,216122,216124,0,2,0
61683,3,3,216125,216125,216128,0,3,1
61684,5,1,216130,216130,216131,0,1,2
61685,4,3,216134,216134,216137,0,3,3
61686,1,1,216135,216137,216138,2,3,0
61687,1,3,216136,216138,216141,2,5,0
61688,5,3,216141,216141,216144,0,3,0
61689,4,1,216145,216145,216146,0,1,1
61690,1,2,216146,216146,216148,0,2,0
61691,1,2,216147,216148,216150,1,3,0
61692,5,3,216152,216152,216155,0,3,2
61693,5,2,216157,216157,216159,0,2,2
61694,5,3,216162,216162,216165,0,3,3
61695,3,2,216165,216165,216167,0,2,0
61696,5,2,216170,216170,216172,0,2,3
61697,5,3,216175,216175,216178,0,3,3
61698,5,3,216180,216180,216183,0,3,2
61699,6,1,216186,216186,216187,0,1,3
61700,5,1,216191,216191,216192,0,1,4
61701,1,1,216192,216192,216193,0,1,0
61702,5,2,216197,216197,216199,0,2,4
61703,3,2,216200,216200,216202,0,2,1
61704,6,3,216206,216206,216209,0,3,4
61705,1,3,216207,216209,216212,2,5,0
61706,5,2,216212,216212,216214,0,2,0
61707,4,1,216216,216216,216217,0,1,2
61708,4,1,216220,216220,216221,0,1,3
61709,3,3,216223,216223,216226,0,3,2
61710,3,3,216226,216226,216229,0,3,0
61711,4,2,216230,216230,216232,0,2,1
61712,5,2,216235,216235,216237,0,2,3
61713,2,2,216237,216237,216239,0,2,0
61714,1,1,216238,216239,216240,1,2,0
61715,1,1,216239,216240,216241,1,2,0
61716,5,1,216244,216244,216245,0,1,3
61717,5,3,216249,216249,216252,0,3,4
61718,5,1,216254,216254,216255,0,1,2
61719,2,2,216256,216256,216258,0,2,1
61720,2,3,216258,216258,216261,0,3,0
61721,2,2,216260,216261,216263,1,3,0
61722,1,3,216261,216263,216266,2,5,0
61723,3,2,216264,216266,216268,2,4,0
61724,6,1,216270,216270,216271,0,1,2
61725,4,2,216274,216274,216276,0,2,3
61726,4,2,216278,216278,216280,0,2,2
61727,4,2,216282,216282,216284,0,2,2
61728,5,2,216287,216287,216289,0,2,3
61729,6,3,216293,216293,216296,0,3,4
61730,1,1,216294,216296,216297,2,3,0
61731,6,1,216300,216300,216301,0,1,3
61732,1,1,216301,216301,216302,0,1,0
61733,1,2,216302,216302,216304,0,2,0
61734,3,3,216305,216305,216308,0,3,1
61735,6,1,216311,216311,216312,0,1,3
61736,6,3,216317,216317,216320,0,3,5
61737,3,3,216320,216320,216323,0,3,0
61738,2,1,216322,216323,216324,1,2,0
61739,1,3,216323,216324,216327,1,4,0
61740,6,1,216329,216329,216330,0,1,2
61741,3,2,216332,216332,216334,0,2,2
61742,3,1,216335,216335,216336,0,1,1
61743,2,2,216337,216337,216339,0,2,1
61744,3,3,216340,216340,216343,0,3,1
61745,4,3,216344,216344,216347,0,3,1
61746,2,2,216346,216347,216349,1,3,0
61747,5,1,216351,216351,216352,0,1,2
61748,2,3,216353,216353,216356,0,3,1
61749,1,2,216354,216356,216358,2,4,0
61750,3,2,216357,216358,216360,1,3,0
61751,1,2,216358,216360,216362,2,4,0
61752,5,1,216363,216363,216364,0,1,1
61753,6,1,216369,216369,216370,0,1,5
61754,1,1,216370,216370,216371,0,1,0
61755,6,1,216376,216376,216377,0,1,5
61756,6,1,216382,216382,216383,0,1,5
61757,4,3,216386,216386,216389,0,3,3
61758,4,1,216390,216390,216391,0,1,1
61759,3,2,216393,216393,216395,0,2,2
61760,2,3,216395,216395,216398,0,3,0
61761,4,2,216399,216399,216401,0,2,1
61762,1,2,216400,216401,216403,1,3,0
61763,3,2,216403,216403,216405,0,2,0
61764,1,1,216404,216405,216406,1,2,0
61765,5,1,216409,216409,216410,0,1,3
61766,4,1,216413,216413,216414,0,1,3
61767,5,3,216418,216418,216421,0,3,4
61768,6,3,216424,216424,216427,0,3,3
61769,2,3,216426,216427,216430,1,4,0
61770,4,3,216430,216430,216433,0,3,0
61771,3,3,216433,216433,216436,0,3,0
61772,5,3,216438,216438,216441,0,3,2
61773,2,1,216440,216441,216442,1,2,0
61774,3,2,216443,216443,216445,0,2,1
61775,1,2,216444,216445,216447,1,3,0
61776,4,2,216448,216448,216450,0,2,1
61777,6,1,216454,216454,216455,0,1,4
61778,6,3,216460,216460,216463,0,3,5
61779,2,3,216462,216463,216466,1,4,0
61780,1,3,216463,216466,216469,3,6,0
61781,2,2,216465,216469,216471,4,6,0
61782,2,1,216467,216471,216472,4,5,0
61783,5,3,216472,216472,216475,0,3,0
61784,5,3,216477,216477,216480,0,3,2
61785,1,2,216478,216480,216482,2,4,0
61786,1,2,216479,216482,216484,3,5,0
61787,3,2,216482,216484,216486,2,4,0
61788,6,3,216488,216488,216491,0,3,2
61789,6,3,216494,216494,216497,0,3,3
61790,2,2,216496,216497,216499,1,3,0
61791,1,2,216497,216499,216501,2,4,0
61792,5,1,216502,216502,216503,0,1,1
61793,1,3,216503,216503,216506,0,3,0
61794,1,2,216504,216506,216508,2,4,0
61795,1,1,216505,216508,216509,3,4,0
61796,3,1,216508,216509,216510,1,2,0
61797,2,3,216510,216510,216513,0,3,0
61798,3,2,216513,216513,216515,0,2,0
61799,3,2,216516,216516,216518,0,2,1
61800,2,3,216518,216518,216521,0,3,0
61801,2,2,216520,216521,216523,1,3,0
61802,4,3,216524,216524,216527,0,3,1
61803,5,3,216529,216529,216532,0,3,2
61804,1,1,216530,216532,216533,2,3,0
61805,2,1,216532,216533,216534,1,2,0
61806,6,1,216538,216538,216539,0,1,4
61807,5,1,216543,216543,216544,0,1,4
61808,4,3,216547,216547,216550,0,3,3
61809,3,2,216550,216550,216552,0,2,0
61810,4,3,216554,216554,216557,0,3,2
61811,2,1,216556,216557,216558,1,2,0
61812,4,3,216560,216560,216563,0,3,2
61813,5,2,216565,216565,216567,0,2,2
61814,6,3,216571,216571,216574,0,3,4
61815,4,1,216575,216575,216576,0,1,1
61816,3,2,216578,216578,216580,0,2,2
61817,3,3,216581,216581,216584,0,3,1
61818,1,1,216582,216584,216585,2,3,0
61819,2,1,216584,216585,216586,1,2,0
61820,3,3,216587,216587,216590,0,3,1
61821,3,2,216590,216590,216592,0,2,0
61822,5,3,216595,216595,216598,0,3,3
61823,1,3,216596,216598,216601,2,5,0
61824,3,3,216599,216601,216604,2,5,0
61825,5,1,216604,216604,216605,0,1,0
61826,6,1,216610,216610,216611,0,1,5
61827,1,1,216611,216611,216612,0,1,0
61828,4,2,216615,216615,216617,0,2,3
61829,4,1,216619,216619,216620,0,1,2
61830,6,1,216625,216625,216626,0,1,5
61831,6,2,216631,216631,216633,0,2,5
61832,6,1,216637,216637,216638,0,1,4
61833,4,1,216641,216641,216642,0,1,3
61834,3,3,216644,216644,216647,0,3,2
61835,6,1,216650,216650,216651,0,1,3
61836,1,3,216651,216651,216654,0,3,0
61837,5,2,216656,216656,216658,0,2,2
61838,6,1,216662,216662,216663,0,1,4
61839,2,3,216664,216664,216667,0,3,1
61840,6,2,216670,216670,216672,0,2,3
61841,2,2,216672,216672,216674,0,2,0
61842,6,1,216678,216678,216679,0,1,4
61843,2,2,216680,216680,216682,0,2,1
61844,4,3,216684,216684,216687,0,3,2
61845,3,1,216687,216687,216688,0,1,0
61846,4,3,216691,216691,216694,0,3,3
61847,1,2,216692,216694,216696,2,4,0
61848,6,2,216698,216698,216700,0,2,2
61849,5,2,216703,216703,216705,0,2,3
61850,1,1,216704,216705,216706,1,2,0
61851,6,2,216710,216710,216712,0,2,4
61852,4,3,216714,216714,216717,0,3,2
61853,5,2,216719,216719,216721,0,2,2
61854,4,3,216723,216723,216726,0,3,2
61855,4,3,216727,216727,216730,0,3,1
61856,5,2,216732,216732,216734,0,2,2
61857,6,3,216738,216738,216741,0,3,4
61858,5,3,216743,216743,216746,0,3,2
61859,2,2,216745,216746,216748,1,3,0
61860,2,1,216747,216748,216749,1,2,0
61861,6,1,216753,216753,216754,0,1,4
61862,5,1,216758,216758,216759,0,1,4
61863,2,2,216760,216760,216762,0,2,1
61864,2,1,216762,216762,216763,0,1,0
61865,4,1,216766,216766,216767,0,1,3
61866,5,2,216771,216771,216773,0,2,4
61867,5,3,216776,216776,216779,0,3,3
61868,1,3,216777,216779,216782,2,5,0
61869,1,3,216778,216782,216785,4,7,0
61870,2,2,216780,216785,216787,5,7,0
61871,5,3,216785,216787,216790,2,5,0
61872,3,3,216788,216790,216793,2,5,0
61873,5,2,216793,216793,216795,0,2,0
61874,2,2,216795,216795,216797,0,2,0
61875,2,1,216797,216797,216798,0,1,0
61876,4,3,216801,216801,216804,0,3,3
61877,1,1,216802,216804,216805,2,3,0
61878,5,2,216807,216807,216809,0,2,2
61879,3,3,216810,216810,216813,0,3,1
61880,4,3,216814,216814,216817,0,3,1
61881,4,3,216818,216818,216821,0,3,1
61882,2,3,216820,216821,216824,1,4,0
61883,5,1,216825,216825,216826,0,1,1
61884,5,3,216830,216830,216833,0,3,4
61885,4,2,216834,216834,216836,0,2,1
61886,2,3,216836,216836,216839,0,3,0
61887,4,1,216840,216840,216841,0,1,1
61888,4,3,216844,216844,216847,0,3,3
61889,2,2,216846,216847,216849,1,3,0
61890,1,2,216847,216849,216851,2,4,0
61891,2,1,216849,216851,216852,2,3,0
61892,3,3,216852,216852,216855,0,3,0
61893,3,2,216855,216855,216857,0,2,0
61894,4,1,216859,216859,216860,0,1,2
61895,3,1,216862,216862,216863,0,1,2
61896,3,3,216865,216865,216868,0,3,2
61897,1,1,216866,216868,216869,2,3,0
61898,4,2,216870,216870,216872,0,2,1
61899,4,3,216874,216874,216877,0,3,2
61900,1,1,216875,216877,216878,2,3,0
61901,2,1,216877,216878,216879,1,2,0
61902,1,2,216878,216879,216881,1,3,0
61903,3,2,216881,216881,216883,0,2,0
61904,1,1,216882,216883,216884,1,2,0
61905,4,2,216886,216886,216888,0,2,2
61906,6,2,216892,216892,216894,0,2,4
61907,5,1,216897,216897,216898,0,1,3
61908,2,2,216899,216899,216901,0,2,1
61909,3,1,216902,216902,216903,0,1,1
61910,1,1,216903,216903,216904,0,1,0
61911,1,3,216904,216904,216907,0,3,0
61912,6,1,216910,216910,216911,0,1,3
61913,1,1,216911,216911,216912,0,1,0
61914,3,1,216914,216914,216915,0,1,2
61915,4,3,216918,216918,216921,0,3,3
61916,5,3,216923,216923,216926,0,3,2
61917,3,1,216926,216926,216927,0,1,0
61918,3,3,216929,216929,216932,0,3,2
61919,2,3,216931,216932,216935,1,4,0
61920,2,1,216933,216935,216936,2,3,0
61921,1,3,216934,216936,216939,2,5,0
61922,6,1,216940,216940,216941,0,1,1
61923,3,2,216943,216943,216945,0,2,2
61924,5,2,216948,216948,216950,0,2,3
61925,4,3,216952,216952,216955,0,3,2
61926,2,1,216954,216955,216956,1,2,0
61927,1,1,216955,216956,216957,1,2,0
61928,2,1,216957,216957,216958,0,1,0
61929,5,3,216962,216962,216965,0,3,4
61930,3,1,216965,216965,216966,0,1,0
61931,4,1,216969,216969,216970,0,1,3
61932,1,1,216970,216970,216971,0,1,0
61933,4,3,216974,216974,216977,0,3,3
61934,4,1,216978,216978,216979,0,1,1
61935,2,2,216980,216980,216982,0,2,1
61936,6,2,216986,216986,216988,0,2,4
61937,1,1,216987,216988,216989,1,2,0
61938,5,1,216992,216992,216993,0,1,3
61939,6,1,216998,216998,216999,0,1,5
61940,2,1,217000,217000,217001,0,1,1
61941,3,1,217003,217003,217004,0,1,2
61942,3,3,217006,217006,217009,0,3,2
61943,5,3,217011,217011,217014,0,3,2
61944,4,1,217015,217015,217016,0,1,1
61945,2,3,217017,217017,217020,0,3,1
61946,4,3,217021,217021,217024,0,3,1
61947,5,3,217026,217026,217029,0,3,2
61948,1,2,217027,217029,217031,2,4,0
61949,4,3,217031,217031,217034,0,3,0
61950,3,1,217034,217034,217035,0,1,0
61951,3,3,217037,217037,217040,0,3,2
61952,1,2,217038,217040,217042,2,4,0
61953,5,2,217043,217043,217045,0,2,1
61954,4,3,217047,217047,217050,0,3,2
61955,2,2,217049,217050,217052,1,3,0
61956,2,2,217051,217052,217054,1,3,0
61957,6,3,217057,217057,217060,0,3,3
61958,2,1,217059,217060,217061,1,2,0
61959,1,1,217060,217061,217062,1,2,0
61960,2,1,217062,217062,217063,0,1,0
61961,3,1,217065,217065,217066,0,1,2
61962,4,1,217069,217069,217070,0,1,3
61963,6,1,217075,217075,217076,0,1,5
61964,6,3,217081,217081,217084,0,3,5
61965,6,3,217087,217087,217090,0,3,3
61966,2,2,217089,217090,217092,1,3,0
61967,4,3,217093,217093,217096,0,3,1
61968,6,1,217099,217099,217100,0,1,3
61969,4,1,217103,217103,217104,0,1,3
61970,4,1,217107,217107,217108,0,1,3
61971,6,1,217113,217113,217114,0,1,5
61972,5,1,217118,217118,217119,0,1,4
61973,2,1,217120,217120,217121,0,1,1
61974,2,2,217122,217122,217124,0,2,1
61975,1,3,217123,217124,217127,1,4,0
61976,1,2,217124,217127,217129,3,5,0
61977,6,1,217130,217130,217131,0,1,1
61978,4,2,217134,217134,217136,0,2,3
61979,3,1,217137,217137,217138,0,1,1
61980,6,3,217143,217143,217146,0,3,5
61981,6,3,217149,217149,217152,0,3,3
61982,3,1,217152,217152,217153,0,1,0
61983,6,2,217158,217158,217160,0,2,5
61984,6,3,217164,217164,217167,0,3,4
61985,4,1,217168,217168,217169,0,1,1
61986,6,1,217174,217174,217175,0,1,5
61987,4,3,217178,217178,217181,0,3,3
61988,1,2,217179,217181,217183,2,4,0
61989,1,2,217180,217183,217185,3,5,0
61990,2,2,217182,217185,217187,3,5,0
61991,3,3,217185,217187,217190,2,5,0
61992,3,3,217188,217190,217193,2,5,0
61993,1,2,217189,217193,217195,4,6,0
61994,2,3,217191,217195,217198,4,7,0
61995,6,3,217197,217198,217201,1,4,0
61996,5,1,217202,217202,217203,0,1,1
61997,5,2,217207,217207,217209,0,2,4
61998,5,1,217212,217212,217213,0,1,3
61999,4,2,217216,217216,217218,0,2,3
62000,5,2,217221,217221,217223,0,2,3
62001,2,2,217223,217223,217225,0,2,0
62002,4,2,217227,217227,217229,0,2,2
62003,2,1,217229,217229,217230,0,1,0
62004,3,3,217232,217232,217235,0,3,2
62005,1,2,217233,217235,217237,2,4,0
62006,1,2,217234,217237,217239,3,5,0
62007,5,2,217239,217239,217241,0,2,0
62008,5,2,217244,217244,217246,0,2,3
62009,4,2,217248,217248,217250,0,2,2
62010,6,1,217254,217254,217255,0,1,4
62011,5,3,217259,217259,217262,0,3,4
62012,4,3,217263,217263,217266,0,3,1
62013,5,3,217268,217268,217271,0,3,2
62014,2,2,217270,217271,217273,1,3,0
62015,3,1,217273,217273,217274,0,1,0
62016,1,2,217274,217274,217276,0,2,0
62017,4,1,217278,217278,217279,0,1,2
62018,4,2,217282,217282,217284,0,2,3
62019,4,1,217286,217286,217287,0,1,2
62020,5,3,217291,217291,217294,0,3,4
62021,1,3,217292,217294,217297,2,5,0
62022,2,1,217294,217297,217298,3,4,0
62023,1,2,217295,217298,217300,3,5,0
62024,2,3,217297,217300,217303,3,6,0
62025,1,3,217298,217303,217306,5,8,0
62026,2,1,217300,217306,217307,6,7,0
62027,1,3,217301,217307,217310,6,9,0
62028,1,1,217302,217310,217311,8,9,0
62029,6,3,217308,217311,217314,3,6,0
62030,2,1,217310,217314,217315,4,5,0
62031,5,1,217315,217315,217316,0,1,0
62032,5,3,217320,217320,217323,0,3,4
62033,2,3,217322,217323,217326,1,4,0
62034,5,1,217327,217327,217328,0,1,1
62035,3,2,217330,217330,217332,0,2,2
62036,1,3,217331,217332,217335,1,4,0
62037,2,1,217333,217335,217336,2,3,0
62038,2,3,217335,217336,217339,1,4,0
62039,1,1,217336,217339,217340,3,4,0
62040,3,2,217339,217340,217342,1,3,0
62041,4,1,217343,217343,217344,0,1,1
62042,4,1,217347,217347,217348,0,1,3
62043,5,2,217352,217352,217354,0,2,4
62044,1,2,217353,217354,217356,1,3,0
62045,6,3,217359,217359,217362,0,3,3
62046,6,2,217365,217365,217367,0,2,3
62047,5,1,217370,217370,217371,0,1,3
62048,4,2,217374,217374,217376,0,2,3
62049,2,3,217376,217376,217379,0,3,0
62050,2,2,217378,217379,217381,1,3,0
62051,4,2,217382,217382,217384,0,2,1
62052,4,2,217386,217386,217388,0,2,2
62053,6,1,217392,217392,217393,0,1,4
62054,4,3,217396,217396,217399,0,3,3
62055,4,1,217400,217400,217401,0,1,1
62056,4,2,217404,217404,217406,0,2,3
62057,5,1,217409,217409,217410,0,1,3
62058,3,3,217412,217412,217415,0,3,2
62059,2,1,217414,217415,217416,1,2,0
62060,3,1,217417,217417,217418,0,1,1
62061,5,3,217422,217422,217425,0,3,4
62062,4,3,217426,217426,217429,0,3,1
62063,6,3,217432,217432,217435,0,3,3
62064,5,3,217437,217437,217440,0,3,2
62065,5,1,217442,217442,217443,0,1,2
62066,4,1,217446,217446,217447,0,1,3
62067,2,3,217448,217448,217451,0,3,1
62068,6,1,217454,217454,217455,0,1,3
62069,1,3,217455,217455,217458,0,3,0
62070,4,3,217459,217459,217462,0,3,1
62071,2,2,217461,217462,217464,1,3,0
62072,5,1,217466,217466,217467,0,1,2
62073,3,3,217469,217469,217472,0,3,2
62074,5,1,217474,217474,217475,0,1,2
62075,4,3,217478,217478,217481,0,3,3
62076,4,1,217482,217482,217483,0,1,1
62077,4,1,217486,217486,217487,0,1,3
62078,2,2,217488,217488,217490,0,2,1
62079,4,1,217492,217492,217493,0,1,2
62080,6,1,217498,217498,217499,0,1,5
62081,2,1,217500,217500,217501,0,1,1
62082,3,2,217503,217503,217505,0,2,2
62083,2,2,217505,217505,217507,0,2,0
62084,4,1,217509,217509,217510,0,1,2
62085,6,1,217515,217515,217516,0,1,5
62086,2,1,217517,217517,217518,0,1,1
62087,3,3,217520,217520,217523,0,3,2
62088,2,3,217522,217523,217526,1,4,0
62089,5,3,217527,217527,217530,0,3,1
62090,3,2,217530,217530,217532,0,2,0
62091,1,1,217531,217532,217533,1,2,0
62092,2,1,217533,217533,217534,0,1,0
62093,6,2,217539,217539,217541,0,2,5
62094,5,3,217544,217544,217547,0,3,3
62095,3,3,217547,217547,217550,0,3,0
62096,4,1,217551,217551,217552,0,1,1
62097,3,3,217554,217554,217557,0,3,2
62098,2,2,217556,217557,217559,1,3,0
62099,5,1,217561,217561,217562,0,1,2
62100,1,1,217562,217562,217563,0,1,0
62101,2,3,217564,217564,217567,0,3,1
62102,6,1,217570,217570,217571,0,1,3
62103,5,1,217575,217575,217576,0,1,4
62104,5,3,217580,217580,217583,0,3,4
62105,5,2,217585,217585,217587,0,2,2
62106,2,1,217587,217587,217588,0,1,0
62107,4,2,217591,217591,217593,0,2,3
62108,4,1,217595,217595,217596,0,1,2
62109,1,3,217596,217596,217599,0,3,0
62110,5,2,217601,217601,217603,0,2,2
62111,2,1,217603,217603,217604,0,1,0
62112,5,3,217608,217608,217611,0,3,4
62113,3,1,217611,217611,217612,0,1,0
62114,1,1,217612,217612,217613,0,1,0
62115,4,1,217616,217616,217617,0,1,3
62116,3,3,217619,217619,217622,0,3,2
62117,5,2,217624,217624,217626,0,2,2
62118,5,3,217629,217629,217632,0,3,3
62119,2,2,217631,217632,217634,1,3,0
62120,5,2,217636,217636,217638,0,2,2
62121,6,2,217642,217642,217644,0,2,4
62122,4,2,217646,217646,217648,0,2,2
62123,3,3,217649,217649,217652,0,3,1
62124,2,3,217651,217652,217655,1,4,0
62125,5,3,217656,217656,217659,0,3,1
62126,5,3,217661,217661,217664,0,3,2
62127,4,2,217665,217665,217667,0,2,1
62128,1,3,217666,217667,217670,1,4,0
62129,4,2,217670,217670,217672,0,2,0
62130,5,2,217675,217675,217677,0,2,3
62131,6,2,217681,217681,217683,0,2,4
62132,4,1,217685,217685,217686,0,1,2
62133,3,3,217688,217688,217691,0,3,2
62134,1,2,217689,217691,217693,2,4,0
62135,6,1,217695,217695,217696,0,1,2
62136,6,2,217701,217701,217703,0,2,5
62137,2,2,217703,217703,217705,0,2,0
62138,6,3,217709,217709,217712,0,3,4
62139,3,3,217712,217712,217715,0,3,0
62140,2,1,217714,217715,217716,1,2,0
62141,4,1,217718,217718,217719,0,1,2
62142,2,3,217720,217720,217723,0,3,1
62143,1,1,217721,217723,217724,2,3,0
62144,4,1,217725,217725,217726,0,1,1
62145,4,1,217729,217729,217730,0,1,3
62146,1,2,217730,217730,217732,0,2,0
62147,5,3,217735,217735,217738,0,3,3
62148,5,1,217740,217740,217741,0,1,2
62149,6,2,217746,217746,217748,0,2,5
62150,2,1,217748,217748,217749,0,1,0
62151,4,1,217752,217752,217753,0,1,3
62152,1,2,217753,217753,217755,0,2,0
62153,6,2,217759,217759,217761,0,2,4
62154,5,1,217764,217764,217765,0,1,3
62155,5,2,217769,217769,217771,0,2,4
62156,1,3,217770,217771,217774,1,4,0
62157,1,2,217771,217774,217776,3,5,0
62158,4,1,217775,217776,217777,1,2,0
62159,6,1,217781,217781,217782,0,1,4
62160,5,2,217786,217786,217788,0,2,4
62161,3,3,217789,217789,217792,0,3,1
62162,1,1,217790,217792,217793,2,3,0
62163,3,1,217793,217793,217794,0,1,0
62164,6,2,217799,217799,217801,0,2,5
62165,5,1,217804,217804,217805,0,1,3
62166,3,2,217807,217807,217809,0,2,2
62167,4,3,217811,217811,217814,0,3,2
62168,4,3,217815,217815,217818,0,3,1
62169,1,1,217816,217818,217819,2,3,0
62170,5,1,217821,217821,217822,0,1,2
62171,2,2,217823,217823,217825,0,2,1
62172,4,2,217827,217827,217829,0,2,2
62173,4,3,217831,217831,217834,0,3,2
62174,2,3,217833,217834,217837,1,4,0
62175,3,3,217836,217837,217840,1,4,0
62176,3,2,217839,217840,217842,1,3,0
62177,1,3,217840,217842,217845,2,5,0
62178,1,3,217841,217845,217848,4,7,0
62179,4,2,217845,217848,217850,3,5,0
62180,4,3,217849,217850,217853,1,4,0
62181,1,2,217850,217853,217855,3,5,0
62182,5,3,217855,217855,217858,0,3,0
62183,1,3,217856,217858,217861,2,5,0
62184,4,2,217860,217861,217863,1,3,0
62185,1,3,217861,217863,217866,2,5,0
62186,6,1,217867,217867,217868,0,1,1
62187,4,3,217871,217871,217874,0,3,3
62188,3,2,217874,217874,217876,0,2,0
62189,4,3,217878,217878,217881,0,3,2
62190,3,3,217881,217881,217884,0,3,0
62191,3,1,217884,217884,217885,0,1,0
62192,3,3,217887,217887,217890,0,3,2
62193,4,1,217891,217891,217892,0,1,1
62194,1,1,217892,217892,217893,0,1,0
62195,1,3,217893,217893,217896,0,3,0
62196,6,3,217899,217899,217902,0,3,3
62197,1,2,217900,217902,217904,2,4,0
62198,1,1,217901,217904,217905,3,4,0
62199,2,3,217903,217905,217908,2,5,0
62200,5,3,217908,217908,217911,0,3,0
62201,4,2,217912,217912,217914,0,2,1
62202,2,3,217914,217914,217917,0,3,0
62203,5,3,217919,217919,217922,0,3,2
62204,3,1,217922,217922,217923,0,1,0
62205,6,2,217928,217928,217930,0,2,5
62206,5,2,217933,217933,217935,0,2,3
62207,6,2,217939,217939,217941,0,2,4
62208,2,3,217941,217941,217944,0,3,0
62209,6,1,217947,217947,217948,0,1,3
62210,6,1,217953,217953,217954,0,1,5
62211,2,1,217955,217955,217956,0,1,1
62212,6,3,217961,217961,217964,0,3,5
62213,2,2,217963,217964,217966,1,3,0
62214,5,1,217968,217968,217969,0,1,2
62215,5,3,217973,217973,217976,0,3,4
62216,2,3,217975,217976,217979,1,4,0
62217,3,3,217978,217979,217982,1,4,0
62218,4,3,217982,217982,217985,0,3,0
62219,6,2,217988,217988,217990,0,2,3
62220,1,2,217989,217990,217992,1,3,0
62221,3,1,217992,217992,217993,0,1,0
62222,1,1,217993,217993,217994,0,1,0
62223,5,2,217998,217998,218000,0,2,4
62224,2,1,218000,218000,218001,0,1,0
62225,6,1,218006,218006,218007,0,1,5
62226,3,3,218009,218009,218012,0,3,2
62227,4,1,218013,218013,218014,0,1,1
62228,6,3,218019,218019,218022,0,3,5
62229,1,3,218020,218022,218025,2,5,0
62230,4,2,218024,218025,218027,1,3,0
62231,6,1,218030,218030,218031,0,1,3
62232,6,1,218036,218036,218037,0,1,5
62233,6,1,218042,218042,218043,0,1,5
62234,2,2,218044,218044,218046,0,2,1
62235,1,1,218045,218046,218047,1,2,0
62236,6,1,218051,218051,218052,0,1,4
62237,2,3,218053,218053,218056,0,3,1
62238,4,1,218057,218057,218058,0,1,1
62239,3,2,218060,218060,218062,0,2,2
62240,2,1,218062,218062,218063,0,1,0
62241,4,1,218066,218066,218067,0,1,3
62242,1,1,218067,218067,218068,0,1,0
62243,6,3,218073,218073,218076,0,3,5
62244,6,3,218079,218079,218082,0,3,3
62245,5,2,218084,218084,218086,0,2,2
62246,3,2,218087,218087,218089,0,2,1
62247,4,3,218091,218091,218094,0,3,2
62248,5,1,218096,218096,218097,0,1,2
62249,1,1,218097,218097,218098,0,1,0
62250,2,1,218099,218099,218100,0,1,1
62251,2,1,218101,218101,218102,0,1,1
62252,4,1,218105,218105,218106,0,1,3
62253,3,1,218108,218108,218109,0,1,2
62254,3,3,218111,218111,218114,0,3,2
62255,4,2,218115,218115,218117,0,2,1
62256,2,1,218117,218117,218118,0,1,0
62257,3,1,218120,218120,218121,0,1,2
62258,3,2,218123,218123,218125,0,2,2
62259,2,1,218125,218125,218126,0,1,0
62260,6,2,218131,218131,218133,0,2,5
62261,6,2,218137,218137,218139,0,2,4
62262,1,1,218138,218139,218140,1,2,0
62263,1,3,218139,218140,218143,1,4,0
62264,1,2,218140,218143,218145,3,5,0
62265,4,1,218144,218145,218146,1,2,0
62266,3,2,218147,218147,218149,0,2,1
62267,1,3,218148,218149,218152,1,4,0
62268,6,1,218154,218154,218155,0,1,2
62269,6,3,218160,218160,218163,0,3,5
62270,3,2,218163,218163,218165,0,2,0
62271,6,2,218169,218169,218171,0,2,4
62272,1,3,218170,218171,218174,1,4,0
62273,5,2,218175,218175,218177,0,2,1
62274,3,3,218178,218178,218181,0,3,1
62275,5,3,218183,218183,218186,0,3,2
62276,3,2,218186,218186,218188,0,2,0
62277,3,2,218189,218189,218191,0,2,1
62278,1,1,218190,218191,218192,1,2,0
62279,5,1,218195,218195,218196,0,1,3
62280,1,3,218196,218196,218199,0,3,0
62281,6,3,218202,218202,218205,0,3,3
62282,2,3,218204,218205,218208,1,4,0
62283,2,2,218206,218208,218210,2,4,0
62284,6,2,218212,218212,218214,0,2,2
62285,2,3,218214,218214,218217,0,3,0
62286,3,3,218217,218217,218220,0,3,0
62287,3,1,218220,218220,218221,0,1,0
62288,5,3,218225,218225,218228,0,3,4
62289,6,1,218231,218231,218232,0,1,3
62290,2,3,218233,218233,218236,0,3,1
62291,5,1,218238,218238,218239,0,1,2
62292,2,2,218240,218240,218242,0,2,1
62293,4,2,218244,218244,218246,0,2,2
62294,5,3,218249,218249,218252,0,3,3
62295,4,2,218253,218253,218255,0,2,1
62296,6,1,218259,218259,218260,0,1,4
62297,1,2,218260,218260,218262,0,2,0
62298,1,1,218261,218262,218263,1,2,0
62299,2,3,218263,218263,218266,0,3,0
62300,2,2,218265,218266,218268,1,3,0
62301,6,3,218271,218271,218274,0,3,3
62302,6,1,218277,218277,218278,0,1,3
62303,4,2,218281,218281,218283,0,2,3
62304,1,1,218282,218283,218284,1,2,0
62305,1,1,218283,218284,218285,1,2,0
62306,4,1,218287,218287,218288,0,1,2
62307,2,1,218289,218289,218290,0,1,1
62308,4,3,218293,218293,218296,0,3,3
62309,1,2,218294,218296,218298,2,4,0
62310,5,1,218299,218299,218300,0,1,1
62311,2,1,218301,218301,218302,0,1,1
62312,6,1,218307,218307,218308,0,1,5
62313,3,3,218310,218310,218313,0,3,2
62314,4,1,218314,218314,218315,0,1,1
62315,3,3,218317,218317,218320,0,3,2
62316,6,1,218323,218323,218324,0,1,3
62317,3,2,218326,218326,218328,0,2,2
62318,1,3,218327,218328,218331,1,4,0
62319,2,2,218329,218331,218333,2,4,0
62320,4,1,218333,218333,218334,0,1,0
62321,5,3,218338,218338,218341,0,3,4
62322,5,3,218343,218343,218346,0,3,2
62323,5,3,218348,218348,218351,0,3,2
62324,3,1,218351,218351,218352,0,1,0
62325,5,2,218356,218356,218358,0,2,4
62326,2,3,218358,218358,218361,0,3,0
62327,1,2,218359,218361,218363,2,4,0
62328,5,2,218364,218364,218366,0,2,1
62329,3,3,218367,218367,218370,0,3,1
62330,3,2,218370,218370,218372,0,2,0
62331,4,2,218374,218374,218376,0,2,2
62332,1,3,218375,218376,218379,1,4,0
62333,2,1,218377,218379,218380,2,3,0
62334,1,2,218378,218380,218382,2,4,0
62335,5,1,218383,218383,218384,0,1,1
62336,2,3,218385,218385,218388,0,3,1
62337,1,2,218386,218388,218390,2,4,0
62338,4,1,218390,218390,218391,0,1,0
62339,4,1,218394,218394,218395,0,1,3
62340,1,2,218395,218395,218397,0,2,0
62341,2,2,218397,218397,218399,0,2,0
62342,1,2,218398,218399,218401,1,3,0
62343,2,3,218400,218401,218404,1,4,0
62344,3,1,218403,218404,218405,1,2,0
62345,1,2,218404,218405,218407,1,3,0
62346,4,1,218408,218408,218409,0,1,1
62347,5,2,218413,218413,218415,0,2,4
62348,1,1,218414,218415,218416,1,2,0
62349,1,1,218415,218416,218417,1,2,0
62350,5,3,218420,218420,218423,0,3,3
62351,6,1,218426,218426,218427,0,1,3
62352,4,3,218430,218430,218433,0,3,3
62353,4,3,218434,218434,218437,0,3,1
62354,6,1,218440,218440,218441,0,1,3
62355,2,1,218442,218442,218443,0,1,1
62356,6,2,218448,218448,218450,0,2,5
62357,2,1,218450,218450,218451,0,1,0
62358,6,1,218456,218456,218457,0,1,5
62359,2,2,218458,218458,218460,0,2,1
62360,2,1,218460,218460,218461,0,1,0
62361,3,2,218463,218463,218465,0,2,2
62362,3,2,218466,218466,218468,0,2,1
62363,4,3,218470,218470,218473,0,3,2
62364,5,1,218475,218475,218476,0,1,2
62365,6,2,218481,218481,218483,0,2,5
62366,1,2,218482,218483,218485,1,3,0
62367,3,3,218485,218485,218488,0,3,0
62368,4,2,218489,218489,218491,0,2,1
62369,1,1,218490,218491,218492,1,2,0
62370,5,2,218495,218495,218497,0,2,3
62371,1,1,218496,218497,218498,1,2,0
62372,6,3,218502,218502,218505,0,3,4
62373,5,2,218507,218507,218509,0,2,2
62374,2,1,218509,218509,218510,0,1,0
62375,2,2,218511,218511,218513,0,2,1
62376,3,2,218514,218514,218516,0,2,1
62377,4,3,218518,218518,218521,0,3,2
62378,5,2,218523,218523,218525,0,2,2
62379,5,1,218528,218528,218529,0,1,3
62380,3,3,218531,218531,218534,0,3,2
62381,3,2,218534,218534,218536,0,2,0
62382,4,1,218538,218538,218539,0,1,2
62383,1,2,218539,218539,218541,0,2,0
62384,3,1,218542,218542,218543,0,1,1
62385,6,2,218548,218548,218550,0,2,5
62386,3,3,218551,218551,218554,0,3,1
62387,5,2,218556,218556,218558,0,2,2
62388,3,2,218559,218559,218561,0,2,1
62389,1,3,218560,218561,218564,1,4,0
62390,5,3,218565,218565,218568,0,3,1
62391,2,3,218567,218568,218571,1,4,0
62392,5,3,218572,218572,218575,0,3,1
62393,3,1,218575,218575,218576,0,1,0
62394,1,2,218576,218576,218578,0,2,0
62395,2,3,218578,218578,218581,0,3,0
62396,6,2,218584,218584,218586,0,2,3
62397,2,2,218586,218586,218588,0,2,0
62398,1,2,218587,218588,218590,1,3,0
62399,6,2,218593,218593,218595,0,2,3
62400,4,2,218597,218597,218599,0,2,2
62401,5,2,218602,218602,218604,0,2,3
62402,2,3,218604,218604,218607,0,3,0
62403,5,3,218609,218609,218612,0,3,2
62404,6,1,218615,218615,218616,0,1,3
62405,3,2,218618,218618,218620,0,2,2
62406,3,1,218621,218621,218622,0,1,1
62407,4,2,218625,218625,218627,0,2,3
62408,5,1,218630,218630,218631,0,1,3
62409,5,3,218635,218635,218638,0,3,4
62410,2,2,218637,218638,218640,1,3,0
62411,4,2,218641,218641,218643,0,2,1
62412,4,1,218645,218645,218646,0,1,2
62413,6,3,218651,218651,218654,0,3,5
62414,1,2,218652,218654,218656,2,4,0
62415,2,2,218654,218656,218658,2,4,0
62416,6,2,218660,218660,218662,0,2,2
62417,6,2,218666,218666,218668,0,2,4
62418,2,1,218668,218668,218669,0,1,0
62419,4,2,218672,218672,218674,0,2,3
62420,6,1,218678,218678,218679,0,1,4
62421,6,1,218684,218684,218685,0,1,5
62422,6,3,218690,218690,218693,0,3,5
62423,2,3,218692,218693,218696,1,4,0
62424,1,3,218693,218696,218699,3,6,0
62425,3,2,218696,218699,218701,3,5,0
62426,6,2,218702,218702,218704,0,2,1
62427,1,2,218703,218704,218706,1,3,0
62428,6,3,218709,218709,218712,0,3,3
62429,5,3,218714,218714,218717,0,3,2
62430,5,1,218719,218719,218720,0,1,2
62431,5,1,218724,218724,218725,0,1,4
62432,1,2,218725,218725,218727,0,2,0
62433,1,2,218726,218727,218729,1,3,0
62434,4,1,218730,218730,218731,0,1,1
62435,4,3,218734,218734,218737,0,3,3
62436,6,3,218740,218740,218743,0,3,3
62437,4,1,218744,218744,218745,0,1,1
62438,1,1,218745,218745,218746,0,1,0
62439,1,1,218746,218746,218747,0,1,0
62440,4,1,218750,218750,218751,0,1,3
62441,4,3,218754,218754,218757,0,3,3
62442,5,2,218759,218759,218761,0,2,2
62443,2,2,218761,218761,218763,0,2,0
62444,2,2,218763,218763,218765,0,2,0
62445,5,2,218768,218768,218770,0,2,3
62446,2,1,218770,218770,218771,0,1,0
62447,2,3,218772,218772,218775,0,3,1
62448,5,1,218777,218777,218778,0,1,2
62449,1,2,218778,218778,218780,0,2,0
62450,4,3,218782,218782,218785,0,3,2
62451,2,2,218784,218785,218787,1,3,0
62452,6,2,218790,218790,218792,0,2,3
62453,6,3,218796,218796,218799,0,3,4
62454,5,3,218801,218801,218804,0,3,2
62455,4,1,218805,218805,218806,0,1,1
62456,2,1,218807,218807,218808,0,1,1
62457,2,2,218809,218809,218811,0,2,1
62458,1,3,218810,218811,218814,1,4,0
62459,3,3,218813,218814,218817,1,4,0
62460,1,2,218814,218817,218819,3,5,0
62461,2,1,218816,218819,218820,3,4,0
62462,2,2,218818,218820,218822,2,4,0
62463,3,3,218821,218822,218825,1,4,0
62464,2,3,218823,218825,218828,2,5,0
62465,2,3,218825,218828,218831,3,6,0
62466,4,3,218829,218831,218834,2,5,0
62467,2,1,218831,218834,218835,3,4,0
62468,6,2,218837,218837,218839,0,2,2
62469,4,3,218841,218841,218844,0,3,2
62470,5,2,218846,218846,218848,0,2,2
62471,2,3,218848,218848,218851,0,3,0
62472,5,2,218853,218853,218855,0,2,2
62473,3,3,218856,218856,218859,0,3,1
62474,2,1,218858,218859,218860,1,2,0
62475,2,2,218860,218860,218862,0,2,0
62476,6,3,218866,218866,218869,0,3,4
62477,5,1,218871,218871,218872,0,1,2
62478,1,1,218872,218872,218873,0,1,0
62479,4,3,218876,218876,218879,0,3,3
62480,4,2,218880,218880,218882,0,2,1
62481,6,3,218886,218886,218889,0,3,4
62482,1,2,218887,218889,218891,2,4,0
62483,2,3,218889,218891,218894,2,5,0
62484,1,2,218890,218894,218896,4,6,0
62485,3,3,218893,218896,218899,3,6,0
62486,3,3,218896,218899,218902,3,6,0
62487,3,1,218899,218902,218903,3,4,0
62488,3,3,218902,218903,218906,1,4,0
62489,1,1,218903,218906,218907,3,4,0
62490,1,3,218904,218907,218910,3,6,0
62491,1,2,218905,218910,218912,5,7,0
62492,3,3,218908,218912,218915,4,7,0
62493,5,1,218913,218915,218916,2,3,0
62494,1,2,218914,218916,218918,2,4,0
62495,2,1,218916,218918,218919,2,3,0
62496,2,1,218918,218919,218920,1,2,0
62497,1,3,218919,218920,218923,1,4,0
62498,4,3,218923,218923,218926,0,3,0
62499,6,2,218929,218929,218931,0,2,3
62500,4,3,218933,218933,218936,0,3,2
62501,4,3,218937,218937,218940,0,3,1
62502,2,1,218939,218940,218941,1,2,0
62503,2,1,218941,218941,218942,0,1,0
62504,2,3,218943,218943,218946,0,3,1
62505,4,3,218947,218947,218950,0,3,1
62506,5,1,218952,218952,218953,0,1,2
62507,5,1,218957,218957,218958,0,1,4
62508,4,1,218961,218961,218962,0,1,3
62509,1,3,218962,218962,218965,0,3,0
62510,2,1,218964,218965,218966,1,2,0
62511,1,3,218965,218966,218969,1,4,0
62512,4,3,218969,218969,218972,0,3,0
62513,5,1,218974,218974,218975,0,1,2
62514,4,2,218978,218978,218980,0,2,3
62515,4,2,218982,218982,218984,0,2,2
62516,1,1,218983,218984,218985,1,2,0
62517,5,1,218988,218988,218989,0,1,3
62518,1,1,218989,218989,218990,0,1,0
62519,5,3,218994,218994,218997,0,3,4
62520,6,2,219000,219000,219002,0,2,3
62521,1,1,219001,219002,219003,1,2,0
62522,4,2,219005,219005,219007,0,2,2
62523,1,2,219006,219007,219009,1,3,0
62524,3,2,219009,219009,219011,0,2,0
62525,1,2,219010,219011,219013,1,3,0
62526,6,3,219016,219016,219019,0,3,3
62527,5,1,219021,219021,219022,0,1,2
62528,5,2,219026,219026,219028,0,2,4
62529,2,1,219028,219028,219029,0,1,0
62530,3,2,219031,219031,219033,0,2,2
62531,1,2,219032,219033,219035,1,3,0
62532,1,3,219033,219035,219038,2,5,0
62533,6,1,219039,219039,219040,0,1,1
62534,1,1,219040,219040,219041,0,1,0
62535,6,3,219046,219046,219049,0,3,5
62536,5,3,219051,219051,219054,0,3,2
62537,1,2,219052,219054,219056,2,4,0
62538,4,3,219056,219056,219059,0,3,0
62539,3,3,219059,219059,219062,0,3,0
62540,5,3,219064,219064,219067,0,3,2
62541,1,2,219065,219067,219069,2,4,0
62542,1,2,219066,219069,219071,3,5,0
62543,6,3,219072,219072,219075,0,3,1
62544,3,2,219075,219075,219077,0,2,0
62545,4,1,219079,219079,219080,0,1,2
62546,3,3,219082,219082,219085,0,3,2
62547,4,1,219086,219086,219087,0,1,1
62548,5,2,219091,219091,219093,0,2,4
62549,1,1,219092,219093,219094,1,2,0
62550,5,3,219097,219097,219100,0,3,3
62551,3,3,219100,219100,219103,0,3,0
62552,2,3,219102,219103,219106,1,4,0
62553,6,2,219108,219108,219110,0,2,2
62554,2,1,219110,219110,219111,0,1,0
62555,2,3,219112,219112,219115,0,3,1
62556,6,1,219118,219118,219119,0,1,3
62557,5,2,219123,219123,219125,0,2,4
62558,1,2,219124,219125,219127,1,3,0
62559,3,3,219127,219127,219130,0,3,0
62560,6,2,219133,219133,219135,0,2,3
62561,3,2,219136,219136,219138,0,2,1
62562,4,3,219140,219140,219143,0,3,2
62563,6,3,219146,219146,219149,0,3,3
62564,1,1,219147,219149,219150,2,3,0
62565,3,2,219150,219150,219152,0,2,0
62566,1,2,219151,219152,219154,1,3,0
62567,6,2,219157,219157,219159,0,2,3
62568,5,3,219162,219162,219165,0,3,3
62569,6,2,219168,219168,219170,0,2,3
62570,5,3,219173,219173,219176,0,3,3
62571,5,2,219178,219178,219180,0,2,2
62572,2,1,219180,219180,219181,0,1,0
62573,2,1,219182,219182,219183,0,1,1
62574,4,2,219186,219186,219188,0,2,3
62575,1,3,219187,219188,219191,1,4,0
62576,1,2,219188,219191,219193,3,5,0
62577,1,2,219189,219193,219195,4,6,0
62578,2,1,219191,219195,219196,4,5,0
62579,2,3,219193,219196,219199,3,6,0
62580,1,1,219194,219199,219200,5,6,0
62581,4,1,219198,219200,219201,2,3,0
62582,6,1,219204,219204,219205,0,1,3
62583,3,2,219207,219207,219209,0,2,2
62584,1,2,219208,219209,219211,1,3,0
62585,6,2,219214,219214,219216,0,2,3
62586,2,1,219216,219216,219217,0,1,0
62587,5,1,219221,219221,219222,0,1,4
62588,3,3,219224,219224,219227,0,3,2
62589,5,3,219229,219229,219232,0,3,2
62590,2,2,219231,219232,219234,1,3,0
62591,2,2,219233,219234,219236,1,3,0
62592,3,2,219236,219236,219238,0,2,0
62593,6,2,219242,219242,219244,0,2,4
62594,4,2,219246,219246,219248,0,2,2
62595,5,3,219251,219251,219254,0,3,3
62596,2,3,219253,219254,219257,1,4,0
62597,1,3,219254,219257,219260,3,6,0
62598,5,3,219259,219260,219263,1,4,0
62599,2,3,219261,219263,219266,2,5,0
62600,2,2,219263,219266,219268,3,5,0
62601,2,3,219265,219268,219271,3,6,0
62602,5,1,219270,219271,219272,1,2,0
62603,1,3,219271,219272,219275,1,4,0
62604,6,2,219277,219277,219279,0,2,2
62605,4,3,219281,219281,219284,0,3,2
62606,6,1,219287,219287,219288,0,1,3
62607,5,3,219292,219292,219295,0,3,4
62608,4,2,219296,219296,219298,0,2,1
62609,3,1,219299,219299,219300,0,1,1
62610,5,2,219304,219304,219306,0,2,4
62611,3,1,219307,219307,219308,0,1,1
62612,5,2,219312,219312,219314,0,2,4
62613,4,2,219316,219316,219318,0,2,2
62614,5,2,219321,219321,219323,0,2,3
62615,6,2,219327,219327,219329,0,2,4
62616,1,2,219328,219329,219331,1,3,0
62617,6,3,219334,219334,219337,0,3,3
62618,2,2,219336,219337,219339,1,3,0
62619,1,3,219337,219339,219342,2,5,0
62620,3,3,219340,219342,219345,2,5,0
62621,4,2,219344,219345,219347,1,3,0
62622,6,2,219350,219350,219352,0,2,3
62623,5,3,219355,219355,219358,0,3,3
62624,2,3,219357,219358,219361,1,4,0
62625,5,1,219362,219362,219363,0,1,1
62626,3,1,219365,219365,219366,0,1,2
62627,4,1,219369,219369,219370,0,1,3
62628,4,2,219373,219373,219375,0,2,3
62629,3,3,219376,219376,219379,0,3,1
62630,5,1,219381,219381,219382,0,1,2
62631,1,2,219382,219382,219384,0,2,0
62632,5,1,219387,219387,219388,0,1,3
62633,5,1,219392,219392,219393,0,1,4
62634,3,1,219395,219395,219396,0,1,2
62635,6,3,219401,219401,219404,0,3,5
62636,5,1,219406,219406,219407,0,1,2
62637,2,1,219408,219408,219409,0,1,1
62638,2,1,219410,219410,219411,0,1,1
62639,5,3,219415,219415,219418,0,3,4
62640,4,3,219419,219419,219422,0,3,1
62641,1,1,219420,219422,219423,2,3,0
62642,4,3,219424,219424,219427,0,3,1
62643,1,1,219425,219427,219428,2,3,0
62644,6,1,219431,219431,219432,0,1,3
62645,4,1,219435,219435,219436,0,1,3
62646,3,2,219438,219438,219440,0,2,2
62647,1,3,219439,219440,219443,1,4,0
62648,3,1,219442,219443,219444,1,2,0
62649,5,3,219447,219447,219450,0,3,3
62650,1,2,219448,219450,219452,2,4,0
62651,6,1,219454,219454,219455,0,1,2
62652,1,3,219455,219455,219458,0,3,0
62653,2,1,219457,219458,219459,1,2,0
62654,2,1,219459,219459,219460,0,1,0
62655,1,2,219460,219460,219462,0,2,0
62656,4,1,219464,219464,219465,0,1,2
62657,5,1,219469,219469,219470,0,1,4
62658,3,1,219472,219472,219473,0,1,2
62659,6,1,219478,219478,219479,0,1,5
62660,4,1,219482,219482,219483,0,1,3
62661,3,1,219485,219485,219486,0,1,2
62662,4,2,219489,219489,219491,0,2,3
62663,4,3,219493,219493,219496,0,3,2
62664,1,3,219494,219496,219499,2,5,0
62665,3,3,219497,219499,219502,2,5,0
62666,1,2,219498,219502,219504,4,6,0
62667,4,2,219502,219504,219506,2,4,0
62668,1,1,219503,219506,219507,3,4,0
62669,3,1,219506,219507,219508,1,2,0
62670,6,3,219512,219512,219515,0,3,4
62671,2,3,219514,219515,219518,1,4,0
62672,4,2,219518,219518,219520,0,2,0
62673,2,3,219520,219520,219523,0,3,0
62674,6,1,219526,219526,219527,0,1,3
62675,1,1,219527,219527,219528,0,1,0
62676,4,1,219531,219531,219532,0,1,3
62677,2,2,219533,219533,219535,0,2,1
62678,5,1,219538,219538,219539,0,1,3
62679,4,2,219542,219542,219544,0,2,3
62680,5,1,219547,219547,219548,0,1,3
62681,4,2,219551,219551,219553,0,2,3
62682,4,1,219555,219555,219556,0,1,2
62683,4,1,219559,219559,219560,0,1,3
62684,6,3,219565,219565,219568,0,3,5
62685,3,3,219568,219568,219571,0,3,0
62686,6,2,219574,219574,219576,0,2,3
62687,5,3,219579,219579,219582,0,3,3
62688,5,1,219584,219584,219585,0,1,2
62689,4,1,219588,219588,219589,0,1,3
62690,3,3,219591,219591,219594,0,3,2
62691,5,1,219596,219596,219597,0,1,2
62692,4,3,219600,219600,219603,0,3,3
62693,3,3,219603,219603,219606,0,3,0
62694,3,2,219606,219606,219608,0,2,0
62695,3,1,219609,219609,219610,0,1,1
62696,2,2,219611,219611,219613,0,2,1
62697,2,1,219613,219613,219614,0,1,0
62698,4,3,219617,219617,219620,0,3,3
62699,1,3,219618,219620,219623,2,5,0
62700,1,3,219619,219623,219626,4,7,0
62701,3,1,219622,219626,219627,4,5,0
62702,3,1,219625,219627,219628,2,3,0
62703,2,3,219627,219628,219631,1,4,0
62704,3,1,219630,219631,219632,1,2,0
62705,3,2,219633,219633,219635,0,2,1
62706,6,3,219639,219639,219642,0,3,4
62707,3,1,219642,219642,219643,0,1,0
62708,6,1,219648,219648,219649,0,1,5
62709,1,3,219649,219649,219652,0,3,0
62710,4,2,219653,219653,219655,0,2,1
62711,4,3,219657,219657,219660,0,3,2
62712,1,2,219658,219660,219662,2,4,0
62713,5,2,219663,219663,219665,0,2,1
62714,4,1,219667,219667,219668,0,1,2
62715,1,3,219668,219668,219671,0,3,0
62716,4,1,219672,219672,219673,0,1,1
62717,3,2,219675,219675,219677,0,2,2
62718,1,1,219676,219677,219678,1,2,0
62719,6,2,219682,219682,219684,0,2,4
62720,1,2,219683,219684,219686,1,3,0
62721,6,1,219689,219689,219690,0,1,3
62722,5,2,219694,219694,219696,0,2,4
62723,5,3,219699,219699,219702,0,3,3
62724,6,3,219705,219705,219708,0,3,3
62725,1,1,219706,219708,219709,2,3,0
62726,6,3,219712,219712,219715,0,3,3
62727,5,2,219717,219717,219719,0,2,2
62728,5,1,219722,219722,219723,0,1,3
62729,6,3,219728,219728,219731,0,3,5
62730,1,2,219729,219731,219733,2,4,0
62731,3,2,219732,219733,219735,1,3,0
62732,2,2,219734,219735,219737,1,3,0
62733,6,3,219740,219740,219743,0,3,3
62734,5,1,219745,219745,219746,0,1,2
62735,6,3,219751,219751,219754,0,3,5
62736,5,2,219756,219756,219758,0,2,2
62737,4,1,219760,219760,219761,0,1,2
62738,6,2,219766,219766,219768,0,2,5
62739,6,1,219772,219772,219773,0,1,4
62740,3,2,219775,219775,219777,0,2,2
62741,4,1,219779,219779,219780,0,1,2
62742,1,1,219780,219780,219781,0,1,0
62743,2,1,219782,219782,219783,0,1,1
62744,1,1,219783,219783,219784,0,1,0
62745,6,1,219789,219789,219790,0,1,5
62746,5,2,219794,219794,219796,0,2,4
62747,6,3,219800,219800,219803,0,3,4
62748,2,3,219802,219803,219806,1,4,0
62749,1,2,219803,219806,219808,3,5,0
62750,6,3,219809,219809,219812,0,3,1
62751,1,3,219810,219812,219815,2,5,0
62752,1,3,219811,219815,219818,4,7,0
62753,6,3,219817,219818,219821,1,4,0
62754,6,1,219823,219823,219824,0,1,2
62755,2,1,219825,219825,219826,0,1,1
62756,1,1,219826,219826,219827,0,1,0
62757,4,3,219830,219830,219833,0,3,3
62758,2,3,219832,219833,219836,1,4,0
62759,5,3,219837,219837,219840,0,3,1
62760,2,2,219839,219840,219842,1,3,0
62761,2,2,219841,219842,219844,1,3,0
62762,3,2,219844,219844,219846,0,2,0
62763,6,1,219850,219850,219851,0,1,4
62764,4,3,219854,219854,219857,0,3,3
62765,4,1,219858,219858,219859,0,1,1
62766,4,2,219862,219862,219864,0,2,3
62767,6,1,219868,219868,219869,0,1,4
62768,1,3,219869,219869,219872,0,3,0
62769,6,3,219875,219875,219878,0,3,3
62770,1,3,219876,219878,219881,2,5,0
62771,6,1,219882,219882,219883,0,1,1
62772,5,3,219887,219887,219890,0,3,4
62773,4,2,219891,219891,219893,0,2,1
62774,4,3,219895,219895,219898,0,3,2
62775,3,3,219898,219898,219901,0,3,0
62776,5,3,219903,219903,219906,0,3,2
62777,1,2,219904,219906,219908,2,4,0
62778,4,3,219908,219908,219911,0,3,0
62779,2,1,219910,219911,219912,1,2,0
62780,1,1,219911,219912,219913,1,2,0
62781,2,1,219913,219913,219914,0,1,0
62782,4,3,219917,219917,219920,0,3,3
62783,5,2,219922,219922,219924,0,2,2
62784,1,3,219923,219924,219927,1,4,0
62785,3,3,219926,219927,219930,1,4,0
62786,2,3,219928,219930,219933,2,5,0
62787,1,3,219929,219933,219936,4,7,0
62788,1,1,219930,219936,219937,6,7,0
62789,2,2,219932,219937,219939,5,7,0
62790,5,2,219937,219939,219941,2,4,0
62791,2,1,219939,219941,219942,2,3,0
62792,5,3,219944,219944,219947,0,3,2
62793,1,2,219945,219947,219949,2,4,0
62794,3,1,219948,219949,219950,1,2,0
62795,5,3,219953,219953,219956,0,3,3
62796,4,3,219957,219957,219960,0,3,1
62797,1,2,219958,219960,219962,2,4,0
62798,2,2,219960,219962,219964,2,4,0
62799,5,1,219965,219965,219966,0,1,1
62800,3,3,219968,219968,219971,0,3,2
62801,3,3,219971,219971,219974,0,3,0
62802,5,3,219976,219976,219979,0,3,2
62803,2,2,219978,219979,219981,1,3,0
62804,5,3,219983,219983,219986,0,3,2
62805,5,1,219988,219988,219989,0,1,2
62806,5,3,219993,219993,219996,0,3,4
62807,6,2,219999,219999,220001,0,2,3
62808,5,3,220004,220004,220007,0,3,3
62809,2,3,220006,220007,220010,1,4,0
62810,6,2,220012,220012,220014,0,2,2
62811,5,1,220017,220017,220018,0,1,3
62812,6,1,220023,220023,220024,0,1,5
62813,1,2,220024,220024,220026,0,2,0
62814,2,3,220026,220026,220029,0,3,0
62815,6,1,220032,220032,220033,0,1,3
62816,3,3,220035,220035,220038,0,3,2
62817,2,3,220037,220038,220041,1,4,0
62818,2,3,220039,220041,220044,2,5,0
62819,5,2,220044,220044,220046,0,2,0
62820,2,3,220046,220046,220049,0,3,0
62821,2,2,220048,220049,220051,1,3,0
62822,3,1,220051,220051,220052,0,1,0
62823,6,3,220057,220057,220060,0,3,5
62824,5,2,220062,220062,220064,0,2,2
62825,6,2,220068,220068,220070,0,2,4
62826,3,3,220071,220071,220074,0,3,1
62827,1,2,220072,220074,220076,2,4,0
62828,4,3,220076,220076,220079,0,3,0
62829,1,2,220077,220079,220081,2,4,0
62830,3,3,220080,220081,220084,1,4,0
62831,4,2,220084,220084,220086,0,2,0
62832,2,3,220086,220086,220089,0,3,0
62833,3,1,220089,220089,220090,0,1,0
62834,6,1,220095,220095,220096,0,1,5
62835,4,3,220099,220099,220102,0,3,3
62836,2,1,220101,220102,220103,1,2,0
62837,5,3,220106,220106,220109,0,3,3
62838,6,1,220112,220112,220113,0,1,3
62839,2,2,220114,220114,220116,0,2,1
62840,4,3,220118,220118,220121,0,3,2
62841,6,3,220124,220124,220127,0,3,3
62842,3,2,220127,220127,220129,0,2,0
62843,5,3,220132,220132,220135,0,3,3
62844,2,1,220134,220135,220136,1,2,0
62845,3,2,220137,220137,220139,0,2,1
62846,1,1,220138,220139,220140,1,2,0
62847,1,3,220139,220140,220143,1,4,0
62848,5,2,220144,220144,220146,0,2,1
62849,4,2,220148,220148,220150,0,2,2
62850,3,1,220151,220151,220152,0,1,1
62851,5,3,220156,220156,220159,0,3,4
62852,1,3,220157,220159,220162,2,5,0
62853,1,3,220158,220162,220165,4,7,0
62854,4,1,220162,220165,220166,3,4,0
62855,4,3,220166,220166,220169,0,3,0
62856,1,1,220167,220169,220170,2,3,0
62857,4,2,220171,220171,220173,0,2,1
62858,3,1,220174,220174,220175,0,1,1
62859,2,3,220176,220176,220179,0,3,1
62860,3,2,220179,220179,220181,0,2,0
62861,5,2,220184,220184,220186,0,2,3
62862,6,2,220190,220190,220192,0,2,4
62863,6,2,220196,220196,220198,0,2,4
62864,1,1,220197,220198,220199,1,2,0
62865,2,1,220199,220199,220200,0,1,0
62866,5,1,220204,220204,220205,0,1,4
62867,5,3,220209,220209,220212,0,3,4
62868,6,1,220215,220215,220216,0,1,3
62869,3,1,220218,220218,220219,0,1,2
62870,2,3,220220,220220,220223,0,3,1
62871,1,2,220221,220223,220225,2,4,0
62872,3,1,220224,220225,220226,1,2,0
62873,1,1,220225,220226,220227,1,2,0
62874,5,1,220230,220230,220231,0,1,3
62875,4,3,220234,220234,220237,0,3,3
62876,4,2,220238,220238,220240,0,2,1
62877,4,3,220242,220242,220245,0,3,2
62878,3,1,220245,220245,220246,0,1,0
62879,1,3,220246,220246,220249,0,3,0
62880,2,2,220248,220249,220251,1,3,0
62881,3,2,220251,220251,220253,0,2,0
62882,1,1,220252,220253,220254,1,2,0
62883,3,1,220255,220255,220256,0,1,1
62884,2,3,220257,220257,220260,0,3,1
62885,3,3,220260,220260,220263,0,3,0
62886,5,2,220265,220265,220267,0,2,2
62887,2,1,220267,220267,220268,0,1,0
62888,1,1,220268,220268,220269,0,1,0
62889,1,1,220269,220269,220270,0,1,0
62890,4,3,220273,220273,220276,0,3,3
62891,5,2,220278,220278,220280,0,2,2
62892,2,3,220280,220280,220283,0,3,0
62893,2,1,220282,220283,220284,1,2,0
62894,6,2,220288,220288,220290,0,2,4
62895,2,3,220290,220290,220293,0,3,0
62896,2,1,220292,220293,220294,1,2,0
62897,2,2,220294,220294,220296,0,2,0
62898,1,3,220295,220296,220299,1,4,0
62899,3,2,220298,220299,220301,1,3,0
62900,4,3,220302,220302,220305,0,3,1
62901,1,3,220303,220305,220308,2,5,0
62902,2,1,220305,220308,220309,3,4,0
62903,2,3,220307,220309,220312,2,5,0
62904,4,1,220311,220312,220313,1,2,0
62905,1,2,220312,220313,220315,1,3,0
62906,3,3,220315,220315,220318,0,3,0
62907,3,3,220318,220318,220321,0,3,0
62908,1,1,220319,220321,220322,2,3,0
62909,3,3,220322,220322,220325,0,3,0
62910,6,1,220328,220328,220329,0,1,3
62911,2,3,220330,220330,220333,0,3,1
62912,5,2,220335,220335,220337,0,2,2
62913,3,1,220338,220338,220339,0,1,1
62914,3,3,220341,220341,220344,0,3,2
62915,3,2,220344,220344,220346,0,2,0
62916,2,2,220346,220346,220348,0,2,0
62917,3,1,220349,220349,220350,0,1,1
62918,4,2,220353,220353,220355,0,2,3
62919,6,3,220359,220359,220362,0,3,4
62920,4,2,220363,220363,220365,0,2,1
62921,6,3,220369,220369,220372,0,3,4
62922,6,1,220375,220375,220376,0,1,3
62923,1,3,220376,220376,220379,0,3,0
62924,5,3,220381,220381,220384,0,3,2
62925,6,3,220387,220387,220390,0,3,3
62926,2,2,220389,220390,220392,1,3,0
62927,3,2,220392,220392,220394,0,2,0
62928,6,1,220398,220398,220399,0,1,4
62929,1,3,220399,220399,220402,0,3,0
62930,6,3,220405,220405,220408,0,3,3
62931,3,3,220408,220408,220411,0,3,0
62932,3,1,220411,220411,220412,0,1,0
62933,3,1,220414,220414,220415,0,1,2
62934,4,3,220418,220418,220421,0,3,3
62935,2,3,220420,220421,220424,1,4,0
62936,3,1,220423,220424,220425,1,2,0
62937,2,1,220425,220425,220426,0,1,0
62938,1,3,220426,220426,220429,0,3,0
62939,4,3,220430,220430,220433,0,3,1
62940,6,1,220436,220436,220437,0,1,3
62941,2,1,220438,220438,220439,0,1,1
62942,3,3,220441,220441,220444,0,3,2
62943,5,2,220446,220446,220448,0,2,2
62944,6,1,220452,220452,220453,0,1,4
62945,4,3,220456,220456,220459,0,3,3
62946,5,3,220461,220461,220464,0,3,2
62947,5,1,220466,220466,220467,0,1,2
62948,6,3,220472,220472,220475,0,3,5
62949,5,1,220477,220477,220478,0,1,2
62950,5,1,220482,220482,220483,0,1,4
62951,2,1,220484,220484,220485,0,1,1
62952,3,2,220487,220487,220489,0,2,2
62953,5,1,220492,220492,220493,0,1,3
62954,3,1,220495,220495,220496,0,1,2
62955,5,2,220500,220500,220502,0,2,4
62956,3,2,220503,220503,220505,0,2,1
62957,4,2,220507,220507,220509,0,2,2
62958,5,1,220512,220512,220513,0,1,3
62959,2,1,220514,220514,220515,0,1,1
62960,2,1,220516,220516,220517,0,1,1
62961,6,1,220522,220522,220523,0,1,5
62962,1,1,220523,220523,220524,0,1,0
62963,6,3,220529,220529,220532,0,3,5
62964,1,3,220530,220532,220535,2,5,0
62965,4,3,220534,220535,220538,1,4,0
62966,6,1,220540,220540,220541,0,1,2
62967,6,1,220546,220546,220547,0,1,5
62968,6,2,220552,220552,220554,0,2,5
62969,5,3,220557,220557,220560,0,3,3
62970,5,1,220562,220562,220563,0,1,2
62971,4,2,220566,220566,220568,0,2,3
62972,5,3,220571,220571,220574,0,3,3
62973,3,3,220574,220574,220577,0,3,0
62974,2,3,220576,220577,220580,1,4,0
62975,1,1,220577,220580,220581,3,4,0
62976,2,1,220579,220581,220582,2,3,0
62977,3,2,220582,220582,220584,0,2,0
62978,5,1,220587,220587,220588,0,1,3
62979,6,1,220593,220593,220594,0,1,5
62980,4,2,220597,220597,220599,0,2,3
62981,1,1,220598,220599,220600,1,2,0
62982,4,2,220602,220602,220604,0,2,2
62983,2,1,220604,220604,220605,0,1,0
62984,1,3,220605,220605,220608,0,3,0
62985,4,3,220609,220609,220612,0,3,1
62986,1,3,220610,220612,220615,2,5,0
62987,3,1,220613,220615,220616,2,3,0
62988,4,2,220617,220617,220619,0,2,1
62989,3,3,220620,220620,220623,0,3,1
62990,4,2,220624,220624,220626,0,2,1
62991,5,3,220629,220629,220632,0,3,3
62992,4,1,220633,220633,220634,0,1,1
62993,1,3,220634,220634,220637,0,3,0
62994,1,3,220635,220637,220640,2,5,0
62995,6,1,220641,220641,220642,0,1,1
62996,6,3,220647,220647,220650,0,3,5
62997,2,3,220649,220650,220653,1,4,0
62998,6,1,220655,220655,220656,0,1,2
62999,4,3,220659,220659,220662,0,3,3
63000,2,1,220661,220662,220663,1,2,0
63001,1,1,220662,220663,220664,1,2,0
63002,2,3,220664,220664,220667,0,3,0
63003,2,3,220666,220667,220670,1,4,0
63004,5,1,220671,220671,220672,0,1,1
63005,1,3,220672,220672,220675,0,3,0
63006,2,2,220674,220675,220677,1,3,0
63007,1,1,220675,220677,220678,2,3,0
63008,2,1,220677,220678,220679,1,2,0
63009,5,1,220682,220682,220683,0,1,3
63010,2,3,220684,220684,220687,0,3,1
63011,3,1,220687,220687,220688,0,1,0
63012,6,3,220693,220693,220696,0,3,5
63013,2,3,220695,220696,220699,1,4,0
63014,6,2,220701,220701,220703,0,2,2
63015,1,1,220702,220703,220704,1,2,0
63016,2,1,220704,220704,220705,0,1,0
63017,6,2,220710,220710,220712,0,2,5
63018,2,2,220712,220712,220714,0,2,0
63019,6,2,220718,220718,220720,0,2,4
63020,3,3,220721,220721,220724,0,3,1
63021,3,3,220724,220724,220727,0,3,0
63022,5,2,220729,220729,220731,0,2,2
63023,6,1,220735,220735,220736,0,1,4
63024,1,3,220736,220736,220739,0,3,0
63025,1,3,220737,220739,220742,2,5,0
63026,6,3,220743,220743,220746,0,3,1
63027,6,1,220749,220749,220750,0,1,3
63028,3,3,220752,220752,220755,0,3,2
63029,6,3,220758,220758,220761,0,3,3
63030,6,2,220764,220764,220766,0,2,3
63031,5,1,220769,220769,220770,0,1,3
63032,4,1,220773,220773,220774,0,1,3
63033,1,2,220774,220774,220776,0,2,0
63034,4,2,220778,220778,220780,0,2,2
63035,3,3,220781,220781,220784,0,3,1
63036,1,1,220782,220784,220785,2,3,0
63037,2,2,220784,220785,220787,1,3,0
63038,5,2,220789,220789,220791,0,2,2
63039,4,1,220793,220793,220794,0,1,2
63040,1,1,220794,220794,220795,0,1,0
63041,3,2,220797,220797,220799,0,2,2
63042,6,1,220803,220803,220804,0,1,4
63043,5,1,220808,220808,220809,0,1,4
63044,4,1,220812,220812,220813,0,1,3
63045,6,2,220818,220818,220820,0,2,5
63046,3,1,220821,220821,220822,0,1,1
63047,5,3,220826,220826,220829,0,3,4
63048,4,2,220830,220830,220832,0,2,1
63049,1,2,220831,220832,220834,1,3,0
63050,3,2,220834,220834,220836,0,2,0
63051,4,2,220838,220838,220840,0,2,2
63052,1,1,220839,220840,220841,1,2,0
63053,1,2,220840,220841,220843,1,3,0
63054,1,1,220841,220843,220844,2,3,0
63055,5,1,220846,220846,220847,0,1,2
63056,3,3,220849,220849,220852,0,3,2
63057,3,3,220852,220852,220855,0,3,0
63058,5,3,220857,220857,220860,0,3,2
63059,6,3,220863,220863,220866,0,3,3
63060,5,3,220868,220868,220871,0,3,2
63061,1,2,220869,220871,220873,2,4,0
63062,2,3,220871,220873,220876,2,5,0
63063,6,2,220877,220877,220879,0,2,1
63064,6,3,220883,220883,220886,0,3,4
63065,5,3,220888,220888,220891,0,3,2
63066,4,2,220892,220892,220894,0,2,1
63067,4,1,220896,220896,220897,0,1,2
63068,1,2,220897,220897,220899,0,2,0
63069,4,3,220901,220901,220904,0,3,2
63070,3,3,220904,220904,220907,0,3,0
63071,2,3,220906,220907,220910,1,4,0
63072,6,1,220912,220912,220913,0,1,2
63073,5,2,220917,220917,220919,0,2,4
63074,6,2,220923,220923,220925,0,2,4
63075,6,2,220929,220929,220931,0,2,4
63076,4,1,220933,220933,220934,0,1,2
63077,2,1,220935,220935,220936,0,1,1
63078,2,1,220937,220937,220938,0,1,1
63079,3,2,220940,220940,220942,0,2,2
63080,6,2,220946,220946,220948,0,2,4
63081,1,3,220947,220948,220951,1,4,0
63082,1,3,220948,220951,220954,3,6,0
63083,5,1,220953,220954,220955,1,2,0
63084,2,2,220955,220955,220957,0,2,0
63085,5,1,220960,220960,220961,0,1,3
63086,5,1,220965,220965,220966,0,1,4
63087,6,1,220971,220971,220972,0,1,5
63088,3,3,220974,220974,220977,0,3,2
63089,2,2,220976,220977,220979,1,3,0
63090,5,1,220981,220981,220982,0,1,2
63091,5,1,220986,220986,220987,0,1,4
63092,4,3,220990,220990,220993,0,3,3
63093,4,1,220994,220994,220995,0,1,1
63094,5,1,220999,220999,221000,0,1,4
63095,5,2,221004,221004,221006,0,2,4
63096,5,1,221009,221009,221010,0,1,3
63097,1,2,221010,221010,221012,0,2,0
63098,1,1,221011,221012,221013,1,2,0
63099,5,1,221016,221016,221017,0,1,3
63100,3,3,221019,221019,221022,0,3,2
63101,2,1,221021,221022,221023,1,2,0
63102,5,1,221026,221026,221027,0,1,3
63103,6,1,221032,221032,221033,0,1,5
63104,2,3,221034,221034,221037,0,3,1
63105,6,2,221040,221040,221042,0,2,3
63106,1,3,221041,221042,221045,1,4,0
63107,2,1,221043,221045,221046,2,3,0
63108,1,3,221044,221046,221049,2,5,0
63109,6,3,221050,221050,221053,0,3,1
63110,1,3,221051,221053,221056,2,5,0
63111,1,2,221052,221056,221058,4,6,0
63112,6,1,221058,221058,221059,0,1,0
63113,1,1,221059,221059,221060,0,1,0
63114,1,2,221060,221060,221062,0,2,0
63115,2,1,221062,221062,221063,0,1,0
63116,3,1,221065,221065,221066,0,1,2
63117,1,2,221066,221066,221068,0,2,0
63118,2,3,221068,221068,221071,0,3,0
63119,2,2,221070,221071,221073,1,3,0
63120,6,1,221076,221076,221077,0,1,3
63121,3,1,221079,221079,221080,0,1,2
63122,3,2,221082,221082,221084,0,2,2
63123,2,2,221084,221084,221086,0,2,0
63124,6,1,221090,221090,221091,0,1,4
63125,1,3,221091,221091,221094,0,3,0
63126,1,3,221092,221094,221097,2,5,0
63127,3,2,221095,221097,221099,2,4,0
63128,5,3,221100,221100,221103,0,3,1
63129,2,3,221102,221103,221106,1,4,0
63130,4,2,221106,221106,221108,0,2,0
63131,4,2,221110,221110,221112,0,2,2
63132,4,2,221114,221114,221116,0,2,2
63133,3,1,221117,221117,221118,0,1,1
63134,2,2,221119,221119,221121,0,2,1
63135,2,3,221121,221121,221124,0,3,0
63136,6,1,221127,221127,221128,0,1,3
63137,3,1,221130,221130,221131,0,1,2
63138,4,3,221134,221134,221137,0,3,3
63139,3,3,221137,221137,221140,0,3,0
63140,3,1,221140,221140,221141,0,1,0
63141,1,3,221141,221141,221144,0,3,0
63142,1,3,221142,221144,221147,2,5,0
63143,6,2,221148,221148,221150,0,2,1
63144,5,1,221153,221153,221154,0,1,3
63145,4,2,221157,221157,221159,0,2,3
63146,2,2,221159,221159,221161,0,2,0
63147,5,1,221164,221164,221165,0,1,3
63148,6,2,221170,221170,221172,0,2,5
63149,3,2,221173,221173,221175,0,2,1
63150,3,1,221176,221176,221177,0,1,1
63151,4,2,221180,221180,221182,0,2,3
63152,4,1,221184,221184,221185,0,1,2
63153,2,3,221186,221186,221189,0,3,1
63154,4,3,221190,221190,221193,0,3,1
63155,4,2,221194,221194,221196,0,2,1
63156,3,2,221197,221197,221199,0,2,1
63157,4,1,221201,221201,221202,0,1,2
63158,2,1,221203,221203,221204,0,1,1
63159,2,2,221205,221205,221207,0,2,1
63160,1,1,221206,221207,221208,1,2,0
63161,1,2,221207,221208,221210,1,3,0
63162,2,1,221209,221210,221211,1,2,0
63163,3,2,221212,221212,221214,0,2,1
63164,4,2,221216,221216,221218,0,2,2
63165,6,1,221222,221222,221223,0,1,4
63166,5,3,221227,221227,221230,0,3,4
63167,3,1,221230,221230,221231,0,1,0
63168,3,2,221233,221233,221235,0,2,2
63169,3,3,221236,221236,221239,0,3,1
63170,4,1,221240,221240,221241,0,1,1
63171,1,3,221241,221241,221244,0,3,0
63172,5,3,221246,221246,221249,0,3,2
63173,2,1,221248,221249,221250,1,2,0
63174,1,3,221249,221250,221253,1,4,0
63175,3,1,221252,221253,221254,1,2,0
63176,2,2,221254,221254,221256,0,2,0
63177,2,3,221256,221256,221259,0,3,0
63178,5,2,221261,221261,221263,0,2,2
63179,6,3,221267,221267,221270,0,3,4
63180,2,3,221269,221270,221273,1,4,0
63181,6,3,221275,221275,221278,0,3,2
63182,1,3,221276,221278,221281,2,5,0
63183,6,2,221282,221282,221284,0,2,1
63184,1,2,221283,221284,221286,1,3,0
63185,6,3,221289,221289,221292,0,3,3
63186,3,3,221292,221292,221295,0,3,0
63187,2,2,221294,221295,221297,1,3,0
63188,2,1,221296,221297,221298,1,2,0
63189,3,3,221299,221299,221302,0,3,1
63190,4,3,221303,221303,221306,0,3,1
63191,4,2,221307,221307,221309,0,2,1
63192,2,1,221309,221309,221310,0,1,0
63193,6,1,221315,221315,221316,0,1,5
63194,2,1,221317,221317,221318,0,1,1
63195,3,2,221320,221320,221322,0,2,2
63196,4,1,221324,221324,221325,0,1,2
63197,4,1,221328,221328,221329,0,1,3
63198,3,1,221331,221331,221332,0,1,2
63199,5,1,221336,221336,221337,0,1,4
63200,1,2,221337,221337,221339,0,2,0
63201,3,1,221340,221340,221341,0,1,1
63202,3,1,221343,221343,221344,0,1,2
63203,6,2,221349,221349,221351,0,2,5
63204,3,1,221352,221352,221353,0,1,1
63205,3,2,221355,221355,221357,0,2,2
63206,2,1,221357,221357,221358,0,1,0
63207,2,3,221359,221359,221362,0,3,1
63208,5,3,221364,221364,221367,0,3,2
63209,3,3,221367,221367,221370,0,3,0
63210,2,1,221369,221370,221371,1,2,0
63211,1,2,221370,221371,221373,1,3,0
63212,1,3,221371,221373,221376,2,5,0
63213,1,3,221372,221376,221379,4,7,0
63214,3,2,221375,221379,221381,4,6,0
63215,6,3,221381,221381,221384,0,3,0
63216,2,2,221383,221384,221386,1,3,0
63217,5,3,221388,221388,221391,0,3,2
63218,3,1,221391,221391,221392,0,1,0
63219,2,2,221393,221393,221395,0,2,1
63220,6,1,221399,221399,221400,0,1,4
63221,1,2,221400,221400,221402,0,2,0
63222,5,2,221405,221405,221407,0,2,3
63223,1,2,221406,221407,221409,1,3,0
63224,6,2,221412,221412,221414,0,2,3
63225,3,2,221415,221415,221417,0,2,1
63226,4,1,221419,221419,221420,0,1,2
63227,5,3,221424,221424,221427,0,3,4
63228,1,3,221425,221427,221430,2,5,0
63229,5,3,221430,221430,221433,0,3,0
63230,1,3,221431,221433,221436,2,5,0
63231,1,2,221432,221436,221438,4,6,0
63232,5,2,221437,221438,221440,1,3,0
63233,2,2,221439,221440,221442,1,3,0
63234,2,2,221441,221442,221444,1,3,0
63235,6,1,221447,221447,221448,0,1,3
63236,4,3,221451,221451,221454,0,3,3
63237,4,1,221455,221455,221456,0,1,1
63238,6,3,221461,221461,221464,0,3,5
63239,3,3,221464,221464,221467,0,3,0
63240,3,1,221467,221467,221468,0,1,0
63241,1,3,221468,221468,221471,0,3,0
63242,4,2,221472,221472,221474,0,2,1
63243,5,1,221477,221477,221478,0,1,3
63244,2,3,221479,221479,221482,0,3,1
63245,5,3,221484,221484,221487,0,3,2
63246,3,1,221487,221487,221488,0,1,0
63247,1,1,221488,221488,221489,0,1,0
63248,5,1,221493,221493,221494,0,1,4
63249,4,2,221497,221497,221499,0,2,3
63250,6,1,221503,221503,221504,0,1,4
63251,4,1,221507,221507,221508,0,1,3
63252,6,1,221513,221513,221514,0,1,5
63253,2,2,221515,221515,221517,0,2,1
63254,6,3,221521,221521,221524,0,3,4
63255,3,3,221524,221524,221527,0,3,0
63256,4,3,221528,221528,221531,0,3,1
63257,3,2,221531,221531,221533,0,2,0
63258,2,2,221533,221533,221535,0,2,0
63259,2,1,221535,221535,221536,0,1,0
63260,5,2,221540,221540,221542,0,2,4
63261,3,2,221543,221543,221545,0,2,1
63262,5,1,221548,221548,221549,0,1,3
63263,1,3,221549,221549,221552,0,3,0
63264,5,2,221554,221554,221556,0,2,2
63265,4,1,221558,221558,221559,0,1,2
63266,2,2,221560,221560,221562,0,2,1
63267,2,3,221562,221562,221565,0,3,0
63268,4,2,221566,221566,221568,0,2,1
63269,4,3,221570,221570,221573,0,3,2
63270,6,1,221576,221576,221577,0,1,3
63271,4,1,221580,221580,221581,0,1,3
63272,4,1,221584,221584,221585,0,1,3
63273,2,2,221586,221586,221588,0,2,1
63274,5,1,221591,221591,221592,0,1,3
63275,1,1,221592,221592,221593,0,1,0
63276,5,1,221597,221597,221598,0,1,4
63277,1,2,221598,221598,221600,0,2,0
63278,5,2,221603,221603,221605,0,2,3
63279,5,3,221608,221608,221611,0,3,3
63280,5,3,221613,221613,221616,0,3,2
63281,4,1,221617,221617,221618,0,1,1
63282,2,2,221619,221619,221621,0,2,1
63283,4,3,221623,221623,221626,0,3,2
63284,4,1,221627,221627,221628,0,1,1
63285,3,1,221630,221630,221631,0,1,2
63286,2,3,221632,221632,221635,0,3,1
63287,2,3,221634,221635,221638,1,4,0
63288,1,1,221635,221638,221639,3,4,0
63289,3,3,221638,221639,221642,1,4,0
63290,6,1,221644,221644,221645,0,1,2
63291,4,2,221648,221648,221650,0,2,3
63292,5,2,221653,221653,221655,0,2,3
63293,3,2,221656,221656,221658,0,2,1
63294,4,1,221660,221660,221661,0,1,2
63295,3,3,221663,221663,221666,0,3,2
63296,5,1,221668,221668,221669,0,1,2
63297,4,3,221672,221672,221675,0,3,3
63298,2,2,221674,221675,221677,1,3,0
63299,4,3,221678,221678,221681,0,3,1
63300,3,1,221681,221681,221682,0,1,0
63301,4,2,221685,221685,221687,0,2,3
63302,6,2,221691,221691,221693,0,2,4
63303,2,2,221693,221693,221695,0,2,0
63304,4,3,221697,221697,221700,0,3,2
63305,1,3,221698,221700,221703,2,5,0
63306,6,1,221704,221704,221705,0,1,1
63307,6,1,221710,221710,221711,0,1,5
63308,4,2,221714,221714,221716,0,2,3
63309,6,3,221720,221720,221723,0,3,4
63310,1,3,221721,221723,221726,2,5,0
63311,4,2,221725,221726,221728,1,3,0
63312,2,1,221727,221728,221729,1,2,0
63313,3,2,221730,221730,221732,0,2,1
63314,5,1,221735,221735,221736,0,1,3
63315,6,1,221741,221741,221742,0,1,5
63316,4,3,221745,221745,221748,0,3,3
63317,5,1,221750,221750,221751,0,1,2
63318,1,1,221751,221751,221752,0,1,0
63319,2,3,221753,221753,221756,0,3,1
63320,3,2,221756,221756,221758,0,2,0
63321,6,2,221762,221762,221764,0,2,4
63322,6,3,221768,221768,221771,0,3,4
63323,3,1,221771,221771,221772,0,1,0
63324,4,2,221775,221775,221777,0,2,3
63325,6,3,221781,221781,221784,0,3,4
63326,4,2,221785,221785,221787,0,2,1
63327,3,2,221788,221788,221790,0,2,1
63328,5,3,221793,221793,221796,0,3,3
63329,5,2,221798,221798,221800,0,2,2
63330,4,2,221802,221802,221804,0,2,2
63331,5,2,221807,221807,221809,0,2,3
63332,5,3,221812,221812,221815,0,3,3
63333,1,3,221813,221815,221818,2,5,0
63334,3,3,221816,221818,221821,2,5,0
63335,2,2,221818,221821,221823,3,5,0
63336,2,3,221820,221823,221826,3,6,0
63337,3,2,221823,221826,221828,3,5,0
63338,3,3,221826,221828,221831,2,5,0
63339,2,2,221828,221831,221833,3,5,0
63340,1,2,221829,221833,221835,4,6,0
63341,4,3,221833,221835,221838,2,5,0
63342,1,3,221834,221838,221841,4,7,0
63343,6,1,221840,221841,221842,1,2,0
63344,1,1,221841,221842,221843,1,2,0
63345,5,3,221846,221846,221849,0,3,3
63346,4,2,221850,221850,221852,0,2,1
63347,1,3,221851,221852,221855,1,4,0
63348,1,3,221852,221855,221858,3,6,0
63349,2,3,221854,221858,221861,4,7,0
63350,5,1,221859,221861,221862,2,3,0
63351,6,1,221865,221865,221866,0,1,3
63352,1,3,221866,221866,221869,0,3,0
63353,6,3,221872,221872,221875,0,3,3
63354,3,1,221875,221875,221876,0,1,0
63355,5,2,221880,221880,221882,0,2,4
63356,1,2,221881,221882,221884,1,3,0
63357,6,2,221887,221887,221889,0,2,3
63358,4,2,221891,221891,221893,0,2,2
63359,4,2,221895,221895,221897,0,2,2
63360,4,3,221899,221899,221902,0,3,2
63361,6,2,221905,221905,221907,0,2,3
63362,2,3,221907,221907,221910,0,3,0
63363,2,3,221909,221910,221913,1,4,0
63364,5,2,221914,221914,221916,0,2,1
63365,6,1,221920,221920,221921,0,1,4
63366,6,1,221926,221926,221927,0,1,5
63367,2,1,221928,221928,221929,0,1,1
63368,4,3,221932,221932,221935,0,3,3
63369,4,1,221936,221936,221937,0,1,1
63370,3,1,221939,221939,221940,0,1,2
63371,3,1,221942,221942,221943,0,1,2
63372,2,3,221944,221944,221947,0,3,1
63373,3,1,221947,221947,221948,0,1,0
63374,1,2,221948,221948,221950,0,2,0
63375,5,2,221953,221953,221955,0,2,3
63376,5,2,221958,221958,221960,0,2,3
63377,3,1,221961,221961,221962,0,1,1
63378,3,1,221964,221964,221965,0,1,2
63379,1,3,221965,221965,221968,0,3,0
63380,1,2,221966,221968,221970,2,4,0
63381,5,3,221971,221971,221974,0,3,1
63382,2,2,221973,221974,221976,1,3,0
63383,5,2,221978,221978,221980,0,2,2
63384,2,1,221980,221980,221981,0,1,0
63385,4,1,221984,221984,221985,0,1,3
63386,5,2,221989,221989,221991,0,2,4
63387,5,2,221994,221994,221996,0,2,3
63388,4,1,221998,221998,221999,0,1,2
63389,4,3,222002,222002,222005,0,3,3
63390,1,2,222003,222005,222007,2,4,0
63391,2,1,222005,222007,222008,2,3,0
63392,1,1,222006,222008,222009,2,3,0
63393,6,2,222012,222012,222014,0,2,3
63394,1,3,222013,222014,222017,1,4,0
63395,6,1,222019,222019,222020,0,1,2
63396,4,2,222023,222023,222025,0,2,3
63397,2,3,222025,222025,222028,0,3,0
63398,6,2,222031,222031,222033,0,2,3
63399,3,3,222034,222034,222037,0,3,1
63400,1,1,222035,222037,222038,2,3,0
63401,5,2,222040,222040,222042,0,2,2
63402,3,3,222043,222043,222046,0,3,1
63403,5,2,222048,222048,222050,0,2,2
63404,4,2,222052,222052,222054,0,2,2
63405,3,2,222055,222055,222057,0,2,1
63406,2,1,222057,222057,222058,0,1,0
63407,4,3,222061,222061,222064,0,3,3
63408,6,1,222067,222067,222068,0,1,3
63409,3,3,222070,222070,222073,0,3,2
63410,2,3,222072,222073,222076,1,4,0
63411,3,3,222075,222076,222079,1,4,0
63412,5,2,222080,222080,222082,0,2,1
63413,5,3,222085,222085,222088,0,3,3
63414,3,1,222088,222088,222089,0,1,0
63415,1,2,222089,222089,222091,0,2,0
63416,3,2,222092,222092,222094,0,2,1
63417,4,3,222096,222096,222099,0,3,2
63418,3,3,222099,222099,222102,0,3,0
63419,1,2,222100,222102,222104,2,4,0
63420,6,2,222106,222106,222108,0,2,2
63421,2,1,222108,222108,222109,0,1,0
63422,4,2,222112,222112,222114,0,2,3
63423,4,3,222116,222116,222119,0,3,2
63424,2,3,222118,222119,222122,1,4,0
63425,6,2,222124,222124,222126,0,2,2
63426,3,3,222127,222127,222130,0,3,1
63427,6,1,222133,222133,222134,0,1,3
63428,5,2,222138,222138,222140,0,2,4
63429,1,1,222139,222140,222141,1,2,0
63430,4,2,222143,222143,222145,0,2,2
63431,3,2,222146,222146,222148,0,2,1
63432,3,3,222149,222149,222152,0,3,1
63433,5,1,222154,222154,222155,0,1,2
63434,4,3,222158,222158,222161,0,3,3
63435,1,2,222159,222161,222163,2,4,0
63436,2,1,222161,222163,222164,2,3,0
63437,4,2,222165,222165,222167,0,2,1
63438,2,2,222167,222167,222169,0,2,0
63439,2,2,222169,222169,222171,0,2,0
63440,2,3,222171,222171,222174,0,3,0
63441,1,3,222172,222174,222177,2,5,0
63442,1,3,222173,222177,222180,4,7,0
63443,2,1,222175,222180,222181,5,6,0
63444,4,2,222179,222181,222183,2,4,0
63445,6,2,222185,222185,222187,0,2,2
63446,2,3,222187,222187,222190,0,3,0
63447,3,1,222190,222190,222191,0,1,0
63448,3,2,222193,222193,222195,0,2,2
63449,1,1,222194,222195,222196,1,2,0
63450,5,3,222199,222199,222202,0,3,3
63451,3,3,222202,222202,222205,0,3,0
63452,5,2,222207,222207,222209,0,2,2
63453,1,1,222208,222209,222210,1,2,0
63454,4,3,222212,222212,222215,0,3,2
63455,5,1,222217,222217,222218,0,1,2
63456,5,1,222222,222222,222223,0,1,4
63457,4,2,222226,222226,222228,0,2,3
63458,3,1,222229,222229,222230,0,1,1
63459,4,1,222233,222233,222234,0,1,3
63460,2,3,222235,222235,222238,0,3,1
63461,6,2,222241,222241,222243,0,2,3
63462,1,1,222242,222243,222244,1,2,0
63463,4,1,222246,222246,222247,0,1,2
63464,3,2,222249,222249,222251,0,2,2
63465,3,1,222252,222252,222253,0,1,1
63466,5,3,222257,222257,222260,0,3,4
63467,2,1,222259,222260,222261,1,2,0
63468,4,1,222263,222263,222264,0,1,2
63469,1,3,222264,222264,222267,0,3,0
63470,5,1,222269,222269,222270,0,1,2
63471,2,1,222271,222271,222272,0,1,1
63472,3,3,222274,222274,222277,0,3,2
63473,1,1,222275,222277,222278,2,3,0
63474,4,1,222279,222279,222280,0,1,1
63475,5,2,222284,222284,222286,0,2,4
63476,2,2,222286,222286,222288,0,2,0
63477,2,1,222288,222288,222289,0,1,0
63478,4,1,222292,222292,222293,0,1,3
63479,5,2,222297,222297,222299,0,2,4
63480,3,2,222300,222300,222302,0,2,1
63481,2,3,222302,222302,222305,0,3,0
63482,5,2,222307,222307,222309,0,2,2
63483,3,2,222310,222310,222312,0,2,1
63484,6,3,222316,222316,222319,0,3,4
63485,2,3,222318,222319,222322,1,4,0
63486,4,2,222322,222322,222324,0,2,0
63487,4,3,222326,222326,222329,0,3,2
63488,3,2,222329,222329,222331,0,2,0
63489,2,2,222331,222331,222333,0,2,0
63490,3,1,222334,222334,222335,0,1,1
63491,6,3,222340,222340,222343,0,3,5
63492,2,3,222342,222343,222346,1,4,0
63493,3,3,222345,222346,222349,1,4,0
63494,2,3,222347,222349,222352,2,5,0
63495,4,3,222351,222352,222355,1,4,0
63496,4,3,222355,222355,222358,0,3,0
63497,3,1,222358,222358,222359,0,1,0
63498,6,3,222364,222364,222367,0,3,5
63499,3,3,222367,222367,222370,0,3,0
63500,3,1,222370,222370,222371,0,1,0
63501,2,1,222372,222372,222373,0,1,1
63502,6,1,222378,222378,222379,0,1,5
63503,5,2,222383,222383,222385,0,2,4
63504,5,2,222388,222388,222390,0,2,3
63505,3,1,222391,222391,222392,0,1,1
63506,2,3,222393,222393,222396,0,3,1
63507,4,1,222397,222397,222398,0,1,1
63508,6,2,222403,222403,222405,0,2,5
63509,6,3,222409,222409,222412,0,3,4
63510,4,1,222413,222413,222414,0,1,1
63511,2,2,222415,222415,222417,0,2,1
63512,5,2,222420,222420,222422,0,2,3
63513,1,2,222421,222422,222424,1,3,0
63514,2,3,222423,222424,222427,1,4,0
63515,2,3,222425,222427,222430,2,5,0
63516,6,3,222431,222431,222434,0,3,1
63517,6,3,222437,222437,222440,0,3,3
63518,6,2,222443,222443,222445,0,2,3
63519,1,3,222444,222445,222448,1,4,0
63520,2,3,222446,222448,222451,2,5,0
63521,6,3,222452,222452,222455,0,3,1
63522,1,2,222453,222455,222457,2,4,0
63523,1,1,222454,222457,222458,3,4,0
63524,2,1,222456,222458,222459,2,3,0
63525,5,2,222461,222461,222463,0,2,2
63526,6,2,222467,222467,222469,0,2,4
63527,5,3,222472,222472,222475,0,3,3
63528,1,3,222473,222475,222478,2,5,0
63529,1,2,222474,222478,222480,4,6,0
63530,4,3,222478,222480,222483,2,5,0
63531,2,2,222480,222483,222485,3,5,0
63532,3,3,222483,222485,222488,2,5,0
63533,6,1,222489,222489,222490,0,1,1
63534,4,1,222493,222493,222494,0,1,3
63535,6,3,222499,222499,222502,0,3,5
63536,5,2,222504,222504,222506,0,2,2
63537,5,3,222509,222509,222512,0,3,3
63538,2,3,222511,222512,222515,1,4,0
63539,6,1,222517,222517,222518,0,1,2
63540,4,3,222521,222521,222524,0,3,3
63541,3,2,222524,222524,222526,0,2,0
63542,4,1,222528,222528,222529,0,1,2
63543,2,1,222530,222530,222531,0,1,1
63544,3,2,222533,222533,222535,0,2,2
63545,1,2,222534,222535,222537,1,3,0
63546,5,3,222539,222539,222542,0,3,2
63547,3,3,222542,222542,222545,0,3,0
63548,4,3,222546,222546,222549,0,3,1
63549,6,1,222552,222552,222553,0,1,3
63550,5,2,222557,222557,222559,0,2,4
63551,1,1,222558,222559,222560,1,2,0
63552,3,1,222561,222561,222562,0,1,1
63553,2,1,222563,222563,222564,0,1,1
63554,2,1,222565,222565,222566,0,1,1
63555,6,1,222571,222571,222572,0,1,5
63556,4,2,222575,222575,222577,0,2,3
63557,1,1,222576,222577,222578,1,2,0
63558,2,2,222578,222578,222580,0,2,0
63559,5,1,222583,222583,222584,0,1,3
63560,1,1,222584,222584,222585,0,1,0
63561,6,1,222590,222590,222591,0,1,5
63562,5,2,222595,222595,222597,0,2,4
63563,6,3,222601,222601,222604,0,3,4
63564,3,3,222604,222604,222607,0,3,0
63565,4,2,222608,222608,222610,0,2,1
63566,3,2,222611,222611,222613,0,2,1
63567,2,1,222613,222613,222614,0,1,0
63568,4,3,222617,222617,222620,0,3,3
63569,1,3,222618,222620,222623,2,5,0
63570,4,1,222622,222623,222624,1,2,0
63571,4,3,222626,222626,222629,0,3,2
63572,4,1,222630,222630,222631,0,1,1
63573,4,2,222634,222634,222636,0,2,3
63574,3,2,222637,222637,222639,0,2,1
63575,2,2,222639,222639,222641,0,2,0
63576,2,2,222641,222641,222643,0,2,0
63577,1,3,222642,222643,222646,1,4,0
63578,6,2,222648,222648,222650,0,2,2
63579,1,3,222649,222650,222653,1,4,0
63580,2,3,222651,222653,222656,2,5,0
63581,6,3,222657,222657,222660,0,3,1
63582,6,1,222663,222663,222664,0,1,3
63583,3,3,222666,222666,222669,0,3,2
63584,4,3,222670,222670,222673,0,3,1
63585,2,1,222672,222673,222674,1,2,0
63586,1,2,222673,222674,222676,1,3,0
63587,1,2,222674,222676,222678,2,4,0
63588,5,1,222679,222679,222680,0,1,1
63589,1,1,222680,222680,222681,0,1,0
63590,2,3,222682,222682,222685,0,3,1
63591,5,1,222687,222687,222688,0,1,2
63592,5,1,222692,222692,222693,0,1,4
63593,3,1,222695,222695,222696,0,1,2
63594,2,3,222697,222697,222700,0,3,1
63595,6,2,222703,222703,222705,0,2,3
63596,2,3,222705,222705,222708,0,3,0
63597,6,2,222711,222711,222713,0,2,3
63598,1,2,222712,222713,222715,1,3,0
63599,4,1,222716,222716,222717,0,1,1
63600,1,3,222717,222717,222720,0,3,0
63601,5,2,222722,222722,222724,0,2,2
63602,1,2,222723,222724,222726,1,3,0
63603,6,3,222729,222729,222732,0,3,3
63604,4,1,222733,222733,222734,0,1,1
63605,4,1,222737,222737,222738,0,1,3
63606,6,1,222743,222743,222744,0,1,5
63607,2,3,222745,222745,222748,0,3,1
63608,6,3,222751,222751,222754,0,3,3
63609,6,3,222757,222757,222760,0,3,3
63610,4,2,222761,222761,222763,0,2,1
63611,2,3,222763,222763,222766,0,3,0
63612,4,1,222767,222767,222768,0,1,1
63613,6,3,222773,222773,222776,0,3,5
63614,2,1,222775,222776,222777,1,2,0
63615,5,3,222780,222780,222783,0,3,3
63616,2,1,222782,222783,222784,1,2,0
63617,1,3,222783,222784,222787,1,4,0
63618,3,2,222786,222787,222789,1,3,0
63619,4,3,222790,222790,222793,0,3,1
63620,4,1,222794,222794,222795,0,1,1
63621,5,1,222799,222799,222800,0,1,4
63622,2,1,222801,222801,222802,0,1,1
63623,6,2,222807,222807,222809,0,2,5
63624,1,1,222808,222809,222810,1,2,0
63625,3,3,222811,222811,222814,0,3,1
63626,5,3,222816,222816,222819,0,3,2
63627,6,3,222822,222822,222825,0,3,3
63628,1,2,222823,222825,222827,2,4,0
63629,1,2,222824,222827,222829,3,5,0
63630,5,1,222829,222829,222830,0,1,0
63631,2,3,222831,222831,222834,0,3,1
63632,4,3,222835,222835,222838,0,3,1
63633,5,3,222840,222840,222843,0,3,2
63634,5,2,222845,222845,222847,0,2,2
63635,6,1,222851,222851,222852,0,1,4
63636,6,1,222857,222857,222858,0,1,5
63637,1,1,222858,222858,222859,0,1,0
63638,2,3,222860,222860,222863,0,3,1
63639,3,1,222863,222863,222864,0,1,0
63640,6,1,222869,222869,222870,0,1,5
63641,1,2,222870,222870,222872,0,2,0
63642,1,2,222871,222872,222874,1,3,0
63643,4,2,222875,222875,222877,0,2,1
63644,5,2,222880,222880,222882,0,2,3
63645,2,2,222882,222882,222884,0,2,0
63646,3,2,222885,222885,222887,0,2,1
63647,2,2,222887,222887,222889,0,2,0
63648,5,1,222892,222892,222893,0,1,3
63649,3,1,222895,222895,222896,0,1,2
63650,5,3,222900,222900,222903,0,3,4
63651,4,3,222904,222904,222907,0,3,1
63652,3,1,222907,222907,222908,0,1,0
63653,3,1,222910,222910,222911,0,1,2
63654,5,2,222915,222915,222917,0,2,4
63655,3,2,222918,222918,222920,0,2,1
63656,6,2,222924,222924,222926,0,2,4
63657,2,3,222926,222926,222929,0,3,0
63658,5,2,222931,222931,222933,0,2,2
63659,2,2,222933,222933,222935,0,2,0
63660,6,2,222939,222939,222941,0,2,4
63661,5,2,222944,222944,222946,0,2,3
63662,1,2,222945,222946,222948,1,3,0
63663,4,2,222949,222949,222951,0,2,1
63664,5,1,222954,222954,222955,0,1,3
63665,4,3,222958,222958,222961,0,3,3
63666,2,3,222960,222961,222964,1,4,0
63667,5,2,222965,222965,222967,0,2,1
63668,6,2,222971,222971,222973,0,2,4
63669,5,1,222976,222976,222977,0,1,3
63670,6,1,222982,222982,222983,0,1,5
63671,6,2,222988,222988,222990,0,2,5
63672,3,1,222991,222991,222992,0,1,1
63673,5,1,222996,222996,222997,0,1,4
63674,5,1,223001,223001,223002,0,1,4
63675,2,1,223003,223003,223004,0,1,1
63676,2,2,223005,223005,223007,0,2,1
63677,4,1,223009,223009,223010,0,1,2
63678,2,1,223011,223011,223012,0,1,1
63679,1,3,223012,223012,223015,0,3,0
63680,1,1,223013,223015,223016,2,3,0
63681,1,2,223014,223016,223018,2,4,0
63682,6,1,223020,223020,223021,0,1,2
63683,3,2,223023,223023,223025,0,2,2
63684,3,1,223026,223026,223027,0,1,1
63685,5,2,223031,223031,223033,0,2,4
63686,6,3,223037,223037,223040,0,3,4
63687,2,2,223039,223040,223042,1,3,0
63688,5,2,223044,223044,223046,0,2,2
63689,1,3,223045,223046,223049,1,4,0
63690,4,3,223049,223049,223052,0,3,0
63691,6,2,223055,223055,223057,0,2,3
63692,2,2,223057,223057,223059,0,2,0
63693,1,2,223058,223059,223061,1,3,0
63694,5,3,223063,223063,223066,0,3,2
63695,2,2,223065,223066,223068,1,3,0
63696,4,2,223069,223069,223071,0,2,1
63697,2,1,223071,223071,223072,0,1,0
63698,4,3,223075,223075,223078,0,3,3
63699,2,1,223077,223078,223079,1,2,0
63700,3,3,223080,223080,223083,0,3,1
63701,4,1,223084,223084,223085,0,1,1
63702,1,3,223085,223085,223088,0,3,0
63703,2,1,223087,223088,223089,1,2,0
63704,6,2,223093,223093,223095,0,2,4
63705,1,2,223094,223095,223097,1,3,0
63706,3,2,223097,223097,223099,0,2,0
63707,4,2,223101,223101,223103,0,2,2
63708,6,3,223107,223107,223110,0,3,4
63709,4,3,223111,223111,223114,0,3,1
63710,2,2,223113,223114,223116,1,3,0
63711,1,3,223114,223116,223119,2,5,0
63712,6,1,223120,223120,223121,0,1,1
63713,4,3,223124,223124,223127,0,3,3
63714,5,2,223129,223129,223131,0,2,2
63715,2,2,223131,223131,223133,0,2,0
63716,3,2,223134,223134,223136,0,2,1
63717,5,1,223139,223139,223140,0,1,3
63718,3,1,223142,223142,223143,0,1,2
63719,1,1,223143,223143,223144,0,1,0
63720,2,3,223145,223145,223148,0,3,1
63721,2,1,223147,223148,223149,1,2,0
63722,4,1,223151,223151,223152,0,1,2
63723,1,3,223152,223152,223155,0,3,0
63724,2,1,223154,223155,223156,1,2,0
63725,1,2,223155,223156,223158,1,3,0
63726,1,1,223156,223158,223159,2,3,0
63727,6,2,223162,223162,223164,0,2,3
63728,6,2,223168,223168,223170,0,2,4
63729,4,1,223172,223172,223173,0,1,2
63730,3,3,223175,223175,223178,0,3,2
63731,1,2,223176,223178,223180,2,4,0
63732,3,2,223179,223180,223182,1,3,0
63733,6,1,223185,223185,223186,0,1,3
63734,1,2,223186,223186,223188,0,2,0
63735,4,1,223190,223190,223191,0,1,2
63736,4,1,223194,223194,223195,0,1,3
63737,5,2,223199,223199,223201,0,2,4
63738,6,2,223205,223205,223207,0,2,4
63739,1,3,223206,223207,223210,1,4,0
63740,6,1,223212,223212,223213,0,1,2
63741,4,3,223216,223216,223219,0,3,3
63742,3,2,223219,223219,223221,0,2,0
63743,5,2,223224,223224,223226,0,2,3
63744,4,2,223228,223228,223230,0,2,2
63745,3,3,223231,223231,223234,0,3,1
63746,2,3,223233,223234,223237,1,4,0
63747,1,2,223234,223237,223239,3,5,0
63748,2,3,223236,223239,223242,3,6,0
63749,5,2,223241,223242,223244,1,3,0
63750,5,3,223246,223246,223249,0,3,2
63751,4,2,223250,223250,223252,0,2,1
63752,2,2,223252,223252,223254,0,2,0
63753,5,3,223257,223257,223260,0,3,3
63754,3,3,223260,223260,223263,0,3,0
63755,6,3,223266,223266,223269,0,3,3
63756,6,2,223272,223272,223274,0,2,3
63757,6,1,223278,223278,223279,0,1,4
63758,1,2,223279,223279,223281,0,2,0
63759,2,1,223281,223281,223282,0,1,0
63760,5,3,223286,223286,223289,0,3,4
63761,1,1,223287,223289,223290,2,3,0
63762,5,1,223292,223292,223293,0,1,2
63763,4,2,223296,223296,223298,0,2,3
63764,5,3,223301,223301,223304,0,3,3
63765,5,3,223306,223306,223309,0,3,2
63766,5,2,223311,223311,223313,0,2,2
63767,5,2,223316,223316,223318,0,2,3
63768,2,3,223318,223318,223321,0,3,0
63769,3,1,223321,223321,223322,0,1,0
63770,6,3,223327,223327,223330,0,3,5
63771,6,3,223333,223333,223336,0,3,3
63772,4,1,223337,223337,223338,0,1,1
63773,6,3,223343,223343,223346,0,3,5
63774,2,1,223345,223346,223347,1,2,0
63775,5,1,223350,223350,223351,0,1,3
63776,1,3,223351,223351,223354,0,3,0
63777,5,2,223356,223356,223358,0,2,2
63778,5,3,223361,223361,223364,0,3,3
63779,1,2,223362,223364,223366,2,4,0
63780,1,2,223363,223366,223368,3,5,0
63781,4,3,223367,223368,223371,1,4,0
63782,5,2,223372,223372,223374,0,2,1
63783,5,3,223377,223377,223380,0,3,3
63784,3,1,223380,223380,223381,0,1,0
63785,3,3,223383,223383,223386,0,3,2
63786,2,3,223385,223386,223389,1,4,0
63787,6,1,223391,223391,223392,0,1,2
63788,3,1,223394,223394,223395,0,1,2
63789,6,3,223400,223400,223403,0,3,5
63790,4,1,223404,223404,223405,0,1,1
63791,2,1,223406,223406,223407,0,1,1
63792,6,3,223412,223412,223415,0,3,5
63793,4,1,223416,223416,223417,0,1,1
63794,5,1,223421,223421,223422,0,1,4
63795,2,2,223423,223423,223425,0,2,1
63796,4,3,223427,223427,223430,0,3,2
63797,4,3,223431,223431,223434,0,3,1
63798,6,1,223437,223437,223438,0,1,3
63799,4,3,223441,223441,223444,0,3,3
63800,1,2,223442,223444,223446,2,4,0
63801,3,3,223445,223446,223449,1,4,0
63802,6,3,223451,223451,223454,0,3,2
63803,2,1,223453,223454,223455,1,2,0
63804,4,3,223457,223457,223460,0,3,2
63805,5,3,223462,223462,223465,0,3,2
63806,6,2,223468,223468,223470,0,2,3
63807,6,1,223474,223474,223475,0,1,4
63808,4,2,223478,223478,223480,0,2,3
63809,4,3,223482,223482,223485,0,3,2
63810,4,3,223486,223486,223489,0,3,1
63811,1,2,223487,223489,223491,2,4,0
63812,2,1,223489,223491,223492,2,3,0
63813,4,3,223493,223493,223496,0,3,1
63814,6,3,223499,223499,223502,0,3,3
63815,3,1,223502,223502,223503,0,1,0
63816,5,3,223507,223507,223510,0,3,4
63817,6,3,223513,223513,223516,0,3,3
63818,6,3,223519,223519,223522,0,3,3
63819,3,2,223522,223522,223524,0,2,0
63820,4,3,223526,223526,223529,0,3,2
63821,2,2,223528,223529,223531,1,3,0
63822,5,2,223533,223533,223535,0,2,2
63823,1,1,223534,223535,223536,1,2,0
63824,5,2,223539,223539,223541,0,2,3
63825,4,3,223543,223543,223546,0,3,2
63826,1,3,223544,223546,223549,2,5,0
63827,1,2,223545,223549,223551,4,6,0
63828,3,2,223548,223551,223553,3,5,0
63829,5,3,223553,223553,223556,0,3,0
63830,1,1,223554,223556,223557,2,3,0
63831,5,1,223559,223559,223560,0,1,2
63832,4,1,223563,223563,223564,0,1,3
63833,2,2,223565,223565,223567,0,2,1
63834,3,3,223568,223568,223571,0,3,1
63835,2,1,223570,223571,223572,1,2,0
63836,6,2,223576,223576,223578,0,2,4
63837,3,1,223579,223579,223580,0,1,1
63838,2,2,223581,223581,223583,0,2,1
63839,4,3,223585,223585,223588,0,3,2
63840,1,3,223586,223588,223591,2,5,0
63841,3,1,223589,223591,223592,2,3,0
63842,4,2,223593,223593,223595,0,2,1
63843,4,3,223597,223597,223600,0,3,2
63844,2,2,223599,223600,223602,1,3,0
63845,2,3,223601,223602,223605,1,4,0
63846,3,2,223604,223605,223607,1,3,0
63847,5,3,223609,223609,223612,0,3,2
63848,3,3,223612,223612,223615,0,3,0
63849,1,3,223613,223615,223618,2,5,0
63850,2,1,223615,223618,223619,3,4,0
63851,2,2,223617,223619,223621,2,4,0
63852,2,3,223619,223621,223624,2,5,0
63853,2,1,223621,223624,223625,3,4,0
63854,2,2,223623,223625,223627,2,4,0
63855,4,3,223627,223627,223630,0,3,0
63856,5,3,223632,223632,223635,0,3,2
63857,6,3,223638,223638,223641,0,3,3
63858,2,1,223640,223641,223642,1,2,0
63859,5,3,223645,223645,223648,0,3,3
63860,4,1,223649,223649,223650,0,1,1
63861,6,2,223655,223655,223657,0,2,5
63862,6,2,223661,223661,223663,0,2,4
63863,3,2,223664,223664,223666,0,2,1
63864,3,3,223667,223667,223670,0,3,1
63865,6,3,223673,223673,223676,0,3,3
63866,1,1,223674,223676,223677,2,3,0
63867,3,1,223677,223677,223678,0,1,0
63868,6,3,223683,223683,223686,0,3,5
63869,3,2,223686,223686,223688,0,2,0
63870,4,1,223690,223690,223691,0,1,2
63871,3,1,223693,223693,223694,0,1,2
63872,1,1,223694,223694,223695,0,1,0
63873,4,1,223698,223698,223699,0,1,3
63874,4,3,223702,223702,223705,0,3,3
63875,1,2,223703,223705,223707,2,4,0
63876,1,3,223704,223707,223710,3,6,0
63877,4,2,223708,223710,223712,2,4,0
63878,6,3,223714,223714,223717,0,3,2
63879,6,3,223720,223720,223723,0,3,3
63880,5,3,223725,223725,223728,0,3,2
63881,5,1,223730,223730,223731,0,1,2
63882,3,3,223733,223733,223736,0,3,2
63883,1,3,223734,223736,223739,2,5,0
63884,3,1,223737,223739,223740,2,3,0
63885,5,3,223742,223742,223745,0,3,2
63886,2,1,223744,223745,223746,1,2,0
63887,4,3,223748,223748,223751,0,3,2
63888,4,3,223752,223752,223755,0,3,1
63889,1,1,223753,223755,223756,2,3,0
63890,6,1,223759,223759,223760,0,1,3
63891,2,3,223761,223761,223764,0,3,1
63892,6,1,223767,223767,223768,0,1,3
63893,1,3,223768,223768,223771,0,3,0
63894,1,1,223769,223771,223772,2,3,0
63895,2,2,223771,223772,223774,1,3,0
63896,2,1,223773,223774,223775,1,2,0
63897,3,1,223776,223776,223777,0,1,1
63898,4,1,223780,223780,223781,0,1,3
63899,1,2,223781,223781,223783,0,2,0
63900,2,1,223783,223783,223784,0,1,0
63901,2,1,223785,223785,223786,0,1,1
63902,6,2,223791,223791,223793,0,2,5
63903,5,3,223796,223796,223799,0,3,3
63904,4,1,223800,223800,223801,0,1,1
63905,6,1,223806,223806,223807,0,1,5
63906,4,3,223810,223810,223813,0,3,3
63907,4,1,223814,223814,223815,0,1,1
63908,3,3,223817,223817,223820,0,3,2
63909,4,3,223821,223821,223824,0,3,1
63910,4,3,223825,223825,223828,0,3,1
63911,4,1,223829,223829,223830,0,1,1
63912,6,1,223835,223835,223836,0,1,5
63913,5,2,223840,223840,223842,0,2,4
63914,5,2,223845,223845,223847,0,2,3
63915,1,1,223846,223847,223848,1,2,0
63916,3,1,223849,223849,223850,0,1,1
63917,5,2,223854,223854,223856,0,2,4
63918,5,3,223859,223859,223862,0,3,3
63919,4,1,223863,223863,223864,0,1,1
63920,4,3,223867,223867,223870,0,3,3
63921,6,1,223873,223873,223874,0,1,3
63922,6,1,223879,223879,223880,0,1,5
63923,2,1,223881,223881,223882,0,1,1
63924,5,3,223886,223886,223889,0,3,4
63925,6,2,223892,223892,223894,0,2,3
63926,6,2,223898,223898,223900,0,2,4
63927,5,2,223903,223903,223905,0,2,3
63928,6,2,223909,223909,223911,0,2,4
63929,6,2,223915,223915,223917,0,2,4
63930,2,1,223917,223917,223918,0,1,0
63931,1,2,223918,223918,223920,0,2,0
63932,6,3,223924,223924,223927,0,3,4
63933,6,3,223930,223930,223933,0,3,3
63934,1,2,223931,223933,223935,2,4,0
63935,5,3,223936,223936,223939,0,3,1
63936,2,2,223938,223939,223941,1,3,0
63937,2,3,223940,223941,223944,1,4,0
63938,1,2,223941,223944,223946,3,5,0
63939,2,3,223943,223946,223949,3,6,0
63940,4,1,223947,223949,223950,2,3,0
63941,3,3,223950,223950,223953,0,3,0
63942,6,2,223956,223956,223958,0,2,3
63943,4,2,223960,223960,223962,0,2,2
63944,5,2,223965,223965,223967,0,2,3
63945,3,2,223968,223968,223970,0,2,1
63946,1,1,223969,223970,223971,1,2,0
63947,4,3,223973,223973,223976,0,3,2
63948,4,2,223977,223977,223979,0,2,1
63949,2,3,223979,223979,223982,0,3,0
63950,1,3,223980,223982,223985,2,5,0
63951,6,2,223986,223986,223988,0,2,1
63952,3,1,223989,223989,223990,0,1,1
63953,5,2,223994,223994,223996,0,2,4
63954,3,1,223997,223997,223998,0,1,1
63955,3,3,224000,224000,224003,0,3,2
63956,4,2,224004,224004,224006,0,2,1
63957,4,1,224008,224008,224009,0,1,2
63958,6,1,224014,224014,224015,0,1,5
63959,5,3,224019,224019,224022,0,3,4
63960,1,1,224020,224022,224023,2,3,0
63961,6,3,224026,224026,224029,0,3,3
63962,5,3,224031,224031,224034,0,3,2
63963,1,3,224032,224034,224037,2,5,0
63964,4,1,224036,224037,224038,1,2,0
63965,1,1,224037,224038,224039,1,2,0
63966,5,3,224042,224042,224045,0,3,3
63967,3,2,224045,224045,224047,0,2,0
63968,6,3,224051,224051,224054,0,3,4
63969,6,3,224057,224057,224060,0,3,3
63970,3,2,224060,224060,224062,0,2,0
63971,1,2,224061,224062,224064,1,3,0
63972,4,1,224065,224065,224066,0,1,1
63973,4,3,224069,224069,224072,0,3,3
63974,5,1,224074,224074,224075,0,1,2
63975,6,2,224080,224080,224082,0,2,5
63976,2,1,224082,224082,224083,0,1,0
63977,6,3,224088,224088,224091,0,3,5
63978,2,2,224090,224091,224093,1,3,0
63979,5,1,224095,224095,224096,0,1,2
63980,4,1,224099,224099,224100,0,1,3
63981,2,1,224101,224101,224102,0,1,1
63982,1,2,224102,224102,224104,0,2,0
63983,2,3,224104,224104,224107,0,3,0
63984,3,1,224107,224107,224108,0,1,0
63985,5,2,224112,224112,224114,0,2,4
63986,2,3,224114,224114,224117,0,3,0
63987,4,2,224118,224118,224120,0,2,1
63988,3,2,224121,224121,224123,0,2,1
63989,2,1,224123,224123,224124,0,1,0
63990,5,3,224128,224128,224131,0,3,4
63991,1,2,224129,224131,224133,2,4,0
63992,1,1,224130,224133,224134,3,4,0
63993,3,2,224133,224134,224136,1,3,0
63994,2,1,224135,224136,224137,1,2,0
63995,4,1,224139,224139,224140,0,1,2
63996,2,3,224141,224141,224144,0,3,1
63997,3,1,224144,224144,224145,0,1,0
63998,1,2,224145,224145,224147,0,2,0
63999,5,1,224150,224150,224151,0,1,3
64000,4,3,224154,224154,224157,0,3,3
64001,6,2,224160,224160,224162,0,2,3
64002,4,1,224164,224164,224165,0,1,2
64003,4,1,224168,224168,224169,0,1,3
64004,3,3,224171,224171,224174,0,3,2
64005,2,3,224173,224174,224177,1,4,0
64006,1,3,224174,224177,224180,3,6,0
64007,4,1,224178,224180,224181,2,3,0
64008,5,1,224183,224183,224184,0,1,2
64009,1,3,224184,224184,224187,0,3,0
64010,6,1,224190,224190,224191,0,1,3
64011,1,3,224191,224191,224194,0,3,0
64012,5,2,224196,224196,224198,0,2,2
64013,4,3,224200,224200,224203,0,3,2
64014,1,2,224201,224203,224205,2,4,0
64015,2,3,224203,224205,224208,2,5,0
64016,2,1,224205,224208,224209,3,4,0
64017,1,2,224206,224209,224211,3,5,0
64018,2,1,224208,224211,224212,3,4,0
64019,1,1,224209,224212,224213,3,4,0
64020,2,1,224211,224213,224214,2,3,0
64021,5,3,224216,224216,224219,0,3,2
64022,3,1,224219,224219,224220,0,1,0
64023,2,1,224221,224221,224222,0,1,1
64024,6,2,224227,224227,224229,0,2,5
64025,6,3,224233,224233,224236,0,3,4
64026,2,1,224235,224236,224237,1,2,0
64027,5,2,224240,224240,224242,0,2,3
64028,4,1,224244,224244,224245,0,1,2
64029,3,3,224247,224247,224250,0,3,2
64030,6,1,224253,224253,224254,0,1,3
64031,6,2,224259,224259,224261,0,2,5
64032,1,2,224260,224261,224263,1,3,0
64033,4,2,224264,224264,224266,0,2,1
64034,6,1,224270,224270,224271,0,1,4
64035,4,3,224274,224274,224277,0,3,3
64036,3,2,224277,224277,224279,0,2,0
64037,4,3,224281,224281,224284,0,3,2
64038,1,2,224282,224284,224286,2,4,0
64039,1,1,224283,224286,224287,3,4,0
64040,2,3,224285,224287,224290,2,5,0
64041,6,1,224291,224291,224292,0,1,1
64042,4,1,224295,224295,224296,0,1,3
64043,5,1,224300,224300,224301,0,1,4
64044,3,3,224303,224303,224306,0,3,2
64045,1,3,224304,224306,224309,2,5,0
64046,6,2,224310,224310,224312,0,2,1
64047,1,3,224311,224312,224315,1,4,0
64048,6,2,224317,224317,224319,0,2,2
64049,1,3,224318,224319,224322,1,4,0
64050,6,1,224324,224324,224325,0,1,2
64051,2,3,224326,224326,224329,0,3,1
64052,1,1,224327,224329,224330,2,3,0
64053,1,3,224328,224330,224333,2,5,0
64054,6,1,224334,224334,224335,0,1,1
64055,1,2,224335,224335,224337,0,2,0
64056,5,2,224340,224340,224342,0,2,3
64057,1,2,224341,224342,224344,1,3,0
64058,6,1,224347,224347,224348,0,1,3
64059,1,3,224348,224348,224351,0,3,0
64060,5,1,224353,224353,224354,0,1,2
64061,5,2,224358,224358,224360,0,2,4
64062,4,3,224362,224362,224365,0,3,2
64063,3,2,224365,224365,224367,0,2,0
64064,3,3,224368,224368,224371,0,3,1
64065,1,2,224369,224371,224373,2,4,0
64066,2,2,224371,224373,224375,2,4,0
64067,6,3,224377,224377,224380,0,3,2
64068,3,2,224380,224380,224382,0,2,0
64069,5,1,224385,224385,224386,0,1,3
64070,6,1,224391,224391,224392,0,1,5
64071,4,1,224395,224395,224396,0,1,3
64072,5,1,224400,224400,224401,0,1,4
64073,1,2,224401,224401,224403,0,2,0
64074,1,3,224402,224403,224406,1,4,0
64075,4,3,224406,224406,224409,0,3,0
64076,5,2,224411,224411,224413,0,2,2
64077,4,3,224415,224415,224418,0,3,2
64078,4,3,224419,224419,224422,0,3,1
64079,4,3,224423,224423,224426,0,3,1
64080,4,3,224427,224427,224430,0,3,1
64081,1,1,224428,224430,224431,2,3,0
64082,5,2,224433,224433,224435,0,2,2
64083,6,2,224439,224439,224441,0,2,4
64084,6,3,224445,224445,224448,0,3,4
64085,5,3,224450,224450,224453,0,3,2
64086,5,1,224455,224455,224456,0,1,2
64087,5,3,224460,224460,224463,0,3,4
64088,5,2,224465,224465,224467,0,2,2
64089,6,1,224471,224471,224472,0,1,4
64090,2,3,224473,224473,224476,0,3,1
64091,1,2,224474,224476,224478,2,4,0
64092,3,1,224477,224478,224479,1,2,0
64093,1,1,224478,224479,224480,1,2,0
64094,1,3,224479,224480,224483,1,4,0
64095,2,2,224481,224483,224485,2,4,0
64096,3,2,224484,224485,224487,1,3,0
64097,3,1,224487,224487,224488,0,1,0
64098,6,2,224493,224493,224495,0,2,5
64099,2,1,224495,224495,224496,0,1,0
64100,6,3,224501,224501,224504,0,3,5
64101,2,1,224503,224504,224505,1,2,0
64102,2,2,224505,224505,224507,0,2,0
64103,5,1,224510,224510,224511,0,1,3
64104,5,2,224515,224515,224517,0,2,4
64105,4,3,224519,224519,224522,0,3,2
64106,1,3,224520,224522,224525,2,5,0
64107,2,1,224522,224525,224526,3,4,0
64108,3,1,224525,224526,224527,1,2,0
64109,1,2,224526,224527,224529,1,3,0
64110,6,2,224532,224532,224534,0,2,3
64111,1,2,224533,224534,224536,1,3,0
64112,6,1,224539,224539,224540,0,1,3
64113,2,1,224541,224541,224542,0,1,1
64114,1,3,224542,224542,224545,0,3,0
64115,4,2,224546,224546,224548,0,2,1
64116,5,1,224551,224551,224552,0,1,3
64117,5,1,224556,224556,224557,0,1,4
64118,3,2,224559,224559,224561,0,2,2
64119,6,3,224565,224565,224568,0,3,4
64120,6,3,224571,224571,224574,0,3,3
64121,3,1,224574,224574,224575,0,1,0
64122,1,3,224575,224575,224578,0,3,0
64123,1,1,224576,224578,224579,2,3,0
64124,2,2,224578,224579,224581,1,3,0
64125,5,2,224583,224583,224585,0,2,2
64126,6,3,224589,224589,224592,0,3,4
64127,4,1,224593,224593,224594,0,1,1
64128,2,3,224595,224595,224598,0,3,1
64129,5,3,224600,224600,224603,0,3,2
64130,5,3,224605,224605,224608,0,3,2
64131,2,2,224607,224608,224610,1,3,0
64132,1,1,224608,224610,224611,2,3,0
64133,2,1,224610,224611,224612,1,2,0
64134,1,2,224611,224612,224614,1,3,0
64135,5,2,224616,224616,224618,0,2,2
64136,2,3,224618,224618,224621,0,3,0
64137,1,2,224619,224621,224623,2,4,0
64138,3,3,224622,224623,224626,1,4,0
64139,2,3,224624,224626,224629,2,5,0
64140,2,2,224626,224629,224631,3,5,0
64141,3,2,224629,224631,224633,2,4,0
64142,5,2,224634,224634,224636,0,2,1
64143,5,2,224639,224639,224641,0,2,3
64144,1,3,224640,224641,224644,1,4,0
64145,1,3,224641,224644,224647,3,6,0
64146,3,3,224644,224647,224650,3,6,0
64147,4,3,224648,224650,224653,2,5,0
64148,3,1,224651,224653,224654,2,3,0
64149,4,3,224655,224655,224658,0,3,1
64150,1,1,224656,224658,224659,2,3,0
64151,4,1,224660,224660,224661,0,1,1
64152,5,2,224665,224665,224667,0,2,4
64153,3,2,224668,224668,224670,0,2,1
64154,2,3,224670,224670,224673,0,3,0
64155,2,2,224672,224673,224675,1,3,0
64156,3,3,224675,224675,224678,0,3,0
64157,5,2,224680,224680,224682,0,2,2
64158,6,3,224686,224686,224689,0,3,4
64159,5,2,224691,224691,224693,0,2,2
64160,1,2,224692,224693,224695,1,3,0
64161,3,1,224695,224695,224696,0,1,0
64162,5,3,224700,224700,224703,0,3,4
64163,3,3,224703,224703,224706,0,3,0
64164,5,1,224708,224708,224709,0,1,2
64165,5,2,224713,224713,224715,0,2,4
64166,1,2,224714,224715,224717,1,3,0
64167,5,3,224719,224719,224722,0,3,2
64168,3,2,224722,224722,224724,0,2,0
64169,2,3,224724,224724,224727,0,3,0
64170,6,2,224730,224730,224732,0,2,3
64171,2,1,224732,224732,224733,0,1,0
64172,3,1,224735,224735,224736,0,1,2
64173,5,1,224740,224740,224741,0,1,4
64174,5,2,224745,224745,224747,0,2,4
64175,1,3,224746,224747,224750,1,4,0
64176,5,3,224751,224751,224754,0,3,1
64177,2,2,224753,224754,224756,1,3,0
64178,5,1,224758,224758,224759,0,1,2
64179,1,1,224759,224759,224760,0,1,0
64180,3,1,224762,224762,224763,0,1,2
64181,6,1,224768,224768,224769,0,1,5
64182,4,3,224772,224772,224775,0,3,3
64183,5,3,224777,224777,224780,0,3,2
64184,5,1,224782,224782,224783,0,1,2
64185,2,1,224784,224784,224785,0,1,1
64186,2,1,224786,224786,224787,0,1,1
64187,4,2,224790,224790,224792,0,2,3
64188,6,1,224796,224796,224797,0,1,4
64189,2,3,224798,224798,224801,0,3,1
64190,3,3,224801,224801,224804,0,3,0
64191,3,1,224804,224804,224805,0,1,0
64192,6,1,224810,224810,224811,0,1,5
64193,4,2,224814,224814,224816,0,2,3
64194,5,1,224819,224819,224820,0,1,3
64195,3,2,224822,224822,224824,0,2,2
64196,3,1,224825,224825,224826,0,1,1
64197,3,3,224828,224828,224831,0,3,2
64198,5,1,224833,224833,224834,0,1,2
64199,6,1,224839,224839,224840,0,1,5
64200,3,2,224842,224842,224844,0,2,2
64201,1,3,224843,224844,224847,1,4,0
64202,6,3,224849,224849,224852,0,3,2
64203,4,1,224853,224853,224854,0,1,1
64204,1,2,224854,224854,224856,0,2,0
64205,5,1,224859,224859,224860,0,1,3
64206,5,1,224864,224864,224865,0,1,4
64207,6,3,224870,224870,224873,0,3,5
64208,1,1,224871,224873,224874,2,3,0
64209,1,3,224872,224874,224877,2,5,0
64210,6,1,224878,224878,224879,0,1,1
64211,1,1,224879,224879,224880,0,1,0
64212,5,3,224884,224884,224887,0,3,4
64213,6,3,224890,224890,224893,0,3,3
64214,4,3,224894,224894,224897,0,3,1
64215,1,2,224895,224897,224899,2,4,0
64216,5,3,224900,224900,224903,0,3,1
64217,5,3,224905,224905,224908,0,3,2
64218,3,2,224908,224908,224910,0,2,0
64219,3,3,224911,224911,224914,0,3,1
64220,3,1,224914,224914,224915,0,1,0
64221,2,2,224916,224916,224918,0,2,1
64222,4,2,224920,224920,224922,0,2,2
64223,2,3,224922,224922,224925,0,3,0
64224,2,2,224924,224925,224927,1,3,0
64225,4,1,224928,224928,224929,0,1,1
64226,4,3,224932,224932,224935,0,3,3
64227,4,3,224936,224936,224939,0,3,1
64228,5,2,224941,224941,224943,0,2,2
64229,4,1,224945,224945,224946,0,1,2
64230,4,3,224949,224949,224952,0,3,3
64231,5,2,224954,224954,224956,0,2,2
64232,3,3,224957,224957,224960,0,3,1
64233,6,1,224963,224963,224964,0,1,3
64234,6,2,224969,224969,224971,0,2,5
64235,4,1,224973,224973,224974,0,1,2
64236,3,1,224976,224976,224977,0,1,2
64237,1,1,224977,224977,224978,0,1,0
64238,4,2,224981,224981,224983,0,2,3
64239,3,2,224984,224984,224986,0,2,1
64240,3,3,224987,224987,224990,0,3,1
64241,4,3,224991,224991,224994,0,3,1
64242,3,3,224994,224994,224997,0,3,0
64243,2,3,224996,224997,225000,1,4,0
64244,1,1,224997,225000,225001,3,4,0
64245,4,1,225001,225001,225002,0,1,0
64246,5,2,225006,225006,225008,0,2,4
64247,1,3,225007,225008,225011,1,4,0
64248,5,3,225012,225012,225015,0,3,1
64249,1,1,225013,225015,225016,2,3,0
64250,4,2,225017,225017,225019,0,2,1
64251,1,3,225018,225019,225022,1,4,0
64252,4,2,225022,225022,225024,0,2,0
64253,5,3,225027,225027,225030,0,3,3
64254,2,1,225029,225030,225031,1,2,0
64255,1,1,225030,225031,225032,1,2,0
64256,5,2,225035,225035,225037,0,2,3
64257,6,1,225041,225041,225042,0,1,4
64258,3,1,225044,225044,225045,0,1,2
64259,4,1,225048,225048,225049,0,1,3
64260,2,3,225050,225050,225053,0,3,1
64261,3,2,225053,225053,225055,0,2,0
64262,3,2,225056,225056,225058,0,2,1
64263,1,1,225057,225058,225059,1,2,0
64264,2,1,225059,225059,225060,0,1,0
64265,4,1,225063,225063,225064,0,1,3
64266,6,1,225069,225069,225070,0,1,5
64267,3,1,225072,225072,225073,0,1,2
64268,4,1,225076,225076,225077,0,1,3
64269,2,2,225078,225078,225080,0,2,1
64270,3,2,225081,225081,225083,0,2,1
64271,5,1,225086,225086,225087,0,1,3
64272,5,2,225091,225091,225093,0,2,4
64273,6,2,225097,225097,225099,0,2,4
64274,2,3,225099,225099,225102,0,3,0
64275,2,1,225101,225102,225103,1,2,0
64276,1,2,225102,225103,225105,1,3,0
64277,3,1,225105,225105,225106,0,1,0
64278,4,1,225109,225109,225110,0,1,3
64279,3,3,225112,225112,225115,0,3,2
64280,1,2,225113,225115,225117,2,4,0
64281,1,1,225114,225117,225118,3,4,0
64282,1,3,225115,225118,225121,3,6,0
64283,2,3,225117,225121,225124,4,7,0
64284,5,2,225122,225124,225126,2,4,0
64285,1,3,225123,225126,225129,3,6,0
64286,3,1,225126,225129,225130,3,4,0
64287,6,1,225132,225132,225133,0,1,2
64288,3,2,225135,225135,225137,0,2,2
64289,3,2,225138,225138,225140,0,2,1
64290,4,3,225142,225142,225145,0,3,2
64291,6,1,225148,225148,225149,0,1,3
64292,4,2,225152,225152,225154,0,2,3
64293,4,2,225156,225156,225158,0,2,2
64294,1,3,225157,225158,225161,1,4,0
64295,3,1,225160,225161,225162,1,2,0
64296,3,3,225163,225163,225166,0,3,1
64297,1,2,225164,225166,225168,2,4,0
64298,5,1,225169,225169,225170,0,1,1
64299,6,2,225175,225175,225177,0,2,5
64300,3,1,225178,225178,225179,0,1,1
64301,4,1,225182,225182,225183,0,1,3
64302,5,2,225187,225187,225189,0,2,4
64303,6,1,225193,225193,225194,0,1,4
64304,3,1,225196,225196,225197,0,1,2
64305,1,1,225197,225197,225198,0,1,0
64306,1,1,225198,225198,225199,0,1,0
64307,2,2,225200,225200,225202,0,2,1
64308,4,3,225204,225204,225207,0,3,2
64309,3,3,225207,225207,225210,0,3,0
64310,5,2,225212,225212,225214,0,2,2
64311,3,3,225215,225215,225218,0,3,1
64312,4,2,225219,225219,225221,0,2,1
64313,6,3,225225,225225,225228,0,3,4
64314,5,3,225230,225230,225233,0,3,2
64315,1,1,225231,225233,225234,2,3,0
64316,5,2,225236,225236,225238,0,2,2
64317,3,3,225239,225239,225242,0,3,1
64318,1,2,225240,225242,225244,2,4,0
64319,5,3,225245,225245,225248,0,3,1
64320,1,1,225246,225248,225249,2,3,0
64321,6,1,225252,225252,225253,0,1,3
64322,2,2,225254,225254,225256,0,2,1
64323,4,3,225258,225258,225261,0,3,2
64324,2,1,225260,225261,225262,1,2,0
64325,3,1,225263,225263,225264,0,1,1
64326,1,1,225264,225264,225265,0,1,0
64327,6,2,225270,225270,225272,0,2,5
64328,2,2,225272,225272,225274,0,2,0
64329,1,3,225273,225274,225277,1,4,0
64330,5,3,225278,225278,225281,0,3,1
64331,4,3,225282,225282,225285,0,3,1
64332,2,3,225284,225285,225288,1,4,0
64333,2,1,225286,225288,225289,2,3,0
64334,2,3,225288,225289,225292,1,4,0
64335,5,2,225293,225293,225295,0,2,1
64336,1,3,225294,225295,225298,1,4,0
64337,6,1,225300,225300,225301,0,1,2
64338,6,2,225306,225306,225308,0,2,5
64339,4,3,225310,225310,225313,0,3,2
64340,4,3,225314,225314,225317,0,3,1
64341,4,2,225318,225318,225320,0,2,1
64342,6,3,225324,225324,225327,0,3,4
64343,3,2,225327,225327,225329,0,2,0
64344,5,3,225332,225332,225335,0,3,3
64345,6,2,225338,225338,225340,0,2,3
64346,4,3,225342,225342,225345,0,3,2
64347,4,2,225346,225346,225348,0,2,1
64348,2,2,225348,225348,225350,0,2,0
64349,4,3,225352,225352,225355,0,3,2
64350,2,2,225354,225355,225357,1,3,0
64351,1,2,225355,225357,225359,2,4,0
64352,5,1,225360,225360,225361,0,1,1
64353,2,1,225362,225362,225363,0,1,1
64354,5,3,225367,225367,225370,0,3,4
64355,2,2,225369,225370,225372,1,3,0
64356,2,3,225371,225372,225375,1,4,0
64357,1,1,225372,225375,225376,3,4,0
64358,1,3,225373,225376,225379,3,6,0
64359,5,1,225378,225379,225380,1,2,0
64360,1,1,225379,225380,225381,1,2,0
64361,3,1,225382,225382,225383,0,1,1
64362,5,1,225387,225387,225388,0,1,4
64363,5,1,225392,225392,225393,0,1,4
64364,6,1,225398,225398,225399,0,1,5
64365,4,3,225402,225402,225405,0,3,3
64366,6,3,225408,225408,225411,0,3,3
64367,5,1,225413,225413,225414,0,1,2
64368,5,3,225418,225418,225421,0,3,4
64369,1,3,225419,225421,225424,2,5,0
64370,3,3,225422,225424,225427,2,5,0
64371,6,2,225428,225428,225430,0,2,1
64372,5,3,225433,225433,225436,0,3,3
64373,3,1,225436,225436,225437,0,1,0
64374,4,2,225440,225440,225442,0,2,3
64375,2,1,225442,225442,225443,0,1,0
64376,2,3,225444,225444,225447,0,3,1
64377,4,1,225448,225448,225449,0,1,1
64378,4,2,225452,225452,225454,0,2,3
64379,3,1,225455,225455,225456,0,1,1
64380,2,1,225457,225457,225458,0,1,1
64381,5,2,225462,225462,225464,0,2,4
64382,5,2,225467,225467,225469,0,2,3
64383,1,1,225468,225469,225470,1,2,0
64384,1,2,225469,225470,225472,1,3,0
64385,6,3,225475,225475,225478,0,3,3
64386,3,3,225478,225478,225481,0,3,0
64387,5,2,225483,225483,225485,0,2,2
64388,6,1,225489,225489,225490,0,1,4
64389,4,3,225493,225493,225496,0,3,3
64390,3,2,225496,225496,225498,0,2,0
64391,1,1,225497,225498,225499,1,2,0
64392,6,2,225503,225503,225505,0,2,4
64393,1,3,225504,225505,225508,1,4,0
64394,6,1,225510,225510,225511,0,1,2
64395,3,3,225513,225513,225516,0,3,2
64396,5,2,225518,225518,225520,0,2,2
64397,5,3,225523,225523,225526,0,3,3
64398,6,3,225529,225529,225532,0,3,3
64399,5,2,225534,225534,225536,0,2,2
64400,4,3,225538,225538,225541,0,3,2
64401,5,3,225543,225543,225546,0,3,2
64402,1,2,225544,225546,225548,2,4,0
64403,5,3,225549,225549,225552,0,3,1
64404,6,3,225555,225555,225558,0,3,3
64405,2,3,225557,225558,225561,1,4,0
64406,6,1,225563,225563,225564,0,1,2
64407,2,1,225565,225565,225566,0,1,1
64408,5,3,225570,225570,225573,0,3,4
64409,2,2,225572,225573,225575,1,3,0
64410,4,1,225576,225576,225577,0,1,1
64411,2,3,225578,225578,225581,0,3,1
64412,6,2,225584,225584,225586,0,2,3
64413,5,3,225589,225589,225592,0,3,3
64414,5,3,225594,225594,225597,0,3,2
64415,1,3,225595,225597,225600,2,5,0
64416,1,2,225596,225600,225602,4,6,0
64417,6,1,225602,225602,225603,0,1,0
64418,5,2,225607,225607,225609,0,2,4
64419,1,2,225608,225609,225611,1,3,0
64420,6,3,225614,225614,225617,0,3,3
64421,6,3,225620,225620,225623,0,3,3
64422,6,1,225626,225626,225627,0,1,3
64423,3,2,225629,225629,225631,0,2,2
64424,2,3,225631,225631,225634,0,3,0
64425,3,2,225634,225634,225636,0,2,0
64426,2,1,225636,225636,225637,0,1,0
64427,6,2,225642,225642,225644,0,2,5
64428,6,2,225648,225648,225650,0,2,4
64429,2,3,225650,225650,225653,0,3,0
64430,6,3,225656,225656,225659,0,3,3
64431,5,2,225661,225661,225663,0,2,2
64432,1,3,225662,225663,225666,1,4,0
64433,1,2,225663,225666,225668,3,5,0
64434,2,1,225665,225668,225669,3,4,0
64435,3,1,225668,225669,225670,1,2,0
64436,3,3,225671,225671,225674,0,3,1
64437,4,1,225675,225675,225676,0,1,1
64438,2,1,225677,225677,225678,0,1,1
64439,6,3,225683,225683,225686,0,3,5
64440,6,2,225689,225689,225691,0,2,3
64441,4,2,225693,225693,225695,0,2,2
64442,5,1,225698,225698,225699,0,1,3
64443,2,1,225700,225700,225701,0,1,1
64444,1,1,225701,225701,225702,0,1,0
64445,2,3,225703,225703,225706,0,3,1
64446,5,3,225708,225708,225711,0,3,2
64447,6,2,225714,225714,225716,0,2,3
64448,4,1,225718,225718,225719,0,1,2
64449,6,1,225724,225724,225725,0,1,5
64450,3,1,225727,225727,225728,0,1,2
64451,4,1,225731,225731,225732,0,1,3
64452,2,3,225733,225733,225736,0,3,1
64453,6,1,225739,225739,225740,0,1,3
64454,4,1,225743,225743,225744,0,1,3
64455,3,1,225746,225746,225747,0,1,2
64456,5,3,225751,225751,225754,0,3,4
64457,6,1,225757,225757,225758,0,1,3
64458,1,2,225758,225758,225760,0,2,0
64459,3,1,225761,225761,225762,0,1,1
64460,3,2,225764,225764,225766,0,2,2
64461,1,2,225765,225766,225768,1,3,0
64462,5,3,225770,225770,225773,0,3,2
64463,4,2,225774,225774,225776,0,2,1
64464,6,2,225780,225780,225782,0,2,4
64465,1,3,225781,225782,225785,1,4,0
64466,4,1,225785,225785,225786,0,1,0
64467,1,2,225786,225786,225788,0,2,0
64468,6,2,225792,225792,225794,0,2,4
64469,5,1,225797,225797,225798,0,1,3
64470,6,3,225803,225803,225806,0,3,5
64471,4,2,225807,225807,225809,0,2,1
64472,1,2,225808,225809,225811,1,3,0
64473,1,2,225809,225811,225813,2,4,0
64474,4,1,225813,225813,225814,0,1,0
64475,3,3,225816,225816,225819,0,3,2
64476,6,1,225822,225822,225823,0,1,3
64477,5,1,225827,225827,225828,0,1,4
64478,4,1,225831,225831,225832,0,1,3
64479,4,1,225835,225835,225836,0,1,3
64480,4,3,225839,225839,225842,0,3,3
64481,2,2,225841,225842,225844,1,3,0
64482,5,3,225846,225846,225849,0,3,2
64483,4,3,225850,225850,225853,0,3,1
64484,1,2,225851,225853,225855,2,4,0
64485,2,1,225853,225855,225856,2,3,0
64486,3,2,225856,225856,225858,0,2,0
64487,3,3,225859,225859,225862,0,3,1
64488,2,3,225861,225862,225865,1,4,0
64489,2,3,225863,225865,225868,2,5,0
64490,3,2,225866,225868,225870,2,4,0
64491,1,1,225867,225870,225871,3,4,0
64492,3,2,225870,225871,225873,1,3,0
64493,4,3,225874,225874,225877,0,3,1
64494,2,1,225876,225877,225878,1,2,0
64495,2,1,225878,225878,225879,0,1,0
64496,1,3,225879,225879,225882,0,3,0
64497,4,1,225883,225883,225884,0,1,1
64498,3,3,225886,225886,225889,0,3,2
64499,1,3,225887,225889,225892,2,5,0
64500,4,1,225891,225892,225893,1,2,0
64501,2,2,225893,225893,225895,0,2,0
64502,4,1,225897,225897,225898,0,1,2
64503,2,3,225899,225899,225902,0,3,1
64504,2,3,225901,225902,225905,1,4,0
64505,1,1,225902,225905,225906,3,4,0
64506,5,1,225907,225907,225908,0,1,1
64507,2,1,225909,225909,225910,0,1,1
64508,6,3,225915,225915,225918,0,3,5
64509,1,1,225916,225918,225919,2,3,0
64510,1,1,225917,225919,225920,2,3,0
64511,2,3,225919,225920,225923,1,4,0
64512,3,3,225922,225923,225926,1,4,0
64513,3,2,225925,225926,225928,1,3,0
64514,3,2,225928,225928,225930,0,2,0
64515,4,1,225932,225932,225933,0,1,2
64516,4,2,225936,225936,225938,0,2,3
64517,2,1,225938,225938,225939,0,1,0
64518,5,1,225943,225943,225944,0,1,4
64519,6,2,225949,225949,225951,0,2,5
64520,4,2,225953,225953,225955,0,2,2
64521,4,1,225957,225957,225958,0,1,2
64522,3,1,225960,225960,225961,0,1,2
64523,4,2,225964,225964,225966,0,2,3
64524,5,3,225969,225969,225972,0,3,3
64525,4,1,225973,225973,225974,0,1,1
64526,2,3,225975,225975,225978,0,3,1
64527,2,1,225977,225978,225979,1,2,0
64528,6,2,225983,225983,225985,0,2,4
64529,4,3,225987,225987,225990,0,3,2
64530,6,3,225993,225993,225996,0,3,3
64531,3,1,225996,225996,225997,0,1,0
64532,3,2,225999,225999,226001,0,2,2
64533,2,3,226001,226001,226004,0,3,0
64534,5,3,226006,226006,226009,0,3,2
64535,4,2,226010,226010,226012,0,2,1
64536,4,1,226014,226014,226015,0,1,2
64537,3,1,226017,226017,226018,0,1,2
64538,2,2,226019,226019,226021,0,2,1
64539,1,2,226020,226021,226023,1,3,0
64540,5,2,226025,226025,226027,0,2,2
64541,1,1,226026,226027,226028,1,2,0
64542,2,1,226028,226028,226029,0,1,0
64543,2,2,226030,226030,226032,0,2,1
64544,5,3,226035,226035,226038,0,3,3
64545,3,2,226038,226038,226040,0,2,0
64546,6,2,226044,226044,226046,0,2,4
64547,3,3,226047,226047,226050,0,3,1
64548,3,1,226050,226050,226051,0,1,0
64549,1,3,226051,226051,226054,0,3,0
64550,5,1,226056,226056,226057,0,1,2
64551,5,2,226061,226061,226063,0,2,4
64552,5,3,226066,226066,226069,0,3,3
64553,2,3,226068,226069,226072,1,4,0
64554,6,3,226074,226074,226077,0,3,2
64555,4,1,226078,226078,226079,0,1,1
64556,5,3,226083,226083,226086,0,3,4
64557,2,2,226085,226086,226088,1,3,0
64558,3,2,226088,226088,226090,0,2,0
64559,3,2,226091,226091,226093,0,2,1
64560,4,2,226095,226095,226097,0,2,2
64561,4,2,226099,226099,226101,0,2,2
64562,5,2,226104,226104,226106,0,2,3
64563,5,3,226109,226109,226112,0,3,3
64564,5,1,226114,226114,226115,0,1,2
64565,2,2,226116,226116,226118,0,2,1
64566,5,1,226121,226121,226122,0,1,3
64567,4,3,226125,226125,226128,0,3,3
64568,2,2,226127,226128,226130,1,3,0
64569,4,3,226131,226131,226134,0,3,1
64570,6,2,226137,226137,226139,0,2,3
64571,2,3,226139,226139,226142,0,3,0
64572,1,1,226140,226142,226143,2,3,0
64573,1,1,226141,226143,226144,2,3,0
64574,6,3,226147,226147,226150,0,3,3
64575,4,1,226151,226151,226152,0,1,1
64576,3,1,226154,226154,226155,0,1,2
64577,1,1,226155,226155,226156,0,1,0
64578,4,2,226159,226159,226161,0,2,3
64579,6,2,226165,226165,226167,0,2,4
64580,4,2,226169,226169,226171,0,2,2
64581,2,1,226171,226171,226172,0,1,0
64582,4,2,226175,226175,226177,0,2,3
64583,3,1,226178,226178,226179,0,1,1
64584,4,2,226182,226182,226184,0,2,3
64585,6,1,226188,226188,226189,0,1,4
64586,4,3,226192,226192,226195,0,3,3
64587,5,3,226197,226197,226200,0,3,2
64588,2,3,226199,226200,226203,1,4,0
64589,6,3,226205,226205,226208,0,3,2
64590,5,3,226210,226210,226213,0,3,2
64591,2,2,226212,226213,226215,1,3,0
64592,6,1,226218,226218,226219,0,1,3
64593,2,1,226220,226220,226221,0,1,1
64594,5,1,226225,226225,226226,0,1,4
64595,4,2,226229,226229,226231,0,2,3
64596,4,1,226233,226233,226234,0,1,2
64597,1,3,226234,226234,226237,0,3,0
64598,5,3,226239,226239,226242,0,3,2
64599,5,1,226244,226244,226245,0,1,2
64600,1,2,226245,226245,226247,0,2,0
64601,1,1,226246,226247,226248,1,2,0
64602,3,1,226249,226249,226250,0,1,1
64603,3,2,226252,226252,226254,0,2,2
64604,4,1,226256,226256,226257,0,1,2
64605,2,1,226258,226258,226259,0,1,1
64606,3,1,226261,226261,226262,0,1,2
64607,6,2,226267,226267,226269,0,2,5
64608,6,3,226273,226273,226276,0,3,4
64609,1,3,226274,226276,226279,2,5,0
64610,3,3,226277,226279,226282,2,5,0
64611,1,3,226278,226282,226285,4,7,0
64612,5,2,226283,226285,226287,2,4,0
64613,4,1,226287,226287,226288,0,1,0
64614,3,3,226290,226290,226293,0,3,2
64615,5,2,226295,226295,226297,0,2,2
64616,5,1,226300,226300,226301,0,1,3
64617,5,2,226305,226305,226307,0,2,4
64618,4,2,226309,226309,226311,0,2,2
64619,5,1,226314,226314,226315,0,1,3
64620,1,1,226315,226315,226316,0,1,0
64621,4,2,226319,226319,226321,0,2,3
64622,4,2,226323,226323,226325,0,2,2
64623,1,1,226324,226325,226326,1,2,0
64624,6,3,226330,226330,226333,0,3,4
64625,5,1,226335,226335,226336,0,1,2
64626,5,1,226340,226340,226341,0,1,4
64627,4,3,226344,226344,226347,0,3,3
64628,3,3,226347,226347,226350,0,3,0
64629,1,1,226348,226350,226351,2,3,0
64630,2,1,226350,226351,226352,1,2,0
64631,4,1,226354,226354,226355,0,1,2
64632,3,2,226357,226357,226359,0,2,2
64633,1,2,226358,226359,226361,1,3,0
64634,3,1,226361,226361,226362,0,1,0
64635,2,1,226363,226363,226364,0,1,1
64636,2,2,226365,226365,226367,0,2,1
64637,6,3,226371,226371,226374,0,3,4
64638,5,2,226376,226376,226378,0,2,2
64639,4,3,226380,226380,226383,0,3,2
64640,5,2,226385,226385,226387,0,2,2
64641,1,3,226386,226387,226390,1,4,0
64642,1,1,226387,226390,226391,3,4,0
64643,1,3,226388,226391,226394,3,6,0
64644,2,3,226390,226394,226397,4,7,0
64645,2,1,226392,226397,226398,5,6,0
64646,3,3,226395,226398,226401,3,6,0
64647,3,3,226398,226401,226404,3,6,0
64648,3,3,226401,226404,226407,3,6,0
64649,6,3,226407,226407,226410,0,3,0
64650,2,1,226409,226410,226411,1,2,0
64651,5,3,226414,226414,226417,0,3,3
64652,4,3,226418,226418,226421,0,3,1
64653,5,1,226423,226423,226424,0,1,2
64654,3,3,226426,226426,226429,0,3,2
64655,3,2,226429,226429,226431,0,2,0
64656,1,3,226430,226431,226434,1,4,0
64657,1,3,226431,226434,226437,3,6,0
64658,2,2,226433,226437,226439,4,6,0
64659,2,2,226435,226439,226441,4,6,0
64660,2,1,226437,226441,226442,4,5,0
64661,3,2,226440,226442,226444,2,4,0
64662,4,3,226444,226444,226447,0,3,0
64663,6,1,226450,226450,226451,0,1,3
64664,6,2,226456,226456,226458,0,2,5
64665,1,2,226457,226458,226460,1,3,0
64666,5,1,226462,226462,226463,0,1,2
64667,6,2,226468,226468,226470,0,2,5
64668,2,1,226470,226470,226471,0,1,0
64669,5,2,226475,226475,226477,0,2,4
64670,1,3,226476,226477,226480,1,4,0
64671,5,3,226481,226481,226484,0,3,1
64672,2,1,226483,226484,226485,1,2,0
64673,3,1,226486,226486,226487,0,1,1
64674,4,2,226490,226490,226492,0,2,3
64675,5,2,226495,226495,226497,0,2,3
64676,1,1,226496,226497,226498,1,2,0
64677,6,3,226502,226502,226505,0,3,4
64678,3,1,226505,226505,226506,0,1,0
64679,4,3,226509,226509,226512,0,3,3
64680,2,2,226511,226512,226514,1,3,0
64681,5,1,226516,226516,226517,0,1,2
64682,1,2,226517,226517,226519,0,2,0
64683,5,2,226522,226522,226524,0,2,3
64684,4,1,226526,226526,226527,0,1,2
64685,2,1,226528,226528,226529,0,1,1
64686,4,3,226532,226532,226535,0,3,3
64687,2,2,226534,226535,226537,1,3,0
64688,2,2,226536,226537,226539,1,3,0
64689,3,1,226539,226539,226540,0,1,0
64690,2,1,226541,226541,226542,0,1,1
64691,3,2,226544,226544,226546,0,2,2
64692,6,2,226550,226550,226552,0,2,4
64693,1,1,226551,226552,226553,1,2,0
64694,5,3,226556,226556,226559,0,3,3
64695,4,2,226560,226560,226562,0,2,1
64696,3,3,226563,226563,226566,0,3,1
64697,6,3,226569,226569,226572,0,3,3
64698,3,3,226572,226572,226575,0,3,0
64699,6,2,226578,226578,226580,0,2,3
64700,2,3,226580,226580,226583,0,3,0
64701,1,1,226581,226583,226584,2,3,0
64702,3,2,226584,226584,226586,0,2,0
64703,4,3,226588,226588,226591,0,3,2
64704,6,1,226594,226594,226595,0,1,3
64705,4,3,226598,226598,226601,0,3,3
64706,3,1,226601,226601,226602,0,1,0
64707,2,3,226603,226603,226606,0,3,1
64708,4,3,226607,226607,226610,0,3,1
64709,2,2,226609,226610,226612,1,3,0
64710,5,3,226614,226614,226617,0,3,2
64711,1,2,226615,226617,226619,2,4,0
64712,6,2,226621,226621,226623,0,2,2
64713,3,1,226624,226624,226625,0,1,1
64714,3,1,226627,226627,226628,0,1,2
64715,4,2,226631,226631,226633,0,2,3
64716,2,3,226633,226633,226636,0,3,0
64717,3,1,226636,226636,226637,0,1,0
64718,1,1,226637,226637,226638,0,1,0
64719,1,1,226638,226638,226639,0,1,0
64720,2,2,226640,226640,226642,0,2,1
64721,4,1,226644,226644,226645,0,1,2
64722,3,3,226647,226647,226650,0,3,2
64723,5,1,226652,226652,226653,0,1,2
64724,6,2,226658,226658,226660,0,2,5
64725,2,1,226660,226660,226661,0,1,0
64726,4,3,226664,226664,226667,0,3,3
64727,3,3,226667,226667,226670,0,3,0
64728,1,1,226668,226670,226671,2,3,0
64729,3,3,226671,226671,226674,0,3,0
64730,3,1,226674,226674,226675,0,1,0
64731,5,3,226679,226679,226682,0,3,4
64732,5,2,226684,226684,226686,0,2,2
64733,4,1,226688,226688,226689,0,1,2
64734,4,3,226692,226692,226695,0,3,3
64735,2,1,226694,226695,226696,1,2,0
64736,4,3,226698,226698,226701,0,3,2
64737,1,1,226699,226701,226702,2,3,0
64738,4,3,226703,226703,226706,0,3,1
64739,5,1,226708,226708,226709,0,1,2
64740,1,2,226709,226709,226711,0,2,0
64741,1,3,226710,226711,226714,1,4,0
64742,5,2,226715,226715,226717,0,2,1
64743,2,3,226717,226717,226720,0,3,0
64744,4,3,226721,226721,226724,0,3,1
64745,4,3,226725,226725,226728,0,3,1
64746,6,1,226731,226731,226732,0,1,3
64747,3,1,226734,226734,226735,0,1,2
64748,1,2,226735,226735,226737,0,2,0
64749,1,3,226736,226737,226740,1,4,0
64750,3,1,226739,226740,226741,1,2,0
64751,1,3,226740,226741,226744,1,4,0
64752,4,1,226744,226744,226745,0,1,0
64753,5,2,226749,226749,226751,0,2,4
64754,3,1,226752,226752,226753,0,1,1
64755,5,1,226757,226757,226758,0,1,4
64756,1,3,226758,226758,226761,0,3,0
64757,6,1,226764,226764,226765,0,1,3
64758,3,3,226767,226767,226770,0,3,2
64759,3,2,226770,226770,226772,0,2,0
64760,2,2,226772,226772,226774,0,2,0
64761,2,3,226774,226774,226777,0,3,0
64762,4,2,226778,226778,226780,0,2,1
64763,5,3,226783,226783,226786,0,3,3
64764,6,1,226789,226789,226790,0,1,3
64765,1,3,226790,226790,226793,0,3,0
64766,2,2,226792,226793,226795,1,3,0
64767,3,1,226795,226795,226796,0,1,0
64768,4,1,226799,226799,226800,0,1,3
64769,6,2,226805,226805,226807,0,2,5
64770,5,1,226810,226810,226811,0,1,3
64771,5,2,226815,226815,226817,0,2,4
64772,3,3,226818,226818,226821,0,3,1
64773,3,1,226821,226821,226822,0,1,0
64774,6,1,226827,226827,226828,0,1,5
64775,4,2,226831,226831,226833,0,2,3
64776,3,2,226834,226834,226836,0,2,1
64777,1,1,226835,226836,226837,1,2,0
64778,6,1,226841,226841,226842,0,1,4
64779,1,2,226842,226842,226844,0,2,0
64780,6,3,226848,226848,226851,0,3,4
64781,1,2,226849,226851,226853,2,4,0
64782,6,1,226855,226855,226856,0,1,2
64783,4,1,226859,226859,226860,0,1,3
64784,1,2,226860,226860,226862,0,2,0
64785,4,2,226864,226864,226866,0,2,2
64786,4,2,226868,226868,226870,0,2,2
64787,2,1,226870,226870,226871,0,1,0
64788,1,3,226871,226871,226874,0,3,0
64789,2,3,226873,226874,226877,1,4,0
64790,4,3,226877,226877,226880,0,3,0
64791,3,1,226880,226880,226881,0,1,0
64792,4,2,226884,226884,226886,0,2,3
64793,5,3,226889,226889,226892,0,3,3
64794,5,1,226894,226894,226895,0,1,2
64795,5,2,226899,226899,226901,0,2,4
64796,4,1,226903,226903,226904,0,1,2
64797,2,2,226905,226905,226907,0,2,1
64798,1,3,226906,226907,226910,1,4,0
64799,1,3,226907,226910,226913,3,6,0
64800,5,1,226912,226913,226914,1,2,0
64801,4,1,226916,226916,226917,0,1,2
64802,1,2,226917,226917,226919,0,2,0
64803,4,2,226921,226921,226923,0,2,2
64804,5,1,226926,226926,226927,0,1,3
64805,4,2,226930,226930,226932,0,2,3
64806,6,1,226936,226936,226937,0,1,4
64807,2,1,226938,226938,226939,0,1,1
64808,3,2,226941,226941,226943,0,2,2
64809,2,2,226943,226943,226945,0,2,0
64810,1,3,226944,226945,226948,1,4,0
64811,2,1,226946,226948,226949,2,3,0
64812,1,1,226947,226949,226950,2,3,0
64813,3,2,226950,226950,226952,0,2,0
64814,2,2,226952,226952,226954,0,2,0
64815,4,3,226956,226956,226959,0,3,2
64816,3,2,226959,226959,226961,0,2,0
64817,5,1,226964,226964,226965,0,1,3
64818,5,1,226969,226969,226970,0,1,4
64819,5,1,226974,226974,226975,0,1,4
64820,6,2,226980,226980,226982,0,2,5
64821,6,3,226986,226986,226989,0,3,4
64822,6,2,226992,226992,226994,0,2,3
64823,4,1,226996,226996,226997,0,1,2
64824,6,1,227002,227002,227003,0,1,5
64825,1,3,227003,227003,227006,0,3,0
64826,6,3,227009,227009,227012,0,3,3
64827,6,3,227015,227015,227018,0,3,3
64828,4,2,227019,227019,227021,0,2,1
64829,2,3,227021,227021,227024,0,3,0
64830,5,3,227026,227026,227029,0,3,2
64831,4,3,227030,227030,227033,0,3,1
64832,1,3,227031,227033,227036,2,5,0
64833,4,1,227035,227036,227037,1,2,0
64834,5,2,227040,227040,227042,0,2,3
64835,2,3,227042,227042,227045,0,3,0
64836,5,2,227047,227047,227049,0,2,2
64837,4,2,227051,227051,227053,0,2,2
64838,6,3,227057,227057,227060,0,3,4
64839,1,3,227058,227060,227063,2,5,0
64840,4,3,227062,227063,227066,1,4,0
64841,3,2,227065,227066,227068,1,3,0
64842,6,2,227071,227071,227073,0,2,3
64843,1,3,227072,227073,227076,1,4,0
64844,1,2,227073,227076,227078,3,5,0
64845,1,3,227074,227078,227081,4,7,0
64846,5,1,227079,227081,227082,2,3,0
64847,4,1,227083,227083,227084,0,1,1
64848,5,2,227088,227088,227090,0,2,4
64849,3,2,227091,227091,227093,0,2,1
64850,4,3,227095,227095,227098,0,3,2
64851,4,3,227099,227099,227102,0,3,1
64852,2,1,227101,227102,227103,1,2,0
64853,3,3,227104,227104,227107,0,3,1
64854,4,1,227108,227108,227109,0,1,1
64855,3,1,227111,227111,227112,0,1,2
64856,2,2,227113,227113,227115,0,2,1
64857,1,1,227114,227115,227116,1,2,0
64858,4,2,227118,227118,227120,0,2,2
64859,5,3,227123,227123,227126,0,3,3
64860,1,2,227124,227126,227128,2,4,0
64861,1,1,227125,227128,227129,3,4,0
64862,6,2,227131,227131,227133,0,2,2
64863,1,1,227132,227133,227134,1,2,0
64864,4,1,227136,227136,227137,0,1,2
64865,3,2,227139,227139,227141,0,2,2
64866,3,1,227142,227142,227143,0,1,1
64867,1,1,227143,227143,227144,0,1,0
64868,6,3,227149,227149,227152,0,3,5
64869,3,1,227152,227152,227153,0,1,0
64870,2,3,227154,227154,227157,0,3,1
64871,6,1,227160,227160,227161,0,1,3
64872,3,2,227163,227163,227165,0,2,2
64873,2,1,227165,227165,227166,0,1,0
64874,3,3,227168,227168,227171,0,3,2
64875,1,3,227169,227171,227174,2,5,0
64876,3,1,227172,227174,227175,2,3,0
64877,1,1,227173,227175,227176,2,3,0
64878,1,1,227174,227176,227177,2,3,0
64879,4,2,227178,227178,227180,0,2,1
64880,3,2,227181,227181,227183,0,2,1
64881,2,1,227183,227183,227184,0,1,0
64882,4,2,227187,227187,227189,0,2,3
64883,4,1,227191,227191,227192,0,1,2
64884,6,3,227197,227197,227200,0,3,5
64885,5,3,227202,227202,227205,0,3,2
64886,4,1,227206,227206,227207,0,1,1
64887,6,2,227212,227212,227214,0,2,5
64888,3,3,227215,227215,227218,0,3,1
64889,3,1,227218,227218,227219,0,1,0
64890,6,3,227224,227224,227227,0,3,5
64891,4,3,227228,227228,227231,0,3,1
64892,4,3,227232,227232,227235,0,3,1
64893,6,1,227238,227238,227239,0,1,3
64894,6,1,227244,227244,227245,0,1,5
64895,6,3,227250,227250,227253,0,3,5
64896,5,1,227255,227255,227256,0,1,2
64897,2,2,227257,227257,227259,0,2,1
64898,1,3,227258,227259,227262,1,4,0
64899,4,2,227262,227262,227264,0,2,0
64900,2,2,227264,227264,227266,0,2,0
64901,6,3,227270,227270,227273,0,3,4
64902,2,2,227272,227273,227275,1,3,0
64903,3,2,227275,227275,227277,0,2,0
64904,3,1,227278,227278,227279,0,1,1
64905,6,2,227284,227284,227286,0,2,5
64906,2,3,227286,227286,227289,0,3,0
64907,3,2,227289,227289,227291,0,2,0
64908,5,1,227294,227294,227295,0,1,3
64909,1,2,227295,227295,227297,0,2,0
64910,4,1,227299,227299,227300,0,1,2
64911,3,2,227302,227302,227304,0,2,2
64912,6,2,227308,227308,227310,0,2,4
64913,3,3,227311,227311,227314,0,3,1
64914,3,3,227314,227314,227317,0,3,0
64915,6,3,227320,227320,227323,0,3,3
64916,6,1,227326,227326,227327,0,1,3
64917,6,1,227332,227332,227333,0,1,5
64918,6,3,227338,227338,227341,0,3,5
64919,3,2,227341,227341,227343,0,2,0
64920,1,1,227342,227343,227344,1,2,0
64921,5,1,227347,227347,227348,0,1,3
64922,5,2,227352,227352,227354,0,2,4
64923,5,1,227357,227357,227358,0,1,3
64924,4,2,227361,227361,227363,0,2,3
64925,1,2,227362,227363,227365,1,3,0
64926,2,3,227364,227365,227368,1,4,0
64927,4,2,227368,227368,227370,0,2,0
64928,5,1,227373,227373,227374,0,1,3
64929,6,2,227379,227379,227381,0,2,5
64930,2,3,227381,227381,227384,0,3,0
64931,4,2,227385,227385,227387,0,2,1
64932,3,1,227388,227388,227389,0,1,1
64933,2,2,227390,227390,227392,0,2,1
64934,2,3,227392,227392,227395,0,3,0
64935,2,3,227394,227395,227398,1,4,0
64936,5,1,227399,227399,227400,0,1,1
64937,3,2,227402,227402,227404,0,2,2
64938,1,1,227403,227404,227405,1,2,0
64939,3,3,227406,227406,227409,0,3,1
64940,6,1,227412,227412,227413,0,1,3
64941,5,1,227417,227417,227418,0,1,4
64942,5,3,227422,227422,227425,0,3,4
64943,5,2,227427,227427,227429,0,2,2
64944,3,1,227430,227430,227431,0,1,1
64945,3,3,227433,227433,227436,0,3,2
64946,2,1,227435,227436,227437,1,2,0
64947,4,3,227439,227439,227442,0,3,2
64948,5,1,227444,227444,227445,0,1,2
64949,3,1,227447,227447,227448,0,1,2
64950,2,2,227449,227449,227451,0,2,1
64951,2,1,227451,227451,227452,0,1,0
64952,2,1,227453,227453,227454,0,1,1
64953,5,1,227458,227458,227459,0,1,4
64954,5,1,227463,227463,227464,0,1,4
64955,5,2,227468,227468,227470,0,2,4
64956,3,1,227471,227471,227472,0,1,1
64957,6,3,227477,227477,227480,0,3,5
64958,3,2,227480,227480,227482,0,2,0
64959,3,3,227483,227483,227486,0,3,1
64960,4,3,227487,227487,227490,0,3,1
64961,4,2,227491,227491,227493,0,2,1
64962,3,2,227494,227494,227496,0,2,1
64963,3,2,227497,227497,227499,0,2,1
64964,4,2,227501,227501,227503,0,2,2
64965,2,2,227503,227503,227505,0,2,0
64966,5,2,227508,227508,227510,0,2,3
64967,4,3,227512,227512,227515,0,3,2
64968,6,2,227518,227518,227520,0,2,3
64969,3,1,227521,227521,227522,0,1,1
64970,6,2,227527,227527,227529,0,2,5
64971,6,2,227533,227533,227535,0,2,4
64972,5,2,227538,227538,227540,0,2,3
64973,5,2,227543,227543,227545,0,2,3
64974,5,2,227548,227548,227550,0,2,3
64975,3,3,227551,227551,227554,0,3,1
64976,1,2,227552,227554,227556,2,4,0
64977,3,3,227555,227556,227559,1,4,0
64978,1,2,227556,227559,227561,3,5,0
64979,1,1,227557,227561,227562,4,5,0
64980,4,2,227561,227562,227564,1,3,0
64981,1,3,227562,227564,227567,2,5,0
64982,3,1,227565,227567,227568,2,3,0
64983,3,3,227568,227568,227571,0,3,0
64984,5,2,227573,227573,227575,0,2,2
64985,3,2,227576,227576,227578,0,2,1
64986,4,2,227580,227580,227582,0,2,2
64987,3,1,227583,227583,227584,0,1,1
64988,1,3,227584,227584,227587,0,3,0
64989,2,1,227586,227587,227588,1,2,0
64990,5,3,227591,227591,227594,0,3,3
64991,1,3,227592,227594,227597,2,5,0
64992,4,3,227596,227597,227600,1,4,0
64993,6,2,227602,227602,227604,0,2,2
64994,4,3,227606,227606,227609,0,3,2
64995,4,1,227610,227610,227611,0,1,1
64996,5,2,227615,227615,227617,0,2,4
64997,4,2,227619,227619,227621,0,2,2
64998,2,2,227621,227621,227623,0,2,0
64999,1,1,227622,227623,227624,1,2,0
65000,2,1,227624,227624,227625,0,1,0
65001,1,3,227625,227625,227628,0,3,0
65002,4,3,227629,227629,227632,0,3,1
65003,2,2,227631,227632,227634,1,3,0
65004,5,3,227636,227636,227639,0,3,2
65005,4,2,227640,227640,227642,0,2,1
65006,5,1,227645,227645,227646,0,1,3
65007,5,2,227650,227650,227652,0,2,4
65008,5,1,227655,227655,227656,0,1,3
65009,4,2,227659,227659,227661,0,2,3
65010,2,1,227661,227661,227662,0,1,0
65011,5,3,227666,227666,227669,0,3,4
65012,2,1,227668,227669,227670,1,2,0
65013,6,3,227674,227674,227677,0,3,4
65014,4,1,227678,227678,227679,0,1,1
65015,6,1,227684,227684,227685,0,1,5
65016,1,3,227685,227685,227688,0,3,0
65017,2,2,227687,227688,227690,1,3,0
65018,1,1,227688,227690,227691,2,3,0
65019,3,1,227691,227691,227692,0,1,0
65020,1,2,227692,227692,227694,0,2,0
65021,4,1,227696,227696,227697,0,1,2
65022,4,2,227700,227700,227702,0,2,3
65023,6,1,227706,227706,227707,0,1,4
65024,2,1,227708,227708,227709,0,1,1
65025,3,3,227711,227711,227714,0,3,2
65026,5,3,227716,227716,227719,0,3,2
65027,3,1,227719,227719,227720,0,1,0
65028,2,3,227721,227721,227724,0,3,1
65029,2,2,227723,227724,227726,1,3,0
65030,1,3,227724,227726,227729,2,5,0
65031,3,1,227727,227729,227730,2,3,0
65032,6,3,227733,227733,227736,0,3,3
65033,6,3,227739,227739,227742,0,3,3
65034,1,2,227740,227742,227744,2,4,0
65035,2,2,227742,227744,227746,2,4,0
65036,2,2,227744,227746,227748,2,4,0
65037,2,1,227746,227748,227749,2,3,0
65038,2,2,227748,227749,227751,1,3,0
65039,1,2,227749,227751,227753,2,4,0
65040,1,1,227750,227753,227754,3,4,0
65041,1,2,227751,227754,227756,3,5,0
65042,1,3,227752,227756,227759,4,7,0
65043,4,3,227756,227759,227762,3,6,0
65044,2,3,227758,227762,227765,4,7,0
65045,2,2,227760,227765,227767,5,7,0
65046,3,3,227763,227767,227770,4,7,0
65047,3,1,227766,227770,227771,4,5,0
65048,5,3,227771,227771,227774,0,3,0
65049,5,3,227776,227776,227779,0,3,2
65050,5,1,227781,227781,227782,0,1,2
65051,6,1,227787,227787,227788,0,1,5
65052,2,2,227789,227789,227791,0,2,1
65053,2,2,227791,227791,227793,0,2,0
65054,2,3,227793,227793,227796,0,3,0
65055,4,2,227797,227797,227799,0,2,1
65056,4,1,227801,227801,227802,0,1,2
65057,2,1,227803,227803,227804,0,1,1
65058,2,1,227805,227805,227806,0,1,1
65059,1,2,227806,227806,227808,0,2,0
65060,4,2,227810,227810,227812,0,2,2
65061,5,2,227815,227815,227817,0,2,3
65062,6,3,227821,227821,227824,0,3,4
65063,2,2,227823,227824,227826,1,3,0
65064,4,1,227827,227827,227828,0,1,1
65065,6,3,227833,227833,227836,0,3,5
65066,2,3,227835,227836,227839,1,4,0
65067,1,1,227836,227839,227840,3,4,0
65068,3,2,227839,227840,227842,1,3,0
65069,3,1,227842,227842,227843,0,1,0
65070,2,3,227844,227844,227847,0,3,1
65071,6,3,227850,227850,227853,0,3,3
65072,5,1,227855,227855,227856,0,1,2
65073,3,1,227858,227858,227859,0,1,2
65074,2,2,227860,227860,227862,0,2,1
65075,4,2,227864,227864,227866,0,2,2
65076,3,2,227867,227867,227869,0,2,1
65077,2,2,227869,227869,227871,0,2,0
65078,1,1,227870,227871,227872,1,2,0
65079,3,2,227873,227873,227875,0,2,1
65080,6,1,227879,227879,227880,0,1,4
65081,2,1,227881,227881,227882,0,1,1
65082,6,1,227887,227887,227888,0,1,5
65083,4,2,227891,227891,227893,0,2,3
65084,6,1,227897,227897,227898,0,1,4
65085,6,1,227903,227903,227904,0,1,5
65086,1,1,227904,227904,227905,0,1,0
65087,6,3,227910,227910,227913,0,3,5
65088,4,1,227914,227914,227915,0,1,1
65089,5,3,227919,227919,227922,0,3,4
65090,3,3,227922,227922,227925,0,3,0
65091,5,3,227927,227927,227930,0,3,2
65092,1,2,227928,227930,227932,2,4,0
65093,2,1,227930,227932,227933,2,3,0
65094,2,3,227932,227933,227936,1,4,0
65095,5,3,227937,227937,227940,0,3,1
65096,4,2,227941,227941,227943,0,2,1
65097,5,2,227946,227946,227948,0,2,3
65098,1,2,227947,227948,227950,1,3,0
65099,4,1,227951,227951,227952,0,1,1
65100,1,2,227952,227952,227954,0,2,0
65101,4,1,227956,227956,227957,0,1,2
65102,3,3,227959,227959,227962,0,3,2
65103,1,2,227960,227962,227964,2,4,0
65104,6,3,227966,227966,227969,0,3,2
65105,6,1,227972,227972,227973,0,1,3
65106,5,1,227977,227977,227978,0,1,4
65107,4,1,227981,227981,227982,0,1,3
65108,2,1,227983,227983,227984,0,1,1
65109,4,3,227987,227987,227990,0,3,3
65110,6,1,227993,227993,227994,0,1,3
65111,2,3,227995,227995,227998,0,3,1
65112,6,3,228001,228001,228004,0,3,3
65113,1,1,228002,228004,228005,2,3,0
65114,2,2,228004,228005,228007,1,3,0
65115,1,2,228005,228007,228009,2,4,0
65116,3,1,228008,228009,228010,1,2,0
65117,1,1,228009,228010,228011,1,2,0
65118,4,2,228013,228013,228015,0,2,2
65119,2,1,228015,228015,228016,0,1,0
65120,4,3,228019,228019,228022,0,3,3
65121,4,2,228023,228023,228025,0,2,1
65122,5,2,228028,228028,228030,0,2,3
65123,3,2,228031,228031,228033,0,2,1
65124,3,3,228034,228034,228037,0,3,1
65125,5,3,228039,228039,228042,0,3,2
65126,2,3,228041,228042,228045,1,4,0
65127,5,2,228046,228046,228048,0,2,1
65128,3,1,228049,228049,228050,0,1,1
65129,2,2,228051,228051,228053,0,2,1
65130,6,3,228057,228057,228060,0,3,4
65131,2,1,228059,228060,228061,1,2,0
65132,3,1,228062,228062,228063,0,1,1
65133,2,3,228064,228064,228067,0,3,1
65134,2,3,228066,228067,228070,1,4,0
65135,5,1,228071,228071,228072,0,1,1
65136,2,3,228073,228073,228076,0,3,1
65137,4,1,228077,228077,228078,0,1,1
65138,1,1,228078,228078,228079,0,1,0
65139,4,1,228082,228082,228083,0,1,3
65140,3,2,228085,228085,228087,0,2,2
65141,2,2,228087,228087,228089,0,2,0
65142,5,1,228092,228092,228093,0,1,3
65143,4,2,228096,228096,228098,0,2,3
65144,6,2,228102,228102,228104,0,2,4
65145,1,3,228103,228104,228107,1,4,0
65146,5,2,228108,228108,228110,0,2,1
65147,1,1,228109,228110,228111,1,2,0
65148,5,1,228114,228114,228115,0,1,3
65149,4,1,228118,228118,228119,0,1,3
65150,1,3,228119,228119,228122,0,3,0
65151,3,1,228122,228122,228123,0,1,0
65152,3,3,228125,228125,228128,0,3,2
65153,4,3,228129,228129,228132,0,3,1
65154,6,2,228135,228135,228137,0,2,3
65155,3,2,228138,228138,228140,0,2,1
65156,5,3,228143,228143,228146,0,3,3
65157,1,3,228144,228146,228149,2,5,0
65158,2,3,228146,228149,228152,3,6,0
65159,5,3,228151,228152,228155,1,4,0
65160,3,2,228154,228155,228157,1,3,0
65161,2,3,228156,228157,228160,1,4,0
65162,5,2,228161,228161,228163,0,2,1
65163,1,1,228162,228163,228164,1,2,0
65164,6,1,228168,228168,228169,0,1,4
65165,1,2,228169,228169,228171,0,2,0
65166,5,2,228174,228174,228176,0,2,3
65167,3,3,228177,228177,228180,0,3,1
65168,6,2,228183,228183,228185,0,2,3
65169,6,1,228189,228189,228190,0,1,4
65170,4,2,228193,228193,228195,0,2,3
65171,4,1,228197,228197,228198,0,1,2
65172,6,1,228203,228203,228204,0,1,5
65173,3,3,228206,228206,228209,0,3,2
65174,4,1,228210,228210,228211,0,1,1
65175,4,3,228214,228214,228217,0,3,3
65176,1,3,228215,228217,228220,2,5,0
65177,6,2,228221,228221,228223,0,2,1
65178,3,3,228224,228224,228227,0,3,1
65179,2,3,228226,228227,228230,1,4,0
65180,4,1,228230,228230,228231,0,1,0
65181,4,3,228234,228234,228237,0,3,3
65182,2,3,228236,228237,228240,1,4,0
65183,5,1,228241,228241,228242,0,1,1
65184,3,2,228244,228244,228246,0,2,2
65185,2,2,228246,228246,228248,0,2,0
65186,3,1,228249,228249,228250,0,1,1
65187,6,1,228255,228255,228256,0,1,5
65188,2,2,228257,228257,228259,0,2,1
65189,1,1,228258,228259,228260,1,2,0
65190,3,1,228261,228261,228262,0,1,1
65191,4,1,228265,228265,228266,0,1,3
65192,4,1,228269,228269,228270,0,1,3
65193,3,3,228272,228272,228275,0,3,2
65194,6,1,228278,228278,228279,0,1,3
65195,2,2,228280,228280,228282,0,2,1
65196,3,2,228283,228283,228285,0,2,1
65197,4,3,228287,228287,228290,0,3,2
65198,5,2,228292,228292,228294,0,2,2
65199,5,1,228297,228297,228298,0,1,3
65200,3,3,228300,228300,228303,0,3,2
65201,4,3,228304,228304,228307,0,3,1
65202,4,3,228308,228308,228311,0,3,1
65203,6,2,228314,228314,228316,0,2,3
65204,4,2,228318,228318,228320,0,2,2
65205,2,3,228320,228320,228323,0,3,0
65206,6,1,228326,228326,228327,0,1,3
65207,4,3,228330,228330,228333,0,3,3
65208,3,1,228333,228333,228334,0,1,0
65209,2,1,228335,228335,228336,0,1,1
65210,1,3,228336,228336,228339,0,3,0
65211,5,2,228341,228341,228343,0,2,2
65212,2,1,228343,228343,228344,0,1,0
65213,2,3,228345,228345,228348,0,3,1
65214,2,2,228347,228348,228350,1,3,0
65215,6,2,228353,228353,228355,0,2,3
65216,2,3,228355,228355,228358,0,3,0
65217,5,2,228360,228360,228362,0,2,2
65218,2,2,228362,228362,228364,0,2,0
65219,3,3,228365,228365,228368,0,3,1
65220,6,2,228371,228371,228373,0,2,3
65221,1,3,228372,228373,228376,1,4,0
65222,6,1,228378,228378,228379,0,1,2
65223,1,1,228379,228379,228380,0,1,0
65224,6,1,228385,228385,228386,0,1,5
65225,4,1,228389,228389,228390,0,1,3
65226,6,2,228395,228395,228397,0,2,5
65227,1,1,228396,228397,228398,1,2,0
65228,4,3,228400,228400,228403,0,3,2
65229,1,3,228401,228403,228406,2,5,0
65230,6,3,228407,228407,228410,0,3,1
65231,5,2,228412,228412,228414,0,2,2
65232,2,3,228414,228414,228417,0,3,0
65233,3,3,228417,228417,228420,0,3,0
65234,6,2,228423,228423,228425,0,2,3
65235,1,1,228424,228425,228426,1,2,0
65236,5,1,228429,228429,228430,0,1,3
65237,4,3,228433,228433,228436,0,3,3
65238,6,1,228439,228439,228440,0,1,3
65239,2,3,228441,228441,228444,0,3,1
65240,4,1,228445,228445,228446,0,1,1
65241,6,2,228451,228451,228453,0,2,5
65242,2,2,228453,228453,228455,0,2,0
65243,3,2,228456,228456,228458,0,2,1
65244,2,3,228458,228458,228461,0,3,0
65245,3,3,228461,228461,228464,0,3,0
65246,3,3,228464,228464,228467,0,3,0
65247,2,3,228466,228467,228470,1,4,0
65248,6,2,228472,228472,228474,0,2,2
65249,6,3,228478,228478,228481,0,3,4
65250,5,2,228483,228483,228485,0,2,2
65251,4,3,228487,228487,228490,0,3,2
65252,1,1,228488,228490,228491,2,3,0
65253,6,3,228494,228494,228497,0,3,3
65254,3,3,228497,228497,228500,0,3,0
65255,5,1,228502,228502,228503,0,1,2
65256,3,3,228505,228505,228508,0,3,2
65257,1,2,228506,228508,228510,2,4,0
65258,3,1,228509,228510,228511,1,2,0
65259,3,1,228512,228512,228513,0,1,1
65260,2,2,228514,228514,228516,0,2,1
65261,1,1,228515,228516,228517,1,2,0
65262,1,3,228516,228517,228520,1,4,0
65263,5,3,228521,228521,228524,0,3,1
65264,6,3,228527,228527,228530,0,3,3
65265,1,1,228528,228530,228531,2,3,0
65266,6,2,228534,228534,228536,0,2,3
65267,5,2,228539,228539,228541,0,2,3
65268,1,1,228540,228541,228542,1,2,0
65269,3,1,228543,228543,228544,0,1,1
65270,4,2,228547,228547,228549,0,2,3
65271,4,2,228551,228551,228553,0,2,2
65272,4,2,228555,228555,228557,0,2,2
65273,5,1,228560,228560,228561,0,1,3
65274,5,1,228565,228565,228566,0,1,4
65275,6,2,228571,228571,228573,0,2,5
65276,3,1,228574,228574,228575,0,1,1
65277,1,3,228575,228575,228578,0,3,0
65278,3,2,228578,228578,228580,0,2,0
65279,5,3,228583,228583,228586,0,3,3
65280,6,1,228589,228589,228590,0,1,3
65281,4,3,228593,228593,228596,0,3,3
65282,2,3,228595,228596,228599,1,4,0
65283,4,2,228599,228599,228601,0,2,0
65284,4,3,228603,228603,228606,0,3,2
65285,4,3,228607,228607,228610,0,3,1
65286,6,1,228613,228613,228614,0,1,3
65287,6,3,228619,228619,228622,0,3,5
65288,5,3,228624,228624,228627,0,3,2
65289,2,1,228626,228627,228628,1,2,0
65290,3,1,228629,228629,228630,0,1,1
65291,5,3,228634,228634,228637,0,3,4
65292,3,2,228637,228637,228639,0,2,0
65293,4,1,228641,228641,228642,0,1,2
65294,6,3,228647,228647,228650,0,3,5
65295,6,3,228653,228653,228656,0,3,3
65296,1,1,228654,228656,228657,2,3,0
65297,3,3,228657,228657,228660,0,3,0
65298,4,3,228661,228661,228664,0,3,1
65299,3,2,228664,228664,228666,0,2,0
65300,6,1,228670,228670,228671,0,1,4
65301,3,1,228673,228673,228674,0,1,2
65302,6,3,228679,228679,228682,0,3,5
65303,3,1,228682,228682,228683,0,1,0
65304,2,3,228684,228684,228687,0,3,1
65305,4,2,228688,228688,228690,0,2,1
65306,1,2,228689,228690,228692,1,3,0
65307,4,1,228693,228693,228694,0,1,1
65308,6,3,228699,228699,228702,0,3,5
65309,6,1,228705,228705,228706,0,1,3
65310,1,3,228706,228706,228709,0,3,0
65311,5,2,228711,228711,228713,0,2,2
65312,3,2,228714,228714,228716,0,2,1
65313,3,2,228717,228717,228719,0,2,1
65314,5,2,228722,228722,228724,0,2,3
65315,6,1,228728,228728,228729,0,1,4
65316,3,1,228731,228731,228732,0,1,2
65317,5,1,228736,228736,228737,0,1,4
65318,3,2,228739,228739,228741,0,2,2
65319,6,1,228745,228745,228746,0,1,4
65320,4,1,228749,228749,228750,0,1,3
65321,6,2,228755,228755,228757,0,2,5
65322,1,2,228756,228757,228759,1,3,0
65323,6,3,228762,228762,228765,0,3,3
65324,3,2,228765,228765,228767,0,2,0
65325,6,1,228771,228771,228772,0,1,4
65326,3,2,228774,228774,228776,0,2,2
65327,2,2,228776,228776,228778,0,2,0
65328,6,3,228782,228782,228785,0,3,4
65329,1,2,228783,228785,228787,2,4,0
65330,4,3,228787,228787,228790,0,3,0
65331,1,1,228788,228790,228791,2,3,0
65332,3,1,228791,228791,228792,0,1,0
65333,1,1,228792,228792,228793,0,1,0
65334,3,2,228795,228795,228797,0,2,2
65335,1,1,228796,228797,228798,1,2,0
65336,6,1,228802,228802,228803,0,1,4
65337,2,2,228804,228804,228806,0,2,1
65338,6,2,228810,228810,228812,0,2,4
65339,2,3,228812,228812,228815,0,3,0
65340,4,3,228816,228816,228819,0,3,1
65341,3,3,228819,228819,228822,0,3,0
65342,5,1,228824,228824,228825,0,1,2
65343,6,2,228830,228830,228832,0,2,5
65344,3,2,228833,228833,228835,0,2,1
65345,4,2,228837,228837,228839,0,2,2
65346,3,3,228840,228840,228843,0,3,1
65347,4,1,228844,228844,228845,0,1,1
65348,2,2,228846,228846,228848,0,2,1
65349,6,2,228852,228852,228854,0,2,4
65350,3,2,228855,228855,228857,0,2,1
65351,5,3,228860,228860,228863,0,3,3
65352,4,3,228864,228864,228867,0,3,1
65353,4,1,228868,228868,228869,0,1,1
65354,1,2,228869,228869,228871,0,2,0
65355,2,1,228871,228871,228872,0,1,0
65356,6,3,228877,228877,228880,0,3,5
65357,5,2,228882,228882,228884,0,2,2
65358,4,1,228886,228886,228887,0,1,2
65359,3,2,228889,228889,228891,0,2,2
65360,5,1,228894,228894,228895,0,1,3
65361,5,2,228899,228899,228901,0,2,4
65362,6,2,228905,228905,228907,0,2,4
65363,6,1,228911,228911,228912,0,1,4
65364,2,3,228913,228913,228916,0,3,1
65365,5,3,228918,228918,228921,0,3,2
65366,4,3,228922,228922,228925,0,3,1
65367,1,1,228923,228925,228926,2,3,0
65368,5,3,228928,228928,228931,0,3,2
65369,4,3,228932,228932,228935,0,3,1
65370,1,3,228933,228935,228938,2,5,0
65371,6,3,228939,228939,228942,0,3,1
65372,3,3,228942,228942,228945,0,3,0
65373,3,2,228945,228945,228947,0,2,0
65374,4,2,228949,228949,228951,0,2,2
65375,6,2,228955,228955,228957,0,2,4
65376,5,3,228960,228960,228963,0,3,3
65377,1,1,228961,228963,228964,2,3,0
65378,3,2,228964,228964,228966,0,2,0
65379,3,2,228967,228967,228969,0,2,1
65380,2,3,228969,228969,228972,0,3,0
65381,3,2,228972,228972,228974,0,2,0
65382,3,1,228975,228975,228976,0,1,1
65383,1,1,228976,228976,228977,0,1,0
65384,2,1,228978,228978,228979,0,1,1
65385,6,3,228984,228984,228987,0,3,5
65386,5,1,228989,228989,228990,0,1,2
65387,4,1,228993,228993,228994,0,1,3
65388,4,1,228997,228997,228998,0,1,3
65389,1,1,228998,228998,228999,0,1,0
65390,5,1,229003,229003,229004,0,1,4
65391,1,1,229004,229004,229005,0,1,0
65392,5,3,229009,229009,229012,0,3,4
65393,1,2,229010,229012,229014,2,4,0
65394,4,2,229014,229014,229016,0,2,0
65395,4,2,229018,229018,229020,0,2,2
65396,5,3,229023,229023,229026,0,3,3
65397,5,1,229028,229028,229029,0,1,2
65398,5,3,229033,229033,229036,0,3,4
65399,2,3,229035,229036,229039,1,4,0
65400,6,3,229041,229041,229044,0,3,2
65401,2,3,229043,229044,229047,1,4,0
65402,1,2,229044,229047,229049,3,5,0
65403,2,2,229046,229049,229051,3,5,0
65404,2,2,229048,229051,229053,3,5,0
65405,1,2,229049,229053,229055,4,6,0
65406,2,2,229051,229055,229057,4,6,0
65407,5,3,229056,229057,229060,1,4,0
65408,5,1,229061,229061,229062,0,1,1
65409,2,1,229063,229063,229064,0,1,1
65410,3,3,229066,229066,229069,0,3,2
65411,1,1,229067,229069,229070,2,3,0
65412,6,3,229073,229073,229076,0,3,3
65413,5,3,229078,229078,229081,0,3,2
65414,6,1,229084,229084,229085,0,1,3
65415,2,3,229086,229086,229089,0,3,1
65416,1,1,229087,229089,229090,2,3,0
65417,5,2,229092,229092,229094,0,2,2
65418,4,2,229096,229096,229098,0,2,2
65419,5,1,229101,229101,229102,0,1,3
65420,5,2,229106,229106,229108,0,2,4
65421,6,1,229112,229112,229113,0,1,4
65422,1,3,229113,229113,229116,0,3,0
65423,5,1,229118,229118,229119,0,1,2
65424,4,3,229122,229122,229125,0,3,3
65425,4,3,229126,229126,229129,0,3,1
65426,5,1,229131,229131,229132,0,1,2
65427,5,1,229136,229136,229137,0,1,4
65428,5,2,229141,229141,229143,0,2,4
65429,3,1,229144,229144,229145,0,1,1
65430,5,2,229149,229149,229151,0,2,4
65431,1,3,229150,229151,229154,1,4,0
65432,4,2,229154,229154,229156,0,2,0
65433,3,2,229157,229157,229159,0,2,1
65434,4,3,229161,229161,229164,0,3,2
65435,3,3,229164,229164,229167,0,3,0
65436,4,2,229168,229168,229170,0,2,1
65437,5,3,229173,229173,229176,0,3,3
65438,2,1,229175,229176,229177,1,2,0
65439,2,1,229177,229177,229178,0,1,0
65440,2,1,229179,229179,229180,0,1,1
65441,4,2,229183,229183,229185,0,2,3
65442,6,2,229189,229189,229191,0,2,4
65443,6,3,229195,229195,229198,0,3,4
65444,3,2,229198,229198,229200,0,2,0
65445,3,2,229201,229201,229203,0,2,1
65446,4,2,229205,229205,229207,0,2,2
65447,5,2,229210,229210,229212,0,2,3
65448,3,3,229213,229213,229216,0,3,1
65449,3,2,229216,229216,229218,0,2,0
65450,4,3,229220,229220,229223,0,3,2
65451,4,2,229224,229224,229226,0,2,1
65452,3,1,229227,229227,229228,0,1,1
65453,4,2,229231,229231,229233,0,2,3
65454,6,3,229237,229237,229240,0,3,4
65455,3,3,229240,229240,229243,0,3,0
65456,3,1,229243,229243,229244,0,1,0
65457,5,2,229248,229248,229250,0,2,4
65458,1,3,229249,229250,229253,1,4,0
65459,4,2,229253,229253,229255,0,2,0
65460,4,1,229257,229257,229258,0,1,2
65461,6,3,229263,229263,229266,0,3,5
65462,6,1,229269,229269,229270,0,1,3
65463,5,2,229274,229274,229276,0,2,4
65464,6,3,229280,229280,229283,0,3,4
65465,1,1,229281,229283,229284,2,3,0
65466,5,3,229286,229286,229289,0,3,2
65467,3,1,229289,229289,229290,0,1,0
65468,1,1,229290,229290,229291,0,1,0
65469,1,1,229291,229291,229292,0,1,0
65470,3,2,229294,229294,229296,0,2,2
65471,6,2,229300,229300,229302,0,2,4
65472,3,2,229303,229303,229305,0,2,1
65473,6,1,229309,229309,229310,0,1,4
65474,3,2,229312,229312,229314,0,2,2
65475,2,3,229314,229314,229317,0,3,0
65476,2,3,229316,229317,229320,1,4,0
65477,1,1,229317,229320,229321,3,4,0
65478,4,3,229321,229321,229324,0,3,0
65479,6,2,229327,229327,229329,0,2,3
65480,6,1,229333,229333,229334,0,1,4
65481,1,3,229334,229334,229337,0,3,0
65482,4,1,229338,229338,229339,0,1,1
65483,1,1,229339,229339,229340,0,1,0
65484,2,2,229341,229341,229343,0,2,1
65485,5,3,229346,229346,229349,0,3,3
65486,3,2,229349,229349,229351,0,2,0
65487,5,2,229354,229354,229356,0,2,3
65488,1,3,229355,229356,229359,1,4,0
65489,6,1,229361,229361,229362,0,1,2
65490,1,3,229362,229362,229365,0,3,0
65491,4,3,229366,229366,229369,0,3,1
65492,6,3,229372,229372,229375,0,3,3
65493,3,2,229375,229375,229377,0,2,0
65494,3,2,229378,229378,229380,0,2,1
65495,1,3,229379,229380,229383,1,4,0
65496,3,3,229382,229383,229386,1,4,0
65497,3,2,229385,229386,229388,1,3,0
65498,4,3,229389,229389,229392,0,3,1
65499,2,3,229391,229392,229395,1,4,0
65500,5,2,229396,229396,229398,0,2,1
65501,3,2,229399,229399,229401,0,2,1
65502,2,3,229401,229401,229404,0,3,0
65503,2,1,229403,229404,229405,1,2,0
65504,2,2,229405,229405,229407,0,2,0
65505,5,2,229410,229410,229412,0,2,3
65506,3,1,229413,229413,229414,0,1,1
65507,5,1,229418,229418,229419,0,1,4
65508,1,2,229419,229419,229421,0,2,0
65509,5,2,229424,229424,229426,0,2,3
65510,6,3,229430,229430,229433,0,3,4
65511,3,3,229433,229433,229436,0,3,0
65512,6,1,229439,229439,229440,0,1,3
65513,3,1,229442,229442,229443,0,1,2
65514,5,1,229447,229447,229448,0,1,4
65515,4,2,229451,229451,229453,0,2,3
65516,5,1,229456,229456,229457,0,1,3
65517,3,1,229459,229459,229460,0,1,2
65518,2,1,229461,229461,229462,0,1,1
65519,1,2,229462,229462,229464,0,2,0
65520,6,1,229468,229468,229469,0,1,4
65521,2,3,229470,229470,229473,0,3,1
65522,6,1,229476,229476,229477,0,1,3
65523,2,3,229478,229478,229481,0,3,1
65524,5,2,229483,229483,229485,0,2,2
65525,6,2,229489,229489,229491,0,2,4
65526,1,2,229490,229491,229493,1,3,0
65527,6,3,229496,229496,229499,0,3,3
65528,1,1,229497,229499,229500,2,3,0
65529,2,2,229499,229500,229502,1,3,0
65530,3,3,229502,229502,229505,0,3,0
65531,1,3,229503,229505,229508,2,5,0
65532,4,3,229507,229508,229511,1,4,0
65533,6,2,229513,229513,229515,0,2,2
65534,3,3,229516,229516,229519,0,3,1
65535,5,1,229521,229521,229522,0,1,2
65536,2,3,229523,229523,229526,0,3,1
65537,4,1,229527,229527,229528,0,1,1
65538,4,3,229531,229531,229534,0,3,3
65539,1,2,229532,229534,229536,2,4,0
65540,2,1,229534,229536,229537,2,3,0
65541,3,3,229537,229537,229540,0,3,0
65542,6,1,229543,229543,229544,0,1,3
65543,2,1,229545,229545,229546,0,1,1
65544,1,1,229546,229546,229547,0,1,0
65545,1,3,229547,229547,229550,0,3,0
65546,5,1,229552,229552,229553,0,1,2
65547,2,3,229554,229554,229557,0,3,1
65548,6,2,229560,229560,229562,0,2,3
65549,3,3,229563,229563,229566,0,3,1
65550,2,2,229565,229566,229568,1,3,0
65551,4,2,229569,229569,229571,0,2,1
65552,3,1,229572,229572,229573,0,1,1
65553,6,3,229578,229578,229581,0,3,5
65554,1,1,229579,229581,229582,2,3,0
65555,1,2,229580,229582,229584,2,4,0
65556,4,2,229584,229584,229586,0,2,0
65557,6,3,229590,229590,229593,0,3,4
65558,2,3,229592,229593,229596,1,4,0
65559,5,3,229597,229597,229600,0,3,1
65560,4,3,229601,229601,229604,0,3,1
65561,5,1,229606,229606,229607,0,1,2
65562,2,1,229608,229608,229609,0,1,1
65563,3,2,229611,229611,229613,0,2,2
65564,5,2,229616,229616,229618,0,2,3
65565,4,2,229620,229620,229622,0,2,2
65566,5,2,229625,229625,229627,0,2,3
65567,5,2,229630,229630,229632,0,2,3
65568,2,3,229632,229632,229635,0,3,0
65569,3,2,229635,229635,229637,0,2,0
65570,4,1,229639,229639,229640,0,1,2
65571,4,3,229643,229643,229646,0,3,3
65572,4,1,229647,229647,229648,0,1,1
65573,4,1,229651,229651,229652,0,1,3
65574,1,2,229652,229652,229654,0,2,0
65575,6,2,229658,229658,229660,0,2,4
65576,1,3,229659,229660,229663,1,4,0
65577,2,1,229661,229663,229664,2,3,0
65578,1,1,229662,229664,229665,2,3,0
65579,3,2,229665,229665,229667,0,2,0
65580,1,2,229666,229667,229669,1,3,0
65581,5,3,229671,229671,229674,0,3,2
65582,5,3,229676,229676,229679,0,3,2
65583,4,2,229680,229680,229682,0,2,1
65584,1,1,229681,229682,229683,1,2,0
65585,2,1,229683,229683,229684,0,1,0
65586,4,1,229687,229687,229688,0,1,3
65587,2,3,229689,229689,229692,0,3,1
65588,3,2,229692,229692,229694,0,2,0
65589,5,3,229697,229697,229700,0,3,3
65590,2,1,229699,229700,229701,1,2,0
65591,4,2,229703,229703,229705,0,2,2
65592,2,1,229705,229705,229706,0,1,0
65593,3,2,229708,229708,229710,0,2,2
65594,4,1,229712,229712,229713,0,1,2
65595,2,2,229714,229714,229716,0,2,1
65596,2,1,229716,229716,229717,0,1,0
65597,6,3,229722,229722,229725,0,3,5
65598,3,3,229725,229725,229728,0,3,0
65599,4,1,229729,229729,229730,0,1,1
65600,3,3,229732,229732,229735,0,3,2
65601,3,2,229735,229735,229737,0,2,0
65602,4,2,229739,229739,229741,0,2,2
65603,4,1,229743,229743,229744,0,1,2
65604,6,2,229749,229749,229751,0,2,5
65605,3,2,229752,229752,229754,0,2,1
65606,3,3,229755,229755,229758,0,3,1
65607,4,3,229759,229759,229762,0,3,1
65608,6,1,229765,229765,229766,0,1,3
65609,5,1,229770,229770,229771,0,1,4
65610,1,2,229771,229771,229773,0,2,0
65611,1,1,229772,229773,229774,1,2,0
65612,1,3,229773,229774,229777,1,4,0
65613,3,3,229776,229777,229780,1,4,0
65614,3,3,229779,229780,229783,1,4,0
65615,4,1,229783,229783,229784,0,1,0
65616,3,2,229786,229786,229788,0,2,2
65617,3,1,229789,229789,229790,0,1,1
65618,2,1,229791,229791,229792,0,1,1
65619,6,3,229797,229797,229800,0,3,5
65620,6,1,229803,229803,229804,0,1,3
65621,1,2,229804,229804,229806,0,2,0
65622,2,1,229806,229806,229807,0,1,0
65623,6,3,229812,229812,229815,0,3,5
65624,6,1,229818,229818,229819,0,1,3
65625,4,3,229822,229822,229825,0,3,3
65626,1,1,229823,229825,229826,2,3,0
65627,6,3,229829,229829,229832,0,3,3
65628,5,2,229834,229834,229836,0,2,2
65629,4,1,229838,229838,229839,0,1,2
65630,5,1,229843,229843,229844,0,1,4
65631,6,3,229849,229849,229852,0,3,5
65632,6,3,229855,229855,229858,0,3,3
65633,1,3,229856,229858,229861,2,5,0
65634,2,1,229858,229861,229862,3,4,0
65635,5,2,229863,229863,229865,0,2,1
65636,6,1,229869,229869,229870,0,1,4
65637,3,3,229872,229872,229875,0,3,2
65638,1,3,229873,229875,229878,2,5,0
65639,1,1,229874,229878,229879,4,5,0
65640,2,2,229876,229879,229881,3,5,0
65641,1,1,229877,229881,229882,4,5,0
65642,1,1,229878,229882,229883,4,5,0
65643,2,1,229880,229883,229884,3,4,0
65644,3,2,229883,229884,229886,1,3,0
65645,2,2,229885,229886,229888,1,3,0
65646,3,1,229888,229888,229889,0,1,0
65647,5,2,229893,229893,229895,0,2,4
65648,3,2,229896,229896,229898,0,2,1
65649,6,1,229902,229902,229903,0,1,4
65650,4,1,229906,229906,229907,0,1,3
65651,3,1,229909,229909,229910,0,1,2
65652,3,1,229912,229912,229913,0,1,2
65653,4,3,229916,229916,229919,0,3,3
65654,5,3,229921,229921,229924,0,3,2
65655,3,1,229924,229924,229925,0,1,0
65656,5,1,229929,229929,229930,0,1,4
65657,2,3,229931,229931,229934,0,3,1
65658,1,1,229932,229934,229935,2,3,0
65659,3,2,229935,229935,229937,0,2,0
65660,5,3,229940,229940,229943,0,3,3
65661,4,3,229944,229944,229947,0,3,1
65662,4,1,229948,229948,229949,0,1,1
65663,5,2,229953,229953,229955,0,2,4
65664,2,2,229955,229955,229957,0,2,0
65665,5,3,229960,229960,229963,0,3,3
65666,2,3,229962,229963,229966,1,4,0
65667,3,2,229965,229966,229968,1,3,0
65668,6,2,229971,229971,229973,0,2,3
65669,4,2,229975,229975,229977,0,2,2
65670,4,2,229979,229979,229981,0,2,2
65671,4,3,229983,229983,229986,0,3,2
65672,1,1,229984,229986,229987,2,3,0
65673,1,2,229985,229987,229989,2,4,0
65674,6,1,229991,229991,229992,0,1,2
65675,3,2,229994,229994,229996,0,2,2
65676,2,1,229996,229996,229997,0,1,0
65677,4,3,230000,230000,230003,0,3,3
65678,2,1,230002,230003,230004,1,2,0
65679,6,3,230008,230008,230011,0,3,4
65680,6,1,230014,230014,230015,0,1,3
65681,6,2,230020,230020,230022,0,2,5
65682,2,2,230022,230022,230024,0,2,0
65683,6,2,230028,230028,230030,0,2,4
65684,6,3,230034,230034,230037,0,3,4
65685,2,2,230036,230037,230039,1,3,0
65686,3,3,230039,230039,230042,0,3,0
65687,6,2,230045,230045,230047,0,2,3
65688,2,3,230047,230047,230050,0,3,0
65689,6,1,230053,230053,230054,0,1,3
65690,2,2,230055,230055,230057,0,2,1
65691,1,2,230056,230057,230059,1,3,0
65692,5,1,230061,230061,230062,0,1,2
65693,3,2,230064,230064,230066,0,2,2
65694,6,3,230070,230070,230073,0,3,4
65695,1,3,230071,230073,230076,2,5,0
65696,6,2,230077,230077,230079,0,2,1
65697,6,1,230083,230083,230084,0,1,4
65698,3,2,230086,230086,230088,0,2,2
65699,3,2,230089,230089,230091,0,2,1
65700,5,1,230094,230094,230095,0,1,3
65701,1,1,230095,230095,230096,0,1,0
65702,2,1,230097,230097,230098,0,1,1
65703,6,3,230103,230103,230106,0,3,5
65704,1,2,230104,230106,230108,2,4,0
65705,5,1,230109,230109,230110,0,1,1
65706,5,2,230114,230114,230116,0,2,4
65707,4,3,230118,230118,230121,0,3,2
65708,1,2,230119,230121,230123,2,4,0
65709,3,1,230122,230123,230124,1,2,0
65710,4,2,230126,230126,230128,0,2,2
65711,3,2,230129,230129,230131,0,2,1
65712,6,3,230135,230135,230138,0,3,4
65713,5,3,230140,230140,230143,0,3,2
65714,4,1,230144,230144,230145,0,1,1
65715,3,3,230147,230147,230150,0,3,2
65716,2,3,230149,230150,230153,1,4,0
65717,6,3,230155,230155,230158,0,3,2
65718,5,1,230160,230160,230161,0,1,2
65719,1,2,230161,230161,230163,0,2,0
65720,2,3,230163,230163,230166,0,3,0
65721,2,2,230165,230166,230168,1,3,0
65722,4,3,230169,230169,230172,0,3,1
65723,1,2,230170,230172,230174,2,4,0
65724,5,3,230175,230175,230178,0,3,1
65725,3,1,230178,230178,230179,0,1,0
65726,2,1,230180,230180,230181,0,1,1
65727,5,1,230185,230185,230186,0,1,4
65728,1,1,230186,230186,230187,0,1,0
65729,6,1,230192,230192,230193,0,1,5
65730,4,3,230196,230196,230199,0,3,3
65731,1,1,230197,230199,230200,2,3,0
65732,6,2,230203,230203,230205,0,2,3
65733,1,2,230204,230205,230207,1,3,0
65734,6,3,230210,230210,230213,0,3,3
65735,4,2,230214,230214,230216,0,2,1
65736,5,1,230219,230219,230220,0,1,3
65737,3,3,230222,230222,230225,0,3,2
65738,4,1,230226,230226,230227,0,1,1
65739,4,3,230230,230230,230233,0,3,3
65740,4,2,230234,230234,230236,0,2,1
65741,1,2,230235,230236,230238,1,3,0
65742,6,3,230241,230241,230244,0,3,3
65743,3,3,230244,230244,230247,0,3,0
65744,5,3,230249,230249,230252,0,3,2
65745,1,1,230250,230252,230253,2,3,0
65746,6,1,230256,230256,230257,0,1,3
65747,2,1,230258,230258,230259,0,1,1
65748,2,2,230260,230260,230262,0,2,1
65749,2,2,230262,230262,230264,0,2,0
65750,5,1,230267,230267,230268,0,1,3
65751,4,1,230271,230271,230272,0,1,3
65752,1,2,230272,230272,230274,0,2,0
65753,2,3,230274,230274,230277,0,3,0
65754,6,2,230280,230280,230282,0,2,3
65755,6,2,230286,230286,230288,0,2,4
65756,4,3,230290,230290,230293,0,3,2
65757,2,2,230292,230293,230295,1,3,0
65758,3,2,230295,230295,230297,0,2,0
65759,4,1,230299,230299,230300,0,1,2
65760,3,2,230302,230302,230304,0,2,2
65761,3,2,230305,230305,230307,0,2,1
65762,6,3,230311,230311,230314,0,3,4
65763,6,1,230317,230317,230318,0,1,3
65764,6,2,230323,230323,230325,0,2,5
65765,3,1,230326,230326,230327,0,1,1
65766,3,3,230329,230329,230332,0,3,2
65767,4,3,230333,230333,230336,0,3,1
65768,6,2,230339,230339,230341,0,2,3
65769,1,3,230340,230341,230344,1,4,0
65770,5,2,230345,230345,230347,0,2,1
65771,1,3,230346,230347,230350,1,4,0
65772,4,3,230350,230350,230353,0,3,0
65773,1,3,230351,230353,230356,2,5,0
65774,1,2,230352,230356,230358,4,6,0
65775,3,1,230355,230358,230359,3,4,0
65776,2,1,230357,230359,230360,2,3,0
65777,5,3,230362,230362,230365,0,3,2
65778,6,1,230368,230368,230369,0,1,3
65779,3,1,230371,230371,230372,0,1,2
65780,2,2,230373,230373,230375,0,2,1
65781,6,2,230379,230379,230381,0,2,4
65782,1,1,230380,230381,230382,1,2,0
65783,6,2,230386,230386,230388,0,2,4
65784,1,3,230387,230388,230391,1,4,0
65785,6,1,230393,230393,230394,0,1,2
65786,1,3,230394,230394,230397,0,3,0
65787,1,3,230395,230397,230400,2,5,0
65788,4,2,230399,230400,230402,1,3,0
65789,1,3,230400,230402,230405,2,5,0
65790,2,2,230402,230405,230407,3,5,0
65791,2,1,230404,230407,230408,3,4,0
65792,3,2,230407,230408,230410,1,3,0
65793,5,3,230412,230412,230415,0,3,2
65794,1,2,230413,230415,230417,2,4,0
65795,1,3,230414,230417,230420,3,6,0
65796,6,1,230420,230420,230421,0,1,0
65797,6,2,230426,230426,230428,0,2,5
65798,1,3,230427,230428,230431,1,4,0
65799,1,1,230428,230431,230432,3,4,0
65800,5,2,230433,230433,230435,0,2,1
65801,1,3,230434,230435,230438,1,4,0
65802,1,2,230435,230438,230440,3,5,0
65803,5,1,230440,230440,230441,0,1,0
65804,2,2,230442,230442,230444,0,2,1
65805,4,2,230446,230446,230448,0,2,2
65806,6,1,230452,230452,230453,0,1,4
65807,2,2,230454,230454,230456,0,2,1
65808,2,1,230456,230456,230457,0,1,0
65809,5,2,230461,230461,230463,0,2,4
65810,3,3,230464,230464,230467,0,3,1
65811,5,3,230469,230469,230472,0,3,2
65812,6,2,230475,230475,230477,0,2,3
65813,6,3,230481,230481,230484,0,3,4
65814,3,1,230484,230484,230485,0,1,0
65815,3,2,230487,230487,230489,0,2,2
65816,6,3,230493,230493,230496,0,3,4
65817,1,2,230494,230496,230498,2,4,0
65818,6,1,230500,230500,230501,0,1,2
65819,1,3,230501,230501,230504,0,3,0
65820,6,2,230507,230507,230509,0,2,3
65821,3,2,230510,230510,230512,0,2,1
65822,3,1,230513,230513,230514,0,1,1
65823,5,3,230518,230518,230521,0,3,4
65824,3,1,230521,230521,230522,0,1,0
65825,5,2,230526,230526,230528,0,2,4
65826,1,2,230527,230528,230530,1,3,0
65827,3,1,230530,230530,230531,0,1,0
65828,1,1,230531,230531,230532,0,1,0
65829,6,1,230537,230537,230538,0,1,5
65830,6,3,230543,230543,230546,0,3,5
65831,5,3,230548,230548,230551,0,3,2
65832,6,2,230554,230554,230556,0,2,3
65833,2,2,230556,230556,230558,0,2,0
65834,5,3,230561,230561,230564,0,3,3
65835,3,2,230564,230564,230566,0,2,0
65836,6,3,230570,230570,230573,0,3,4
65837,3,2,230573,230573,230575,0,2,0
65838,2,3,230575,230575,230578,0,3,0
65839,4,3,230579,230579,230582,0,3,1
65840,3,3,230582,230582,230585,0,3,0
65841,6,1,230588,230588,230589,0,1,3
65842,1,1,230589,230589,230590,0,1,0
65843,5,3,230594,230594,230597,0,3,4
65844,3,1,230597,230597,230598,0,1,0
65845,1,1,230598,230598,230599,0,1,0
65846,3,1,230601,230601,230602,0,1,2
65847,3,1,230604,230604,230605,0,1,2
65848,6,3,230610,230610,230613,0,3,5
65849,1,3,230611,230613,230616,2,5,0
65850,5,2,230616,230616,230618,0,2,0
65851,2,3,230618,230618,230621,0,3,0
65852,6,2,230624,230624,230626,0,2,3
65853,6,1,230630,230630,230631,0,1,4
65854,2,2,230632,230632,230634,0,2,1
65855,1,3,230633,230634,230637,1,4,0
65856,1,2,230634,230637,230639,3,5,0
65857,3,3,230637,230639,230642,2,5,0
65858,3,3,230640,230642,230645,2,5,0
65859,4,1,230644,230645,230646,1,2,0
65860,2,1,230646,230646,230647,0,1,0
65861,5,2,230651,230651,230653,0,2,4
65862,4,2,230655,230655,230657,0,2,2
65863,2,1,230657,230657,230658,0,1,0
65864,3,3,230660,230660,230663,0,3,2
65865,6,3,230666,230666,230669,0,3,3
65866,1,1,230667,230669,230670,2,3,0
65867,3,2,230670,230670,230672,0,2,0
65868,5,2,230675,230675,230677,0,2,3
65869,4,2,230679,230679,230681,0,2,2
65870,3,1,230682,230682,230683,0,1,1
65871,3,3,230685,230685,230688,0,3,2
65872,1,2,230686,230688,230690,2,4,0
65873,2,3,230688,230690,230693,2,5,0
65874,3,2,230691,230693,230695,2,4,0
65875,4,1,230695,230695,230696,0,1,0
65876,4,2,230699,230699,230701,0,2,3
65877,3,3,230702,230702,230705,0,3,1
65878,5,3,230707,230707,230710,0,3,2
65879,4,1,230711,230711,230712,0,1,1
65880,2,1,230713,230713,230714,0,1,1
65881,4,1,230717,230717,230718,0,1,3
65882,6,1,230723,230723,230724,0,1,5
65883,5,2,230728,230728,230730,0,2,4
65884,6,3,230734,230734,230737,0,3,4
65885,2,3,230736,230737,230740,1,4,0
65886,3,1,230739,230740,230741,1,2,0
65887,3,3,230742,230742,230745,0,3,1
65888,2,2,230744,230745,230747,1,3,0
65889,6,3,230750,230750,230753,0,3,3
65890,6,2,230756,230756,230758,0,2,3
65891,2,3,230758,230758,230761,0,3,0
65892,3,2,230761,230761,230763,0,2,0
65893,3,1,230764,230764,230765,0,1,1
65894,2,2,230766,230766,230768,0,2,1
65895,3,2,230769,230769,230771,0,2,1
65896,6,1,230775,230775,230776,0,1,4
65897,4,1,230779,230779,230780,0,1,3
65898,4,1,230783,230783,230784,0,1,3
65899,3,1,230786,230786,230787,0,1,2
65900,4,3,230790,230790,230793,0,3,3
65901,2,3,230792,230793,230796,1,4,0
65902,6,3,230798,230798,230801,0,3,2
65903,4,1,230802,230802,230803,0,1,1
65904,1,1,230803,230803,230804,0,1,0
65905,3,1,230806,230806,230807,0,1,2
65906,3,2,230809,230809,230811,0,2,2
65907,5,1,230814,230814,230815,0,1,3
65908,4,2,230818,230818,230820,0,2,3
65909,6,3,230824,230824,230827,0,3,4
65910,5,2,230829,230829,230831,0,2,2
65911,2,1,230831,230831,230832,0,1,0
65912,2,3,230833,230833,230836,0,3,1
65913,3,1,230836,230836,230837,0,1,0
65914,2,1,230838,230838,230839,0,1,1
65915,5,2,230843,230843,230845,0,2,4
65916,5,2,230848,230848,230850,0,2,3
65917,6,3,230854,230854,230857,0,3,4
65918,4,1,230858,230858,230859,0,1,1
65919,1,3,230859,230859,230862,0,3,0
65920,4,3,230863,230863,230866,0,3,1
65921,4,3,230867,230867,230870,0,3,1
65922,6,2,230873,230873,230875,0,2,3
65923,4,1,230877,230877,230878,0,1,2
65924,2,1,230879,230879,230880,0,1,1
65925,3,2,230882,230882,230884,0,2,2
65926,5,2,230887,230887,230889,0,2,3
65927,6,1,230893,230893,230894,0,1,4
65928,5,3,230898,230898,230901,0,3,4
65929,5,3,230903,230903,230906,0,3,2
65930,3,3,230906,230906,230909,0,3,0
65931,4,2,230910,230910,230912,0,2,1
65932,2,1,230912,230912,230913,0,1,0
65933,3,1,230915,230915,230916,0,1,2
65934,3,2,230918,230918,230920,0,2,2
65935,3,3,230921,230921,230924,0,3,1
65936,1,1,230922,230924,230925,2,3,0
65937,6,1,230928,230928,230929,0,1,3
65938,5,1,230933,230933,230934,0,1,4
65939,2,3,230935,230935,230938,0,3,1
65940,5,1,230940,230940,230941,0,1,2
65941,6,2,230946,230946,230948,0,2,5
65942,3,1,230949,230949,230950,0,1,1
65943,1,2,230950,230950,230952,0,2,0
65944,3,1,230953,230953,230954,0,1,1
65945,4,1,230957,230957,230958,0,1,3
65946,6,2,230963,230963,230965,0,2,5
65947,2,3,230965,230965,230968,0,3,0
65948,5,1,230970,230970,230971,0,1,2
65949,6,2,230976,230976,230978,0,2,5
65950,6,2,230982,230982,230984,0,2,4
65951,4,2,230986,230986,230988,0,2,2
65952,5,3,230991,230991,230994,0,3,3
65953,5,2,230996,230996,230998,0,2,2
65954,3,2,230999,230999,231001,0,2,1
65955,4,1,231003,231003,231004,0,1,2
65956,1,3,231004,231004,231007,0,3,0
65957,5,2,231009,231009,231011,0,2,2
65958,6,2,231015,231015,231017,0,2,4
65959,3,1,231018,231018,231019,0,1,1
65960,5,1,231023,231023,231024,0,1,4
65961,2,2,231025,231025,231027,0,2,1
65962,5,3,231030,231030,231033,0,3,3
65963,6,2,231036,231036,231038,0,2,3
65964,3,2,231039,231039,231041,0,2,1
65965,1,1,231040,231041,231042,1,2,0
65966,5,1,231045,231045,231046,0,1,3
65967,2,2,231047,231047,231049,0,2,1
65968,1,2,231048,231049,231051,1,3,0
65969,5,1,231053,231053,231054,0,1,2
65970,5,3,231058,231058,231061,0,3,4
65971,5,2,231063,231063,231065,0,2,2
65972,6,1,231069,231069,231070,0,1,4
65973,4,1,231073,231073,231074,0,1,3
65974,4,1,231077,231077,231078,0,1,3
65975,2,3,231079,231079,231082,0,3,1
65976,6,3,231085,231085,231088,0,3,3
65977,4,3,231089,231089,231092,0,3,1
65978,3,3,231092,231092,231095,0,3,0
65979,5,3,231097,231097,231100,0,3,2
65980,4,1,231101,231101,231102,0,1,1
65981,2,1,231103,231103,231104,0,1,1
65982,5,1,231108,231108,231109,0,1,4
65983,6,1,231114,231114,231115,0,1,5
65984,6,1,231120,231120,231121,0,1,5
65985,1,2,231121,231121,231123,0,2,0
65986,4,2,231125,231125,231127,0,2,2
65987,4,2,231129,231129,231131,0,2,2
65988,4,1,231133,231133,231134,0,1,2
65989,3,3,231136,231136,231139,0,3,2
65990,1,3,231137,231139,231142,2,5,0
65991,5,2,231142,231142,231144,0,2,0
65992,3,3,231145,231145,231148,0,3,1
65993,1,2,231146,231148,231150,2,4,0
65994,4,2,231150,231150,231152,0,2,0
65995,1,2,231151,231152,231154,1,3,0
65996,3,3,231154,231154,231157,0,3,0
65997,5,1,231159,231159,231160,0,1,2
65998,2,2,231161,231161,231163,0,2,1
65999,4,2,231165,231165,231167,0,2,2
66000,2,2,231167,231167,231169,0,2,0
66001,2,3,231169,231169,231172,0,3,0
66002,4,1,231173,231173,231174,0,1,1
66003,4,3,231177,231177,231180,0,3,3
66004,4,1,231181,231181,231182,0,1,1
66005,4,1,231185,231185,231186,0,1,3
66006,6,2,231191,231191,231193,0,2,5
66007,3,2,231194,231194,231196,0,2,1
66008,2,1,231196,231196,231197,0,1,0
66009,2,3,231198,231198,231201,0,3,1
66010,3,3,231201,231201,231204,0,3,0
66011,4,2,231205,231205,231207,0,2,1
66012,5,2,231210,231210,231212,0,2,3
66013,6,1,231216,231216,231217,0,1,4
66014,4,3,231220,231220,231223,0,3,3
66015,6,2,231226,231226,231228,0,2,3
66016,2,2,231228,231228,231230,0,2,0
66017,2,2,231230,231230,231232,0,2,0
66018,1,1,231231,231232,231233,1,2,0
66019,2,1,231233,231233,231234,0,1,0
66020,1,3,231234,231234,231237,0,3,0
66021,5,3,231239,231239,231242,0,3,2
66022,6,1,231245,231245,231246,0,1,3
66023,3,1,231248,231248,231249,0,1,2
66024,5,2,231253,231253,231255,0,2,4
66025,1,2,231254,231255,231257,1,3,0
66026,6,3,231260,231260,231263,0,3,3
66027,2,1,231262,231263,231264,1,2,0
66028,6,2,231268,231268,231270,0,2,4
66029,1,2,231269,231270,231272,1,3,0
66030,1,1,231270,231272,231273,2,3,0
66031,2,2,231272,231273,231275,1,3,0
66032,1,2,231273,231275,231277,2,4,0
66033,2,3,231275,231277,231280,2,5,0
66034,2,1,231277,231280,231281,3,4,0
66035,1,3,231278,231281,231284,3,6,0
66036,2,1,231280,231284,231285,4,5,0
66037,6,2,231286,231286,231288,0,2,1
66038,3,3,231289,231289,231292,0,3,1
66039,1,3,231290,231292,231295,2,5,0
66040,2,2,231292,231295,231297,3,5,0
66041,4,1,231296,231297,231298,1,2,0
66042,3,2,231299,231299,231301,0,2,1
66043,1,1,231300,231301,231302,1,2,0
66044,6,3,231306,231306,231309,0,3,4
66045,4,1,231310,231310,231311,0,1,1
66046,2,3,231312,231312,231315,0,3,1
66047,6,2,231318,231318,231320,0,2,3
66048,5,3,231323,231323,231326,0,3,3
66049,6,1,231329,231329,231330,0,1,3
66050,6,3,231335,231335,231338,0,3,5
66051,2,3,231337,231338,231341,1,4,0
66052,5,2,231342,231342,231344,0,2,1
66053,6,2,231348,231348,231350,0,2,4
66054,5,2,231353,231353,231355,0,2,3
66055,6,2,231359,231359,231361,0,2,4
66056,3,3,231362,231362,231365,0,3,1
66057,1,1,231363,231365,231366,2,3,0
66058,5,3,231368,231368,231371,0,3,2
66059,5,1,231373,231373,231374,0,1,2
66060,2,2,231375,231375,231377,0,2,1
66061,5,2,231380,231380,231382,0,2,3
66062,4,1,231384,231384,231385,0,1,2
66063,2,3,231386,231386,231389,0,3,1
66064,6,2,231392,231392,231394,0,2,3
66065,3,2,231395,231395,231397,0,2,1
66066,2,1,231397,231397,231398,0,1,0
66067,3,3,231400,231400,231403,0,3,2
66068,4,3,231404,231404,231407,0,3,1
66069,1,1,231405,231407,231408,2,3,0
66070,2,1,231407,231408,231409,1,2,0
66071,6,3,231413,231413,231416,0,3,4
66072,4,1,231417,231417,231418,0,1,1
66073,3,1,231420,231420,231421,0,1,2
66074,5,2,231425,231425,231427,0,2,4
66075,6,3,231431,231431,231434,0,3,4
66076,3,1,231434,231434,231435,0,1,0
66077,4,2,231438,231438,231440,0,2,3
66078,1,1,231439,231440,231441,1,2,0
66079,3,2,231442,231442,231444,0,2,1
66080,5,1,231447,231447,231448,0,1,3
66081,1,1,231448,231448,231449,0,1,0
66082,4,3,231452,231452,231455,0,3,3
66083,2,1,231454,231455,231456,1,2,0
66084,4,2,231458,231458,231460,0,2,2
66085,3,2,231461,231461,231463,0,2,1
66086,4,2,231465,231465,231467,0,2,2
66087,6,2,231471,231471,231473,0,2,4
66088,6,2,231477,231477,231479,0,2,4
66089,3,1,231480,231480,231481,0,1,1
66090,4,1,231484,231484,231485,0,1,3
66091,1,2,231485,231485,231487,0,2,0
66092,1,3,231486,231487,231490,1,4,0
66093,3,2,231489,231490,231492,1,3,0
66094,1,3,231490,231492,231495,2,5,0
66095,4,2,231494,231495,231497,1,3,0
66096,6,3,231500,231500,231503,0,3,3
66097,5,2,231505,231505,231507,0,2,2
66098,2,3,231507,231507,231510,0,3,0
66099,2,1,231509,231510,231511,1,2,0
66100,2,2,231511,231511,231513,0,2,0
66101,6,1,231517,231517,231518,0,1,4
66102,2,3,231519,231519,231522,0,3,1
66103,3,2,231522,231522,231524,0,2,0
66104,1,2,231523,231524,231526,1,3,0
66105,6,1,231529,231529,231530,0,1,3
66106,5,2,231534,231534,231536,0,2,4
66107,2,2,231536,231536,231538,0,2,0
66108,4,2,231540,231540,231542,0,2,2
66109,6,1,231546,231546,231547,0,1,4
66110,2,1,231548,231548,231549,0,1,1
66111,1,3,231549,231549,231552,0,3,0
66112,3,3,231552,231552,231555,0,3,0
66113,4,2,231556,231556,231558,0,2,1
66114,4,3,231560,231560,231563,0,3,2
66115,1,3,231561,231563,231566,2,5,0
66116,5,3,231566,231566,231569,0,3,0
66117,3,3,231569,231569,231572,0,3,0
66118,3,3,231572,231572,231575,0,3,0
66119,3,3,231575,231575,231578,0,3,0
66120,3,3,231578,231578,231581,0,3,0
66121,2,2,231580,231581,231583,1,3,0
66122,1,3,231581,231583,231586,2,5,0
66123,4,2,231585,231586,231588,1,3,0
66124,4,1,231589,231589,231590,0,1,1
66125,5,1,231594,231594,231595,0,1,4
66126,5,1,231599,231599,231600,0,1,4
66127,3,1,231602,231602,231603,0,1,2
66128,3,1,231605,231605,231606,0,1,2
66129,5,1,231610,231610,231611,0,1,4
66130,5,1,231615,231615,231616,0,1,4
66131,3,2,231618,231618,231620,0,2,2
66132,1,3,231619,231620,231623,1,4,0
66133,6,3,231625,231625,231628,0,3,2
66134,2,3,231627,231628,231631,1,4,0
66135,1,1,231628,231631,231632,3,4,0
66136,5,3,231633,231633,231636,0,3,1
66137,6,1,231639,231639,231640,0,1,3
66138,6,2,231645,231645,231647,0,2,5
66139,3,1,231648,231648,231649,0,1,1
66140,5,1,231653,231653,231654,0,1,4
66141,5,1,231658,231658,231659,0,1,4
66142,5,1,231663,231663,231664,0,1,4
66143,1,2,231664,231664,231666,0,2,0
66144,2,3,231666,231666,231669,0,3,0
66145,6,3,231672,231672,231675,0,3,3
66146,4,1,231676,231676,231677,0,1,1
66147,2,1,231678,231678,231679,0,1,1
66148,1,2,231679,231679,231681,0,2,0
66149,6,2,231685,231685,231687,0,2,4
66150,5,1,231690,231690,231691,0,1,3
66151,5,2,231695,231695,231697,0,2,4
66152,2,2,231697,231697,231699,0,2,0
66153,1,3,231698,231699,231702,1,4,0
66154,1,3,231699,231702,231705,3,6,0
66155,4,1,231703,231705,231706,2,3,0
66156,5,2,231708,231708,231710,0,2,2
66157,6,1,231714,231714,231715,0,1,4
66158,4,1,231718,231718,231719,0,1,3
66159,1,3,231719,231719,231722,0,3,0
66160,2,3,231721,231722,231725,1,4,0
66161,4,3,231725,231725,231728,0,3,0
66162,4,3,231729,231729,231732,0,3,1
66163,6,2,231735,231735,231737,0,2,3
66164,4,2,231739,231739,231741,0,2,2
66165,6,1,231745,231745,231746,0,1,4
66166,5,1,231750,231750,231751,0,1,4
66167,4,2,231754,231754,231756,0,2,3
66168,1,3,231755,231756,231759,1,4,0
66169,5,3,231760,231760,231763,0,3,1
66170,1,2,231761,231763,231765,2,4,0
66171,6,2,231767,231767,231769,0,2,2
66172,3,1,231770,231770,231771,0,1,1
66173,3,2,231773,231773,231775,0,2,2
66174,6,3,231779,231779,231782,0,3,4
66175,5,2,231784,231784,231786,0,2,2
66176,1,1,231785,231786,231787,1,2,0
66177,3,3,231788,231788,231791,0,3,1
66178,3,1,231791,231791,231792,0,1,0
66179,6,1,231797,231797,231798,0,1,5
66180,1,3,231798,231798,231801,0,3,0
66181,3,3,231801,231801,231804,0,3,0
66182,2,2,231803,231804,231806,1,3,0
66183,6,3,231809,231809,231812,0,3,3
66184,2,1,231811,231812,231813,1,2,0
66185,3,3,231814,231814,231817,0,3,1
66186,6,3,231820,231820,231823,0,3,3
66187,2,1,231822,231823,231824,1,2,0
66188,1,2,231823,231824,231826,1,3,0
66189,3,2,231826,231826,231828,0,2,0
66190,6,1,231832,231832,231833,0,1,4
66191,6,2,231838,231838,231840,0,2,5
66192,3,2,231841,231841,231843,0,2,1
66193,3,3,231844,231844,231847,0,3,1
66194,3,3,231847,231847,231850,0,3,0
66195,6,2,231853,231853,231855,0,2,3
66196,5,2,231858,231858,231860,0,2,3
66197,4,1,231862,231862,231863,0,1,2
66198,3,1,231865,231865,231866,0,1,2
66199,6,2,231871,231871,231873,0,2,5
66200,3,3,231874,231874,231877,0,3,1
66201,4,3,231878,231878,231881,0,3,1
66202,3,2,231881,231881,231883,0,2,0
66203,1,2,231882,231883,231885,1,3,0
66204,3,3,231885,231885,231888,0,3,0
66205,1,3,231886,231888,231891,2,5,0
66206,4,3,231890,231891,231894,1,4,0
66207,4,3,231894,231894,231897,0,3,0
66208,5,1,231899,231899,231900,0,1,2
66209,2,1,231901,231901,231902,0,1,1
66210,3,2,231904,231904,231906,0,2,2
66211,5,1,231909,231909,231910,0,1,3
66212,1,3,231910,231910,231913,0,3,0
66213,1,1,231911,231913,231914,2,3,0
66214,5,1,231916,231916,231917,0,1,2
66215,1,3,231917,231917,231920,0,3,0
66216,4,2,231921,231921,231923,0,2,1
66217,4,1,231925,231925,231926,0,1,2
66218,4,3,231929,231929,231932,0,3,3
66219,3,2,231932,231932,231934,0,2,0
66220,1,3,231933,231934,231937,1,4,0
66221,1,2,231934,231937,231939,3,5,0
66222,6,3,231940,231940,231943,0,3,1
66223,2,2,231942,231943,231945,1,3,0
66224,4,1,231946,231946,231947,0,1,1
66225,6,3,231952,231952,231955,0,3,5
66226,4,1,231956,231956,231957,0,1,1
66227,4,1,231960,231960,231961,0,1,3
66228,3,2,231963,231963,231965,0,2,2
66229,6,1,231969,231969,231970,0,1,4
66230,4,1,231973,231973,231974,0,1,3
66231,4,3,231977,231977,231980,0,3,3
66232,4,1,231981,231981,231982,0,1,1
66233,3,1,231984,231984,231985,0,1,2
66234,2,3,231986,231986,231989,0,3,1
66235,4,1,231990,231990,231991,0,1,1
66236,2,3,231992,231992,231995,0,3,1
66237,5,1,231997,231997,231998,0,1,2
66238,1,1,231998,231998,231999,0,1,0
66239,5,1,232003,232003,232004,0,1,4
66240,6,3,232009,232009,232012,0,3,5
66241,5,1,232014,232014,232015,0,1,2
66242,1,1,232015,232015,232016,0,1,0
66243,4,3,232019,232019,232022,0,3,3
66244,4,3,232023,232023,232026,0,3,1
66245,3,2,232026,232026,232028,0,2,0
66246,4,2,232030,232030,232032,0,2,2
66247,2,3,232032,232032,232035,0,3,0
66248,6,2,232038,232038,232040,0,2,3
66249,1,3,232039,232040,232043,1,4,0
66250,1,1,232040,232043,232044,3,4,0
66251,4,1,232044,232044,232045,0,1,0
66252,1,3,232045,232045,232048,0,3,0
66253,6,1,232051,232051,232052,0,1,3
66254,1,3,232052,232052,232055,0,3,0
66255,2,3,232054,232055,232058,1,4,0
66256,2,1,232056,232058,232059,2,3,0
66257,5,3,232061,232061,232064,0,3,2
66258,4,2,232065,232065,232067,0,2,1
66259,6,2,232071,232071,232073,0,2,4
66260,3,1,232074,232074,232075,0,1,1
66261,5,3,232079,232079,232082,0,3,4
66262,2,1,232081,232082,232083,1,2,0
66263,6,2,232087,232087,232089,0,2,4
66264,5,3,232092,232092,232095,0,3,3
66265,4,3,232096,232096,232099,0,3,1
66266,5,3,232101,232101,232104,0,3,2
66267,6,2,232107,232107,232109,0,2,3
66268,2,1,232109,232109,232110,0,1,0
66269,2,3,232111,232111,232114,0,3,1
66270,1,1,232112,232114,232115,2,3,0
66271,6,2,232118,232118,232120,0,2,3
66272,4,2,232122,232122,232124,0,2,2
66273,5,3,232127,232127,232130,0,3,3
66274,5,3,232132,232132,232135,0,3,2
66275,5,2,232137,232137,232139,0,2,2
66276,2,2,232139,232139,232141,0,2,0
66277,4,2,232143,232143,232145,0,2,2
66278,4,3,232147,232147,232150,0,3,2
66279,5,3,232152,232152,232155,0,3,2
66280,4,1,232156,232156,232157,0,1,1
66281,6,2,232162,232162,232164,0,2,5
66282,1,1,232163,232164,232165,1,2,0
66283,3,2,232166,232166,232168,0,2,1
66284,1,2,232167,232168,232170,1,3,0
66285,2,1,232169,232170,232171,1,2,0
66286,6,3,232175,232175,232178,0,3,4
66287,2,1,232177,232178,232179,1,2,0
66288,2,1,232179,232179,232180,0,1,0
66289,2,3,232181,232181,232184,0,3,1
66290,6,2,232187,232187,232189,0,2,3
66291,3,3,232190,232190,232193,0,3,1
66292,1,3,232191,232193,232196,2,5,0
66293,3,1,232194,232196,232197,2,3,0
66294,6,1,232200,232200,232201,0,1,3
66295,4,2,232204,232204,232206,0,2,3
66296,3,1,232207,232207,232208,0,1,1
66297,2,1,232209,232209,232210,0,1,1
66298,4,3,232213,232213,232216,0,3,3
66299,3,2,232216,232216,232218,0,2,0
66300,1,1,232217,232218,232219,1,2,0
66301,5,1,232222,232222,232223,0,1,3
66302,2,3,232224,232224,232227,0,3,1
66303,2,3,232226,232227,232230,1,4,0
66304,2,1,232228,232230,232231,2,3,0
66305,6,1,232234,232234,232235,0,1,3
66306,1,3,232235,232235,232238,0,3,0
66307,2,2,232237,232238,232240,1,3,0
66308,3,3,232240,232240,232243,0,3,0
66309,2,1,232242,232243,232244,1,2,0
66310,3,3,232245,232245,232248,0,3,1
66311,1,3,232246,232248,232251,2,5,0
66312,1,2,232247,232251,232253,4,6,0
66313,5,3,232252,232253,232256,1,4,0
66314,4,1,232256,232256,232257,0,1,0
66315,5,2,232261,232261,232263,0,2,4
66316,4,3,232265,232265,232268,0,3,2
66317,3,2,232268,232268,232270,0,2,0
66318,6,3,232274,232274,232277,0,3,4
66319,6,1,232280,232280,232281,0,1,3
66320,1,1,232281,232281,232282,0,1,0
66321,4,2,232285,232285,232287,0,2,3
66322,2,3,232287,232287,232290,0,3,0
66323,1,1,232288,232290,232291,2,3,0
66324,4,2,232292,232292,232294,0,2,1
66325,6,2,232298,232298,232300,0,2,4
66326,3,1,232301,232301,232302,0,1,1
66327,6,1,232307,232307,232308,0,1,5
66328,5,1,232312,232312,232313,0,1,4
66329,3,3,232315,232315,232318,0,3,2
66330,4,3,232319,232319,232322,0,3,1
66331,5,3,232324,232324,232327,0,3,2
66332,1,3,232325,232327,232330,2,5,0
66333,6,3,232331,232331,232334,0,3,1
66334,4,3,232335,232335,232338,0,3,1
66335,4,3,232339,232339,232342,0,3,1
66336,2,1,232341,232342,232343,1,2,0
66337,4,1,232345,232345,232346,0,1,2
66338,6,3,232351,232351,232354,0,3,5
66339,6,1,232357,232357,232358,0,1,3
66340,3,2,232360,232360,232362,0,2,2
66341,2,1,232362,232362,232363,0,1,0
66342,3,3,232365,232365,232368,0,3,2
66343,6,2,232371,232371,232373,0,2,3
66344,1,2,232372,232373,232375,1,3,0
66345,5,1,232377,232377,232378,0,1,2
66346,2,2,232379,232379,232381,0,2,1
66347,5,1,232384,232384,232385,0,1,3
66348,1,1,232385,232385,232386,0,1,0
66349,5,3,232390,232390,232393,0,3,4
66350,6,1,232396,232396,232397,0,1,3
66351,5,3,232401,232401,232404,0,3,4
66352,5,2,232406,232406,232408,0,2,2
66353,4,1,232410,232410,232411,0,1,2
66354,1,3,232411,232411,232414,0,3,0
66355,1,2,232412,232414,232416,2,4,0
66356,6,2,232418,232418,232420,0,2,2
66357,3,1,232421,232421,232422,0,1,1
66358,6,3,232427,232427,232430,0,3,5
66359,3,3,232430,232430,232433,0,3,0
66360,4,3,232434,232434,232437,0,3,1
66361,5,1,232439,232439,232440,0,1,2
66362,3,3,232442,232442,232445,0,3,2
66363,1,1,232443,232445,232446,2,3,0
66364,1,3,232444,232446,232449,2,5,0
66365,3,3,232447,232449,232452,2,5,0
66366,1,3,232448,232452,232455,4,7,0
66367,3,2,232451,232455,232457,4,6,0
66368,6,2,232457,232457,232459,0,2,0
66369,4,2,232461,232461,232463,0,2,2
66370,2,1,232463,232463,232464,0,1,0
66371,3,3,232466,232466,232469,0,3,2
66372,5,1,232471,232471,232472,0,1,2
66373,4,2,232475,232475,232477,0,2,3
66374,5,1,232480,232480,232481,0,1,3
66375,1,2,232481,232481,232483,0,2,0
66376,5,3,232486,232486,232489,0,3,3
66377,4,3,232490,232490,232493,0,3,1
66378,6,1,232496,232496,232497,0,1,3
66379,1,3,232497,232497,232500,0,3,0
66380,5,3,232502,232502,232505,0,3,2
66381,1,2,232503,232505,232507,2,4,0
66382,4,3,232507,232507,232510,0,3,0
66383,3,2,232510,232510,232512,0,2,0
66384,5,2,232515,232515,232517,0,2,3
66385,6,3,232521,232521,232524,0,3,4
66386,5,2,232526,232526,232528,0,2,2
66387,3,3,232529,232529,232532,0,3,1
66388,1,2,232530,232532,232534,2,4,0
66389,4,2,232534,232534,232536,0,2,0
66390,3,2,232537,232537,232539,0,2,1
66391,5,3,232542,232542,232545,0,3,3
66392,5,1,232547,232547,232548,0,1,2
66393,3,3,232550,232550,232553,0,3,2
66394,5,2,232555,232555,232557,0,2,2
66395,3,1,232558,232558,232559,0,1,1
66396,6,1,232564,232564,232565,0,1,5
66397,3,3,232567,232567,232570,0,3,2
66398,3,1,232570,232570,232571,0,1,0
66399,3,2,232573,232573,232575,0,2,2
66400,3,1,232576,232576,232577,0,1,1
66401,3,3,232579,232579,232582,0,3,2
66402,5,1,232584,232584,232585,0,1,2
66403,2,2,232586,232586,232588,0,2,1
66404,3,1,232589,232589,232590,0,1,1
66405,6,3,232595,232595,232598,0,3,5
66406,1,2,232596,232598,232600,2,4,0
66407,1,1,232597,232600,232601,3,4,0
66408,4,3,232601,232601,232604,0,3,0
66409,6,3,232607,232607,232610,0,3,3
66410,1,2,232608,232610,232612,2,4,0
66411,5,2,232613,232613,232615,0,2,1
66412,2,3,232615,232615,232618,0,3,0
66413,6,3,232621,232621,232624,0,3,3
66414,2,2,232623,232624,232626,1,3,0
66415,3,3,232626,232626,232629,0,3,0
66416,6,3,232632,232632,232635,0,3,3
66417,2,3,232634,232635,232638,1,4,0
66418,2,1,232636,232638,232639,2,3,0
66419,2,3,232638,232639,232642,1,4,0
66420,5,2,232643,232643,232645,0,2,1
66421,2,2,232645,232645,232647,0,2,0
66422,5,3,232650,232650,232653,0,3,3
66423,5,3,232655,232655,232658,0,3,2
66424,1,2,232656,232658,232660,2,4,0
66425,6,3,232662,232662,232665,0,3,2
66426,2,1,232664,232665,232666,1,2,0
66427,3,2,232667,232667,232669,0,2,1
66428,2,2,232669,232669,232671,0,2,0
66429,3,1,232672,232672,232673,0,1,1
66430,5,3,232677,232677,232680,0,3,4
66431,3,2,232680,232680,232682,0,2,0
66432,5,1,232685,232685,232686,0,1,3
66433,5,3,232690,232690,232693,0,3,4
66434,5,2,232695,232695,232697,0,2,2
66435,6,1,232701,232701,232702,0,1,4
66436,4,3,232705,232705,232708,0,3,3
66437,3,3,232708,232708,232711,0,3,0
66438,2,3,232710,232711,232714,1,4,0
66439,6,3,232716,232716,232719,0,3,2
66440,2,1,232718,232719,232720,1,2,0
66441,1,3,232719,232720,232723,1,4,0
66442,3,3,232722,232723,232726,1,4,0
66443,1,1,232723,232726,232727,3,4,0
66444,5,1,232728,232728,232729,0,1,1
66445,3,2,232731,232731,232733,0,2,2
66446,1,2,232732,232733,232735,1,3,0
66447,2,1,232734,232735,232736,1,2,0
66448,3,3,232737,232737,232740,0,3,1
66449,5,3,232742,232742,232745,0,3,2
66450,1,1,232743,232745,232746,2,3,0
66451,6,3,232749,232749,232752,0,3,3
66452,6,1,232755,232755,232756,0,1,3
66453,1,3,232756,232756,232759,0,3,0
66454,4,2,232760,232760,232762,0,2,1
66455,4,3,232764,232764,232767,0,3,2
66456,3,2,232767,232767,232769,0,2,0
66457,5,2,232772,232772,232774,0,2,3
66458,3,2,232775,232775,232777,0,2,1
66459,5,3,232780,232780,232783,0,3,3
66460,2,2,232782,232783,232785,1,3,0
66461,5,1,232787,232787,232788,0,1,2
66462,3,2,232790,232790,232792,0,2,2
66463,3,3,232793,232793,232796,0,3,1
66464,6,3,232799,232799,232802,0,3,3
66465,2,1,232801,232802,232803,1,2,0
66466,5,3,232806,232806,232809,0,3,3
66467,2,2,232808,232809,232811,1,3,0
66468,3,3,232811,232811,232814,0,3,0
66469,3,2,232814,232814,232816,0,2,0
66470,6,2,232820,232820,232822,0,2,4
66471,1,1,232821,232822,232823,1,2,0
66472,4,3,232825,232825,232828,0,3,2
66473,5,2,232830,232830,232832,0,2,2
66474,5,1,232835,232835,232836,0,1,3
66475,6,3,232841,232841,232844,0,3,5
66476,6,1,232847,232847,232848,0,1,3
66477,4,2,232851,232851,232853,0,2,3
66478,4,2,232855,232855,232857,0,2,2
66479,2,3,232857,232857,232860,0,3,0
66480,6,1,232863,232863,232864,0,1,3
66481,2,2,232865,232865,232867,0,2,1
66482,4,3,232869,232869,232872,0,3,2
66483,5,1,232874,232874,232875,0,1,2
66484,2,3,232876,232876,232879,0,3,1
66485,5,1,232881,232881,232882,0,1,2
66486,3,3,232884,232884,232887,0,3,2
66487,2,2,232886,232887,232889,1,3,0
66488,4,2,232890,232890,232892,0,2,1
66489,1,3,232891,232892,232895,1,4,0
66490,4,2,232895,232895,232897,0,2,0
66491,6,1,232901,232901,232902,0,1,4
66492,2,1,232903,232903,232904,0,1,1
66493,3,3,232906,232906,232909,0,3,2
66494,6,1,232912,232912,232913,0,1,3
66495,4,1,232916,232916,232917,0,1,3
66496,6,1,232922,232922,232923,0,1,5
66497,4,1,232926,232926,232927,0,1,3
66498,6,2,232932,232932,232934,0,2,5
66499,6,3,232938,232938,232941,0,3,4
66500,6,3,232944,232944,232947,0,3,3
66501,5,2,232949,232949,232951,0,2,2
66502,6,1,232955,232955,232956,0,1,4
66503,2,3,232957,232957,232960,0,3,1
66504,1,1,232958,232960,232961,2,3,0
66505,3,3,232961,232961,232964,0,3,0
66506,6,3,232967,232967,232970,0,3,3
66507,2,1,232969,232970,232971,1,2,0
66508,6,2,232975,232975,232977,0,2,4
66509,5,1,232980,232980,232981,0,1,3
66510,5,3,232985,232985,232988,0,3,4
66511,4,1,232989,232989,232990,0,1,1
66512,5,3,232994,232994,232997,0,3,4
66513,2,3,232996,232997,233000,1,4,0
66514,2,1,232998,233000,233001,2,3,0
66515,2,1,233000,233001,233002,1,2,0
66516,2,3,233002,233002,233005,0,3,0
66517,1,1,233003,233005,233006,2,3,0
66518,4,2,233007,233007,233009,0,2,1
66519,6,1,233013,233013,233014,0,1,4
66520,6,1,233019,233019,233020,0,1,5
66521,2,3,233021,233021,233024,0,3,1
66522,3,2,233024,233024,233026,0,2,0
66523,1,2,233025,233026,233028,1,3,0
66524,3,3,233028,233028,233031,0,3,0
66525,4,3,233032,233032,233035,0,3,1
66526,1,2,233033,233035,233037,2,4,0
66527,3,3,233036,233037,233040,1,4,0
66528,6,3,233042,233042,233045,0,3,2
66529,3,1,233045,233045,233046,0,1,0
66530,6,3,233051,233051,233054,0,3,5
66531,3,1,233054,233054,233055,0,1,0
66532,5,1,233059,233059,233060,0,1,4
66533,6,3,233065,233065,233068,0,3,5
66534,4,2,233069,233069,233071,0,2,1
66535,6,2,233075,233075,233077,0,2,4
66536,6,2,233081,233081,233083,0,2,4
66537,1,3,233082,233083,233086,1,4,0
66538,1,3,233083,233086,233089,3,6,0
66539,2,1,233085,233089,233090,4,5,0
66540,6,3,233091,233091,233094,0,3,1
66541,3,3,233094,233094,233097,0,3,0
66542,3,1,233097,233097,233098,0,1,0
66543,1,1,233098,233098,233099,0,1,0
66544,3,1,233101,233101,233102,0,1,2
66545,4,3,233105,233105,233108,0,3,3
66546,1,1,233106,233108,233109,2,3,0
66547,6,1,233112,233112,233113,0,1,3
66548,5,2,233117,233117,233119,0,2,4
66549,1,3,233118,233119,233122,1,4,0
66550,4,3,233122,233122,233125,0,3,0
66551,1,1,233123,233125,233126,2,3,0
66552,4,1,233127,233127,233128,0,1,1
66553,5,3,233132,233132,233135,0,3,4
66554,3,3,233135,233135,233138,0,3,0
66555,5,3,233140,233140,233143,0,3,2
66556,5,2,233145,233145,233147,0,2,2
66557,3,1,233148,233148,233149,0,1,1
66558,4,1,233152,233152,233153,0,1,3
66559,6,2,233158,233158,233160,0,2,5
66560,2,3,233160,233160,233163,0,3,0
66561,3,2,233163,233163,233165,0,2,0
66562,3,3,233166,233166,233169,0,3,1
66563,6,3,233172,233172,233175,0,3,3
66564,1,3,233173,233175,233178,2,5,0
66565,2,2,233175,233178,233180,3,5,0
66566,6,1,233181,233181,233182,0,1,1
66567,2,2,233183,233183,233185,0,2,1
66568,6,2,233189,233189,233191,0,2,4
66569,5,2,233194,233194,233196,0,2,3
66570,6,3,233200,233200,233203,0,3,4
66571,2,1,233202,233203,233204,1,2,0
66572,5,1,233207,233207,233208,0,1,3
66573,4,1,233211,233211,233212,0,1,3
66574,5,1,233216,233216,233217,0,1,4
66575,1,3,233217,233217,233220,0,3,0
66576,3,3,233220,233220,233223,0,3,0
66577,2,1,233222,233223,233224,1,2,0
66578,4,1,233226,233226,233227,0,1,2
66579,5,3,233231,233231,233234,0,3,4
66580,5,3,233236,233236,233239,0,3,2
66581,5,3,233241,233241,233244,0,3,2
66582,3,1,233244,233244,233245,0,1,0
66583,5,3,233249,233249,233252,0,3,4
66584,1,2,233250,233252,233254,2,4,0
66585,5,3,233255,233255,233258,0,3,1
66586,2,2,233257,233258,233260,1,3,0
66587,6,2,233263,233263,233265,0,2,3
66588,2,3,233265,233265,233268,0,3,0
66589,1,3,233266,233268,233271,2,5,0
66590,1,3,233267,233271,233274,4,7,0
66591,1,3,233268,233274,233277,6,9,0
66592,4,3,233272,233277,233280,5,8,0
66593,5,3,233277,233280,233283,3,6,0
66594,6,2,233283,233283,233285,0,2,0
66595,3,3,233286,233286,233289,0,3,1
66596,1,1,233287,233289,233290,2,3,0
66597,6,1,233293,233293,233294,0,1,3
66598,6,3,233299,233299,233302,0,3,5
66599,4,3,233303,233303,233306,0,3,1
66600,1,1,233304,233306,233307,2,3,0
66601,4,2,233308,233308,233310,0,2,1
66602,4,1,233312,233312,233313,0,1,2
66603,2,3,233314,233314,233317,0,3,1
66604,3,1,233317,233317,233318,0,1,0
66605,2,1,233319,233319,233320,0,1,1
66606,6,1,233325,233325,233326,0,1,5
66607,3,3,233328,233328,233331,0,3,2
66608,2,1,233330,233331,233332,1,2,0
66609,1,3,233331,233332,233335,1,4,0
66610,6,1,233337,233337,233338,0,1,2
66611,6,2,233343,233343,233345,0,2,5
66612,1,2,233344,233345,233347,1,3,0
66613,3,2,233347,233347,233349,0,2,0
66614,5,2,233352,233352,233354,0,2,3
66615,6,1,233358,233358,233359,0,1,4
66616,5,3,233363,233363,233366,0,3,4
66617,3,3,233366,233366,233369,0,3,0
66618,4,3,233370,233370,233373,0,3,1
66619,4,2,233374,233374,233376,0,2,1
66620,2,1,233376,233376,233377,0,1,0
66621,5,1,233381,233381,233382,0,1,4
66622,5,3,233386,233386,233389,0,3,4
66623,5,2,233391,233391,233393,0,2,2
66624,4,1,233395,233395,233396,0,1,2
66625,6,2,233401,233401,233403,0,2,5
66626,1,2,233402,233403,233405,1,3,0
66627,6,1,233408,233408,233409,0,1,3
66628,1,2,233409,233409,233411,0,2,0
66629,1,2,233410,233411,233413,1,3,0
66630,2,3,233412,233413,233416,1,4,0
66631,1,1,233413,233416,233417,3,4,0
66632,4,1,233417,233417,233418,0,1,0
66633,1,1,233418,233418,233419,0,1,0
66634,2,1,233420,233420,233421,0,1,1
66635,6,2,233426,233426,233428,0,2,5
66636,4,2,233430,233430,233432,0,2,2
66637,3,3,233433,233433,233436,0,3,1
66638,3,2,233436,233436,233438,0,2,0
66639,4,3,233440,233440,233443,0,3,2
66640,1,1,233441,233443,233444,2,3,0
66641,2,3,233443,233444,233447,1,4,0
66642,5,1,233448,233448,233449,0,1,1
66643,2,1,233450,233450,233451,0,1,1
66644,6,1,233456,233456,233457,0,1,5
66645,5,3,233461,233461,233464,0,3,4
66646,1,3,233462,233464,233467,2,5,0
66647,2,2,233464,233467,233469,3,5,0
66648,3,3,233467,233469,233472,2,5,0
66649,2,1,233469,233472,233473,3,4,0
66650,5,1,233474,233474,233475,0,1,1
66651,4,3,233478,233478,233481,0,3,3
66652,5,2,233483,233483,233485,0,2,2
66653,1,2,233484,233485,233487,1,3,0
66654,4,3,233488,233488,233491,0,3,1
66655,2,1,233490,233491,233492,1,2,0
66656,3,1,233493,233493,233494,0,1,1
66657,3,2,233496,233496,233498,0,2,2
66658,4,2,233500,233500,233502,0,2,2
66659,3,3,233503,233503,233506,0,3,1
66660,6,1,233509,233509,233510,0,1,3
66661,5,3,233514,233514,233517,0,3,4
66662,5,3,233519,233519,233522,0,3,2
66663,2,3,233521,233522,233525,1,4,0
66664,5,1,233526,233526,233527,0,1,1
66665,4,2,233530,233530,233532,0,2,3
66666,5,1,233535,233535,233536,0,1,3
66667,2,1,233537,233537,233538,0,1,1
66668,2,3,233539,233539,233542,0,3,1
66669,1,3,233540,233542,233545,2,5,0
66670,4,2,233544,233545,233547,1,3,0
66671,2,1,233546,233547,233548,1,2,0
66672,6,1,233552,233552,233553,0,1,4
66673,1,3,233553,233553,233556,0,3,0
66674,3,1,233556,233556,233557,0,1,0
66675,5,2,233561,233561,233563,0,2,4
66676,1,1,233562,233563,233564,1,2,0
66677,6,1,233568,233568,233569,0,1,4
66678,1,2,233569,233569,233571,0,2,0
66679,6,1,233575,233575,233576,0,1,4
66680,4,3,233579,233579,233582,0,3,3
66681,6,3,233585,233585,233588,0,3,3
66682,3,1,233588,233588,233589,0,1,0
66683,4,2,233592,233592,233594,0,2,3
66684,3,3,233595,233595,233598,0,3,1
66685,2,2,233597,233598,233600,1,3,0
66686,3,1,233600,233600,233601,0,1,0
66687,5,3,233605,233605,233608,0,3,4
66688,3,3,233608,233608,233611,0,3,0
66689,6,1,233614,233614,233615,0,1,3
66690,1,1,233615,233615,233616,0,1,0
66691,2,2,233617,233617,233619,0,2,1
66692,6,3,233623,233623,233626,0,3,4
66693,2,1,233625,233626,233627,1,2,0
66694,3,1,233628,233628,233629,0,1,1
66695,1,3,233629,233629,233632,0,3,0
66696,4,1,233633,233633,233634,0,1,1
66697,4,1,233637,233637,233638,0,1,3
66698,5,3,233642,233642,233645,0,3,4
66699,2,3,233644,233645,233648,1,4,0
66700,3,3,233647,233648,233651,1,4,0
66701,3,1,233650,233651,233652,1,2,0
66702,6,2,233656,233656,233658,0,2,4
66703,3,3,233659,233659,233662,0,3,1
66704,5,2,233664,233664,233666,0,2,2
66705,5,1,233669,233669,233670,0,1,3
66706,6,2,233675,233675,233677,0,2,5
66707,5,2,233680,233680,233682,0,2,3
66708,2,2,233682,233682,233684,0,2,0
66709,6,3,233688,233688,233691,0,3,4
66710,5,3,233693,233693,233696,0,3,2
66711,6,1,233699,233699,233700,0,1,3
66712,2,1,233701,233701,233702,0,1,1
66713,2,3,233703,233703,233706,0,3,1
66714,2,3,233705,233706,233709,1,4,0
66715,3,2,233708,233709,233711,1,3,0
66716,2,2,233710,233711,233713,1,3,0
66717,3,1,233713,233713,233714,0,1,0
66718,1,2,233714,233714,233716,0,2,0
66719,1,1,233715,233716,233717,1,2,0
66720,3,1,233718,233718,233719,0,1,1
66721,1,2,233719,233719,233721,0,2,0
66722,6,1,233725,233725,233726,0,1,4
66723,5,3,233730,233730,233733,0,3,4
66724,5,3,233735,233735,233738,0,3,2
66725,2,2,233737,233738,233740,1,3,0
66726,6,2,233743,233743,233745,0,2,3
66727,6,2,233749,233749,233751,0,2,4
66728,3,3,233752,233752,233755,0,3,1
66729,4,1,233756,233756,233757,0,1,1
66730,2,2,233758,233758,233760,0,2,1
66731,4,1,233762,233762,233763,0,1,2
66732,5,1,233767,233767,233768,0,1,4
66733,4,2,233771,233771,233773,0,2,3
66734,3,2,233774,233774,233776,0,2,1
66735,3,1,233777,233777,233778,0,1,1
66736,1,1,233778,233778,233779,0,1,0
66737,6,2,233784,233784,233786,0,2,5
66738,1,1,233785,233786,233787,1,2,0
66739,5,2,233790,233790,233792,0,2,3
66740,2,3,233792,233792,233795,0,3,0
66741,1,2,233793,233795,233797,2,4,0
66742,4,1,233797,233797,233798,0,1,0
66743,1,3,233798,233798,233801,0,3,0
66744,5,1,233803,233803,233804,0,1,2
66745,4,3,233807,233807,233810,0,3,3
66746,1,2,233808,233810,233812,2,4,0
66747,2,2,233810,233812,233814,2,4,0
66748,5,1,233815,233815,233816,0,1,1
66749,6,2,233821,233821,233823,0,2,5
66750,4,1,233825,233825,233826,0,1,2
66751,3,2,233828,233828,233830,0,2,2
66752,2,1,233830,233830,233831,0,1,0
66753,2,3,233832,233832,233835,0,3,1
66754,2,3,233834,233835,233838,1,4,0
66755,3,1,233837,233838,233839,1,2,0
66756,1,3,233838,233839,233842,1,4,0
66757,4,3,233842,233842,233845,0,3,0
66758,6,1,233848,233848,233849,0,1,3
66759,4,2,233852,233852,233854,0,2,3
66760,1,3,233853,233854,233857,1,4,0
66761,1,1,233854,233857,233858,3,4,0
66762,6,2,233860,233860,233862,0,2,2
66763,5,2,233865,233865,233867,0,2,3
66764,4,3,233869,233869,233872,0,3,2
66765,3,3,233872,233872,233875,0,3,0
66766,5,3,233877,233877,233880,0,3,2
66767,5,2,233882,233882,233884,0,2,2
66768,3,3,233885,233885,233888,0,3,1
66769,2,3,233887,233888,233891,1,4,0
66770,4,1,233891,233891,233892,0,1,0
66771,3,3,233894,233894,233897,0,3,2
66772,3,2,233897,233897,233899,0,2,0
66773,1,2,233898,233899,233901,1,3,0
66774,4,3,233902,233902,233905,0,3,1
66775,3,1,233905,233905,233906,0,1,0
66776,5,2,233910,233910,233912,0,2,4
66777,2,2,233912,233912,233914,0,2,0
66778,2,3,233914,233914,233917,0,3,0
66779,3,3,233917,233917,233920,0,3,0
66780,5,3,233922,233922,233925,0,3,2
66781,6,1,233928,233928,233929,0,1,3
66782,3,3,233931,233931,233934,0,3,2
66783,2,1,233933,233934,233935,1,2,0
66784,2,1,233935,233935,233936,0,1,0
66785,4,3,233939,233939,233942,0,3,3
66786,5,2,233944,233944,233946,0,2,2
66787,5,3,233949,233949,233952,0,3,3
66788,3,3,233952,233952,233955,0,3,0
66789,5,2,233957,233957,233959,0,2,2
66790,3,2,233960,233960,233962,0,2,1
66791,4,2,233964,233964,233966,0,2,2
66792,2,1,233966,233966,233967,0,1,0
66793,6,2,233972,233972,233974,0,2,5
66794,2,2,233974,233974,233976,0,2,0
66795,4,3,233978,233978,233981,0,3,2
66796,2,3,233980,233981,233984,1,4,0
66797,3,3,233983,233984,233987,1,4,0
66798,5,2,233988,233988,233990,0,2,1
66799,5,2,233993,233993,233995,0,2,3
66800,6,3,233999,233999,234002,0,3,4
66801,5,3,234004,234004,234007,0,3,2
66802,2,3,234006,234007,234010,1,4,0
66803,4,3,234010,234010,234013,0,3,0
66804,6,3,234016,234016,234019,0,3,3
66805,1,3,234017,234019,234022,2,5,0
66806,4,1,234021,234022,234023,1,2,0
66807,2,2,234023,234023,234025,0,2,0
66808,6,3,234029,234029,234032,0,3,4
66809,4,3,234033,234033,234036,0,3,1
66810,6,3,234039,234039,234042,0,3,3
66811,2,1,234041,234042,234043,1,2,0
66812,6,1,234047,234047,234048,0,1,4
66813,4,2,234051,234051,234053,0,2,3
66814,4,3,234055,234055,234058,0,3,2
66815,3,3,234058,234058,234061,0,3,0
66816,2,3,234060,234061,234064,1,4,0
66817,6,2,234066,234066,234068,0,2,2
66818,4,2,234070,234070,234072,0,2,2
66819,5,3,234075,234075,234078,0,3,3
66820,1,1,234076,234078,234079,2,3,0
66821,2,3,234078,234079,234082,1,4,0
66822,6,3,234084,234084,234087,0,3,2
66823,3,2,234087,234087,234089,0,2,0
66824,4,2,234091,234091,234093,0,2,2
66825,3,2,234094,234094,234096,0,2,1
66826,1,1,234095,234096,234097,1,2,0
66827,2,1,234097,234097,234098,0,1,0
66828,1,2,234098,234098,234100,0,2,0
66829,5,2,234103,234103,234105,0,2,3
66830,4,3,234107,234107,234110,0,3,2
66831,5,2,234112,234112,234114,0,2,2
66832,3,2,234115,234115,234117,0,2,1
66833,4,2,234119,234119,234121,0,2,2
66834,1,1,234120,234121,234122,1,2,0
66835,4,1,234124,234124,234125,0,1,2
66836,3,2,234127,234127,234129,0,2,2
66837,1,3,234128,234129,234132,1,4,0
66838,6,3,234134,234134,234137,0,3,2
66839,3,1,234137,234137,234138,0,1,0
66840,4,2,234141,234141,234143,0,2,3
66841,5,3,234146,234146,234149,0,3,3
66842,3,1,234149,234149,234150,0,1,0
66843,2,3,234151,234151,234154,0,3,1
66844,3,1,234154,234154,234155,0,1,0
66845,3,2,234157,234157,234159,0,2,2
66846,4,2,234161,234161,234163,0,2,2
66847,5,1,234166,234166,234167,0,1,3
66848,6,3,234172,234172,234175,0,3,5
66849,4,1,234176,234176,234177,0,1,1
66850,1,3,234177,234177,234180,0,3,0
66851,3,3,234180,234180,234183,0,3,0
66852,4,1,234184,234184,234185,0,1,1
66853,1,2,234185,234185,234187,0,2,0
66854,3,3,234188,234188,234191,0,3,1
66855,5,2,234193,234193,234195,0,2,2
66856,4,1,234197,234197,234198,0,1,2
66857,5,3,234202,234202,234205,0,3,4
66858,2,1,234204,234205,234206,1,2,0
66859,6,2,234210,234210,234212,0,2,4
66860,5,1,234215,234215,234216,0,1,3
66861,1,2,234216,234216,234218,0,2,0
66862,6,1,234222,234222,234223,0,1,4
66863,1,2,234223,234223,234225,0,2,0
66864,1,2,234224,234225,234227,1,3,0
66865,3,2,234227,234227,234229,0,2,0
66866,5,3,234232,234232,234235,0,3,3
66867,3,3,234235,234235,234238,0,3,0
66868,2,1,234237,234238,234239,1,2,0
66869,4,2,234241,234241,234243,0,2,2
66870,3,1,234244,234244,234245,0,1,1
66871,1,1,234245,234245,234246,0,1,0
66872,1,1,234246,234246,234247,0,1,0
66873,3,2,234249,234249,234251,0,2,2
66874,4,1,234253,234253,234254,0,1,2
66875,6,2,234259,234259,234261,0,2,5
66876,1,3,234260,234261,234264,1,4,0
66877,2,3,234262,234264,234267,2,5,0
66878,4,3,234266,234267,234270,1,4,0
66879,5,2,234271,234271,234273,0,2,1
66880,2,2,234273,234273,234275,0,2,0
66881,4,2,234277,234277,234279,0,2,2
66882,5,3,234282,234282,234285,0,3,3
66883,2,3,234284,234285,234288,1,4,0
66884,5,1,234289,234289,234290,0,1,1
66885,6,3,234295,234295,234298,0,3,5
66886,3,3,234298,234298,234301,0,3,0
66887,5,1,234303,234303,234304,0,1,2
66888,5,3,234308,234308,234311,0,3,4
66889,1,3,234309,234311,234314,2,5,0
66890,3,2,234312,234314,234316,2,4,0
66891,4,1,234316,234316,234317,0,1,0
66892,6,1,234322,234322,234323,0,1,5
66893,1,2,234323,234323,234325,0,2,0
66894,1,1,234324,234325,234326,1,2,0
66895,1,2,234325,234326,234328,1,3,0
66896,5,3,234330,234330,234333,0,3,2
66897,2,1,234332,234333,234334,1,2,0
66898,6,2,234338,234338,234340,0,2,4
66899,3,2,234341,234341,234343,0,2,1
66900,3,1,234344,234344,234345,0,1,1
66901,6,1,234350,234350,234351,0,1,5
66902,5,1,234355,234355,234356,0,1,4
66903,4,1,234359,234359,234360,0,1,3
66904,4,1,234363,234363,234364,0,1,3
66905,1,1,234364,234364,234365,0,1,0
66906,6,3,234370,234370,234373,0,3,5
66907,2,2,234372,234373,234375,1,3,0
66908,1,3,234373,234375,234378,2,5,0
66909,5,2,234378,234378,234380,0,2,0
66910,3,1,234381,234381,234382,0,1,1
66911,5,3,234386,234386,234389,0,3,4
66912,1,2,234387,234389,234391,2,4,0
66913,4,3,234391,234391,234394,0,3,0
66914,2,3,234393,234394,234397,1,4,0
66915,6,1,234399,234399,234400,0,1,2
66916,4,1,234403,234403,234404,0,1,3
66917,4,2,234407,234407,234409,0,2,3
66918,1,2,234408,234409,234411,1,3,0
66919,4,2,234412,234412,234414,0,2,1
66920,1,2,234413,234414,234416,1,3,0
66921,5,2,234418,234418,234420,0,2,2
66922,4,2,234422,234422,234424,0,2,2
66923,5,1,234427,234427,234428,0,1,3
66924,2,3,234429,234429,234432,0,3,1
66925,2,3,234431,234432,234435,1,4,0
66926,6,3,234437,234437,234440,0,3,2
66927,1,1,234438,234440,234441,2,3,0
66928,2,3,234440,234441,234444,1,4,0
66929,6,1,234446,234446,234447,0,1,2
66930,3,2,234449,234449,234451,0,2,2
66931,1,2,234450,234451,234453,1,3,0
66932,4,2,234454,234454,234456,0,2,1
66933,3,1,234457,234457,234458,0,1,1
66934,2,1,234459,234459,234460,0,1,1
66935,2,2,234461,234461,234463,0,2,1
66936,1,2,234462,234463,234465,1,3,0
66937,2,1,234464,234465,234466,1,2,0
66938,3,2,234467,234467,234469,0,2,1
66939,1,1,234468,234469,234470,1,2,0
66940,5,2,234473,234473,234475,0,2,3
66941,4,2,234477,234477,234479,0,2,2
66942,2,1,234479,234479,234480,0,1,0
66943,4,2,234483,234483,234485,0,2,3
66944,2,1,234485,234485,234486,0,1,0
66945,6,3,234491,234491,234494,0,3,5
66946,4,3,234495,234495,234498,0,3,1
66947,1,1,234496,234498,234499,2,3,0
66948,4,1,234500,234500,234501,0,1,1
66949,2,2,234502,234502,234504,0,2,1
66950,5,1,234507,234507,234508,0,1,3
66951,2,1,234509,234509,234510,0,1,1
66952,3,3,234512,234512,234515,0,3,2
66953,5,3,234517,234517,234520,0,3,2
66954,2,3,234519,234520,234523,1,4,0
66955,4,2,234523,234523,234525,0,2,0
66956,5,3,234528,234528,234531,0,3,3
66957,3,1,234531,234531,234532,0,1,0
66958,3,3,234534,234534,234537,0,3,2
66959,6,1,234540,234540,234541,0,1,3
66960,1,3,234541,234541,234544,0,3,0
66961,4,2,234545,234545,234547,0,2,1
66962,5,1,234550,234550,234551,0,1,3
66963,1,2,234551,234551,234553,0,2,0
66964,1,1,234552,234553,234554,1,2,0
66965,6,1,234558,234558,234559,0,1,4
66966,5,1,234563,234563,234564,0,1,4
66967,5,2,234568,234568,234570,0,2,4
66968,1,1,234569,234570,234571,1,2,0
66969,2,3,234571,234571,234574,0,3,0
66970,3,1,234574,234574,234575,0,1,0
66971,4,3,234578,234578,234581,0,3,3
66972,4,2,234582,234582,234584,0,2,1
66973,2,2,234584,234584,234586,0,2,0
66974,3,3,234587,234587,234590,0,3,1
66975,1,3,234588,234590,234593,2,5,0
66976,2,2,234590,234593,234595,3,5,0
66977,1,3,234591,234595,234598,4,7,0
66978,3,1,234594,234598,234599,4,5,0
66979,5,1,234599,234599,234600,0,1,0
66980,6,2,234605,234605,234607,0,2,5
66981,4,2,234609,234609,234611,0,2,2
66982,1,2,234610,234611,234613,1,3,0
66983,6,3,234616,234616,234619,0,3,3
66984,4,1,234620,234620,234621,0,1,1
66985,6,3,234626,234626,234629,0,3,5
66986,5,3,234631,234631,234634,0,3,2
66987,4,3,234635,234635,234638,0,3,1
66988,1,1,234636,234638,234639,2,3,0
66989,5,3,234641,234641,234644,0,3,2
66990,2,2,234643,234644,234646,1,3,0
66991,1,3,234644,234646,234649,2,5,0
66992,5,1,234649,234649,234650,0,1,0
66993,4,3,234653,234653,234656,0,3,3
66994,5,3,234658,234658,234661,0,3,2
66995,2,3,234660,234661,234664,1,4,0
66996,3,3,234663,234664,234667,1,4,0
66997,6,1,234669,234669,234670,0,1,2
66998,2,2,234671,234671,234673,0,2,1
66999,4,1,234675,234675,234676,0,1,2
67000,1,1,234676,234676,234677,0,1,0
67001,5,2,234681,234681,234683,0,2,4
67002,5,3,234686,234686,234689,0,3,3
67003,5,2,234691,234691,234693,0,2,2
67004,3,3,234694,234694,234697,0,3,1
67005,2,1,234696,234697,234698,1,2,0
67006,5,2,234701,234701,234703,0,2,3
67007,2,3,234703,234703,234706,0,3,0
67008,3,1,234706,234706,234707,0,1,0
67009,4,1,234710,234710,234711,0,1,3
67010,6,3,234716,234716,234719,0,3,5
67011,1,2,234717,234719,234721,2,4,0
67012,2,1,234719,234721,234722,2,3,0
67013,3,1,234722,234722,234723,0,1,0
67014,1,3,234723,234723,234726,0,3,0
67015,2,2,234725,234726,234728,1,3,0
67016,4,3,234729,234729,234732,0,3,1
67017,5,1,234734,234734,234735,0,1,2
67018,1,1,234735,234735,234736,0,1,0
67019,1,2,234736,234736,234738,0,2,0
67020,5,3,234741,234741,234744,0,3,3
67021,5,2,234746,234746,234748,0,2,2
67022,3,3,234749,234749,234752,0,3,1
67023,3,3,234752,234752,234755,0,3,0
67024,4,2,234756,234756,234758,0,2,1
67025,4,1,234760,234760,234761,0,1,2
67026,5,1,234765,234765,234766,0,1,4
67027,1,1,234766,234766,234767,0,1,0
67028,3,3,234769,234769,234772,0,3,2
67029,4,1,234773,234773,234774,0,1,1
67030,6,2,234779,234779,234781,0,2,5
67031,3,2,234782,234782,234784,0,2,1
67032,6,3,234788,234788,234791,0,3,4
67033,1,1,234789,234791,234792,2,3,0
67034,6,3,234795,234795,234798,0,3,3
67035,4,3,234799,234799,234802,0,3,1
67036,1,3,234800,234802,234805,2,5,0
67037,6,2,234806,234806,234808,0,2,1
67038,4,2,234810,234810,234812,0,2,2
67039,5,2,234815,234815,234817,0,2,3
67040,2,1,234817,234817,234818,0,1,0
67041,3,3,234820,234820,234823,0,3,2
67042,6,2,234826,234826,234828,0,2,3
67043,6,1,234832,234832,234833,0,1,4
67044,4,3,234836,234836,234839,0,3,3
67045,5,3,234841,234841,234844,0,3,2
67046,5,2,234846,234846,234848,0,2,2
67047,5,1,234851,234851,234852,0,1,3
67048,6,1,234857,234857,234858,0,1,5
67049,3,3,234860,234860,234863,0,3,2
67050,4,1,234864,234864,234865,0,1,1
67051,2,1,234866,234866,234867,0,1,1
67052,2,3,234868,234868,234871,0,3,1
67053,4,2,234872,234872,234874,0,2,1
67054,3,1,234875,234875,234876,0,1,1
67055,6,1,234881,234881,234882,0,1,5
67056,6,1,234887,234887,234888,0,1,5
67057,1,2,234888,234888,234890,0,2,0
67058,1,2,234889,234890,234892,1,3,0
67059,3,1,234892,234892,234893,0,1,0
67060,4,2,234896,234896,234898,0,2,3
67061,1,1,234897,234898,234899,1,2,0
67062,2,3,234899,234899,234902,0,3,0
67063,6,3,234905,234905,234908,0,3,3
67064,6,1,234911,234911,234912,0,1,3
67065,5,1,234916,234916,234917,0,1,4
67066,4,2,234920,234920,234922,0,2,3
67067,5,1,234925,234925,234926,0,1,3
67068,4,1,234929,234929,234930,0,1,3
67069,3,1,234932,234932,234933,0,1,2
67070,6,2,234938,234938,234940,0,2,5
67071,2,1,234940,234940,234941,0,1,0
67072,5,3,234945,234945,234948,0,3,4
67073,2,3,234947,234948,234951,1,4,0
67074,4,2,234951,234951,234953,0,2,0
67075,3,3,234954,234954,234957,0,3,1
67076,1,1,234955,234957,234958,2,3,0
67077,4,3,234959,234959,234962,0,3,1
67078,6,1,234965,234965,234966,0,1,3
67079,1,3,234966,234966,234969,0,3,0
67080,5,3,234971,234971,234974,0,3,2
67081,6,3,234977,234977,234980,0,3,3
67082,5,3,234982,234982,234985,0,3,2
67083,4,1,234986,234986,234987,0,1,1
67084,6,2,234992,234992,234994,0,2,5
67085,6,1,234998,234998,234999,0,1,4
67086,5,2,235003,235003,235005,0,2,4
67087,1,2,235004,235005,235007,1,3,0
67088,2,1,235006,235007,235008,1,2,0
67089,4,3,235010,235010,235013,0,3,2
67090,5,1,235015,235015,235016,0,1,2
67091,2,3,235017,235017,235020,0,3,1
67092,5,2,235022,235022,235024,0,2,2
67093,2,1,235024,235024,235025,0,1,0
67094,1,1,235025,235025,235026,0,1,0
67095,6,2,235031,235031,235033,0,2,5
67096,5,2,235036,235036,235038,0,2,3
67097,1,3,235037,235038,235041,1,4,0
67098,4,1,235041,235041,235042,0,1,0
67099,5,1,235046,235046,235047,0,1,4
67100,4,3,235050,235050,235053,0,3,3
67101,2,2,235052,235053,235055,1,3,0
67102,1,1,235053,235055,235056,2,3,0
67103,3,3,235056,235056,235059,0,3,0
67104,4,2,235060,235060,235062,0,2,1
67105,1,2,235061,235062,235064,1,3,0
67106,5,3,235066,235066,235069,0,3,2
67107,4,3,235070,235070,235073,0,3,1
67108,1,1,235071,235073,235074,2,3,0
67109,6,1,235077,235077,235078,0,1,3
67110,5,3,235082,235082,235085,0,3,4
67111,6,3,235088,235088,235091,0,3,3
67112,1,2,235089,235091,235093,2,4,0
67113,2,3,235091,235093,235096,2,5,0
67114,1,1,235092,235096,235097,4,5,0
67115,6,1,235098,235098,235099,0,1,1
67116,4,3,235102,235102,235105,0,3,3
67117,6,1,235108,235108,235109,0,1,3
67118,4,2,235112,235112,235114,0,2,3
67119,5,2,235117,235117,235119,0,2,3
67120,6,3,235123,235123,235126,0,3,4
67121,1,1,235124,235126,235127,2,3,0
67122,6,3,235130,235130,235133,0,3,3
67123,1,3,235131,235133,235136,2,5,0
67124,5,3,235136,235136,235139,0,3,0
67125,1,3,235137,235139,235142,2,5,0
67126,5,3,235142,235142,235145,0,3,0
67127,6,3,235148,235148,235151,0,3,3
67128,1,3,235149,235151,235154,2,5,0
67129,4,3,235153,235154,235157,1,4,0
67130,6,1,235159,235159,235160,0,1,2
67131,4,1,235163,235163,235164,0,1,3
67132,6,2,235169,235169,235171,0,2,5
67133,6,1,235175,235175,235176,0,1,4
67134,4,1,235179,235179,235180,0,1,3
67135,4,1,235183,235183,235184,0,1,3
67136,4,3,235187,235187,235190,0,3,3
67137,1,2,235188,235190,235192,2,4,0
67138,4,2,235192,235192,235194,0,2,0
67139,4,3,235196,235196,235199,0,3,2
67140,5,1,235201,235201,235202,0,1,2
67141,5,3,235206,235206,235209,0,3,4
67142,6,3,235212,235212,235215,0,3,3
67143,4,2,235216,235216,235218,0,2,1
67144,2,1,235218,235218,235219,0,1,0
67145,5,1,235223,235223,235224,0,1,4
67146,6,3,235229,235229,235232,0,3,5
67147,1,1,235230,235232,235233,2,3,0
67148,5,2,235235,235235,235237,0,2,2
67149,5,1,235240,235240,235241,0,1,3
67150,5,2,235245,235245,235247,0,2,4
67151,4,2,235249,235249,235251,0,2,2
67152,4,3,235253,235253,235256,0,3,2
67153,1,1,235254,235256,235257,2,3,0
67154,3,3,235257,235257,235260,0,3,0
67155,5,1,235262,235262,235263,0,1,2
67156,5,1,235267,235267,235268,0,1,4
67157,6,2,235273,235273,235275,0,2,5
67158,2,2,235275,235275,235277,0,2,0
67159,1,3,235276,235277,235280,1,4,0
67160,6,2,235282,235282,235284,0,2,2
67161,6,1,235288,235288,235289,0,1,4
67162,1,3,235289,235289,235292,0,3,0
67163,1,1,235290,235292,235293,2,3,0
67164,2,1,235292,235293,235294,1,2,0
67165,6,3,235298,235298,235301,0,3,4
67166,4,2,235302,235302,235304,0,2,1
67167,6,3,235308,235308,235311,0,3,4
67168,1,2,235309,235311,235313,2,4,0
67169,4,3,235313,235313,235316,0,3,0
67170,3,2,235316,235316,235318,0,2,0
67171,1,3,235317,235318,235321,1,4,0
67172,2,3,235319,235321,235324,2,5,0
67173,1,1,235320,235324,235325,4,5,0
67174,6,2,235326,235326,235328,0,2,1
67175,4,1,235330,235330,235331,0,1,2
67176,3,1,235333,235333,235334,0,1,2
67177,1,2,235334,235334,235336,0,2,0
67178,6,3,235340,235340,235343,0,3,4
67179,6,2,235346,235346,235348,0,2,3
67180,4,3,235350,235350,235353,0,3,2
67181,5,2,235355,235355,235357,0,2,2
67182,6,1,235361,235361,235362,0,1,4
67183,5,2,235366,235366,235368,0,2,4
67184,5,3,235371,235371,235374,0,3,3
67185,1,2,235372,235374,235376,2,4,0
67186,2,2,235374,235376,235378,2,4,0
67187,6,2,235380,235380,235382,0,2,2
67188,2,1,235382,235382,235383,0,1,0
67189,4,3,235386,235386,235389,0,3,3
67190,6,1,235392,235392,235393,0,1,3
67191,2,3,235394,235394,235397,0,3,1
67192,5,3,235399,235399,235402,0,3,2
67193,2,1,235401,235402,235403,1,2,0
67194,5,1,235406,235406,235407,0,1,3
67195,5,2,235411,235411,235413,0,2,4
67196,6,1,235417,235417,235418,0,1,4
67197,2,1,235419,235419,235420,0,1,1
67198,1,2,235420,235420,235422,0,2,0
67199,1,3,235421,235422,235425,1,4,0
67200,3,3,235424,235425,235428,1,4,0
67201,3,1,235427,235428,235429,1,2,0
67202,5,3,235432,235432,235435,0,3,3
67203,4,2,235436,235436,235438,0,2,1
67204,2,2,235438,235438,235440,0,2,0
67205,2,1,235440,235440,235441,0,1,0
67206,5,3,235445,235445,235448,0,3,4
67207,6,3,235451,235451,235454,0,3,3
67208,3,3,235454,235454,235457,0,3,0
67209,1,1,235455,235457,235458,2,3,0
67210,3,2,235458,235458,235460,0,2,0
67211,3,2,235461,235461,235463,0,2,1
67212,3,3,235464,235464,235467,0,3,1
67213,1,2,235465,235467,235469,2,4,0
67214,6,3,235471,235471,235474,0,3,2
67215,6,2,235477,235477,235479,0,2,3
67216,1,1,235478,235479,235480,1,2,0
67217,3,2,235481,235481,235483,0,2,1
67218,6,2,235487,235487,235489,0,2,4
67219,2,3,235489,235489,235492,0,3,0
67220,3,2,235492,235492,235494,0,2,0
67221,2,3,235494,235494,235497,0,3,0
67222,6,2,235500,235500,235502,0,2,3
67223,1,2,235501,235502,235504,1,3,0
67224,4,3,235505,235505,235508,0,3,1
67225,4,2,235509,235509,235511,0,2,1
67226,6,2,235515,235515,235517,0,2,4
67227,6,2,235521,235521,235523,0,2,4
67228,3,2,235524,235524,235526,0,2,1
67229,3,1,235527,235527,235528,0,1,1
67230,5,1,235532,235532,235533,0,1,4
67231,3,3,235535,235535,235538,0,3,2
67232,6,2,235541,235541,235543,0,2,3
67233,4,2,235545,235545,235547,0,2,2
67234,6,2,235551,235551,235553,0,2,4
67235,3,2,235554,235554,235556,0,2,1
67236,6,3,235560,235560,235563,0,3,4
67237,1,2,235561,235563,235565,2,4,0
67238,4,3,235565,235565,235568,0,3,0
67239,3,1,235568,235568,235569,0,1,0
67240,3,2,235571,235571,235573,0,2,2
67241,3,2,235574,235574,235576,0,2,1
67242,1,1,235575,235576,235577,1,2,0
67243,3,1,235578,235578,235579,0,1,1
67244,3,3,235581,235581,235584,0,3,2
67245,4,3,235585,235585,235588,0,3,1
67246,3,1,235588,235588,235589,0,1,0
67247,4,3,235592,235592,235595,0,3,3
67248,3,1,235595,235595,235596,0,1,0
67249,2,2,235597,235597,235599,0,2,1
67250,6,1,235603,235603,235604,0,1,4
67251,6,2,235609,235609,235611,0,2,5
67252,5,3,235614,235614,235617,0,3,3
67253,2,3,235616,235617,235620,1,4,0
67254,4,2,235620,235620,235622,0,2,0
67255,6,1,235626,235626,235627,0,1,4
67256,1,2,235627,235627,235629,0,2,0
67257,4,2,235631,235631,235633,0,2,2
67258,3,2,235634,235634,235636,0,2,1
67259,5,1,235639,235639,235640,0,1,3
67260,4,1,235643,235643,235644,0,1,3
67261,4,2,235647,235647,235649,0,2,3
67262,6,2,235653,235653,235655,0,2,4
67263,4,1,235657,235657,235658,0,1,2
67264,3,2,235660,235660,235662,0,2,2
67265,5,3,235665,235665,235668,0,3,3
67266,1,3,235666,235668,235671,2,5,0
67267,1,2,235667,235671,235673,4,6,0
67268,6,1,235673,235673,235674,0,1,0
67269,4,1,235677,235677,235678,0,1,3
67270,2,3,235679,235679,235682,0,3,1
67271,6,2,235685,235685,235687,0,2,3
67272,3,1,235688,235688,235689,0,1,1
67273,4,2,235692,235692,235694,0,2,3
67274,2,2,235694,235694,235696,0,2,0
67275,6,2,235700,235700,235702,0,2,4
67276,5,2,235705,235705,235707,0,2,3
67277,1,2,235706,235707,235709,1,3,0
67278,4,1,235710,235710,235711,0,1,1
67279,3,3,235713,235713,235716,0,3,2
67280,6,2,235719,235719,235721,0,2,3
67281,1,2,235720,235721,235723,1,3,0
67282,6,1,235726,235726,235727,0,1,3
67283,2,2,235728,235728,235730,0,2,1
67284,1,3,235729,235730,235733,1,4,0
67285,2,2,235731,235733,235735,2,4,0
67286,2,2,235733,235735,235737,2,4,0
67287,3,1,235736,235737,235738,1,2,0
67288,6,1,235742,235742,235743,0,1,4
67289,1,1,235743,235743,235744,0,1,0
67290,6,2,235749,235749,235751,0,2,5
67291,5,3,235754,235754,235757,0,3,3
67292,6,2,235760,235760,235762,0,2,3
67293,6,3,235766,235766,235769,0,3,4
67294,1,2,235767,235769,235771,2,4,0
67295,1,2,235768,235771,235773,3,5,0
67296,5,1,235773,235773,235774,0,1,0
67297,2,1,235775,235775,235776,0,1,1
67298,5,2,235780,235780,235782,0,2,4
67299,6,3,235786,235786,235789,0,3,4
67300,5,1,235791,235791,235792,0,1,2
67301,2,1,235793,235793,235794,0,1,1
67302,6,3,235799,235799,235802,0,3,5
67303,2,3,235801,235802,235805,1,4,0
67304,1,2,235802,235805,235807,3,5,0
67305,6,1,235808,235808,235809,0,1,1
67306,1,3,235809,235809,235812,0,3,0
67307,5,1,235814,235814,235815,0,1,2
67308,2,2,235816,235816,235818,0,2,1
67309,4,2,235820,235820,235822,0,2,2
67310,2,3,235822,235822,235825,0,3,0
67311,5,3,235827,235827,235830,0,3,2
67312,4,3,235831,235831,235834,0,3,1
67313,5,1,235836,235836,235837,0,1,2
67314,5,3,235841,235841,235844,0,3,4
67315,1,1,235842,235844,235845,2,3,0
67316,6,2,235848,235848,235850,0,2,3
67317,5,3,235853,235853,235856,0,3,3
67318,5,1,235858,235858,235859,0,1,2
67319,3,1,235861,235861,235862,0,1,2
67320,5,2,235866,235866,235868,0,2,4
67321,5,2,235871,235871,235873,0,2,3
67322,1,2,235872,235873,235875,1,3,0
67323,5,3,235877,235877,235880,0,3,2
67324,2,3,235879,235880,235883,1,4,0
67325,2,1,235881,235883,235884,2,3,0
67326,2,2,235883,235884,235886,1,3,0
67327,6,1,235889,235889,235890,0,1,3
67328,4,1,235893,235893,235894,0,1,3
67329,1,2,235894,235894,235896,0,2,0
67330,4,3,235898,235898,235901,0,3,2
67331,6,3,235904,235904,235907,0,3,3
67332,5,2,235909,235909,235911,0,2,2
67333,1,3,235910,235911,235914,1,4,0
67334,3,3,235913,235914,235917,1,4,0
67335,5,1,235918,235918,235919,0,1,1
67336,1,1,235919,235919,235920,0,1,0
67337,3,1,235922,235922,235923,0,1,2
67338,2,3,235924,235924,235927,0,3,1
67339,4,3,235928,235928,235931,0,3,1
67340,4,2,235932,235932,235934,0,2,1
67341,6,1,235938,235938,235939,0,1,4
67342,6,1,235944,235944,235945,0,1,5
67343,3,2,235947,235947,235949,0,2,2
67344,4,1,235951,235951,235952,0,1,2
67345,2,1,235953,235953,235954,0,1,1
67346,5,1,235958,235958,235959,0,1,4
67347,4,3,235962,235962,235965,0,3,3
67348,6,2,235968,235968,235970,0,2,3
67349,2,3,235970,235970,235973,0,3,0
67350,6,3,235976,235976,235979,0,3,3
67351,5,1,235981,235981,235982,0,1,2
67352,1,1,235982,235982,235983,0,1,0
67353,1,3,235983,235983,235986,0,3,0
67354,3,1,235986,235986,235987,0,1,0
67355,1,1,235987,235987,235988,0,1,0
67356,5,3,235992,235992,235995,0,3,4
67357,3,2,235995,235995,235997,0,2,0
67358,5,3,236000,236000,236003,0,3,3
67359,6,3,236006,236006,236009,0,3,3
67360,6,1,236012,236012,236013,0,1,3
67361,2,2,236014,236014,236016,0,2,1
67362,4,2,236018,236018,236020,0,2,2
67363,3,2,236021,236021,236023,0,2,1
67364,1,3,236022,236023,236026,1,4,0
67365,5,1,236027,236027,236028,0,1,1
67366,5,1,236032,236032,236033,0,1,4
67367,1,1,236033,236033,236034,0,1,0
67368,3,3,236036,236036,236039,0,3,2
67369,1,1,236037,236039,236040,2,3,0
67370,6,3,236043,236043,236046,0,3,3
67371,6,3,236049,236049,236052,0,3,3
67372,3,1,236052,236052,236053,0,1,0
67373,3,1,236055,236055,236056,0,1,2
67374,6,3,236061,236061,236064,0,3,5
67375,1,2,236062,236064,236066,2,4,0
67376,5,2,236067,236067,236069,0,2,1
67377,2,2,236069,236069,236071,0,2,0
67378,2,2,236071,236071,236073,0,2,0
67379,1,3,236072,236073,236076,1,4,0
67380,2,2,236074,236076,236078,2,4,0
67381,6,3,236080,236080,236083,0,3,2
67382,6,3,236086,236086,236089,0,3,3
67383,2,2,236088,236089,236091,1,3,0
67384,4,3,236092,236092,236095,0,3,1
67385,5,3,236097,236097,236100,0,3,2
67386,6,2,236103,236103,236105,0,2,3
67387,5,3,236108,236108,236111,0,3,3
67388,5,2,236113,236113,236115,0,2,2
67389,5,1,236118,236118,236119,0,1,3
67390,6,2,236124,236124,236126,0,2,5
67391,5,2,236129,236129,236131,0,2,3
67392,1,3,236130,236131,236134,1,4,0
67393,4,3,236134,236134,236137,0,3,0
67394,6,1,236140,236140,236141,0,1,3
67395,3,1,236143,236143,236144,0,1,2
67396,1,3,236144,236144,236147,0,3,0
67397,4,3,236148,236148,236151,0,3,1
67398,3,1,236151,236151,236152,0,1,0
67399,4,1,236155,236155,236156,0,1,3
67400,3,2,236158,236158,236160,0,2,2
67401,3,2,236161,236161,236163,0,2,1
67402,6,3,236167,236167,236170,0,3,4
67403,4,1,236171,236171,236172,0,1,1
67404,2,3,236173,236173,236176,0,3,1
67405,2,2,236175,236176,236178,1,3,0
67406,2,1,236177,236178,236179,1,2,0
67407,4,2,236181,236181,236183,0,2,2
67408,6,3,236187,236187,236190,0,3,4
67409,5,2,236192,236192,236194,0,2,2
67410,1,3,236193,236194,236197,1,4,0
67411,6,1,236199,236199,236200,0,1,2
67412,6,2,236205,236205,236207,0,2,5
67413,3,3,236208,236208,236211,0,3,1
67414,6,2,236214,236214,236216,0,2,3
67415,4,1,236218,236218,236219,0,1,2
67416,1,3,236219,236219,236222,0,3,0
67417,5,1,236224,236224,236225,0,1,2
67418,4,1,236228,236228,236229,0,1,3
67419,1,2,236229,236229,236231,0,2,0
67420,5,1,236234,236234,236235,0,1,3
67421,6,1,236240,236240,236241,0,1,5
67422,5,1,236245,236245,236246,0,1,4
67423,2,2,236247,236247,236249,0,2,1
67424,3,3,236250,236250,236253,0,3,1
67425,1,3,236251,236253,236256,2,5,0
67426,5,3,236256,236256,236259,0,3,0
67427,3,1,236259,236259,236260,0,1,0
67428,5,2,236264,236264,236266,0,2,4
67429,6,3,236270,236270,236273,0,3,4
67430,4,2,236274,236274,236276,0,2,1
67431,5,1,236279,236279,236280,0,1,3
67432,2,1,236281,236281,236282,0,1,1
67433,4,3,236285,236285,236288,0,3,3
67434,1,1,236286,236288,236289,2,3,0
67435,1,3,236287,236289,236292,2,5,0
67436,1,3,236288,236292,236295,4,7,0
67437,4,3,236292,236295,236298,3,6,0
67438,4,1,236296,236298,236299,2,3,0
67439,4,3,236300,236300,236303,0,3,1
67440,6,1,236306,236306,236307,0,1,3
67441,3,1,236309,236309,236310,0,1,2
67442,5,2,236314,236314,236316,0,2,4
67443,1,3,236315,236316,236319,1,4,0
67444,6,1,236321,236321,236322,0,1,2
67445,3,2,236324,236324,236326,0,2,2
67446,3,1,236327,236327,236328,0,1,1
67447,2,2,236329,236329,236331,0,2,1
67448,1,2,236330,236331,236333,1,3,0
67449,4,3,236334,236334,236337,0,3,1
67450,6,3,236340,236340,236343,0,3,3
67451,4,3,236344,236344,236347,0,3,1
67452,4,2,236348,236348,236350,0,2,1
67453,6,3,236354,236354,236357,0,3,4
67454,1,1,236355,236357,236358,2,3,0
67455,1,3,236356,236358,236361,2,5,0
67456,3,2,236359,236361,236363,2,4,0
67457,5,2,236364,236364,236366,0,2,1
67458,3,3,236367,236367,236370,0,3,1
67459,2,2,236369,236370,236372,1,3,0
67460,3,2,236372,236372,236374,0,2,0
67461,4,3,236376,236376,236379,0,3,2
67462,2,1,236378,236379,236380,1,2,0
67463,3,2,236381,236381,236383,0,2,1
67464,3,3,236384,236384,236387,0,3,1
67465,1,2,236385,236387,236389,2,4,0
67466,4,1,236389,236389,236390,0,1,0
67467,2,2,236391,236391,236393,0,2,1
67468,3,3,236394,236394,236397,0,3,1
67469,3,3,236397,236397,236400,0,3,0
67470,4,3,236401,236401,236404,0,3,1
67471,6,1,236407,236407,236408,0,1,3
67472,6,1,236413,236413,236414,0,1,5
67473,3,1,236416,236416,236417,0,1,2
67474,2,3,236418,236418,236421,0,3,1
67475,1,2,236419,236421,236423,2,4,0
67476,5,1,236424,236424,236425,0,1,1
67477,2,1,236426,236426,236427,0,1,1
67478,6,3,236432,236432,236435,0,3,5
67479,3,3,236435,236435,236438,0,3,0
67480,4,2,236439,236439,236441,0,2,1
67481,6,3,236445,236445,236448,0,3,4
67482,4,2,236449,236449,236451,0,2,1
67483,6,3,236455,236455,236458,0,3,4
67484,1,3,236456,236458,236461,2,5,0
67485,3,1,236459,236461,236462,2,3,0
67486,3,1,236462,236462,236463,0,1,0
67487,5,1,236467,236467,236468,0,1,4
67488,5,1,236472,236472,236473,0,1,4
67489,1,2,236473,236473,236475,0,2,0
67490,3,2,236476,236476,236478,0,2,1
67491,4,3,236480,236480,236483,0,3,2
67492,1,2,236481,236483,236485,2,4,0
67493,4,3,236485,236485,236488,0,3,0
67494,3,2,236488,236488,236490,0,2,0
67495,5,2,236493,236493,236495,0,2,3
67496,2,2,236495,236495,236497,0,2,0
67497,3,3,236498,236498,236501,0,3,1
67498,2,1,236500,236501,236502,1,2,0
67499,6,2,236506,236506,236508,0,2,4
67500,3,2,236509,236509,236511,0,2,1
67501,3,2,236512,236512,236514,0,2,1
67502,4,1,236516,236516,236517,0,1,2
67503,6,3,236522,236522,236525,0,3,5
67504,1,1,236523,236525,236526,2,3,0
67505,6,2,236529,236529,236531,0,2,3
67506,4,3,236533,236533,236536,0,3,2
67507,5,2,236538,236538,236540,0,2,2
67508,2,2,236540,236540,236542,0,2,0
67509,5,1,236545,236545,236546,0,1,3
67510,4,1,236549,236549,236550,0,1,3
67511,6,2,236555,236555,236557,0,2,5
67512,1,2,236556,236557,236559,1,3,0
67513,3,1,236559,236559,236560,0,1,0
67514,4,1,236563,236563,236564,0,1,3
67515,4,1,236567,236567,236568,0,1,3
67516,3,2,236570,236570,236572,0,2,2
67517,6,2,236576,236576,236578,0,2,4
67518,4,2,236580,236580,236582,0,2,2
67519,5,1,236585,236585,236586,0,1,3
67520,1,1,236586,236586,236587,0,1,0
67521,5,1,236591,236591,236592,0,1,4
67522,3,1,236594,236594,236595,0,1,2
67523,2,3,236596,236596,236599,0,3,1
67524,1,3,236597,236599,236602,2,5,0
67525,3,2,236600,236602,236604,2,4,0
67526,3,1,236603,236604,236605,1,2,0
67527,6,3,236609,236609,236612,0,3,4
67528,1,1,236610,236612,236613,2,3,0
67529,5,2,236615,236615,236617,0,2,2
67530,2,2,236617,236617,236619,0,2,0
67531,3,2,236620,236620,236622,0,2,1
67532,3,1,236623,236623,236624,0,1,1
67533,1,3,236624,236624,236627,0,3,0
67534,4,3,236628,236628,236631,0,3,1
67535,2,1,236630,236631,236632,1,2,0
67536,4,1,236634,236634,236635,0,1,2
67537,6,2,236640,236640,236642,0,2,5
67538,3,3,236643,236643,236646,0,3,1
67539,1,3,236644,236646,236649,2,5,0
67540,4,3,236648,236649,236652,1,4,0
67541,3,2,236651,236652,236654,1,3,0
67542,6,1,236657,236657,236658,0,1,3
67543,5,3,236662,236662,236665,0,3,4
67544,6,2,236668,236668,236670,0,2,3
67545,5,3,236673,236673,236676,0,3,3
67546,6,3,236679,236679,236682,0,3,3
67547,4,2,236683,236683,236685,0,2,1
67548,1,3,236684,236685,236688,1,4,0
67549,4,1,236688,236688,236689,0,1,0
67550,5,2,236693,236693,236695,0,2,4
67551,5,1,236698,236698,236699,0,1,3
67552,5,1,236703,236703,236704,0,1,4
67553,4,2,236707,236707,236709,0,2,3
67554,2,2,236709,236709,236711,0,2,0
67555,2,3,236711,236711,236714,0,3,0
67556,1,2,236712,236714,236716,2,4,0
67557,3,2,236715,236716,236718,1,3,0
67558,3,1,236718,236718,236719,0,1,0
67559,4,1,236722,236722,236723,0,1,3
67560,4,3,236726,236726,236729,0,3,3
67561,1,2,236727,236729,236731,2,4,0
67562,6,3,236733,236733,236736,0,3,2
67563,1,2,236734,236736,236738,2,4,0
67564,6,1,236740,236740,236741,0,1,2
67565,5,3,236745,236745,236748,0,3,4
67566,1,1,236746,236748,236749,2,3,0
67567,3,3,236749,236749,236752,0,3,0
67568,1,3,236750,236752,236755,2,5,0
67569,5,2,236755,236755,236757,0,2,0
67570,2,2,236757,236757,236759,0,2,0
67571,1,1,236758,236759,236760,1,2,0
67572,5,3,236763,236763,236766,0,3,3
67573,4,1,236767,236767,236768,0,1,1
67574,4,2,236771,236771,236773,0,2,3
67575,4,3,236775,236775,236778,0,3,2
67576,1,2,236776,236778,236780,2,4,0
67577,1,1,236777,236780,236781,3,4,0
67578,5,2,236782,236782,236784,0,2,1
67579,4,1,236786,236786,236787,0,1,2
67580,4,3,236790,236790,236793,0,3,3
67581,1,2,236791,236793,236795,2,4,0
67582,3,3,236794,236795,236798,1,4,0
67583,2,2,236796,236798,236800,2,4,0
67584,1,1,236797,236800,236801,3,4,0
67585,6,1,236803,236803,236804,0,1,2
67586,4,2,236807,236807,236809,0,2,3
67587,6,1,236813,236813,236814,0,1,4
67588,3,2,236816,236816,236818,0,2,2
67589,1,3,236817,236818,236821,1,4,0
67590,1,2,236818,236821,236823,3,5,0
67591,6,1,236824,236824,236825,0,1,1
67592,6,2,236830,236830,236832,0,2,5
67593,5,3,236835,236835,236838,0,3,3
67594,2,1,236837,236838,236839,1,2,0
67595,5,1,236842,236842,236843,0,1,3
67596,4,2,236846,236846,236848,0,2,3
67597,2,2,236848,236848,236850,0,2,0
67598,6,3,236854,236854,236857,0,3,4
67599,4,1,236858,236858,236859,0,1,1
67600,1,2,236859,236859,236861,0,2,0
67601,6,2,236865,236865,236867,0,2,4
67602,2,3,236867,236867,236870,0,3,0
67603,2,3,236869,236870,236873,1,4,0
67604,2,1,236871,236873,236874,2,3,0
67605,2,2,236873,236874,236876,1,3,0
67606,1,1,236874,236876,236877,2,3,0
67607,1,2,236875,236877,236879,2,4,0
67608,1,3,236876,236879,236882,3,6,0
67609,1,2,236877,236882,236884,5,7,0
67610,4,3,236881,236884,236887,3,6,0
67611,3,1,236884,236887,236888,3,4,0
67612,2,1,236886,236888,236889,2,3,0
67613,2,3,236888,236889,236892,1,4,0
67614,2,1,236890,236892,236893,2,3,0
67615,2,2,236892,236893,236895,1,3,0
67616,5,1,236897,236897,236898,0,1,2
67617,3,1,236900,236900,236901,0,1,2
67618,4,1,236904,236904,236905,0,1,3
67619,6,1,236910,236910,236911,0,1,5
67620,6,3,236916,236916,236919,0,3,5
67621,4,2,236920,236920,236922,0,2,1
67622,6,3,236926,236926,236929,0,3,4
67623,5,1,236931,236931,236932,0,1,2
67624,2,3,236933,236933,236936,0,3,1
67625,4,3,236937,236937,236940,0,3,1
67626,2,3,236939,236940,236943,1,4,0
67627,1,3,236940,236943,236946,3,6,0
67628,6,1,236946,236946,236947,0,1,0
67629,2,2,236948,236948,236950,0,2,1
67630,5,1,236953,236953,236954,0,1,3
67631,2,3,236955,236955,236958,0,3,1
67632,3,2,236958,236958,236960,0,2,0
67633,2,1,236960,236960,236961,0,1,0
67634,4,1,236964,236964,236965,0,1,3
67635,4,2,236968,236968,236970,0,2,3
67636,3,3,236971,236971,236974,0,3,1
67637,4,3,236975,236975,236978,0,3,1
67638,1,1,236976,236978,236979,2,3,0
67639,2,2,236978,236979,236981,1,3,0
67640,2,3,236980,236981,236984,1,4,0
67641,5,2,236985,236985,236987,0,2,1
67642,1,1,236986,236987,236988,1,2,0
67643,2,2,236988,236988,236990,0,2,0
67644,6,1,236994,236994,236995,0,1,4
67645,5,2,236999,236999,237001,0,2,4
67646,6,3,237005,237005,237008,0,3,4
67647,3,3,237008,237008,237011,0,3,0
67648,3,2,237011,237011,237013,0,2,0
67649,6,1,237017,237017,237018,0,1,4
67650,6,3,237023,237023,237026,0,3,5
67651,4,2,237027,237027,237029,0,2,1
67652,6,3,237033,237033,237036,0,3,4
67653,5,1,237038,237038,237039,0,1,2
67654,2,2,237040,237040,237042,0,2,1
67655,3,3,237043,237043,237046,0,3,1
67656,4,2,237047,237047,237049,0,2,1
67657,1,2,237048,237049,237051,1,3,0
67658,1,3,237049,237051,237054,2,5,0
67659,5,1,237054,237054,237055,0,1,0
67660,4,2,237058,237058,237060,0,2,3
67661,5,1,237063,237063,237064,0,1,3
67662,1,3,237064,237064,237067,0,3,0
67663,2,2,237066,237067,237069,1,3,0
67664,2,1,237068,237069,237070,1,2,0
67665,5,2,237073,237073,237075,0,2,3
67666,6,2,237079,237079,237081,0,2,4
67667,6,3,237085,237085,237088,0,3,4
67668,5,1,237090,237090,237091,0,1,2
67669,6,2,237096,237096,237098,0,2,5
67670,1,3,237097,237098,237101,1,4,0
67671,5,3,237102,237102,237105,0,3,1
67672,3,3,237105,237105,237108,0,3,0
67673,6,2,237111,237111,237113,0,2,3
67674,2,1,237113,237113,237114,0,1,0
67675,1,2,237114,237114,237116,0,2,0
67676,4,1,237118,237118,237119,0,1,2
67677,3,1,237121,237121,237122,0,1,2
67678,4,3,237125,237125,237128,0,3,3
67679,1,2,237126,237128,237130,2,4,0
67680,6,1,237132,237132,237133,0,1,2
67681,5,3,237137,237137,237140,0,3,4
67682,4,2,237141,237141,237143,0,2,1
67683,5,2,237146,237146,237148,0,2,3
67684,3,2,237149,237149,237151,0,2,1
67685,1,3,237150,237151,237154,1,4,0
67686,5,3,237155,237155,237158,0,3,1
67687,6,2,237161,237161,237163,0,2,3
67688,6,3,237167,237167,237170,0,3,4
67689,1,2,237168,237170,237172,2,4,0
67690,1,3,237169,237172,237175,3,6,0
67691,6,1,237175,237175,237176,0,1,0
67692,2,3,237177,237177,237180,0,3,1
67693,4,2,237181,237181,237183,0,2,1
67694,1,1,237182,237183,237184,1,2,0
67695,6,3,237188,237188,237191,0,3,4
67696,2,2,237190,237191,237193,1,3,0
67697,4,2,237194,237194,237196,0,2,1
67698,2,3,237196,237196,237199,0,3,0
67699,2,2,237198,237199,237201,1,3,0
67700,1,2,237199,237201,237203,2,4,0
67701,2,2,237201,237203,237205,2,4,0
67702,6,2,237207,237207,237209,0,2,2
67703,5,3,237212,237212,237215,0,3,3
67704,6,1,237218,237218,237219,0,1,3
67705,4,2,237222,237222,237224,0,2,3
67706,3,1,237225,237225,237226,0,1,1
67707,3,3,237228,237228,237231,0,3,2
67708,3,1,237231,237231,237232,0,1,0
67709,5,3,237236,237236,237239,0,3,4
67710,2,2,237238,237239,237241,1,3,0
67711,2,1,237240,237241,237242,1,2,0
67712,4,3,237244,237244,237247,0,3,2
67713,4,3,237248,237248,237251,0,3,1
67714,2,1,237250,237251,237252,1,2,0
67715,2,2,237252,237252,237254,0,2,0
67716,1,2,237253,237254,237256,1,3,0
67717,5,2,237258,237258,237260,0,2,2
67718,1,2,237259,237260,237262,1,3,0
67719,6,2,237265,237265,237267,0,2,3
67720,5,3,237270,237270,237273,0,3,3
67721,6,1,237276,237276,237277,0,1,3
67722,5,2,237281,237281,237283,0,2,4
67723,4,2,237285,237285,237287,0,2,2
67724,6,1,237291,237291,237292,0,1,4
67725,6,1,237297,237297,237298,0,1,5
67726,4,1,237301,237301,237302,0,1,3
67727,3,3,237304,237304,237307,0,3,2
67728,4,2,237308,237308,237310,0,2,1
67729,5,2,237313,237313,237315,0,2,3
67730,6,3,237319,237319,237322,0,3,4
67731,5,3,237324,237324,237327,0,3,2
67732,2,2,237326,237327,237329,1,3,0
67733,3,3,237329,237329,237332,0,3,0
67734,2,1,237331,237332,237333,1,2,0
67735,1,3,237332,237333,237336,1,4,0
67736,3,3,237335,237336,237339,1,4,0
67737,4,2,237339,237339,237341,0,2,0
67738,5,3,237344,237344,237347,0,3,3
67739,2,1,237346,237347,237348,1,2,0
67740,5,1,237351,237351,237352,0,1,3
67741,1,3,237352,237352,237355,0,3,0
67742,5,2,237357,237357,237359,0,2,2
67743,3,1,237360,237360,237361,0,1,1
67744,3,3,237363,237363,237366,0,3,2
67745,6,3,237369,237369,237372,0,3,3
67746,1,3,237370,237372,237375,2,5,0
67747,5,2,237375,237375,237377,0,2,0
67748,3,3,237378,237378,237381,0,3,1
67749,1,2,237379,237381,237383,2,4,0
67750,3,3,237382,237383,237386,1,4,0
67751,6,1,237388,237388,237389,0,1,2
67752,4,3,237392,237392,237395,0,3,3
67753,2,2,237394,237395,237397,1,3,0
67754,1,3,237395,237397,237400,2,5,0
67755,5,1,237400,237400,237401,0,1,0
67756,2,2,237402,237402,237404,0,2,1
67757,5,2,237407,237407,237409,0,2,3
67758,1,2,237408,237409,237411,1,3,0
67759,2,2,237410,237411,237413,1,3,0
67760,4,2,237414,237414,237416,0,2,1
67761,1,3,237415,237416,237419,1,4,0
67762,6,2,237421,237421,237423,0,2,2
67763,4,1,237425,237425,237426,0,1,2
67764,3,2,237428,237428,237430,0,2,2
67765,2,1,237430,237430,237431,0,1,0
67766,4,3,237434,237434,237437,0,3,3
67767,2,1,237436,237437,237438,1,2,0
67768,5,2,237441,237441,237443,0,2,3
67769,5,2,237446,237446,237448,0,2,3
67770,5,2,237451,237451,237453,0,2,3
67771,6,3,237457,237457,237460,0,3,4
67772,2,2,237459,237460,237462,1,3,0
67773,3,3,237462,237462,237465,0,3,0
67774,6,3,237468,237468,237471,0,3,3
67775,1,3,237469,237471,237474,2,5,0
67776,5,3,237474,237474,237477,0,3,0
67777,4,1,237478,237478,237479,0,1,1
67778,3,3,237481,237481,237484,0,3,2
67779,3,1,237484,237484,237485,0,1,0
67780,2,1,237486,237486,237487,0,1,1
67781,1,1,237487,237487,237488,0,1,0
67782,5,2,237492,237492,237494,0,2,4
67783,4,1,237496,237496,237497,0,1,2
67784,4,1,237500,237500,237501,0,1,3
67785,2,3,237502,237502,237505,0,3,1
67786,6,2,237508,237508,237510,0,2,3
67787,1,2,237509,237510,237512,1,3,0
67788,1,3,237510,237512,237515,2,5,0
67789,4,1,237514,237515,237516,1,2,0
67790,5,2,237519,237519,237521,0,2,3
67791,3,1,237522,237522,237523,0,1,1
67792,5,1,237527,237527,237528,0,1,4
67793,3,3,237530,237530,237533,0,3,2
67794,3,1,237533,237533,237534,0,1,0
67795,3,1,237536,237536,237537,0,1,2
67796,2,1,237538,237538,237539,0,1,1
67797,3,2,237541,237541,237543,0,2,2
67798,5,2,237546,237546,237548,0,2,3
67799,5,2,237551,237551,237553,0,2,3
67800,3,1,237554,237554,237555,0,1,1
67801,4,1,237558,237558,237559,0,1,3
67802,1,1,237559,237559,237560,0,1,0
67803,4,2,237563,237563,237565,0,2,3
67804,1,3,237564,237565,237568,1,4,0
67805,6,3,237570,237570,237573,0,3,2
67806,2,1,237572,237573,237574,1,2,0
67807,2,2,237574,237574,237576,0,2,0
67808,5,3,237579,237579,237582,0,3,3
67809,2,1,237581,237582,237583,1,2,0
67810,3,2,237584,237584,237586,0,2,1
67811,4,2,237588,237588,237590,0,2,2
67812,5,1,237593,237593,237594,0,1,3
67813,1,3,237594,237594,237597,0,3,0
67814,1,2,237595,237597,237599,2,4,0
67815,2,3,237597,237599,237602,2,5,0
67816,4,1,237601,237602,237603,1,2,0
67817,4,2,237605,237605,237607,0,2,2
67818,2,3,237607,237607,237610,0,3,0
67819,1,2,237608,237610,237612,2,4,0
67820,2,1,237610,237612,237613,2,3,0
67821,2,2,237612,237613,237615,1,3,0
67822,6,3,237618,237618,237621,0,3,3
67823,4,2,237622,237622,237624,0,2,1
67824,2,2,237624,237624,237626,0,2,0
67825,5,3,237629,237629,237632,0,3,3
67826,6,2,237635,237635,237637,0,2,3
67827,5,1,237640,237640,237641,0,1,3
67828,1,3,237641,237641,237644,0,3,0
67829,3,2,237644,237644,237646,0,2,0
67830,5,3,237649,237649,237652,0,3,3
67831,1,2,237650,237652,237654,2,4,0
67832,4,3,237654,237654,237657,0,3,0
67833,6,2,237660,237660,237662,0,2,3
67834,6,3,237666,237666,237669,0,3,4
67835,5,1,237671,237671,237672,0,1,2
67836,6,3,237677,237677,237680,0,3,5
67837,2,3,237679,237680,237683,1,4,0
67838,3,3,237682,237683,237686,1,4,0
67839,6,1,237688,237688,237689,0,1,2
67840,4,1,237692,237692,237693,0,1,3
67841,4,3,237696,237696,237699,0,3,3
67842,1,1,237697,237699,237700,2,3,0
67843,3,2,237700,237700,237702,0,2,0
67844,1,3,237701,237702,237705,1,4,0
67845,1,2,237702,237705,237707,3,5,0
67846,5,1,237707,237707,237708,0,1,0
67847,5,3,237712,237712,237715,0,3,4
67848,1,2,237713,237715,237717,2,4,0
67849,6,2,237719,237719,237721,0,2,2
67850,3,3,237722,237722,237725,0,3,1
67851,1,1,237723,237725,237726,2,3,0
67852,2,1,237725,237726,237727,1,2,0
67853,2,1,237727,237727,237728,0,1,0
67854,3,2,237730,237730,237732,0,2,2
67855,6,2,237736,237736,237738,0,2,4
67856,1,3,237737,237738,237741,1,4,0
67857,2,1,237739,237741,237742,2,3,0
67858,1,1,237740,237742,237743,2,3,0
67859,1,2,237741,237743,237745,2,4,0
67860,4,2,237745,237745,237747,0,2,0
67861,6,3,237751,237751,237754,0,3,4
67862,2,2,237753,237754,237756,1,3,0
67863,3,1,237756,237756,237757,0,1,0
67864,6,2,237762,237762,237764,0,2,5
67865,2,3,237764,237764,237767,0,3,0
67866,3,2,237767,237767,237769,0,2,0
67867,4,3,237771,237771,237774,0,3,2
67868,5,1,237776,237776,237777,0,1,2
67869,2,1,237778,237778,237779,0,1,1
67870,4,2,237782,237782,237784,0,2,3
67871,1,3,237783,237784,237787,1,4,0
67872,6,3,237789,237789,237792,0,3,2
67873,6,3,237795,237795,237798,0,3,3
67874,5,1,237800,237800,237801,0,1,2
67875,2,1,237802,237802,237803,0,1,1
67876,2,3,237804,237804,237807,0,3,1
67877,6,3,237810,237810,237813,0,3,3
67878,4,3,237814,237814,237817,0,3,1
67879,6,3,237820,237820,237823,0,3,3
67880,3,2,237823,237823,237825,0,2,0
67881,6,1,237829,237829,237830,0,1,4
67882,4,1,237833,237833,237834,0,1,3
67883,1,3,237834,237834,237837,0,3,0
67884,2,3,237836,237837,237840,1,4,0
67885,3,2,237839,237840,237842,1,3,0
67886,3,1,237842,237842,237843,0,1,0
67887,2,2,237844,237844,237846,0,2,1
67888,1,2,237845,237846,237848,1,3,0
67889,2,2,237847,237848,237850,1,3,0
67890,6,3,237853,237853,237856,0,3,3
67891,1,3,237854,237856,237859,2,5,0
67892,6,1,237860,237860,237861,0,1,1
67893,5,3,237865,237865,237868,0,3,4
67894,1,3,237866,237868,237871,2,5,0
67895,6,3,237872,237872,237875,0,3,1
67896,6,2,237878,237878,237880,0,2,3
67897,2,3,237880,237880,237883,0,3,0
67898,2,2,237882,237883,237885,1,3,0
67899,1,1,237883,237885,237886,2,3,0
67900,6,2,237889,237889,237891,0,2,3
67901,1,1,237890,237891,237892,1,2,0
67902,6,2,237896,237896,237898,0,2,4
67903,2,1,237898,237898,237899,0,1,0
67904,4,1,237902,237902,237903,0,1,3
67905,6,1,237908,237908,237909,0,1,5
67906,6,3,237914,237914,237917,0,3,5
67907,3,1,237917,237917,237918,0,1,0
67908,6,1,237923,237923,237924,0,1,5
67909,1,3,237924,237924,237927,0,3,0
67910,5,1,237929,237929,237930,0,1,2
67911,2,1,237931,237931,237932,0,1,1
67912,5,1,237936,237936,237937,0,1,4
67913,3,2,237939,237939,237941,0,2,2
67914,2,1,237941,237941,237942,0,1,0
67915,3,1,237944,237944,237945,0,1,2
67916,1,2,237945,237945,237947,0,2,0
67917,1,3,237946,237947,237950,1,4,0
67918,2,2,237948,237950,237952,2,4,0
67919,1,3,237949,237952,237955,3,6,0
67920,6,1,237955,237955,237956,0,1,0
67921,3,3,237958,237958,237961,0,3,2
67922,1,1,237959,237961,237962,2,3,0
67923,2,2,237961,237962,237964,1,3,0
67924,5,3,237966,237966,237969,0,3,2
67925,5,2,237971,237971,237973,0,2,2
67926,1,1,237972,237973,237974,1,2,0
67927,6,1,237978,237978,237979,0,1,4
67928,6,3,237984,237984,237987,0,3,5
67929,4,2,237988,237988,237990,0,2,1
67930,1,3,237989,237990,237993,1,4,0
67931,1,2,237990,237993,237995,3,5,0
67932,1,2,237991,237995,237997,4,6,0
67933,5,3,237996,237997,238000,1,4,0
67934,1,3,237997,238000,238003,3,6,0
67935,3,2,238000,238003,238005,3,5,0
67936,6,2,238006,238006,238008,0,2,1
67937,3,2,238009,238009,238011,0,2,1
67938,5,3,238014,238014,238017,0,3,3
67939,3,2,238017,238017,238019,0,2,0
67940,4,1,238021,238021,238022,0,1,2
67941,1,3,238022,238022,238025,0,3,0
67942,1,1,238023,238025,238026,2,3,0
67943,2,3,238025,238026,238029,1,4,0
67944,4,3,238029,238029,238032,0,3,0
67945,6,2,238035,238035,238037,0,2,3
67946,4,2,238039,238039,238041,0,2,2
67947,6,2,238045,238045,238047,0,2,4
67948,5,2,238050,238050,238052,0,2,3
67949,6,3,238056,238056,238059,0,3,4
67950,4,3,238060,238060,238063,0,3,1
67951,4,3,238064,238064,238067,0,3,1
67952,6,1,238070,238070,238071,0,1,3
67953,6,2,238076,238076,238078,0,2,5
67954,6,3,238082,238082,238085,0,3,4
67955,5,2,238087,238087,238089,0,2,2
67956,1,2,238088,238089,238091,1,3,0
67957,5,1,238093,238093,238094,0,1,2
67958,1,3,238094,238094,238097,0,3,0
67959,2,3,238096,238097,238100,1,4,0
67960,6,2,238102,238102,238104,0,2,2
67961,3,1,238105,238105,238106,0,1,1
67962,4,2,238109,238109,238111,0,2,3
67963,4,1,238113,238113,238114,0,1,2
67964,3,3,238116,238116,238119,0,3,2
67965,5,2,238121,238121,238123,0,2,2
67966,4,2,238125,238125,238127,0,2,2
67967,2,3,238127,238127,238130,0,3,0
67968,6,1,238133,238133,238134,0,1,3
67969,2,1,238135,238135,238136,0,1,1
67970,1,3,238136,238136,238139,0,3,0
67971,6,3,238142,238142,238145,0,3,3
67972,4,2,238146,238146,238148,0,2,1
67973,6,3,238152,238152,238155,0,3,4
67974,3,1,238155,238155,238156,0,1,0
67975,6,2,238161,238161,238163,0,2,5
67976,5,3,238166,238166,238169,0,3,3
67977,1,1,238167,238169,238170,2,3,0
67978,1,3,238168,238170,238173,2,5,0
67979,3,2,238171,238173,238175,2,4,0
67980,2,2,238173,238175,238177,2,4,0
67981,5,1,238178,238178,238179,0,1,1
67982,5,2,238183,238183,238185,0,2,4
67983,6,1,238189,238189,238190,0,1,4
67984,2,3,238191,238191,238194,0,3,1
67985,5,2,238196,238196,238198,0,2,2
67986,4,3,238200,238200,238203,0,3,2
67987,2,1,238202,238203,238204,1,2,0
67988,6,3,238208,238208,238211,0,3,4
67989,2,2,238210,238211,238213,1,3,0
67990,5,1,238215,238215,238216,0,1,2
67991,1,1,238216,238216,238217,0,1,0
67992,1,3,238217,238217,238220,0,3,0
67993,4,3,238221,238221,238224,0,3,1
67994,6,2,238227,238227,238229,0,2,3
67995,5,2,238232,238232,238234,0,2,3
67996,6,2,238238,238238,238240,0,2,4
67997,4,2,238242,238242,238244,0,2,2
67998,3,1,238245,238245,238246,0,1,1
67999,4,3,238249,238249,238252,0,3,3
68000,4,2,238253,238253,238255,0,2,1
68001,2,2,238255,238255,238257,0,2,0
68002,4,1,238259,238259,238260,0,1,2
68003,5,1,238264,238264,238265,0,1,4
68004,5,3,238269,238269,238272,0,3,4
68005,3,1,238272,238272,238273,0,1,0
68006,3,2,238275,238275,238277,0,2,2
68007,2,1,238277,238277,238278,0,1,0
68008,1,3,238278,238278,238281,0,3,0
68009,1,1,238279,238281,238282,2,3,0
68010,6,2,238285,238285,238287,0,2,3
68011,3,2,238288,238288,238290,0,2,1
68012,1,2,238289,238290,238292,1,3,0
68013,3,3,238292,238292,238295,0,3,0
68014,2,1,238294,238295,238296,1,2,0
68015,6,1,238300,238300,238301,0,1,4
68016,3,3,238303,238303,238306,0,3,2
68017,6,2,238309,238309,238311,0,2,3
68018,3,1,238312,238312,238313,0,1,1
68019,1,2,238313,238313,238315,0,2,0
68020,5,3,238318,238318,238321,0,3,3
68021,2,3,238320,238321,238324,1,4,0
68022,1,1,238321,238324,238325,3,4,0
68023,5,3,238326,238326,238329,0,3,1
68024,6,3,238332,238332,238335,0,3,3
68025,4,2,238336,238336,238338,0,2,1
68026,5,3,238341,238341,238344,0,3,3
68027,3,3,238344,238344,238347,0,3,0
68028,6,3,238350,238350,238353,0,3,3
68029,5,2,238355,238355,238357,0,2,2
68030,4,1,238359,238359,238360,0,1,2
68031,2,1,238361,238361,238362,0,1,1
68032,2,3,238363,238363,238366,0,3,1
68033,6,2,238369,238369,238371,0,2,3
68034,5,2,238374,238374,238376,0,2,3
68035,6,2,238380,238380,238382,0,2,4
68036,3,3,238383,238383,238386,0,3,1
68037,1,2,238384,238386,238388,2,4,0
68038,5,3,238389,238389,238392,0,3,1
68039,5,2,238394,238394,238396,0,2,2
68040,2,3,238396,238396,238399,0,3,0
68041,4,2,238400,238400,238402,0,2,1
68042,1,3,238401,238402,238405,1,4,0
68043,5,1,238406,238406,238407,0,1,1
68044,4,3,238410,238410,238413,0,3,3
68045,4,2,238414,238414,238416,0,2,1
68046,3,1,238417,238417,238418,0,1,1
68047,6,2,238423,238423,238425,0,2,5
68048,3,2,238426,238426,238428,0,2,1
68049,3,2,238429,238429,238431,0,2,1
68050,1,1,238430,238431,238432,1,2,0
68051,2,1,238432,238432,238433,0,1,0
68052,2,3,238434,238434,238437,0,3,1
68053,6,1,238440,238440,238441,0,1,3
68054,1,3,238441,238441,238444,0,3,0
68055,3,2,238444,238444,238446,0,2,0
68056,1,3,238445,238446,238449,1,4,0
68057,2,2,238447,238449,238451,2,4,0
68058,2,3,238449,238451,238454,2,5,0
68059,1,3,238450,238454,238457,4,7,0
68060,2,3,238452,238457,238460,5,8,0
68061,5,2,238457,238460,238462,3,5,0
68062,6,3,238463,238463,238466,0,3,1
68063,5,1,238468,238468,238469,0,1,2
68064,5,2,238473,238473,238475,0,2,4
68065,1,3,238474,238475,238478,1,4,0
68066,4,2,238478,238478,238480,0,2,0
68067,1,1,238479,238480,238481,1,2,0
68068,4,2,238483,238483,238485,0,2,2
68069,3,2,238486,238486,238488,0,2,1
68070,2,3,238488,238488,238491,0,3,0
68071,5,1,238493,238493,238494,0,1,2
68072,2,3,238495,238495,238498,0,3,1
68073,2,3,238497,238498,238501,1,4,0
68074,6,3,238503,238503,238506,0,3,2
68075,2,1,238505,238506,238507,1,2,0
68076,1,1,238506,238507,238508,1,2,0
68077,4,1,238510,238510,238511,0,1,2
68078,3,2,238513,238513,238515,0,2,2
68079,6,2,238519,238519,238521,0,2,4
68080,1,2,238520,238521,238523,1,3,0
68081,3,1,238523,238523,238524,0,1,0
68082,2,1,238525,238525,238526,0,1,1
68083,5,3,238530,238530,238533,0,3,4
68084,2,3,238532,238533,238536,1,4,0
68085,4,3,238536,238536,238539,0,3,0
68086,5,3,238541,238541,238544,0,3,2
68087,2,2,238543,238544,238546,1,3,0
68088,2,1,238545,238546,238547,1,2,0
68089,1,1,238546,238547,238548,1,2,0
68090,3,1,238549,238549,238550,0,1,1
68091,1,2,238550,238550,238552,0,2,0
68092,6,2,238556,238556,238558,0,2,4
68093,1,1,238557,238558,238559,1,2,0
68094,1,3,238558,238559,238562,1,4,0
68095,3,2,238561,238562,238564,1,3,0
68096,6,3,238567,238567,238570,0,3,3
68097,3,1,238570,238570,238571,0,1,0
68098,1,2,238571,238571,238573,0,2,0
68099,4,3,238575,238575,238578,0,3,2
68100,4,2,238579,238579,238581,0,2,1
68101,5,3,238584,238584,238587,0,3,3
68102,3,1,238587,238587,238588,0,1,0
68103,4,3,238591,238591,238594,0,3,3
68104,5,3,238596,238596,238599,0,3,2
68105,3,3,238599,238599,238602,0,3,0
68106,4,3,238603,238603,238606,0,3,1
68107,3,1,238606,238606,238607,0,1,0
68108,4,3,238610,238610,238613,0,3,3
68109,6,2,238616,238616,238618,0,2,3
68110,2,2,238618,238618,238620,0,2,0
68111,5,1,238623,238623,238624,0,1,3
68112,1,2,238624,238624,238626,0,2,0
68113,2,1,238626,238626,238627,0,1,0
68114,5,1,238631,238631,238632,0,1,4
68115,5,3,238636,238636,238639,0,3,4
68116,5,3,238641,238641,238644,0,3,2
68117,2,2,238643,238644,238646,1,3,0
68118,1,3,238644,238646,238649,2,5,0
68119,3,3,238647,238649,238652,2,5,0
68120,6,2,238653,238653,238655,0,2,1
68121,6,1,238659,238659,238660,0,1,4
68122,5,3,238664,238664,238667,0,3,4
68123,2,3,238666,238667,238670,1,4,0
68124,1,2,238667,238670,238672,3,5,0
68125,3,1,238670,238672,238673,2,3,0
68126,4,1,238674,238674,238675,0,1,1
68127,5,2,238679,238679,238681,0,2,4
68128,4,1,238683,238683,238684,0,1,2
68129,4,3,238687,238687,238690,0,3,3
68130,3,2,238690,238690,238692,0,2,0
68131,3,3,238693,238693,238696,0,3,1
68132,2,3,238695,238696,238699,1,4,0
68133,6,1,238701,238701,238702,0,1,2
68134,3,1,238704,238704,238705,0,1,2
68135,5,2,238709,238709,238711,0,2,4
68136,3,1,238712,238712,238713,0,1,1
68137,4,3,238716,238716,238719,0,3,3
68138,2,2,238718,238719,238721,1,3,0
68139,6,1,238724,238724,238725,0,1,3
68140,2,2,238726,238726,238728,0,2,1
68141,3,1,238729,238729,238730,0,1,1
68142,1,2,238730,238730,238732,0,2,0
68143,4,3,238734,238734,238737,0,3,2
68144,3,3,238737,238737,238740,0,3,0
68145,5,1,238742,238742,238743,0,1,2
68146,6,1,238748,238748,238749,0,1,5
68147,2,1,238750,238750,238751,0,1,1
68148,1,3,238751,238751,238754,0,3,0
68149,6,1,238757,238757,238758,0,1,3
68150,1,3,238758,238758,238761,0,3,0
68151,2,1,238760,238761,238762,1,2,0
68152,6,2,238766,238766,238768,0,2,4
68153,4,2,238770,238770,238772,0,2,2
68154,4,3,238774,238774,238777,0,3,2
68155,1,2,238775,238777,238779,2,4,0
68156,2,2,238777,238779,238781,2,4,0
68157,4,2,238781,238781,238783,0,2,0
68158,1,1,238782,238783,238784,1,2,0
68159,3,3,238785,238785,238788,0,3,1
68160,4,3,238789,238789,238792,0,3,1
68161,1,2,238790,238792,238794,2,4,0
68162,3,2,238793,238794,238796,1,3,0
68163,3,1,238796,238796,238797,0,1,0
68164,6,3,238802,238802,238805,0,3,5
68165,1,2,238803,238805,238807,2,4,0
68166,6,3,238809,238809,238812,0,3,2
68167,3,3,238812,238812,238815,0,3,0
68168,1,3,238813,238815,238818,2,5,0
68169,6,3,238819,238819,238822,0,3,1
68170,6,3,238825,238825,238828,0,3,3
68171,3,2,238828,238828,238830,0,2,0
68172,6,3,238834,238834,238837,0,3,4
68173,6,2,238840,238840,238842,0,2,3
68174,3,2,238843,238843,238845,0,2,1
68175,6,3,238849,238849,238852,0,3,4
68176,5,2,238854,238854,238856,0,2,2
68177,1,1,238855,238856,238857,1,2,0
68178,6,3,238861,238861,238864,0,3,4
68179,4,2,238865,238865,238867,0,2,1
68180,6,2,238871,238871,238873,0,2,4
68181,6,2,238877,238877,238879,0,2,4
68182,4,2,238881,238881,238883,0,2,2
68183,1,1,238882,238883,238884,1,2,0
68184,3,3,238885,238885,238888,0,3,1
68185,4,1,238889,238889,238890,0,1,1
68186,2,1,238891,238891,238892,0,1,1
68187,5,1,238896,238896,238897,0,1,4
68188,2,2,238898,238898,238900,0,2,1
68189,5,2,238903,238903,238905,0,2,3
68190,5,2,238908,238908,238910,0,2,3
68191,6,1,238914,238914,238915,0,1,4
68192,5,1,238919,238919,238920,0,1,4
68193,4,3,238923,238923,238926,0,3,3
68194,4,2,238927,238927,238929,0,2,1
68195,3,2,238930,238930,238932,0,2,1
68196,2,2,238932,238932,238934,0,2,0
68197,3,1,238935,238935,238936,0,1,1
68198,4,3,238939,238939,238942,0,3,3
68199,5,1,238944,238944,238945,0,1,2
68200,4,2,238948,238948,238950,0,2,3
68201,1,1,238949,238950,238951,1,2,0
68202,4,1,238953,238953,238954,0,1,2
68203,5,3,238958,238958,238961,0,3,4
68204,4,1,238962,238962,238963,0,1,1
68205,1,2,238963,238963,238965,0,2,0
68206,4,2,238967,238967,238969,0,2,2
68207,4,2,238971,238971,238973,0,2,2
68208,6,2,238977,238977,238979,0,2,4
68209,2,1,238979,238979,238980,0,1,0
68210,2,3,238981,238981,238984,0,3,1
68211,4,1,238985,238985,238986,0,1,1
68212,3,3,238988,238988,238991,0,3,2
68213,1,2,238989,238991,238993,2,4,0
68214,3,1,238992,238993,238994,1,2,0
68215,6,3,238998,238998,239001,0,3,4
68216,3,2,239001,239001,239003,0,2,0
68217,1,1,239002,239003,239004,1,2,0
68218,2,3,239004,239004,239007,0,3,0
68219,4,2,239008,239008,239010,0,2,1
68220,5,1,239013,239013,239014,0,1,3
68221,6,3,239019,239019,239022,0,3,5
68222,3,3,239022,239022,239025,0,3,0
68223,6,3,239028,239028,239031,0,3,3
68224,1,2,239029,239031,239033,2,4,0
68225,5,1,239034,239034,239035,0,1,1
68226,3,3,239037,239037,239040,0,3,2
68227,1,2,239038,239040,239042,2,4,0
68228,4,3,239042,239042,239045,0,3,0
68229,3,3,239045,239045,239048,0,3,0
68230,5,3,239050,239050,239053,0,3,2
68231,1,2,239051,239053,239055,2,4,0
68232,5,1,239056,239056,239057,0,1,1
68233,6,1,239062,239062,239063,0,1,5
68234,4,1,239066,239066,239067,0,1,3
68235,3,2,239069,239069,239071,0,2,2
68236,2,2,239071,239071,239073,0,2,0
68237,2,2,239073,239073,239075,0,2,0
68238,3,2,239076,239076,239078,0,2,1
68239,5,3,239081,239081,239084,0,3,3
68240,5,3,239086,239086,239089,0,3,2
68241,6,3,239092,239092,239095,0,3,3
68242,3,1,239095,239095,239096,0,1,0
68243,3,3,239098,239098,239101,0,3,2
68244,1,3,239099,239101,239104,2,5,0
68245,1,3,239100,239104,239107,4,7,0
68246,5,1,239105,239107,239108,2,3,0
68247,4,2,239109,239109,239111,0,2,1
68248,1,3,239110,239111,239114,1,4,0
68249,2,2,239112,239114,239116,2,4,0
68250,6,3,239118,239118,239121,0,3,2
68251,5,3,239123,239123,239126,0,3,2
68252,2,3,239125,239126,239129,1,4,0
68253,1,3,239126,239129,239132,3,6,0
68254,4,3,239130,239132,239135,2,5,0
68255,6,2,239136,239136,239138,0,2,1
68256,1,1,239137,239138,239139,1,2,0
68257,5,2,239142,239142,239144,0,2,3
68258,5,1,239147,239147,239148,0,1,3
68259,4,3,239151,239151,239154,0,3,3
68260,4,1,239155,239155,239156,0,1,1
68261,5,1,239160,239160,239161,0,1,4
68262,5,2,239165,239165,239167,0,2,4
68263,5,3,239170,239170,239173,0,3,3
68264,3,2,239173,239173,239175,0,2,0
68265,2,3,239175,239175,239178,0,3,0
68266,4,3,239179,239179,239182,0,3,1
68267,4,1,239183,239183,239184,0,1,1
68268,5,2,239188,239188,239190,0,2,4
68269,3,3,239191,239191,239194,0,3,1
68270,1,3,239192,239194,239197,2,5,0
68271,4,3,239196,239197,239200,1,4,0
68272,3,2,239199,239200,239202,1,3,0
68273,2,3,239201,239202,239205,1,4,0
68274,3,2,239204,239205,239207,1,3,0
68275,4,3,239208,239208,239211,0,3,1
68276,2,2,239210,239211,239213,1,3,0
68277,5,1,239215,239215,239216,0,1,2
68278,2,1,239217,239217,239218,0,1,1
68279,2,3,239219,239219,239222,0,3,1
68280,1,1,239220,239222,239223,2,3,0
68281,5,2,239225,239225,239227,0,2,2
68282,4,3,239229,239229,239232,0,3,2
68283,2,2,239231,239232,239234,1,3,0
68284,3,2,239234,239234,239236,0,2,0
68285,5,3,239239,239239,239242,0,3,3
68286,2,3,239241,239242,239245,1,4,0
68287,5,2,239246,239246,239248,0,2,1
68288,5,1,239251,239251,239252,0,1,3
68289,4,1,239255,239255,239256,0,1,3
68290,6,1,239261,239261,239262,0,1,5
68291,1,1,239262,239262,239263,0,1,0
68292,2,1,239264,239264,239265,0,1,1
68293,3,2,239267,239267,239269,0,2,2
68294,2,3,239269,239269,239272,0,3,0
68295,5,3,239274,239274,239277,0,3,2
68296,2,2,239276,239277,239279,1,3,0
68297,1,1,239277,239279,239280,2,3,0
68298,4,3,239281,239281,239284,0,3,1
68299,1,2,239282,239284,239286,2,4,0
68300,6,1,239288,239288,239289,0,1,2
68301,3,3,239291,239291,239294,0,3,2
68302,4,2,239295,239295,239297,0,2,1
68303,5,1,239300,239300,239301,0,1,3
68304,1,1,239301,239301,239302,0,1,0
68305,4,1,239305,239305,239306,0,1,3
68306,1,2,239306,239306,239308,0,2,0
68307,3,1,239309,239309,239310,0,1,1
68308,4,1,239313,239313,239314,0,1,3
68309,3,1,239316,239316,239317,0,1,2
68310,1,2,239317,239317,239319,0,2,0
68311,2,2,239319,239319,239321,0,2,0
68312,4,1,239323,239323,239324,0,1,2
68313,6,3,239329,239329,239332,0,3,5
68314,4,3,239333,239333,239336,0,3,1
68315,1,2,239334,239336,239338,2,4,0
68316,4,2,239338,239338,239340,0,2,0
68317,6,2,239344,239344,239346,0,2,4
68318,1,3,239345,239346,239349,1,4,0
68319,5,3,239350,239350,239353,0,3,1
68320,5,1,239355,239355,239356,0,1,2
68321,3,2,239358,239358,239360,0,2,2
68322,3,1,239361,239361,239362,0,1,1
68323,1,2,239362,239362,239364,0,2,0
68324,4,3,239366,239366,239369,0,3,2
68325,5,1,239371,239371,239372,0,1,2
68326,3,2,239374,239374,239376,0,2,2
68327,2,1,239376,239376,239377,0,1,0
68328,5,2,239381,239381,239383,0,2,4
68329,2,3,239383,239383,239386,0,3,0
68330,1,3,239384,239386,239389,2,5,0
68331,2,3,239386,239389,239392,3,6,0
68332,3,1,239389,239392,239393,3,4,0
68333,2,2,239391,239393,239395,2,4,0
68334,4,1,239395,239395,239396,0,1,0
68335,5,2,239400,239400,239402,0,2,4
68336,2,3,239402,239402,239405,0,3,0
68337,6,3,239408,239408,239411,0,3,3
68338,1,2,239409,239411,239413,2,4,0
68339,1,1,239410,239413,239414,3,4,0
68340,3,3,239413,239414,239417,1,4,0
68341,2,2,239415,239417,239419,2,4,0
68342,3,3,239418,239419,239422,1,4,0
68343,1,3,239419,239422,239425,3,6,0
68344,2,1,239421,239425,239426,4,5,0
68345,5,1,239426,239426,239427,0,1,0
68346,1,1,239427,239427,239428,0,1,0
68347,4,2,239431,239431,239433,0,2,3
68348,4,3,239435,239435,239438,0,3,2
68349,1,1,239436,239438,239439,2,3,0
68350,3,2,239439,239439,239441,0,2,0
68351,5,3,239444,239444,239447,0,3,3
68352,5,3,239449,239449,239452,0,3,2
68353,5,2,239454,239454,239456,0,2,2
68354,6,2,239460,239460,239462,0,2,4
68355,2,2,239462,239462,239464,0,2,0
68356,2,2,239464,239464,239466,0,2,0
68357,2,3,239466,239466,239469,0,3,0
68358,4,2,239470,239470,239472,0,2,1
68359,2,2,239472,239472,239474,0,2,0
68360,2,3,239474,239474,239477,0,3,0
68361,5,3,239479,239479,239482,0,3,2
68362,1,2,239480,239482,239484,2,4,0
68363,1,2,239481,239484,239486,3,5,0
68364,1,3,239482,239486,239489,4,7,0
68365,3,1,239485,239489,239490,4,5,0
68366,4,3,239489,239490,239493,1,4,0
68367,5,2,239494,239494,239496,0,2,1
68368,2,3,239496,239496,239499,0,3,0
68369,3,1,239499,239499,239500,0,1,0
68370,6,2,239505,239505,239507,0,2,5
68371,3,3,239508,239508,239511,0,3,1
68372,6,2,239514,239514,239516,0,2,3
68373,4,2,239518,239518,239520,0,2,2
68374,2,3,239520,239520,239523,0,3,0
68375,6,2,239526,239526,239528,0,2,3
68376,5,2,239531,239531,239533,0,2,3
68377,2,2,239533,239533,239535,0,2,0
68378,6,2,239539,239539,239541,0,2,4
68379,6,3,239545,239545,239548,0,3,4
68380,6,1,239551,239551,239552,0,1,3
68381,1,2,239552,239552,239554,0,2,0
68382,1,3,239553,239554,239557,1,4,0
68383,1,1,239554,239557,239558,3,4,0
68384,5,3,239559,239559,239562,0,3,1
68385,6,1,239565,239565,239566,0,1,3
68386,3,1,239568,239568,239569,0,1,2
68387,4,3,239572,239572,239575,0,3,3
68388,1,1,239573,239575,239576,2,3,0
68389,5,1,239578,239578,239579,0,1,2
68390,5,1,239583,239583,239584,0,1,4
68391,3,2,239586,239586,239588,0,2,2
68392,5,2,239591,239591,239593,0,2,3
68393,2,3,239593,239593,239596,0,3,0
68394,3,2,239596,239596,239598,0,2,0
68395,2,1,239598,239598,239599,0,1,0
68396,2,2,239600,239600,239602,0,2,1
68397,4,3,239604,239604,239607,0,3,2
68398,2,1,239606,239607,239608,1,2,0
68399,1,2,239607,239608,239610,1,3,0
68400,5,3,239612,239612,239615,0,3,2
68401,1,1,239613,239615,239616,2,3,0
68402,6,1,239619,239619,239620,0,1,3
68403,4,1,239623,239623,239624,0,1,3
68404,4,2,239627,239627,239629,0,2,3
68405,5,2,239632,239632,239634,0,2,3
68406,6,1,239638,239638,239639,0,1,4
68407,5,2,239643,239643,239645,0,2,4
68408,2,3,239645,239645,239648,0,3,0
68409,2,2,239647,239648,239650,1,3,0
68410,4,3,239651,239651,239654,0,3,1
68411,4,1,239655,239655,239656,0,1,1
68412,1,2,239656,239656,239658,0,2,0
68413,1,1,239657,239658,239659,1,2,0
68414,2,1,239659,239659,239660,0,1,0
68415,2,1,239661,239661,239662,0,1,1
68416,2,2,239663,239663,239665,0,2,1
68417,6,2,239669,239669,239671,0,2,4
68418,3,1,239672,239672,239673,0,1,1
68419,1,1,239673,239673,239674,0,1,0
68420,5,1,239678,239678,239679,0,1,4
68421,1,3,239679,239679,239682,0,3,0
68422,3,2,239682,239682,239684,0,2,0
68423,1,2,239683,239684,239686,1,3,0
68424,5,3,239688,239688,239691,0,3,2
68425,2,2,239690,239691,239693,1,3,0
68426,5,1,239695,239695,239696,0,1,2
68427,3,3,239698,239698,239701,0,3,2
68428,1,2,239699,239701,239703,2,4,0
68429,2,1,239701,239703,239704,2,3,0
68430,5,3,239706,239706,239709,0,3,2
68431,3,1,239709,239709,239710,0,1,0
68432,2,3,239711,239711,239714,0,3,1
68433,2,3,239713,239714,239717,1,4,0
68434,5,2,239718,239718,239720,0,2,1
68435,6,3,239724,239724,239727,0,3,4
68436,2,2,239726,239727,239729,1,3,0
68437,2,2,239728,239729,239731,1,3,0
68438,2,3,239730,239731,239734,1,4,0
68439,2,1,239732,239734,239735,2,3,0
68440,3,3,239735,239735,239738,0,3,0
68441,5,3,239740,239740,239743,0,3,2
68442,1,3,239741,239743,239746,2,5,0
68443,5,2,239746,239746,239748,0,2,0
68444,1,2,239747,239748,239750,1,3,0
68445,2,3,239749,239750,239753,1,4,0
68446,4,3,239753,239753,239756,0,3,0
68447,4,2,239757,239757,239759,0,2,1
68448,2,2,239759,239759,239761,0,2,0
68449,1,1,239760,239761,239762,1,2,0
68450,6,2,239766,239766,239768,0,2,4
68451,3,2,239769,239769,239771,0,2,1
68452,2,2,239771,239771,239773,0,2,0
68453,3,3,239774,239774,239777,0,3,1
68454,1,2,239775,239777,239779,2,4,0
68455,5,1,239780,239780,239781,0,1,1
68456,2,2,239782,239782,239784,0,2,1
68457,3,1,239785,239785,239786,0,1,1
68458,6,3,239791,239791,239794,0,3,5
68459,3,3,239794,239794,239797,0,3,0
68460,2,2,239796,239797,239799,1,3,0
68461,6,3,239802,239802,239805,0,3,3
68462,6,3,239808,239808,239811,0,3,3
68463,6,2,239814,239814,239816,0,2,3
68464,2,1,239816,239816,239817,0,1,0
68465,1,1,239817,239817,239818,0,1,0
68466,4,2,239821,239821,239823,0,2,3
68467,5,2,239826,239826,239828,0,2,3
68468,1,2,239827,239828,239830,1,3,0
68469,1,1,239828,239830,239831,2,3,0
68470,5,3,239833,239833,239836,0,3,2
68471,4,2,239837,239837,239839,0,2,1
68472,3,1,239840,239840,239841,0,1,1
68473,4,2,239844,239844,239846,0,2,3
68474,2,3,239846,239846,239849,0,3,0
68475,5,3,239851,239851,239854,0,3,2
68476,6,2,239857,239857,239859,0,2,3
68477,4,2,239861,239861,239863,0,2,2
68478,3,2,239864,239864,239866,0,2,1
68479,3,2,239867,239867,239869,0,2,1
68480,1,3,239868,239869,239872,1,4,0
68481,6,1,239874,239874,239875,0,1,2
68482,4,1,239878,239878,239879,0,1,3
68483,5,3,239883,239883,239886,0,3,4
68484,6,1,239889,239889,239890,0,1,3
68485,1,2,239890,239890,239892,0,2,0
68486,1,2,239891,239892,239894,1,3,0
68487,3,3,239894,239894,239897,0,3,0
68488,5,2,239899,239899,239901,0,2,2
68489,6,2,239905,239905,239907,0,2,4
68490,6,3,239911,239911,239914,0,3,4
68491,6,1,239917,239917,239918,0,1,3
68492,4,2,239921,239921,239923,0,2,3
68493,6,1,239927,239927,239928,0,1,4
68494,5,1,239932,239932,239933,0,1,4
68495,3,1,239935,239935,239936,0,1,2
68496,5,3,239940,239940,239943,0,3,4
68497,6,2,239946,239946,239948,0,2,3
68498,3,1,239949,239949,239950,0,1,1
68499,2,2,239951,239951,239953,0,2,1
68500,4,2,239955,239955,239957,0,2,2
68501,5,3,239960,239960,239963,0,3,3
68502,3,1,239963,239963,239964,0,1,0
68503,1,3,239964,239964,239967,0,3,0
68504,5,3,239969,239969,239972,0,3,2
68505,6,2,239975,239975,239977,0,2,3
68506,5,1,239980,239980,239981,0,1,3
68507,5,3,239985,239985,239988,0,3,4
68508,4,1,239989,239989,239990,0,1,1
68509,2,2,239991,239991,239993,0,2,1
68510,5,2,239996,239996,239998,0,2,3
68511,2,1,239998,239998,239999,0,1,0
68512,2,2,240000,240000,240002,0,2,1
68513,1,3,240001,240002,240005,1,4,0
68514,5,3,240006,240006,240009,0,3,1
68515,1,1,240007,240009,240010,2,3,0
68516,5,2,240012,240012,240014,0,2,2
68517,5,3,240017,240017,240020,0,3,3
68518,6,1,240023,240023,240024,0,1,3
68519,3,3,240026,240026,240029,0,3,2
68520,4,2,240030,240030,240032,0,2,1
68521,6,2,240036,240036,240038,0,2,4
68522,6,2,240042,240042,240044,0,2,4
68523,2,3,240044,240044,240047,0,3,0
68524,6,2,240050,240050,240052,0,2,3
68525,1,2,240051,240052,240054,1,3,0
68526,5,1,240056,240056,240057,0,1,2
68527,1,1,240057,240057,240058,0,1,0
68528,4,1,240061,240061,240062,0,1,3
68529,5,3,240066,240066,240069,0,3,4
68530,5,2,240071,240071,240073,0,2,2
68531,3,3,240074,240074,240077,0,3,1
68532,1,3,240075,240077,240080,2,5,0
68533,6,1,240081,240081,240082,0,1,1
68534,6,2,240087,240087,240089,0,2,5
68535,1,1,240088,240089,240090,1,2,0
68536,3,3,240091,240091,240094,0,3,1
68537,4,1,240095,240095,240096,0,1,1
68538,6,1,240101,240101,240102,0,1,5
68539,4,3,240105,240105,240108,0,3,3
68540,2,2,240107,240108,240110,1,3,0
68541,1,1,240108,240110,240111,2,3,0
68542,5,1,240113,240113,240114,0,1,2
68543,6,1,240119,240119,240120,0,1,5
68544,1,2,240120,240120,240122,0,2,0
68545,4,1,240124,240124,240125,0,1,2
68546,4,3,240128,240128,240131,0,3,3
68547,3,3,240131,240131,240134,0,3,0
68548,3,2,240134,240134,240136,0,2,0
68549,6,2,240140,240140,240142,0,2,4
68550,5,3,240145,240145,240148,0,3,3
68551,2,1,240147,240148,240149,1,2,0
68552,6,3,240153,240153,240156,0,3,4
68553,3,2,240156,240156,240158,0,2,0
68554,2,1,240158,240158,240159,0,1,0
68555,2,3,240160,240160,240163,0,3,1
68556,1,2,240161,240163,240165,2,4,0
68557,1,3,240162,240165,240168,3,6,0
68558,1,2,240163,240168,240170,5,7,0
68559,5,3,240168,240170,240173,2,5,0
68560,4,2,240172,240173,240175,1,3,0
68561,3,3,240175,240175,240178,0,3,0
68562,1,2,240176,240178,240180,2,4,0
68563,6,3,240182,240182,240185,0,3,2
68564,5,3,240187,240187,240190,0,3,2
68565,2,2,240189,240190,240192,1,3,0
68566,5,2,240194,240194,240196,0,2,2
68567,3,1,240197,240197,240198,0,1,1
68568,3,2,240200,240200,240202,0,2,2
68569,1,3,240201,240202,240205,1,4,0
68570,5,3,240206,240206,240209,0,3,1
68571,2,3,240208,240209,240212,1,4,0
68572,6,2,240214,240214,240216,0,2,2
68573,3,3,240217,240217,240220,0,3,1
68574,4,3,240221,240221,240224,0,3,1
68575,4,1,240225,240225,240226,0,1,1
68576,4,2,240229,240229,240231,0,2,3
68577,2,2,240231,240231,240233,0,2,0
68578,2,1,240233,240233,240234,0,1,0
68579,1,1,240234,240234,240235,0,1,0
68580,5,3,240239,240239,240242,0,3,4
68581,6,1,240245,240245,240246,0,1,3
68582,1,2,240246,240246,240248,0,2,0
68583,1,3,240247,240248,240251,1,4,0
68584,4,2,240251,240251,240253,0,2,0
68585,5,1,240256,240256,240257,0,1,3
68586,2,2,240258,240258,240260,0,2,1
68587,2,1,240260,240260,240261,0,1,0
68588,5,2,240265,240265,240267,0,2,4
68589,3,2,240268,240268,240270,0,2,1
68590,1,3,240269,240270,240273,1,4,0
68591,4,2,240273,240273,240275,0,2,0
68592,4,3,240277,240277,240280,0,3,2
68593,3,1,240280,240280,240281,0,1,0
68594,5,2,240285,240285,240287,0,2,4
68595,5,1,240290,240290,240291,0,1,3
68596,2,1,240292,240292,240293,0,1,1
68597,4,1,240296,240296,240297,0,1,3
68598,4,2,240300,240300,240302,0,2,3
68599,5,2,240305,240305,240307,0,2,3
68600,5,1,240310,240310,240311,0,1,3
68601,2,1,240312,240312,240313,0,1,1
68602,3,1,240315,240315,240316,0,1,2
68603,6,1,240321,240321,240322,0,1,5
68604,5,1,240326,240326,240327,0,1,4
68605,3,2,240329,240329,240331,0,2,2
68606,2,2,240331,240331,240333,0,2,0
68607,2,3,240333,240333,240336,0,3,0
68608,1,3,240334,240336,240339,2,5,0
68609,6,3,240340,240340,240343,0,3,1
68610,6,2,240346,240346,240348,0,2,3
68611,5,3,240351,240351,240354,0,3,3
68612,2,1,240353,240354,240355,1,2,0
68613,5,3,240358,240358,240361,0,3,3
68614,4,1,240362,240362,240363,0,1,1
68615,3,2,240365,240365,240367,0,2,2
68616,2,3,240367,240367,240370,0,3,0
68617,6,3,240373,240373,240376,0,3,3
68618,2,2,240375,240376,240378,1,3,0
68619,2,2,240377,240378,240380,1,3,0
68620,6,1,240383,240383,240384,0,1,3
68621,3,2,240386,240386,240388,0,2,2
68622,4,3,240390,240390,240393,0,3,2
68623,4,1,240394,240394,240395,0,1,1
68624,1,3,240395,240395,240398,0,3,0
68625,3,3,240398,240398,240401,0,3,0
68626,5,1,240403,240403,240404,0,1,2
68627,2,2,240405,240405,240407,0,2,1
68628,1,3,240406,240407,240410,1,4,0
68629,4,1,240410,240410,240411,0,1,0
68630,6,2,240416,240416,240418,0,2,5
68631,5,2,240421,240421,240423,0,2,3
68632,3,2,240424,240424,240426,0,2,1
68633,1,3,240425,240426,240429,1,4,0
68634,4,3,240429,240429,240432,0,3,0
68635,1,1,240430,240432,240433,2,3,0
68636,3,1,240433,240433,240434,0,1,0
68637,2,3,240435,240435,240438,0,3,1
68638,4,1,240439,240439,240440,0,1,1
68639,3,2,240442,240442,240444,0,2,2
68640,5,1,240447,240447,240448,0,1,3
68641,4,1,240451,240451,240452,0,1,3
68642,3,2,240454,240454,240456,0,2,2
68643,4,3,240458,240458,240461,0,3,2
68644,4,2,240462,240462,240464,0,2,1
68645,3,3,240465,240465,240468,0,3,1
68646,6,3,240471,240471,240474,0,3,3
68647,4,3,240475,240475,240478,0,3,1
68648,1,3,240476,240478,240481,2,5,0
68649,4,3,240480,240481,240484,1,4,0
68650,2,1,240482,240484,240485,2,3,0
68651,5,3,240487,240487,240490,0,3,2
68652,6,3,240493,240493,240496,0,3,3
68653,2,2,240495,240496,240498,1,3,0
68654,6,2,240501,240501,240503,0,2,3
68655,1,3,240502,240503,240506,1,4,0
68656,2,3,240504,240506,240509,2,5,0
68657,4,2,240508,240509,240511,1,3,0
68658,3,3,240511,240511,240514,0,3,0
68659,5,3,240516,240516,240519,0,3,2
68660,4,1,240520,240520,240521,0,1,1
68661,2,1,240522,240522,240523,0,1,1
68662,4,3,240526,240526,240529,0,3,3
68663,3,1,240529,240529,240530,0,1,0
68664,5,2,240534,240534,240536,0,2,4
68665,4,2,240538,240538,240540,0,2,2
68666,1,1,240539,240540,240541,1,2,0
68667,1,3,240540,240541,240544,1,4,0
68668,2,3,240542,240544,240547,2,5,0
68669,1,2,240543,240547,240549,4,6,0
68670,4,2,240547,240549,240551,2,4,0
68671,1,3,240548,240551,240554,3,6,0
68672,6,3,240554,240554,240557,0,3,0
68673,4,3,240558,240558,240561,0,3,1
68674,2,1,240560,240561,240562,1,2,0
68675,2,1,240562,240562,240563,0,1,0
68676,3,1,240565,240565,240566,0,1,2
68677,3,1,240568,240568,240569,0,1,2
68678,3,2,240571,240571,240573,0,2,2
68679,4,2,240575,240575,240577,0,2,2
68680,6,2,240581,240581,240583,0,2,4
68681,6,2,240587,240587,240589,0,2,4
68682,5,1,240592,240592,240593,0,1,3
68683,1,1,240593,240593,240594,0,1,0
68684,4,1,240597,240597,240598,0,1,3
68685,1,3,240598,240598,240601,0,3,0
68686,2,2,240600,240601,240603,1,3,0
68687,6,3,240606,240606,240609,0,3,3
68688,6,2,240612,240612,240614,0,2,3
68689,6,1,240618,240618,240619,0,1,4
68690,2,3,240620,240620,240623,0,3,1
68691,2,3,240622,240623,240626,1,4,0
68692,3,2,240625,240626,240628,1,3,0
68693,3,3,240628,240628,240631,0,3,0
68694,4,1,240632,240632,240633,0,1,1
68695,3,1,240635,240635,240636,0,1,2
68696,6,3,240641,240641,240644,0,3,5
68697,5,2,240646,240646,240648,0,2,2
68698,1,2,240647,240648,240650,1,3,0
68699,4,3,240651,240651,240654,0,3,1
68700,4,2,240655,240655,240657,0,2,1
68701,4,1,240659,240659,240660,0,1,2
68702,2,1,240661,240661,240662,0,1,1
68703,6,1,240667,240667,240668,0,1,5
68704,1,1,240668,240668,240669,0,1,0
68705,5,2,240673,240673,240675,0,2,4
68706,4,1,240677,240677,240678,0,1,2
68707,5,2,240682,240682,240684,0,2,4
68708,6,3,240688,240688,240691,0,3,4
68709,5,2,240693,240693,240695,0,2,2
68710,2,2,240695,240695,240697,0,2,0
68711,2,3,240697,240697,240700,0,3,0
68712,1,1,240698,240700,240701,2,3,0
68713,1,3,240699,240701,240704,2,5,0
68714,5,1,240704,240704,240705,0,1,0
68715,1,1,240705,240705,240706,0,1,0
68716,6,1,240711,240711,240712,0,1,5
68717,4,2,240715,240715,240717,0,2,3
68718,5,1,240720,240720,240721,0,1,3
68719,4,1,240724,240724,240725,0,1,3
68720,4,2,240728,240728,240730,0,2,3
68721,3,3,240731,240731,240734,0,3,1
68722,5,3,240736,240736,240739,0,3,2
68723,5,2,240741,240741,240743,0,2,2
68724,2,1,240743,240743,240744,0,1,0
68725,1,1,240744,240744,240745,0,1,0
68726,1,2,240745,240745,240747,0,2,0
68727,4,1,240749,240749,240750,0,1,2
68728,2,2,240751,240751,240753,0,2,1
68729,4,2,240755,240755,240757,0,2,2
68730,6,1,240761,240761,240762,0,1,4
68731,2,2,240763,240763,240765,0,2,1
68732,2,1,240765,240765,240766,0,1,0
68733,5,1,240770,240770,240771,0,1,4
68734,1,2,240771,240771,240773,0,2,0
68735,5,1,240776,240776,240777,0,1,3
68736,2,2,240778,240778,240780,0,2,1
68737,5,2,240783,240783,240785,0,2,3
68738,1,1,240784,240785,240786,1,2,0
68739,3,1,240787,240787,240788,0,1,1
68740,6,2,240793,240793,240795,0,2,5
68741,4,2,240797,240797,240799,0,2,2
68742,3,3,240800,240800,240803,0,3,1
68743,1,2,240801,240803,240805,2,4,0
68744,1,3,240802,240805,240808,3,6,0
68745,5,3,240807,240808,240811,1,4,0
68746,5,1,240812,240812,240813,0,1,1
68747,3,1,240815,240815,240816,0,1,2
68748,2,1,240817,240817,240818,0,1,1
68749,6,2,240823,240823,240825,0,2,5
68750,2,3,240825,240825,240828,0,3,0
68751,1,1,240826,240828,240829,2,3,0
68752,5,2,240831,240831,240833,0,2,2
68753,6,1,240837,240837,240838,0,1,4
68754,3,2,240840,240840,240842,0,2,2
68755,6,1,240846,240846,240847,0,1,4
68756,6,2,240852,240852,240854,0,2,5
68757,6,3,240858,240858,240861,0,3,4
68758,4,1,240862,240862,240863,0,1,1
68759,2,3,240864,240864,240867,0,3,1
68760,5,1,240869,240869,240870,0,1,2
68761,6,3,240875,240875,240878,0,3,5
68762,3,3,240878,240878,240881,0,3,0
68763,4,3,240882,240882,240885,0,3,1
68764,5,1,240887,240887,240888,0,1,2
68765,6,2,240893,240893,240895,0,2,5
68766,4,2,240897,240897,240899,0,2,2
68767,2,1,240899,240899,240900,0,1,0
68768,1,1,240900,240900,240901,0,1,0
68769,5,1,240905,240905,240906,0,1,4
68770,6,3,240911,240911,240914,0,3,5
68771,3,1,240914,240914,240915,0,1,0
68772,3,3,240917,240917,240920,0,3,2
68773,4,3,240921,240921,240924,0,3,1
68774,3,1,240924,240924,240925,0,1,0
68775,5,1,240929,240929,240930,0,1,4
68776,2,3,240931,240931,240934,0,3,1
68777,3,1,240934,240934,240935,0,1,0
68778,5,1,240939,240939,240940,0,1,4
68779,5,3,240944,240944,240947,0,3,4
68780,4,1,240948,240948,240949,0,1,1
68781,6,2,240954,240954,240956,0,2,5
68782,2,2,240956,240956,240958,0,2,0
68783,3,3,240959,240959,240962,0,3,1
68784,3,2,240962,240962,240964,0,2,0
68785,1,2,240963,240964,240966,1,3,0
68786,3,3,240966,240966,240969,0,3,0
68787,6,1,240972,240972,240973,0,1,3
68788,2,1,240974,240974,240975,0,1,1
68789,4,2,240978,240978,240980,0,2,3
68790,2,3,240980,240980,240983,0,3,0
68791,3,3,240983,240983,240986,0,3,0
68792,5,3,240988,240988,240991,0,3,2
68793,2,3,240990,240991,240994,1,4,0
68794,5,3,240995,240995,240998,0,3,1
68795,3,1,240998,240998,240999,0,1,0
68796,3,2,241001,241001,241003,0,2,2
68797,6,2,241007,241007,241009,0,2,4
68798,1,2,241008,241009,241011,1,3,0
68799,2,2,241010,241011,241013,1,3,0
68800,4,3,241014,241014,241017,0,3,1
68801,2,2,241016,241017,241019,1,3,0
68802,4,1,241020,241020,241021,0,1,1
68803,6,3,241026,241026,241029,0,3,5
68804,3,2,241029,241029,241031,0,2,0
68805,6,2,241035,241035,241037,0,2,4
68806,6,2,241041,241041,241043,0,2,4
68807,2,2,241043,241043,241045,0,2,0
68808,2,2,241045,241045,241047,0,2,0
68809,4,1,241049,241049,241050,0,1,2
68810,1,1,241050,241050,241051,0,1,0
68811,6,3,241056,241056,241059,0,3,5
68812,1,3,241057,241059,241062,2,5,0
68813,1,2,241058,241062,241064,4,6,0
68814,2,3,241060,241064,241067,4,7,0
68815,1,3,241061,241067,241070,6,9,0
68816,5,3,241066,241070,241073,4,7,0
68817,2,1,241068,241073,241074,5,6,0
68818,3,2,241071,241074,241076,3,5,0
68819,2,2,241073,241076,241078,3,5,0
68820,6,3,241079,241079,241082,0,3,1
68821,5,2,241084,241084,241086,0,2,2
68822,3,3,241087,241087,241090,0,3,1
68823,6,3,241093,241093,241096,0,3,3
68824,2,3,241095,241096,241099,1,4,0
68825,1,1,241096,241099,241100,3,4,0
68826,2,2,241098,241100,241102,2,4,0
68827,5,1,241103,241103,241104,0,1,1
68828,3,1,241106,241106,241107,0,1,2
68829,3,1,241109,241109,241110,0,1,2
68830,3,1,241112,241112,241113,0,1,2
68831,5,3,241117,241117,241120,0,3,4
68832,3,3,241120,241120,241123,0,3,0
68833,6,3,241126,241126,241129,0,3,3
68834,5,1,241131,241131,241132,0,1,2
68835,4,1,241135,241135,241136,0,1,3
68836,4,1,241139,241139,241140,0,1,3
68837,2,1,241141,241141,241142,0,1,1
68838,3,2,241144,241144,241146,0,2,2
68839,2,2,241146,241146,241148,0,2,0
68840,4,3,241150,241150,241153,0,3,2
68841,3,1,241153,241153,241154,0,1,0
68842,2,2,241155,241155,241157,0,2,1
68843,3,1,241158,241158,241159,0,1,1
68844,2,1,241160,241160,241161,0,1,1
68845,4,3,241164,241164,241167,0,3,3
68846,4,3,241168,241168,241171,0,3,1
68847,5,1,241173,241173,241174,0,1,2
68848,4,1,241177,241177,241178,0,1,3
68849,3,2,241180,241180,241182,0,2,2
68850,4,2,241184,241184,241186,0,2,2
68851,2,1,241186,241186,241187,0,1,0
68852,4,3,241190,241190,241193,0,3,3
68853,2,3,241192,241193,241196,1,4,0
68854,5,1,241197,241197,241198,0,1,1
68855,4,2,241201,241201,241203,0,2,3
68856,4,3,241205,241205,241208,0,3,2
68857,1,2,241206,241208,241210,2,4,0
68858,2,2,241208,241210,241212,2,4,0
68859,2,3,241210,241212,241215,2,5,0
68860,5,2,241215,241215,241217,0,2,0
68861,2,2,241217,241217,241219,0,2,0
68862,5,3,241222,241222,241225,0,3,3
68863,5,1,241227,241227,241228,0,1,2
68864,3,3,241230,241230,241233,0,3,2
68865,3,1,241233,241233,241234,0,1,0
68866,1,1,241234,241234,241235,0,1,0
68867,1,3,241235,241235,241238,0,3,0
68868,6,2,241241,241241,241243,0,2,3
68869,6,1,241247,241247,241248,0,1,4
68870,6,3,241253,241253,241256,0,3,5
68871,2,2,241255,241256,241258,1,3,0
68872,4,2,241259,241259,241261,0,2,1
68873,4,1,241263,241263,241264,0,1,2
68874,4,1,241267,241267,241268,0,1,3
68875,6,3,241273,241273,241276,0,3,5
68876,6,3,241279,241279,241282,0,3,3
68877,1,1,241280,241282,241283,2,3,0
68878,6,2,241286,241286,241288,0,2,3
68879,6,3,241292,241292,241295,0,3,4
68880,6,1,241298,241298,241299,0,1,3
68881,6,3,241304,241304,241307,0,3,5
68882,3,1,241307,241307,241308,0,1,0
68883,4,3,241311,241311,241314,0,3,3
68884,5,1,241316,241316,241317,0,1,2
68885,3,3,241319,241319,241322,0,3,2
68886,5,2,241324,241324,241326,0,2,2
68887,3,1,241327,241327,241328,0,1,1
68888,4,1,241331,241331,241332,0,1,3
68889,4,1,241335,241335,241336,0,1,3
68890,2,1,241337,241337,241338,0,1,1
68891,6,3,241343,241343,241346,0,3,5
68892,4,3,241347,241347,241350,0,3,1
68893,5,1,241352,241352,241353,0,1,2
68894,1,3,241353,241353,241356,0,3,0
68895,4,2,241357,241357,241359,0,2,1
68896,3,2,241360,241360,241362,0,2,1
68897,6,2,241366,241366,241368,0,2,4
68898,4,2,241370,241370,241372,0,2,2
68899,2,1,241372,241372,241373,0,1,0
68900,1,2,241373,241373,241375,0,2,0
68901,5,3,241378,241378,241381,0,3,3
68902,2,3,241380,241381,241384,1,4,0
68903,2,2,241382,241384,241386,2,4,0
68904,3,1,241385,241386,241387,1,2,0
68905,4,3,241389,241389,241392,0,3,2
68906,4,1,241393,241393,241394,0,1,1
68907,1,2,241394,241394,241396,0,2,0
68908,1,1,241395,241396,241397,1,2,0
68909,3,3,241398,241398,241401,0,3,1
68910,2,1,241400,241401,241402,1,2,0
68911,3,2,241403,241403,241405,0,2,1
68912,5,1,241408,241408,241409,0,1,3
68913,3,3,241411,241411,241414,0,3,2
68914,6,3,241417,241417,241420,0,3,3
68915,3,1,241420,241420,241421,0,1,0
68916,3,3,241423,241423,241426,0,3,2
68917,3,3,241426,241426,241429,0,3,0
68918,6,1,241432,241432,241433,0,1,3
68919,6,1,241438,241438,241439,0,1,5
68920,5,2,241443,241443,241445,0,2,4
68921,5,3,241448,241448,241451,0,3,3
68922,4,2,241452,241452,241454,0,2,1
68923,1,1,241453,241454,241455,1,2,0
68924,5,1,241458,241458,241459,0,1,3
68925,2,2,241460,241460,241462,0,2,1
68926,4,2,241464,241464,241466,0,2,2
68927,5,1,241469,241469,241470,0,1,3
68928,4,1,241473,241473,241474,0,1,3
68929,6,1,241479,241479,241480,0,1,5
68930,6,3,241485,241485,241488,0,3,5
68931,4,2,241489,241489,241491,0,2,1
68932,1,2,241490,241491,241493,1,3,0
68933,2,1,241492,241493,241494,1,2,0
68934,6,1,241498,241498,241499,0,1,4
68935,6,3,241504,241504,241507,0,3,5
68936,6,1,241510,241510,241511,0,1,3
68937,4,3,241514,241514,241517,0,3,3
68938,6,1,241520,241520,241521,0,1,3
68939,4,1,241524,241524,241525,0,1,3
68940,4,2,241528,241528,241530,0,2,3
68941,1,3,241529,241530,241533,1,4,0
68942,2,3,241531,241533,241536,2,5,0
68943,1,3,241532,241536,241539,4,7,0
68944,6,1,241538,241539,241540,1,2,0
68945,5,2,241543,241543,241545,0,2,3
68946,4,2,241547,241547,241549,0,2,2
68947,6,3,241553,241553,241556,0,3,4
68948,1,2,241554,241556,241558,2,4,0
68949,4,3,241558,241558,241561,0,3,0
68950,3,2,241561,241561,241563,0,2,0
68951,3,1,241564,241564,241565,0,1,1
68952,2,3,241566,241566,241569,0,3,1
68953,1,1,241567,241569,241570,2,3,0
68954,2,1,241569,241570,241571,1,2,0
68955,5,1,241574,241574,241575,0,1,3
68956,3,3,241577,241577,241580,0,3,2
68957,4,2,241581,241581,241583,0,2,1
68958,6,1,241587,241587,241588,0,1,4
68959,4,3,241591,241591,241594,0,3,3
68960,4,3,241595,241595,241598,0,3,1
68961,6,1,241601,241601,241602,0,1,3
68962,3,3,241604,241604,241607,0,3,2
68963,2,2,241606,241607,241609,1,3,0
68964,2,3,241608,241609,241612,1,4,0
68965,2,1,241610,241612,241613,2,3,0
68966,2,1,241612,241613,241614,1,2,0
68967,1,1,241613,241614,241615,1,2,0
68968,5,2,241618,241618,241620,0,2,3
68969,6,3,241624,241624,241627,0,3,4
68970,1,3,241625,241627,241630,2,5,0
68971,5,1,241630,241630,241631,0,1,0
68972,3,2,241633,241633,241635,0,2,2
68973,5,3,241638,241638,241641,0,3,3
68974,4,2,241642,241642,241644,0,2,1
68975,1,2,241643,241644,241646,1,3,0
68976,1,1,241644,241646,241647,2,3,0
68977,2,3,241646,241647,241650,1,4,0
68978,4,1,241650,241650,241651,0,1,0
68979,3,2,241653,241653,241655,0,2,2
68980,6,3,241659,241659,241662,0,3,4
68981,3,1,241662,241662,241663,0,1,0
68982,2,2,241664,241664,241666,0,2,1
68983,4,2,241668,241668,241670,0,2,2
68984,4,3,241672,241672,241675,0,3,2
68985,2,3,241674,241675,241678,1,4,0
68986,5,3,241679,241679,241682,0,3,1
68987,6,3,241685,241685,241688,0,3,3
68988,4,1,241689,241689,241690,0,1,1
68989,6,2,241695,241695,241697,0,2,5
68990,2,1,241697,241697,241698,0,1,0
68991,2,2,241699,241699,241701,0,2,1
68992,3,2,241702,241702,241704,0,2,1
68993,6,2,241708,241708,241710,0,2,4
68994,6,3,241714,241714,241717,0,3,4
68995,1,3,241715,241717,241720,2,5,0
68996,2,3,241717,241720,241723,3,6,0
68997,6,2,241723,241723,241725,0,2,0
68998,5,1,241728,241728,241729,0,1,3
68999,3,3,241731,241731,241734,0,3,2
69000,4,1,241735,241735,241736,0,1,1
69001,4,2,241739,241739,241741,0,2,3
69002,3,1,241742,241742,241743,0,1,1
69003,5,1,241747,241747,241748,0,1,4
69004,1,2,241748,241748,241750,0,2,0
69005,3,3,241751,241751,241754,0,3,1
69006,6,2,241757,241757,241759,0,2,3
69007,6,3,241763,241763,241766,0,3,4
69008,2,1,241765,241766,241767,1,2,0
69009,1,1,241766,241767,241768,1,2,0
69010,5,2,241771,241771,241773,0,2,3
69011,2,3,241773,241773,241776,0,3,0
69012,5,2,241778,241778,241780,0,2,2
69013,3,1,241781,241781,241782,0,1,1
69014,4,3,241785,241785,241788,0,3,3
69015,1,2,241786,241788,241790,2,4,0
69016,5,2,241791,241791,241793,0,2,1
69017,6,3,241797,241797,241800,0,3,4
69018,2,3,241799,241800,241803,1,4,0
69019,1,3,241800,241803,241806,3,6,0
69020,5,1,241805,241806,241807,1,2,0
69021,4,2,241809,241809,241811,0,2,2
69022,3,1,241812,241812,241813,0,1,1
69023,4,1,241816,241816,241817,0,1,3
69024,3,1,241819,241819,241820,0,1,2
69025,3,2,241822,241822,241824,0,2,2
69026,1,2,241823,241824,241826,1,3,0
69027,6,2,241829,241829,241831,0,2,3
69028,1,2,241830,241831,241833,1,3,0
69029,3,2,241833,241833,241835,0,2,0
69030,2,1,241835,241835,241836,0,1,0
69031,6,2,241841,241841,241843,0,2,5
69032,6,2,241847,241847,241849,0,2,4
69033,3,1,241850,241850,241851,0,1,1
69034,3,3,241853,241853,241856,0,3,2
69035,4,1,241857,241857,241858,0,1,1
69036,1,3,241858,241858,241861,0,3,0
69037,4,1,241862,241862,241863,0,1,1
69038,6,2,241868,241868,241870,0,2,5
69039,1,2,241869,241870,241872,1,3,0
69040,1,2,241870,241872,241874,2,4,0
69041,3,1,241873,241874,241875,1,2,0
69042,6,1,241879,241879,241880,0,1,4
69043,6,3,241885,241885,241888,0,3,5
69044,4,1,241889,241889,241890,0,1,1
69045,3,2,241892,241892,241894,0,2,2
69046,4,1,241896,241896,241897,0,1,2
69047,6,1,241902,241902,241903,0,1,5
69048,5,2,241907,241907,241909,0,2,4
69049,4,3,241911,241911,241914,0,3,2
69050,3,3,241914,241914,241917,0,3,0
69051,2,2,241916,241917,241919,1,3,0
69052,1,2,241917,241919,241921,2,4,0
69053,2,1,241919,241921,241922,2,3,0
69054,3,1,241922,241922,241923,0,1,0
69055,5,3,241927,241927,241930,0,3,4
69056,6,1,241933,241933,241934,0,1,3
69057,2,3,241935,241935,241938,0,3,1
69058,2,3,241937,241938,241941,1,4,0
69059,5,3,241942,241942,241945,0,3,1
69060,6,2,241948,241948,241950,0,2,3
69061,2,3,241950,241950,241953,0,3,0
69062,5,3,241955,241955,241958,0,3,2
69063,3,1,241958,241958,241959,0,1,0
69064,6,1,241964,241964,241965,0,1,5
69065,5,2,241969,241969,241971,0,2,4
69066,5,3,241974,241974,241977,0,3,3
69067,4,1,241978,241978,241979,0,1,1
69068,1,2,241979,241979,241981,0,2,0
69069,4,2,241983,241983,241985,0,2,2
69070,3,1,241986,241986,241987,0,1,1
69071,6,3,241992,241992,241995,0,3,5
69072,6,2,241998,241998,242000,0,2,3
69073,4,1,242002,242002,242003,0,1,2
69074,6,1,242008,242008,242009,0,1,5
69075,5,1,242013,242013,242014,0,1,4
69076,2,1,242015,242015,242016,0,1,1
69077,2,3,242017,242017,242020,0,3,1
69078,4,3,242021,242021,242024,0,3,1
69079,1,1,242022,242024,242025,2,3,0
69080,4,1,242026,242026,242027,0,1,1
69081,6,2,242032,242032,242034,0,2,5
69082,2,1,242034,242034,242035,0,1,0
69083,2,2,242036,242036,242038,0,2,1
69084,5,3,242041,242041,242044,0,3,3
69085,2,3,242043,242044,242047,1,4,0
69086,6,3,242049,242049,242052,0,3,2
69087,3,1,242052,242052,242053,0,1,0
69088,5,1,242057,242057,242058,0,1,4
69089,2,3,242059,242059,242062,0,3,1
69090,1,1,242060,242062,242063,2,3,0
69091,6,3,242066,242066,242069,0,3,3
69092,1,2,242067,242069,242071,2,4,0
69093,1,3,242068,242071,242074,3,6,0
69094,6,1,242074,242074,242075,0,1,0
69095,6,2,242080,242080,242082,0,2,5
69096,2,2,242082,242082,242084,0,2,0
69097,6,1,242088,242088,242089,0,1,4
69098,2,1,242090,242090,242091,0,1,1
69099,5,3,242095,242095,242098,0,3,4
69100,5,1,242100,242100,242101,0,1,2
69101,3,3,242103,242103,242106,0,3,2
69102,6,3,242109,242109,242112,0,3,3
69103,3,1,242112,242112,242113,0,1,0
69104,1,1,242113,242113,242114,0,1,0
69105,1,3,242114,242114,242117,0,3,0
69106,1,3,242115,242117,242120,2,5,0
69107,2,3,242117,242120,242123,3,6,0
69108,1,3,242118,242123,242126,5,8,0
69109,6,2,242124,242126,242128,2,4,0
69110,2,3,242126,242128,242131,2,5,0
69111,3,1,242129,242131,242132,2,3,0
69112,4,1,242133,242133,242134,0,1,1
69113,4,3,242137,242137,242140,0,3,3
69114,6,1,242143,242143,242144,0,1,3
69115,3,3,242146,242146,242149,0,3,2
69116,2,3,242148,242149,242152,1,4,0
69117,2,1,242150,242152,242153,2,3,0
69118,5,3,242155,242155,242158,0,3,2
69119,6,1,242161,242161,242162,0,1,3
69120,6,1,242167,242167,242168,0,1,5
69121,1,2,242168,242168,242170,0,2,0
69122,4,3,242172,242172,242175,0,3,2
69123,6,2,242178,242178,242180,0,2,3
69124,1,2,242179,242180,242182,1,3,0
69125,1,2,242180,242182,242184,2,4,0
69126,4,3,242184,242184,242187,0,3,0
69127,1,1,242185,242187,242188,2,3,0
69128,6,3,242191,242191,242194,0,3,3
69129,1,1,242192,242194,242195,2,3,0
69130,1,3,242193,242195,242198,2,5,0
69131,3,2,242196,242198,242200,2,4,0
69132,1,3,242197,242200,242203,3,6,0
69133,6,3,242203,242203,242206,0,3,0
69134,6,2,242209,242209,242211,0,2,3
69135,2,3,242211,242211,242214,0,3,0
69136,2,2,242213,242214,242216,1,3,0
69137,3,2,242216,242216,242218,0,2,0
69138,1,3,242217,242218,242221,1,4,0
69139,3,3,242220,242221,242224,1,4,0
69140,4,2,242224,242224,242226,0,2,0
69141,4,2,242228,242228,242230,0,2,2
69142,6,1,242234,242234,242235,0,1,4
69143,6,3,242240,242240,242243,0,3,5
69144,4,3,242244,242244,242247,0,3,1
69145,6,3,242250,242250,242253,0,3,3
69146,4,3,242254,242254,242257,0,3,1
69147,5,2,242259,242259,242261,0,2,2
69148,2,2,242261,242261,242263,0,2,0
69149,3,1,242264,242264,242265,0,1,1
69150,3,1,242267,242267,242268,0,1,2
69151,5,1,242272,242272,242273,0,1,4
69152,1,1,242273,242273,242274,0,1,0
69153,5,3,242278,242278,242281,0,3,4
69154,5,1,242283,242283,242284,0,1,2
69155,2,1,242285,242285,242286,0,1,1
69156,2,3,242287,242287,242290,0,3,1
69157,1,2,242288,242290,242292,2,4,0
69158,2,3,242290,242292,242295,2,5,0
69159,3,1,242293,242295,242296,2,3,0
69160,5,1,242298,242298,242299,0,1,2
69161,2,2,242300,242300,242302,0,2,1
69162,6,3,242306,242306,242309,0,3,4
69163,4,3,242310,242310,242313,0,3,1
69164,2,2,242312,242313,242315,1,3,0
69165,5,1,242317,242317,242318,0,1,2
69166,4,1,242321,242321,242322,0,1,3
69167,6,3,242327,242327,242330,0,3,5
69168,5,3,242332,242332,242335,0,3,2
69169,4,3,242336,242336,242339,0,3,1
69170,5,3,242341,242341,242344,0,3,2
69171,5,1,242346,242346,242347,0,1,2
69172,3,1,242349,242349,242350,0,1,2
69173,5,2,242354,242354,242356,0,2,4
69174,6,3,242360,242360,242363,0,3,4
69175,2,3,242362,242363,242366,1,4,0
69176,4,2,242366,242366,242368,0,2,0
69177,5,3,242371,242371,242374,0,3,3
69178,4,3,242375,242375,242378,0,3,1
69179,5,2,242380,242380,242382,0,2,2
69180,4,1,242384,242384,242385,0,1,2
69181,6,2,242390,242390,242392,0,2,5
69182,4,1,242394,242394,242395,0,1,2
69183,1,3,242395,242395,242398,0,3,0
69184,2,3,242397,242398,242401,1,4,0
69185,1,2,242398,242401,242403,3,5,0
69186,4,2,242402,242403,242405,1,3,0
69187,3,3,242405,242405,242408,0,3,0
69188,6,3,242411,242411,242414,0,3,3
69189,2,1,242413,242414,242415,1,2,0
69190,2,2,242415,242415,242417,0,2,0
69191,1,2,242416,242417,242419,1,3,0
69192,4,2,242420,242420,242422,0,2,1
69193,1,2,242421,242422,242424,1,3,0
69194,2,2,242423,242424,242426,1,3,0
69195,1,2,242424,242426,242428,2,4,0
69196,6,1,242430,242430,242431,0,1,2
69197,5,3,242435,242435,242438,0,3,4
69198,1,1,242436,242438,242439,2,3,0
69199,3,1,242439,242439,242440,0,1,0
69200,4,2,242443,242443,242445,0,2,3
69201,3,3,242446,242446,242449,0,3,1
69202,4,1,242450,242450,242451,0,1,1
69203,6,2,242456,242456,242458,0,2,5
69204,1,2,242457,242458,242460,1,3,0
69205,2,2,242459,242460,242462,1,3,0
69206,3,1,242462,242462,242463,0,1,0
69207,5,3,242467,242467,242470,0,3,4
69208,2,3,242469,242470,242473,1,4,0
69209,1,2,242470,242473,242475,3,5,0
69210,1,2,242471,242475,242477,4,6,0
69211,2,2,242473,242477,242479,4,6,0
69212,1,3,242474,242479,242482,5,8,0
69213,5,1,242479,242482,242483,3,4,0
69214,5,2,242484,242484,242486,0,2,1
69215,4,2,242488,242488,242490,0,2,2
69216,6,3,242494,242494,242497,0,3,4
69217,4,3,242498,242498,242501,0,3,1
69218,3,3,242501,242501,242504,0,3,0
69219,1,1,242502,242504,242505,2,3,0
69220,1,1,242503,242505,242506,2,3,0
69221,5,3,242508,242508,242511,0,3,2
69222,6,2,242514,242514,242516,0,2,3
69223,5,1,242519,242519,242520,0,1,3
69224,3,1,242522,242522,242523,0,1,2
69225,3,3,242525,242525,242528,0,3,2
69226,6,1,242531,242531,242532,0,1,3
69227,6,2,242537,242537,242539,0,2,5
69228,4,2,242541,242541,242543,0,2,2
69229,4,1,242545,242545,242546,0,1,2
69230,5,3,242550,242550,242553,0,3,4
69231,4,3,242554,242554,242557,0,3,1
69232,4,3,242558,242558,242561,0,3,1
69233,1,2,242559,242561,242563,2,4,0
69234,1,2,242560,242563,242565,3,5,0
69235,3,3,242563,242565,242568,2,5,0
69236,1,2,242564,242568,242570,4,6,0
69237,6,2,242570,242570,242572,0,2,0
69238,3,2,242573,242573,242575,0,2,1
69239,6,3,242579,242579,242582,0,3,4
69240,3,1,242582,242582,242583,0,1,0
69241,4,2,242586,242586,242588,0,2,3
69242,6,3,242592,242592,242595,0,3,4
69243,1,1,242593,242595,242596,2,3,0
69244,4,3,242597,242597,242600,0,3,1
69245,6,2,242603,242603,242605,0,2,3
69246,1,2,242604,242605,242607,1,3,0
69247,5,2,242609,242609,242611,0,2,2
69248,5,2,242614,242614,242616,0,2,3
69249,5,3,242619,242619,242622,0,3,3
69250,2,2,242621,242622,242624,1,3,0
69251,3,2,242624,242624,242626,0,2,0
69252,1,1,242625,242626,242627,1,2,0
69253,6,3,242631,242631,242634,0,3,4
69254,6,1,242637,242637,242638,0,1,3
69255,3,2,242640,242640,242642,0,2,2
69256,4,3,242644,242644,242647,0,3,2
69257,3,3,242647,242647,242650,0,3,0
69258,6,2,242653,242653,242655,0,2,3
69259,1,2,242654,242655,242657,1,3,0
69260,1,3,242655,242657,242660,2,5,0
69261,1,3,242656,242660,242663,4,7,0
69262,2,3,242658,242663,242666,5,8,0
69263,6,1,242664,242666,242667,2,3,0
69264,2,3,242666,242667,242670,1,4,0
69265,4,2,242670,242670,242672,0,2,0
69266,1,2,242671,242672,242674,1,3,0
69267,2,1,242673,242674,242675,1,2,0
69268,5,1,242678,242678,242679,0,1,3
69269,4,1,242682,242682,242683,0,1,3
69270,4,2,242686,242686,242688,0,2,3
69271,2,1,242688,242688,242689,0,1,0
69272,2,3,242690,242690,242693,0,3,1
69273,2,3,242692,242693,242696,1,4,0
69274,3,1,242695,242696,242697,1,2,0
69275,4,3,242699,242699,242702,0,3,2
69276,2,3,242701,242702,242705,1,4,0
69277,6,3,242707,242707,242710,0,3,2
69278,6,3,242713,242713,242716,0,3,3
69279,3,1,242716,242716,242717,0,1,0
69280,5,1,242721,242721,242722,0,1,4
69281,5,1,242726,242726,242727,0,1,4
69282,5,2,242731,242731,242733,0,2,4
69283,6,2,242737,242737,242739,0,2,4
69284,6,1,242743,242743,242744,0,1,4
69285,5,3,242748,242748,242751,0,3,4
69286,5,2,242753,242753,242755,0,2,2
69287,5,3,242758,242758,242761,0,3,3
69288,2,2,242760,242761,242763,1,3,0
69289,3,3,242763,242763,242766,0,3,0
69290,1,2,242764,242766,242768,2,4,0
69291,6,2,242770,242770,242772,0,2,2
69292,2,1,242772,242772,242773,0,1,0
69293,4,1,242776,242776,242777,0,1,3
69294,1,3,242777,242777,242780,0,3,0
69295,6,3,242783,242783,242786,0,3,3
69296,6,1,242789,242789,242790,0,1,3
69297,3,2,242792,242792,242794,0,2,2
69298,2,1,242794,242794,242795,0,1,0
69299,4,3,242798,242798,242801,0,3,3
69300,4,3,242802,242802,242805,0,3,1
69301,3,1,242805,242805,242806,0,1,0
69302,1,1,242806,242806,242807,0,1,0
69303,3,1,242809,242809,242810,0,1,2
69304,3,3,242812,242812,242815,0,3,2
69305,1,3,242813,242815,242818,2,5,0
69306,2,1,242815,242818,242819,3,4,0
69307,6,1,242821,242821,242822,0,1,2
69308,6,2,242827,242827,242829,0,2,5
69309,5,2,242832,242832,242834,0,2,3
69310,1,3,242833,242834,242837,1,4,0
69311,5,1,242838,242838,242839,0,1,1
69312,3,3,242841,242841,242844,0,3,2
69313,2,1,242843,242844,242845,1,2,0
69314,4,1,242847,242847,242848,0,1,2
69315,3,1,242850,242850,242851,0,1,2
69316,4,2,242854,242854,242856,0,2,3
69317,6,3,242860,242860,242863,0,3,4
69318,3,3,242863,242863,242866,0,3,0
69319,1,2,242864,242866,242868,2,4,0
69320,1,2,242865,242868,242870,3,5,0
69321,3,1,242868,242870,242871,2,3,0
69322,2,2,242870,242871,242873,1,3,0
69323,1,2,242871,242873,242875,2,4,0
69324,6,2,242877,242877,242879,0,2,2
69325,2,2,242879,242879,242881,0,2,0
69326,3,3,242882,242882,242885,0,3,1
69327,3,2,242885,242885,242887,0,2,0
69328,6,3,242891,242891,242894,0,3,4
69329,5,1,242896,242896,242897,0,1,2
69330,2,1,242898,242898,242899,0,1,1
69331,2,1,242900,242900,242901,0,1,1
69332,4,3,242904,242904,242907,0,3,3
69333,4,1,242908,242908,242909,0,1,1
69334,1,3,242909,242909,242912,0,3,0
69335,1,3,242910,242912,242915,2,5,0
69336,1,3,242911,242915,242918,4,7,0
69337,3,2,242914,242918,242920,4,6,0
69338,3,3,242917,242920,242923,3,6,0
69339,4,3,242921,242923,242926,2,5,0
69340,5,1,242926,242926,242927,0,1,0
69341,6,3,242932,242932,242935,0,3,5
69342,5,2,242937,242937,242939,0,2,2
69343,1,3,242938,242939,242942,1,4,0
69344,1,2,242939,242942,242944,3,5,0
69345,5,3,242944,242944,242947,0,3,0
69346,2,2,242946,242947,242949,1,3,0
69347,1,1,242947,242949,242950,2,3,0
69348,6,1,242953,242953,242954,0,1,3
69349,5,1,242958,242958,242959,0,1,4
69350,4,1,242962,242962,242963,0,1,3
69351,2,3,242964,242964,242967,0,3,1
69352,4,1,242968,242968,242969,0,1,1
69353,1,1,242969,242969,242970,0,1,0
69354,5,2,242974,242974,242976,0,2,4
69355,2,3,242976,242976,242979,0,3,0
69356,1,3,242977,242979,242982,2,5,0
69357,5,2,242982,242982,242984,0,2,0
69358,5,1,242987,242987,242988,0,1,3
69359,6,3,242993,242993,242996,0,3,5
69360,3,2,242996,242996,242998,0,2,0
69361,2,2,242998,242998,243000,0,2,0
69362,2,1,243000,243000,243001,0,1,0
69363,1,1,243001,243001,243002,0,1,0
69364,1,2,243002,243002,243004,0,2,0
69365,6,3,243008,243008,243011,0,3,4
69366,4,1,243012,243012,243013,0,1,1
69367,3,1,243015,243015,243016,0,1,2
69368,1,3,243016,243016,243019,0,3,0
69369,1,2,243017,243019,243021,2,4,0
69370,3,2,243020,243021,243023,1,3,0
69371,1,1,243021,243023,243024,2,3,0
69372,5,1,243026,243026,243027,0,1,2
69373,6,1,243032,243032,243033,0,1,5
69374,5,1,243037,243037,243038,0,1,4
69375,6,1,243043,243043,243044,0,1,5
69376,3,2,243046,243046,243048,0,2,2
69377,4,1,243050,243050,243051,0,1,2
69378,1,1,243051,243051,243052,0,1,0
69379,2,2,243053,243053,243055,0,2,1
69380,6,1,243059,243059,243060,0,1,4
69381,1,1,243060,243060,243061,0,1,0
69382,2,3,243062,243062,243065,0,3,1
69383,5,1,243067,243067,243068,0,1,2
69384,5,3,243072,243072,243075,0,3,4
69385,5,1,243077,243077,243078,0,1,2
69386,4,1,243081,243081,243082,0,1,3
69387,3,2,243084,243084,243086,0,2,2
69388,6,2,243090,243090,243092,0,2,4
69389,4,2,243094,243094,243096,0,2,2
69390,1,1,243095,243096,243097,1,2,0
69391,1,3,243096,243097,243100,1,4,0
69392,1,3,243097,243100,243103,3,6,0
69393,2,1,243099,243103,243104,4,5,0
69394,5,1,243104,243104,243105,0,1,0
69395,2,1,243106,243106,243107,0,1,1
69396,2,3,243108,243108,243111,0,3,1
69397,3,3,243111,243111,243114,0,3,0
69398,2,2,243113,243114,243116,1,3,0
69399,6,3,243119,243119,243122,0,3,3
69400,3,2,243122,243122,243124,0,2,0
69401,5,3,243127,243127,243130,0,3,3
69402,2,1,243129,243130,243131,1,2,0
69403,3,2,243132,243132,243134,0,2,1
69404,3,2,243135,243135,243137,0,2,1
69405,2,3,243137,243137,243140,0,3,0
69406,2,3,243139,243140,243143,1,4,0
69407,1,2,243140,243143,243145,3,5,0
69408,6,2,243146,243146,243148,0,2,1
69409,1,1,243147,243148,243149,1,2,0
69410,6,1,243153,243153,243154,0,1,4
69411,5,1,243158,243158,243159,0,1,4
69412,1,3,243159,243159,243162,0,3,0
69413,3,2,243162,243162,243164,0,2,0
69414,1,3,243163,243164,243167,1,4,0
69415,2,3,243165,243167,243170,2,5,0
69416,6,3,243171,243171,243174,0,3,1
69417,3,3,243174,243174,243177,0,3,0
69418,3,2,243177,243177,243179,0,2,0
69419,3,1,243180,243180,243181,0,1,1
69420,1,1,243181,243181,243182,0,1,0
69421,6,2,243187,243187,243189,0,2,5
69422,1,1,243188,243189,243190,1,2,0
69423,1,2,243189,243190,243192,1,3,0
69424,2,2,243191,243192,243194,1,3,0
69425,6,3,243197,243197,243200,0,3,3
69426,2,3,243199,243200,243203,1,4,0
69427,1,2,243200,243203,243205,3,5,0
69428,1,3,243201,243205,243208,4,7,0
69429,3,2,243204,243208,243210,4,6,0
69430,6,2,243210,243210,243212,0,2,0
69431,6,3,243216,243216,243219,0,3,4
69432,5,1,243221,243221,243222,0,1,2
69433,5,3,243226,243226,243229,0,3,4
69434,3,1,243229,243229,243230,0,1,0
69435,5,1,243234,243234,243235,0,1,4
69436,1,3,243235,243235,243238,0,3,0
69437,4,2,243239,243239,243241,0,2,1
69438,4,2,243243,243243,243245,0,2,2
69439,6,1,243249,243249,243250,0,1,4
69440,6,3,243255,243255,243258,0,3,5
69441,3,3,243258,243258,243261,0,3,0
69442,1,1,243259,243261,243262,2,3,0
69443,5,3,243264,243264,243267,0,3,2
69444,1,2,243265,243267,243269,2,4,0
69445,4,1,243269,243269,243270,0,1,0
69446,3,3,243272,243272,243275,0,3,2
69447,1,3,243273,243275,243278,2,5,0
69448,6,1,243279,243279,243280,0,1,1
69449,6,1,243285,243285,243286,0,1,5
69450,1,2,243286,243286,243288,0,2,0
69451,3,1,243289,243289,243290,0,1,1
69452,2,1,243291,243291,243292,0,1,1
69453,6,3,243297,243297,243300,0,3,5
69454,3,1,243300,243300,243301,0,1,0
69455,6,2,243306,243306,243308,0,2,5
69456,2,1,243308,243308,243309,0,1,0
69457,4,3,243312,243312,243315,0,3,3
69458,4,1,243316,243316,243317,0,1,1
69459,3,2,243319,243319,243321,0,2,2
69460,5,2,243324,243324,243326,0,2,3
69461,4,3,243328,243328,243331,0,3,2
69462,3,2,243331,243331,243333,0,2,0
69463,2,3,243333,243333,243336,0,3,0
69464,2,2,243335,243336,243338,1,3,0
69465,4,1,243339,243339,243340,0,1,1
69466,6,3,243345,243345,243348,0,3,5
69467,1,3,243346,243348,243351,2,5,0
69468,5,1,243351,243351,243352,0,1,0
69469,4,1,243355,243355,243356,0,1,3
69470,3,3,243358,243358,243361,0,3,2
69471,3,3,243361,243361,243364,0,3,0
69472,5,1,243366,243366,243367,0,1,2
69473,3,2,243369,243369,243371,0,2,2
69474,4,3,243373,243373,243376,0,3,2
69475,1,3,243374,243376,243379,2,5,0
69476,4,1,243378,243379,243380,1,2,0
69477,4,1,243382,243382,243383,0,1,2
69478,1,3,243383,243383,243386,0,3,0
69479,3,1,243386,243386,243387,0,1,0
69480,1,1,243387,243387,243388,0,1,0
69481,5,2,243392,243392,243394,0,2,4
69482,1,2,243393,243394,243396,1,3,0
69483,5,1,243398,243398,243399,0,1,2
69484,1,3,243399,243399,243402,0,3,0
69485,3,2,243402,243402,243404,0,2,0
69486,6,3,243408,243408,243411,0,3,4
69487,1,2,243409,243411,243413,2,4,0
69488,6,1,243415,243415,243416,0,1,2
69489,5,3,243420,243420,243423,0,3,4
69490,1,3,243421,243423,243426,2,5,0
69491,2,3,243423,243426,243429,3,6,0
69492,4,1,243427,243429,243430,2,3,0
69493,3,3,243430,243430,243433,0,3,0
69494,6,1,243436,243436,243437,0,1,3
69495,3,2,243439,243439,243441,0,2,2
69496,2,3,243441,243441,243444,0,3,0
69497,3,2,243444,243444,243446,0,2,0
69498,2,2,243446,243446,243448,0,2,0
69499,5,3,243451,243451,243454,0,3,3
69500,1,3,243452,243454,243457,2,5,0
69501,6,1,243458,243458,243459,0,1,1
69502,6,2,243464,243464,243466,0,2,5
69503,1,1,243465,243466,243467,1,2,0
69504,2,3,243467,243467,243470,0,3,0
69505,4,2,243471,243471,243473,0,2,1
69506,5,3,243476,243476,243479,0,3,3
69507,5,1,243481,243481,243482,0,1,2
69508,6,3,243487,243487,243490,0,3,5
69509,3,3,243490,243490,243493,0,3,0
69510,4,2,243494,243494,243496,0,2,1
69511,5,1,243499,243499,243500,0,1,3
69512,4,3,243503,243503,243506,0,3,3
69513,5,1,243508,243508,243509,0,1,2
69514,2,3,243510,243510,243513,0,3,1
69515,3,1,243513,243513,243514,0,1,0
69516,5,3,243518,243518,243521,0,3,4
69517,5,3,243523,243523,243526,0,3,2
69518,3,3,243526,243526,243529,0,3,0
69519,4,3,243530,243530,243533,0,3,1
69520,4,1,243534,243534,243535,0,1,1
69521,1,2,243535,243535,243537,0,2,0
69522,2,3,243537,243537,243540,0,3,0
69523,5,2,243542,243542,243544,0,2,2
69524,4,3,243546,243546,243549,0,3,2
69525,4,1,243550,243550,243551,0,1,1
69526,4,2,243554,243554,243556,0,2,3
69527,3,1,243557,243557,243558,0,1,1
69528,5,2,243562,243562,243564,0,2,4
69529,2,1,243564,243564,243565,0,1,0
69530,3,1,243567,243567,243568,0,1,2
69531,3,1,243570,243570,243571,0,1,2
69532,1,1,243571,243571,243572,0,1,0
69533,6,1,243577,243577,243578,0,1,5
69534,2,2,243579,243579,243581,0,2,1
69535,1,3,243580,243581,243584,1,4,0
69536,6,3,243586,243586,243589,0,3,2
69537,4,1,243590,243590,243591,0,1,1
69538,1,3,243591,243591,243594,0,3,0
69539,3,2,243594,243594,243596,0,2,0
69540,5,3,243599,243599,243602,0,3,3
69541,5,2,243604,243604,243606,0,2,2
69542,5,3,243609,243609,243612,0,3,3
69543,5,1,243614,243614,243615,0,1,2
69544,5,3,243619,243619,243622,0,3,4
69545,1,3,243620,243622,243625,2,5,0
69546,1,1,243621,243625,243626,4,5,0
69547,2,1,243623,243626,243627,3,4,0
69548,2,3,243625,243627,243630,2,5,0
69549,1,1,243626,243630,243631,4,5,0
69550,3,2,243629,243631,243633,2,4,0
69551,6,1,243635,243635,243636,0,1,2
69552,4,3,243639,243639,243642,0,3,3
69553,4,2,243643,243643,243645,0,2,1
69554,6,1,243649,243649,243650,0,1,4
69555,2,1,243651,243651,243652,0,1,1
69556,1,3,243652,243652,243655,0,3,0
69557,5,2,243657,243657,243659,0,2,2
69558,2,3,243659,243659,243662,0,3,0
69559,2,2,243661,243662,243664,1,3,0
69560,1,2,243662,243664,243666,2,4,0
69561,1,2,243663,243666,243668,3,5,0
69562,1,3,243664,243668,243671,4,7,0
69563,5,3,243669,243671,243674,2,5,0
69564,4,1,243673,243674,243675,1,2,0
69565,4,1,243677,243677,243678,0,1,2
69566,1,1,243678,243678,243679,0,1,0
69567,3,3,243681,243681,243684,0,3,2
69568,1,3,243682,243684,243687,2,5,0
69569,2,2,243684,243687,243689,3,5,0
69570,4,3,243688,243689,243692,1,4,0
69571,6,3,243694,243694,243697,0,3,2
69572,3,1,243697,243697,243698,0,1,0
69573,1,1,243698,243698,243699,0,1,0
69574,6,2,243704,243704,243706,0,2,5
69575,2,3,243706,243706,243709,0,3,0
69576,2,3,243708,243709,243712,1,4,0
69577,4,1,243712,243712,243713,0,1,0
69578,1,3,243713,243713,243716,0,3,0
69579,3,3,243716,243716,243719,0,3,0
69580,4,1,243720,243720,243721,0,1,1
69581,4,1,243724,243724,243725,0,1,3
69582,5,3,243729,243729,243732,0,3,4
69583,1,1,243730,243732,243733,2,3,0
69584,6,2,243736,243736,243738,0,2,3
69585,5,1,243741,243741,243742,0,1,3
69586,6,2,243747,243747,243749,0,2,5
69587,5,2,243752,243752,243754,0,2,3
69588,4,1,243756,243756,243757,0,1,2
69589,4,3,243760,243760,243763,0,3,3
69590,4,3,243764,243764,243767,0,3,1
69591,1,3,243765,243767,243770,2,5,0
69592,2,1,243767,243770,243771,3,4,0
69593,2,3,243769,243771,243774,2,5,0
69594,2,1,243771,243774,243775,3,4,0
69595,4,3,243775,243775,243778,0,3,0
69596,4,3,243779,243779,243782,0,3,1
69597,3,1,243782,243782,243783,0,1,0
69598,5,2,243787,243787,243789,0,2,4
69599,1,1,243788,243789,243790,1,2,0
69600,3,1,243791,243791,243792,0,1,1
69601,4,1,243795,243795,243796,0,1,3
69602,3,1,243798,243798,243799,0,1,2
69603,3,1,243801,243801,243802,0,1,2
69604,1,1,243802,243802,243803,0,1,0
69605,6,1,243808,243808,243809,0,1,5
69606,2,3,243810,243810,243813,0,3,1
69607,6,3,243816,243816,243819,0,3,3
69608,4,3,243820,243820,243823,0,3,1
69609,3,3,243823,243823,243826,0,3,0
69610,6,1,243829,243829,243830,0,1,3
69611,2,2,243831,243831,243833,0,2,1
69612,6,2,243837,243837,243839,0,2,4
69613,1,1,243838,243839,243840,1,2,0
69614,3,2,243841,243841,243843,0,2,1
69615,5,3,243846,243846,243849,0,3,3
69616,3,1,243849,243849,243850,0,1,0
69617,1,2,243850,243850,243852,0,2,0
69618,2,3,243852,243852,243855,0,3,0
69619,4,2,243856,243856,243858,0,2,1
69620,4,2,243860,243860,243862,0,2,2
69621,2,2,243862,243862,243864,0,2,0
69622,5,2,243867,243867,243869,0,2,3
69623,2,3,243869,243869,243872,0,3,0
69624,2,3,243871,243872,243875,1,4,0
69625,5,3,243876,243876,243879,0,3,1
69626,1,1,243877,243879,243880,2,3,0
69627,5,2,243882,243882,243884,0,2,2
69628,1,1,243883,243884,243885,1,2,0
69629,4,2,243887,243887,243889,0,2,2
69630,1,2,243888,243889,243891,1,3,0
69631,1,1,243889,243891,243892,2,3,0
69632,3,3,243892,243892,243895,0,3,0
69633,6,3,243898,243898,243901,0,3,3
69634,3,2,243901,243901,243903,0,2,0
69635,5,2,243906,243906,243908,0,2,3
69636,4,1,243910,243910,243911,0,1,2
69637,6,1,243916,243916,243917,0,1,5
69638,6,3,243922,243922,243925,0,3,5
69639,4,2,243926,243926,243928,0,2,1
69640,1,1,243927,243928,243929,1,2,0
69641,1,1,243928,243929,243930,1,2,0
69642,5,1,243933,243933,243934,0,1,3
69643,3,3,243936,243936,243939,0,3,2
69644,5,2,243941,243941,243943,0,2,2
69645,1,2,243942,243943,243945,1,3,0
69646,1,1,243943,243945,243946,2,3,0
69647,3,2,243946,243946,243948,0,2,0
69648,6,3,243952,243952,243955,0,3,4
69649,6,2,243958,243958,243960,0,2,3
69650,6,1,243964,243964,243965,0,1,4
69651,3,2,243967,243967,243969,0,2,2
69652,3,2,243970,243970,243972,0,2,1
69653,3,1,243973,243973,243974,0,1,1
69654,6,1,243979,243979,243980,0,1,5
69655,3,3,243982,243982,243985,0,3,2
69656,3,3,243985,243985,243988,0,3,0
69657,1,3,243986,243988,243991,2,5,0
69658,5,1,243991,243991,243992,0,1,0
69659,6,3,243997,243997,244000,0,3,5
69660,1,3,243998,244000,244003,2,5,0
69661,3,1,244001,244003,244004,2,3,0
69662,6,1,244007,244007,244008,0,1,3
69663,3,2,244010,244010,244012,0,2,2
69664,6,2,244016,244016,244018,0,2,4
69665,3,2,244019,244019,244021,0,2,1
69666,1,2,244020,244021,244023,1,3,0
69667,6,2,244026,244026,244028,0,2,3
69668,3,3,244029,244029,244032,0,3,1
69669,3,1,244032,244032,244033,0,1,0
69670,2,3,244034,244034,244037,0,3,1
69671,5,1,244039,244039,244040,0,1,2
69672,3,3,244042,244042,244045,0,3,2
69673,6,2,244048,244048,244050,0,2,3
69674,5,3,244053,244053,244056,0,3,3
69675,3,1,244056,244056,244057,0,1,0
69676,4,1,244060,244060,244061,0,1,3
69677,5,3,244065,244065,244068,0,3,4
69678,1,3,244066,244068,244071,2,5,0
69679,4,1,244070,244071,244072,1,2,0
69680,4,3,244074,244074,244077,0,3,2
69681,5,1,244079,244079,244080,0,1,2
69682,5,2,244084,244084,244086,0,2,4
69683,4,2,244088,244088,244090,0,2,2
69684,6,1,244094,244094,244095,0,1,4
69685,6,2,244100,244100,244102,0,2,5
69686,4,2,244104,244104,244106,0,2,2
69687,6,3,244110,244110,244113,0,3,4
69688,5,2,244115,244115,244117,0,2,2
69689,3,3,244118,244118,244121,0,3,1
69690,5,1,244123,244123,244124,0,1,2
69691,4,3,244127,244127,244130,0,3,3
69692,4,2,244131,244131,244133,0,2,1
69693,6,3,244137,244137,244140,0,3,4
69694,2,2,244139,244140,244142,1,3,0
69695,2,2,244141,244142,244144,1,3,0
69696,6,1,244147,244147,244148,0,1,3
69697,6,3,244153,244153,244156,0,3,5
69698,4,2,244157,244157,244159,0,2,1
69699,4,2,244161,244161,244163,0,2,2
69700,5,3,244166,244166,244169,0,3,3
69701,1,3,244167,244169,244172,2,5,0
69702,5,3,244172,244172,244175,0,3,0
69703,5,1,244177,244177,244178,0,1,2
69704,1,3,244178,244178,244181,0,3,0
69705,4,3,244182,244182,244185,0,3,1
69706,4,1,244186,244186,244187,0,1,1
69707,4,3,244190,244190,244193,0,3,3
69708,1,2,244191,244193,244195,2,4,0
69709,4,1,244195,244195,244196,0,1,0
69710,1,1,244196,244196,244197,0,1,0
69711,1,3,244197,244197,244200,0,3,0
69712,4,2,244201,244201,244203,0,2,1
69713,4,1,244205,244205,244206,0,1,2
69714,1,3,244206,244206,244209,0,3,0
69715,5,3,244211,244211,244214,0,3,2
69716,3,2,244214,244214,244216,0,2,0
69717,2,1,244216,244216,244217,0,1,0
69718,3,1,244219,244219,244220,0,1,2
69719,5,3,244224,244224,244227,0,3,4
69720,3,2,244227,244227,244229,0,2,0
69721,3,1,244230,244230,244231,0,1,1
69722,6,1,244236,244236,244237,0,1,5
69723,4,2,244240,244240,244242,0,2,3
69724,6,1,244246,244246,244247,0,1,4
69725,6,1,244252,244252,244253,0,1,5
69726,2,2,244254,244254,244256,0,2,1
69727,1,2,244255,244256,244258,1,3,0
69728,3,2,244258,244258,244260,0,2,0
69729,5,2,244263,244263,244265,0,2,3
69730,2,2,244265,244265,244267,0,2,0
69731,5,1,244270,244270,244271,0,1,3
69732,1,3,244271,244271,244274,0,3,0
69733,6,3,244277,244277,244280,0,3,3
69734,4,1,244281,244281,244282,0,1,1
69735,4,1,244285,244285,244286,0,1,3
69736,3,3,244288,244288,244291,0,3,2
69737,3,3,244291,244291,244294,0,3,0
69738,3,2,244294,244294,244296,0,2,0
69739,4,2,244298,244298,244300,0,2,2
69740,1,3,244299,244300,244303,1,4,0
69741,5,1,244304,244304,244305,0,1,1
69742,2,1,244306,244306,244307,0,1,1
69743,1,3,244307,244307,244310,0,3,0
69744,2,2,244309,244310,244312,1,3,0
69745,3,1,244312,244312,244313,0,1,0
69746,1,2,244313,244313,244315,0,2,0
69747,3,2,244316,244316,244318,0,2,1
69748,3,2,244319,244319,244321,0,2,1
69749,1,2,244320,244321,244323,1,3,0
69750,2,3,244322,244323,244326,1,4,0
69751,2,1,244324,244326,244327,2,3,0
69752,1,2,244325,244327,244329,2,4,0
69753,3,1,244328,244329,244330,1,2,0
69754,4,2,244332,244332,244334,0,2,2
69755,5,3,244337,244337,244340,0,3,3
69756,2,1,244339,244340,244341,1,2,0
69757,6,3,244345,244345,244348,0,3,4
69758,3,1,244348,244348,244349,0,1,0
69759,3,3,244351,244351,244354,0,3,2
69760,2,1,244353,244354,244355,1,2,0
69761,2,1,244355,244355,244356,0,1,0
69762,5,2,244360,244360,244362,0,2,4
69763,2,2,244362,244362,244364,0,2,0
69764,1,1,244363,244364,244365,1,2,0
69765,4,1,244367,244367,244368,0,1,2
69766,2,1,244369,244369,244370,0,1,1
69767,6,1,244375,244375,244376,0,1,5
69768,1,1,244376,244376,244377,0,1,0
69769,1,3,244377,244377,244380,0,3,0
69770,1,2,244378,244380,244382,2,4,0
69771,5,1,244383,244383,244384,0,1,1
69772,5,1,244388,244388,244389,0,1,4
69773,2,3,244390,244390,244393,0,3,1
69774,1,1,244391,244393,244394,2,3,0
69775,1,2,244392,244394,244396,2,4,0
69776,2,2,244394,244396,244398,2,4,0
69777,1,1,244395,244398,244399,3,4,0
69778,4,3,244399,244399,244402,0,3,0
69779,3,3,244402,244402,244405,0,3,0
69780,6,1,244408,244408,244409,0,1,3
69781,1,3,244409,244409,244412,0,3,0
69782,2,3,244411,244412,244415,1,4,0
69783,3,3,244414,244415,244418,1,4,0
69784,6,3,244420,244420,244423,0,3,2
69785,3,2,244423,244423,244425,0,2,0
69786,1,3,244424,244425,244428,1,4,0
69787,6,1,244430,244430,244431,0,1,2
69788,3,2,244433,244433,244435,0,2,2
69789,1,1,244434,244435,244436,1,2,0
69790,1,1,244435,244436,244437,1,2,0
69791,1,2,244436,244437,244439,1,3,0
69792,6,2,244442,244442,244444,0,2,3
69793,5,2,244447,244447,244449,0,2,3
69794,4,1,244451,244451,244452,0,1,2
69795,1,1,244452,244452,244453,0,1,0
69796,1,1,244453,244453,244454,0,1,0
69797,6,3,244459,244459,244462,0,3,5
69798,4,1,244463,244463,244464,0,1,1
69799,3,2,244466,244466,244468,0,2,2
69800,4,1,244470,244470,244471,0,1,2
69801,1,3,244471,244471,244474,0,3,0
69802,3,2,244474,244474,244476,0,2,0
69803,2,1,244476,244476,244477,0,1,0
69804,4,2,244480,244480,244482,0,2,3
69805,1,1,244481,244482,244483,1,2,0
69806,6,3,244487,244487,244490,0,3,4
69807,4,1,244491,244491,244492,0,1,1
69808,2,3,244493,244493,244496,0,3,1
69809,2,2,244495,244496,244498,1,3,0
69810,2,1,244497,244498,244499,1,2,0
69811,6,2,244503,244503,244505,0,2,4
69812,2,3,244505,244505,244508,0,3,0
69813,6,1,244511,244511,244512,0,1,3
69814,5,1,244516,244516,244517,0,1,4
69815,6,1,244522,244522,244523,0,1,5
69816,3,3,244525,244525,244528,0,3,2
69817,6,2,244531,244531,244533,0,2,3
69818,5,1,244536,244536,244537,0,1,3
69819,4,2,244540,244540,244542,0,2,3
69820,4,2,244544,244544,244546,0,2,2
69821,3,3,244547,244547,244550,0,3,1
69822,3,1,244550,244550,244551,0,1,0
69823,3,3,244553,244553,244556,0,3,2
69824,1,3,244554,244556,244559,2,5,0
69825,5,3,244559,244559,244562,0,3,0
69826,3,3,244562,244562,244565,0,3,0
69827,2,3,244564,244565,244568,1,4,0
69828,6,3,244570,244570,244573,0,3,2
69829,5,2,244575,244575,244577,0,2,2
69830,1,3,244576,244577,244580,1,4,0
69831,5,3,244581,244581,244584,0,3,1
69832,5,3,244586,244586,244589,0,3,2
69833,1,3,244587,244589,244592,2,5,0
69834,6,1,244593,244593,244594,0,1,1
69835,2,3,244595,244595,244598,0,3,1
69836,1,1,244596,244598,244599,2,3,0
69837,4,1,244600,244600,244601,0,1,1
69838,2,1,244602,244602,244603,0,1,1
69839,6,1,244608,244608,244609,0,1,5
69840,1,1,244609,244609,244610,0,1,0
69841,5,2,244614,244614,244616,0,2,4
69842,3,2,244617,244617,244619,0,2,1
69843,5,2,244622,244622,244624,0,2,3
69844,5,2,244627,244627,244629,0,2,3
69845,1,2,244628,244629,244631,1,3,0
69846,4,3,244632,244632,244635,0,3,1
69847,4,2,244636,244636,244638,0,2,1
69848,6,3,244642,244642,244645,0,3,4
69849,1,3,244643,244645,244648,2,5,0
69850,5,2,244648,244648,244650,0,2,0
69851,4,3,244652,244652,244655,0,3,2
69852,5,2,244657,244657,244659,0,2,2
69853,1,2,244658,244659,244661,1,3,0
69854,2,3,244660,244661,244664,1,4,0
69855,3,3,244663,244664,244667,1,4,0
69856,6,3,244669,244669,244672,0,3,2
69857,6,1,244675,244675,244676,0,1,3
69858,3,1,244678,244678,244679,0,1,2
69859,6,3,244684,244684,244687,0,3,5
69860,4,1,244688,244688,244689,0,1,1
69861,6,2,244694,244694,244696,0,2,5
69862,5,2,244699,244699,244701,0,2,3
69863,5,1,244704,244704,244705,0,1,3
69864,6,1,244710,244710,244711,0,1,5
69865,6,2,244716,244716,244718,0,2,5
69866,1,2,244717,244718,244720,1,3,0
69867,5,2,244722,244722,244724,0,2,2
69868,6,1,244728,244728,244729,0,1,4
69869,5,2,244733,244733,244735,0,2,4
69870,3,1,244736,244736,244737,0,1,1
69871,5,2,244741,244741,244743,0,2,4
69872,6,1,244747,244747,244748,0,1,4
69873,4,1,244751,244751,244752,0,1,3
69874,5,2,244756,244756,244758,0,2,4
69875,4,1,244760,244760,244761,0,1,2
69876,3,3,244763,244763,244766,0,3,2
69877,5,1,244768,244768,244769,0,1,2
69878,4,1,244772,244772,244773,0,1,3
69879,2,1,244774,244774,244775,0,1,1
69880,1,1,244775,244775,244776,0,1,0
69881,3,2,244778,244778,244780,0,2,2
69882,4,1,244782,244782,244783,0,1,2
69883,6,3,244788,244788,244791,0,3,5
69884,2,1,244790,244791,244792,1,2,0
69885,3,3,244793,244793,244796,0,3,1
69886,4,3,244797,244797,244800,0,3,1
69887,4,2,244801,244801,244803,0,2,1
69888,1,2,244802,244803,244805,1,3,0
69889,4,2,244806,244806,244808,0,2,1
69890,1,2,244807,244808,244810,1,3,0
69891,6,3,244813,244813,244816,0,3,3
69892,1,2,244814,244816,244818,2,4,0
69893,2,3,244816,244818,244821,2,5,0
69894,6,2,244822,244822,244824,0,2,1
69895,1,3,244823,244824,244827,1,4,0
69896,6,3,244829,244829,244832,0,3,2
69897,3,3,244832,244832,244835,0,3,0
69898,3,3,244835,244835,244838,0,3,0
69899,5,3,244840,244840,244843,0,3,2
69900,3,2,244843,244843,244845,0,2,0
69901,3,1,244846,244846,244847,0,1,1
69902,2,2,244848,244848,244850,0,2,1
69903,5,3,244853,244853,244856,0,3,3
69904,1,1,244854,244856,244857,2,3,0
69905,5,3,244859,244859,244862,0,3,2
69906,2,1,244861,244862,244863,1,2,0
69907,5,3,244866,244866,244869,0,3,3
69908,4,2,244870,244870,244872,0,2,1
69909,6,1,244876,244876,244877,0,1,4
69910,2,2,244878,244878,244880,0,2,1
69911,6,2,244884,244884,244886,0,2,4
69912,6,3,244890,244890,244893,0,3,4
69913,5,2,244895,244895,244897,0,2,2
69914,1,2,244896,244897,244899,1,3,0
69915,3,1,244899,244899,244900,0,1,0
69916,2,1,244901,244901,244902,0,1,1
69917,1,1,244902,244902,244903,0,1,0
69918,2,1,244904,244904,244905,0,1,1
69919,6,3,244910,244910,244913,0,3,5
69920,5,2,244915,244915,244917,0,2,2
69921,6,2,244921,244921,244923,0,2,4
69922,1,3,244922,244923,244926,1,4,0
69923,5,1,244927,244927,244928,0,1,1
69924,5,1,244932,244932,244933,0,1,4
69925,5,2,244937,244937,244939,0,2,4
69926,5,2,244942,244942,244944,0,2,3
69927,6,2,244948,244948,244950,0,2,4
69928,2,3,244950,244950,244953,0,3,0
69929,5,2,244955,244955,244957,0,2,2
69930,5,1,244960,244960,244961,0,1,3
69931,3,3,244963,244963,244966,0,3,2
69932,6,3,244969,244969,244972,0,3,3
69933,1,1,244970,244972,244973,2,3,0
69934,4,1,244974,244974,244975,0,1,1
69935,5,2,244979,244979,244981,0,2,4
69936,5,1,244984,244984,244985,0,1,3
69937,3,1,244987,244987,244988,0,1,2
69938,4,1,244991,244991,244992,0,1,3
69939,6,1,244997,244997,244998,0,1,5
69940,2,3,244999,244999,245002,0,3,1
69941,6,3,245005,245005,245008,0,3,3
69942,2,3,245007,245008,245011,1,4,0
69943,2,2,245009,245011,245013,2,4,0
69944,6,2,245015,245015,245017,0,2,2
69945,5,3,245020,245020,245023,0,3,3
69946,1,3,245021,245023,245026,2,5,0
69947,3,1,245024,245026,245027,2,3,0
69948,2,1,245026,245027,245028,1,2,0
69949,1,3,245027,245028,245031,1,4,0
69950,4,2,245031,245031,245033,0,2,0
69951,4,1,245035,245035,245036,0,1,2
69952,5,3,245040,245040,245043,0,3,4
69953,4,2,245044,245044,245046,0,2,1
69954,1,3,245045,245046,245049,1,4,0
69955,2,3,245047,245049,245052,2,5,0
69956,1,2,245048,245052,245054,4,6,0
69957,4,2,245052,245054,245056,2,4,0
69958,3,3,245055,245056,245059,1,4,0
69959,5,2,245060,245060,245062,0,2,1
69960,2,2,245062,245062,245064,0,2,0
69961,1,2,245063,245064,245066,1,3,0
69962,4,3,245067,245067,245070,0,3,1
69963,2,1,245069,245070,245071,1,2,0
69964,1,2,245070,245071,245073,1,3,0
69965,1,2,245071,245073,245075,2,4,0
69966,1,3,245072,245075,245078,3,6,0
69967,2,3,245074,245078,245081,4,7,0
69968,4,2,245078,245081,245083,3,5,0
69969,2,2,245080,245083,245085,3,5,0
69970,6,2,245086,245086,245088,0,2,1
69971,5,1,245091,245091,245092,0,1,3
69972,6,2,245097,245097,245099,0,2,5
69973,6,2,245103,245103,245105,0,2,4
69974,2,3,245105,245105,245108,0,3,0
69975,6,1,245111,245111,245112,0,1,3
69976,5,2,245116,245116,245118,0,2,4
69977,2,2,245118,245118,245120,0,2,0
69978,1,2,245119,245120,245122,1,3,0
69979,1,1,245120,245122,245123,2,3,0
69980,6,1,245126,245126,245127,0,1,3
69981,6,1,245132,245132,245133,0,1,5
69982,2,1,245134,245134,245135,0,1,1
69983,4,1,245138,245138,245139,0,1,3
69984,4,2,245142,245142,245144,0,2,3
69985,2,2,245144,245144,245146,0,2,0
69986,4,3,245148,245148,245151,0,3,2
69987,1,1,245149,245151,245152,2,3,0
69988,5,2,245154,245154,245156,0,2,2
69989,6,1,245160,245160,245161,0,1,4
69990,5,3,245165,245165,245168,0,3,4
69991,1,2,245166,245168,245170,2,4,0
69992,5,2,245171,245171,245173,0,2,1
69993,6,2,245177,245177,245179,0,2,4
69994,6,3,245183,245183,245186,0,3,4
69995,2,2,245185,245186,245188,1,3,0
69996,3,2,245188,245188,245190,0,2,0
69997,2,2,245190,245190,245192,0,2,0
69998,5,2,245195,245195,245197,0,2,3
69999,6,2,245201,245201,245203,0,2,4
70000,3,1,245204,245204,245205,0,1,1
70001,3,3,245207,245207,245210,0,3,2
70002,2,2,245209,245210,245212,1,3,0
70003,1,1,245210,245212,245213,2,3,0
70004,5,1,245215,245215,245216,0,1,2
70005,1,1,245216,245216,245217,0,1,0
70006,6,3,245222,245222,245225,0,3,5
70007,4,3,245226,245226,245229,0,3,1
70008,5,3,245231,245231,245234,0,3,2
70009,4,2,245235,245235,245237,0,2,1
70010,4,3,245239,245239,245242,0,3,2
70011,3,2,245242,245242,245244,0,2,0
70012,6,1,245248,245248,245249,0,1,4
70013,3,1,245251,245251,245252,0,1,2
70014,1,1,245252,245252,245253,0,1,0
70015,3,2,245255,245255,245257,0,2,2
70016,4,2,245259,245259,245261,0,2,2
70017,5,3,245264,245264,245267,0,3,3
70018,1,2,245265,245267,245269,2,4,0
70019,6,2,245271,245271,245273,0,2,2
70020,5,2,245276,245276,245278,0,2,3
70021,4,2,245280,245280,245282,0,2,2
70022,2,1,245282,245282,245283,0,1,0
70023,3,2,245285,245285,245287,0,2,2
70024,2,2,245287,245287,245289,0,2,0
70025,1,1,245288,245289,245290,1,2,0
70026,5,1,245293,245293,245294,0,1,3
70027,2,1,245295,245295,245296,0,1,1
70028,3,2,245298,245298,245300,0,2,2
70029,5,1,245303,245303,245304,0,1,3
70030,4,3,245307,245307,245310,0,3,3
70031,3,2,245310,245310,245312,0,2,0
70032,2,2,245312,245312,245314,0,2,0
70033,3,3,245315,245315,245318,0,3,1
70034,4,3,245319,245319,245322,0,3,1
70035,6,1,245325,245325,245326,0,1,3
70036,4,1,245329,245329,245330,0,1,3
70037,6,3,245335,245335,245338,0,3,5
70038,1,2,245336,245338,245340,2,4,0
70039,4,3,245340,245340,245343,0,3,0
70040,2,3,245342,245343,245346,1,4,0
70041,4,1,245346,245346,245347,0,1,0
70042,3,1,245349,245349,245350,0,1,2
70043,4,2,245353,245353,245355,0,2,3
70044,5,3,245358,245358,245361,0,3,3
70045,6,1,245364,245364,245365,0,1,3
70046,1,1,245365,245365,245366,0,1,0
70047,2,1,245367,245367,245368,0,1,1
70048,1,2,245368,245368,245370,0,2,0
70049,2,1,245370,245370,245371,0,1,0
70050,4,1,245374,245374,245375,0,1,3
70051,1,3,245375,245375,245378,0,3,0
70052,4,3,245379,245379,245382,0,3,1
70053,1,2,245380,245382,245384,2,4,0
70054,2,2,245382,245384,245386,2,4,0
70055,3,3,245385,245386,245389,1,4,0
70056,6,3,245391,245391,245394,0,3,2
70057,4,2,245395,245395,245397,0,2,1
70058,6,1,245401,245401,245402,0,1,4
70059,2,2,245403,245403,245405,0,2,1
70060,2,2,245405,245405,245407,0,2,0
70061,6,3,245411,245411,245414,0,3,4
70062,3,1,245414,245414,245415,0,1,0
70063,3,1,245417,245417,245418,0,1,2
70064,3,3,245420,245420,245423,0,3,2
70065,4,2,245424,245424,245426,0,2,1
70066,5,2,245429,245429,245431,0,2,3
70067,1,2,245430,245431,245433,1,3,0
70068,4,3,245434,245434,245437,0,3,1
70069,5,1,245439,245439,245440,0,1,2
70070,3,2,245442,245442,245444,0,2,2
70071,4,2,245446,245446,245448,0,2,2
70072,3,2,245449,245449,245451,0,2,1
70073,3,2,245452,245452,245454,0,2,1
70074,1,2,245453,245454,245456,1,3,0
70075,1,1,245454,245456,245457,2,3,0
70076,3,2,245457,245457,245459,0,2,0
70077,6,1,245463,245463,245464,0,1,4
70078,6,3,245469,245469,245472,0,3,5
70079,1,1,245470,245472,245473,2,3,0
70080,6,1,245476,245476,245477,0,1,3
70081,1,3,245477,245477,245480,0,3,0
70082,6,3,245483,245483,245486,0,3,3
70083,3,3,245486,245486,245489,0,3,0
70084,5,3,245491,245491,245494,0,3,2
70085,4,1,245495,245495,245496,0,1,1
70086,2,1,245497,245497,245498,0,1,1
70087,3,2,245500,245500,245502,0,2,2
70088,1,3,245501,245502,245505,1,4,0
70089,1,1,245502,245505,245506,3,4,0
70090,2,3,245504,245506,245509,2,5,0
70091,6,1,245510,245510,245511,0,1,1
70092,6,2,245516,245516,245518,0,2,5
70093,4,2,245520,245520,245522,0,2,2
70094,4,2,245524,245524,245526,0,2,2
70095,2,3,245526,245526,245529,0,3,0
70096,1,2,245527,245529,245531,2,4,0
70097,4,3,245531,245531,245534,0,3,0
70098,5,2,245536,245536,245538,0,2,2
70099,3,2,245539,245539,245541,0,2,1
70100,2,2,245541,245541,245543,0,2,0
70101,3,2,245544,245544,245546,0,2,1
70102,4,1,245548,245548,245549,0,1,2
70103,4,1,245552,245552,245553,0,1,3
70104,4,3,245556,245556,245559,0,3,3
70105,4,1,245560,245560,245561,0,1,1
70106,4,1,245564,245564,245565,0,1,3
70107,2,1,245566,245566,245567,0,1,1
70108,6,1,245572,245572,245573,0,1,5
70109,5,2,245577,245577,245579,0,2,4
70110,2,2,245579,245579,245581,0,2,0
70111,6,3,245585,245585,245588,0,3,4
70112,2,1,245587,245588,245589,1,2,0
70113,5,3,245592,245592,245595,0,3,3
70114,5,3,245597,245597,245600,0,3,2
70115,4,3,245601,245601,245604,0,3,1
70116,6,1,245607,245607,245608,0,1,3
70117,3,2,245610,245610,245612,0,2,2
70118,2,1,245612,245612,245613,0,1,0
70119,2,1,245614,245614,245615,0,1,1
70120,2,2,245616,245616,245618,0,2,1
70121,3,1,245619,245619,245620,0,1,1
70122,3,3,245622,245622,245625,0,3,2
70123,5,2,245627,245627,245629,0,2,2
70124,1,2,245628,245629,245631,1,3,0
70125,4,1,245632,245632,245633,0,1,1
70126,6,3,245638,245638,245641,0,3,5
70127,2,3,245640,245641,245644,1,4,0
70128,5,2,245645,245645,245647,0,2,1
70129,4,1,245649,245649,245650,0,1,2
70130,3,3,245652,245652,245655,0,3,2
70131,3,1,245655,245655,245656,0,1,0
70132,1,1,245656,245656,245657,0,1,0
70133,1,2,245657,245657,245659,0,2,0
70134,1,3,245658,245659,245662,1,4,0
70135,2,3,245660,245662,245665,2,5,0
70136,5,1,245665,245665,245666,0,1,0
70137,3,2,245668,245668,245670,0,2,2
70138,5,1,245673,245673,245674,0,1,3
70139,6,2,245679,245679,245681,0,2,5
70140,5,2,245684,245684,245686,0,2,3
70141,5,2,245689,245689,245691,0,2,3
70142,5,2,245694,245694,245696,0,2,3
70143,5,2,245699,245699,245701,0,2,3
70144,4,1,245703,245703,245704,0,1,2
70145,3,3,245706,245706,245709,0,3,2
70146,4,1,245710,245710,245711,0,1,1
70147,1,1,245711,245711,245712,0,1,0
70148,4,1,245715,245715,245716,0,1,3
70149,3,1,245718,245718,245719,0,1,2
70150,2,1,245720,245720,245721,0,1,1
70151,3,2,245723,245723,245725,0,2,2
70152,4,2,245727,245727,245729,0,2,2
70153,1,1,245728,245729,245730,1,2,0
70154,5,1,245733,245733,245734,0,1,3
70155,3,2,245736,245736,245738,0,2,2
70156,5,1,245741,245741,245742,0,1,3
70157,4,3,245745,245745,245748,0,3,3
70158,5,1,245750,245750,245751,0,1,2
70159,3,2,245753,245753,245755,0,2,2
70160,5,3,245758,245758,245761,0,3,3
70161,1,1,245759,245761,245762,2,3,0
70162,3,2,245762,245762,245764,0,2,0
70163,6,1,245768,245768,245769,0,1,4
70164,2,1,245770,245770,245771,0,1,1
70165,3,1,245773,245773,245774,0,1,2
70166,3,3,245776,245776,245779,0,3,2
70167,6,2,245782,245782,245784,0,2,3
70168,1,1,245783,245784,245785,1,2,0
70169,1,2,245784,245785,245787,1,3,0
70170,5,3,245789,245789,245792,0,3,2
70171,2,3,245791,245792,245795,1,4,0
70172,1,3,245792,245795,245798,3,6,0
70173,3,2,245795,245798,245800,3,5,0
70174,2,1,245797,245800,245801,3,4,0
70175,5,2,245802,245802,245804,0,2,1
70176,2,2,245804,245804,245806,0,2,0
70177,6,1,245810,245810,245811,0,1,4
70178,5,2,245815,245815,245817,0,2,4
70179,6,1,245821,245821,245822,0,1,4
70180,3,2,245824,245824,245826,0,2,2
70181,4,3,245828,245828,245831,0,3,2
70182,2,1,245830,245831,245832,1,2,0
70183,5,3,245835,245835,245838,0,3,3
70184,1,2,245836,245838,245840,2,4,0
70185,3,1,245839,245840,245841,1,2,0
70186,3,1,245842,245842,245843,0,1,1
70187,6,1,245848,245848,245849,0,1,5
70188,6,2,245854,245854,245856,0,2,5
70189,3,3,245857,245857,245860,0,3,1
70190,2,1,245859,245860,245861,1,2,0
70191,1,3,245860,245861,245864,1,4,0
70192,4,3,245864,245864,245867,0,3,0
70193,4,3,245868,245868,245871,0,3,1
70194,1,2,245869,245871,245873,2,4,0
70195,4,2,245873,245873,245875,0,2,0
70196,5,1,245878,245878,245879,0,1,3
70197,4,2,245882,245882,245884,0,2,3
70198,5,1,245887,245887,245888,0,1,3
70199,5,1,245892,245892,245893,0,1,4
70200,6,3,245898,245898,245901,0,3,5
70201,6,1,245904,245904,245905,0,1,3
70202,6,3,245910,245910,245913,0,3,5
70203,2,3,245912,245913,245916,1,4,0
70204,2,3,245914,245916,245919,2,5,0
70205,2,1,245916,245919,245920,3,4,0
70206,1,3,245917,245920,245923,3,6,0
70207,1,2,245918,245923,245925,5,7,0
70208,4,1,245922,245925,245926,3,4,0
70209,5,1,245927,245927,245928,0,1,1
70210,3,3,245930,245930,245933,0,3,2
70211,3,3,245933,245933,245936,0,3,0
70212,1,1,245934,245936,245937,2,3,0
70213,2,3,245936,245937,245940,1,4,0
70214,2,2,245938,245940,245942,2,4,0
70215,5,3,245943,245943,245946,0,3,1
70216,4,1,245947,245947,245948,0,1,1
70217,6,3,245953,245953,245956,0,3,5
70218,6,1,245959,245959,245960,0,1,3
70219,6,2,245965,245965,245967,0,2,5
70220,6,2,245971,245971,245973,0,2,4
70221,4,2,245975,245975,245977,0,2,2
70222,4,3,245979,245979,245982,0,3,2
70223,1,1,245980,245982,245983,2,3,0
70224,1,2,245981,245983,245985,2,4,0
70225,2,1,245983,245985,245986,2,3,0
70226,5,2,245988,245988,245990,0,2,2
70227,6,1,245994,245994,245995,0,1,4
70228,3,3,245997,245997,246000,0,3,2
70229,1,2,245998,246000,246002,2,4,0
70230,2,2,246000,246002,246004,2,4,0
70231,3,2,246003,246004,246006,1,3,0
70232,6,3,246009,246009,246012,0,3,3
70233,2,1,246011,246012,246013,1,2,0
70234,4,2,246015,246015,246017,0,2,2
70235,1,2,246016,246017,246019,1,3,0
70236,4,3,246020,246020,246023,0,3,1
70237,5,2,246025,246025,246027,0,2,2
70238,6,1,246031,246031,246032,0,1,4
70239,3,2,246034,246034,246036,0,2,2
70240,4,3,246038,246038,246041,0,3,2
70241,5,1,246043,246043,246044,0,1,2
70242,4,2,246047,246047,246049,0,2,3
70243,1,2,246048,246049,246051,1,3,0
70244,3,2,246051,246051,246053,0,2,0
70245,6,3,246057,246057,246060,0,3,4
70246,5,2,246062,246062,246064,0,2,2
70247,2,2,246064,246064,246066,0,2,0
70248,5,3,246069,246069,246072,0,3,3
70249,5,2,246074,246074,246076,0,2,2
70250,5,3,246079,246079,246082,0,3,3
70251,3,1,246082,246082,246083,0,1,0
70252,4,1,246086,246086,246087,0,1,3
70253,6,2,246092,246092,246094,0,2,5
70254,6,1,246098,246098,246099,0,1,4
70255,4,2,246102,246102,246104,0,2,3
70256,4,1,246106,246106,246107,0,1,2
70257,1,2,246107,246107,246109,0,2,0
70258,4,3,246111,246111,246114,0,3,2
70259,4,1,246115,246115,246116,0,1,1
70260,3,3,246118,246118,246121,0,3,2
70261,3,2,246121,246121,246123,0,2,0
70262,1,3,246122,246123,246126,1,4,0
70263,5,3,246127,246127,246130,0,3,1
70264,3,1,246130,246130,246131,0,1,0
70265,2,1,246132,246132,246133,0,1,1
70266,5,1,246137,246137,246138,0,1,4
70267,3,3,246140,246140,246143,0,3,2
70268,6,2,246146,246146,246148,0,2,3
70269,4,2,246150,246150,246152,0,2,2
70270,6,1,246156,246156,246157,0,1,4
70271,3,2,246159,246159,246161,0,2,2
70272,2,1,246161,246161,246162,0,1,0
70273,3,2,246164,246164,246166,0,2,2
70274,5,1,246169,246169,246170,0,1,3
70275,4,2,246173,246173,246175,0,2,3
70276,3,2,246176,246176,246178,0,2,1
70277,4,2,246180,246180,246182,0,2,2
70278,1,3,246181,246182,246185,1,4,0
70279,5,2,246186,246186,246188,0,2,1
70280,6,2,246192,246192,246194,0,2,4
70281,6,2,246198,246198,246200,0,2,4
70282,5,2,246203,246203,246205,0,2,3
70283,5,2,246208,246208,246210,0,2,3
70284,2,3,246210,246210,246213,0,3,0
70285,2,1,246212,246213,246214,1,2,0
70286,2,2,246214,246214,246216,0,2,0
70287,6,1,246220,246220,246221,0,1,4
70288,6,1,246226,246226,246227,0,1,5
70289,5,1,246231,246231,246232,0,1,4
70290,6,2,246237,246237,246239,0,2,5
70291,3,2,246240,246240,246242,0,2,1
70292,1,1,246241,246242,246243,1,2,0
70293,1,1,246242,246243,246244,1,2,0
70294,1,1,246243,246244,246245,1,2,0
70295,1,3,246244,246245,246248,1,4,0
70296,3,2,246247,246248,246250,1,3,0
70297,3,3,246250,246250,246253,0,3,0
70298,6,1,246256,246256,246257,0,1,3
70299,5,1,246261,246261,246262,0,1,4
70300,1,1,246262,246262,246263,0,1,0
70301,1,1,246263,246263,246264,0,1,0
70302,3,3,246266,246266,246269,0,3,2
70303,4,2,246270,246270,246272,0,2,1
70304,6,3,246276,246276,246279,0,3,4
70305,5,2,246281,246281,246283,0,2,2
70306,2,2,246283,246283,246285,0,2,0
70307,2,1,246285,246285,246286,0,1,0
70308,3,2,246288,246288,246290,0,2,2
70309,5,1,246293,246293,246294,0,1,3
70310,3,3,246296,246296,246299,0,3,2
70311,2,2,246298,246299,246301,1,3,0
70312,3,2,246301,246301,246303,0,2,0
70313,6,1,246307,246307,246308,0,1,4
70314,1,1,246308,246308,246309,0,1,0
70315,2,2,246310,246310,246312,0,2,1
70316,1,3,246311,246312,246315,1,4,0
70317,5,3,246316,246316,246319,0,3,1
70318,2,2,246318,246319,246321,1,3,0
70319,2,1,246320,246321,246322,1,2,0
70320,2,3,246322,246322,246325,0,3,0
70321,4,3,246326,246326,246329,0,3,1
70322,5,1,246331,246331,246332,0,1,2
70323,2,3,246333,246333,246336,0,3,1
70324,5,3,246338,246338,246341,0,3,2
70325,3,2,246341,246341,246343,0,2,0
70326,4,1,246345,246345,246346,0,1,2
70327,4,1,246349,246349,246350,0,1,3
70328,6,2,246355,246355,246357,0,2,5
70329,6,1,246361,246361,246362,0,1,4
70330,6,3,246367,246367,246370,0,3,5
70331,5,2,246372,246372,246374,0,2,2
70332,1,2,246373,246374,246376,1,3,0
70333,4,1,246377,246377,246378,0,1,1
70334,4,3,246381,246381,246384,0,3,3
70335,6,1,246387,246387,246388,0,1,3
70336,6,1,246393,246393,246394,0,1,5
70337,4,3,246397,246397,246400,0,3,3
70338,5,3,246402,246402,246405,0,3,2
70339,5,2,246407,246407,246409,0,2,2
70340,1,2,246408,246409,246411,1,3,0
70341,4,1,246412,246412,246413,0,1,1
70342,1,2,246413,246413,246415,0,2,0
70343,5,1,246418,246418,246419,0,1,3
70344,4,1,246422,246422,246423,0,1,3
70345,3,3,246425,246425,246428,0,3,2
70346,4,3,246429,246429,246432,0,3,1
70347,3,1,246432,246432,246433,0,1,0
70348,1,2,246433,246433,246435,0,2,0
70349,5,3,246438,246438,246441,0,3,3
70350,2,1,246440,246441,246442,1,2,0
70351,1,2,246441,246442,246444,1,3,0
70352,6,1,246447,246447,246448,0,1,3
70353,6,1,246453,246453,246454,0,1,5
70354,2,3,246455,246455,246458,0,3,1
70355,2,2,246457,246458,246460,1,3,0
70356,3,1,246460,246460,246461,0,1,0
70357,5,1,246465,246465,246466,0,1,4
70358,1,1,246466,246466,246467,0,1,0
70359,2,1,246468,246468,246469,0,1,1
70360,2,2,246470,246470,246472,0,2,1
70361,6,1,246476,246476,246477,0,1,4
70362,5,1,246481,246481,246482,0,1,4
70363,5,2,246486,246486,246488,0,2,4
70364,6,1,246492,246492,246493,0,1,4
70365,1,1,246493,246493,246494,0,1,0
70366,2,2,246495,246495,246497,0,2,1
70367,6,2,246501,246501,246503,0,2,4
70368,4,1,246505,246505,246506,0,1,2
70369,1,1,246506,246506,246507,0,1,0
70370,6,1,246512,246512,246513,0,1,5
70371,4,1,246516,246516,246517,0,1,3
70372,6,1,246522,246522,246523,0,1,5
70373,4,1,246526,246526,246527,0,1,3
70374,3,3,246529,246529,246532,0,3,2
70375,2,1,246531,246532,246533,1,2,0
70376,6,3,246537,246537,246540,0,3,4
70377,4,2,246541,246541,246543,0,2,1
70378,4,2,246545,246545,246547,0,2,2
70379,2,1,246547,246547,246548,0,1,0
70380,3,2,246550,246550,246552,0,2,2
70381,3,3,246553,246553,246556,0,3,1
70382,2,1,246555,246556,246557,1,2,0
70383,2,1,246557,246557,246558,0,1,0
70384,1,3,246558,246558,246561,0,3,0
70385,2,1,246560,246561,246562,1,2,0
70386,2,1,246562,246562,246563,0,1,0
70387,5,1,246567,246567,246568,0,1,4
70388,3,1,246570,246570,246571,0,1,2
70389,4,1,246574,246574,246575,0,1,3
70390,5,1,246579,246579,246580,0,1,4
70391,6,3,246585,246585,246588,0,3,5
70392,4,1,246589,246589,246590,0,1,1
70393,3,3,246592,246592,246595,0,3,2
70394,1,1,246593,246595,246596,2,3,0
70395,5,2,246598,246598,246600,0,2,2
70396,4,1,246602,246602,246603,0,1,2
70397,5,1,246607,246607,246608,0,1,4
70398,6,3,246613,246613,246616,0,3,5
70399,2,1,246615,246616,246617,1,2,0
70400,6,1,246621,246621,246622,0,1,4
70401,2,3,246623,246623,246626,0,3,1
70402,5,2,246628,246628,246630,0,2,2
70403,2,2,246630,246630,246632,0,2,0
70404,1,2,246631,246632,246634,1,3,0
70405,1,3,246632,246634,246637,2,5,0
70406,6,1,246638,246638,246639,0,1,1
70407,6,2,246644,246644,246646,0,2,5
70408,4,2,246648,246648,246650,0,2,2
70409,2,3,246650,246650,246653,0,3,0
70410,2,3,246652,246653,246656,1,4,0
70411,5,3,246657,246657,246660,0,3,1
70412,2,2,246659,246660,246662,1,3,0
70413,4,2,246663,246663,246665,0,2,1
70414,2,3,246665,246665,246668,0,3,0
70415,4,1,246669,246669,246670,0,1,1
70416,4,1,246673,246673,246674,0,1,3
70417,1,3,246674,246674,246677,0,3,0
70418,4,2,246678,246678,246680,0,2,1
70419,2,3,246680,246680,246683,0,3,0
70420,3,1,246683,246683,246684,0,1,0
70421,1,2,246684,246684,246686,0,2,0
70422,4,3,246688,246688,246691,0,3,2
70423,6,2,246694,246694,246696,0,2,3
70424,1,2,246695,246696,246698,1,3,0
70425,4,1,246699,246699,246700,0,1,1
70426,1,1,246700,246700,246701,0,1,0
70427,6,3,246706,246706,246709,0,3,5
70428,4,1,246710,246710,246711,0,1,1
70429,4,1,246714,246714,246715,0,1,3
70430,4,3,246718,246718,246721,0,3,3
70431,6,3,246724,246724,246727,0,3,3
70432,3,3,246727,246727,246730,0,3,0
70433,1,1,246728,246730,246731,2,3,0
70434,6,2,246734,246734,246736,0,2,3
70435,5,3,246739,246739,246742,0,3,3
70436,2,2,246741,246742,246744,1,3,0
70437,3,2,246744,246744,246746,0,2,0
70438,1,1,246745,246746,246747,1,2,0
70439,5,1,246750,246750,246751,0,1,3
70440,2,2,246752,246752,246754,0,2,1
70441,3,2,246755,246755,246757,0,2,1
70442,2,3,246757,246757,246760,0,3,0
70443,2,1,246759,246760,246761,1,2,0
70444,4,2,246763,246763,246765,0,2,2
70445,3,3,246766,246766,246769,0,3,1
70446,1,2,246767,246769,246771,2,4,0
70447,2,1,246769,246771,246772,2,3,0
70448,5,2,246774,246774,246776,0,2,2
70449,3,1,246777,246777,246778,0,1,1
70450,6,2,246783,246783,246785,0,2,5
70451,5,1,246788,246788,246789,0,1,3
70452,3,1,246791,246791,246792,0,1,2
70453,2,1,246793,246793,246794,0,1,1
70454,3,2,246796,246796,246798,0,2,2
70455,2,2,246798,246798,246800,0,2,0
70456,3,3,246801,246801,246804,0,3,1
70457,5,1,246806,246806,246807,0,1,2
70458,5,3,246811,246811,246814,0,3,4
70459,4,3,246815,246815,246818,0,3,1
70460,4,2,246819,246819,246821,0,2,1
70461,2,2,246821,246821,246823,0,2,0
70462,2,3,246823,246823,246826,0,3,0
70463,3,1,246826,246826,246827,0,1,0
70464,3,2,246829,246829,246831,0,2,2
70465,3,3,246832,246832,246835,0,3,1
70466,3,2,246835,246835,246837,0,2,0
70467,3,2,246838,246838,246840,0,2,1
70468,2,3,246840,246840,246843,0,3,0
70469,1,3,246841,246843,246846,2,5,0
70470,1,1,246842,246846,246847,4,5,0
70471,4,3,246846,246847,246850,1,4,0
70472,5,3,246851,246851,246854,0,3,1
70473,5,1,246856,246856,246857,0,1,2
70474,5,1,246861,246861,246862,0,1,4
70475,6,3,246867,246867,246870,0,3,5
70476,1,2,246868,246870,246872,2,4,0
70477,3,3,246871,246872,246875,1,4,0
70478,1,1,246872,246875,246876,3,4,0
70479,5,1,246877,246877,246878,0,1,1
70480,6,1,246883,246883,246884,0,1,5
70481,4,1,246887,246887,246888,0,1,3
70482,6,3,246893,246893,246896,0,3,5
70483,5,2,246898,246898,246900,0,2,2
70484,2,1,246900,246900,246901,0,1,0
70485,3,1,246903,246903,246904,0,1,2
70486,2,3,246905,246905,246908,0,3,1
70487,1,1,246906,246908,246909,2,3,0
70488,4,2,246910,246910,246912,0,2,1
70489,1,3,246911,246912,246915,1,4,0
70490,5,1,246916,246916,246917,0,1,1
70491,3,3,246919,246919,246922,0,3,2
70492,6,1,246925,246925,246926,0,1,3
70493,5,2,246930,246930,246932,0,2,4
70494,2,3,246932,246932,246935,0,3,0
70495,1,1,246933,246935,246936,2,3,0
70496,5,3,246938,246938,246941,0,3,2
70497,2,2,246940,246941,246943,1,3,0
70498,4,3,246944,246944,246947,0,3,1
70499,3,3,246947,246947,246950,0,3,0
70500,2,3,246949,246950,246953,1,4,0
70501,5,3,246954,246954,246957,0,3,1
70502,5,3,246959,246959,246962,0,3,2
70503,5,1,246964,246964,246965,0,1,2
70504,2,2,246966,246966,246968,0,2,1
70505,1,1,246967,246968,246969,1,2,0
70506,1,1,246968,246969,246970,1,2,0
70507,6,2,246974,246974,246976,0,2,4
70508,3,1,246977,246977,246978,0,1,1
70509,2,2,246979,246979,246981,0,2,1
70510,4,2,246983,246983,246985,0,2,2
70511,3,2,246986,246986,246988,0,2,1
70512,3,2,246989,246989,246991,0,2,1
70513,3,3,246992,246992,246995,0,3,1
70514,5,1,246997,246997,246998,0,1,2
70515,5,1,247002,247002,247003,0,1,4
70516,1,2,247003,247003,247005,0,2,0
70517,6,2,247009,247009,247011,0,2,4
70518,6,1,247015,247015,247016,0,1,4
70519,1,1,247016,247016,247017,0,1,0
70520,6,1,247022,247022,247023,0,1,5
70521,2,2,247024,247024,247026,0,2,1
70522,1,2,247025,247026,247028,1,3,0
70523,3,1,247028,247028,247029,0,1,0
70524,4,3,247032,247032,247035,0,3,3
70525,6,2,247038,247038,247040,0,2,3
70526,2,2,247040,247040,247042,0,2,0
70527,2,3,247042,247042,247045,0,3,0
70528,3,3,247045,247045,247048,0,3,0
70529,2,1,247047,247048,247049,1,2,0
70530,3,1,247050,247050,247051,0,1,1
70531,6,2,247056,247056,247058,0,2,5
70532,2,2,247058,247058,247060,0,2,0
70533,6,1,247064,247064,247065,0,1,4
70534,1,2,247065,247065,247067,0,2,0
70535,5,1,247070,247070,247071,0,1,3
70536,6,3,247076,247076,247079,0,3,5
70537,4,3,247080,247080,247083,0,3,1
70538,3,2,247083,247083,247085,0,2,0
70539,3,2,247086,247086,247088,0,2,1
70540,1,2,247087,247088,247090,1,3,0
70541,1,3,247088,247090,247093,2,5,0
70542,6,2,247094,247094,247096,0,2,1
70543,1,3,247095,247096,247099,1,4,0
70544,2,1,247097,247099,247100,2,3,0
70545,6,3,247103,247103,247106,0,3,3
70546,4,1,247107,247107,247108,0,1,1
70547,2,2,247109,247109,247111,0,2,1
70548,3,1,247112,247112,247113,0,1,1
70549,5,1,247117,247117,247118,0,1,4
70550,3,3,247120,247120,247123,0,3,2
70551,1,3,247121,247123,247126,2,5,0
70552,4,2,247125,247126,247128,1,3,0
70553,3,1,247128,247128,247129,0,1,0
70554,4,2,247132,247132,247134,0,2,3
70555,4,2,247136,247136,247138,0,2,2
70556,3,2,247139,247139,247141,0,2,1
70557,1,1,247140,247141,247142,1,2,0
70558,2,3,247142,247142,247145,0,3,0
70559,2,2,247144,247145,247147,1,3,0
70560,6,2,247150,247150,247152,0,2,3
70561,2,2,247152,247152,247154,0,2,0
70562,6,3,247158,247158,247161,0,3,4
70563,4,2,247162,247162,247164,0,2,1
70564,6,3,247168,247168,247171,0,3,4
70565,5,2,247173,247173,247175,0,2,2
70566,6,3,247179,247179,247182,0,3,4
70567,6,2,247185,247185,247187,0,2,3
70568,1,3,247186,247187,247190,1,4,0
70569,5,1,247191,247191,247192,0,1,1
70570,3,1,247194,247194,247195,0,1,2
70571,2,2,247196,247196,247198,0,2,1
70572,1,1,247197,247198,247199,1,2,0
70573,2,3,247199,247199,247202,0,3,0
70574,6,1,247205,247205,247206,0,1,3
70575,3,1,247208,247208,247209,0,1,2
70576,4,3,247212,247212,247215,0,3,3
70577,4,3,247216,247216,247219,0,3,1
70578,1,3,247217,247219,247222,2,5,0
70579,5,2,247222,247222,247224,0,2,0
70580,2,1,247224,247224,247225,0,1,0
70581,5,2,247229,247229,247231,0,2,4
70582,1,1,247230,247231,247232,1,2,0
70583,6,2,247236,247236,247238,0,2,4
70584,6,2,247242,247242,247244,0,2,4
70585,4,1,247246,247246,247247,0,1,2
70586,2,1,247248,247248,247249,0,1,1
70587,5,3,247253,247253,247256,0,3,4
70588,4,3,247257,247257,247260,0,3,1
70589,1,1,247258,247260,247261,2,3,0
70590,1,1,247259,247261,247262,2,3,0
70591,6,2,247265,247265,247267,0,2,3
70592,5,3,247270,247270,247273,0,3,3
70593,3,1,247273,247273,247274,0,1,0
70594,2,1,247275,247275,247276,0,1,1
70595,4,2,247279,247279,247281,0,2,3
70596,4,2,247283,247283,247285,0,2,2
70597,4,1,247287,247287,247288,0,1,2
70598,1,3,247288,247288,247291,0,3,0
70599,6,2,247294,247294,247296,0,2,3
70600,3,2,247297,247297,247299,0,2,1
70601,3,1,247300,247300,247301,0,1,1
70602,2,1,247302,247302,247303,0,1,1
70603,3,2,247305,247305,247307,0,2,2
70604,5,3,247310,247310,247313,0,3,3
70605,4,3,247314,247314,247317,0,3,1
70606,4,3,247318,247318,247321,0,3,1
70607,5,1,247323,247323,247324,0,1,2
70608,2,3,247325,247325,247328,0,3,1
70609,1,1,247326,247328,247329,2,3,0
70610,1,1,247327,247329,247330,2,3,0
70611,1,1,247328,247330,247331,2,3,0
70612,5,1,247333,247333,247334,0,1,2
70613,3,2,247336,247336,247338,0,2,2
70614,3,1,247339,247339,247340,0,1,1
70615,6,3,247345,247345,247348,0,3,5
70616,2,1,247347,247348,247349,1,2,0
70617,4,2,247351,247351,247353,0,2,2
70618,2,1,247353,247353,247354,0,1,0
70619,6,1,247359,247359,247360,0,1,5
70620,6,3,247365,247365,247368,0,3,5
70621,5,3,247370,247370,247373,0,3,2
70622,5,1,247375,247375,247376,0,1,2
70623,1,2,247376,247376,247378,0,2,0
70624,2,2,247378,247378,247380,0,2,0
70625,3,2,247381,247381,247383,0,2,1
70626,6,2,247387,247387,247389,0,2,4
70627,1,2,247388,247389,247391,1,3,0
70628,3,1,247391,247391,247392,0,1,0
70629,2,3,247393,247393,247396,0,3,1
70630,4,1,247397,247397,247398,0,1,1
70631,1,1,247398,247398,247399,0,1,0
70632,3,3,247401,247401,247404,0,3,2
70633,1,2,247402,247404,247406,2,4,0
70634,6,1,247408,247408,247409,0,1,2
70635,1,3,247409,247409,247412,0,3,0
70636,4,2,247413,247413,247415,0,2,1
70637,5,1,247418,247418,247419,0,1,3
70638,6,2,247424,247424,247426,0,2,5
70639,6,1,247430,247430,247431,0,1,4
70640,1,2,247431,247431,247433,0,2,0
70641,1,2,247432,247433,247435,1,3,0
70642,1,3,247433,247435,247438,2,5,0
70643,2,3,247435,247438,247441,3,6,0
70644,5,1,247440,247441,247442,1,2,0
70645,1,3,247441,247442,247445,1,4,0
70646,3,3,247444,247445,247448,1,4,0
70647,4,1,247448,247448,247449,0,1,0
70648,1,3,247449,247449,247452,0,3,0
70649,5,2,247454,247454,247456,0,2,2
70650,3,1,247457,247457,247458,0,1,1
70651,3,1,247460,247460,247461,0,1,2
70652,3,1,247463,247463,247464,0,1,2
70653,3,3,247466,247466,247469,0,3,2
70654,1,2,247467,247469,247471,2,4,0
70655,5,3,247472,247472,247475,0,3,1
70656,5,1,247477,247477,247478,0,1,2
70657,6,2,247483,247483,247485,0,2,5
70658,5,1,247488,247488,247489,0,1,3
70659,6,3,247494,247494,247497,0,3,5
70660,6,1,247500,247500,247501,0,1,3
70661,4,1,247504,247504,247505,0,1,3
70662,4,2,247508,247508,247510,0,2,3
70663,1,3,247509,247510,247513,1,4,0
70664,2,3,247511,247513,247516,2,5,0
70665,6,1,247517,247517,247518,0,1,1
70666,6,1,247523,247523,247524,0,1,5
70667,3,2,247526,247526,247528,0,2,2
70668,4,3,247530,247530,247533,0,3,2
70669,1,2,247531,247533,247535,2,4,0
70670,4,3,247535,247535,247538,0,3,0
70671,4,1,247539,247539,247540,0,1,1
70672,3,3,247542,247542,247545,0,3,2
70673,3,1,247545,247545,247546,0,1,0
70674,4,3,247549,247549,247552,0,3,3
70675,6,3,247555,247555,247558,0,3,3
70676,2,3,247557,247558,247561,1,4,0
70677,4,3,247561,247561,247564,0,3,0
70678,3,3,247564,247564,247567,0,3,0
70679,5,3,247569,247569,247572,0,3,2
70680,4,1,247573,247573,247574,0,1,1
70681,5,3,247578,247578,247581,0,3,4
70682,1,1,247579,247581,247582,2,3,0
70683,6,2,247585,247585,247587,0,2,3
70684,3,1,247588,247588,247589,0,1,1
70685,5,1,247593,247593,247594,0,1,4
70686,3,3,247596,247596,247599,0,3,2
70687,2,2,247598,247599,247601,1,3,0
70688,5,3,247603,247603,247606,0,3,2
70689,1,1,247604,247606,247607,2,3,0
70690,2,3,247606,247607,247610,1,4,0
70691,6,2,247612,247612,247614,0,2,2
70692,4,1,247616,247616,247617,0,1,2
70693,1,3,247617,247617,247620,0,3,0
70694,1,2,247618,247620,247622,2,4,0
70695,5,1,247623,247623,247624,0,1,1
70696,1,1,247624,247624,247625,0,1,0
70697,6,1,247630,247630,247631,0,1,5
70698,6,2,247636,247636,247638,0,2,5
70699,6,2,247642,247642,247644,0,2,4
70700,3,2,247645,247645,247647,0,2,1
70701,2,1,247647,247647,247648,0,1,0
70702,1,1,247648,247648,247649,0,1,0
70703,4,1,247652,247652,247653,0,1,3
70704,3,1,247655,247655,247656,0,1,2
70705,5,2,247660,247660,247662,0,2,4
70706,6,3,247666,247666,247669,0,3,4
70707,6,3,247672,247672,247675,0,3,3
70708,3,1,247675,247675,247676,0,1,0
70709,4,2,247679,247679,247681,0,2,3
70710,5,1,247684,247684,247685,0,1,3
70711,3,1,247687,247687,247688,0,1,2
70712,4,2,247691,247691,247693,0,2,3
70713,6,3,247697,247697,247700,0,3,4
70714,5,3,247702,247702,247705,0,3,2
70715,1,2,247703,247705,247707,2,4,0
70716,4,1,247707,247707,247708,0,1,0
70717,4,1,247711,247711,247712,0,1,3
70718,5,2,247716,247716,247718,0,2,4
70719,2,3,247718,247718,247721,0,3,0
70720,2,2,247720,247721,247723,1,3,0
70721,2,1,247722,247723,247724,1,2,0
70722,3,1,247725,247725,247726,0,1,1
70723,3,2,247728,247728,247730,0,2,2
70724,2,3,247730,247730,247733,0,3,0
70725,4,1,247734,247734,247735,0,1,1
70726,6,3,247740,247740,247743,0,3,5
70727,2,3,247742,247743,247746,1,4,0
70728,5,3,247747,247747,247750,0,3,1
70729,2,3,247749,247750,247753,1,4,0
70730,6,2,247755,247755,247757,0,2,2
70731,1,2,247756,247757,247759,1,3,0
70732,1,1,247757,247759,247760,2,3,0
70733,3,3,247760,247760,247763,0,3,0
70734,4,2,247764,247764,247766,0,2,1
70735,2,3,247766,247766,247769,0,3,0
70736,4,2,247770,247770,247772,0,2,1
70737,5,1,247775,247775,247776,0,1,3
70738,1,3,247776,247776,247779,0,3,0
70739,5,1,247781,247781,247782,0,1,2
70740,6,3,247787,247787,247790,0,3,5
70741,4,3,247791,247791,247794,0,3,1
70742,4,3,247795,247795,247798,0,3,1
70743,3,2,247798,247798,247800,0,2,0
70744,2,3,247800,247800,247803,0,3,0
70745,1,1,247801,247803,247804,2,3,0
70746,2,3,247803,247804,247807,1,4,0
70747,5,1,247808,247808,247809,0,1,1
70748,1,2,247809,247809,247811,0,2,0
70749,6,2,247815,247815,247817,0,2,4
70750,1,3,247816,247817,247820,1,4,0
70751,6,1,247822,247822,247823,0,1,2
70752,1,2,247823,247823,247825,0,2,0
70753,6,3,247829,247829,247832,0,3,4
70754,2,1,247831,247832,247833,1,2,0
70755,5,1,247836,247836,247837,0,1,3
70756,4,1,247840,247840,247841,0,1,3
70757,3,1,247843,247843,247844,0,1,2
70758,1,1,247844,247844,247845,0,1,0
70759,5,1,247849,247849,247850,0,1,4
70760,6,2,247855,247855,247857,0,2,5
70761,2,1,247857,247857,247858,0,1,0
70762,4,3,247861,247861,247864,0,3,3
70763,5,2,247866,247866,247868,0,2,2
70764,3,2,247869,247869,247871,0,2,1
70765,5,3,247874,247874,247877,0,3,3
70766,3,3,247877,247877,247880,0,3,0
70767,4,3,247881,247881,247884,0,3,1
70768,1,2,247882,247884,247886,2,4,0
70769,5,2,247887,247887,247889,0,2,1
70770,1,3,247888,247889,247892,1,4,0
70771,5,1,247893,247893,247894,0,1,1
70772,1,2,247894,247894,247896,0,2,0
70773,6,1,247900,247900,247901,0,1,4
70774,4,2,247904,247904,247906,0,2,3
70775,6,3,247910,247910,247913,0,3,4
70776,3,3,247913,247913,247916,0,3,0
70777,6,3,247919,247919,247922,0,3,3
70778,2,1,247921,247922,247923,1,2,0
70779,4,3,247925,247925,247928,0,3,2
70780,4,3,247929,247929,247932,0,3,1
70781,6,2,247935,247935,247937,0,2,3
70782,3,2,247938,247938,247940,0,2,1
70783,1,2,247939,247940,247942,1,3,0
70784,4,2,247943,247943,247945,0,2,1
70785,1,2,247944,247945,247947,1,3,0
70786,5,2,247949,247949,247951,0,2,2
70787,1,1,247950,247951,247952,1,2,0
70788,1,2,247951,247952,247954,1,3,0
70789,5,2,247956,247956,247958,0,2,2
70790,4,2,247960,247960,247962,0,2,2
70791,1,1,247961,247962,247963,1,2,0
70792,1,1,247962,247963,247964,1,2,0
70793,4,1,247966,247966,247967,0,1,2
70794,6,3,247972,247972,247975,0,3,5
70795,4,3,247976,247976,247979,0,3,1
70796,3,2,247979,247979,247981,0,2,0
70797,6,1,247985,247985,247986,0,1,4
70798,3,2,247988,247988,247990,0,2,2
70799,2,3,247990,247990,247993,0,3,0
70800,3,3,247993,247993,247996,0,3,0
70801,1,1,247994,247996,247997,2,3,0
70802,3,3,247997,247997,248000,0,3,0
70803,4,2,248001,248001,248003,0,2,1
70804,2,2,248003,248003,248005,0,2,0
70805,6,1,248009,248009,248010,0,1,4
70806,1,1,248010,248010,248011,0,1,0
70807,3,2,248013,248013,248015,0,2,2
70808,1,2,248014,248015,248017,1,3,0
70809,2,1,248016,248017,248018,1,2,0
70810,4,2,248020,248020,248022,0,2,2
70811,4,2,248024,248024,248026,0,2,2
70812,3,2,248027,248027,248029,0,2,1
70813,2,3,248029,248029,248032,0,3,0
70814,6,1,248035,248035,248036,0,1,3
70815,6,2,248041,248041,248043,0,2,5
70816,5,3,248046,248046,248049,0,3,3
70817,1,3,248047,248049,248052,2,5,0
70818,2,2,248049,248052,248054,3,5,0
70819,4,1,248053,248054,248055,1,2,0
70820,2,2,248055,248055,248057,0,2,0
70821,3,3,248058,248058,248061,0,3,1
70822,2,2,248060,248061,248063,1,3,0
70823,1,2,248061,248063,248065,2,4,0
70824,5,2,248066,248066,248068,0,2,1
70825,2,2,248068,248068,248070,0,2,0
70826,6,1,248074,248074,248075,0,1,4
70827,1,1,248075,248075,248076,0,1,0
70828,1,2,248076,248076,248078,0,2,0
70829,6,3,248082,248082,248085,0,3,4
70830,4,1,248086,248086,248087,0,1,1
70831,3,1,248089,248089,248090,0,1,2
70832,4,2,248093,248093,248095,0,2,3
70833,1,3,248094,248095,248098,1,4,0
70834,5,1,248099,248099,248100,0,1,1
70835,4,1,248103,248103,248104,0,1,3
70836,5,1,248108,248108,248109,0,1,4
70837,4,1,248112,248112,248113,0,1,3
70838,5,1,248117,248117,248118,0,1,4
70839,6,1,248123,248123,248124,0,1,5
70840,6,3,248129,248129,248132,0,3,5
70841,1,3,248130,248132,248135,2,5,0
70842,2,2,248132,248135,248137,3,5,0
70843,3,2,248135,248137,248139,2,4,0
70844,4,3,248139,248139,248142,0,3,0
70845,5,3,248144,248144,248147,0,3,2
70846,5,2,248149,248149,248151,0,2,2
70847,3,1,248152,248152,248153,0,1,1
70848,3,3,248155,248155,248158,0,3,2
70849,6,3,248161,248161,248164,0,3,3
70850,5,2,248166,248166,248168,0,2,2
70851,1,3,248167,248168,248171,1,4,0
70852,5,1,248172,248172,248173,0,1,1
70853,4,3,248176,248176,248179,0,3,3
70854,5,3,248181,248181,248184,0,3,2
70855,6,2,248187,248187,248189,0,2,3
70856,3,2,248190,248190,248192,0,2,1
70857,3,1,248193,248193,248194,0,1,1
70858,2,3,248195,248195,248198,0,3,1
70859,1,3,248196,248198,248201,2,5,0
70860,5,1,248201,248201,248202,0,1,0
70861,5,2,248206,248206,248208,0,2,4
70862,1,1,248207,248208,248209,1,2,0
70863,3,1,248210,248210,248211,0,1,1
70864,5,2,248215,248215,248217,0,2,4
70865,4,2,248219,248219,248221,0,2,2
70866,3,1,248222,248222,248223,0,1,1
70867,1,3,248223,248223,248226,0,3,0
70868,3,1,248226,248226,248227,0,1,0
70869,4,2,248230,248230,248232,0,2,3
70870,4,2,248234,248234,248236,0,2,2
70871,6,3,248240,248240,248243,0,3,4
70872,2,3,248242,248243,248246,1,4,0
70873,5,2,248247,248247,248249,0,2,1
70874,2,2,248249,248249,248251,0,2,0
70875,4,2,248253,248253,248255,0,2,2
70876,4,2,248257,248257,248259,0,2,2
70877,5,1,248262,248262,248263,0,1,3
70878,5,1,248267,248267,248268,0,1,4
70879,4,2,248271,248271,248273,0,2,3
70880,4,3,248275,248275,248278,0,3,2
70881,6,1,248281,248281,248282,0,1,3
70882,5,2,248286,248286,248288,0,2,4
70883,5,3,248291,248291,248294,0,3,3
70884,2,1,248293,248294,248295,1,2,0
70885,1,2,248294,248295,248297,1,3,0
70886,2,2,248296,248297,248299,1,3,0
70887,2,2,248298,248299,248301,1,3,0
70888,4,3,248302,248302,248305,0,3,1
70889,4,2,248306,248306,248308,0,2,1
70890,3,1,248309,248309,248310,0,1,1
70891,4,2,248313,248313,248315,0,2,3
70892,1,3,248314,248315,248318,1,4,0
70893,1,1,248315,248318,248319,3,4,0
70894,5,1,248320,248320,248321,0,1,1
70895,6,2,248326,248326,248328,0,2,5
70896,2,2,248328,248328,248330,0,2,0
70897,3,2,248331,248331,248333,0,2,1
70898,3,1,248334,248334,248335,0,1,1
70899,3,1,248337,248337,248338,0,1,2
70900,4,2,248341,248341,248343,0,2,3
70901,4,3,248345,248345,248348,0,3,2
70902,1,3,248346,248348,248351,2,5,0
70903,1,1,248347,248351,248352,4,5,0
70904,4,1,248351,248352,248353,1,2,0
70905,2,2,248353,248353,248355,0,2,0
70906,6,3,248359,248359,248362,0,3,4
70907,6,2,248365,248365,248367,0,2,3
70908,2,1,248367,248367,248368,0,1,0
70909,1,3,248368,248368,248371,0,3,0
70910,3,3,248371,248371,248374,0,3,0
70911,2,3,248373,248374,248377,1,4,0
70912,5,2,248378,248378,248380,0,2,1
70913,4,1,248382,248382,248383,0,1,2
70914,3,3,248385,248385,248388,0,3,2
70915,1,2,248386,248388,248390,2,4,0
70916,6,1,248392,248392,248393,0,1,2
70917,1,1,248393,248393,248394,0,1,0
70918,2,1,248395,248395,248396,0,1,1
70919,2,3,248397,248397,248400,0,3,1
70920,1,1,248398,248400,248401,2,3,0
70921,2,3,248400,248401,248404,1,4,0
70922,4,1,248404,248404,248405,0,1,0
70923,2,3,248406,248406,248409,0,3,1
70924,1,1,248407,248409,248410,2,3,0
70925,6,3,248413,248413,248416,0,3,3
70926,5,2,248418,248418,248420,0,2,2
70927,5,2,248423,248423,248425,0,2,3
70928,1,3,248424,248425,248428,1,4,0
70929,1,2,248425,248428,248430,3,5,0
70930,6,1,248431,248431,248432,0,1,1
70931,5,1,248436,248436,248437,0,1,4
70932,2,3,248438,248438,248441,0,3,1
70933,6,3,248444,248444,248447,0,3,3
70934,4,3,248448,248448,248451,0,3,1
70935,6,2,248454,248454,248456,0,2,3
70936,1,2,248455,248456,248458,1,3,0
70937,2,1,248457,248458,248459,1,2,0
70938,3,2,248460,248460,248462,0,2,1
70939,1,3,248461,248462,248465,1,4,0
70940,3,3,248464,248465,248468,1,4,0
70941,1,2,248465,248468,248470,3,5,0
70942,2,3,248467,248470,248473,3,6,0
70943,2,3,248469,248473,248476,4,7,0
70944,1,2,248470,248476,248478,6,8,0
70945,6,1,248476,248478,248479,2,3,0
70946,1,3,248477,248479,248482,2,5,0
70947,5,2,248482,248482,248484,0,2,0
70948,4,1,248486,248486,248487,0,1,2
70949,2,3,248488,248488,248491,0,3,1
70950,4,3,248492,248492,248495,0,3,1
70951,6,3,248498,248498,248501,0,3,3
70952,2,3,248500,248501,248504,1,4,0
70953,1,3,248501,248504,248507,3,6,0
70954,5,1,248506,248507,248508,1,2,0
70955,4,1,248510,248510,248511,0,1,2
70956,6,3,248516,248516,248519,0,3,5
70957,5,2,248521,248521,248523,0,2,2
70958,5,1,248526,248526,248527,0,1,3
70959,3,1,248529,248529,248530,0,1,2
70960,6,1,248535,248535,248536,0,1,5
70961,4,1,248539,248539,248540,0,1,3
70962,2,2,248541,248541,248543,0,2,1
70963,4,2,248545,248545,248547,0,2,2
70964,2,2,248547,248547,248549,0,2,0
70965,2,1,248549,248549,248550,0,1,0
70966,2,3,248551,248551,248554,0,3,1
70967,2,3,248553,248554,248557,1,4,0
70968,1,3,248554,248557,248560,3,6,0
70969,6,2,248560,248560,248562,0,2,0
70970,1,1,248561,248562,248563,1,2,0
70971,1,2,248562,248563,248565,1,3,0
70972,1,2,248563,248565,248567,2,4,0
70973,3,1,248566,248567,248568,1,2,0
70974,5,1,248571,248571,248572,0,1,3
70975,5,1,248576,248576,248577,0,1,4
70976,1,2,248577,248577,248579,0,2,0
70977,4,2,248581,248581,248583,0,2,2
70978,6,2,248587,248587,248589,0,2,4
70979,6,2,248593,248593,248595,0,2,4
70980,3,1,248596,248596,248597,0,1,1
70981,1,1,248597,248597,248598,0,1,0
70982,3,3,248600,248600,248603,0,3,2
70983,6,3,248606,248606,248609,0,3,3
70984,6,1,248612,248612,248613,0,1,3
70985,3,1,248615,248615,248616,0,1,2
70986,5,2,248620,248620,248622,0,2,4
70987,5,3,248625,248625,248628,0,3,3
70988,3,2,248628,248628,248630,0,2,0
70989,4,1,248632,248632,248633,0,1,2
70990,4,3,248636,248636,248639,0,3,3
70991,4,2,248640,248640,248642,0,2,1
70992,4,2,248644,248644,248646,0,2,2
70993,2,1,248646,248646,248647,0,1,0
70994,4,3,248650,248650,248653,0,3,3
70995,4,2,248654,248654,248656,0,2,1
70996,4,2,248658,248658,248660,0,2,2
70997,3,3,248661,248661,248664,0,3,1
70998,3,1,248664,248664,248665,0,1,0
70999,1,3,248665,248665,248668,0,3,0
71000,5,1,248670,248670,248671,0,1,2
71001,5,3,248675,248675,248678,0,3,4
71002,6,3,248681,248681,248684,0,3,3
71003,3,3,248684,248684,248687,0,3,0
71004,2,3,248686,248687,248690,1,4,0
71005,4,2,248690,248690,248692,0,2,0
71006,5,1,248695,248695,248696,0,1,3
71007,4,2,248699,248699,248701,0,2,3
71008,6,2,248705,248705,248707,0,2,4
71009,6,2,248711,248711,248713,0,2,4
71010,6,1,248717,248717,248718,0,1,4
71011,1,1,248718,248718,248719,0,1,0
71012,3,3,248721,248721,248724,0,3,2
71013,4,3,248725,248725,248728,0,3,1
71014,4,1,248729,248729,248730,0,1,1
71015,5,2,248734,248734,248736,0,2,4
71016,2,1,248736,248736,248737,0,1,0
71017,5,3,248741,248741,248744,0,3,4
71018,3,3,248744,248744,248747,0,3,0
71019,4,3,248748,248748,248751,0,3,1
71020,3,1,248751,248751,248752,0,1,0
71021,1,2,248752,248752,248754,0,2,0
71022,5,2,248757,248757,248759,0,2,3
71023,3,1,248760,248760,248761,0,1,1
71024,4,1,248764,248764,248765,0,1,3
71025,6,1,248770,248770,248771,0,1,5
71026,2,3,248772,248772,248775,0,3,1
71027,6,1,248778,248778,248779,0,1,3
71028,1,3,248779,248779,248782,0,3,0
71029,5,3,248784,248784,248787,0,3,2
71030,3,1,248787,248787,248788,0,1,0
71031,1,1,248788,248788,248789,0,1,0
71032,6,1,248794,248794,248795,0,1,5
71033,2,3,248796,248796,248799,0,3,1
71034,6,1,248802,248802,248803,0,1,3
71035,4,3,248806,248806,248809,0,3,3
71036,1,2,248807,248809,248811,2,4,0
71037,2,2,248809,248811,248813,2,4,0
71038,4,2,248813,248813,248815,0,2,0
71039,4,3,248817,248817,248820,0,3,2
71040,2,2,248819,248820,248822,1,3,0
71041,5,3,248824,248824,248827,0,3,2
71042,5,3,248829,248829,248832,0,3,2
71043,6,2,248835,248835,248837,0,2,3
71044,2,2,248837,248837,248839,0,2,0
71045,2,2,248839,248839,248841,0,2,0
71046,3,3,248842,248842,248845,0,3,1
71047,3,2,248845,248845,248847,0,2,0
71048,1,1,248846,248847,248848,1,2,0
71049,5,3,248851,248851,248854,0,3,3
71050,2,2,248853,248854,248856,1,3,0
71051,5,1,248858,248858,248859,0,1,2
71052,5,1,248863,248863,248864,0,1,4
71053,3,1,248866,248866,248867,0,1,2
71054,3,1,248869,248869,248870,0,1,2
71055,2,3,248871,248871,248874,0,3,1
71056,1,2,248872,248874,248876,2,4,0
71057,4,3,248876,248876,248879,0,3,0
71058,1,2,248877,248879,248881,2,4,0
71059,5,2,248882,248882,248884,0,2,1
71060,4,1,248886,248886,248887,0,1,2
71061,4,2,248890,248890,248892,0,2,3
71062,1,3,248891,248892,248895,1,4,0
71063,4,3,248895,248895,248898,0,3,0
71064,2,1,248897,248898,248899,1,2,0
71065,2,2,248899,248899,248901,0,2,0
71066,5,3,248904,248904,248907,0,3,3
71067,5,3,248909,248909,248912,0,3,2
71068,1,1,248910,248912,248913,2,3,0
71069,1,3,248911,248913,248916,2,5,0
71070,4,3,248915,248916,248919,1,4,0
71071,6,2,248921,248921,248923,0,2,2
71072,2,1,248923,248923,248924,0,1,0
71073,1,3,248924,248924,248927,0,3,0
71074,2,2,248926,248927,248929,1,3,0
71075,3,2,248929,248929,248931,0,2,0
71076,1,3,248930,248931,248934,1,4,0
71077,5,3,248935,248935,248938,0,3,1
71078,5,3,248940,248940,248943,0,3,2
71079,1,2,248941,248943,248945,2,4,0
71080,5,2,248946,248946,248948,0,2,1
71081,2,3,248948,248948,248951,0,3,0
71082,1,2,248949,248951,248953,2,4,0
71083,6,3,248955,248955,248958,0,3,2
71084,5,2,248960,248960,248962,0,2,2
71085,6,1,248966,248966,248967,0,1,4
71086,2,3,248968,248968,248971,0,3,1
71087,2,1,248970,248971,248972,1,2,0
71088,3,3,248973,248973,248976,0,3,1
71089,3,1,248976,248976,248977,0,1,0
71090,4,1,248980,248980,248981,0,1,3
71091,4,2,248984,248984,248986,0,2,3
71092,6,3,248990,248990,248993,0,3,4
71093,6,1,248996,248996,248997,0,1,3
71094,4,3,249000,249000,249003,0,3,3
71095,4,3,249004,249004,249007,0,3,1
71096,2,3,249006,249007,249010,1,4,0
71097,3,1,249009,249010,249011,1,2,0
71098,3,2,249012,249012,249014,0,2,1
71099,5,2,249017,249017,249019,0,2,3
71100,1,2,249018,249019,249021,1,3,0
71101,4,1,249022,249022,249023,0,1,1
71102,6,2,249028,249028,249030,0,2,5
71103,6,2,249034,249034,249036,0,2,4
71104,2,2,249036,249036,249038,0,2,0
71105,2,3,249038,249038,249041,0,3,0
71106,5,1,249043,249043,249044,0,1,2
71107,3,1,249046,249046,249047,0,1,2
71108,4,3,249050,249050,249053,0,3,3
71109,1,1,249051,249053,249054,2,3,0
71110,1,1,249052,249054,249055,2,3,0
71111,5,1,249057,249057,249058,0,1,2
71112,3,3,249060,249060,249063,0,3,2
71113,5,2,249065,249065,249067,0,2,2
71114,3,3,249068,249068,249071,0,3,1
71115,1,3,249069,249071,249074,2,5,0
71116,3,1,249072,249074,249075,2,3,0
71117,4,3,249076,249076,249079,0,3,1
71118,6,3,249082,249082,249085,0,3,3
71119,2,1,249084,249085,249086,1,2,0
71120,5,2,249089,249089,249091,0,2,3
71121,3,2,249092,249092,249094,0,2,1
71122,4,2,249096,249096,249098,0,2,2
71123,2,2,249098,249098,249100,0,2,0
71124,2,3,249100,249100,249103,0,3,0
71125,3,3,249103,249103,249106,0,3,0
71126,1,1,249104,249106,249107,2,3,0
71127,2,3,249106,249107,249110,1,4,0
71128,5,1,249111,249111,249112,0,1,1
71129,4,2,249115,249115,249117,0,2,3
71130,1,2,249116,249117,249119,1,3,0
71131,2,2,249118,249119,249121,1,3,0
71132,3,1,249121,249121,249122,0,1,0
71133,2,2,249123,249123,249125,0,2,1
71134,4,3,249127,249127,249130,0,3,2
71135,5,3,249132,249132,249135,0,3,2
71136,2,3,249134,249135,249138,1,4,0
71137,3,2,249137,249138,249140,1,3,0
71138,3,2,249140,249140,249142,0,2,0
71139,2,2,249142,249142,249144,0,2,0
71140,1,1,249143,249144,249145,1,2,0
71141,2,1,249145,249145,249146,0,1,0
71142,4,2,249149,249149,249151,0,2,3
71143,2,3,249151,249151,249154,0,3,0
71144,3,1,249154,249154,249155,0,1,0
71145,1,2,249155,249155,249157,0,2,0
71146,4,2,249159,249159,249161,0,2,2
71147,2,2,249161,249161,249163,0,2,0
71148,4,2,249165,249165,249167,0,2,2
71149,2,2,249167,249167,249169,0,2,0
71150,3,2,249170,249170,249172,0,2,1
71151,3,1,249173,249173,249174,0,1,1
71152,1,2,249174,249174,249176,0,2,0
71153,1,2,249175,249176,249178,1,3,0
71154,4,3,249179,249179,249182,0,3,1
71155,4,3,249183,249183,249186,0,3,1
71156,4,1,249187,249187,249188,0,1,1
71157,4,2,249191,249191,249193,0,2,3
71158,4,3,249195,249195,249198,0,3,2
71159,3,1,249198,249198,249199,0,1,0
71160,4,1,249202,249202,249203,0,1,3
71161,6,1,249208,249208,249209,0,1,5
71162,1,1,249209,249209,249210,0,1,0
71163,6,1,249215,249215,249216,0,1,5
71164,1,2,249216,249216,249218,0,2,0
71165,4,3,249220,249220,249223,0,3,2
71166,3,3,249223,249223,249226,0,3,0
71167,1,2,249224,249226,249228,2,4,0
71168,5,1,249229,249229,249230,0,1,1
71169,5,1,249234,249234,249235,0,1,4
71170,6,1,249240,249240,249241,0,1,5
71171,4,2,249244,249244,249246,0,2,3
71172,4,3,249248,249248,249251,0,3,2
71173,5,3,249253,249253,249256,0,3,2
71174,3,2,249256,249256,249258,0,2,0
71175,6,3,249262,249262,249265,0,3,4
71176,1,2,249263,249265,249267,2,4,0
71177,5,2,249268,249268,249270,0,2,1
71178,2,3,249270,249270,249273,0,3,0
71179,4,3,249274,249274,249277,0,3,1
71180,6,2,249280,249280,249282,0,2,3
71181,1,2,249281,249282,249284,1,3,0
71182,1,3,249282,249284,249287,2,5,0
71183,2,1,249284,249287,249288,3,4,0
71184,5,3,249289,249289,249292,0,3,1
71185,1,3,249290,249292,249295,2,5,0
71186,5,1,249295,249295,249296,0,1,0
71187,4,1,249299,249299,249300,0,1,3
71188,1,3,249300,249300,249303,0,3,0
71189,4,3,249304,249304,249307,0,3,1
71190,3,3,249307,249307,249310,0,3,0
71191,6,2,249313,249313,249315,0,2,3
71192,6,3,249319,249319,249322,0,3,4
71193,5,1,249324,249324,249325,0,1,2
71194,2,2,249326,249326,249328,0,2,1
71195,4,1,249330,249330,249331,0,1,2
71196,3,2,249333,249333,249335,0,2,2
71197,4,2,249337,249337,249339,0,2,2
71198,3,2,249340,249340,249342,0,2,1
71199,5,3,249345,249345,249348,0,3,3
71200,5,1,249350,249350,249351,0,1,2
71201,4,1,249354,249354,249355,0,1,3
71202,6,1,249360,249360,249361,0,1,5
71203,1,2,249361,249361,249363,0,2,0
71204,2,1,249363,249363,249364,0,1,0
71205,3,1,249366,249366,249367,0,1,2
71206,4,2,249370,249370,249372,0,2,3
71207,2,1,249372,249372,249373,0,1,0
71208,4,1,249376,249376,249377,0,1,3
71209,5,3,249381,249381,249384,0,3,4
71210,1,1,249382,249384,249385,2,3,0
71211,1,1,249383,249385,249386,2,3,0
71212,4,3,249387,249387,249390,0,3,1
71213,1,3,249388,249390,249393,2,5,0
71214,5,2,249393,249393,249395,0,2,0
71215,1,2,249394,249395,249397,1,3,0
71216,5,3,249399,249399,249402,0,3,2
71217,2,2,249401,249402,249404,1,3,0
71218,2,3,249403,249404,249407,1,4,0
71219,2,1,249405,249407,249408,2,3,0
71220,5,2,249410,249410,249412,0,2,2
71221,5,3,249415,249415,249418,0,3,3
71222,6,1,249421,249421,249422,0,1,3
71223,5,2,249426,249426,249428,0,2,4
71224,4,3,249430,249430,249433,0,3,2
71225,6,1,249436,249436,249437,0,1,3
71226,4,2,249440,249440,249442,0,2,3
71227,3,3,249443,249443,249446,0,3,1
71228,3,2,249446,249446,249448,0,2,0
71229,3,3,249449,249449,249452,0,3,1
71230,6,2,249455,249455,249457,0,2,3
71231,5,1,249460,249460,249461,0,1,3
71232,5,3,249465,249465,249468,0,3,4
71233,1,2,249466,249468,249470,2,4,0
71234,2,2,249468,249470,249472,2,4,0
71235,3,3,249471,249472,249475,1,4,0
71236,2,2,249473,249475,249477,2,4,0
71237,5,2,249478,249478,249480,0,2,1
71238,2,2,249480,249480,249482,0,2,0
71239,3,1,249483,249483,249484,0,1,1
71240,4,2,249487,249487,249489,0,2,3
71241,3,1,249490,249490,249491,0,1,1
71242,1,2,249491,249491,249493,0,2,0
71243,1,2,249492,249493,249495,1,3,0
71244,6,3,249498,249498,249501,0,3,3
71245,2,3,249500,249501,249504,1,4,0
71246,5,1,249505,249505,249506,0,1,1
71247,4,3,249509,249509,249512,0,3,3
71248,6,1,249515,249515,249516,0,1,3
71249,1,3,249516,249516,249519,0,3,0
71250,3,3,249519,249519,249522,0,3,0
71251,2,1,249521,249522,249523,1,2,0
71252,1,1,249522,249523,249524,1,2,0
71253,1,3,249523,249524,249527,1,4,0
71254,4,2,249527,249527,249529,0,2,0
71255,3,2,249530,249530,249532,0,2,1
71256,2,1,249532,249532,249533,0,1,0
71257,4,1,249536,249536,249537,0,1,3
71258,6,2,249542,249542,249544,0,2,5
71259,2,2,249544,249544,249546,0,2,0
71260,1,3,249545,249546,249549,1,4,0
71261,5,1,249550,249550,249551,0,1,1
71262,3,3,249553,249553,249556,0,3,2
71263,4,3,249557,249557,249560,0,3,1
71264,4,2,249561,249561,249563,0,2,1
71265,5,2,249566,249566,249568,0,2,3
71266,4,3,249570,249570,249573,0,3,2
71267,2,1,249572,249573,249574,1,2,0
71268,6,2,249578,249578,249580,0,2,4
71269,1,3,249579,249580,249583,1,4,0
71270,1,2,249580,249583,249585,3,5,0
71271,4,2,249584,249585,249587,1,3,0
71272,1,2,249585,249587,249589,2,4,0
71273,2,3,249587,249589,249592,2,5,0
71274,5,3,249592,249592,249595,0,3,0
71275,3,3,249595,249595,249598,0,3,0
71276,2,3,249597,249598,249601,1,4,0
71277,6,2,249603,249603,249605,0,2,2
71278,6,2,249609,249609,249611,0,2,4
71279,4,3,249613,249613,249616,0,3,2
71280,4,3,249617,249617,249620,0,3,1
71281,2,2,249619,249620,249622,1,3,0
71282,5,1,249624,249624,249625,0,1,2
71283,4,3,249628,249628,249631,0,3,3
71284,4,1,249632,249632,249633,0,1,1
71285,4,3,249636,249636,249639,0,3,3
71286,1,1,249637,249639,249640,2,3,0
71287,5,2,249642,249642,249644,0,2,2
71288,2,1,249644,249644,249645,0,1,0
71289,1,1,249645,249645,249646,0,1,0
71290,5,3,249650,249650,249653,0,3,4
71291,4,2,249654,249654,249656,0,2,1
71292,3,2,249657,249657,249659,0,2,1
71293,2,3,249659,249659,249662,0,3,0
71294,3,1,249662,249662,249663,0,1,0
71295,4,2,249666,249666,249668,0,2,3
71296,2,1,249668,249668,249669,0,1,0
71297,3,1,249671,249671,249672,0,1,2
71298,4,1,249675,249675,249676,0,1,3
71299,1,2,249676,249676,249678,0,2,0
71300,5,3,249681,249681,249684,0,3,3
71301,5,2,249686,249686,249688,0,2,2
71302,3,3,249689,249689,249692,0,3,1
71303,2,1,249691,249692,249693,1,2,0
71304,6,2,249697,249697,249699,0,2,4
71305,2,1,249699,249699,249700,0,1,0
71306,3,3,249702,249702,249705,0,3,2
71307,4,1,249706,249706,249707,0,1,1
71308,2,3,249708,249708,249711,0,3,1
71309,3,1,249711,249711,249712,0,1,0
71310,3,3,249714,249714,249717,0,3,2
71311,2,1,249716,249717,249718,1,2,0
71312,6,2,249722,249722,249724,0,2,4
71313,1,1,249723,249724,249725,1,2,0
71314,2,3,249725,249725,249728,0,3,0
71315,5,3,249730,249730,249733,0,3,2
71316,5,1,249735,249735,249736,0,1,2
71317,2,2,249737,249737,249739,0,2,1
71318,5,1,249742,249742,249743,0,1,3
71319,5,1,249747,249747,249748,0,1,4
71320,6,1,249753,249753,249754,0,1,5
71321,3,2,249756,249756,249758,0,2,2
71322,6,3,249762,249762,249765,0,3,4
71323,5,1,249767,249767,249768,0,1,2
71324,4,3,249771,249771,249774,0,3,3
71325,3,2,249774,249774,249776,0,2,0
71326,4,1,249778,249778,249779,0,1,2
71327,2,3,249780,249780,249783,0,3,1
71328,1,1,249781,249783,249784,2,3,0
71329,2,3,249783,249784,249787,1,4,0
71330,2,3,249785,249787,249790,2,5,0
71331,1,2,249786,249790,249792,4,6,0
71332,3,3,249789,249792,249795,3,6,0
71333,5,3,249794,249795,249798,1,4,0
71334,6,3,249800,249800,249803,0,3,2
71335,5,3,249805,249805,249808,0,3,2
71336,3,1,249808,249808,249809,0,1,0
71337,2,3,249810,249810,249813,0,3,1
71338,4,1,249814,249814,249815,0,1,1
71339,5,3,249819,249819,249822,0,3,4
71340,4,2,249823,249823,249825,0,2,1
71341,3,2,249826,249826,249828,0,2,1
71342,5,3,249831,249831,249834,0,3,3
71343,4,1,249835,249835,249836,0,1,1
71344,6,2,249841,249841,249843,0,2,5
71345,3,2,249844,249844,249846,0,2,1
71346,1,3,249845,249846,249849,1,4,0
71347,1,1,249846,249849,249850,3,4,0
71348,4,2,249850,249850,249852,0,2,0
71349,2,2,249852,249852,249854,0,2,0
71350,4,3,249856,249856,249859,0,3,2
71351,3,1,249859,249859,249860,0,1,0
71352,5,1,249864,249864,249865,0,1,4
71353,2,3,249866,249866,249869,0,3,1
71354,5,1,249871,249871,249872,0,1,2
71355,6,2,249877,249877,249879,0,2,5
71356,2,3,249879,249879,249882,0,3,0
71357,5,2,249884,249884,249886,0,2,2
71358,2,2,249886,249886,249888,0,2,0
71359,5,3,249891,249891,249894,0,3,3
71360,2,3,249893,249894,249897,1,4,0
71361,4,2,249897,249897,249899,0,2,0
71362,2,2,249899,249899,249901,0,2,0
71363,1,1,249900,249901,249902,1,2,0
71364,6,1,249906,249906,249907,0,1,4
71365,1,2,249907,249907,249909,0,2,0
71366,4,3,249911,249911,249914,0,3,2
71367,6,2,249917,249917,249919,0,2,3
71368,3,3,249920,249920,249923,0,3,1
71369,2,2,249922,249923,249925,1,3,0
71370,4,2,249926,249926,249928,0,2,1
71371,5,3,249931,249931,249934,0,3,3
71372,3,1,249934,249934,249935,0,1,0
71373,3,2,249937,249937,249939,0,2,2
71374,5,2,249942,249942,249944,0,2,3
71375,3,3,249945,249945,249948,0,3,1
71376,4,3,249949,249949,249952,0,3,1
71377,1,2,249950,249952,249954,2,4,0
71378,3,3,249953,249954,249957,1,4,0
71379,4,3,249957,249957,249960,0,3,0
71380,3,1,249960,249960,249961,0,1,0
71381,4,2,249964,249964,249966,0,2,3
71382,5,1,249969,249969,249970,0,1,3
71383,4,1,249973,249973,249974,0,1,3
71384,2,2,249975,249975,249977,0,2,1
71385,5,3,249980,249980,249983,0,3,3
71386,2,2,249982,249983,249985,1,3,0
71387,2,2,249984,249985,249987,1,3,0
71388,1,2,249985,249987,249989,2,4,0
71389,5,1,249990,249990,249991,0,1,1
71390,1,3,249991,249991,249994,0,3,0
71391,4,3,249995,249995,249998,0,3,1
71392,5,2,250000,250000,250002,0,2,2
71393,6,2,250006,250006,250008,0,2,4
71394,2,2,250008,250008,250010,0,2,0
71395,1,1,250009,250010,250011,1,2,0
71396,4,2,250013,250013,250015,0,2,2
71397,4,2,250017,250017,250019,0,2,2
71398,4,2,250021,250021,250023,0,2,2
71399,5,3,250026,250026,250029,0,3,3
71400,2,1,250028,250029,250030,1,2,0
71401,1,1,250029,250030,250031,1,2,0
71402,1,3,250030,250031,250034,1,4,0
71403,2,1,250032,250034,250035,2,3,0
71404,5,3,250037,250037,250040,0,3,2
71405,6,3,250043,250043,250046,0,3,3
71406,4,3,250047,250047,250050,0,3,1
71407,5,1,250052,250052,250053,0,1,2
71408,3,2,250055,250055,250057,0,2,2
71409,1,1,250056,250057,250058,1,2,0
71410,5,2,250061,250061,250063,0,2,3
71411,1,3,250062,250063,250066,1,4,0
71412,6,2,250068,250068,250070,0,2,2
71413,5,2,250073,250073,250075,0,2,3
71414,2,1,250075,250075,250076,0,1,0
71415,2,3,250077,250077,250080,0,3,1
71416,1,1,250078,250080,250081,2,3,0
71417,4,1,250082,250082,250083,0,1,1
71418,1,2,250083,250083,250085,0,2,0
71419,4,3,250087,250087,250090,0,3,2
71420,5,1,250092,250092,250093,0,1,2
71421,2,1,250094,250094,250095,0,1,1
71422,4,2,250098,250098,250100,0,2,3
71423,2,1,250100,250100,250101,0,1,0
71424,1,3,250101,250101,250104,0,3,0
71425,3,1,250104,250104,250105,0,1,0
71426,2,1,250106,250106,250107,0,1,1
71427,4,1,250110,250110,250111,0,1,3
71428,5,2,250115,250115,250117,0,2,4
71429,3,3,250118,250118,250121,0,3,1
71430,1,1,250119,250121,250122,2,3,0
71431,3,1,250122,250122,250123,0,1,0
71432,3,1,250125,250125,250126,0,1,2
71433,6,1,250131,250131,250132,0,1,5
71434,6,3,250137,250137,250140,0,3,5
71435,4,3,250141,250141,250144,0,3,1
71436,4,1,250145,250145,250146,0,1,1
71437,2,2,250147,250147,250149,0,2,1
71438,5,2,250152,250152,250154,0,2,3
71439,6,1,250158,250158,250159,0,1,4
71440,5,2,250163,250163,250165,0,2,4
71441,5,1,250168,250168,250169,0,1,3
71442,1,3,250169,250169,250172,0,3,0
71443,3,3,250172,250172,250175,0,3,0
71444,5,1,250177,250177,250178,0,1,2
71445,3,1,250180,250180,250181,0,1,2
71446,3,3,250183,250183,250186,0,3,2
71447,6,1,250189,250189,250190,0,1,3
71448,2,2,250191,250191,250193,0,2,1
71449,6,2,250197,250197,250199,0,2,4
71450,6,3,250203,250203,250206,0,3,4
71451,4,1,250207,250207,250208,0,1,1
71452,3,2,250210,250210,250212,0,2,2
71453,3,3,250213,250213,250216,0,3,1
71454,3,2,250216,250216,250218,0,2,0
71455,2,2,250218,250218,250220,0,2,0
71456,4,3,250222,250222,250225,0,3,2
71457,1,1,250223,250225,250226,2,3,0
71458,2,1,250225,250226,250227,1,2,0
71459,2,2,250227,250227,250229,0,2,0
71460,4,2,250231,250231,250233,0,2,2
71461,3,1,250234,250234,250235,0,1,1
71462,3,2,250237,250237,250239,0,2,2
71463,4,2,250241,250241,250243,0,2,2
71464,4,2,250245,250245,250247,0,2,2
71465,3,1,250248,250248,250249,0,1,1
71466,1,1,250249,250249,250250,0,1,0
71467,6,2,250255,250255,250257,0,2,5
71468,2,1,250257,250257,250258,0,1,0
71469,6,3,250263,250263,250266,0,3,5
71470,4,1,250267,250267,250268,0,1,1
71471,1,3,250268,250268,250271,0,3,0
71472,6,3,250274,250274,250277,0,3,3
71473,2,1,250276,250277,250278,1,2,0
71474,6,1,250282,250282,250283,0,1,4
71475,6,1,250288,250288,250289,0,1,5
71476,1,3,250289,250289,250292,0,3,0
71477,3,3,250292,250292,250295,0,3,0
71478,2,3,250294,250295,250298,1,4,0
71479,1,2,250295,250298,250300,3,5,0
71480,3,1,250298,250300,250301,2,3,0
71481,5,1,250303,250303,250304,0,1,2
71482,1,3,250304,250304,250307,0,3,0
71483,4,2,250308,250308,250310,0,2,1
71484,4,3,250312,250312,250315,0,3,2
71485,5,2,250317,250317,250319,0,2,2
71486,1,3,250318,250319,250322,1,4,0
71487,5,1,250323,250323,250324,0,1,1
71488,1,3,250324,250324,250327,0,3,0
71489,3,3,250327,250327,250330,0,3,0
71490,3,1,250330,250330,250331,0,1,0
71491,5,1,250335,250335,250336,0,1,4
71492,4,1,250339,250339,250340,0,1,3
71493,4,1,250343,250343,250344,0,1,3
71494,6,2,250349,250349,250351,0,2,5
71495,3,3,250352,250352,250355,0,3,1
71496,1,1,250353,250355,250356,2,3,0
71497,3,3,250356,250356,250359,0,3,0
71498,2,2,250358,250359,250361,1,3,0
71499,3,1,250361,250361,250362,0,1,0
71500,4,2,250365,250365,250367,0,2,3
71501,4,2,250369,250369,250371,0,2,2
71502,3,3,250372,250372,250375,0,3,1
71503,5,1,250377,250377,250378,0,1,2
71504,3,1,250380,250380,250381,0,1,2
71505,6,1,250386,250386,250387,0,1,5
71506,6,1,250392,250392,250393,0,1,5
71507,1,2,250393,250393,250395,0,2,0
71508,5,2,250398,250398,250400,0,2,3
71509,2,1,250400,250400,250401,0,1,0
71510,1,2,250401,250401,250403,0,2,0
71511,4,2,250405,250405,250407,0,2,2
71512,2,2,250407,250407,250409,0,2,0
71513,1,3,250408,250409,250412,1,4,0
71514,6,3,250414,250414,250417,0,3,2
71515,3,2,250417,250417,250419,0,2,0
71516,5,3,250422,250422,250425,0,3,3
71517,5,3,250427,250427,250430,0,3,2
71518,4,1,250431,250431,250432,0,1,1
71519,6,1,250437,250437,250438,0,1,5
71520,1,3,250438,250438,250441,0,3,0
71521,1,2,250439,250441,250443,2,4,0
71522,3,3,250442,250443,250446,1,4,0
71523,1,3,250443,250446,250449,3,6,0
71524,6,3,250449,250449,250452,0,3,0
71525,5,3,250454,250454,250457,0,3,2
71526,4,2,250458,250458,250460,0,2,1
71527,3,2,250461,250461,250463,0,2,1
71528,5,1,250466,250466,250467,0,1,3
71529,5,3,250471,250471,250474,0,3,4
71530,2,1,250473,250474,250475,1,2,0
71531,6,2,250479,250479,250481,0,2,4
71532,3,1,250482,250482,250483,0,1,1
71533,1,3,250483,250483,250486,0,3,0
71534,4,2,250487,250487,250489,0,2,1
71535,4,1,250491,250491,250492,0,1,2
71536,3,1,250494,250494,250495,0,1,2
71537,5,2,250499,250499,250501,0,2,4
71538,4,1,250503,250503,250504,0,1,2
71539,2,3,250505,250505,250508,0,3,1
71540,5,2,250510,250510,250512,0,2,2
71541,6,2,250516,250516,250518,0,2,4
71542,3,1,250519,250519,250520,0,1,1
71543,5,2,250524,250524,250526,0,2,4
71544,3,2,250527,250527,250529,0,2,1
71545,2,2,250529,250529,250531,0,2,0
71546,4,2,250533,250533,250535,0,2,2
71547,1,1,250534,250535,250536,1,2,0
71548,4,1,250538,250538,250539,0,1,2
71549,4,3,250542,250542,250545,0,3,3
71550,1,2,250543,250545,250547,2,4,0
71551,1,2,250544,250547,250549,3,5,0
71552,2,2,250546,250549,250551,3,5,0
71553,3,3,250549,250551,250554,2,5,0
71554,3,3,250552,250554,250557,2,5,0
71555,4,3,250556,250557,250560,1,4,0
71556,5,3,250561,250561,250564,0,3,1
71557,1,3,250562,250564,250567,2,5,0
71558,2,1,250564,250567,250568,3,4,0
71559,6,3,250570,250570,250573,0,3,2
71560,6,3,250576,250576,250579,0,3,3
71561,5,1,250581,250581,250582,0,1,2
71562,2,3,250583,250583,250586,0,3,1
71563,4,2,250587,250587,250589,0,2,1
71564,1,2,250588,250589,250591,1,3,0
71565,3,1,250591,250591,250592,0,1,0
71566,6,1,250597,250597,250598,0,1,5
71567,1,1,250598,250598,250599,0,1,0
71568,4,2,250602,250602,250604,0,2,3
71569,3,2,250605,250605,250607,0,2,1
71570,5,3,250610,250610,250613,0,3,3
71571,3,3,250613,250613,250616,0,3,0
71572,3,3,250616,250616,250619,0,3,0
71573,2,1,250618,250619,250620,1,2,0
71574,2,2,250620,250620,250622,0,2,0
71575,1,2,250621,250622,250624,1,3,0
71576,2,1,250623,250624,250625,1,2,0
71577,3,1,250626,250626,250627,0,1,1
71578,2,2,250628,250628,250630,0,2,1
71579,1,2,250629,250630,250632,1,3,0
71580,2,3,250631,250632,250635,1,4,0
71581,1,1,250632,250635,250636,3,4,0
71582,2,2,250634,250636,250638,2,4,0
71583,4,1,250638,250638,250639,0,1,0
71584,6,1,250644,250644,250645,0,1,5
71585,4,3,250648,250648,250651,0,3,3
71586,4,3,250652,250652,250655,0,3,1
71587,2,3,250654,250655,250658,1,4,0
71588,1,3,250655,250658,250661,3,6,0
71589,1,1,250656,250661,250662,5,6,0
71590,2,1,250658,250662,250663,4,5,0
71591,3,3,250661,250663,250666,2,5,0
71592,2,3,250663,250666,250669,3,6,0
71593,2,1,250665,250669,250670,4,5,0
71594,1,1,250666,250670,250671,4,5,0
71595,4,3,250670,250671,250674,1,4,0
71596,6,1,250676,250676,250677,0,1,2
71597,6,3,250682,250682,250685,0,3,5
71598,5,3,250687,250687,250690,0,3,2
71599,3,1,250690,250690,250691,0,1,0
71600,5,3,250695,250695,250698,0,3,4
71601,2,3,250697,250698,250701,1,4,0
71602,1,1,250698,250701,250702,3,4,0
71603,1,2,250699,250702,250704,3,5,0
71604,5,1,250704,250704,250705,0,1,0
71605,5,3,250709,250709,250712,0,3,4
71606,3,3,250712,250712,250715,0,3,0
71607,4,2,250716,250716,250718,0,2,1
71608,3,2,250719,250719,250721,0,2,1
71609,4,1,250723,250723,250724,0,1,2
71610,2,3,250725,250725,250728,0,3,1
71611,6,1,250731,250731,250732,0,1,3
71612,6,1,250737,250737,250738,0,1,5
71613,5,2,250742,250742,250744,0,2,4
71614,5,2,250747,250747,250749,0,2,3
71615,4,3,250751,250751,250754,0,3,2
71616,4,2,250755,250755,250757,0,2,1
71617,6,3,250761,250761,250764,0,3,4
71618,1,1,250762,250764,250765,2,3,0
71619,5,1,250767,250767,250768,0,1,2
71620,1,2,250768,250768,250770,0,2,0
71621,5,2,250773,250773,250775,0,2,3
71622,1,3,250774,250775,250778,1,4,0
71623,4,2,250778,250778,250780,0,2,0
71624,1,2,250779,250780,250782,1,3,0
71625,4,1,250783,250783,250784,0,1,1
71626,3,2,250786,250786,250788,0,2,2
71627,2,1,250788,250788,250789,0,1,0
71628,2,1,250790,250790,250791,0,1,1
71629,5,3,250795,250795,250798,0,3,4
71630,5,1,250800,250800,250801,0,1,2
71631,5,2,250805,250805,250807,0,2,4
71632,3,1,250808,250808,250809,0,1,1
71633,5,1,250813,250813,250814,0,1,4
71634,5,1,250818,250818,250819,0,1,4
71635,4,2,250822,250822,250824,0,2,3
71636,6,1,250828,250828,250829,0,1,4
71637,4,1,250832,250832,250833,0,1,3
71638,3,1,250835,250835,250836,0,1,2
71639,6,3,250841,250841,250844,0,3,5
71640,4,2,250845,250845,250847,0,2,1
71641,1,3,250846,250847,250850,1,4,0
71642,1,2,250847,250850,250852,3,5,0
71643,6,3,250853,250853,250856,0,3,1
71644,4,2,250857,250857,250859,0,2,1
71645,5,2,250862,250862,250864,0,2,3
71646,1,2,250863,250864,250866,1,3,0
71647,2,1,250865,250866,250867,1,2,0
71648,5,3,250870,250870,250873,0,3,3
71649,2,1,250872,250873,250874,1,2,0
71650,1,2,250873,250874,250876,1,3,0
71651,1,1,250874,250876,250877,2,3,0
71652,1,3,250875,250877,250880,2,5,0
71653,1,3,250876,250880,250883,4,7,0
71654,1,2,250877,250883,250885,6,8,0
71655,1,3,250878,250885,250888,7,10,0
71656,6,1,250884,250888,250889,4,5,0
71657,6,1,250890,250890,250891,0,1,1
71658,2,2,250892,250892,250894,0,2,1
71659,4,3,250896,250896,250899,0,3,2
71660,6,2,250902,250902,250904,0,2,3
71661,4,1,250906,250906,250907,0,1,2
71662,6,3,250912,250912,250915,0,3,5
71663,1,3,250913,250915,250918,2,5,0
71664,2,3,250915,250918,250921,3,6,0
71665,6,3,250921,250921,250924,0,3,0
71666,1,3,250922,250924,250927,2,5,0
71667,5,1,250927,250927,250928,0,1,0
71668,5,2,250932,250932,250934,0,2,4
71669,1,1,250933,250934,250935,1,2,0
71670,3,1,250936,250936,250937,0,1,1
71671,4,3,250940,250940,250943,0,3,3
71672,6,1,250946,250946,250947,0,1,3
71673,6,2,250952,250952,250954,0,2,5
71674,3,3,250955,250955,250958,0,3,1
71675,1,2,250956,250958,250960,2,4,0
71676,2,2,250958,250960,250962,2,4,0
71677,4,3,250962,250962,250965,0,3,0
71678,6,3,250968,250968,250971,0,3,3
71679,2,1,250970,250971,250972,1,2,0
71680,6,1,250976,250976,250977,0,1,4
71681,4,1,250980,250980,250981,0,1,3
71682,5,1,250985,250985,250986,0,1,4
71683,2,1,250987,250987,250988,0,1,1
71684,6,3,250993,250993,250996,0,3,5
71685,2,2,250995,250996,250998,1,3,0
71686,3,2,250998,250998,251000,0,2,0
71687,1,2,250999,251000,251002,1,3,0
71688,3,1,251002,251002,251003,0,1,0
71689,1,1,251003,251003,251004,0,1,0
71690,2,3,251005,251005,251008,0,3,1
71691,6,3,251011,251011,251014,0,3,3
71692,5,2,251016,251016,251018,0,2,2
71693,2,1,251018,251018,251019,0,1,0
71694,2,3,251020,251020,251023,0,3,1
71695,4,2,251024,251024,251026,0,2,1
71696,1,2,251025,251026,251028,1,3,0
71697,2,3,251027,251028,251031,1,4,0
71698,2,1,251029,251031,251032,2,3,0
71699,2,1,251031,251032,251033,1,2,0
71700,2,2,251033,251033,251035,0,2,0
71701,1,2,251034,251035,251037,1,3,0
71702,3,1,251037,251037,251038,0,1,0
71703,2,3,251039,251039,251042,0,3,1
71704,6,1,251045,251045,251046,0,1,3
71705,4,3,251049,251049,251052,0,3,3
71706,2,3,251051,251052,251055,1,4,0
71707,5,3,251056,251056,251059,0,3,1
71708,2,2,251058,251059,251061,1,3,0
71709,2,3,251060,251061,251064,1,4,0
71710,1,1,251061,251064,251065,3,4,0
71711,2,3,251063,251065,251068,2,5,0
71712,6,1,251069,251069,251070,0,1,1
71713,6,3,251075,251075,251078,0,3,5
71714,5,3,251080,251080,251083,0,3,2
71715,6,2,251086,251086,251088,0,2,3
71716,1,2,251087,251088,251090,1,3,0
71717,4,3,251091,251091,251094,0,3,1
71718,5,1,251096,251096,251097,0,1,2
71719,5,1,251101,251101,251102,0,1,4
71720,4,2,251105,251105,251107,0,2,3
71721,4,2,251109,251109,251111,0,2,2
71722,6,1,251115,251115,251116,0,1,4
71723,5,1,251120,251120,251121,0,1,4
71724,3,3,251123,251123,251126,0,3,2
71725,1,2,251124,251126,251128,2,4,0
71726,6,3,251130,251130,251133,0,3,2
71727,3,2,251133,251133,251135,0,2,0
71728,5,1,251138,251138,251139,0,1,3
71729,4,1,251142,251142,251143,0,1,3
71730,3,3,251145,251145,251148,0,3,2
71731,5,2,251150,251150,251152,0,2,2
71732,6,2,251156,251156,251158,0,2,4
71733,3,1,251159,251159,251160,0,1,1
71734,5,3,251164,251164,251167,0,3,4
71735,3,1,251167,251167,251168,0,1,0
71736,5,1,251172,251172,251173,0,1,4
71737,5,3,251177,251177,251180,0,3,4
71738,5,1,251182,251182,251183,0,1,2
71739,4,2,251186,251186,251188,0,2,3
71740,3,3,251189,251189,251192,0,3,1
71741,4,1,251193,251193,251194,0,1,1
71742,4,1,251197,251197,251198,0,1,3
71743,4,3,251201,251201,251204,0,3,3
71744,5,3,251206,251206,251209,0,3,2
71745,4,3,251210,251210,251213,0,3,1
71746,6,2,251216,251216,251218,0,2,3
71747,3,3,251219,251219,251222,0,3,1
71748,6,3,251225,251225,251228,0,3,3
71749,5,1,251230,251230,251231,0,1,2
71750,3,3,251233,251233,251236,0,3,2
71751,1,1,251234,251236,251237,2,3,0
71752,6,1,251240,251240,251241,0,1,3
71753,1,2,251241,251241,251243,0,2,0
71754,6,3,251247,251247,251250,0,3,4
71755,3,2,251250,251250,251252,0,2,0
71756,4,3,251254,251254,251257,0,3,2
71757,6,2,251260,251260,251262,0,2,3
71758,2,3,251262,251262,251265,0,3,0
71759,2,1,251264,251265,251266,1,2,0
71760,2,2,251266,251266,251268,0,2,0
71761,3,3,251269,251269,251272,0,3,1
71762,1,1,251270,251272,251273,2,3,0
71763,4,3,251274,251274,251277,0,3,1
71764,1,2,251275,251277,251279,2,4,0
71765,1,2,251276,251279,251281,3,5,0
71766,4,1,251280,251281,251282,1,2,0
71767,2,2,251282,251282,251284,0,2,0
71768,2,3,251284,251284,251287,0,3,0
71769,4,1,251288,251288,251289,0,1,1
71770,2,3,251290,251290,251293,0,3,1
71771,6,3,251296,251296,251299,0,3,3
71772,2,1,251298,251299,251300,1,2,0
71773,1,1,251299,251300,251301,1,2,0
71774,2,3,251301,251301,251304,0,3,0
71775,1,1,251302,251304,251305,2,3,0
71776,3,2,251305,251305,251307,0,2,0
71777,1,3,251306,251307,251310,1,4,0
71778,4,2,251310,251310,251312,0,2,0
71779,4,2,251314,251314,251316,0,2,2
71780,6,3,251320,251320,251323,0,3,4
71781,1,2,251321,251323,251325,2,4,0
71782,4,3,251325,251325,251328,0,3,0
71783,2,3,251327,251328,251331,1,4,0
71784,1,3,251328,251331,251334,3,6,0
71785,6,3,251334,251334,251337,0,3,0
71786,1,2,251335,251337,251339,2,4,0
71787,1,1,251336,251339,251340,3,4,0
71788,1,1,251337,251340,251341,3,4,0
71789,5,3,251342,251342,251345,0,3,1
71790,4,2,251346,251346,251348,0,2,1
71791,1,2,251347,251348,251350,1,3,0
71792,6,3,251353,251353,251356,0,3,3
71793,2,1,251355,251356,251357,1,2,0
71794,6,1,251361,251361,251362,0,1,4
71795,2,3,251363,251363,251366,0,3,1
71796,1,2,251364,251366,251368,2,4,0
71797,6,2,251370,251370,251372,0,2,2
71798,5,2,251375,251375,251377,0,2,3
71799,3,2,251378,251378,251380,0,2,1
71800,6,2,251384,251384,251386,0,2,4
71801,1,3,251385,251386,251389,1,4,0
71802,5,2,251390,251390,251392,0,2,1
71803,2,1,251392,251392,251393,0,1,0
71804,5,2,251397,251397,251399,0,2,4
71805,1,3,251398,251399,251402,1,4,0
71806,2,3,251400,251402,251405,2,5,0
71807,4,1,251404,251405,251406,1,2,0
71808,6,2,251410,251410,251412,0,2,4
71809,6,2,251416,251416,251418,0,2,4
71810,6,3,251422,251422,251425,0,3,4
71811,5,2,251427,251427,251429,0,2,2
71812,3,2,251430,251430,251432,0,2,1
71813,1,1,251431,251432,251433,1,2,0
71814,2,2,251433,251433,251435,0,2,0
71815,2,3,251435,251435,251438,0,3,0
71816,2,1,251437,251438,251439,1,2,0
71817,6,1,251443,251443,251444,0,1,4
71818,4,3,251447,251447,251450,0,3,3
71819,1,3,251448,251450,251453,2,5,0
71820,6,1,251454,251454,251455,0,1,1
71821,5,3,251459,251459,251462,0,3,4
71822,6,1,251465,251465,251466,0,1,3
71823,2,3,251467,251467,251470,0,3,1
71824,4,2,251471,251471,251473,0,2,1
71825,4,3,251475,251475,251478,0,3,2
71826,2,1,251477,251478,251479,1,2,0
71827,3,1,251480,251480,251481,0,1,1
71828,6,2,251486,251486,251488,0,2,5
71829,5,1,251491,251491,251492,0,1,3
71830,3,2,251494,251494,251496,0,2,2
71831,5,3,251499,251499,251502,0,3,3
71832,4,2,251503,251503,251505,0,2,1
71833,6,1,251509,251509,251510,0,1,4
71834,3,2,251512,251512,251514,0,2,2
71835,1,2,251513,251514,251516,1,3,0
71836,3,3,251516,251516,251519,0,3,0
71837,6,1,251522,251522,251523,0,1,3
71838,6,1,251528,251528,251529,0,1,5
71839,4,2,251532,251532,251534,0,2,3
71840,3,2,251535,251535,251537,0,2,1
71841,1,1,251536,251537,251538,1,2,0
71842,4,2,251540,251540,251542,0,2,2
71843,1,2,251541,251542,251544,1,3,0
71844,1,2,251542,251544,251546,2,4,0
71845,6,1,251548,251548,251549,0,1,2
71846,5,1,251553,251553,251554,0,1,4
71847,1,1,251554,251554,251555,0,1,0
71848,6,3,251560,251560,251563,0,3,5
71849,3,1,251563,251563,251564,0,1,0
71850,1,3,251564,251564,251567,0,3,0
71851,4,1,251568,251568,251569,0,1,1
71852,1,1,251569,251569,251570,0,1,0
71853,6,3,251575,251575,251578,0,3,5
71854,4,1,251579,251579,251580,0,1,1
71855,5,3,251584,251584,251587,0,3,4
71856,4,3,251588,251588,251591,0,3,1
71857,5,2,251593,251593,251595,0,2,2
71858,2,3,251595,251595,251598,0,3,0
71859,6,3,251601,251601,251604,0,3,3
71860,3,1,251604,251604,251605,0,1,0
71861,4,1,251608,251608,251609,0,1,3
71862,3,2,251611,251611,251613,0,2,2
71863,1,2,251612,251613,251615,1,3,0
71864,5,3,251617,251617,251620,0,3,2
71865,5,1,251622,251622,251623,0,1,2
71866,5,2,251627,251627,251629,0,2,4
71867,2,1,251629,251629,251630,0,1,0
71868,4,2,251633,251633,251635,0,2,3
71869,6,3,251639,251639,251642,0,3,4
71870,3,3,251642,251642,251645,0,3,0
71871,6,2,251648,251648,251650,0,2,3
71872,1,2,251649,251650,251652,1,3,0
71873,5,2,251654,251654,251656,0,2,2
71874,6,2,251660,251660,251662,0,2,4
71875,6,2,251666,251666,251668,0,2,4
71876,4,1,251670,251670,251671,0,1,2
71877,4,1,251674,251674,251675,0,1,3
71878,6,1,251680,251680,251681,0,1,5
71879,2,1,251682,251682,251683,0,1,1
71880,6,3,251688,251688,251691,0,3,5
71881,4,1,251692,251692,251693,0,1,1
71882,3,1,251695,251695,251696,0,1,2
71883,2,2,251697,251697,251699,0,2,1
71884,1,2,251698,251699,251701,1,3,0
71885,3,2,251701,251701,251703,0,2,0
71886,1,2,251702,251703,251705,1,3,0
71887,3,2,251705,251705,251707,0,2,0
71888,1,2,251706,251707,251709,1,3,0
71889,4,2,251710,251710,251712,0,2,1
71890,5,2,251715,251715,251717,0,2,3
71891,5,1,251720,251720,251721,0,1,3
71892,2,1,251722,251722,251723,0,1,1
71893,3,2,251725,251725,251727,0,2,2
71894,4,3,251729,251729,251732,0,3,2
71895,5,1,251734,251734,251735,0,1,2
71896,4,3,251738,251738,251741,0,3,3
71897,3,3,251741,251741,251744,0,3,0
71898,3,2,251744,251744,251746,0,2,0
71899,3,3,251747,251747,251750,0,3,1
71900,4,2,251751,251751,251753,0,2,1
71901,3,2,251754,251754,251756,0,2,1
71902,3,2,251757,251757,251759,0,2,1
71903,3,3,251760,251760,251763,0,3,1
71904,3,3,251763,251763,251766,0,3,0
71905,3,1,251766,251766,251767,0,1,0
71906,3,3,251769,251769,251772,0,3,2
71907,3,2,251772,251772,251774,0,2,0
71908,1,3,251773,251774,251777,1,4,0
71909,1,2,251774,251777,251779,3,5,0
71910,5,2,251779,251779,251781,0,2,0
71911,3,1,251782,251782,251783,0,1,1
71912,3,1,251785,251785,251786,0,1,2
71913,5,2,251790,251790,251792,0,2,4
71914,6,1,251796,251796,251797,0,1,4
71915,4,1,251800,251800,251801,0,1,3
71916,4,3,251804,251804,251807,0,3,3
71917,6,3,251810,251810,251813,0,3,3
71918,2,3,251812,251813,251816,1,4,0
71919,6,3,251818,251818,251821,0,3,2
71920,3,2,251821,251821,251823,0,2,0
71921,5,3,251826,251826,251829,0,3,3
71922,4,3,251830,251830,251833,0,3,1
71923,6,3,251836,251836,251839,0,3,3
71924,2,1,251838,251839,251840,1,2,0
71925,1,3,251839,251840,251843,1,4,0
71926,3,1,251842,251843,251844,1,2,0
71927,1,1,251843,251844,251845,1,2,0
71928,1,2,251844,251845,251847,1,3,0
71929,4,2,251848,251848,251850,0,2,1
71930,2,1,251850,251850,251851,0,1,0
71931,3,3,251853,251853,251856,0,3,2
71932,1,3,251854,251856,251859,2,5,0
71933,4,3,251858,251859,251862,1,4,0
71934,6,1,251864,251864,251865,0,1,2
71935,6,3,251870,251870,251873,0,3,5
71936,4,2,251874,251874,251876,0,2,1
71937,5,2,251879,251879,251881,0,2,3
71938,2,2,251881,251881,251883,0,2,0
71939,1,1,251882,251883,251884,1,2,0
71940,5,2,251887,251887,251889,0,2,3
71941,2,1,251889,251889,251890,0,1,0
71942,3,2,251892,251892,251894,0,2,2
71943,3,1,251895,251895,251896,0,1,1
71944,2,3,251897,251897,251900,0,3,1
71945,4,3,251901,251901,251904,0,3,1
71946,3,1,251904,251904,251905,0,1,0
71947,3,3,251907,251907,251910,0,3,2
71948,1,2,251908,251910,251912,2,4,0
71949,2,1,251910,251912,251913,2,3,0
71950,2,1,251912,251913,251914,1,2,0
71951,6,3,251918,251918,251921,0,3,4
71952,5,2,251923,251923,251925,0,2,2
71953,4,1,251927,251927,251928,0,1,2
71954,2,2,251929,251929,251931,0,2,1
71955,3,1,251932,251932,251933,0,1,1
71956,1,1,251933,251933,251934,0,1,0
71957,2,1,251935,251935,251936,0,1,1
71958,3,3,251938,251938,251941,0,3,2
71959,5,3,251943,251943,251946,0,3,2
71960,5,2,251948,251948,251950,0,2,2
71961,5,3,251953,251953,251956,0,3,3
71962,1,1,251954,251956,251957,2,3,0
71963,5,3,251959,251959,251962,0,3,2
71964,1,3,251960,251962,251965,2,5,0
71965,5,1,251965,251965,251966,0,1,0
71966,2,2,251967,251967,251969,0,2,1
71967,2,1,251969,251969,251970,0,1,0
71968,6,3,251975,251975,251978,0,3,5
71969,3,3,251978,251978,251981,0,3,0
71970,5,1,251983,251983,251984,0,1,2
71971,2,3,251985,251985,251988,0,3,1
71972,3,1,251988,251988,251989,0,1,0
71973,5,1,251993,251993,251994,0,1,4
71974,3,3,251996,251996,251999,0,3,2
71975,1,1,251997,251999,252000,2,3,0
71976,2,2,251999,252000,252002,1,3,0
71977,6,3,252005,252005,252008,0,3,3
71978,3,1,252008,252008,252009,0,1,0
71979,4,2,252012,252012,252014,0,2,3
71980,3,2,252015,252015,252017,0,2,1
71981,5,1,252020,252020,252021,0,1,3
71982,3,1,252023,252023,252024,0,1,2
71983,3,3,252026,252026,252029,0,3,2
71984,3,3,252029,252029,252032,0,3,0
71985,4,2,252033,252033,252035,0,2,1
71986,3,3,252036,252036,252039,0,3,1
71987,3,1,252039,252039,252040,0,1,0
71988,3,2,252042,252042,252044,0,2,2
71989,1,2,252043,252044,252046,1,3,0
71990,3,3,252046,252046,252049,0,3,0
71991,4,1,252050,252050,252051,0,1,1
71992,5,1,252055,252055,252056,0,1,4
71993,4,1,252059,252059,252060,0,1,3
71994,4,1,252063,252063,252064,0,1,3
71995,6,1,252069,252069,252070,0,1,5
71996,1,3,252070,252070,252073,0,3,0
71997,1,3,252071,252073,252076,2,5,0
71998,5,1,252076,252076,252077,0,1,0
71999,5,2,252081,252081,252083,0,2,4
72000,4,2,252085,252085,252087,0,2,2
72001,2,3,252087,252087,252090,0,3,0
72002,2,2,252089,252090,252092,1,3,0
72003,5,2,252094,252094,252096,0,2,2
72004,6,2,252100,252100,252102,0,2,4
72005,2,1,252102,252102,252103,0,1,0
72006,3,3,252105,252105,252108,0,3,2
72007,3,3,252108,252108,252111,0,3,0
72008,2,2,252110,252111,252113,1,3,0
72009,4,2,252114,252114,252116,0,2,1
72010,1,2,252115,252116,252118,1,3,0
72011,6,2,252121,252121,252123,0,2,3
72012,5,2,252126,252126,252128,0,2,3
72013,4,1,252130,252130,252131,0,1,2
72014,5,1,252135,252135,252136,0,1,4
72015,2,1,252137,252137,252138,0,1,1
72016,3,3,252140,252140,252143,0,3,2
72017,1,2,252141,252143,252145,2,4,0
72018,6,3,252147,252147,252150,0,3,2
72019,5,1,252152,252152,252153,0,1,2
72020,3,2,252155,252155,252157,0,2,2
72021,5,1,252160,252160,252161,0,1,3
72022,1,1,252161,252161,252162,0,1,0
72023,5,3,252166,252166,252169,0,3,4
72024,1,2,252167,252169,252171,2,4,0
72025,6,1,252173,252173,252174,0,1,2
72026,5,1,252178,252178,252179,0,1,4
72027,2,2,252180,252180,252182,0,2,1
72028,5,3,252185,252185,252188,0,3,3
72029,2,1,252187,252188,252189,1,2,0
72030,2,1,252189,252189,252190,0,1,0
72031,3,2,252192,252192,252194,0,2,2
72032,6,1,252198,252198,252199,0,1,4
72033,4,2,252202,252202,252204,0,2,3
72034,6,3,252208,252208,252211,0,3,4
72035,6,3,252214,252214,252217,0,3,3
72036,5,2,252219,252219,252221,0,2,2
72037,3,1,252222,252222,252223,0,1,1
72038,4,2,252226,252226,252228,0,2,3
72039,5,1,252231,252231,252232,0,1,3
72040,3,2,252234,252234,252236,0,2,2
72041,6,3,252240,252240,252243,0,3,4
72042,5,1,252245,252245,252246,0,1,2
72043,5,1,252250,252250,252251,0,1,4
72044,1,2,252251,252251,252253,0,2,0
72045,6,2,252257,252257,252259,0,2,4
72046,1,3,252258,252259,252262,1,4,0
72047,6,2,252264,252264,252266,0,2,2
72048,3,3,252267,252267,252270,0,3,1
72049,5,2,252272,252272,252274,0,2,2
72050,3,3,252275,252275,252278,0,3,1
72051,3,3,252278,252278,252281,0,3,0
72052,3,1,252281,252281,252282,0,1,0
72053,1,1,252282,252282,252283,0,1,0
72054,6,1,252288,252288,252289,0,1,5
72055,2,1,252290,252290,252291,0,1,1
72056,1,1,252291,252291,252292,0,1,0
72057,4,3,252295,252295,252298,0,3,3
72058,6,1,252301,252301,252302,0,1,3
72059,2,1,252303,252303,252304,0,1,1
72060,6,2,252309,252309,252311,0,2,5
72061,2,2,252311,252311,252313,0,2,0
72062,5,3,252316,252316,252319,0,3,3
72063,1,1,252317,252319,252320,2,3,0
72064,2,3,252319,252320,252323,1,4,0
72065,4,1,252323,252323,252324,0,1,0
72066,2,1,252325,252325,252326,0,1,1
72067,6,3,252331,252331,252334,0,3,5
72068,3,2,252334,252334,252336,0,2,0
72069,3,3,252337,252337,252340,0,3,1
72070,3,3,252340,252340,252343,0,3,0
72071,1,3,252341,252343,252346,2,5,0
72072,3,2,252344,252346,252348,2,4,0
72073,1,3,252345,252348,252351,3,6,0
72074,5,2,252350,252351,252353,1,3,0
72075,2,1,252352,252353,252354,1,2,0
72076,4,2,252356,252356,252358,0,2,2
72077,6,2,252362,252362,252364,0,2,4
72078,3,1,252365,252365,252366,0,1,1
72079,3,3,252368,252368,252371,0,3,2
72080,4,1,252372,252372,252373,0,1,1
72081,5,1,252377,252377,252378,0,1,4
72082,4,1,252381,252381,252382,0,1,3
72083,4,2,252385,252385,252387,0,2,3
72084,4,3,252389,252389,252392,0,3,2
72085,3,3,252392,252392,252395,0,3,0
72086,4,3,252396,252396,252399,0,3,1
72087,5,1,252401,252401,252402,0,1,2
72088,4,3,252405,252405,252408,0,3,3
72089,3,3,252408,252408,252411,0,3,0
72090,1,2,252409,252411,252413,2,4,0
72091,1,2,252410,252413,252415,3,5,0
72092,1,1,252411,252415,252416,4,5,0
72093,1,3,252412,252416,252419,4,7,0
72094,5,3,252417,252419,252422,2,5,0
72095,3,3,252420,252422,252425,2,5,0
72096,3,3,252423,252425,252428,2,5,0
72097,1,2,252424,252428,252430,4,6,0
72098,1,2,252425,252430,252432,5,7,0
72099,5,2,252430,252432,252434,2,4,0
72100,3,1,252433,252434,252435,1,2,0
72101,3,1,252436,252436,252437,0,1,1
72102,4,1,252440,252440,252441,0,1,3
72103,4,1,252444,252444,252445,0,1,3
72104,2,3,252446,252446,252449,0,3,1
72105,5,1,252451,252451,252452,0,1,2
72106,6,1,252457,252457,252458,0,1,5
72107,4,3,252461,252461,252464,0,3,3
72108,1,3,252462,252464,252467,2,5,0
72109,5,3,252467,252467,252470,0,3,0
72110,6,2,252473,252473,252475,0,2,3
72111,4,1,252477,252477,252478,0,1,2
72112,6,3,252483,252483,252486,0,3,5
72113,6,1,252489,252489,252490,0,1,3
72114,3,2,252492,252492,252494,0,2,2
72115,2,2,252494,252494,252496,0,2,0
72116,5,3,252499,252499,252502,0,3,3
72117,1,2,252500,252502,252504,2,4,0
72118,6,1,252506,252506,252507,0,1,2
72119,6,3,252512,252512,252515,0,3,5
72120,2,2,252514,252515,252517,1,3,0
72121,1,2,252515,252517,252519,2,4,0
72122,4,1,252519,252519,252520,0,1,0
72123,6,2,252525,252525,252527,0,2,5
72124,2,2,252527,252527,252529,0,2,0
72125,2,1,252529,252529,252530,0,1,0
72126,4,2,252533,252533,252535,0,2,3
72127,4,1,252537,252537,252538,0,1,2
72128,2,3,252539,252539,252542,0,3,1
72129,3,2,252542,252542,252544,0,2,0
72130,3,2,252545,252545,252547,0,2,1
72131,2,3,252547,252547,252550,0,3,0
72132,2,1,252549,252550,252551,1,2,0
72133,5,3,252554,252554,252557,0,3,3
72134,2,2,252556,252557,252559,1,3,0
72135,2,2,252558,252559,252561,1,3,0
72136,1,1,252559,252561,252562,2,3,0
72137,3,3,252562,252562,252565,0,3,0
72138,3,3,252565,252565,252568,0,3,0
72139,4,1,252569,252569,252570,0,1,1
72140,5,1,252574,252574,252575,0,1,4
72141,1,1,252575,252575,252576,0,1,0
72142,6,2,252581,252581,252583,0,2,5
72143,5,1,252586,252586,252587,0,1,3
72144,5,2,252591,252591,252593,0,2,4
72145,5,2,252596,252596,252598,0,2,3
72146,3,3,252599,252599,252602,0,3,1
72147,1,1,252600,252602,252603,2,3,0
72148,4,2,252604,252604,252606,0,2,1
72149,2,3,252606,252606,252609,0,3,0
72150,1,3,252607,252609,252612,2,5,0
72151,5,2,252612,252612,252614,0,2,0
72152,5,1,252617,252617,252618,0,1,3
72153,5,2,252622,252622,252624,0,2,4
72154,2,1,252624,252624,252625,0,1,0
72155,4,3,252628,252628,252631,0,3,3
72156,4,3,252632,252632,252635,0,3,1
72157,6,3,252638,252638,252641,0,3,3
72158,2,3,252640,252641,252644,1,4,0
72159,1,3,252641,252644,252647,3,6,0
72160,1,2,252642,252647,252649,5,7,0
72161,2,1,252644,252649,252650,5,6,0
72162,6,2,252650,252650,252652,0,2,0
72163,2,2,252652,252652,252654,0,2,0
72164,6,1,252658,252658,252659,0,1,4
72165,1,3,252659,252659,252662,0,3,0
72166,1,2,252660,252662,252664,2,4,0
72167,4,2,252664,252664,252666,0,2,0
72168,2,1,252666,252666,252667,0,1,0
72169,4,3,252670,252670,252673,0,3,3
72170,1,2,252671,252673,252675,2,4,0
72171,1,1,252672,252675,252676,3,4,0
72172,4,2,252676,252676,252678,0,2,0
72173,6,3,252682,252682,252685,0,3,4
72174,5,3,252687,252687,252690,0,3,2
72175,6,3,252693,252693,252696,0,3,3
72176,4,3,252697,252697,252700,0,3,1
72177,4,2,252701,252701,252703,0,2,1
72178,5,2,252706,252706,252708,0,2,3
72179,6,1,252712,252712,252713,0,1,4
72180,1,2,252713,252713,252715,0,2,0
72181,1,1,252714,252715,252716,1,2,0
72182,2,3,252716,252716,252719,0,3,0
72183,4,1,252720,252720,252721,0,1,1
72184,3,3,252723,252723,252726,0,3,2
72185,6,1,252729,252729,252730,0,1,3
72186,5,3,252734,252734,252737,0,3,4
72187,5,2,252739,252739,252741,0,2,2
72188,4,3,252743,252743,252746,0,3,2
72189,3,3,252746,252746,252749,0,3,0
72190,1,1,252747,252749,252750,2,3,0
72191,1,1,252748,252750,252751,2,3,0
72192,2,3,252750,252751,252754,1,4,0
72193,2,3,252752,252754,252757,2,5,0
72194,6,3,252758,252758,252761,0,3,1
72195,5,1,252763,252763,252764,0,1,2
72196,3,3,252766,252766,252769,0,3,2
72197,1,2,252767,252769,252771,2,4,0
72198,4,3,252771,252771,252774,0,3,0
72199,3,1,252774,252774,252775,0,1,0
72200,5,3,252779,252779,252782,0,3,4
72201,2,1,252781,252782,252783,1,2,0
72202,2,3,252783,252783,252786,0,3,0
72203,5,2,252788,252788,252790,0,2,2
72204,3,2,252791,252791,252793,0,2,1
72205,2,3,252793,252793,252796,0,3,0
72206,5,2,252798,252798,252800,0,2,2
72207,5,3,252803,252803,252806,0,3,3
72208,4,2,252807,252807,252809,0,2,1
72209,2,2,252809,252809,252811,0,2,0
72210,5,2,252814,252814,252816,0,2,3
72211,1,1,252815,252816,252817,1,2,0
72212,6,3,252821,252821,252824,0,3,4
72213,5,1,252826,252826,252827,0,1,2
72214,2,2,252828,252828,252830,0,2,1
72215,3,2,252831,252831,252833,0,2,1
72216,5,2,252836,252836,252838,0,2,3
72217,1,2,252837,252838,252840,1,3,0
72218,4,1,252841,252841,252842,0,1,1
72219,6,3,252847,252847,252850,0,3,5
72220,2,3,252849,252850,252853,1,4,0
72221,1,1,252850,252853,252854,3,4,0
72222,2,1,252852,252854,252855,2,3,0
72223,5,1,252857,252857,252858,0,1,2
72224,6,1,252863,252863,252864,0,1,5
72225,4,1,252867,252867,252868,0,1,3
72226,3,1,252870,252870,252871,0,1,2
72227,6,3,252876,252876,252879,0,3,5
72228,1,1,252877,252879,252880,2,3,0
72229,6,3,252883,252883,252886,0,3,3
72230,6,1,252889,252889,252890,0,1,3
72231,2,1,252891,252891,252892,0,1,1
72232,1,2,252892,252892,252894,0,2,0
72233,2,1,252894,252894,252895,0,1,0
72234,3,2,252897,252897,252899,0,2,2
72235,6,1,252903,252903,252904,0,1,4
72236,6,3,252909,252909,252912,0,3,5
72237,6,2,252915,252915,252917,0,2,3
72238,2,3,252917,252917,252920,0,3,0
72239,3,1,252920,252920,252921,0,1,0
72240,4,1,252924,252924,252925,0,1,3
72241,1,3,252925,252925,252928,0,3,0
72242,4,3,252929,252929,252932,0,3,1
72243,1,2,252930,252932,252934,2,4,0
72244,4,1,252934,252934,252935,0,1,0
72245,3,2,252937,252937,252939,0,2,2
72246,5,3,252942,252942,252945,0,3,3
72247,1,3,252943,252945,252948,2,5,0
72248,5,2,252948,252948,252950,0,2,0
72249,2,2,252950,252950,252952,0,2,0
72250,4,1,252954,252954,252955,0,1,2
72251,4,1,252958,252958,252959,0,1,3
72252,6,2,252964,252964,252966,0,2,5
72253,5,2,252969,252969,252971,0,2,3
72254,6,1,252975,252975,252976,0,1,4
72255,4,1,252979,252979,252980,0,1,3
72256,5,3,252984,252984,252987,0,3,4
72257,4,1,252988,252988,252989,0,1,1
72258,4,2,252992,252992,252994,0,2,3
72259,2,3,252994,252994,252997,0,3,0
72260,6,3,253000,253000,253003,0,3,3
72261,5,1,253005,253005,253006,0,1,2
72262,2,3,253007,253007,253010,0,3,1
72263,5,3,253012,253012,253015,0,3,2
72264,2,3,253014,253015,253018,1,4,0
72265,3,3,253017,253018,253021,1,4,0
72266,1,2,253018,253021,253023,3,5,0
72267,4,3,253022,253023,253026,1,4,0
72268,3,3,253025,253026,253029,1,4,0
72269,5,2,253030,253030,253032,0,2,1
72270,3,1,253033,253033,253034,0,1,1
72271,5,3,253038,253038,253041,0,3,4
72272,4,3,253042,253042,253045,0,3,1
72273,6,2,253048,253048,253050,0,2,3
72274,3,3,253051,253051,253054,0,3,1
72275,5,3,253056,253056,253059,0,3,2
72276,2,1,253058,253059,253060,1,2,0
72277,5,1,253063,253063,253064,0,1,3
72278,6,1,253069,253069,253070,0,1,5
72279,4,1,253073,253073,253074,0,1,3
72280,5,1,253078,253078,253079,0,1,4
72281,3,1,253081,253081,253082,0,1,2
72282,4,2,253085,253085,253087,0,2,3
72283,5,2,253090,253090,253092,0,2,3
72284,2,2,253092,253092,253094,0,2,0
72285,1,1,253093,253094,253095,1,2,0
72286,5,1,253098,253098,253099,0,1,3
72287,3,1,253101,253101,253102,0,1,2
72288,4,3,253105,253105,253108,0,3,3
72289,6,3,253111,253111,253114,0,3,3
72290,1,3,253112,253114,253117,2,5,0
72291,5,1,253117,253117,253118,0,1,0
72292,1,3,253118,253118,253121,0,3,0
72293,2,2,253120,253121,253123,1,3,0
72294,5,2,253125,253125,253127,0,2,2
72295,4,3,253129,253129,253132,0,3,2
72296,6,3,253135,253135,253138,0,3,3
72297,6,3,253141,253141,253144,0,3,3
72298,6,2,253147,253147,253149,0,2,3
72299,4,3,253151,253151,253154,0,3,2
72300,1,2,253152,253154,253156,2,4,0
72301,1,1,253153,253156,253157,3,4,0
72302,4,1,253157,253157,253158,0,1,0
72303,2,2,253159,253159,253161,0,2,1
72304,1,3,253160,253161,253164,1,4,0
72305,4,1,253164,253164,253165,0,1,0
72306,1,2,253165,253165,253167,0,2,0
72307,2,1,253167,253167,253168,0,1,0
72308,5,1,253172,253172,253173,0,1,4
72309,4,1,253176,253176,253177,0,1,3
72310,6,1,253182,253182,253183,0,1,5
72311,5,3,253187,253187,253190,0,3,4
72312,2,3,253189,253190,253193,1,4,0
72313,3,2,253192,253193,253195,1,3,0
72314,1,2,253193,253195,253197,2,4,0
72315,3,2,253196,253197,253199,1,3,0
72316,1,1,253197,253199,253200,2,3,0
72317,1,3,253198,253200,253203,2,5,0
72318,6,3,253204,253204,253207,0,3,1
72319,4,3,253208,253208,253211,0,3,1
72320,1,2,253209,253211,253213,2,4,0
72321,6,3,253215,253215,253218,0,3,2
72322,4,2,253219,253219,253221,0,2,1
72323,5,3,253224,253224,253227,0,3,3
72324,3,2,253227,253227,253229,0,2,0
72325,6,1,253233,253233,253234,0,1,4
72326,3,1,253236,253236,253237,0,1,2
72327,3,2,253239,253239,253241,0,2,2
72328,5,2,253244,253244,253246,0,2,3
72329,4,1,253248,253248,253249,0,1,2
72330,5,2,253253,253253,253255,0,2,4
72331,4,2,253257,253257,253259,0,2,2
72332,6,1,253263,253263,253264,0,1,4
72333,3,3,253266,253266,253269,0,3,2
72334,4,2,253270,253270,253272,0,2,1
72335,4,3,253274,253274,253277,0,3,2
72336,5,3,253279,253279,253282,0,3,2
72337,3,1,253282,253282,253283,0,1,0
72338,1,1,253283,253283,253284,0,1,0
72339,1,2,253284,253284,253286,0,2,0
72340,3,2,253287,253287,253289,0,2,1
72341,2,2,253289,253289,253291,0,2,0
72342,2,2,253291,253291,253293,0,2,0
72343,2,3,253293,253293,253296,0,3,0
72344,2,2,253295,253296,253298,1,3,0
72345,1,3,253296,253298,253301,2,5,0
72346,2,1,253298,253301,253302,3,4,0
72347,3,3,253301,253302,253305,1,4,0
72348,1,3,253302,253305,253308,3,6,0
72349,3,3,253305,253308,253311,3,6,0
72350,4,1,253309,253311,253312,2,3,0
72351,6,3,253315,253315,253318,0,3,3
72352,4,1,253319,253319,253320,0,1,1
72353,3,2,253322,253322,253324,0,2,2
72354,4,3,253326,253326,253329,0,3,2
72355,5,2,253331,253331,253333,0,2,2
72356,4,2,253335,253335,253337,0,2,2
72357,5,1,253340,253340,253341,0,1,3
72358,4,1,253344,253344,253345,0,1,3
72359,4,3,253348,253348,253351,0,3,3
72360,1,3,253349,253351,253354,2,5,0
72361,5,3,253354,253354,253357,0,3,0
72362,1,1,253355,253357,253358,2,3,0
72363,6,2,253361,253361,253363,0,2,3
72364,1,1,253362,253363,253364,1,2,0
72365,4,2,253366,253366,253368,0,2,2
72366,2,1,253368,253368,253369,0,1,0
72367,1,1,253369,253369,253370,0,1,0
72368,6,3,253375,253375,253378,0,3,5
72369,5,1,253380,253380,253381,0,1,2
72370,6,3,253386,253386,253389,0,3,5
72371,4,1,253390,253390,253391,0,1,1
72372,6,2,253396,253396,253398,0,2,5
72373,3,2,253399,253399,253401,0,2,1
72374,2,3,253401,253401,253404,0,3,0
72375,5,3,253406,253406,253409,0,3,2
72376,4,3,253410,253410,253413,0,3,1
72377,6,3,253416,253416,253419,0,3,3
72378,1,1,253417,253419,253420,2,3,0
72379,6,3,253423,253423,253426,0,3,3
72380,5,3,253428,253428,253431,0,3,2
72381,1,2,253429,253431,253433,2,4,0
72382,1,1,253430,253433,253434,3,4,0
72383,5,2,253435,253435,253437,0,2,1
72384,1,1,253436,253437,253438,1,2,0
72385,1,2,253437,253438,253440,1,3,0
72386,5,3,253442,253442,253445,0,3,2
72387,2,3,253444,253445,253448,1,4,0
72388,4,1,253448,253448,253449,0,1,0
72389,1,1,253449,253449,253450,0,1,0
72390,4,2,253453,253453,253455,0,2,3
72391,6,2,253459,253459,253461,0,2,4
72392,5,2,253464,253464,253466,0,2,3
72393,6,2,253470,253470,253472,0,2,4
72394,5,2,253475,253475,253477,0,2,3
72395,3,2,253478,253478,253480,0,2,1
72396,3,1,253481,253481,253482,0,1,1
72397,1,3,253482,253482,253485,0,3,0
72398,5,1,253487,253487,253488,0,1,2
72399,1,3,253488,253488,253491,0,3,0
72400,6,1,253494,253494,253495,0,1,3
72401,1,2,253495,253495,253497,0,2,0
72402,2,3,253497,253497,253500,0,3,0
72403,6,3,253503,253503,253506,0,3,3
72404,2,2,253505,253506,253508,1,3,0
72405,5,1,253510,253510,253511,0,1,2
72406,6,2,253516,253516,253518,0,2,5
72407,2,2,253518,253518,253520,0,2,0
72408,1,3,253519,253520,253523,1,4,0
72409,6,1,253525,253525,253526,0,1,2
72410,3,3,253528,253528,253531,0,3,2
72411,3,2,253531,253531,253533,0,2,0
72412,4,1,253535,253535,253536,0,1,2
72413,4,1,253539,253539,253540,0,1,3
72414,6,3,253545,253545,253548,0,3,5
72415,3,2,253548,253548,253550,0,2,0
72416,3,1,253551,253551,253552,0,1,1
72417,4,1,253555,253555,253556,0,1,3
72418,4,1,253559,253559,253560,0,1,3
72419,1,3,253560,253560,253563,0,3,0
72420,2,2,253562,253563,253565,1,3,0
72421,3,1,253565,253565,253566,0,1,0
72422,5,2,253570,253570,253572,0,2,4
72423,6,2,253576,253576,253578,0,2,4
72424,5,2,253581,253581,253583,0,2,3
72425,4,3,253585,253585,253588,0,3,2
72426,2,1,253587,253588,253589,1,2,0
72427,6,2,253593,253593,253595,0,2,4
72428,1,2,253594,253595,253597,1,3,0
72429,4,2,253598,253598,253600,0,2,1
72430,5,1,253603,253603,253604,0,1,3
72431,5,2,253608,253608,253610,0,2,4
72432,2,1,253610,253610,253611,0,1,0
72433,5,2,253615,253615,253617,0,2,4
72434,5,3,253620,253620,253623,0,3,3
72435,5,2,253625,253625,253627,0,2,2
72436,1,3,253626,253627,253630,1,4,0
72437,4,1,253630,253630,253631,0,1,0
72438,6,3,253636,253636,253639,0,3,5
72439,2,3,253638,253639,253642,1,4,0
72440,3,2,253641,253642,253644,1,3,0
72441,4,2,253645,253645,253647,0,2,1
72442,1,2,253646,253647,253649,1,3,0
72443,1,3,253647,253649,253652,2,5,0
72444,5,1,253652,253652,253653,0,1,0
72445,1,3,253653,253653,253656,0,3,0
72446,2,3,253655,253656,253659,1,4,0
72447,4,3,253659,253659,253662,0,3,0
72448,3,3,253662,253662,253665,0,3,0
72449,6,3,253668,253668,253671,0,3,3
72450,2,3,253670,253671,253674,1,4,0
72451,4,2,253674,253674,253676,0,2,0
72452,4,2,253678,253678,253680,0,2,2
72453,3,2,253681,253681,253683,0,2,1
72454,2,1,253683,253683,253684,0,1,0
72455,3,2,253686,253686,253688,0,2,2
72456,3,3,253689,253689,253692,0,3,1
72457,5,2,253694,253694,253696,0,2,2
72458,3,2,253697,253697,253699,0,2,1
72459,1,2,253698,253699,253701,1,3,0
72460,3,1,253701,253701,253702,0,1,0
72461,6,3,253707,253707,253710,0,3,5
72462,3,3,253710,253710,253713,0,3,0
72463,6,3,253716,253716,253719,0,3,3
72464,1,2,253717,253719,253721,2,4,0
72465,1,2,253718,253721,253723,3,5,0
72466,5,2,253723,253723,253725,0,2,0
72467,3,1,253726,253726,253727,0,1,1
72468,1,3,253727,253727,253730,0,3,0
72469,4,3,253731,253731,253734,0,3,1
72470,5,1,253736,253736,253737,0,1,2
72471,5,3,253741,253741,253744,0,3,4
72472,5,2,253746,253746,253748,0,2,2
72473,4,1,253750,253750,253751,0,1,2
72474,3,2,253753,253753,253755,0,2,2
72475,5,3,253758,253758,253761,0,3,3
72476,4,1,253762,253762,253763,0,1,1
72477,5,2,253767,253767,253769,0,2,4
72478,6,2,253773,253773,253775,0,2,4
72479,1,2,253774,253775,253777,1,3,0
72480,6,2,253780,253780,253782,0,2,3
72481,4,1,253784,253784,253785,0,1,2
72482,6,3,253790,253790,253793,0,3,5
72483,6,1,253796,253796,253797,0,1,3
72484,2,2,253798,253798,253800,0,2,1
72485,3,1,253801,253801,253802,0,1,1
72486,5,3,253806,253806,253809,0,3,4
72487,6,1,253812,253812,253813,0,1,3
72488,6,1,253818,253818,253819,0,1,5
72489,4,3,253822,253822,253825,0,3,3
72490,6,1,253828,253828,253829,0,1,3
72491,4,2,253832,253832,253834,0,2,3
72492,1,1,253833,253834,253835,1,2,0
72493,6,1,253839,253839,253840,0,1,4
72494,2,3,253841,253841,253844,0,3,1
72495,2,3,253843,253844,253847,1,4,0
72496,1,2,253844,253847,253849,3,5,0
72497,2,3,253846,253849,253852,3,6,0
72498,4,3,253850,253852,253855,2,5,0
72499,1,2,253851,253855,253857,4,6,0
72500,2,3,253853,253857,253860,4,7,0
72501,5,2,253858,253860,253862,2,4,0
72502,6,2,253864,253864,253866,0,2,2
72503,5,2,253869,253869,253871,0,2,3
72504,5,2,253874,253874,253876,0,2,3
72505,6,2,253880,253880,253882,0,2,4
72506,2,3,253882,253882,253885,0,3,0
72507,2,1,253884,253885,253886,1,2,0
72508,5,2,253889,253889,253891,0,2,3
72509,3,2,253892,253892,253894,0,2,1
72510,1,2,253893,253894,253896,1,3,0
72511,6,1,253899,253899,253900,0,1,3
72512,1,3,253900,253900,253903,0,3,0
72513,3,2,253903,253903,253905,0,2,0
72514,3,3,253906,253906,253909,0,3,1
72515,4,2,253910,253910,253912,0,2,1
72516,1,1,253911,253912,253913,1,2,0
72517,4,3,253915,253915,253918,0,3,2
72518,1,2,253916,253918,253920,2,4,0
72519,3,1,253919,253920,253921,1,2,0
72520,5,3,253924,253924,253927,0,3,3
72521,2,2,253926,253927,253929,1,3,0
72522,5,1,253931,253931,253932,0,1,2
72523,3,2,253934,253934,253936,0,2,2
72524,6,2,253940,253940,253942,0,2,4
72525,1,1,253941,253942,253943,1,2,0
72526,1,3,253942,253943,253946,1,4,0
72527,2,1,253944,253946,253947,2,3,0
72528,5,3,253949,253949,253952,0,3,2
72529,2,3,253951,253952,253955,1,4,0
72530,4,1,253955,253955,253956,0,1,0
72531,5,3,253960,253960,253963,0,3,4
72532,4,1,253964,253964,253965,0,1,1
72533,4,3,253968,253968,253971,0,3,3
72534,4,3,253972,253972,253975,0,3,1
72535,5,3,253977,253977,253980,0,3,2
72536,1,2,253978,253980,253982,2,4,0
72537,5,2,253983,253983,253985,0,2,1
72538,5,1,253988,253988,253989,0,1,3
72539,5,2,253993,253993,253995,0,2,4
72540,5,3,253998,253998,254001,0,3,3
72541,3,2,254001,254001,254003,0,2,0
72542,6,3,254007,254007,254010,0,3,4
72543,3,2,254010,254010,254012,0,2,0
72544,3,2,254013,254013,254015,0,2,1
72545,3,1,254016,254016,254017,0,1,1
72546,5,1,254021,254021,254022,0,1,4
72547,6,1,254027,254027,254028,0,1,5
72548,5,2,254032,254032,254034,0,2,4
72549,4,3,254036,254036,254039,0,3,2
72550,6,1,254042,254042,254043,0,1,3
72551,5,3,254047,254047,254050,0,3,4
72552,4,2,254051,254051,254053,0,2,1
72553,1,2,254052,254053,254055,1,3,0
72554,4,2,254056,254056,254058,0,2,1
72555,6,2,254062,254062,254064,0,2,4
72556,4,1,254066,254066,254067,0,1,2
72557,1,1,254067,254067,254068,0,1,0
72558,3,2,254070,254070,254072,0,2,2
72559,4,1,254074,254074,254075,0,1,2
72560,5,3,254079,254079,254082,0,3,4
72561,1,3,254080,254082,254085,2,5,0
72562,5,3,254085,254085,254088,0,3,0
72563,4,2,254089,254089,254091,0,2,1
72564,3,2,254092,254092,254094,0,2,1
72565,2,2,254094,254094,254096,0,2,0
72566,5,1,254099,254099,254100,0,1,3
72567,2,2,254101,254101,254103,0,2,1
72568,1,1,254102,254103,254104,1,2,0
72569,5,2,254107,254107,254109,0,2,3
72570,5,2,254112,254112,254114,0,2,3
72571,1,1,254113,254114,254115,1,2,0
72572,3,3,254116,254116,254119,0,3,1
72573,6,2,254122,254122,254124,0,2,3
72574,3,2,254125,254125,254127,0,2,1
72575,5,2,254130,254130,254132,0,2,3
72576,5,2,254135,254135,254137,0,2,3
72577,2,1,254137,254137,254138,0,1,0
72578,2,2,254139,254139,254141,0,2,1
72579,6,3,254145,254145,254148,0,3,4
72580,3,1,254148,254148,254149,0,1,0
72581,6,3,254154,254154,254157,0,3,5
72582,4,1,254158,254158,254159,0,1,1
72583,5,1,254163,254163,254164,0,1,4
72584,6,2,254169,254169,254171,0,2,5
72585,1,3,254170,254171,254174,1,4,0
72586,5,2,254175,254175,254177,0,2,1
72587,3,1,254178,254178,254179,0,1,1
72588,2,3,254180,254180,254183,0,3,1
72589,1,2,254181,254183,254185,2,4,0
72590,2,1,254183,254185,254186,2,3,0
72591,3,3,254186,254186,254189,0,3,0
72592,5,2,254191,254191,254193,0,2,2
72593,3,3,254194,254194,254197,0,3,1
72594,5,3,254199,254199,254202,0,3,2
72595,5,2,254204,254204,254206,0,2,2
72596,5,1,254209,254209,254210,0,1,3
72597,3,3,254212,254212,254215,0,3,2
72598,5,2,254217,254217,254219,0,2,2
72599,5,1,254222,254222,254223,0,1,3
72600,5,1,254227,254227,254228,0,1,4
72601,2,2,254229,254229,254231,0,2,1
72602,4,3,254233,254233,254236,0,3,2
72603,4,3,254237,254237,254240,0,3,1
72604,3,2,254240,254240,254242,0,2,0
72605,5,2,254245,254245,254247,0,2,3
72606,6,2,254251,254251,254253,0,2,4
72607,2,3,254253,254253,254256,0,3,0
72608,4,3,254257,254257,254260,0,3,1
72609,6,1,254263,254263,254264,0,1,3
72610,6,1,254269,254269,254270,0,1,5
72611,6,1,254275,254275,254276,0,1,5
72612,3,1,254278,254278,254279,0,1,2
72613,5,2,254283,254283,254285,0,2,4
72614,2,3,254285,254285,254288,0,3,0
72615,6,1,254291,254291,254292,0,1,3
72616,1,2,254292,254292,254294,0,2,0
72617,3,2,254295,254295,254297,0,2,1
72618,4,2,254299,254299,254301,0,2,2
72619,6,3,254305,254305,254308,0,3,4
72620,4,1,254309,254309,254310,0,1,1
72621,4,1,254313,254313,254314,0,1,3
72622,4,2,254317,254317,254319,0,2,3
72623,2,3,254319,254319,254322,0,3,0
72624,4,3,254323,254323,254326,0,3,1
72625,1,3,254324,254326,254329,2,5,0
72626,4,1,254328,254329,254330,1,2,0
72627,5,1,254333,254333,254334,0,1,3
72628,5,2,254338,254338,254340,0,2,4
72629,4,2,254342,254342,254344,0,2,2
72630,4,3,254346,254346,254349,0,3,2
72631,5,3,254351,254351,254354,0,3,2
72632,3,2,254354,254354,254356,0,2,0
72633,5,1,254359,254359,254360,0,1,3
72634,4,1,254363,254363,254364,0,1,3
72635,1,1,254364,254364,254365,0,1,0
72636,4,1,254368,254368,254369,0,1,3
72637,3,1,254371,254371,254372,0,1,2
72638,6,1,254377,254377,254378,0,1,5
72639,3,2,254380,254380,254382,0,2,2
72640,4,1,254384,254384,254385,0,1,2
72641,5,1,254389,254389,254390,0,1,4
72642,5,2,254394,254394,254396,0,2,4
72643,2,3,254396,254396,254399,0,3,0
72644,4,3,254400,254400,254403,0,3,1
72645,3,2,254403,254403,254405,0,2,0
72646,5,1,254408,254408,254409,0,1,3
72647,3,1,254411,254411,254412,0,1,2
72648,2,2,254413,254413,254415,0,2,1
72649,4,1,254417,254417,254418,0,1,2
72650,1,1,254418,254418,254419,0,1,0
72651,1,2,254419,254419,254421,0,2,0
72652,4,3,254423,254423,254426,0,3,2
72653,6,1,254429,254429,254430,0,1,3
72654,4,2,254433,254433,254435,0,2,3
72655,6,2,254439,254439,254441,0,2,4
72656,4,3,254443,254443,254446,0,3,2
72657,4,2,254447,254447,254449,0,2,1
72658,2,3,254449,254449,254452,0,3,0
72659,5,2,254454,254454,254456,0,2,2
72660,2,3,254456,254456,254459,0,3,0
72661,3,1,254459,254459,254460,0,1,0
72662,4,3,254463,254463,254466,0,3,3
72663,5,2,254468,254468,254470,0,2,2
72664,2,1,254470,254470,254471,0,1,0
72665,6,2,254476,254476,254478,0,2,5
72666,1,2,254477,254478,254480,1,3,0
72667,5,2,254482,254482,254484,0,2,2
72668,1,2,254483,254484,254486,1,3,0
72669,5,3,254488,254488,254491,0,3,2
72670,1,2,254489,254491,254493,2,4,0
72671,6,1,254495,254495,254496,0,1,2
72672,6,1,254501,254501,254502,0,1,5
72673,6,1,254507,254507,254508,0,1,5
72674,5,3,254512,254512,254515,0,3,4
72675,4,2,254516,254516,254518,0,2,1
72676,4,2,254520,254520,254522,0,2,2
72677,6,2,254526,254526,254528,0,2,4
72678,5,2,254531,254531,254533,0,2,3
72679,1,1,254532,254533,254534,1,2,0
72680,6,1,254538,254538,254539,0,1,4
72681,4,3,254542,254542,254545,0,3,3
72682,6,2,254548,254548,254550,0,2,3
72683,4,2,254552,254552,254554,0,2,2
72684,4,3,254556,254556,254559,0,3,2
72685,1,1,254557,254559,254560,2,3,0
72686,1,2,254558,254560,254562,2,4,0
72687,1,3,254559,254562,254565,3,6,0
72688,2,2,254561,254565,254567,4,6,0
72689,5,1,254566,254567,254568,1,2,0
72690,2,1,254568,254568,254569,0,1,0
72691,2,3,254570,254570,254573,0,3,1
72692,4,2,254574,254574,254576,0,2,1
72693,3,2,254577,254577,254579,0,2,1
72694,4,2,254581,254581,254583,0,2,2
72695,5,2,254586,254586,254588,0,2,3
72696,5,1,254591,254591,254592,0,1,3
72697,3,2,254594,254594,254596,0,2,2
72698,6,3,254600,254600,254603,0,3,4
72699,3,3,254603,254603,254606,0,3,0
72700,1,3,254604,254606,254609,2,5,0
72701,6,2,254610,254610,254612,0,2,1
72702,4,3,254614,254614,254617,0,3,2
72703,5,2,254619,254619,254621,0,2,2
72704,3,2,254622,254622,254624,0,2,1
72705,5,2,254627,254627,254629,0,2,3
72706,1,2,254628,254629,254631,1,3,0
72707,1,3,254629,254631,254634,2,5,0
72708,1,2,254630,254634,254636,4,6,0
72709,5,2,254635,254636,254638,1,3,0
72710,2,2,254637,254638,254640,1,3,0
72711,4,1,254641,254641,254642,0,1,1
72712,3,3,254644,254644,254647,0,3,2
72713,4,3,254648,254648,254651,0,3,1
72714,5,1,254653,254653,254654,0,1,2
72715,6,1,254659,254659,254660,0,1,5
72716,6,1,254665,254665,254666,0,1,5
72717,1,2,254666,254666,254668,0,2,0
72718,6,2,254672,254672,254674,0,2,4
72719,1,1,254673,254674,254675,1,2,0
72720,3,2,254676,254676,254678,0,2,1
72721,5,3,254681,254681,254684,0,3,3
72722,6,3,254687,254687,254690,0,3,3
72723,1,1,254688,254690,254691,2,3,0
72724,3,2,254691,254691,254693,0,2,0
72725,1,1,254692,254693,254694,1,2,0
72726,4,3,254696,254696,254699,0,3,2
72727,6,1,254702,254702,254703,0,1,3
72728,3,1,254705,254705,254706,0,1,2
72729,6,1,254711,254711,254712,0,1,5
72730,4,3,254715,254715,254718,0,3,3
72731,2,1,254717,254718,254719,1,2,0
72732,6,3,254723,254723,254726,0,3,4
72733,2,1,254725,254726,254727,1,2,0
72734,2,1,254727,254727,254728,0,1,0
72735,5,1,254732,254732,254733,0,1,4
72736,2,1,254734,254734,254735,0,1,1
72737,5,2,254739,254739,254741,0,2,4
72738,1,1,254740,254741,254742,1,2,0
72739,3,1,254743,254743,254744,0,1,1
72740,3,1,254746,254746,254747,0,1,2
72741,4,2,254750,254750,254752,0,2,3
72742,2,1,254752,254752,254753,0,1,0
72743,5,3,254757,254757,254760,0,3,4
72744,4,1,254761,254761,254762,0,1,1
72745,2,2,254763,254763,254765,0,2,1
72746,2,3,254765,254765,254768,0,3,0
72747,6,3,254771,254771,254774,0,3,3
72748,1,2,254772,254774,254776,2,4,0
72749,4,2,254776,254776,254778,0,2,0
72750,2,2,254778,254778,254780,0,2,0
72751,2,2,254780,254780,254782,0,2,0
72752,2,2,254782,254782,254784,0,2,0
72753,5,1,254787,254787,254788,0,1,3
72754,3,2,254790,254790,254792,0,2,2
72755,5,1,254795,254795,254796,0,1,3
72756,2,1,254797,254797,254798,0,1,1
72757,5,3,254802,254802,254805,0,3,4
72758,4,1,254806,254806,254807,0,1,1
72759,6,3,254812,254812,254815,0,3,5
72760,1,3,254813,254815,254818,2,5,0
72761,6,3,254819,254819,254822,0,3,1
72762,6,1,254825,254825,254826,0,1,3
72763,5,3,254830,254830,254833,0,3,4
72764,1,3,254831,254833,254836,2,5,0
72765,4,2,254835,254836,254838,1,3,0
72766,1,1,254836,254838,254839,2,3,0
72767,3,1,254839,254839,254840,0,1,0
72768,4,1,254843,254843,254844,0,1,3
72769,6,1,254849,254849,254850,0,1,5
72770,6,3,254855,254855,254858,0,3,5
72771,1,3,254856,254858,254861,2,5,0
72772,4,3,254860,254861,254864,1,4,0
72773,5,2,254865,254865,254867,0,2,1
72774,5,3,254870,254870,254873,0,3,3
72775,4,1,254874,254874,254875,0,1,1
72776,2,3,254876,254876,254879,0,3,1
72777,4,1,254880,254880,254881,0,1,1
72778,5,3,254885,254885,254888,0,3,4
72779,4,1,254889,254889,254890,0,1,1
72780,4,2,254893,254893,254895,0,2,3
72781,6,2,254899,254899,254901,0,2,4
72782,1,1,254900,254901,254902,1,2,0
72783,2,3,254902,254902,254905,0,3,0
72784,1,3,254903,254905,254908,2,5,0
72785,4,3,254907,254908,254911,1,4,0
72786,3,1,254910,254911,254912,1,2,0
72787,2,2,254912,254912,254914,0,2,0
72788,2,2,254914,254914,254916,0,2,0
72789,6,2,254920,254920,254922,0,2,4
72790,1,3,254921,254922,254925,1,4,0
72791,6,2,254927,254927,254929,0,2,2
72792,1,3,254928,254929,254932,1,4,0
72793,3,3,254931,254932,254935,1,4,0
72794,1,2,254932,254935,254937,3,5,0
72795,5,2,254937,254937,254939,0,2,0
72796,3,2,254940,254940,254942,0,2,1
72797,3,2,254943,254943,254945,0,2,1
72798,3,3,254946,254946,254949,0,3,1
72799,2,1,254948,254949,254950,1,2,0
72800,1,3,254949,254950,254953,1,4,0
72801,2,3,254951,254953,254956,2,5,0
72802,2,3,254953,254956,254959,3,6,0
72803,1,1,254954,254959,254960,5,6,0
72804,6,1,254960,254960,254961,0,1,0
72805,4,1,254964,254964,254965,0,1,3
72806,5,1,254969,254969,254970,0,1,4
72807,2,1,254971,254971,254972,0,1,1
72808,3,1,254974,254974,254975,0,1,2
72809,3,2,254977,254977,254979,0,2,2
72810,3,1,254980,254980,254981,0,1,1
72811,2,2,254982,254982,254984,0,2,1
72812,2,1,254984,254984,254985,0,1,0
72813,5,1,254989,254989,254990,0,1,4
72814,6,1,254995,254995,254996,0,1,5
72815,3,3,254998,254998,255001,0,3,2
72816,4,1,255002,255002,255003,0,1,1
72817,1,3,255003,255003,255006,0,3,0
72818,5,2,255008,255008,255010,0,2,2
72819,6,2,255014,255014,255016,0,2,4
72820,3,2,255017,255017,255019,0,2,1
72821,3,1,255020,255020,255021,0,1,1
72822,6,1,255026,255026,255027,0,1,5
72823,4,1,255030,255030,255031,0,1,3
72824,3,1,255033,255033,255034,0,1,2
72825,1,1,255034,255034,255035,0,1,0
72826,6,3,255040,255040,255043,0,3,5
72827,2,2,255042,255043,255045,1,3,0
72828,3,1,255045,255045,255046,0,1,0
72829,2,3,255047,255047,255050,0,3,1
72830,1,3,255048,255050,255053,2,5,0
72831,3,1,255051,255053,255054,2,3,0
72832,5,2,255056,255056,255058,0,2,2
72833,6,2,255062,255062,255064,0,2,4
72834,5,2,255067,255067,255069,0,2,3
72835,1,3,255068,255069,255072,1,4,0
72836,5,2,255073,255073,255075,0,2,1
72837,1,3,255074,255075,255078,1,4,0
72838,5,1,255079,255079,255080,0,1,1
72839,6,2,255085,255085,255087,0,2,5
72840,5,2,255090,255090,255092,0,2,3
72841,3,2,255093,255093,255095,0,2,1
72842,2,3,255095,255095,255098,0,3,0
72843,4,2,255099,255099,255101,0,2,1
72844,5,3,255104,255104,255107,0,3,3
72845,2,3,255106,255107,255110,1,4,0
72846,5,2,255111,255111,255113,0,2,1
72847,1,2,255112,255113,255115,1,3,0
72848,6,1,255118,255118,255119,0,1,3
72849,6,2,255124,255124,255126,0,2,5
72850,5,2,255129,255129,255131,0,2,3
72851,4,1,255133,255133,255134,0,1,2
72852,6,3,255139,255139,255142,0,3,5
72853,2,3,255141,255142,255145,1,4,0
72854,1,1,255142,255145,255146,3,4,0
72855,6,2,255148,255148,255150,0,2,2
72856,2,3,255150,255150,255153,0,3,0
72857,1,3,255151,255153,255156,2,5,0
72858,6,3,255157,255157,255160,0,3,1
72859,4,2,255161,255161,255163,0,2,1
72860,3,3,255164,255164,255167,0,3,1
72861,4,2,255168,255168,255170,0,2,1
72862,2,2,255170,255170,255172,0,2,0
72863,3,2,255173,255173,255175,0,2,1
72864,3,2,255176,255176,255178,0,2,1
72865,3,1,255179,255179,255180,0,1,1
72866,2,1,255181,255181,255182,0,1,1
72867,6,1,255187,255187,255188,0,1,5
72868,3,3,255190,255190,255193,0,3,2
72869,5,2,255195,255195,255197,0,2,2
72870,4,3,255199,255199,255202,0,3,2
72871,5,1,255204,255204,255205,0,1,2
72872,2,1,255206,255206,255207,0,1,1
72873,3,2,255209,255209,255211,0,2,2
72874,3,2,255212,255212,255214,0,2,1
72875,4,2,255216,255216,255218,0,2,2
72876,4,2,255220,255220,255222,0,2,2
72877,3,1,255223,255223,255224,0,1,1
72878,5,3,255228,255228,255231,0,3,4
72879,1,2,255229,255231,255233,2,4,0
72880,6,1,255235,255235,255236,0,1,2
72881,1,3,255236,255236,255239,0,3,0
72882,3,2,255239,255239,255241,0,2,0
72883,4,2,255243,255243,255245,0,2,2
72884,6,2,255249,255249,255251,0,2,4
72885,1,1,255250,255251,255252,1,2,0
72886,4,3,255254,255254,255257,0,3,2
72887,6,1,255260,255260,255261,0,1,3
72888,1,2,255261,255261,255263,0,2,0
72889,1,1,255262,255263,255264,1,2,0
72890,3,2,255265,255265,255267,0,2,1
72891,3,2,255268,255268,255270,0,2,1
72892,1,3,255269,255270,255273,1,4,0
72893,3,3,255272,255273,255276,1,4,0
72894,4,3,255276,255276,255279,0,3,0
72895,5,1,255281,255281,255282,0,1,2
72896,6,2,255287,255287,255289,0,2,5
72897,1,1,255288,255289,255290,1,2,0
72898,1,1,255289,255290,255291,1,2,0
72899,2,1,255291,255291,255292,0,1,0
72900,6,2,255297,255297,255299,0,2,5
72901,6,2,255303,255303,255305,0,2,4
72902,6,1,255309,255309,255310,0,1,4
72903,1,2,255310,255310,255312,0,2,0
72904,5,3,255315,255315,255318,0,3,3
72905,3,2,255318,255318,255320,0,2,0
72906,2,1,255320,255320,255321,0,1,0
72907,5,1,255325,255325,255326,0,1,4
72908,5,2,255330,255330,255332,0,2,4
72909,4,3,255334,255334,255337,0,3,2
72910,5,3,255339,255339,255342,0,3,2
72911,5,2,255344,255344,255346,0,2,2
72912,4,2,255348,255348,255350,0,2,2
72913,6,3,255354,255354,255357,0,3,4
72914,4,3,255358,255358,255361,0,3,1
72915,5,2,255363,255363,255365,0,2,2
72916,1,3,255364,255365,255368,1,4,0
72917,6,3,255370,255370,255373,0,3,2
72918,3,2,255373,255373,255375,0,2,0
72919,5,2,255378,255378,255380,0,2,3
72920,3,2,255381,255381,255383,0,2,1
72921,5,1,255386,255386,255387,0,1,3
72922,3,3,255389,255389,255392,0,3,2
72923,2,2,255391,255392,255394,1,3,0
72924,5,2,255396,255396,255398,0,2,2
72925,2,1,255398,255398,255399,0,1,0
72926,2,3,255400,255400,255403,0,3,1
72927,1,3,255401,255403,255406,2,5,0
72928,1,3,255402,255406,255409,4,7,0
72929,2,2,255404,255409,255411,5,7,0
72930,6,1,255410,255411,255412,1,2,0
72931,1,1,255411,255412,255413,1,2,0
72932,2,2,255413,255413,255415,0,2,0
72933,1,3,255414,255415,255418,1,4,0
72934,6,2,255420,255420,255422,0,2,2
72935,2,3,255422,255422,255425,0,3,0
72936,5,1,255427,255427,255428,0,1,2
72937,3,1,255430,255430,255431,0,1,2
72938,1,3,255431,255431,255434,0,3,0
72939,5,1,255436,255436,255437,0,1,2
72940,2,3,255438,255438,255441,0,3,1
72941,3,1,255441,255441,255442,0,1,0
72942,4,3,255445,255445,255448,0,3,3
72943,1,2,255446,255448,255450,2,4,0
72944,4,3,255450,255450,255453,0,3,0
72945,3,3,255453,255453,255456,0,3,0
72946,5,3,255458,255458,255461,0,3,2
72947,3,2,255461,255461,255463,0,2,0
72948,5,1,255466,255466,255467,0,1,3
72949,4,1,255470,255470,255471,0,1,3
72950,3,3,255473,255473,255476,0,3,2
72951,4,1,255477,255477,255478,0,1,1
72952,3,3,255480,255480,255483,0,3,2
72953,5,2,255485,255485,255487,0,2,2
72954,1,1,255486,255487,255488,1,2,0
72955,6,1,255492,255492,255493,0,1,4
72956,6,2,255498,255498,255500,0,2,5
72957,2,1,255500,255500,255501,0,1,0
72958,2,3,255502,255502,255505,0,3,1
72959,2,1,255504,255505,255506,1,2,0
72960,5,3,255509,255509,255512,0,3,3
72961,2,2,255511,255512,255514,1,3,0
72962,6,2,255517,255517,255519,0,2,3
72963,1,2,255518,255519,255521,1,3,0
72964,2,1,255520,255521,255522,1,2,0
72965,1,2,255521,255522,255524,1,3,0
72966,6,1,255527,255527,255528,0,1,3
72967,3,3,255530,255530,255533,0,3,2
72968,4,2,255534,255534,255536,0,2,1
72969,5,2,255539,255539,255541,0,2,3
72970,6,2,255545,255545,255547,0,2,4
72971,6,3,255551,255551,255554,0,3,4
72972,5,1,255556,255556,255557,0,1,2
72973,3,3,255559,255559,255562,0,3,2
72974,3,2,255562,255562,255564,0,2,0
72975,4,1,255566,255566,255567,0,1,2
72976,2,2,255568,255568,255570,0,2,1
72977,3,2,255571,255571,255573,0,2,1
72978,6,3,255577,255577,255580,0,3,4
72979,3,1,255580,255580,255581,0,1,0
72980,1,3,255581,255581,255584,0,3,0
72981,2,1,255583,255584,255585,1,2,0
72982,1,2,255584,255585,255587,1,3,0
72983,6,3,255590,255590,255593,0,3,3
72984,4,2,255594,255594,255596,0,2,1
72985,4,1,255598,255598,255599,0,1,2
72986,6,1,255604,255604,255605,0,1,5
72987,4,1,255608,255608,255609,0,1,3
72988,2,3,255610,255610,255613,0,3,1
72989,5,2,255615,255615,255617,0,2,2
72990,2,2,255617,255617,255619,0,2,0
72991,1,2,255618,255619,255621,1,3,0
72992,3,1,255621,255621,255622,0,1,0
72993,6,1,255627,255627,255628,0,1,5
72994,3,1,255630,255630,255631,0,1,2
72995,6,3,255636,255636,255639,0,3,5
72996,5,1,255641,255641,255642,0,1,2
72997,6,1,255647,255647,255648,0,1,5
72998,5,3,255652,255652,255655,0,3,4
72999,5,1,255657,255657,255658,0,1,2
73000,1,1,255658,255658,255659,0,1,0
73001,3,3,255661,255661,255664,0,3,2
73002,1,2,255662,255664,255666,2,4,0
73003,2,3,255664,255666,255669,2,5,0
73004,1,2,255665,255669,255671,4,6,0
73005,3,3,255668,255671,255674,3,6,0
73006,5,3,255673,255674,255677,1,4,0
73007,4,3,255677,255677,255680,0,3,0
73008,5,3,255682,255682,255685,0,3,2
73009,5,2,255687,255687,255689,0,2,2
73010,2,3,255689,255689,255692,0,3,0
73011,2,3,255691,255692,255695,1,4,0
73012,6,3,255697,255697,255700,0,3,2
73013,1,2,255698,255700,255702,2,4,0
73014,2,3,255700,255702,255705,2,5,0
73015,3,2,255703,255705,255707,2,4,0
73016,5,1,255708,255708,255709,0,1,1
73017,1,1,255709,255709,255710,0,1,0
73018,1,1,255710,255710,255711,0,1,0
73019,1,3,255711,255711,255714,0,3,0
73020,6,2,255717,255717,255719,0,2,3
73021,2,3,255719,255719,255722,0,3,0
73022,3,2,255722,255722,255724,0,2,0
73023,6,2,255728,255728,255730,0,2,4
73024,2,2,255730,255730,255732,0,2,0
73025,4,2,255734,255734,255736,0,2,2
73026,2,3,255736,255736,255739,0,3,0
73027,1,2,255737,255739,255741,2,4,0
73028,4,2,255741,255741,255743,0,2,0
73029,4,1,255745,255745,255746,0,1,2
73030,2,2,255747,255747,255749,0,2,1
73031,1,3,255748,255749,255752,1,4,0
73032,3,3,255751,255752,255755,1,4,0
73033,2,2,255753,255755,255757,2,4,0
73034,3,1,255756,255757,255758,1,2,0
73035,5,2,255761,255761,255763,0,2,3
73036,2,3,255763,255763,255766,0,3,0
73037,4,2,255767,255767,255769,0,2,1
73038,6,1,255773,255773,255774,0,1,4
73039,2,3,255775,255775,255778,0,3,1
73040,2,3,255777,255778,255781,1,4,0
73041,6,3,255783,255783,255786,0,3,2
73042,6,2,255789,255789,255791,0,2,3
73043,5,2,255794,255794,255796,0,2,3
73044,2,2,255796,255796,255798,0,2,0
73045,5,2,255801,255801,255803,0,2,3
73046,5,3,255806,255806,255809,0,3,3
73047,6,2,255812,255812,255814,0,2,3
73048,3,3,255815,255815,255818,0,3,1
73049,4,1,255819,255819,255820,0,1,1
73050,5,2,255824,255824,255826,0,2,4
73051,4,1,255828,255828,255829,0,1,2
73052,2,2,255830,255830,255832,0,2,1
73053,5,3,255835,255835,255838,0,3,3
73054,2,2,255837,255838,255840,1,3,0
73055,3,3,255840,255840,255843,0,3,0
73056,2,3,255842,255843,255846,1,4,0
73057,4,1,255846,255846,255847,0,1,0
73058,6,3,255852,255852,255855,0,3,5
73059,4,3,255856,255856,255859,0,3,1
73060,4,2,255860,255860,255862,0,2,1
73061,6,2,255866,255866,255868,0,2,4
73062,5,2,255871,255871,255873,0,2,3
73063,5,2,255876,255876,255878,0,2,3
73064,1,2,255877,255878,255880,1,3,0
73065,6,1,255883,255883,255884,0,1,3
73066,3,3,255886,255886,255889,0,3,2
73067,4,1,255890,255890,255891,0,1,1
73068,2,3,255892,255892,255895,0,3,1
73069,1,3,255893,255895,255898,2,5,0
73070,6,2,255899,255899,255901,0,2,1
73071,1,1,255900,255901,255902,1,2,0
73072,2,1,255902,255902,255903,0,1,0
73073,2,3,255904,255904,255907,0,3,1
73074,3,1,255907,255907,255908,0,1,0
73075,4,2,255911,255911,255913,0,2,3
73076,2,3,255913,255913,255916,0,3,0
73077,2,2,255915,255916,255918,1,3,0
73078,2,1,255917,255918,255919,1,2,0
73079,1,3,255918,255919,255922,1,4,0
73080,2,3,255920,255922,255925,2,5,0
73081,6,3,255926,255926,255929,0,3,1
73082,3,2,255929,255929,255931,0,2,0
73083,2,3,255931,255931,255934,0,3,0
73084,3,3,255934,255934,255937,0,3,0
73085,1,1,255935,255937,255938,2,3,0
73086,2,3,255937,255938,255941,1,4,0
73087,6,1,255943,255943,255944,0,1,2
73088,2,1,255945,255945,255946,0,1,1
73089,1,3,255946,255946,255949,0,3,0
73090,4,3,255950,255950,255953,0,3,1
73091,4,2,255954,255954,255956,0,2,1
73092,6,3,255960,255960,255963,0,3,4
73093,2,2,255962,255963,255965,1,3,0
73094,6,2,255968,255968,255970,0,2,3
73095,4,1,255972,255972,255973,0,1,2
73096,1,1,255973,255973,255974,0,1,0
73097,1,3,255974,255974,255977,0,3,0
73098,6,2,255980,255980,255982,0,2,3
73099,2,2,255982,255982,255984,0,2,0
73100,6,3,255988,255988,255991,0,3,4
73101,5,1,255993,255993,255994,0,1,2
73102,3,1,255996,255996,255997,0,1,2
73103,2,2,255998,255998,256000,0,2,1
73104,4,1,256002,256002,256003,0,1,2
73105,1,1,256003,256003,256004,0,1,0
73106,6,3,256009,256009,256012,0,3,5
73107,3,1,256012,256012,256013,0,1,0
73108,3,2,256015,256015,256017,0,2,2
73109,6,3,256021,256021,256024,0,3,4
73110,4,2,256025,256025,256027,0,2,1
73111,3,1,256028,256028,256029,0,1,1
73112,1,3,256029,256029,256032,0,3,0
73113,6,1,256035,256035,256036,0,1,3
73114,1,3,256036,256036,256039,0,3,0
73115,4,3,256040,256040,256043,0,3,1
73116,2,2,256042,256043,256045,1,3,0
73117,2,1,256044,256045,256046,1,2,0
73118,3,1,256047,256047,256048,0,1,1
73119,2,2,256049,256049,256051,0,2,1
73120,1,2,256050,256051,256053,1,3,0
73121,1,3,256051,256053,256056,2,5,0
73122,1,2,256052,256056,256058,4,6,0
73123,6,1,256058,256058,256059,0,1,0
73124,4,1,256062,256062,256063,0,1,3
73125,4,1,256066,256066,256067,0,1,3
73126,4,2,256070,256070,256072,0,2,3
73127,5,1,256075,256075,256076,0,1,3
73128,2,1,256077,256077,256078,0,1,1
73129,2,1,256079,256079,256080,0,1,1
73130,6,2,256085,256085,256087,0,2,5
73131,3,3,256088,256088,256091,0,3,1
73132,4,3,256092,256092,256095,0,3,1
73133,5,1,256097,256097,256098,0,1,2
73134,5,2,256102,256102,256104,0,2,4
73135,1,1,256103,256104,256105,1,2,0
73136,3,1,256106,256106,256107,0,1,1
73137,5,1,256111,256111,256112,0,1,4
73138,4,2,256115,256115,256117,0,2,3
73139,2,3,256117,256117,256120,0,3,0
73140,2,1,256119,256120,256121,1,2,0
73141,6,2,256125,256125,256127,0,2,4
73142,5,1,256130,256130,256131,0,1,3
73143,5,3,256135,256135,256138,0,3,4
73144,3,2,256138,256138,256140,0,2,0
73145,1,1,256139,256140,256141,1,2,0
73146,2,1,256141,256141,256142,0,1,0
73147,6,2,256147,256147,256149,0,2,5
73148,4,1,256151,256151,256152,0,1,2
73149,5,2,256156,256156,256158,0,2,4
73150,6,1,256162,256162,256163,0,1,4
73151,4,2,256166,256166,256168,0,2,3
73152,2,1,256168,256168,256169,0,1,0
73153,3,1,256171,256171,256172,0,1,2
73154,6,2,256177,256177,256179,0,2,5
73155,5,1,256182,256182,256183,0,1,3
73156,1,2,256183,256183,256185,0,2,0
73157,2,1,256185,256185,256186,0,1,0
73158,4,2,256189,256189,256191,0,2,3
73159,3,2,256192,256192,256194,0,2,1
73160,3,3,256195,256195,256198,0,3,1
73161,4,3,256199,256199,256202,0,3,1
73162,4,2,256203,256203,256205,0,2,1
73163,3,2,256206,256206,256208,0,2,1
73164,3,3,256209,256209,256212,0,3,1
73165,6,3,256215,256215,256218,0,3,3
73166,2,1,256217,256218,256219,1,2,0
73167,3,3,256220,256220,256223,0,3,1
73168,1,2,256221,256223,256225,2,4,0
73169,2,2,256223,256225,256227,2,4,0
73170,5,3,256228,256228,256231,0,3,1
73171,2,3,256230,256231,256234,1,4,0
73172,6,1,256236,256236,256237,0,1,2
73173,3,3,256239,256239,256242,0,3,2
73174,5,3,256244,256244,256247,0,3,2
73175,6,3,256250,256250,256253,0,3,3
73176,4,2,256254,256254,256256,0,2,1
73177,6,1,256260,256260,256261,0,1,4
73178,5,1,256265,256265,256266,0,1,4
73179,6,3,256271,256271,256274,0,3,5
73180,5,3,256276,256276,256279,0,3,2
73181,5,2,256281,256281,256283,0,2,2
73182,4,1,256285,256285,256286,0,1,2
73183,4,1,256289,256289,256290,0,1,3
73184,1,2,256290,256290,256292,0,2,0
73185,2,3,256292,256292,256295,0,3,0
73186,5,2,256297,256297,256299,0,2,2
73187,3,3,256300,256300,256303,0,3,1
73188,3,1,256303,256303,256304,0,1,0
73189,4,3,256307,256307,256310,0,3,3
73190,4,3,256311,256311,256314,0,3,1
73191,6,1,256317,256317,256318,0,1,3
73192,4,2,256321,256321,256323,0,2,3
73193,3,3,256324,256324,256327,0,3,1
73194,3,2,256327,256327,256329,0,2,0
73195,3,3,256330,256330,256333,0,3,1
73196,6,2,256336,256336,256338,0,2,3
73197,3,1,256339,256339,256340,0,1,1
73198,3,3,256342,256342,256345,0,3,2
73199,1,2,256343,256345,256347,2,4,0
73200,6,2,256349,256349,256351,0,2,2
73201,6,2,256355,256355,256357,0,2,4
73202,4,2,256359,256359,256361,0,2,2
73203,1,1,256360,256361,256362,1,2,0
73204,3,2,256363,256363,256365,0,2,1
73205,1,2,256364,256365,256367,1,3,0
73206,1,1,256365,256367,256368,2,3,0
73207,1,3,256366,256368,256371,2,5,0
73208,3,3,256369,256371,256374,2,5,0
73209,3,3,256372,256374,256377,2,5,0
73210,6,1,256378,256378,256379,0,1,1
73211,1,2,256379,256379,256381,0,2,0
73212,4,2,256383,256383,256385,0,2,2
73213,1,1,256384,256385,256386,1,2,0
73214,1,1,256385,256386,256387,1,2,0
73215,2,2,256387,256387,256389,0,2,0
73216,5,3,256392,256392,256395,0,3,3
73217,6,3,256398,256398,256401,0,3,3
73218,1,1,256399,256401,256402,2,3,0
73219,4,3,256403,256403,256406,0,3,1
73220,6,2,256409,256409,256411,0,2,3
73221,5,3,256414,256414,256417,0,3,3
73222,3,2,256417,256417,256419,0,2,0
73223,6,3,256423,256423,256426,0,3,4
73224,3,2,256426,256426,256428,0,2,0
73225,2,2,256428,256428,256430,0,2,0
73226,1,1,256429,256430,256431,1,2,0
73227,4,1,256433,256433,256434,0,1,2
73228,1,2,256434,256434,256436,0,2,0
73229,4,2,256438,256438,256440,0,2,2
73230,6,2,256444,256444,256446,0,2,4
73231,2,1,256446,256446,256447,0,1,0
73232,3,2,256449,256449,256451,0,2,2
73233,6,1,256455,256455,256456,0,1,4
73234,2,3,256457,256457,256460,0,3,1
73235,1,3,256458,256460,256463,2,5,0
73236,3,2,256461,256463,256465,2,4,0
73237,4,3,256465,256465,256468,0,3,0
73238,3,1,256468,256468,256469,0,1,0
73239,4,1,256472,256472,256473,0,1,3
73240,6,2,256478,256478,256480,0,2,5
73241,4,1,256482,256482,256483,0,1,2
73242,4,2,256486,256486,256488,0,2,3
73243,6,2,256492,256492,256494,0,2,4
73244,3,3,256495,256495,256498,0,3,1
73245,2,2,256497,256498,256500,1,3,0
73246,6,2,256503,256503,256505,0,2,3
73247,2,2,256505,256505,256507,0,2,0
73248,2,3,256507,256507,256510,0,3,0
73249,4,3,256511,256511,256514,0,3,1
73250,6,3,256517,256517,256520,0,3,3
73251,2,2,256519,256520,256522,1,3,0
73252,5,3,256524,256524,256527,0,3,2
73253,6,3,256530,256530,256533,0,3,3
73254,2,1,256532,256533,256534,1,2,0
73255,1,2,256533,256534,256536,1,3,0
73256,4,1,256537,256537,256538,0,1,1
73257,6,2,256543,256543,256545,0,2,5
73258,5,3,256548,256548,256551,0,3,3
73259,1,3,256549,256551,256554,2,5,0
73260,6,1,256555,256555,256556,0,1,1
73261,5,1,256560,256560,256561,0,1,4
73262,1,2,256561,256561,256563,0,2,0
73263,5,3,256566,256566,256569,0,3,3
73264,1,1,256567,256569,256570,2,3,0
73265,1,1,256568,256570,256571,2,3,0
73266,3,1,256571,256571,256572,0,1,0
73267,1,3,256572,256572,256575,0,3,0
73268,6,1,256578,256578,256579,0,1,3
73269,3,3,256581,256581,256584,0,3,2
73270,5,3,256586,256586,256589,0,3,2
73271,5,3,256591,256591,256594,0,3,2
73272,4,2,256595,256595,256597,0,2,1
73273,5,3,256600,256600,256603,0,3,3
73274,6,3,256606,256606,256609,0,3,3
73275,4,1,256610,256610,256611,0,1,1
73276,3,3,256613,256613,256616,0,3,2
73277,2,1,256615,256616,256617,1,2,0
73278,4,1,256619,256619,256620,0,1,2
73279,4,3,256623,256623,256626,0,3,3
73280,1,1,256624,256626,256627,2,3,0
73281,4,3,256628,256628,256631,0,3,1
73282,5,2,256633,256633,256635,0,2,2
73283,6,2,256639,256639,256641,0,2,4
73284,3,3,256642,256642,256645,0,3,1
73285,3,1,256645,256645,256646,0,1,0
73286,1,3,256646,256646,256649,0,3,0
73287,3,2,256649,256649,256651,0,2,0
73288,6,2,256655,256655,256657,0,2,4
73289,3,1,256658,256658,256659,0,1,1
73290,6,3,256664,256664,256667,0,3,5
73291,6,3,256670,256670,256673,0,3,3
73292,2,1,256672,256673,256674,1,2,0
73293,5,2,256677,256677,256679,0,2,3
73294,4,2,256681,256681,256683,0,2,2
73295,5,3,256686,256686,256689,0,3,3
73296,1,2,256687,256689,256691,2,4,0
73297,5,1,256692,256692,256693,0,1,1
73298,4,1,256696,256696,256697,0,1,3
73299,6,3,256702,256702,256705,0,3,5
73300,6,2,256708,256708,256710,0,2,3
73301,3,3,256711,256711,256714,0,3,1
73302,3,2,256714,256714,256716,0,2,0
73303,6,3,256720,256720,256723,0,3,4
73304,2,2,256722,256723,256725,1,3,0
73305,4,3,256726,256726,256729,0,3,1
73306,5,1,256731,256731,256732,0,1,2
73307,2,1,256733,256733,256734,0,1,1
73308,2,3,256735,256735,256738,0,3,1
73309,1,1,256736,256738,256739,2,3,0
73310,1,3,256737,256739,256742,2,5,0
73311,5,3,256742,256742,256745,0,3,0
73312,5,2,256747,256747,256749,0,2,2
73313,5,1,256752,256752,256753,0,1,3
73314,6,3,256758,256758,256761,0,3,5
73315,2,2,256760,256761,256763,1,3,0
73316,6,2,256766,256766,256768,0,2,3
73317,3,2,256769,256769,256771,0,2,1
73318,3,2,256772,256772,256774,0,2,1
73319,2,3,256774,256774,256777,0,3,0
73320,3,2,256777,256777,256779,0,2,0
73321,4,3,256781,256781,256784,0,3,2
73322,2,3,256783,256784,256787,1,4,0
73323,1,2,256784,256787,256789,3,5,0
73324,2,1,256786,256789,256790,3,4,0
73325,6,1,256792,256792,256793,0,1,2
73326,4,2,256796,256796,256798,0,2,3
73327,2,2,256798,256798,256800,0,2,0
73328,6,1,256804,256804,256805,0,1,4
73329,1,2,256805,256805,256807,0,2,0
73330,2,3,256807,256807,256810,0,3,0
73331,1,2,256808,256810,256812,2,4,0
73332,2,1,256810,256812,256813,2,3,0
73333,5,1,256815,256815,256816,0,1,2
73334,2,3,256817,256817,256820,0,3,1
73335,1,1,256818,256820,256821,2,3,0
73336,3,1,256821,256821,256822,0,1,0
73337,3,2,256824,256824,256826,0,2,2
73338,5,1,256829,256829,256830,0,1,3
73339,4,1,256833,256833,256834,0,1,3
73340,5,1,256838,256838,256839,0,1,4
73341,6,2,256844,256844,256846,0,2,5
73342,2,2,256846,256846,256848,0,2,0
73343,4,2,256850,256850,256852,0,2,2
73344,3,2,256853,256853,256855,0,2,1
73345,4,1,256857,256857,256858,0,1,2
73346,5,1,256862,256862,256863,0,1,4
73347,1,2,256863,256863,256865,0,2,0
73348,4,1,256867,256867,256868,0,1,2
73349,3,2,256870,256870,256872,0,2,2
73350,3,3,256873,256873,256876,0,3,1
73351,1,2,256874,256876,256878,2,4,0
73352,3,1,256877,256878,256879,1,2,0
73353,3,3,256880,256880,256883,0,3,1
73354,5,3,256885,256885,256888,0,3,2
73355,6,3,256891,256891,256894,0,3,3
73356,3,2,256894,256894,256896,0,2,0
73357,1,2,256895,256896,256898,1,3,0
73358,1,3,256896,256898,256901,2,5,0
73359,1,2,256897,256901,256903,4,6,0
73360,3,2,256900,256903,256905,3,5,0
73361,6,1,256906,256906,256907,0,1,1
73362,5,3,256911,256911,256914,0,3,4
73363,6,1,256917,256917,256918,0,1,3
73364,4,3,256921,256921,256924,0,3,3
73365,5,3,256926,256926,256929,0,3,2
73366,4,3,256930,256930,256933,0,3,1
73367,6,2,256936,256936,256938,0,2,3
73368,5,3,256941,256941,256944,0,3,3
73369,2,3,256943,256944,256947,1,4,0
73370,6,1,256949,256949,256950,0,1,2
73371,2,3,256951,256951,256954,0,3,1
73372,6,2,256957,256957,256959,0,2,3
73373,4,1,256961,256961,256962,0,1,2
73374,3,1,256964,256964,256965,0,1,2
73375,5,3,256969,256969,256972,0,3,4
73376,5,3,256974,256974,256977,0,3,2
73377,3,1,256977,256977,256978,0,1,0
73378,4,2,256981,256981,256983,0,2,3
73379,5,1,256986,256986,256987,0,1,3
73380,1,2,256987,256987,256989,0,2,0
73381,1,3,256988,256989,256992,1,4,0
73382,3,3,256991,256992,256995,1,4,0
73383,3,3,256994,256995,256998,1,4,0
73384,2,3,256996,256998,257001,2,5,0
73385,5,3,257001,257001,257004,0,3,0
73386,5,3,257006,257006,257009,0,3,2
73387,1,2,257007,257009,257011,2,4,0
73388,2,2,257009,257011,257013,2,4,0
73389,2,3,257011,257013,257016,2,5,0
73390,5,2,257016,257016,257018,0,2,0
73391,5,3,257021,257021,257024,0,3,3
73392,6,2,257027,257027,257029,0,2,3
73393,5,3,257032,257032,257035,0,3,3
73394,1,1,257033,257035,257036,2,3,0
73395,5,2,257038,257038,257040,0,2,2
73396,4,2,257042,257042,257044,0,2,2
73397,6,3,257048,257048,257051,0,3,4
73398,2,2,257050,257051,257053,1,3,0
73399,6,1,257056,257056,257057,0,1,3
73400,4,2,257060,257060,257062,0,2,3
73401,1,2,257061,257062,257064,1,3,0
73402,1,2,257062,257064,257066,2,4,0
73403,1,1,257063,257066,257067,3,4,0
73404,5,1,257068,257068,257069,0,1,1
73405,5,3,257073,257073,257076,0,3,4
73406,2,3,257075,257076,257079,1,4,0
73407,2,3,257077,257079,257082,2,5,0
73408,4,2,257081,257082,257084,1,3,0
73409,4,2,257085,257085,257087,0,2,1
73410,2,1,257087,257087,257088,0,1,0
73411,2,2,257089,257089,257091,0,2,1
73412,5,3,257094,257094,257097,0,3,3
73413,2,1,257096,257097,257098,1,2,0
73414,1,3,257097,257098,257101,1,4,0
73415,3,3,257100,257101,257104,1,4,0
73416,2,1,257102,257104,257105,2,3,0
73417,6,3,257108,257108,257111,0,3,3
73418,5,2,257113,257113,257115,0,2,2
73419,4,1,257117,257117,257118,0,1,2
73420,2,2,257119,257119,257121,0,2,1
73421,3,3,257122,257122,257125,0,3,1
73422,6,2,257128,257128,257130,0,2,3
73423,6,2,257134,257134,257136,0,2,4
73424,6,1,257140,257140,257141,0,1,4
73425,4,1,257144,257144,257145,0,1,3
73426,2,3,257146,257146,257149,0,3,1
73427,5,2,257151,257151,257153,0,2,2
73428,5,1,257156,257156,257157,0,1,3
73429,3,3,257159,257159,257162,0,3,2
73430,6,1,257165,257165,257166,0,1,3
73431,5,1,257170,257170,257171,0,1,4
73432,3,1,257173,257173,257174,0,1,2
73433,2,3,257175,257175,257178,0,3,1
73434,2,2,257177,257178,257180,1,3,0
73435,1,1,257178,257180,257181,2,3,0
73436,3,2,257181,257181,257183,0,2,0
73437,4,1,257185,257185,257186,0,1,2
73438,6,2,257191,257191,257193,0,2,5
73439,1,1,257192,257193,257194,1,2,0
73440,5,1,257197,257197,257198,0,1,3
73441,4,1,257201,257201,257202,0,1,3
73442,6,2,257207,257207,257209,0,2,5
73443,2,2,257209,257209,257211,0,2,0
73444,5,1,257214,257214,257215,0,1,3
73445,3,3,257217,257217,257220,0,3,2
73446,3,3,257220,257220,257223,0,3,0
73447,5,1,257225,257225,257226,0,1,2
73448,6,1,257231,257231,257232,0,1,5
73449,2,3,257233,257233,257236,0,3,1
73450,2,2,257235,257236,257238,1,3,0
73451,3,1,257238,257238,257239,0,1,0
73452,5,2,257243,257243,257245,0,2,4
73453,3,2,257246,257246,257248,0,2,1
73454,6,2,257252,257252,257254,0,2,4
73455,2,3,257254,257254,257257,0,3,0
73456,2,3,257256,257257,257260,1,4,0
73457,5,1,257261,257261,257262,0,1,1
73458,1,3,257262,257262,257265,0,3,0
73459,5,1,257267,257267,257268,0,1,2
73460,5,3,257272,257272,257275,0,3,4
73461,5,2,257277,257277,257279,0,2,2
73462,5,2,257282,257282,257284,0,2,3
73463,3,1,257285,257285,257286,0,1,1
73464,6,3,257291,257291,257294,0,3,5
73465,4,2,257295,257295,257297,0,2,1
73466,4,1,257299,257299,257300,0,1,2
73467,5,3,257304,257304,257307,0,3,4
73468,6,1,257310,257310,257311,0,1,3
73469,6,2,257316,257316,257318,0,2,5
73470,1,3,257317,257318,257321,1,4,0
73471,3,3,257320,257321,257324,1,4,0
73472,5,3,257325,257325,257328,0,3,1
73473,3,2,257328,257328,257330,0,2,0
73474,5,2,257333,257333,257335,0,2,3
73475,6,1,257339,257339,257340,0,1,4
73476,2,2,257341,257341,257343,0,2,1
73477,4,3,257345,257345,257348,0,3,2
73478,3,1,257348,257348,257349,0,1,0
73479,6,1,257354,257354,257355,0,1,5
73480,6,1,257360,257360,257361,0,1,5
73481,5,2,257365,257365,257367,0,2,4
73482,1,2,257366,257367,257369,1,3,0
73483,1,1,257367,257369,257370,2,3,0
73484,2,2,257369,257370,257372,1,3,0
73485,2,2,257371,257372,257374,1,3,0
73486,1,2,257372,257374,257376,2,4,0
73487,5,2,257377,257377,257379,0,2,1
73488,6,3,257383,257383,257386,0,3,4
73489,1,2,257384,257386,257388,2,4,0
73490,2,3,257386,257388,257391,2,5,0
73491,1,1,257387,257391,257392,4,5,0
73492,3,3,257390,257392,257395,2,5,0
73493,2,3,257392,257395,257398,3,6,0
73494,3,2,257395,257398,257400,3,5,0
73495,5,1,257400,257400,257401,0,1,0
73496,2,1,257402,257402,257403,0,1,1
73497,3,1,257405,257405,257406,0,1,2
73498,6,3,257411,257411,257414,0,3,5
73499,1,1,257412,257414,257415,2,3,0
73500,1,2,257413,257415,257417,2,4,0
73501,6,1,257419,257419,257420,0,1,2
73502,1,1,257420,257420,257421,0,1,0
73503,4,3,257424,257424,257427,0,3,3
73504,2,3,257426,257427,257430,1,4,0
73505,5,1,257431,257431,257432,0,1,1
73506,3,3,257434,257434,257437,0,3,2
73507,4,2,257438,257438,257440,0,2,1
73508,2,3,257440,257440,257443,0,3,0
73509,1,1,257441,257443,257444,2,3,0
73510,6,1,257447,257447,257448,0,1,3
73511,6,2,257453,257453,257455,0,2,5
73512,4,2,257457,257457,257459,0,2,2
73513,1,3,257458,257459,257462,1,4,0
73514,4,1,257462,257462,257463,0,1,0
73515,2,1,257464,257464,257465,0,1,1
73516,4,3,257468,257468,257471,0,3,3
73517,5,1,257473,257473,257474,0,1,2
73518,5,2,257478,257478,257480,0,2,4
73519,2,2,257480,257480,257482,0,2,0
73520,2,3,257482,257482,257485,0,3,0
73521,1,1,257483,257485,257486,2,3,0
73522,4,1,257487,257487,257488,0,1,1
73523,4,2,257491,257491,257493,0,2,3
73524,6,3,257497,257497,257500,0,3,4
73525,1,3,257498,257500,257503,2,5,0
73526,4,1,257502,257503,257504,1,2,0
73527,2,1,257504,257504,257505,0,1,0
73528,4,2,257508,257508,257510,0,2,3
73529,2,2,257510,257510,257512,0,2,0
73530,5,1,257515,257515,257516,0,1,3
73531,5,1,257520,257520,257521,0,1,4
73532,1,2,257521,257521,257523,0,2,0
73533,4,3,257525,257525,257528,0,3,2
73534,3,1,257528,257528,257529,0,1,0
73535,1,2,257529,257529,257531,0,2,0
73536,5,2,257534,257534,257536,0,2,3
73537,5,2,257539,257539,257541,0,2,3
73538,2,3,257541,257541,257544,0,3,0
73539,5,2,257546,257546,257548,0,2,2
73540,2,2,257548,257548,257550,0,2,0
73541,5,2,257553,257553,257555,0,2,3
73542,3,3,257556,257556,257559,0,3,1
73543,6,2,257562,257562,257564,0,2,3
73544,5,1,257567,257567,257568,0,1,3
73545,4,1,257571,257571,257572,0,1,3
73546,6,1,257577,257577,257578,0,1,5
73547,3,1,257580,257580,257581,0,1,2
73548,4,2,257584,257584,257586,0,2,3
73549,5,2,257589,257589,257591,0,2,3
73550,6,2,257595,257595,257597,0,2,4
73551,5,3,257600,257600,257603,0,3,3
73552,3,3,257603,257603,257606,0,3,0
73553,2,3,257605,257606,257609,1,4,0
73554,4,3,257609,257609,257612,0,3,0
73555,4,3,257613,257613,257616,0,3,1
73556,5,3,257618,257618,257621,0,3,2
73557,2,2,257620,257621,257623,1,3,0
73558,3,1,257623,257623,257624,0,1,0
73559,1,3,257624,257624,257627,0,3,0
73560,6,1,257630,257630,257631,0,1,3
73561,4,3,257634,257634,257637,0,3,3
73562,5,3,257639,257639,257642,0,3,2
73563,2,1,257641,257642,257643,1,2,0
73564,5,1,257646,257646,257647,0,1,3
73565,6,1,257652,257652,257653,0,1,5
73566,1,3,257653,257653,257656,0,3,0
73567,2,3,257655,257656,257659,1,4,0
73568,2,1,257657,257659,257660,2,3,0
73569,5,1,257662,257662,257663,0,1,2
73570,1,2,257663,257663,257665,0,2,0
73571,1,3,257664,257665,257668,1,4,0
73572,4,2,257668,257668,257670,0,2,0
73573,6,1,257674,257674,257675,0,1,4
73574,1,2,257675,257675,257677,0,2,0
73575,2,2,257677,257677,257679,0,2,0
73576,6,1,257683,257683,257684,0,1,4
73577,1,2,257684,257684,257686,0,2,0
73578,1,2,257685,257686,257688,1,3,0
73579,6,3,257691,257691,257694,0,3,3
73580,2,1,257693,257694,257695,1,2,0
73581,1,2,257694,257695,257697,1,3,0
73582,3,2,257697,257697,257699,0,2,0
73583,5,2,257702,257702,257704,0,2,3
73584,6,2,257708,257708,257710,0,2,4
73585,3,3,257711,257711,257714,0,3,1
73586,5,2,257716,257716,257718,0,2,2
73587,3,2,257719,257719,257721,0,2,1
73588,1,3,257720,257721,257724,1,4,0
73589,6,1,257726,257726,257727,0,1,2
73590,4,2,257730,257730,257732,0,2,3
73591,3,1,257733,257733,257734,0,1,1
73592,6,2,257739,257739,257741,0,2,5
73593,5,1,257744,257744,257745,0,1,3
73594,2,3,257746,257746,257749,0,3,1
73595,5,2,257751,257751,257753,0,2,2
73596,4,2,257755,257755,257757,0,2,2
73597,2,1,257757,257757,257758,0,1,0
73598,5,2,257762,257762,257764,0,2,4
73599,5,3,257767,257767,257770,0,3,3
73600,3,3,257770,257770,257773,0,3,0
73601,2,1,257772,257773,257774,1,2,0
73602,4,2,257776,257776,257778,0,2,2
73603,3,1,257779,257779,257780,0,1,1
73604,4,2,257783,257783,257785,0,2,3
73605,2,1,257785,257785,257786,0,1,0
73606,1,3,257786,257786,257789,0,3,0
73607,1,3,257787,257789,257792,2,5,0
73608,2,3,257789,257792,257795,3,6,0
73609,6,2,257795,257795,257797,0,2,0
73610,6,1,257801,257801,257802,0,1,4
73611,4,2,257805,257805,257807,0,2,3
73612,4,2,257809,257809,257811,0,2,2
73613,5,1,257814,257814,257815,0,1,3
73614,2,2,257816,257816,257818,0,2,1
73615,6,3,257822,257822,257825,0,3,4
73616,6,2,257828,257828,257830,0,2,3
73617,4,3,257832,257832,257835,0,3,2
73618,1,3,257833,257835,257838,2,5,0
73619,5,3,257838,257838,257841,0,3,0
73620,1,2,257839,257841,257843,2,4,0
73621,1,2,257840,257843,257845,3,5,0
73622,1,3,257841,257845,257848,4,7,0
73623,6,3,257847,257848,257851,1,4,0
73624,2,3,257849,257851,257854,2,5,0
73625,5,1,257854,257854,257855,0,1,0
73626,5,2,257859,257859,257861,0,2,4
73627,6,3,257865,257865,257868,0,3,4
73628,4,1,257869,257869,257870,0,1,1
73629,1,2,257870,257870,257872,0,2,0
73630,5,3,257875,257875,257878,0,3,3
73631,6,1,257881,257881,257882,0,1,3
73632,5,3,257886,257886,257889,0,3,4
73633,3,2,257889,257889,257891,0,2,0
73634,2,1,257891,257891,257892,0,1,0
73635,2,1,257893,257893,257894,0,1,1
73636,4,1,257897,257897,257898,0,1,3
73637,3,3,257900,257900,257903,0,3,2
73638,5,1,257905,257905,257906,0,1,2
73639,4,3,257909,257909,257912,0,3,3
73640,1,2,257910,257912,257914,2,4,0
73641,5,3,257915,257915,257918,0,3,1
73642,5,1,257920,257920,257921,0,1,2
73643,4,1,257924,257924,257925,0,1,3
73644,2,2,257926,257926,257928,0,2,1
73645,6,1,257932,257932,257933,0,1,4
73646,3,3,257935,257935,257938,0,3,2
73647,1,2,257936,257938,257940,2,4,0
73648,5,3,257941,257941,257944,0,3,1
73649,1,3,257942,257944,257947,2,5,0
73650,1,3,257943,257947,257950,4,7,0
73651,5,1,257948,257950,257951,2,3,0
73652,2,1,257950,257951,257952,1,2,0
73653,6,2,257956,257956,257958,0,2,4
73654,6,1,257962,257962,257963,0,1,4
73655,1,1,257963,257963,257964,0,1,0
73656,5,2,257968,257968,257970,0,2,4
73657,6,2,257974,257974,257976,0,2,4
73658,6,3,257980,257980,257983,0,3,4
73659,6,3,257986,257986,257989,0,3,3
73660,1,3,257987,257989,257992,2,5,0
73661,2,2,257989,257992,257994,3,5,0
73662,2,2,257991,257994,257996,3,5,0
73663,5,3,257996,257996,257999,0,3,0
73664,6,3,258002,258002,258005,0,3,3
73665,1,1,258003,258005,258006,2,3,0
73666,4,1,258007,258007,258008,0,1,1
73667,2,2,258009,258009,258011,0,2,1
73668,2,3,258011,258011,258014,0,3,0
73669,1,2,258012,258014,258016,2,4,0
73670,3,2,258015,258016,258018,1,3,0
73671,5,3,258020,258020,258023,0,3,2
73672,5,2,258025,258025,258027,0,2,2
73673,6,1,258031,258031,258032,0,1,4
73674,2,2,258033,258033,258035,0,2,1
73675,1,1,258034,258035,258036,1,2,0
73676,3,3,258037,258037,258040,0,3,1
73677,5,2,258042,258042,258044,0,2,2
73678,5,2,258047,258047,258049,0,2,3
73679,1,2,258048,258049,258051,1,3,0
73680,6,1,258054,258054,258055,0,1,3
73681,5,2,258059,258059,258061,0,2,4
73682,1,2,258060,258061,258063,1,3,0
73683,5,1,258065,258065,258066,0,1,2
73684,2,1,258067,258067,258068,0,1,1
73685,3,1,258070,258070,258071,0,1,2
73686,2,1,258072,258072,258073,0,1,1
73687,6,2,258078,258078,258080,0,2,5
73688,5,1,258083,258083,258084,0,1,3
73689,2,2,258085,258085,258087,0,2,1
73690,2,3,258087,258087,258090,0,3,0
73691,6,1,258093,258093,258094,0,1,3
73692,6,2,258099,258099,258101,0,2,5
73693,2,3,258101,258101,258104,0,3,0
73694,3,3,258104,258104,258107,0,3,0
73695,3,3,258107,258107,258110,0,3,0
73696,6,3,258113,258113,258116,0,3,3
73697,2,2,258115,258116,258118,1,3,0
73698,2,1,258117,258118,258119,1,2,0
73699,5,1,258122,258122,258123,0,1,3
73700,4,1,258126,258126,258127,0,1,3
73701,6,1,258132,258132,258133,0,1,5
73702,3,2,258135,258135,258137,0,2,2
73703,3,3,258138,258138,258141,0,3,1
73704,5,1,258143,258143,258144,0,1,2
73705,2,3,258145,258145,258148,0,3,1
73706,6,1,258151,258151,258152,0,1,3
73707,6,3,258157,258157,258160,0,3,5
73708,3,3,258160,258160,258163,0,3,0
73709,6,1,258166,258166,258167,0,1,3
73710,2,1,258168,258168,258169,0,1,1
73711,1,3,258169,258169,258172,0,3,0
73712,3,3,258172,258172,258175,0,3,0
73713,1,2,258173,258175,258177,2,4,0
73714,5,1,258178,258178,258179,0,1,1
73715,6,2,258184,258184,258186,0,2,5
73716,1,2,258185,258186,258188,1,3,0
73717,3,3,258188,258188,258191,0,3,0
73718,3,1,258191,258191,258192,0,1,0
73719,6,2,258197,258197,258199,0,2,5
73720,1,1,258198,258199,258200,1,2,0
73721,2,2,258200,258200,258202,0,2,0
73722,1,2,258201,258202,258204,1,3,0
73723,4,1,258205,258205,258206,0,1,1
73724,1,3,258206,258206,258209,0,3,0
73725,4,3,258210,258210,258213,0,3,1
73726,4,3,258214,258214,258217,0,3,1
73727,6,2,258220,258220,258222,0,2,3
73728,5,1,258225,258225,258226,0,1,3
73729,6,1,258231,258231,258232,0,1,5
73730,4,1,258235,258235,258236,0,1,3
73731,4,1,258239,258239,258240,0,1,3
73732,1,3,258240,258240,258243,0,3,0
73733,6,2,258246,258246,258248,0,2,3
73734,5,1,258251,258251,258252,0,1,3
73735,6,1,258257,258257,258258,0,1,5
73736,2,2,258259,258259,258261,0,2,1
73737,6,2,258265,258265,258267,0,2,4
73738,5,3,258270,258270,258273,0,3,3
73739,4,3,258274,258274,258277,0,3,1
73740,4,2,258278,258278,258280,0,2,1
73741,3,1,258281,258281,258282,0,1,1
73742,5,2,258286,258286,258288,0,2,4
73743,5,2,258291,258291,258293,0,2,3
73744,6,1,258297,258297,258298,0,1,4
73745,3,1,258300,258300,258301,0,1,2
73746,6,1,258306,258306,258307,0,1,5
73747,5,1,258311,258311,258312,0,1,4
73748,4,3,258315,258315,258318,0,3,3
73749,5,2,258320,258320,258322,0,2,2
73750,5,3,258325,258325,258328,0,3,3
73751,1,1,258326,258328,258329,2,3,0
73752,4,1,258330,258330,258331,0,1,1
73753,1,2,258331,258331,258333,0,2,0
73754,4,3,258335,258335,258338,0,3,2
73755,4,2,258339,258339,258341,0,2,1
73756,4,1,258343,258343,258344,0,1,2
73757,4,1,258347,258347,258348,0,1,3
73758,6,3,258353,258353,258356,0,3,5
73759,2,3,258355,258356,258359,1,4,0
73760,3,1,258358,258359,258360,1,2,0
73761,1,1,258359,258360,258361,1,2,0
73762,2,3,258361,258361,258364,0,3,0
73763,4,1,258365,258365,258366,0,1,1
73764,2,2,258367,258367,258369,0,2,1
73765,2,1,258369,258369,258370,0,1,0
73766,6,1,258375,258375,258376,0,1,5
73767,1,2,258376,258376,258378,0,2,0
73768,4,1,258380,258380,258381,0,1,2
73769,5,1,258385,258385,258386,0,1,4
73770,2,2,258387,258387,258389,0,2,1
73771,4,1,258391,258391,258392,0,1,2
73772,6,3,258397,258397,258400,0,3,5
73773,5,1,258402,258402,258403,0,1,2
73774,2,1,258404,258404,258405,0,1,1
73775,3,3,258407,258407,258410,0,3,2
73776,3,1,258410,258410,258411,0,1,0
73777,2,3,258412,258412,258415,0,3,1
73778,2,1,258414,258415,258416,1,2,0
73779,5,3,258419,258419,258422,0,3,3
73780,5,3,258424,258424,258427,0,3,2
73781,3,3,258427,258427,258430,0,3,0
73782,5,1,258432,258432,258433,0,1,2
73783,2,3,258434,258434,258437,0,3,1
73784,4,3,258438,258438,258441,0,3,1
73785,3,1,258441,258441,258442,0,1,0
73786,3,2,258444,258444,258446,0,2,2
73787,5,2,258449,258449,258451,0,2,3
73788,5,1,258454,258454,258455,0,1,3
73789,5,1,258459,258459,258460,0,1,4
73790,3,1,258462,258462,258463,0,1,2
73791,6,2,258468,258468,258470,0,2,5
73792,4,1,258472,258472,258473,0,1,2
73793,3,3,258475,258475,258478,0,3,2
73794,6,1,258481,258481,258482,0,1,3
73795,6,2,258487,258487,258489,0,2,5
73796,3,2,258490,258490,258492,0,2,1
73797,4,1,258494,258494,258495,0,1,2
73798,4,3,258498,258498,258501,0,3,3
73799,5,2,258503,258503,258505,0,2,2
73800,4,3,258507,258507,258510,0,3,2
73801,1,1,258508,258510,258511,2,3,0
73802,1,1,258509,258511,258512,2,3,0
73803,2,3,258511,258512,258515,1,4,0
73804,6,2,258517,258517,258519,0,2,2
73805,1,1,258518,258519,258520,1,2,0
73806,5,3,258523,258523,258526,0,3,3
73807,6,1,258529,258529,258530,0,1,3
73808,6,1,258535,258535,258536,0,1,5
73809,5,3,258540,258540,258543,0,3,4
73810,6,1,258546,258546,258547,0,1,3
73811,4,2,258550,258550,258552,0,2,3
73812,2,1,258552,258552,258553,0,1,0
73813,6,3,258558,258558,258561,0,3,5
73814,1,3,258559,258561,258564,2,5,0
73815,5,1,258564,258564,258565,0,1,0
73816,2,1,258566,258566,258567,0,1,1
73817,3,1,258569,258569,258570,0,1,2
73818,3,2,258572,258572,258574,0,2,2
73819,3,2,258575,258575,258577,0,2,1
73820,1,1,258576,258577,258578,1,2,0
73821,6,2,258582,258582,258584,0,2,4
73822,2,2,258584,258584,258586,0,2,0
73823,1,2,258585,258586,258588,1,3,0
73824,4,3,258589,258589,258592,0,3,1
73825,2,1,258591,258592,258593,1,2,0
73826,1,2,258592,258593,258595,1,3,0
73827,3,3,258595,258595,258598,0,3,0
73828,1,1,258596,258598,258599,2,3,0
73829,4,3,258600,258600,258603,0,3,1
73830,6,3,258606,258606,258609,0,3,3
73831,5,1,258611,258611,258612,0,1,2
73832,4,3,258615,258615,258618,0,3,3
73833,1,1,258616,258618,258619,2,3,0
73834,2,3,258618,258619,258622,1,4,0
73835,6,1,258624,258624,258625,0,1,2
73836,5,3,258629,258629,258632,0,3,4
73837,4,1,258633,258633,258634,0,1,1
73838,2,1,258635,258635,258636,0,1,1
73839,4,1,258639,258639,258640,0,1,3
73840,3,2,258642,258642,258644,0,2,2
73841,3,1,258645,258645,258646,0,1,1
73842,1,3,258646,258646,258649,0,3,0
73843,4,3,258650,258650,258653,0,3,1
73844,2,2,258652,258653,258655,1,3,0
73845,5,3,258657,258657,258660,0,3,2
73846,6,2,258663,258663,258665,0,2,3
73847,3,3,258666,258666,258669,0,3,1
73848,6,3,258672,258672,258675,0,3,3
73849,5,2,258677,258677,258679,0,2,2
73850,2,3,258679,258679,258682,0,3,0
73851,3,2,258682,258682,258684,0,2,0
73852,5,2,258687,258687,258689,0,2,3
73853,3,1,258690,258690,258691,0,1,1
73854,3,2,258693,258693,258695,0,2,2
73855,4,3,258697,258697,258700,0,3,2
73856,6,2,258703,258703,258705,0,2,3
73857,5,2,258708,258708,258710,0,2,3
73858,6,3,258714,258714,258717,0,3,4
73859,4,1,258718,258718,258719,0,1,1
73860,4,3,258722,258722,258725,0,3,3
73861,3,3,258725,258725,258728,0,3,0
73862,5,1,258730,258730,258731,0,1,2
73863,1,3,258731,258731,258734,0,3,0
73864,1,1,258732,258734,258735,2,3,0
73865,1,3,258733,258735,258738,2,5,0
73866,4,2,258737,258738,258740,1,3,0
73867,4,1,258741,258741,258742,0,1,1
73868,3,1,258744,258744,258745,0,1,2
73869,2,2,258746,258746,258748,0,2,1
73870,2,1,258748,258748,258749,0,1,0
73871,2,2,258750,258750,258752,0,2,1
73872,2,3,258752,258752,258755,0,3,0
73873,5,1,258757,258757,258758,0,1,2
73874,4,1,258761,258761,258762,0,1,3
73875,4,3,258765,258765,258768,0,3,3
73876,4,3,258769,258769,258772,0,3,1
73877,1,2,258770,258772,258774,2,4,0
73878,4,3,258774,258774,258777,0,3,0
73879,4,2,258778,258778,258780,0,2,1
73880,2,1,258780,258780,258781,0,1,0
73881,1,1,258781,258781,258782,0,1,0
73882,5,2,258786,258786,258788,0,2,4
73883,3,3,258789,258789,258792,0,3,1
73884,2,2,258791,258792,258794,1,3,0
73885,2,3,258793,258794,258797,1,4,0
73886,3,3,258796,258797,258800,1,4,0
73887,5,1,258801,258801,258802,0,1,1
73888,2,1,258803,258803,258804,0,1,1
73889,2,2,258805,258805,258807,0,2,1
73890,5,2,258810,258810,258812,0,2,3
73891,4,3,258814,258814,258817,0,3,2
73892,2,3,258816,258817,258820,1,4,0
73893,5,1,258821,258821,258822,0,1,1
73894,4,1,258825,258825,258826,0,1,3
73895,1,3,258826,258826,258829,0,3,0
73896,6,3,258832,258832,258835,0,3,3
73897,4,3,258836,258836,258839,0,3,1
73898,3,2,258839,258839,258841,0,2,0
73899,3,1,258842,258842,258843,0,1,1
73900,2,1,258844,258844,258845,0,1,1
73901,3,3,258847,258847,258850,0,3,2
73902,6,3,258853,258853,258856,0,3,3
73903,5,1,258858,258858,258859,0,1,2
73904,6,3,258864,258864,258867,0,3,5
73905,5,3,258869,258869,258872,0,3,2
73906,1,2,258870,258872,258874,2,4,0
73907,3,3,258873,258874,258877,1,4,0
73908,6,3,258879,258879,258882,0,3,2
73909,6,3,258885,258885,258888,0,3,3
73910,3,2,258888,258888,258890,0,2,0
73911,5,3,258893,258893,258896,0,3,3
73912,2,1,258895,258896,258897,1,2,0
73913,4,2,258899,258899,258901,0,2,2
73914,4,1,258903,258903,258904,0,1,2
73915,2,3,258905,258905,258908,0,3,1
73916,4,1,258909,258909,258910,0,1,1
73917,1,3,258910,258910,258913,0,3,0
73918,5,2,258915,258915,258917,0,2,2
73919,3,3,258918,258918,258921,0,3,1
73920,2,2,258920,258921,258923,1,3,0
73921,4,2,258924,258924,258926,0,2,1
73922,3,3,258927,258927,258930,0,3,1
73923,4,1,258931,258931,258932,0,1,1
73924,3,2,258934,258934,258936,0,2,2
73925,3,1,258937,258937,258938,0,1,1
73926,3,1,258940,258940,258941,0,1,2
73927,5,2,258945,258945,258947,0,2,4
73928,3,1,258948,258948,258949,0,1,1
73929,1,1,258949,258949,258950,0,1,0
73930,3,2,258952,258952,258954,0,2,2
73931,6,1,258958,258958,258959,0,1,4
73932,1,1,258959,258959,258960,0,1,0
73933,3,3,258962,258962,258965,0,3,2
73934,1,2,258963,258965,258967,2,4,0
73935,5,1,258968,258968,258969,0,1,1
73936,1,3,258969,258969,258972,0,3,0
73937,4,3,258973,258973,258976,0,3,1
73938,5,3,258978,258978,258981,0,3,2
73939,6,1,258984,258984,258985,0,1,3
73940,5,3,258989,258989,258992,0,3,4
73941,1,1,258990,258992,258993,2,3,0
73942,6,3,258996,258996,258999,0,3,3
73943,3,2,258999,258999,259001,0,2,0
73944,1,2,259000,259001,259003,1,3,0
73945,6,3,259006,259006,259009,0,3,3
73946,2,2,259008,259009,259011,1,3,0
73947,1,3,259009,259011,259014,2,5,0
73948,6,1,259015,259015,259016,0,1,1
73949,1,1,259016,259016,259017,0,1,0
73950,5,1,259021,259021,259022,0,1,4
73951,6,3,259027,259027,259030,0,3,5
73952,6,2,259033,259033,259035,0,2,3
73953,2,1,259035,259035,259036,0,1,0
73954,4,1,259039,259039,259040,0,1,3
73955,5,1,259044,259044,259045,0,1,4
73956,3,1,259047,259047,259048,0,1,2
73957,4,1,259051,259051,259052,0,1,3
73958,6,2,259057,259057,259059,0,2,5
73959,5,2,259062,259062,259064,0,2,3
73960,1,3,259063,259064,259067,1,4,0
73961,2,3,259065,259067,259070,2,5,0
73962,2,1,259067,259070,259071,3,4,0
73963,5,1,259072,259072,259073,0,1,1
73964,2,2,259074,259074,259076,0,2,1
73965,6,3,259080,259080,259083,0,3,4
73966,2,3,259082,259083,259086,1,4,0
73967,2,1,259084,259086,259087,2,3,0
73968,2,2,259086,259087,259089,1,3,0
73969,5,2,259091,259091,259093,0,2,2
73970,2,3,259093,259093,259096,0,3,0
73971,5,1,259098,259098,259099,0,1,2
73972,1,3,259099,259099,259102,0,3,0
73973,1,3,259100,259102,259105,2,5,0
73974,1,2,259101,259105,259107,4,6,0
73975,1,2,259102,259107,259109,5,7,0
73976,3,3,259105,259109,259112,4,7,0
73977,1,2,259106,259112,259114,6,8,0
73978,4,3,259110,259114,259117,4,7,0
73979,2,1,259112,259117,259118,5,6,0
73980,6,2,259118,259118,259120,0,2,0
73981,1,2,259119,259120,259122,1,3,0
73982,1,1,259120,259122,259123,2,3,0
73983,4,2,259124,259124,259126,0,2,1
73984,3,2,259127,259127,259129,0,2,1
73985,1,2,259128,259129,259131,1,3,0
73986,4,2,259132,259132,259134,0,2,1
73987,6,3,259138,259138,259141,0,3,4
73988,5,1,259143,259143,259144,0,1,2
73989,1,3,259144,259144,259147,0,3,0
73990,3,2,259147,259147,259149,0,2,0
73991,5,3,259152,259152,259155,0,3,3
73992,5,3,259157,259157,259160,0,3,2
73993,1,1,259158,259160,259161,2,3,0
73994,4,1,259162,259162,259163,0,1,1
73995,1,1,259163,259163,259164,0,1,0
73996,4,3,259167,259167,259170,0,3,3
73997,1,2,259168,259170,259172,2,4,0
73998,3,2,259171,259172,259174,1,3,0
73999,5,3,259176,259176,259179,0,3,2
74000,5,3,259181,259181,259184,0,3,2
74001,6,2,259187,259187,259189,0,2,3
74002,5,3,259192,259192,259195,0,3,3
74003,4,3,259196,259196,259199,0,3,1
74004,1,2,259197,259199,259201,2,4,0
74005,2,1,259199,259201,259202,2,3,0
74006,6,1,259205,259205,259206,0,1,3
74007,2,3,259207,259207,259210,0,3,1
74008,2,1,259209,259210,259211,1,2,0
74009,1,3,259210,259211,259214,1,4,0
74010,1,1,259211,259214,259215,3,4,0
74011,5,2,259216,259216,259218,0,2,1
74012,5,3,259221,259221,259224,0,3,3
74013,5,1,259226,259226,259227,0,1,2
74014,5,1,259231,259231,259232,0,1,4
74015,1,1,259232,259232,259233,0,1,0
74016,4,3,259236,259236,259239,0,3,3
74017,4,2,259240,259240,259242,0,2,1
74018,6,1,259246,259246,259247,0,1,4
74019,2,3,259248,259248,259251,0,3,1
74020,4,3,259252,259252,259255,0,3,1
74021,6,1,259258,259258,259259,0,1,3
74022,3,2,259261,259261,259263,0,2,2
74023,4,2,259265,259265,259267,0,2,2
74024,6,1,259271,259271,259272,0,1,4
74025,2,2,259273,259273,259275,0,2,1
74026,1,2,259274,259275,259277,1,3,0
74027,5,2,259279,259279,259281,0,2,2
74028,1,1,259280,259281,259282,1,2,0
74029,6,3,259286,259286,259289,0,3,4
74030,1,3,259287,259289,259292,2,5,0
74031,3,3,259290,259292,259295,2,5,0
74032,1,2,259291,259295,259297,4,6,0
74033,6,1,259297,259297,259298,0,1,0
74034,4,1,259301,259301,259302,0,1,3
74035,1,2,259302,259302,259304,0,2,0
74036,3,1,259305,259305,259306,0,1,1
74037,5,1,259310,259310,259311,0,1,4
74038,2,2,259312,259312,259314,0,2,1
74039,1,3,259313,259314,259317,1,4,0
74040,1,1,259314,259317,259318,3,4,0
74041,2,1,259316,259318,259319,2,3,0
74042,2,1,259318,259319,259320,1,2,0
74043,2,2,259320,259320,259322,0,2,0
74044,4,1,259324,259324,259325,0,1,2
74045,4,2,259328,259328,259330,0,2,3
74046,6,3,259334,259334,259337,0,3,4
74047,1,3,259335,259337,259340,2,5,0
74048,6,1,259341,259341,259342,0,1,1
74049,5,3,259346,259346,259349,0,3,4
74050,2,1,259348,259349,259350,1,2,0
74051,5,3,259353,259353,259356,0,3,3
74052,2,3,259355,259356,259359,1,4,0
74053,5,3,259360,259360,259363,0,3,1
74054,5,1,259365,259365,259366,0,1,2
74055,6,1,259371,259371,259372,0,1,5
74056,1,1,259372,259372,259373,0,1,0
74057,4,1,259376,259376,259377,0,1,3
74058,4,3,259380,259380,259383,0,3,3
74059,1,2,259381,259383,259385,2,4,0
74060,2,3,259383,259385,259388,2,5,0
74061,5,3,259388,259388,259391,0,3,0
74062,2,2,259390,259391,259393,1,3,0
74063,5,2,259395,259395,259397,0,2,2
74064,2,1,259397,259397,259398,0,1,0
74065,1,1,259398,259398,259399,0,1,0
74066,3,1,259401,259401,259402,0,1,2
74067,3,2,259404,259404,259406,0,2,2
74068,6,2,259410,259410,259412,0,2,4
74069,3,1,259413,259413,259414,0,1,1
74070,6,1,259419,259419,259420,0,1,5
74071,2,3,259421,259421,259424,0,3,1
74072,6,3,259427,259427,259430,0,3,3
74073,6,3,259433,259433,259436,0,3,3
74074,5,3,259438,259438,259441,0,3,2
74075,4,3,259442,259442,259445,0,3,1
74076,1,2,259443,259445,259447,2,4,0
74077,3,1,259446,259447,259448,1,2,0
74078,2,3,259448,259448,259451,0,3,0
74079,6,2,259454,259454,259456,0,2,3
74080,4,2,259458,259458,259460,0,2,2
74081,3,3,259461,259461,259464,0,3,1
74082,4,3,259465,259465,259468,0,3,1
74083,4,2,259469,259469,259471,0,2,1
74084,6,3,259475,259475,259478,0,3,4
74085,2,1,259477,259478,259479,1,2,0
74086,3,1,259480,259480,259481,0,1,1
74087,1,1,259481,259481,259482,0,1,0
74088,2,1,259483,259483,259484,0,1,1
74089,3,3,259486,259486,259489,0,3,2
74090,5,2,259491,259491,259493,0,2,2
74091,5,1,259496,259496,259497,0,1,3
74092,3,2,259499,259499,259501,0,2,2
74093,2,2,259501,259501,259503,0,2,0
74094,2,1,259503,259503,259504,0,1,0
74095,4,1,259507,259507,259508,0,1,3
74096,3,3,259510,259510,259513,0,3,2
74097,6,3,259516,259516,259519,0,3,3
74098,3,3,259519,259519,259522,0,3,0
74099,4,1,259523,259523,259524,0,1,1
74100,1,3,259524,259524,259527,0,3,0
74101,1,3,259525,259527,259530,2,5,0
74102,6,2,259531,259531,259533,0,2,1
74103,2,1,259533,259533,259534,0,1,0
74104,3,2,259536,259536,259538,0,2,2
74105,1,1,259537,259538,259539,1,2,0
74106,1,2,259538,259539,259541,1,3,0
74107,6,1,259544,259544,259545,0,1,3
74108,3,1,259547,259547,259548,0,1,2
74109,4,3,259551,259551,259554,0,3,3
74110,1,2,259552,259554,259556,2,4,0
74111,3,1,259555,259556,259557,1,2,0
74112,3,3,259558,259558,259561,0,3,1
74113,1,3,259559,259561,259564,2,5,0
74114,3,1,259562,259564,259565,2,3,0
74115,6,1,259568,259568,259569,0,1,3
74116,2,2,259570,259570,259572,0,2,1
74117,3,1,259573,259573,259574,0,1,1
74118,3,1,259576,259576,259577,0,1,2
74119,5,2,259581,259581,259583,0,2,4
74120,3,3,259584,259584,259587,0,3,1
74121,2,2,259586,259587,259589,1,3,0
74122,2,2,259588,259589,259591,1,3,0
74123,2,3,259590,259591,259594,1,4,0
74124,5,1,259595,259595,259596,0,1,1
74125,1,2,259596,259596,259598,0,2,0
74126,2,1,259598,259598,259599,0,1,0
74127,6,3,259604,259604,259607,0,3,5
74128,5,2,259609,259609,259611,0,2,2
74129,3,3,259612,259612,259615,0,3,1
74130,1,3,259613,259615,259618,2,5,0
74131,5,1,259618,259618,259619,0,1,0
74132,3,3,259621,259621,259624,0,3,2
74133,4,3,259625,259625,259628,0,3,1
74134,6,1,259631,259631,259632,0,1,3
74135,3,2,259634,259634,259636,0,2,2
74136,1,3,259635,259636,259639,1,4,0
74137,2,3,259637,259639,259642,2,5,0
74138,4,1,259641,259642,259643,1,2,0
74139,4,2,259645,259645,259647,0,2,2
74140,1,1,259646,259647,259648,1,2,0
74141,5,3,259651,259651,259654,0,3,3
74142,4,2,259655,259655,259657,0,2,1
74143,1,2,259656,259657,259659,1,3,0
74144,2,2,259658,259659,259661,1,3,0
74145,1,3,259659,259661,259664,2,5,0
74146,3,3,259662,259664,259667,2,5,0
74147,6,1,259668,259668,259669,0,1,1
74148,2,1,259670,259670,259671,0,1,1
74149,4,1,259674,259674,259675,0,1,3
74150,6,1,259680,259680,259681,0,1,5
74151,6,1,259686,259686,259687,0,1,5
74152,3,1,259689,259689,259690,0,1,2
74153,4,1,259693,259693,259694,0,1,3
74154,1,1,259694,259694,259695,0,1,0
74155,4,1,259698,259698,259699,0,1,3
74156,2,3,259700,259700,259703,0,3,1
74157,4,1,259704,259704,259705,0,1,1
74158,6,2,259710,259710,259712,0,2,5
74159,6,1,259716,259716,259717,0,1,4
74160,2,1,259718,259718,259719,0,1,1
74161,1,1,259719,259719,259720,0,1,0
74162,3,2,259722,259722,259724,0,2,2
74163,6,1,259728,259728,259729,0,1,4
74164,4,3,259732,259732,259735,0,3,3
74165,1,3,259733,259735,259738,2,5,0
74166,3,1,259736,259738,259739,2,3,0
74167,5,3,259741,259741,259744,0,3,2
74168,3,2,259744,259744,259746,0,2,0
74169,5,3,259749,259749,259752,0,3,3
74170,3,1,259752,259752,259753,0,1,0
74171,5,1,259757,259757,259758,0,1,4
74172,3,2,259760,259760,259762,0,2,2
74173,1,3,259761,259762,259765,1,4,0
74174,1,1,259762,259765,259766,3,4,0
74175,6,3,259768,259768,259771,0,3,2
74176,5,3,259773,259773,259776,0,3,2
74177,2,2,259775,259776,259778,1,3,0
74178,3,2,259778,259778,259780,0,2,0
74179,5,3,259783,259783,259786,0,3,3
74180,1,3,259784,259786,259789,2,5,0
74181,4,1,259788,259789,259790,1,2,0
74182,2,1,259790,259790,259791,0,1,0
74183,2,3,259792,259792,259795,0,3,1
74184,4,1,259796,259796,259797,0,1,1
74185,1,1,259797,259797,259798,0,1,0
74186,6,2,259803,259803,259805,0,2,5
74187,6,3,259809,259809,259812,0,3,4
74188,4,1,259813,259813,259814,0,1,1
74189,6,2,259819,259819,259821,0,2,5
74190,3,2,259822,259822,259824,0,2,1
74191,2,1,259824,259824,259825,0,1,0
74192,3,3,259827,259827,259830,0,3,2
74193,3,1,259830,259830,259831,0,1,0
74194,1,1,259831,259831,259832,0,1,0
74195,2,3,259833,259833,259836,0,3,1
74196,6,1,259839,259839,259840,0,1,3
74197,6,1,259845,259845,259846,0,1,5
74198,6,3,259851,259851,259854,0,3,5
74199,4,3,259855,259855,259858,0,3,1
74200,4,1,259859,259859,259860,0,1,1
74201,2,3,259861,259861,259864,0,3,1
74202,2,3,259863,259864,259867,1,4,0
74203,1,1,259864,259867,259868,3,4,0
74204,2,2,259866,259868,259870,2,4,0
74205,2,1,259868,259870,259871,2,3,0
74206,4,2,259872,259872,259874,0,2,1
74207,4,3,259876,259876,259879,0,3,2
74208,2,2,259878,259879,259881,1,3,0
74209,3,1,259881,259881,259882,0,1,0
74210,3,3,259884,259884,259887,0,3,2
74211,4,1,259888,259888,259889,0,1,1
74212,5,3,259893,259893,259896,0,3,4
74213,4,2,259897,259897,259899,0,2,1
74214,1,3,259898,259899,259902,1,4,0
74215,4,2,259902,259902,259904,0,2,0
74216,5,1,259907,259907,259908,0,1,3
74217,1,1,259908,259908,259909,0,1,0
74218,3,3,259911,259911,259914,0,3,2
74219,6,2,259917,259917,259919,0,2,3
74220,3,2,259920,259920,259922,0,2,1
74221,5,2,259925,259925,259927,0,2,3
74222,5,2,259930,259930,259932,0,2,3
74223,2,1,259932,259932,259933,0,1,0
74224,6,1,259938,259938,259939,0,1,5
74225,4,2,259942,259942,259944,0,2,3
74226,4,1,259946,259946,259947,0,1,2
74227,5,1,259951,259951,259952,0,1,4
74228,3,1,259954,259954,259955,0,1,2
74229,1,1,259955,259955,259956,0,1,0
74230,5,2,259960,259960,259962,0,2,4
74231,4,3,259964,259964,259967,0,3,2
74232,2,3,259966,259967,259970,1,4,0
74233,6,3,259972,259972,259975,0,3,2
74234,1,3,259973,259975,259978,2,5,0
74235,2,1,259975,259978,259979,3,4,0
74236,3,1,259978,259979,259980,1,2,0
74237,4,3,259982,259982,259985,0,3,2
74238,6,2,259988,259988,259990,0,2,3
74239,3,2,259991,259991,259993,0,2,1
74240,3,1,259994,259994,259995,0,1,1
74241,6,2,260000,260000,260002,0,2,5
74242,4,3,260004,260004,260007,0,3,2
74243,4,3,260008,260008,260011,0,3,1
74244,4,2,260012,260012,260014,0,2,1
74245,1,1,260013,260014,260015,1,2,0
74246,6,3,260019,260019,260022,0,3,4
74247,4,1,260023,260023,260024,0,1,1
74248,3,1,260026,260026,260027,0,1,2
74249,6,3,260032,260032,260035,0,3,5
74250,4,2,260036,260036,260038,0,2,1
74251,3,3,260039,260039,260042,0,3,1
74252,2,2,260041,260042,260044,1,3,0
74253,5,2,260046,260046,260048,0,2,2
74254,6,3,260052,260052,260055,0,3,4
74255,3,2,260055,260055,260057,0,2,0
74256,4,1,260059,260059,260060,0,1,2
74257,4,1,260063,260063,260064,0,1,3
74258,3,1,260066,260066,260067,0,1,2
74259,5,2,260071,260071,260073,0,2,4
74260,4,3,260075,260075,260078,0,3,2
74261,1,3,260076,260078,260081,2,5,0
74262,3,1,260079,260081,260082,2,3,0
74263,1,2,260080,260082,260084,2,4,0
74264,1,3,260081,260084,260087,3,6,0
74265,3,3,260084,260087,260090,3,6,0
74266,1,2,260085,260090,260092,5,7,0
74267,2,1,260087,260092,260093,5,6,0
74268,6,3,260093,260093,260096,0,3,0
74269,4,3,260097,260097,260100,0,3,1
74270,2,1,260099,260100,260101,1,2,0
74271,1,1,260100,260101,260102,1,2,0
74272,5,3,260105,260105,260108,0,3,3
74273,2,1,260107,260108,260109,1,2,0
74274,1,1,260108,260109,260110,1,2,0
74275,3,2,260111,260111,260113,0,2,1
74276,6,3,260117,260117,260120,0,3,4
74277,2,1,260119,260120,260121,1,2,0
74278,6,2,260125,260125,260127,0,2,4
74279,6,3,260131,260131,260134,0,3,4
74280,4,1,260135,260135,260136,0,1,1
74281,2,3,260137,260137,260140,0,3,1
74282,1,2,260138,260140,260142,2,4,0
74283,2,1,260140,260142,260143,2,3,0
74284,4,2,260144,260144,260146,0,2,1
74285,2,1,260146,260146,260147,0,1,0
74286,6,3,260152,260152,260155,0,3,5
74287,5,2,260157,260157,260159,0,2,2
74288,4,1,260161,260161,260162,0,1,2
74289,2,1,260163,260163,260164,0,1,1
74290,5,1,260168,260168,260169,0,1,4
74291,5,2,260173,260173,260175,0,2,4
74292,1,2,260174,260175,260177,1,3,0
74293,4,1,260178,260178,260179,0,1,1
74294,2,2,260180,260180,260182,0,2,1
74295,4,1,260184,260184,260185,0,1,2
74296,3,1,260187,260187,260188,0,1,2
74297,1,2,260188,260188,260190,0,2,0
74298,2,2,260190,260190,260192,0,2,0
74299,5,2,260195,260195,260197,0,2,3
74300,4,2,260199,260199,260201,0,2,2
74301,4,2,260203,260203,260205,0,2,2
74302,2,1,260205,260205,260206,0,1,0
74303,1,1,260206,260206,260207,0,1,0
74304,3,3,260209,260209,260212,0,3,2
74305,6,1,260215,260215,260216,0,1,3
74306,1,3,260216,260216,260219,0,3,0
74307,2,2,260218,260219,260221,1,3,0
74308,6,1,260224,260224,260225,0,1,3
74309,6,3,260230,260230,260233,0,3,5
74310,5,3,260235,260235,260238,0,3,2
74311,3,2,260238,260238,260240,0,2,0
74312,3,2,260241,260241,260243,0,2,1
74313,1,2,260242,260243,260245,1,3,0
74314,4,3,260246,260246,260249,0,3,1
74315,6,3,260252,260252,260255,0,3,3
74316,2,1,260254,260255,260256,1,2,0
74317,6,3,260260,260260,260263,0,3,4
74318,5,2,260265,260265,260267,0,2,2
74319,2,3,260267,260267,260270,0,3,0
74320,3,2,260270,260270,260272,0,2,0
74321,3,2,260273,260273,260275,0,2,1
74322,1,3,260274,260275,260278,1,4,0
74323,5,1,260279,260279,260280,0,1,1
74324,6,3,260285,260285,260288,0,3,5
74325,1,2,260286,260288,260290,2,4,0
74326,5,3,260291,260291,260294,0,3,1
74327,5,1,260296,260296,260297,0,1,2
74328,1,2,260297,260297,260299,0,2,0
74329,3,2,260300,260300,260302,0,2,1
74330,4,3,260304,260304,260307,0,3,2
74331,6,1,260310,260310,260311,0,1,3
74332,4,2,260314,260314,260316,0,2,3
74333,2,1,260316,260316,260317,0,1,0
74334,2,2,260318,260318,260320,0,2,1
74335,1,2,260319,260320,260322,1,3,0
74336,1,1,260320,260322,260323,2,3,0
74337,2,1,260322,260323,260324,1,2,0
74338,1,3,260323,260324,260327,1,4,0
74339,2,1,260325,260327,260328,2,3,0
74340,2,3,260327,260328,260331,1,4,0
74341,3,3,260330,260331,260334,1,4,0
74342,4,2,260334,260334,260336,0,2,0
74343,2,1,260336,260336,260337,0,1,0
74344,5,2,260341,260341,260343,0,2,4
74345,4,1,260345,260345,260346,0,1,2
74346,1,2,260346,260346,260348,0,2,0
74347,1,1,260347,260348,260349,1,2,0
74348,1,1,260348,260349,260350,1,2,0
74349,6,1,260354,260354,260355,0,1,4
74350,3,3,260357,260357,260360,0,3,2
74351,2,1,260359,260360,260361,1,2,0
74352,5,2,260364,260364,260366,0,2,3
74353,2,2,260366,260366,260368,0,2,0
74354,5,2,260371,260371,260373,0,2,3
74355,4,1,260375,260375,260376,0,1,2
74356,2,3,260377,260377,260380,0,3,1
74357,1,3,260378,260380,260383,2,5,0
74358,2,2,260380,260383,260385,3,5,0
74359,6,1,260386,260386,260387,0,1,1
74360,6,2,260392,260392,260394,0,2,5
74361,3,3,260395,260395,260398,0,3,1
74362,6,1,260401,260401,260402,0,1,3
74363,3,1,260404,260404,260405,0,1,2
74364,6,3,260410,260410,260413,0,3,5
74365,6,1,260416,260416,260417,0,1,3
74366,2,1,260418,260418,260419,0,1,1
74367,3,3,260421,260421,260424,0,3,2
74368,3,3,260424,260424,260427,0,3,0
74369,4,2,260428,260428,260430,0,2,1
74370,3,2,260431,260431,260433,0,2,1
74371,2,1,260433,260433,260434,0,1,0
74372,3,2,260436,260436,260438,0,2,2
74373,5,2,260441,260441,260443,0,2,3
74374,4,1,260445,260445,260446,0,1,2
74375,1,2,260446,260446,260448,0,2,0
74376,2,1,260448,260448,260449,0,1,0
74377,6,3,260454,260454,260457,0,3,5
74378,5,3,260459,260459,260462,0,3,2
74379,3,1,260462,260462,260463,0,1,0
74380,3,2,260465,260465,260467,0,2,2
74381,2,3,260467,260467,260470,0,3,0
74382,3,3,260470,260470,260473,0,3,0
74383,3,3,260473,260473,260476,0,3,0
74384,3,1,260476,260476,260477,0,1,0
74385,6,2,260482,260482,260484,0,2,5
74386,4,3,260486,260486,260489,0,3,2
74387,5,2,260491,260491,260493,0,2,2
74388,4,2,260495,260495,260497,0,2,2
74389,5,2,260500,260500,260502,0,2,3
74390,3,1,260503,260503,260504,0,1,1
74391,3,3,260506,260506,260509,0,3,2
74392,2,3,260508,260509,260512,1,4,0
74393,3,1,260511,260512,260513,1,2,0
74394,5,3,260516,260516,260519,0,3,3
74395,1,2,260517,260519,260521,2,4,0
74396,5,1,260522,260522,260523,0,1,1
74397,2,1,260524,260524,260525,0,1,1
74398,1,1,260525,260525,260526,0,1,0
74399,2,2,260527,260527,260529,0,2,1
74400,6,1,260533,260533,260534,0,1,4
74401,5,2,260538,260538,260540,0,2,4
74402,4,2,260542,260542,260544,0,2,2
74403,1,3,260543,260544,260547,1,4,0
74404,2,1,260545,260547,260548,2,3,0
74405,3,1,260548,260548,260549,0,1,0
74406,1,1,260549,260549,260550,0,1,0
74407,5,2,260554,260554,260556,0,2,4
74408,2,1,260556,260556,260557,0,1,0
74409,3,3,260559,260559,260562,0,3,2
74410,3,3,260562,260562,260565,0,3,0
74411,5,2,260567,260567,260569,0,2,2
74412,1,3,260568,260569,260572,1,4,0
74413,3,3,260571,260572,260575,1,4,0
74414,3,1,260574,260575,260576,1,2,0
74415,2,1,260576,260576,260577,0,1,0
74416,5,3,260581,260581,260584,0,3,4
74417,5,2,260586,260586,260588,0,2,2
74418,2,1,260588,260588,260589,0,1,0
74419,3,3,260591,260591,260594,0,3,2
74420,6,3,260597,260597,260600,0,3,3
74421,5,1,260602,260602,260603,0,1,2
74422,5,3,260607,260607,260610,0,3,4
74423,4,2,260611,260611,260613,0,2,1
74424,5,1,260616,260616,260617,0,1,3
74425,6,2,260622,260622,260624,0,2,5
74426,6,2,260628,260628,260630,0,2,4
74427,2,2,260630,260630,260632,0,2,0
74428,4,2,260634,260634,260636,0,2,2
74429,6,3,260640,260640,260643,0,3,4
74430,4,1,260644,260644,260645,0,1,1
74431,1,2,260645,260645,260647,0,2,0
74432,1,3,260646,260647,260650,1,4,0
74433,5,3,260651,260651,260654,0,3,1
74434,3,2,260654,260654,260656,0,2,0
74435,4,2,260658,260658,260660,0,2,2
74436,6,1,260664,260664,260665,0,1,4
74437,3,1,260667,260667,260668,0,1,2
74438,3,2,260670,260670,260672,0,2,2
74439,1,1,260671,260672,260673,1,2,0
74440,1,3,260672,260673,260676,1,4,0
74441,6,3,260678,260678,260681,0,3,2
74442,6,1,260684,260684,260685,0,1,3
74443,1,2,260685,260685,260687,0,2,0
74444,6,1,260691,260691,260692,0,1,4
74445,1,1,260692,260692,260693,0,1,0
74446,3,3,260695,260695,260698,0,3,2
74447,3,2,260698,260698,260700,0,2,0
74448,2,3,260700,260700,260703,0,3,0
74449,3,1,260703,260703,260704,0,1,0
74450,5,2,260708,260708,260710,0,2,4
74451,6,3,260714,260714,260717,0,3,4
74452,1,2,260715,260717,260719,2,4,0
74453,2,2,260717,260719,260721,2,4,0
74454,1,2,260718,260721,260723,3,5,0
74455,1,1,260719,260723,260724,4,5,0
74456,2,2,260721,260724,260726,3,5,0
74457,1,1,260722,260726,260727,4,5,0
74458,3,3,260725,260727,260730,2,5,0
74459,4,3,260729,260730,260733,1,4,0
74460,5,3,260734,260734,260737,0,3,1
74461,1,1,260735,260737,260738,2,3,0
74462,5,3,260740,260740,260743,0,3,2
74463,1,2,260741,260743,260745,2,4,0
74464,4,2,260745,260745,260747,0,2,0
74465,4,3,260749,260749,260752,0,3,2
74466,6,1,260755,260755,260756,0,1,3
74467,5,2,260760,260760,260762,0,2,4
74468,6,3,260766,260766,260769,0,3,4
74469,5,3,260771,260771,260774,0,3,2
74470,2,3,260773,260774,260777,1,4,0
74471,2,3,260775,260777,260780,2,5,0
74472,1,3,260776,260780,260783,4,7,0
74473,5,2,260781,260783,260785,2,4,0
74474,5,2,260786,260786,260788,0,2,1
74475,1,1,260787,260788,260789,1,2,0
74476,3,1,260790,260790,260791,0,1,1
74477,2,3,260792,260792,260795,0,3,1
74478,6,2,260798,260798,260800,0,2,3
74479,4,1,260802,260802,260803,0,1,2
74480,1,3,260803,260803,260806,0,3,0
74481,6,3,260809,260809,260812,0,3,3
74482,1,1,260810,260812,260813,2,3,0
74483,6,2,260816,260816,260818,0,2,3
74484,6,1,260822,260822,260823,0,1,4
74485,6,1,260828,260828,260829,0,1,5
74486,6,2,260834,260834,260836,0,2,5
74487,3,1,260837,260837,260838,0,1,1
74488,4,2,260841,260841,260843,0,2,3
74489,6,3,260847,260847,260850,0,3,4
74490,1,2,260848,260850,260852,2,4,0
74491,4,2,260852,260852,260854,0,2,0
74492,4,2,260856,260856,260858,0,2,2
74493,1,3,260857,260858,260861,1,4,0
74494,3,3,260860,260861,260864,1,4,0
74495,3,2,260863,260864,260866,1,3,0
74496,4,2,260867,260867,260869,0,2,1
74497,5,3,260872,260872,260875,0,3,3
74498,1,1,260873,260875,260876,2,3,0
74499,5,2,260878,260878,260880,0,2,2
74500,3,2,260881,260881,260883,0,2,1
74501,1,3,260882,260883,260886,1,4,0
74502,1,1,260883,260886,260887,3,4,0
74503,6,3,260889,260889,260892,0,3,2
74504,1,3,260890,260892,260895,2,5,0
74505,3,1,260893,260895,260896,2,3,0
74506,1,2,260894,260896,260898,2,4,0
74507,2,3,260896,260898,260901,2,5,0
74508,6,1,260902,260902,260903,0,1,1
74509,3,2,260905,260905,260907,0,2,2
74510,6,3,260911,260911,260914,0,3,4
74511,3,3,260914,260914,260917,0,3,0
74512,1,3,260915,260917,260920,2,5,0
74513,5,3,260920,260920,260923,0,3,0
74514,3,1,260923,260923,260924,0,1,0
74515,2,3,260925,260925,260928,0,3,1
74516,3,3,260928,260928,260931,0,3,0
74517,5,2,260933,260933,260935,0,2,2
74518,1,1,260934,260935,260936,1,2,0
74519,4,2,260938,260938,260940,0,2,2
74520,3,1,260941,260941,260942,0,1,1
74521,5,1,260946,260946,260947,0,1,4
74522,5,3,260951,260951,260954,0,3,4
74523,4,1,260955,260955,260956,0,1,1
74524,2,2,260957,260957,260959,0,2,1
74525,2,1,260959,260959,260960,0,1,0
74526,3,1,260962,260962,260963,0,1,2
74527,5,3,260967,260967,260970,0,3,4
74528,2,3,260969,260970,260973,1,4,0
74529,2,1,260971,260973,260974,2,3,0
74530,6,2,260977,260977,260979,0,2,3
74531,5,3,260982,260982,260985,0,3,3
74532,2,3,260984,260985,260988,1,4,0
74533,4,2,260988,260988,260990,0,2,0
74534,4,3,260992,260992,260995,0,3,2
74535,5,2,260997,260997,260999,0,2,2
74536,1,3,260998,260999,261002,1,4,0
74537,4,1,261002,261002,261003,0,1,0
74538,2,1,261004,261004,261005,0,1,1
74539,2,3,261006,261006,261009,0,3,1
74540,5,2,261011,261011,261013,0,2,2
74541,4,2,261015,261015,261017,0,2,2
74542,4,3,261019,261019,261022,0,3,2
74543,6,2,261025,261025,261027,0,2,3
74544,4,1,261029,261029,261030,0,1,2
74545,2,1,261031,261031,261032,0,1,1
74546,5,2,261036,261036,261038,0,2,4
74547,3,2,261039,261039,261041,0,2,1
74548,1,3,261040,261041,261044,1,4,0
74549,1,2,261041,261044,261046,3,5,0
74550,2,3,261043,261046,261049,3,6,0
74551,6,3,261049,261049,261052,0,3,0
74552,2,1,261051,261052,261053,1,2,0
74553,6,3,261057,261057,261060,0,3,4
74554,3,2,261060,261060,261062,0,2,0
74555,3,1,261063,261063,261064,0,1,1
74556,5,1,261068,261068,261069,0,1,4
74557,4,3,261072,261072,261075,0,3,3
74558,3,1,261075,261075,261076,0,1,0
74559,1,3,261076,261076,261079,0,3,0
74560,2,3,261078,261079,261082,1,4,0
74561,6,3,261084,261084,261087,0,3,2
74562,3,3,261087,261087,261090,0,3,0
74563,1,3,261088,261090,261093,2,5,0
74564,5,1,261093,261093,261094,0,1,0
74565,4,1,261097,261097,261098,0,1,3
74566,2,2,261099,261099,261101,0,2,1
74567,4,1,261103,261103,261104,0,1,2
74568,6,1,261109,261109,261110,0,1,5
74569,3,1,261112,261112,261113,0,1,2
74570,4,3,261116,261116,261119,0,3,3
74571,2,1,261118,261119,261120,1,2,0
74572,1,2,261119,261120,261122,1,3,0
74573,4,1,261123,261123,261124,0,1,1
74574,5,2,261128,261128,261130,0,2,4
74575,3,3,261131,261131,261134,0,3,1
74576,2,1,261133,261134,261135,1,2,0
74577,3,1,261136,261136,261137,0,1,1
74578,6,3,261142,261142,261145,0,3,5
74579,5,1,261147,261147,261148,0,1,2
74580,6,2,261153,261153,261155,0,2,5
74581,6,1,261159,261159,261160,0,1,4
74582,3,1,261162,261162,261163,0,1,2
74583,3,2,261165,261165,261167,0,2,2
74584,5,3,261170,261170,261173,0,3,3
74585,2,3,261172,261173,261176,1,4,0
74586,2,1,261174,261176,261177,2,3,0
74587,5,1,261179,261179,261180,0,1,2
74588,1,3,261180,261180,261183,0,3,0
74589,4,2,261184,261184,261186,0,2,1
74590,2,3,261186,261186,261189,0,3,0
74591,4,2,261190,261190,261192,0,2,1
74592,5,3,261195,261195,261198,0,3,3
74593,3,1,261198,261198,261199,0,1,0
74594,4,1,261202,261202,261203,0,1,3
74595,5,1,261207,261207,261208,0,1,4
74596,3,1,261210,261210,261211,0,1,2
74597,4,3,261214,261214,261217,0,3,3
74598,6,2,261220,261220,261222,0,2,3
74599,3,1,261223,261223,261224,0,1,1
74600,6,3,261229,261229,261232,0,3,5
74601,6,1,261235,261235,261236,0,1,3
74602,2,2,261237,261237,261239,0,2,1
74603,6,1,261243,261243,261244,0,1,4
74604,2,3,261245,261245,261248,0,3,1
74605,5,1,261250,261250,261251,0,1,2
74606,6,2,261256,261256,261258,0,2,5
74607,4,2,261260,261260,261262,0,2,2
74608,4,2,261264,261264,261266,0,2,2
74609,6,2,261270,261270,261272,0,2,4
74610,3,1,261273,261273,261274,0,1,1
74611,4,1,261277,261277,261278,0,1,3
74612,4,2,261281,261281,261283,0,2,3
74613,5,3,261286,261286,261289,0,3,3
74614,5,3,261291,261291,261294,0,3,2
74615,5,1,261296,261296,261297,0,1,2
74616,4,3,261300,261300,261303,0,3,3
74617,5,3,261305,261305,261308,0,3,2
74618,5,1,261310,261310,261311,0,1,2
74619,1,3,261311,261311,261314,0,3,0
74620,2,3,261313,261314,261317,1,4,0
74621,4,1,261317,261317,261318,0,1,0
74622,1,1,261318,261318,261319,0,1,0
74623,6,2,261324,261324,261326,0,2,5
74624,6,1,261330,261330,261331,0,1,4
74625,6,1,261336,261336,261337,0,1,5
74626,4,3,261340,261340,261343,0,3,3
74627,1,2,261341,261343,261345,2,4,0
74628,3,1,261344,261345,261346,1,2,0
74629,4,3,261348,261348,261351,0,3,2
74630,5,1,261353,261353,261354,0,1,2
74631,3,2,261356,261356,261358,0,2,2
74632,3,1,261359,261359,261360,0,1,1
74633,5,2,261364,261364,261366,0,2,4
74634,4,1,261368,261368,261369,0,1,2
74635,2,1,261370,261370,261371,0,1,1
74636,4,3,261374,261374,261377,0,3,3
74637,5,3,261379,261379,261382,0,3,2
74638,6,2,261385,261385,261387,0,2,3
74639,5,2,261390,261390,261392,0,2,3
74640,2,3,261392,261392,261395,0,3,0
74641,2,1,261394,261395,261396,1,2,0
74642,4,1,261398,261398,261399,0,1,2
74643,5,3,261403,261403,261406,0,3,4
74644,3,2,261406,261406,261408,0,2,0
74645,3,3,261409,261409,261412,0,3,1
74646,3,2,261412,261412,261414,0,2,0
74647,4,1,261416,261416,261417,0,1,2
74648,1,1,261417,261417,261418,0,1,0
74649,1,3,261418,261418,261421,0,3,0
74650,1,1,261419,261421,261422,2,3,0
74651,1,2,261420,261422,261424,2,4,0
74652,3,1,261423,261424,261425,1,2,0
74653,6,2,261429,261429,261431,0,2,4
74654,1,1,261430,261431,261432,1,2,0
74655,5,1,261435,261435,261436,0,1,3
74656,3,1,261438,261438,261439,0,1,2
74657,1,1,261439,261439,261440,0,1,0
74658,4,1,261443,261443,261444,0,1,3
74659,4,3,261447,261447,261450,0,3,3
74660,3,2,261450,261450,261452,0,2,0
74661,1,2,261451,261452,261454,1,3,0
74662,5,1,261456,261456,261457,0,1,2
74663,5,1,261461,261461,261462,0,1,4
74664,4,1,261465,261465,261466,0,1,3
74665,2,2,261467,261467,261469,0,2,1
74666,1,3,261468,261469,261472,1,4,0
74667,1,3,261469,261472,261475,3,6,0
74668,5,3,261474,261475,261478,1,4,0
74669,1,1,261475,261478,261479,3,4,0
74670,1,3,261476,261479,261482,3,6,0
74671,4,1,261480,261482,261483,2,3,0
74672,5,3,261485,261485,261488,0,3,2
74673,6,3,261491,261491,261494,0,3,3
74674,2,3,261493,261494,261497,1,4,0
74675,2,3,261495,261497,261500,2,5,0
74676,3,2,261498,261500,261502,2,4,0
74677,4,1,261502,261502,261503,0,1,0
74678,6,2,261508,261508,261510,0,2,5
74679,4,2,261512,261512,261514,0,2,2
74680,6,3,261518,261518,261521,0,3,4
74681,3,2,261521,261521,261523,0,2,0
74682,2,3,261523,261523,261526,0,3,0
74683,2,2,261525,261526,261528,1,3,0
74684,3,3,261528,261528,261531,0,3,0
74685,6,3,261534,261534,261537,0,3,3
74686,5,1,261539,261539,261540,0,1,2
74687,2,2,261541,261541,261543,0,2,1
74688,1,2,261542,261543,261545,1,3,0
74689,3,2,261545,261545,261547,0,2,0
74690,1,1,261546,261547,261548,1,2,0
74691,2,1,261548,261548,261549,0,1,0
74692,4,1,261552,261552,261553,0,1,3
74693,2,2,261554,261554,261556,0,2,1
74694,6,1,261560,261560,261561,0,1,4
74695,5,2,261565,261565,261567,0,2,4
74696,1,3,261566,261567,261570,1,4,0
74697,4,2,261570,261570,261572,0,2,0
74698,4,3,261574,261574,261577,0,3,2
74699,6,1,261580,261580,261581,0,1,3
74700,2,1,261582,261582,261583,0,1,1
74701,3,3,261585,261585,261588,0,3,2
74702,3,1,261588,261588,261589,0,1,0
74703,3,1,261591,261591,261592,0,1,2
74704,5,1,261596,261596,261597,0,1,4
74705,1,1,261597,261597,261598,0,1,0
74706,3,2,261600,261600,261602,0,2,2
74707,2,3,261602,261602,261605,0,3,0
74708,4,1,261606,261606,261607,0,1,1
74709,3,3,261609,261609,261612,0,3,2
74710,2,3,261611,261612,261615,1,4,0
74711,5,2,261616,261616,261618,0,2,1
74712,1,1,261617,261618,261619,1,2,0
74713,6,1,261623,261623,261624,0,1,4
74714,2,3,261625,261625,261628,0,3,1
74715,5,3,261630,261630,261633,0,3,2
74716,1,3,261631,261633,261636,2,5,0
74717,3,1,261634,261636,261637,2,3,0
74718,4,2,261638,261638,261640,0,2,1
74719,4,2,261642,261642,261644,0,2,2
74720,5,3,261647,261647,261650,0,3,3
74721,5,2,261652,261652,261654,0,2,2
74722,1,3,261653,261654,261657,1,4,0
74723,1,3,261654,261657,261660,3,6,0
74724,1,2,261655,261660,261662,5,7,0
74725,1,2,261656,261662,261664,6,8,0
74726,2,3,261658,261664,261667,6,9,0
74727,1,2,261659,261667,261669,8,10,0
74728,4,3,261663,261669,261672,6,9,0
74729,6,2,261669,261672,261674,3,5,0
74730,6,2,261675,261675,261677,0,2,1
74731,3,1,261678,261678,261679,0,1,1
74732,4,3,261682,261682,261685,0,3,3
74733,4,1,261686,261686,261687,0,1,1
74734,6,1,261692,261692,261693,0,1,5
74735,6,1,261698,261698,261699,0,1,5
74736,5,1,261703,261703,261704,0,1,4
74737,4,2,261707,261707,261709,0,2,3
74738,6,2,261713,261713,261715,0,2,4
74739,6,1,261719,261719,261720,0,1,4
74740,6,2,261725,261725,261727,0,2,5
74741,3,2,261728,261728,261730,0,2,1
74742,6,1,261734,261734,261735,0,1,4
74743,5,3,261739,261739,261742,0,3,4
74744,4,2,261743,261743,261745,0,2,1
74745,6,3,261749,261749,261752,0,3,4
74746,2,2,261751,261752,261754,1,3,0
74747,2,2,261753,261754,261756,1,3,0
74748,1,1,261754,261756,261757,2,3,0
74749,5,2,261759,261759,261761,0,2,2
74750,5,3,261764,261764,261767,0,3,3
74751,1,1,261765,261767,261768,2,3,0
74752,2,3,261767,261768,261771,1,4,0
74753,5,2,261772,261772,261774,0,2,1
74754,4,2,261776,261776,261778,0,2,2
74755,6,2,261782,261782,261784,0,2,4
74756,1,2,261783,261784,261786,1,3,0
74757,5,2,261788,261788,261790,0,2,2
74758,1,1,261789,261790,261791,1,2,0
74759,3,1,261792,261792,261793,0,1,1
74760,1,2,261793,261793,261795,0,2,0
74761,6,3,261799,261799,261802,0,3,4
74762,5,2,261804,261804,261806,0,2,2
74763,6,3,261810,261810,261813,0,3,4
74764,2,3,261812,261813,261816,1,4,0
74765,6,2,261818,261818,261820,0,2,2
74766,4,3,261822,261822,261825,0,3,2
74767,3,3,261825,261825,261828,0,3,0
74768,5,2,261830,261830,261832,0,2,2
74769,4,3,261834,261834,261837,0,3,2
74770,2,1,261836,261837,261838,1,2,0
74771,2,3,261838,261838,261841,0,3,0
74772,6,2,261844,261844,261846,0,2,3
74773,3,2,261847,261847,261849,0,2,1
74774,1,1,261848,261849,261850,1,2,0
74775,6,2,261854,261854,261856,0,2,4
74776,4,3,261858,261858,261861,0,3,2
74777,6,3,261864,261864,261867,0,3,3
74778,4,1,261868,261868,261869,0,1,1
74779,5,2,261873,261873,261875,0,2,4
74780,4,2,261877,261877,261879,0,2,2
74781,2,2,261879,261879,261881,0,2,0
74782,5,2,261884,261884,261886,0,2,3
74783,2,2,261886,261886,261888,0,2,0
74784,5,2,261891,261891,261893,0,2,3
74785,2,1,261893,261893,261894,0,1,0
74786,4,3,261897,261897,261900,0,3,3
74787,2,2,261899,261900,261902,1,3,0
74788,5,3,261904,261904,261907,0,3,2
74789,3,3,261907,261907,261910,0,3,0
74790,3,2,261910,261910,261912,0,2,0
74791,4,1,261914,261914,261915,0,1,2
74792,6,3,261920,261920,261923,0,3,5
74793,2,1,261922,261923,261924,1,2,0
74794,1,1,261923,261924,261925,1,2,0
74795,4,1,261927,261927,261928,0,1,2
74796,3,1,261930,261930,261931,0,1,2
74797,4,2,261934,261934,261936,0,2,3
74798,2,1,261936,261936,261937,0,1,0
74799,2,2,261938,261938,261940,0,2,1
74800,5,1,261943,261943,261944,0,1,3
74801,1,1,261944,261944,261945,0,1,0
74802,3,2,261947,261947,261949,0,2,2
74803,1,2,261948,261949,261951,1,3,0
74804,5,2,261953,261953,261955,0,2,2
74805,3,3,261956,261956,261959,0,3,1
74806,2,1,261958,261959,261960,1,2,0
74807,1,3,261959,261960,261963,1,4,0
74808,3,2,261962,261963,261965,1,3,0
74809,1,3,261963,261965,261968,2,5,0
74810,3,3,261966,261968,261971,2,5,0
74811,4,2,261970,261971,261973,1,3,0
74812,4,3,261974,261974,261977,0,3,1
74813,3,2,261977,261977,261979,0,2,0
74814,3,2,261980,261980,261982,0,2,1
74815,5,2,261985,261985,261987,0,2,3
74816,5,1,261990,261990,261991,0,1,3
74817,6,3,261996,261996,261999,0,3,5
74818,4,3,262000,262000,262003,0,3,1
74819,1,1,262001,262003,262004,2,3,0
74820,2,1,262003,262004,262005,1,2,0
74821,2,3,262005,262005,262008,0,3,0
74822,3,2,262008,262008,262010,0,2,0
74823,2,3,262010,262010,262013,0,3,0
74824,4,1,262014,262014,262015,0,1,1
74825,1,2,262015,262015,262017,0,2,0
74826,2,1,262017,262017,262018,0,1,0
74827,5,3,262022,262022,262025,0,3,4
74828,2,1,262024,262025,262026,1,2,0
74829,1,2,262025,262026,262028,1,3,0
74830,6,3,262031,262031,262034,0,3,3
74831,4,3,262035,262035,262038,0,3,1
74832,3,2,262038,262038,262040,0,2,0
74833,6,2,262044,262044,262046,0,2,4
74834,2,2,262046,262046,262048,0,2,0
74835,6,2,262052,262052,262054,0,2,4
74836,4,2,262056,262056,262058,0,2,2
74837,1,1,262057,262058,262059,1,2,0
74838,5,2,262062,262062,262064,0,2,3
74839,4,2,262066,262066,262068,0,2,2
74840,3,1,262069,262069,262070,0,1,1
74841,1,1,262070,262070,262071,0,1,0
74842,4,3,262074,262074,262077,0,3,3
74843,6,3,262080,262080,262083,0,3,3
74844,2,1,262082,262083,262084,1,2,0
74845,5,1,262087,262087,262088,0,1,3
74846,1,3,262088,262088,262091,0,3,0
74847,3,2,262091,262091,262093,0,2,0
74848,5,1,262096,262096,262097,0,1,3
74849,4,3,262100,262100,262103,0,3,3
74850,1,3,262101,262103,262106,2,5,0
74851,5,3,262106,262106,262109,0,3,0
74852,4,2,262110,262110,262112,0,2,1
74853,1,2,262111,262112,262114,1,3,0
74854,5,2,262116,262116,262118,0,2,2
74855,1,2,262117,262118,262120,1,3,0
74856,4,3,262121,262121,262124,0,3,1
74857,5,1,262126,262126,262127,0,1,2
74858,1,1,262127,262127,262128,0,1,0
74859,2,2,262129,262129,262131,0,2,1
74860,6,1,262135,262135,262136,0,1,4
74861,6,1,262141,262141,262142,0,1,5
74862,5,2,262146,262146,262148,0,2,4
74863,5,3,262151,262151,262154,0,3,3
74864,4,3,262155,262155,262158,0,3,1
74865,5,2,262160,262160,262162,0,2,2
74866,5,1,262165,262165,262166,0,1,3
74867,4,2,262169,262169,262171,0,2,3
74868,5,3,262174,262174,262177,0,3,3
74869,2,2,262176,262177,262179,1,3,0
74870,4,1,262180,262180,262181,0,1,1
74871,1,3,262181,262181,262184,0,3,0
74872,6,2,262187,262187,262189,0,2,3
74873,6,3,262193,262193,262196,0,3,4
74874,4,3,262197,262197,262200,0,3,1
74875,5,3,262202,262202,262205,0,3,2
74876,1,2,262203,262205,262207,2,4,0
74877,1,3,262204,262207,262210,3,6,0
74878,3,1,262207,262210,262211,3,4,0
74879,1,3,262208,262211,262214,3,6,0
74880,2,3,262210,262214,262217,4,7,0
74881,3,1,262213,262217,262218,4,5,0
74882,1,1,262214,262218,262219,4,5,0
74883,3,2,262217,262219,262221,2,4,0
74884,3,1,262220,262221,262222,1,2,0
74885,3,3,262223,262223,262226,0,3,1
74886,4,1,262227,262227,262228,0,1,1
74887,4,3,262231,262231,262234,0,3,3
74888,3,2,262234,262234,262236,0,2,0
74889,3,1,262237,262237,262238,0,1,1
74890,6,3,262243,262243,262246,0,3,5
74891,4,1,262247,262247,262248,0,1,1
74892,1,1,262248,262248,262249,0,1,0
74893,5,1,262253,262253,262254,0,1,4
74894,6,2,262259,262259,262261,0,2,5
74895,1,1,262260,262261,262262,1,2,0
74896,1,3,262261,262262,262265,1,4,0
74897,2,2,262263,262265,262267,2,4,0
74898,3,3,262266,262267,262270,1,4,0
74899,5,1,262271,262271,262272,0,1,1
74900,2,1,262273,262273,262274,0,1,1
74901,2,3,262275,262275,262278,0,3,1
74902,5,1,262280,262280,262281,0,1,2
74903,5,1,262285,262285,262286,0,1,4
74904,6,1,262291,262291,262292,0,1,5
74905,4,3,262295,262295,262298,0,3,3
74906,3,1,262298,262298,262299,0,1,0
74907,1,1,262299,262299,262300,0,1,0
74908,6,3,262305,262305,262308,0,3,5
74909,4,3,262309,262309,262312,0,3,1
74910,2,1,262311,262312,262313,1,2,0
74911,6,3,262317,262317,262320,0,3,4
74912,1,2,262318,262320,262322,2,4,0
74913,3,2,262321,262322,262324,1,3,0
74914,4,1,262325,262325,262326,0,1,1
74915,5,2,262330,262330,262332,0,2,4
74916,6,2,262336,262336,262338,0,2,4
74917,3,3,262339,262339,262342,0,3,1
74918,3,1,262342,262342,262343,0,1,0
74919,2,3,262344,262344,262347,0,3,1
74920,2,2,262346,262347,262349,1,3,0
74921,3,3,262349,262349,262352,0,3,0
74922,2,1,262351,262352,262353,1,2,0
74923,4,3,262355,262355,262358,0,3,2
74924,2,3,262357,262358,262361,1,4,0
74925,1,1,262358,262361,262362,3,4,0
74926,3,2,262361,262362,262364,1,3,0
74927,2,3,262363,262364,262367,1,4,0
74928,4,3,262367,262367,262370,0,3,0
74929,1,3,262368,262370,262373,2,5,0
74930,5,3,262373,262373,262376,0,3,0
74931,6,2,262379,262379,262381,0,2,3
74932,5,1,262384,262384,262385,0,1,3
74933,3,2,262387,262387,262389,0,2,2
74934,1,3,262388,262389,262392,1,4,0
74935,2,2,262390,262392,262394,2,4,0
74936,6,2,262396,262396,262398,0,2,2
74937,4,3,262400,262400,262403,0,3,2
74938,6,1,262406,262406,262407,0,1,3
74939,4,3,262410,262410,262413,0,3,3
74940,3,3,262413,262413,262416,0,3,0
74941,6,1,262419,262419,262420,0,1,3
74942,6,3,262425,262425,262428,0,3,5
74943,5,2,262430,262430,262432,0,2,2
74944,1,2,262431,262432,262434,1,3,0
74945,1,3,262432,262434,262437,2,5,0
74946,4,1,262436,262437,262438,1,2,0
74947,5,1,262441,262441,262442,0,1,3
74948,5,1,262446,262446,262447,0,1,4
74949,5,1,262451,262451,262452,0,1,4
74950,4,3,262455,262455,262458,0,3,3
74951,5,3,262460,262460,262463,0,3,2
74952,1,1,262461,262463,262464,2,3,0
74953,5,1,262466,262466,262467,0,1,2
74954,3,1,262469,262469,262470,0,1,2
74955,6,3,262475,262475,262478,0,3,5
74956,4,3,262479,262479,262482,0,3,1
74957,1,1,262480,262482,262483,2,3,0
74958,4,3,262484,262484,262487,0,3,1
74959,2,2,262486,262487,262489,1,3,0
74960,1,2,262487,262489,262491,2,4,0
74961,2,2,262489,262491,262493,2,4,0
74962,1,1,262490,262493,262494,3,4,0
74963,6,2,262496,262496,262498,0,2,2
74964,1,1,262497,262498,262499,1,2,0
74965,5,1,262502,262502,262503,0,1,3
74966,1,2,262503,262503,262505,0,2,0
74967,1,3,262504,262505,262508,1,4,0
74968,6,2,262510,262510,262512,0,2,2
74969,5,1,262515,262515,262516,0,1,3
74970,3,1,262518,262518,262519,0,1,2
74971,4,1,262522,262522,262523,0,1,3
74972,2,1,262524,262524,262525,0,1,1
74973,1,2,262525,262525,262527,0,2,0
74974,1,2,262526,262527,262529,1,3,0
74975,6,3,262532,262532,262535,0,3,3
74976,1,3,262533,262535,262538,2,5,0
74977,6,1,262539,262539,262540,0,1,1
74978,1,2,262540,262540,262542,0,2,0
74979,3,2,262543,262543,262545,0,2,1
74980,2,1,262545,262545,262546,0,1,0
74981,1,1,262546,262546,262547,0,1,0
74982,2,2,262548,262548,262550,0,2,1
74983,6,3,262554,262554,262557,0,3,4
74984,4,3,262558,262558,262561,0,3,1
74985,1,1,262559,262561,262562,2,3,0
74986,1,2,262560,262562,262564,2,4,0
74987,3,3,262563,262564,262567,1,4,0
74988,6,3,262569,262569,262572,0,3,2
74989,3,3,262572,262572,262575,0,3,0
74990,5,2,262577,262577,262579,0,2,2
74991,5,3,262582,262582,262585,0,3,3
74992,2,3,262584,262585,262588,1,4,0
74993,5,3,262589,262589,262592,0,3,1
74994,1,2,262590,262592,262594,2,4,0
74995,3,1,262593,262594,262595,1,2,0
74996,5,3,262598,262598,262601,0,3,3
74997,6,2,262604,262604,262606,0,2,3
74998,6,1,262610,262610,262611,0,1,4
74999,2,3,262612,262612,262615,0,3,1
75000,3,1,262615,262615,262616,0,1,0
75001,1,3,262616,262616,262619,0,3,0
75002,2,1,262618,262619,262620,1,2,0
75003,2,2,262620,262620,262622,0,2,0
75004,1,3,262621,262622,262625,1,4,0
75005,3,3,262624,262625,262628,1,4,0
75006,6,3,262630,262630,262633,0,3,2
75007,2,2,262632,262633,262635,1,3,0
75008,5,1,262637,262637,262638,0,1,2
75009,1,1,262638,262638,262639,0,1,0
75010,4,1,262642,262642,262643,0,1,3
75011,5,1,262647,262647,262648,0,1,4
75012,5,1,262652,262652,262653,0,1,4
75013,5,1,262657,262657,262658,0,1,4
75014,2,1,262659,262659,262660,0,1,1
75015,1,3,262660,262660,262663,0,3,0
75016,2,1,262662,262663,262664,1,2,0
75017,4,2,262666,262666,262668,0,2,2
75018,2,1,262668,262668,262669,0,1,0
75019,3,3,262671,262671,262674,0,3,2
75020,5,2,262676,262676,262678,0,2,2
75021,3,3,262679,262679,262682,0,3,1
75022,6,1,262685,262685,262686,0,1,3
75023,6,3,262691,262691,262694,0,3,5
75024,5,2,262696,262696,262698,0,2,2
75025,1,3,262697,262698,262701,1,4,0
75026,1,1,262698,262701,262702,3,4,0
75027,5,3,262703,262703,262706,0,3,1
75028,4,3,262707,262707,262710,0,3,1
75029,4,3,262711,262711,262714,0,3,1
75030,5,2,262716,262716,262718,0,2,2
75031,5,2,262721,262721,262723,0,2,3
75032,1,2,262722,262723,262725,1,3,0
75033,6,3,262728,262728,262731,0,3,3
75034,4,1,262732,262732,262733,0,1,1
75035,3,1,262735,262735,262736,0,1,2
75036,6,1,262741,262741,262742,0,1,5
75037,6,2,262747,262747,262749,0,2,5
75038,4,3,262751,262751,262754,0,3,2
75039,3,1,262754,262754,262755,0,1,0
75040,1,3,262755,262755,262758,0,3,0
75041,1,3,262756,262758,262761,2,5,0
75042,4,1,262760,262761,262762,1,2,0
75043,4,2,262764,262764,262766,0,2,2
75044,1,3,262765,262766,262769,1,4,0
75045,5,2,262770,262770,262772,0,2,1
75046,2,3,262772,262772,262775,0,3,0
75047,5,2,262777,262777,262779,0,2,2
75048,6,3,262783,262783,262786,0,3,4
75049,1,2,262784,262786,262788,2,4,0
75050,5,3,262789,262789,262792,0,3,1
75051,5,2,262794,262794,262796,0,2,2
75052,3,3,262797,262797,262800,0,3,1
75053,1,3,262798,262800,262803,2,5,0
75054,2,3,262800,262803,262806,3,6,0
75055,3,3,262803,262806,262809,3,6,0
75056,2,3,262805,262809,262812,4,7,0
75057,6,3,262811,262812,262815,1,4,0
75058,2,2,262813,262815,262817,2,4,0
75059,2,2,262815,262817,262819,2,4,0
75060,3,3,262818,262819,262822,1,4,0
75061,6,3,262824,262824,262827,0,3,2
75062,6,3,262830,262830,262833,0,3,3
75063,3,2,262833,262833,262835,0,2,0
75064,1,2,262834,262835,262837,1,3,0
75065,3,2,262837,262837,262839,0,2,0
75066,3,3,262840,262840,262843,0,3,1
75067,6,1,262846,262846,262847,0,1,3
75068,5,2,262851,262851,262853,0,2,4
75069,1,1,262852,262853,262854,1,2,0
75070,4,1,262856,262856,262857,0,1,2
75071,3,3,262859,262859,262862,0,3,2
75072,4,3,262863,262863,262866,0,3,1
75073,6,3,262869,262869,262872,0,3,3
75074,6,1,262875,262875,262876,0,1,3
75075,1,2,262876,262876,262878,0,2,0
75076,3,3,262879,262879,262882,0,3,1
75077,6,1,262885,262885,262886,0,1,3
75078,3,1,262888,262888,262889,0,1,2
75079,2,3,262890,262890,262893,0,3,1
75080,1,3,262891,262893,262896,2,5,0
75081,6,2,262897,262897,262899,0,2,1
75082,2,3,262899,262899,262902,0,3,0
75083,3,3,262902,262902,262905,0,3,0
75084,5,2,262907,262907,262909,0,2,2
75085,4,2,262911,262911,262913,0,2,2
75086,1,3,262912,262913,262916,1,4,0
75087,3,1,262915,262916,262917,1,2,0
75088,4,3,262919,262919,262922,0,3,2
75089,2,3,262921,262922,262925,1,4,0
75090,3,1,262924,262925,262926,1,2,0
75091,1,3,262925,262926,262929,1,4,0
75092,3,3,262928,262929,262932,1,4,0
75093,6,2,262934,262934,262936,0,2,2
75094,3,1,262937,262937,262938,0,1,1
75095,6,2,262943,262943,262945,0,2,5
75096,6,3,262949,262949,262952,0,3,4
75097,6,1,262955,262955,262956,0,1,3
75098,2,1,262957,262957,262958,0,1,1
75099,6,1,262963,262963,262964,0,1,5
75100,4,2,262967,262967,262969,0,2,3
75101,5,3,262972,262972,262975,0,3,3
75102,2,2,262974,262975,262977,1,3,0
75103,2,2,262976,262977,262979,1,3,0
75104,6,3,262982,262982,262985,0,3,3
75105,1,3,262983,262985,262988,2,5,0
75106,3,2,262986,262988,262990,2,4,0
75107,3,2,262989,262990,262992,1,3,0
75108,2,2,262991,262992,262994,1,3,0
75109,5,3,262996,262996,262999,0,3,2
75110,5,3,263001,263001,263004,0,3,2
75111,6,1,263007,263007,263008,0,1,3
75112,5,2,263012,263012,263014,0,2,4
75113,3,3,263015,263015,263018,0,3,1
75114,2,2,263017,263018,263020,1,3,0
75115,3,3,263020,263020,263023,0,3,0
75116,3,2,263023,263023,263025,0,2,0
75117,1,1,263024,263025,263026,1,2,0
75118,4,1,263028,263028,263029,0,1,2
75119,6,3,263034,263034,263037,0,3,5
75120,6,1,263040,263040,263041,0,1,3
75121,4,1,263044,263044,263045,0,1,3
75122,6,1,263050,263050,263051,0,1,5
75123,6,2,263056,263056,263058,0,2,5
75124,6,3,263062,263062,263065,0,3,4
75125,6,3,263068,263068,263071,0,3,3
75126,6,3,263074,263074,263077,0,3,3
75127,1,1,263075,263077,263078,2,3,0
75128,1,2,263076,263078,263080,2,4,0
75129,3,3,263079,263080,263083,1,4,0
75130,3,3,263082,263083,263086,1,4,0
75131,6,1,263088,263088,263089,0,1,2
75132,3,1,263091,263091,263092,0,1,2
75133,1,3,263092,263092,263095,0,3,0
75134,4,3,263096,263096,263099,0,3,1
75135,4,2,263100,263100,263102,0,2,1
75136,5,3,263105,263105,263108,0,3,3
75137,5,1,263110,263110,263111,0,1,2
75138,3,2,263113,263113,263115,0,2,2
75139,4,2,263117,263117,263119,0,2,2
75140,3,1,263120,263120,263121,0,1,1
75141,3,3,263123,263123,263126,0,3,2
75142,3,3,263126,263126,263129,0,3,0
75143,6,2,263132,263132,263134,0,2,3
75144,4,2,263136,263136,263138,0,2,2
75145,4,3,263140,263140,263143,0,3,2
75146,5,2,263145,263145,263147,0,2,2
75147,6,2,263151,263151,263153,0,2,4
75148,1,3,263152,263153,263156,1,4,0
75149,6,1,263158,263158,263159,0,1,2
75150,1,2,263159,263159,263161,0,2,0
75151,6,2,263165,263165,263167,0,2,4
75152,2,3,263167,263167,263170,0,3,0
75153,1,3,263168,263170,263173,2,5,0
75154,4,3,263172,263173,263176,1,4,0
75155,5,2,263177,263177,263179,0,2,1
75156,4,2,263181,263181,263183,0,2,2
75157,2,1,263183,263183,263184,0,1,0
75158,4,1,263187,263187,263188,0,1,3
75159,6,3,263193,263193,263196,0,3,5
75160,3,3,263196,263196,263199,0,3,0
75161,2,2,263198,263199,263201,1,3,0
75162,3,1,263201,263201,263202,0,1,0
75163,2,2,263203,263203,263205,0,2,1
75164,6,3,263209,263209,263212,0,3,4
75165,1,3,263210,263212,263215,2,5,0
75166,1,1,263211,263215,263216,4,5,0
75167,6,1,263217,263217,263218,0,1,1
75168,6,1,263223,263223,263224,0,1,5
75169,2,1,263225,263225,263226,0,1,1
75170,5,2,263230,263230,263232,0,2,4
75171,6,2,263236,263236,263238,0,2,4
75172,5,2,263241,263241,263243,0,2,3
75173,1,1,263242,263243,263244,1,2,0
75174,3,2,263245,263245,263247,0,2,1
75175,1,1,263246,263247,263248,1,2,0
75176,2,2,263248,263248,263250,0,2,0
75177,4,2,263252,263252,263254,0,2,2
75178,6,1,263258,263258,263259,0,1,4
75179,2,3,263260,263260,263263,0,3,1
75180,5,3,263265,263265,263268,0,3,2
75181,4,2,263269,263269,263271,0,2,1
75182,4,2,263273,263273,263275,0,2,2
75183,1,2,263274,263275,263277,1,3,0
75184,1,3,263275,263277,263280,2,5,0
75185,3,3,263278,263280,263283,2,5,0
75186,5,1,263283,263283,263284,0,1,0
75187,1,3,263284,263284,263287,0,3,0
75188,2,2,263286,263287,263289,1,3,0
75189,4,3,263290,263290,263293,0,3,1
75190,4,2,263294,263294,263296,0,2,1
75191,5,1,263299,263299,263300,0,1,3
75192,3,2,263302,263302,263304,0,2,2
75193,1,1,263303,263304,263305,1,2,0
75194,1,2,263304,263305,263307,1,3,0
75195,4,2,263308,263308,263310,0,2,1
75196,3,1,263311,263311,263312,0,1,1
75197,3,3,263314,263314,263317,0,3,2
75198,2,2,263316,263317,263319,1,3,0
75199,4,1,263320,263320,263321,0,1,1
75200,4,3,263324,263324,263327,0,3,3
75201,4,3,263328,263328,263331,0,3,1
75202,3,2,263331,263331,263333,0,2,0
75203,6,3,263337,263337,263340,0,3,4
75204,6,2,263343,263343,263345,0,2,3
75205,5,1,263348,263348,263349,0,1,3
75206,3,2,263351,263351,263353,0,2,2
75207,2,3,263353,263353,263356,0,3,0
75208,5,2,263358,263358,263360,0,2,2
75209,3,1,263361,263361,263362,0,1,1
75210,2,3,263363,263363,263366,0,3,1
75211,1,3,263364,263366,263369,2,5,0
75212,6,2,263370,263370,263372,0,2,1
75213,1,2,263371,263372,263374,1,3,0
75214,1,2,263372,263374,263376,2,4,0
75215,5,1,263377,263377,263378,0,1,1
75216,2,3,263379,263379,263382,0,3,1
75217,2,1,263381,263382,263383,1,2,0
75218,6,2,263387,263387,263389,0,2,4
75219,6,1,263393,263393,263394,0,1,4
75220,3,2,263396,263396,263398,0,2,2
75221,6,3,263402,263402,263405,0,3,4
75222,5,3,263407,263407,263410,0,3,2
75223,1,2,263408,263410,263412,2,4,0
75224,5,2,263413,263413,263415,0,2,1
75225,2,1,263415,263415,263416,0,1,0
75226,5,2,263420,263420,263422,0,2,4
75227,2,1,263422,263422,263423,0,1,0
75228,5,1,263427,263427,263428,0,1,4
75229,4,3,263431,263431,263434,0,3,3
75230,4,3,263435,263435,263438,0,3,1
75231,5,1,263440,263440,263441,0,1,2
75232,4,1,263444,263444,263445,0,1,3
75233,1,3,263445,263445,263448,0,3,0
75234,3,2,263448,263448,263450,0,2,0
75235,4,1,263452,263452,263453,0,1,2
75236,4,1,263456,263456,263457,0,1,3
75237,4,1,263460,263460,263461,0,1,3
75238,5,2,263465,263465,263467,0,2,4
75239,4,1,263469,263469,263470,0,1,2
75240,6,1,263475,263475,263476,0,1,5
75241,4,1,263479,263479,263480,0,1,3
75242,6,3,263485,263485,263488,0,3,5
75243,6,3,263491,263491,263494,0,3,3
75244,4,1,263495,263495,263496,0,1,1
75245,4,1,263499,263499,263500,0,1,3
75246,2,1,263501,263501,263502,0,1,1
75247,3,3,263504,263504,263507,0,3,2
75248,3,3,263507,263507,263510,0,3,0
75249,3,3,263510,263510,263513,0,3,0
75250,3,3,263513,263513,263516,0,3,0
75251,5,2,263518,263518,263520,0,2,2
75252,6,3,263524,263524,263527,0,3,4
75253,2,1,263526,263527,263528,1,2,0
75254,1,3,263527,263528,263531,1,4,0
75255,5,1,263532,263532,263533,0,1,1
75256,6,2,263538,263538,263540,0,2,5
75257,6,2,263544,263544,263546,0,2,4
75258,1,3,263545,263546,263549,1,4,0
75259,3,2,263548,263549,263551,1,3,0
75260,4,1,263552,263552,263553,0,1,1
75261,1,1,263553,263553,263554,0,1,0
75262,6,3,263559,263559,263562,0,3,5
75263,5,2,263564,263564,263566,0,2,2
75264,4,3,263568,263568,263571,0,3,2
75265,4,1,263572,263572,263573,0,1,1
75266,4,3,263576,263576,263579,0,3,3
75267,5,2,263581,263581,263583,0,2,2
75268,2,2,263583,263583,263585,0,2,0
75269,5,3,263588,263588,263591,0,3,3
75270,1,3,263589,263591,263594,2,5,0
75271,1,1,263590,263594,263595,4,5,0
75272,5,2,263595,263595,263597,0,2,0
75273,3,2,263598,263598,263600,0,2,1
75274,1,2,263599,263600,263602,1,3,0
75275,3,3,263602,263602,263605,0,3,0
75276,4,2,263606,263606,263608,0,2,1
75277,1,2,263607,263608,263610,1,3,0
75278,5,1,263612,263612,263613,0,1,2
75279,4,2,263616,263616,263618,0,2,3
75280,3,3,263619,263619,263622,0,3,1
75281,1,3,263620,263622,263625,2,5,0
75282,6,2,263626,263626,263628,0,2,1
75283,1,2,263627,263628,263630,1,3,0
75284,5,2,263632,263632,263634,0,2,2
75285,5,1,263637,263637,263638,0,1,3
75286,1,2,263638,263638,263640,0,2,0
75287,1,1,263639,263640,263641,1,2,0
75288,6,3,263645,263645,263648,0,3,4
75289,5,2,263650,263650,263652,0,2,2
75290,3,2,263653,263653,263655,0,2,1
75291,1,2,263654,263655,263657,1,3,0
75292,4,2,263658,263658,263660,0,2,1
75293,6,2,263664,263664,263666,0,2,4
75294,2,1,263666,263666,263667,0,1,0
75295,4,1,263670,263670,263671,0,1,3
75296,6,2,263676,263676,263678,0,2,5
75297,5,3,263681,263681,263684,0,3,3
75298,5,2,263686,263686,263688,0,2,2
75299,6,3,263692,263692,263695,0,3,4
75300,3,1,263695,263695,263696,0,1,0
75301,2,1,263697,263697,263698,0,1,1
75302,2,2,263699,263699,263701,0,2,1
75303,4,2,263703,263703,263705,0,2,2
75304,6,1,263709,263709,263710,0,1,4
75305,6,2,263715,263715,263717,0,2,5
75306,2,2,263717,263717,263719,0,2,0
75307,5,3,263722,263722,263725,0,3,3
75308,3,3,263725,263725,263728,0,3,0
75309,4,1,263729,263729,263730,0,1,1
75310,6,1,263735,263735,263736,0,1,5
75311,2,1,263737,263737,263738,0,1,1
75312,1,3,263738,263738,263741,0,3,0
75313,6,2,263744,263744,263746,0,2,3
75314,1,3,263745,263746,263749,1,4,0
75315,6,1,263751,263751,263752,0,1,2
75316,6,2,263757,263757,263759,0,2,5
75317,1,2,263758,263759,263761,1,3,0
75318,1,3,263759,263761,263764,2,5,0
75319,2,2,263761,263764,263766,3,5,0
75320,5,2,263766,263766,263768,0,2,0
75321,4,1,263770,263770,263771,0,1,2
75322,2,1,263772,263772,263773,0,1,1
75323,6,1,263778,263778,263779,0,1,5
75324,2,2,263780,263780,263782,0,2,1
75325,6,3,263786,263786,263789,0,3,4
75326,3,2,263789,263789,263791,0,2,0
75327,4,1,263793,263793,263794,0,1,2
75328,1,1,263794,263794,263795,0,1,0
75329,1,3,263795,263795,263798,0,3,0
75330,2,3,263797,263798,263801,1,4,0
75331,2,2,263799,263801,263803,2,4,0
75332,6,3,263805,263805,263808,0,3,2
75333,3,3,263808,263808,263811,0,3,0
75334,1,3,263809,263811,263814,2,5,0
75335,6,3,263815,263815,263818,0,3,1
75336,1,3,263816,263818,263821,2,5,0
75337,2,3,263818,263821,263824,3,6,0
75338,2,3,263820,263824,263827,4,7,0
75339,4,3,263824,263827,263830,3,6,0
75340,1,3,263825,263830,263833,5,8,0
75341,6,1,263831,263833,263834,2,3,0
75342,3,3,263834,263834,263837,0,3,0
75343,4,1,263838,263838,263839,0,1,1
75344,2,2,263840,263840,263842,0,2,1
75345,3,3,263843,263843,263846,0,3,1
75346,6,2,263849,263849,263851,0,2,3
75347,4,1,263853,263853,263854,0,1,2
75348,5,2,263858,263858,263860,0,2,4
75349,6,1,263864,263864,263865,0,1,4
75350,3,3,263867,263867,263870,0,3,2
75351,2,1,263869,263870,263871,1,2,0
75352,5,1,263874,263874,263875,0,1,3
75353,4,2,263878,263878,263880,0,2,3
75354,4,2,263882,263882,263884,0,2,2
75355,2,1,263884,263884,263885,0,1,0
75356,1,3,263885,263885,263888,0,3,0
75357,4,1,263889,263889,263890,0,1,1
75358,5,3,263894,263894,263897,0,3,4
75359,1,1,263895,263897,263898,2,3,0
75360,5,2,263900,263900,263902,0,2,2
75361,4,3,263904,263904,263907,0,3,2
75362,6,1,263910,263910,263911,0,1,3
75363,4,1,263914,263914,263915,0,1,3
75364,4,3,263918,263918,263921,0,3,3
75365,4,2,263922,263922,263924,0,2,1
75366,1,3,263923,263924,263927,1,4,0
75367,4,3,263927,263927,263930,0,3,0
75368,6,2,263933,263933,263935,0,2,3
75369,2,3,263935,263935,263938,0,3,0
75370,4,1,263939,263939,263940,0,1,1
75371,6,1,263945,263945,263946,0,1,5
75372,6,1,263951,263951,263952,0,1,5
75373,6,1,263957,263957,263958,0,1,5
75374,3,2,263960,263960,263962,0,2,2
75375,1,1,263961,263962,263963,1,2,0
75376,6,1,263967,263967,263968,0,1,4
75377,1,2,263968,263968,263970,0,2,0
75378,6,3,263974,263974,263977,0,3,4
75379,4,3,263978,263978,263981,0,3,1
75380,5,1,263983,263983,263984,0,1,2
75381,2,2,263985,263985,263987,0,2,1
75382,4,3,263989,263989,263992,0,3,2
75383,1,3,263990,263992,263995,2,5,0
75384,1,1,263991,263995,263996,4,5,0
75385,6,2,263997,263997,263999,0,2,1
75386,1,1,263998,263999,264000,1,2,0
75387,6,3,264004,264004,264007,0,3,4
75388,4,3,264008,264008,264011,0,3,1
75389,2,1,264010,264011,264012,1,2,0
75390,5,3,264015,264015,264018,0,3,3
75391,5,1,264020,264020,264021,0,1,2
75392,1,3,264021,264021,264024,0,3,0
75393,4,3,264025,264025,264028,0,3,1
75394,6,1,264031,264031,264032,0,1,3
75395,1,1,264032,264032,264033,0,1,0
75396,2,2,264034,264034,264036,0,2,1
75397,2,1,264036,264036,264037,0,1,0
75398,5,3,264041,264041,264044,0,3,4
75399,2,1,264043,264044,264045,1,2,0
75400,3,3,264046,264046,264049,0,3,1
75401,2,3,264048,264049,264052,1,4,0
75402,1,3,264049,264052,264055,3,6,0
75403,1,3,264050,264055,264058,5,8,0
75404,3,2,264053,264058,264060,5,7,0
75405,4,1,264057,264060,264061,3,4,0
75406,5,2,264062,264062,264064,0,2,1
75407,6,2,264068,264068,264070,0,2,4
75408,5,2,264073,264073,264075,0,2,3
75409,4,1,264077,264077,264078,0,1,2
75410,3,2,264080,264080,264082,0,2,2
75411,2,3,264082,264082,264085,0,3,0
75412,4,3,264086,264086,264089,0,3,1
75413,1,2,264087,264089,264091,2,4,0
75414,2,2,264089,264091,264093,2,4,0
75415,6,1,264095,264095,264096,0,1,2
75416,1,1,264096,264096,264097,0,1,0
75417,4,3,264100,264100,264103,0,3,3
75418,2,2,264102,264103,264105,1,3,0
75419,3,2,264105,264105,264107,0,2,0
75420,5,2,264110,264110,264112,0,2,3
75421,6,3,264116,264116,264119,0,3,4
75422,3,3,264119,264119,264122,0,3,0
75423,2,3,264121,264122,264125,1,4,0
75424,5,1,264126,264126,264127,0,1,1
75425,6,1,264132,264132,264133,0,1,5
75426,4,3,264136,264136,264139,0,3,3
75427,1,1,264137,264139,264140,2,3,0
75428,2,1,264139,264140,264141,1,2,0
75429,1,1,264140,264141,264142,1,2,0
75430,5,3,264145,264145,264148,0,3,3
75431,5,2,264150,264150,264152,0,2,2
75432,2,2,264152,264152,264154,0,2,0
75433,2,3,264154,264154,264157,0,3,0
75434,5,1,264159,264159,264160,0,1,2
75435,4,3,264163,264163,264166,0,3,3
75436,1,1,264164,264166,264167,2,3,0
75437,2,3,264166,264167,264170,1,4,0
75438,6,2,264172,264172,264174,0,2,2
75439,5,2,264177,264177,264179,0,2,3
75440,3,2,264180,264180,264182,0,2,1
75441,3,2,264183,264183,264185,0,2,1
75442,1,1,264184,264185,264186,1,2,0
75443,1,2,264185,264186,264188,1,3,0
75444,2,3,264187,264188,264191,1,4,0
75445,2,1,264189,264191,264192,2,3,0
75446,3,3,264192,264192,264195,0,3,0
75447,1,1,264193,264195,264196,2,3,0
75448,4,1,264197,264197,264198,0,1,1
75449,5,1,264202,264202,264203,0,1,4
75450,2,3,264204,264204,264207,0,3,1
75451,1,3,264205,264207,264210,2,5,0
75452,1,2,264206,264210,264212,4,6,0
75453,3,1,264209,264212,264213,3,4,0
75454,1,2,264210,264213,264215,3,5,0
75455,2,2,264212,264215,264217,3,5,0
75456,3,1,264215,264217,264218,2,3,0
75457,4,3,264219,264219,264222,0,3,1
75458,1,3,264220,264222,264225,2,5,0
75459,4,3,264224,264225,264228,1,4,0
75460,2,3,264226,264228,264231,2,5,0
75461,3,1,264229,264231,264232,2,3,0
75462,1,2,264230,264232,264234,2,4,0
75463,3,1,264233,264234,264235,1,2,0
75464,4,3,264237,264237,264240,0,3,2
75465,1,1,264238,264240,264241,2,3,0
75466,4,2,264242,264242,264244,0,2,1
75467,6,3,264248,264248,264251,0,3,4
75468,5,2,264253,264253,264255,0,2,2
75469,2,2,264255,264255,264257,0,2,0
75470,4,3,264259,264259,264262,0,3,2
75471,5,3,264264,264264,264267,0,3,2
75472,1,2,264265,264267,264269,2,4,0
75473,1,1,264266,264269,264270,3,4,0
75474,2,2,264268,264270,264272,2,4,0
75475,1,1,264269,264272,264273,3,4,0
75476,6,3,264275,264275,264278,0,3,2
75477,3,1,264278,264278,264279,0,1,0
75478,6,3,264284,264284,264287,0,3,5
75479,3,2,264287,264287,264289,0,2,0
75480,1,3,264288,264289,264292,1,4,0
75481,1,2,264289,264292,264294,3,5,0
75482,3,3,264292,264294,264297,2,5,0
75483,3,3,264295,264297,264300,2,5,0
75484,1,2,264296,264300,264302,4,6,0
75485,3,3,264299,264302,264305,3,6,0
75486,4,1,264303,264305,264306,2,3,0
75487,5,3,264308,264308,264311,0,3,2
75488,5,2,264313,264313,264315,0,2,2
75489,2,3,264315,264315,264318,0,3,0
75490,5,2,264320,264320,264322,0,2,2
75491,2,1,264322,264322,264323,0,1,0
75492,1,3,264323,264323,264326,0,3,0
75493,2,1,264325,264326,264327,1,2,0
75494,5,2,264330,264330,264332,0,2,3
75495,4,1,264334,264334,264335,0,1,2
75496,1,1,264335,264335,264336,0,1,0
75497,1,2,264336,264336,264338,0,2,0
75498,3,2,264339,264339,264341,0,2,1
75499,3,3,264342,264342,264345,0,3,1
75500,5,2,264347,264347,264349,0,2,2
75501,3,3,264350,264350,264353,0,3,1
75502,5,1,264355,264355,264356,0,1,2
75503,5,3,264360,264360,264363,0,3,4
75504,1,2,264361,264363,264365,2,4,0
75505,1,1,264362,264365,264366,3,4,0
75506,4,3,264366,264366,264369,0,3,0
75507,5,1,264371,264371,264372,0,1,2
75508,2,3,264373,264373,264376,0,3,1
75509,2,3,264375,264376,264379,1,4,0
75510,5,1,264380,264380,264381,0,1,1
75511,5,2,264385,264385,264387,0,2,4
75512,4,1,264389,264389,264390,0,1,2
75513,4,2,264393,264393,264395,0,2,3
75514,2,1,264395,264395,264396,0,1,0
75515,5,3,264400,264400,264403,0,3,4
75516,3,2,264403,264403,264405,0,2,0
75517,4,3,264407,264407,264410,0,3,2
75518,6,3,264413,264413,264416,0,3,3
75519,6,3,264419,264419,264422,0,3,3
75520,1,2,264420,264422,264424,2,4,0
75521,3,3,264423,264424,264427,1,4,0
75522,3,3,264426,264427,264430,1,4,0
75523,1,2,264427,264430,264432,3,5,0
75524,4,3,264431,264432,264435,1,4,0
75525,6,2,264437,264437,264439,0,2,2
75526,5,3,264442,264442,264445,0,3,3
75527,4,3,264446,264446,264449,0,3,1
75528,6,2,264452,264452,264454,0,2,3
75529,6,3,264458,264458,264461,0,3,4
75530,1,1,264459,264461,264462,2,3,0
75531,3,1,264462,264462,264463,0,1,0
75532,4,3,264466,264466,264469,0,3,3
75533,2,3,264468,264469,264472,1,4,0
75534,5,2,264473,264473,264475,0,2,1
75535,5,2,264478,264478,264480,0,2,3
75536,5,3,264483,264483,264486,0,3,3
75537,1,1,264484,264486,264487,2,3,0
75538,2,1,264486,264487,264488,1,2,0
75539,6,3,264492,264492,264495,0,3,4
75540,5,2,264497,264497,264499,0,2,2
75541,1,1,264498,264499,264500,1,2,0
75542,2,2,264500,264500,264502,0,2,0
75543,5,3,264505,264505,264508,0,3,3
75544,1,1,264506,264508,264509,2,3,0
75545,6,2,264512,264512,264514,0,2,3
75546,2,1,264514,264514,264515,0,1,0
75547,4,3,264518,264518,264521,0,3,3
75548,3,1,264521,264521,264522,0,1,0
75549,6,3,264527,264527,264530,0,3,5
75550,1,1,264528,264530,264531,2,3,0
75551,6,1,264534,264534,264535,0,1,3
75552,5,1,264539,264539,264540,0,1,4
75553,6,1,264545,264545,264546,0,1,5
75554,5,2,264550,264550,264552,0,2,4
75555,6,3,264556,264556,264559,0,3,4
75556,6,2,264562,264562,264564,0,2,3
75557,5,1,264567,264567,264568,0,1,3
75558,2,2,264569,264569,264571,0,2,1
75559,2,1,264571,264571,264572,0,1,0
75560,2,3,264573,264573,264576,0,3,1
75561,4,1,264577,264577,264578,0,1,1
75562,2,2,264579,264579,264581,0,2,1
75563,5,1,264584,264584,264585,0,1,3
75564,5,1,264589,264589,264590,0,1,4
75565,2,3,264591,264591,264594,0,3,1
75566,1,3,264592,264594,264597,2,5,0
75567,2,2,264594,264597,264599,3,5,0
75568,3,1,264597,264599,264600,2,3,0
75569,5,1,264602,264602,264603,0,1,2
75570,1,3,264603,264603,264606,0,3,0
75571,5,3,264608,264608,264611,0,3,2
75572,6,2,264614,264614,264616,0,2,3
75573,2,1,264616,264616,264617,0,1,0
75574,3,2,264619,264619,264621,0,2,2
75575,2,2,264621,264621,264623,0,2,0
75576,5,3,264626,264626,264629,0,3,3
75577,4,1,264630,264630,264631,0,1,1
75578,2,1,264632,264632,264633,0,1,1
75579,3,2,264635,264635,264637,0,2,2
75580,3,3,264638,264638,264641,0,3,1
75581,4,1,264642,264642,264643,0,1,1
75582,4,1,264646,264646,264647,0,1,3
75583,6,2,264652,264652,264654,0,2,5
75584,1,1,264653,264654,264655,1,2,0
75585,3,1,264656,264656,264657,0,1,1
75586,5,2,264661,264661,264663,0,2,4
75587,1,2,264662,264663,264665,1,3,0
75588,1,2,264663,264665,264667,2,4,0
75589,2,1,264665,264667,264668,2,3,0
75590,4,3,264669,264669,264672,0,3,1
75591,3,2,264672,264672,264674,0,2,0
75592,1,2,264673,264674,264676,1,3,0
75593,1,1,264674,264676,264677,2,3,0
75594,2,3,264676,264677,264680,1,4,0
75595,4,1,264680,264680,264681,0,1,0
75596,5,3,264685,264685,264688,0,3,4
75597,3,1,264688,264688,264689,0,1,0
75598,5,3,264693,264693,264696,0,3,4
75599,2,1,264695,264696,264697,1,2,0
75600,2,3,264697,264697,264700,0,3,0
75601,1,3,264698,264700,264703,2,5,0
75602,4,1,264702,264703,264704,1,2,0
75603,3,2,264705,264705,264707,0,2,1
75604,5,2,264710,264710,264712,0,2,3
75605,3,1,264713,264713,264714,0,1,1
75606,5,2,264718,264718,264720,0,2,4
75607,2,3,264720,264720,264723,0,3,0
75608,3,1,264723,264723,264724,0,1,0
75609,5,3,264728,264728,264731,0,3,4
75610,2,3,264730,264731,264734,1,4,0
75611,5,3,264735,264735,264738,0,3,1
75612,1,2,264736,264738,264740,2,4,0
75613,2,2,264738,264740,264742,2,4,0
75614,3,1,264741,264742,264743,1,2,0
75615,5,3,264746,264746,264749,0,3,3
75616,6,2,264752,264752,264754,0,2,3
75617,5,1,264757,264757,264758,0,1,3
75618,2,3,264759,264759,264762,0,3,1
75619,1,2,264760,264762,264764,2,4,0
75620,3,3,264763,264764,264767,1,4,0
75621,1,1,264764,264767,264768,3,4,0
75622,3,3,264767,264768,264771,1,4,0
75623,5,3,264772,264772,264775,0,3,1
75624,3,2,264775,264775,264777,0,2,0
75625,2,3,264777,264777,264780,0,3,0
75626,1,2,264778,264780,264782,2,4,0
75627,1,2,264779,264782,264784,3,5,0
75628,1,1,264780,264784,264785,4,5,0
75629,2,2,264782,264785,264787,3,5,0
75630,6,2,264788,264788,264790,0,2,1
75631,5,3,264793,264793,264796,0,3,3
75632,4,2,264797,264797,264799,0,2,1
75633,6,3,264803,264803,264806,0,3,4
75634,5,1,264808,264808,264809,0,1,2
75635,5,2,264813,264813,264815,0,2,4
75636,3,3,264816,264816,264819,0,3,1
75637,3,3,264819,264819,264822,0,3,0
75638,1,1,264820,264822,264823,2,3,0
75639,6,1,264826,264826,264827,0,1,3
75640,1,3,264827,264827,264830,0,3,0
75641,5,3,264832,264832,264835,0,3,2
75642,6,1,264838,264838,264839,0,1,3
75643,6,1,264844,264844,264845,0,1,5
75644,4,3,264848,264848,264851,0,3,3
75645,6,3,264854,264854,264857,0,3,3
75646,3,1,264857,264857,264858,0,1,0
75647,2,3,264859,264859,264862,0,3,1
75648,1,1,264860,264862,264863,2,3,0
75649,3,2,264863,264863,264865,0,2,0
75650,4,3,264867,264867,264870,0,3,2
75651,3,2,264870,264870,264872,0,2,0
75652,5,2,264875,264875,264877,0,2,3
75653,2,1,264877,264877,264878,0,1,0
75654,4,3,264881,264881,264884,0,3,3
75655,5,3,264886,264886,264889,0,3,2
75656,1,1,264887,264889,264890,2,3,0
75657,4,3,264891,264891,264894,0,3,1
75658,6,2,264897,264897,264899,0,2,3
75659,2,3,264899,264899,264902,0,3,0
75660,6,3,264905,264905,264908,0,3,3
75661,2,3,264907,264908,264911,1,4,0
75662,3,3,264910,264911,264914,1,4,0
75663,6,1,264916,264916,264917,0,1,2
75664,6,2,264922,264922,264924,0,2,5
75665,1,3,264923,264924,264927,1,4,0
75666,5,3,264928,264928,264931,0,3,1
75667,2,3,264930,264931,264934,1,4,0
75668,2,2,264932,264934,264936,2,4,0
75669,5,2,264937,264937,264939,0,2,1
75670,3,2,264940,264940,264942,0,2,1
75671,3,2,264943,264943,264945,0,2,1
75672,5,2,264948,264948,264950,0,2,3
75673,2,1,264950,264950,264951,0,1,0
75674,2,2,264952,264952,264954,0,2,1
75675,6,1,264958,264958,264959,0,1,4
75676,5,2,264963,264963,264965,0,2,4
75677,5,1,264968,264968,264969,0,1,3
75678,1,2,264969,264969,264971,0,2,0
75679,1,1,264970,264971,264972,1,2,0
75680,1,2,264971,264972,264974,1,3,0
75681,4,3,264975,264975,264978,0,3,1
75682,3,2,264978,264978,264980,0,2,0
75683,6,1,264984,264984,264985,0,1,4
75684,3,3,264987,264987,264990,0,3,2
75685,3,2,264990,264990,264992,0,2,0
75686,6,3,264996,264996,264999,0,3,4
75687,3,3,264999,264999,265002,0,3,0
75688,2,2,265001,265002,265004,1,3,0
75689,2,2,265003,265004,265006,1,3,0
75690,3,2,265006,265006,265008,0,2,0
75691,6,1,265012,265012,265013,0,1,4
75692,4,2,265016,265016,265018,0,2,3
75693,5,2,265021,265021,265023,0,2,3
75694,6,2,265027,265027,265029,0,2,4
75695,6,3,265033,265033,265036,0,3,4
75696,1,1,265034,265036,265037,2,3,0
75697,6,1,265040,265040,265041,0,1,3
75698,1,2,265041,265041,265043,0,2,0
75699,1,3,265042,265043,265046,1,4,0
75700,1,1,265043,265046,265047,3,4,0
75701,5,1,265048,265048,265049,0,1,1
75702,3,1,265051,265051,265052,0,1,2
75703,5,3,265056,265056,265059,0,3,4
75704,3,1,265059,265059,265060,0,1,0
75705,5,1,265064,265064,265065,0,1,4
75706,2,3,265066,265066,265069,0,3,1
75707,6,2,265072,265072,265074,0,2,3
75708,4,3,265076,265076,265079,0,3,2
75709,6,1,265082,265082,265083,0,1,3
75710,2,2,265084,265084,265086,0,2,1
75711,6,2,265090,265090,265092,0,2,4
75712,1,1,265091,265092,265093,1,2,0
75713,4,1,265095,265095,265096,0,1,2
75714,4,1,265099,265099,265100,0,1,3
75715,5,2,265104,265104,265106,0,2,4
75716,1,1,265105,265106,265107,1,2,0
75717,5,3,265110,265110,265113,0,3,3
75718,2,3,265112,265113,265116,1,4,0
75719,4,1,265116,265116,265117,0,1,0
75720,3,3,265119,265119,265122,0,3,2
75721,5,2,265124,265124,265126,0,2,2
75722,5,3,265129,265129,265132,0,3,3
75723,5,1,265134,265134,265135,0,1,2
75724,3,1,265137,265137,265138,0,1,2
75725,4,1,265141,265141,265142,0,1,3
75726,4,3,265145,265145,265148,0,3,3
75727,2,2,265147,265148,265150,1,3,0
75728,6,1,265153,265153,265154,0,1,3
75729,2,1,265155,265155,265156,0,1,1
75730,1,2,265156,265156,265158,0,2,0
75731,6,2,265162,265162,265164,0,2,4
75732,3,1,265165,265165,265166,0,1,1
75733,5,1,265170,265170,265171,0,1,4
75734,2,3,265172,265172,265175,0,3,1
75735,4,3,265176,265176,265179,0,3,1
75736,2,1,265178,265179,265180,1,2,0
75737,3,1,265181,265181,265182,0,1,1
75738,3,1,265184,265184,265185,0,1,2
75739,2,1,265186,265186,265187,0,1,1
75740,4,1,265190,265190,265191,0,1,3
75741,2,3,265192,265192,265195,0,3,1
75742,6,1,265198,265198,265199,0,1,3
75743,4,2,265202,265202,265204,0,2,3
75744,2,3,265204,265204,265207,0,3,0
75745,6,2,265210,265210,265212,0,2,3
75746,3,1,265213,265213,265214,0,1,1
75747,4,3,265217,265217,265220,0,3,3
75748,4,2,265221,265221,265223,0,2,1
75749,5,3,265226,265226,265229,0,3,3
75750,2,1,265228,265229,265230,1,2,0
75751,6,2,265234,265234,265236,0,2,4
75752,3,3,265237,265237,265240,0,3,1
75753,1,2,265238,265240,265242,2,4,0
75754,4,3,265242,265242,265245,0,3,0
75755,6,1,265248,265248,265249,0,1,3
75756,5,2,265253,265253,265255,0,2,4
75757,4,3,265257,265257,265260,0,3,2
75758,2,3,265259,265260,265263,1,4,0
75759,2,3,265261,265263,265266,2,5,0
75760,1,3,265262,265266,265269,4,7,0
75761,1,2,265263,265269,265271,6,8,0
75762,4,3,265267,265271,265274,4,7,0
75763,3,1,265270,265274,265275,4,5,0
75764,4,3,265274,265275,265278,1,4,0
75765,5,2,265279,265279,265281,0,2,1
75766,4,3,265283,265283,265286,0,3,2
75767,5,2,265288,265288,265290,0,2,2
75768,4,2,265292,265292,265294,0,2,2
75769,3,2,265295,265295,265297,0,2,1
75770,5,1,265300,265300,265301,0,1,3
75771,5,2,265305,265305,265307,0,2,4
75772,1,3,265306,265307,265310,1,4,0
75773,4,1,265310,265310,265311,0,1,0
75774,1,1,265311,265311,265312,0,1,0
75775,2,1,265313,265313,265314,0,1,1
75776,5,1,265318,265318,265319,0,1,4
75777,1,2,265319,265319,265321,0,2,0
75778,1,3,265320,265321,265324,1,4,0
75779,3,2,265323,265324,265326,1,3,0
75780,5,1,265328,265328,265329,0,1,2
75781,3,3,265331,265331,265334,0,3,2
75782,2,1,265333,265334,265335,1,2,0
75783,2,2,265335,265335,265337,0,2,0
75784,5,2,265340,265340,265342,0,2,3
75785,2,1,265342,265342,265343,0,1,0
75786,6,1,265348,265348,265349,0,1,5
75787,1,3,265349,265349,265352,0,3,0
75788,4,2,265353,265353,265355,0,2,1
75789,6,3,265359,265359,265362,0,3,4
75790,3,2,265362,265362,265364,0,2,0
75791,2,3,265364,265364,265367,0,3,0
75792,3,3,265367,265367,265370,0,3,0
75793,2,2,265369,265370,265372,1,3,0
75794,5,3,265374,265374,265377,0,3,2
75795,4,1,265378,265378,265379,0,1,1
75796,4,3,265382,265382,265385,0,3,3
75797,2,3,265384,265385,265388,1,4,0
75798,5,1,265389,265389,265390,0,1,1
75799,1,1,265390,265390,265391,0,1,0
75800,4,1,265394,265394,265395,0,1,3
75801,6,3,265400,265400,265403,0,3,5
75802,1,1,265401,265403,265404,2,3,0
75803,5,3,265406,265406,265409,0,3,2
75804,6,3,265412,265412,265415,0,3,3
75805,1,3,265413,265415,265418,2,5,0
75806,2,2,265415,265418,265420,3,5,0
75807,4,3,265419,265420,265423,1,4,0
75808,6,3,265425,265425,265428,0,3,2
75809,1,3,265426,265428,265431,2,5,0
75810,3,3,265429,265431,265434,2,5,0
75811,6,2,265435,265435,265437,0,2,1
75812,4,2,265439,265439,265441,0,2,2
75813,4,1,265443,265443,265444,0,1,2
75814,2,2,265445,265445,265447,0,2,1
75815,6,3,265451,265451,265454,0,3,4
75816,3,3,265454,265454,265457,0,3,0
75817,5,3,265459,265459,265462,0,3,2
75818,5,3,265464,265464,265467,0,3,2
75819,3,2,265467,265467,265469,0,2,0
75820,1,2,265468,265469,265471,1,3,0
75821,4,1,265472,265472,265473,0,1,1
75822,5,1,265477,265477,265478,0,1,4
75823,2,1,265479,265479,265480,0,1,1
75824,1,3,265480,265480,265483,0,3,0
75825,2,1,265482,265483,265484,1,2,0
75826,4,3,265486,265486,265489,0,3,2
75827,3,2,265489,265489,265491,0,2,0
75828,5,2,265494,265494,265496,0,2,3
75829,3,3,265497,265497,265500,0,3,1
75830,6,2,265503,265503,265505,0,2,3
75831,1,3,265504,265505,265508,1,4,0
75832,1,3,265505,265508,265511,3,6,0
75833,3,3,265508,265511,265514,3,6,0
75834,3,3,265511,265514,265517,3,6,0
75835,4,2,265515,265517,265519,2,4,0
75836,5,3,265520,265520,265523,0,3,1
75837,6,3,265526,265526,265529,0,3,3
75838,5,2,265531,265531,265533,0,2,2
75839,6,3,265537,265537,265540,0,3,4
75840,2,3,265539,265540,265543,1,4,0
75841,5,2,265544,265544,265546,0,2,1
75842,6,1,265550,265550,265551,0,1,4
75843,4,3,265554,265554,265557,0,3,3
75844,5,2,265559,265559,265561,0,2,2
75845,4,2,265563,265563,265565,0,2,2
75846,3,3,265566,265566,265569,0,3,1
75847,1,2,265567,265569,265571,2,4,0
75848,4,1,265571,265571,265572,0,1,0
75849,3,3,265574,265574,265577,0,3,2
75850,3,3,265577,265577,265580,0,3,0
75851,5,1,265582,265582,265583,0,1,2
75852,3,1,265585,265585,265586,0,1,2
75853,6,1,265591,265591,265592,0,1,5
75854,4,2,265595,265595,265597,0,2,3
75855,1,2,265596,265597,265599,1,3,0
75856,6,3,265602,265602,265605,0,3,3
75857,1,3,265603,265605,265608,2,5,0
75858,2,1,265605,265608,265609,3,4,0
75859,4,2,265609,265609,265611,0,2,0
75860,4,1,265613,265613,265614,0,1,2
75861,5,2,265618,265618,265620,0,2,4
75862,1,1,265619,265620,265621,1,2,0
75863,1,2,265620,265621,265623,1,3,0
75864,3,2,265623,265623,265625,0,2,0
75865,4,1,265627,265627,265628,0,1,2
75866,2,1,265629,265629,265630,0,1,1
75867,1,3,265630,265630,265633,0,3,0
75868,6,1,265636,265636,265637,0,1,3
75869,2,2,265638,265638,265640,0,2,1
75870,4,2,265642,265642,265644,0,2,2
75871,5,2,265647,265647,265649,0,2,3
75872,5,2,265652,265652,265654,0,2,3
75873,4,1,265656,265656,265657,0,1,2
75874,2,2,265658,265658,265660,0,2,1
75875,2,3,265660,265660,265663,0,3,0
75876,6,3,265666,265666,265669,0,3,3
75877,4,2,265670,265670,265672,0,2,1
75878,5,1,265675,265675,265676,0,1,3
75879,3,3,265678,265678,265681,0,3,2
75880,5,2,265683,265683,265685,0,2,2
75881,4,1,265687,265687,265688,0,1,2
75882,4,3,265691,265691,265694,0,3,3
75883,1,1,265692,265694,265695,2,3,0
75884,3,1,265695,265695,265696,0,1,0
75885,5,1,265700,265700,265701,0,1,4
75886,1,2,265701,265701,265703,0,2,0
75887,4,2,265705,265705,265707,0,2,2
75888,6,2,265711,265711,265713,0,2,4
75889,4,1,265715,265715,265716,0,1,2
75890,3,1,265718,265718,265719,0,1,2
75891,3,3,265721,265721,265724,0,3,2
75892,5,1,265726,265726,265727,0,1,2
75893,5,2,265731,265731,265733,0,2,4
75894,4,1,265735,265735,265736,0,1,2
75895,4,2,265739,265739,265741,0,2,3
75896,4,3,265743,265743,265746,0,3,2
75897,5,3,265748,265748,265751,0,3,2
75898,1,3,265749,265751,265754,2,5,0
75899,6,1,265755,265755,265756,0,1,1
75900,2,3,265757,265757,265760,0,3,1
75901,2,3,265759,265760,265763,1,4,0
75902,6,2,265765,265765,265767,0,2,2
75903,1,3,265766,265767,265770,1,4,0
75904,3,2,265769,265770,265772,1,3,0
75905,1,3,265770,265772,265775,2,5,0
75906,3,1,265773,265775,265776,2,3,0
75907,2,3,265775,265776,265779,1,4,0
75908,3,1,265778,265779,265780,1,2,0
75909,6,1,265784,265784,265785,0,1,4
75910,5,1,265789,265789,265790,0,1,4
75911,1,2,265790,265790,265792,0,2,0
75912,6,2,265796,265796,265798,0,2,4
75913,4,3,265800,265800,265803,0,3,2
75914,1,2,265801,265803,265805,2,4,0
75915,5,2,265806,265806,265808,0,2,1
75916,2,3,265808,265808,265811,0,3,0
75917,6,1,265814,265814,265815,0,1,3
75918,6,1,265820,265820,265821,0,1,5
75919,2,3,265822,265822,265825,0,3,1
75920,5,1,265827,265827,265828,0,1,2
75921,1,2,265828,265828,265830,0,2,0
75922,5,3,265833,265833,265836,0,3,3
75923,2,3,265835,265836,265839,1,4,0
75924,5,1,265840,265840,265841,0,1,1
75925,2,3,265842,265842,265845,0,3,1
75926,4,2,265846,265846,265848,0,2,1
75927,2,1,265848,265848,265849,0,1,0
75928,3,2,265851,265851,265853,0,2,2
75929,5,2,265856,265856,265858,0,2,3
75930,5,3,265861,265861,265864,0,3,3
75931,5,2,265866,265866,265868,0,2,2
75932,3,2,265869,265869,265871,0,2,1
75933,4,1,265873,265873,265874,0,1,2
75934,1,1,265874,265874,265875,0,1,0
75935,2,1,265876,265876,265877,0,1,1
75936,3,3,265879,265879,265882,0,3,2
75937,6,1,265885,265885,265886,0,1,3
75938,3,3,265888,265888,265891,0,3,2
75939,5,1,265893,265893,265894,0,1,2
75940,2,1,265895,265895,265896,0,1,1
75941,6,1,265901,265901,265902,0,1,5
75942,1,1,265902,265902,265903,0,1,0
75943,2,3,265904,265904,265907,0,3,1
75944,5,1,265909,265909,265910,0,1,2
75945,6,2,265915,265915,265917,0,2,5
75946,2,3,265917,265917,265920,0,3,0
75947,6,2,265923,265923,265925,0,2,3
75948,1,1,265924,265925,265926,1,2,0
75949,2,3,265926,265926,265929,0,3,0
75950,2,2,265928,265929,265931,1,3,0
75951,2,2,265930,265931,265933,1,3,0
75952,4,1,265934,265934,265935,0,1,1
75953,2,3,265936,265936,265939,0,3,1
75954,1,2,265937,265939,265941,2,4,0
75955,5,2,265942,265942,265944,0,2,1
75956,4,1,265946,265946,265947,0,1,2
75957,2,2,265948,265948,265950,0,2,1
75958,2,3,265950,265950,265953,0,3,0
75959,3,2,265953,265953,265955,0,2,0
75960,3,3,265956,265956,265959,0,3,1
75961,4,3,265960,265960,265963,0,3,1
75962,6,2,265966,265966,265968,0,2,3
75963,3,3,265969,265969,265972,0,3,1
75964,2,3,265971,265972,265975,1,4,0
75965,3,2,265974,265975,265977,1,3,0
75966,1,1,265975,265977,265978,2,3,0
75967,6,1,265981,265981,265982,0,1,3
75968,1,2,265982,265982,265984,0,2,0
75969,6,1,265988,265988,265989,0,1,4
75970,4,3,265992,265992,265995,0,3,3
75971,1,3,265993,265995,265998,2,5,0
75972,1,2,265994,265998,266000,4,6,0
75973,6,2,266000,266000,266002,0,2,0
75974,5,2,266005,266005,266007,0,2,3
75975,3,1,266008,266008,266009,0,1,1
75976,5,3,266013,266013,266016,0,3,4
75977,6,1,266019,266019,266020,0,1,3
75978,5,1,266024,266024,266025,0,1,4
75979,5,3,266029,266029,266032,0,3,4
75980,5,2,266034,266034,266036,0,2,2
75981,3,1,266037,266037,266038,0,1,1
75982,4,1,266041,266041,266042,0,1,3
75983,5,2,266046,266046,266048,0,2,4
75984,3,3,266049,266049,266052,0,3,1
75985,1,3,266050,266052,266055,2,5,0
75986,1,3,266051,266055,266058,4,7,0
75987,4,1,266055,266058,266059,3,4,0
75988,1,2,266056,266059,266061,3,5,0
75989,4,3,266060,266061,266064,1,4,0
75990,6,3,266066,266066,266069,0,3,2
75991,4,2,266070,266070,266072,0,2,1
75992,4,3,266074,266074,266077,0,3,2
75993,6,3,266080,266080,266083,0,3,3
75994,5,2,266085,266085,266087,0,2,2
75995,1,1,266086,266087,266088,1,2,0
75996,4,1,266090,266090,266091,0,1,2
75997,1,3,266091,266091,266094,0,3,0
75998,4,3,266095,266095,266098,0,3,1
75999,1,2,266096,266098,266100,2,4,0
76000,6,2,266102,266102,266104,0,2,2
76001,5,1,266107,266107,266108,0,1,3
76002,6,1,266113,266113,266114,0,1,5
76003,4,1,266117,266117,266118,0,1,3
76004,2,2,266119,266119,266121,0,2,1
76005,6,3,266125,266125,266128,0,3,4
76006,2,1,266127,266128,266129,1,2,0
76007,2,1,266129,266129,266130,0,1,0
76008,4,3,266133,266133,266136,0,3,3
76009,2,2,266135,266136,266138,1,3,0
76010,3,2,266138,266138,266140,0,2,0
76011,4,3,266142,266142,266145,0,3,2
76012,1,3,266143,266145,266148,2,5,0
76013,3,1,266146,266148,266149,2,3,0
76014,4,3,266150,266150,266153,0,3,1
76015,4,1,266154,266154,266155,0,1,1
76016,3,2,266157,266157,266159,0,2,2
76017,5,1,266162,266162,266163,0,1,3
76018,5,3,266167,266167,266170,0,3,4
76019,3,2,266170,266170,266172,0,2,0
76020,1,1,266171,266172,266173,1,2,0
76021,6,1,266177,266177,266178,0,1,4
76022,1,3,266178,266178,266181,0,3,0
76023,1,1,266179,266181,266182,2,3,0
76024,5,2,266184,266184,266186,0,2,2
76025,3,1,266187,266187,266188,0,1,1
76026,2,3,266189,266189,266192,0,3,1
76027,1,2,266190,266192,266194,2,4,0
76028,5,2,266195,266195,266197,0,2,1
76029,3,1,266198,266198,266199,0,1,1
76030,2,2,266200,266200,266202,0,2,1
76031,6,3,266206,266206,266209,0,3,4
76032,2,3,266208,266209,266212,1,4,0
76033,1,2,266209,266212,266214,3,5,0
76034,1,1,266210,266214,266215,4,5,0
76035,3,3,266213,266215,266218,2,5,0
76036,5,2,266218,266218,266220,0,2,0
76037,2,3,266220,266220,266223,0,3,0
76038,3,3,266223,266223,266226,0,3,0
76039,4,3,266227,266227,266230,0,3,1
76040,5,1,266232,266232,266233,0,1,2
76041,4,1,266236,266236,266237,0,1,3
76042,2,3,266238,266238,266241,0,3,1
76043,1,3,266239,266241,266244,2,5,0
76044,6,1,266245,266245,266246,0,1,1
76045,1,1,266246,266246,266247,0,1,0
76046,1,2,266247,266247,266249,0,2,0
76047,4,3,266251,266251,266254,0,3,2
76048,3,1,266254,266254,266255,0,1,0
76049,4,1,266258,266258,266259,0,1,3
76050,2,1,266260,266260,266261,0,1,1
76051,6,2,266266,266266,266268,0,2,5
76052,3,1,266269,266269,266270,0,1,1
76053,4,3,266273,266273,266276,0,3,3
76054,2,1,266275,266276,266277,1,2,0
76055,6,3,266281,266281,266284,0,3,4
76056,2,2,266283,266284,266286,1,3,0
76057,5,3,266288,266288,266291,0,3,2
76058,3,2,266291,266291,266293,0,2,0
76059,6,1,266297,266297,266298,0,1,4
76060,5,2,266302,266302,266304,0,2,4
76061,2,1,266304,266304,266305,0,1,0
76062,1,1,266305,266305,266306,0,1,0
76063,3,2,266308,266308,266310,0,2,2
76064,1,3,266309,266310,266313,1,4,0
76065,4,2,266313,266313,266315,0,2,0
76066,2,1,266315,266315,266316,0,1,0
76067,6,1,266321,266321,266322,0,1,5
76068,3,2,266324,266324,266326,0,2,2
76069,6,3,266330,266330,266333,0,3,4
76070,4,1,266334,266334,266335,0,1,1
76071,2,1,266336,266336,266337,0,1,1
76072,4,2,266340,266340,266342,0,2,3
76073,3,3,266343,266343,266346,0,3,1
76074,5,3,266348,266348,266351,0,3,2
76075,2,1,266350,266351,266352,1,2,0
76076,4,1,266354,266354,266355,0,1,2
76077,4,3,266358,266358,266361,0,3,3
76078,1,2,266359,266361,266363,2,4,0
76079,6,3,266365,266365,266368,0,3,2
76080,3,3,266368,266368,266371,0,3,0
76081,2,1,266370,266371,266372,1,2,0
76082,1,1,266371,266372,266373,1,2,0
76083,3,2,266374,266374,266376,0,2,1
76084,6,2,266380,266380,266382,0,2,4
76085,5,3,266385,266385,266388,0,3,3
76086,4,1,266389,266389,266390,0,1,1
76087,5,1,266394,266394,266395,0,1,4
76088,5,2,266399,266399,266401,0,2,4
76089,5,3,266404,266404,266407,0,3,3
76090,1,3,266405,266407,266410,2,5,0
76091,5,2,266410,266410,266412,0,2,0
76092,2,2,266412,266412,266414,0,2,0
76093,2,1,266414,266414,266415,0,1,0
76094,2,1,266416,266416,266417,0,1,1
76095,5,2,266421,266421,266423,0,2,4
76096,5,1,266426,266426,266427,0,1,3
76097,5,3,266431,266431,266434,0,3,4
76098,6,1,266437,266437,266438,0,1,3
76099,4,3,266441,266441,266444,0,3,3
76100,5,3,266446,266446,266449,0,3,2
76101,5,3,266451,266451,266454,0,3,2
76102,3,3,266454,266454,266457,0,3,0
76103,3,2,266457,266457,266459,0,2,0
76104,3,3,266460,266460,266463,0,3,1
76105,5,3,266465,266465,266468,0,3,2
76106,3,2,266468,266468,266470,0,2,0
76107,3,1,266471,266471,266472,0,1,1
76108,4,3,266475,266475,266478,0,3,3
76109,1,1,266476,266478,266479,2,3,0
76110,4,2,266480,266480,266482,0,2,1
76111,4,2,266484,266484,266486,0,2,2
76112,1,2,266485,266486,266488,1,3,0
76113,4,3,266489,266489,266492,0,3,1
76114,5,3,266494,266494,266497,0,3,2
76115,3,3,266497,266497,266500,0,3,0
76116,2,2,266499,266500,266502,1,3,0
76117,1,1,266500,266502,266503,2,3,0
76118,5,2,266505,266505,266507,0,2,2
76119,3,2,266508,266508,266510,0,2,1
76120,3,3,266511,266511,266514,0,3,1
76121,2,2,266513,266514,266516,1,3,0
76122,4,1,266517,266517,266518,0,1,1
76123,2,2,266519,266519,266521,0,2,1
76124,3,1,266522,266522,266523,0,1,1
76125,2,1,266524,266524,266525,0,1,1
76126,4,2,266528,266528,266530,0,2,3
76127,2,1,266530,266530,266531,0,1,0
76128,1,3,266531,266531,266534,0,3,0
76129,6,1,266537,266537,266538,0,1,3
76130,3,1,266540,266540,266541,0,1,2
76131,4,3,266544,266544,266547,0,3,3
76132,5,1,266549,266549,266550,0,1,2
76133,5,3,266554,266554,266557,0,3,4
76134,4,3,266558,266558,266561,0,3,1
76135,3,3,266561,266561,266564,0,3,0
76136,2,1,266563,266564,266565,1,2,0
76137,2,3,266565,266565,266568,0,3,0
76138,4,3,266569,266569,266572,0,3,1
76139,3,3,266572,266572,266575,0,3,0
76140,5,3,266577,266577,266580,0,3,2
76141,1,1,266578,266580,266581,2,3,0
76142,4,1,266582,266582,266583,0,1,1
76143,3,3,266585,266585,266588,0,3,2
76144,6,2,266591,266591,266593,0,2,3
76145,5,2,266596,266596,266598,0,2,3
76146,1,3,266597,266598,266601,1,4,0
76147,1,3,266598,266601,266604,3,6,0
76148,3,3,266601,266604,266607,3,6,0
76149,5,3,266606,266607,266610,1,4,0
76150,6,1,266612,266612,266613,0,1,2
76151,3,2,266615,266615,266617,0,2,2
76152,6,3,266621,266621,266624,0,3,4
76153,3,3,266624,266624,266627,0,3,0
76154,4,2,266628,266628,266630,0,2,1
76155,2,3,266630,266630,266633,0,3,0
76156,6,2,266636,266636,266638,0,2,3
76157,3,3,266639,266639,266642,0,3,1
76158,2,2,266641,266642,266644,1,3,0
76159,1,1,266642,266644,266645,2,3,0
76160,4,2,266646,266646,266648,0,2,1
76161,4,1,266650,266650,266651,0,1,2
76162,3,3,266653,266653,266656,0,3,2
76163,5,2,266658,266658,266660,0,2,2
76164,1,3,266659,266660,266663,1,4,0
76165,2,3,266661,266663,266666,2,5,0
76166,1,2,266662,266666,266668,4,6,0
76167,2,1,266664,266668,266669,4,5,0
76168,1,3,266665,266669,266672,4,7,0
76169,4,1,266669,266672,266673,3,4,0
76170,5,2,266674,266674,266676,0,2,1
76171,6,1,266680,266680,266681,0,1,4
76172,1,2,266681,266681,266683,0,2,0
76173,3,3,266684,266684,266687,0,3,1
76174,6,1,266690,266690,266691,0,1,3
76175,4,1,266694,266694,266695,0,1,3
76176,3,1,266697,266697,266698,0,1,2
76177,6,3,266703,266703,266706,0,3,5
76178,3,2,266706,266706,266708,0,2,0
76179,1,1,266707,266708,266709,1,2,0
76180,5,3,266712,266712,266715,0,3,3
76181,3,1,266715,266715,266716,0,1,0
76182,3,3,266718,266718,266721,0,3,2
76183,6,2,266724,266724,266726,0,2,3
76184,5,3,266729,266729,266732,0,3,3
76185,5,2,266734,266734,266736,0,2,2
76186,2,1,266736,266736,266737,0,1,0
76187,4,3,266740,266740,266743,0,3,3
76188,2,2,266742,266743,266745,1,3,0
76189,1,1,266743,266745,266746,2,3,0
76190,3,3,266746,266746,266749,0,3,0
76191,1,2,266747,266749,266751,2,4,0
76192,2,1,266749,266751,266752,2,3,0
76193,4,1,266753,266753,266754,0,1,1
76194,6,2,266759,266759,266761,0,2,5
76195,5,1,266764,266764,266765,0,1,3
76196,2,2,266766,266766,266768,0,2,1
76197,5,2,266771,266771,266773,0,2,3
76198,1,1,266772,266773,266774,1,2,0
76199,6,2,266778,266778,266780,0,2,4
76200,3,3,266781,266781,266784,0,3,1
76201,4,1,266785,266785,266786,0,1,1
76202,3,1,266788,266788,266789,0,1,2
76203,4,2,266792,266792,266794,0,2,3
76204,4,2,266796,266796,266798,0,2,2
76205,2,1,266798,266798,266799,0,1,0
76206,1,3,266799,266799,266802,0,3,0
76207,6,1,266805,266805,266806,0,1,3
76208,2,3,266807,266807,266810,0,3,1
76209,2,3,266809,266810,266813,1,4,0
76210,6,1,266815,266815,266816,0,1,2
76211,5,1,266820,266820,266821,0,1,4
76212,6,2,266826,266826,266828,0,2,5
76213,3,2,266829,266829,266831,0,2,1
76214,1,2,266830,266831,266833,1,3,0
76215,5,2,266835,266835,266837,0,2,2
76216,2,1,266837,266837,266838,0,1,0
76217,1,2,266838,266838,266840,0,2,0
76218,3,3,266841,266841,266844,0,3,1
76219,1,3,266842,266844,266847,2,5,0
76220,2,2,266844,266847,266849,3,5,0
76221,2,3,266846,266849,266852,3,6,0
76222,3,1,266849,266852,266853,3,4,0
76223,3,1,266852,266853,266854,1,2,0
76224,3,1,266855,266855,266856,0,1,1
76225,4,1,266859,266859,266860,0,1,3
76226,1,2,266860,266860,266862,0,2,0
76227,2,2,266862,266862,266864,0,2,0
76228,5,1,266867,266867,266868,0,1,3
76229,2,2,266869,266869,266871,0,2,1
76230,5,1,266874,266874,266875,0,1,3
76231,6,2,266880,266880,266882,0,2,5
76232,6,3,266886,266886,266889,0,3,4
76233,1,2,266887,266889,266891,2,4,0
76234,3,3,266890,266891,266894,1,4,0
76235,6,3,266896,266896,266899,0,3,2
76236,6,2,266902,266902,266904,0,2,3
76237,4,1,266906,266906,266907,0,1,2
76238,5,1,266911,266911,266912,0,1,4
76239,1,2,266912,266912,266914,0,2,0
76240,1,2,266913,266914,266916,1,3,0
76241,1,1,266914,266916,266917,2,3,0
76242,4,1,266918,266918,266919,0,1,1
76243,3,3,266921,266921,266924,0,3,2
76244,6,2,266927,266927,266929,0,2,3
76245,6,2,266933,266933,266935,0,2,4
76246,5,2,266938,266938,266940,0,2,3
76247,2,3,266940,266940,266943,0,3,0
76248,3,1,266943,266943,266944,0,1,0
76249,1,2,266944,266944,266946,0,2,0
76250,1,1,266945,266946,266947,1,2,0
76251,1,1,266946,266947,266948,1,2,0
76252,5,1,266951,266951,266952,0,1,3
76253,2,3,266953,266953,266956,0,3,1
76254,3,1,266956,266956,266957,0,1,0
76255,5,3,266961,266961,266964,0,3,4
76256,2,1,266963,266964,266965,1,2,0
76257,1,2,266964,266965,266967,1,3,0
76258,3,1,266967,266967,266968,0,1,0
76259,3,2,266970,266970,266972,0,2,2
76260,3,2,266973,266973,266975,0,2,1
76261,2,2,266975,266975,266977,0,2,0
76262,5,3,266980,266980,266983,0,3,3
76263,5,3,266985,266985,266988,0,3,2
76264,6,1,266991,266991,266992,0,1,3
76265,1,3,266992,266992,266995,0,3,0
76266,1,2,266993,266995,266997,2,4,0
76267,6,2,266999,266999,267001,0,2,2
76268,1,2,267000,267001,267003,1,3,0
76269,6,1,267006,267006,267007,0,1,3
76270,4,2,267010,267010,267012,0,2,3
76271,2,1,267012,267012,267013,0,1,0
76272,3,3,267015,267015,267018,0,3,2
76273,1,3,267016,267018,267021,2,5,0
76274,2,2,267018,267021,267023,3,5,0
76275,2,1,267020,267023,267024,3,4,0
76276,5,1,267025,267025,267026,0,1,1
76277,5,3,267030,267030,267033,0,3,4
76278,1,3,267031,267033,267036,2,5,0
76279,6,3,267037,267037,267040,0,3,1
76280,3,2,267040,267040,267042,0,2,0
76281,6,2,267046,267046,267048,0,2,4
76282,5,1,267051,267051,267052,0,1,3
76283,1,2,267052,267052,267054,0,2,0
76284,5,2,267057,267057,267059,0,2,3
76285,2,1,267059,267059,267060,0,1,0
76286,1,1,267060,267060,267061,0,1,0
76287,5,1,267065,267065,267066,0,1,4
76288,4,1,267069,267069,267070,0,1,3
76289,3,1,267072,267072,267073,0,1,2
76290,6,3,267078,267078,267081,0,3,5
76291,2,2,267080,267081,267083,1,3,0
76292,3,1,267083,267083,267084,0,1,0
76293,6,1,267089,267089,267090,0,1,5
76294,5,2,267094,267094,267096,0,2,4
76295,4,3,267098,267098,267101,0,3,2
76296,5,1,267103,267103,267104,0,1,2
76297,2,1,267105,267105,267106,0,1,1
76298,4,2,267109,267109,267111,0,2,3
76299,5,2,267114,267114,267116,0,2,3
76300,6,2,267120,267120,267122,0,2,4
76301,2,1,267122,267122,267123,0,1,0
76302,5,3,267127,267127,267130,0,3,4
76303,3,2,267130,267130,267132,0,2,0
76304,6,2,267136,267136,267138,0,2,4
76305,1,1,267137,267138,267139,1,2,0
76306,2,3,267139,267139,267142,0,3,0
76307,5,3,267144,267144,267147,0,3,2
76308,3,1,267147,267147,267148,0,1,0
76309,6,1,267153,267153,267154,0,1,5
76310,5,3,267158,267158,267161,0,3,4
76311,5,3,267163,267163,267166,0,3,2
76312,5,1,267168,267168,267169,0,1,2
76313,1,2,267169,267169,267171,0,2,0
76314,4,3,267173,267173,267176,0,3,2
76315,2,1,267175,267176,267177,1,2,0
76316,3,1,267178,267178,267179,0,1,1
76317,6,1,267184,267184,267185,0,1,5
76318,4,3,267188,267188,267191,0,3,3
76319,6,1,267194,267194,267195,0,1,3
76320,3,2,267197,267197,267199,0,2,2
76321,2,2,267199,267199,267201,0,2,0
76322,4,2,267203,267203,267205,0,2,2
76323,5,1,267208,267208,267209,0,1,3
76324,6,1,267214,267214,267215,0,1,5
76325,3,1,267217,267217,267218,0,1,2
76326,1,2,267218,267218,267220,0,2,0
76327,1,2,267219,267220,267222,1,3,0
76328,4,3,267223,267223,267226,0,3,1
76329,4,2,267227,267227,267229,0,2,1
76330,2,3,267229,267229,267232,0,3,0
76331,3,3,267232,267232,267235,0,3,0
76332,5,3,267237,267237,267240,0,3,2
76333,6,2,267243,267243,267245,0,2,3
76334,5,1,267248,267248,267249,0,1,3
76335,2,3,267250,267250,267253,0,3,1
76336,4,1,267254,267254,267255,0,1,1
76337,6,2,267260,267260,267262,0,2,5
76338,6,3,267266,267266,267269,0,3,4
76339,1,1,267267,267269,267270,2,3,0
76340,3,1,267270,267270,267271,0,1,0
76341,4,2,267274,267274,267276,0,2,3
76342,3,2,267277,267277,267279,0,2,1
76343,1,2,267278,267279,267281,1,3,0
76344,4,2,267282,267282,267284,0,2,1
76345,5,3,267287,267287,267290,0,3,3
76346,4,1,267291,267291,267292,0,1,1
76347,6,1,267297,267297,267298,0,1,5
76348,4,1,267301,267301,267302,0,1,3
76349,4,3,267305,267305,267308,0,3,3
76350,1,2,267306,267308,267310,2,4,0
76351,2,2,267308,267310,267312,2,4,0
76352,2,3,267310,267312,267315,2,5,0
76353,4,2,267314,267315,267317,1,3,0
76354,3,2,267317,267317,267319,0,2,0
76355,5,2,267322,267322,267324,0,2,3
76356,6,1,267328,267328,267329,0,1,4
76357,5,2,267333,267333,267335,0,2,4
76358,6,2,267339,267339,267341,0,2,4
76359,3,1,267342,267342,267343,0,1,1
76360,5,1,267347,267347,267348,0,1,4
76361,3,3,267350,267350,267353,0,3,2
76362,1,2,267351,267353,267355,2,4,0
76363,1,1,267352,267355,267356,3,4,0
76364,6,2,267358,267358,267360,0,2,2
76365,3,3,267361,267361,267364,0,3,1
76366,5,3,267366,267366,267369,0,3,2
76367,2,2,267368,267369,267371,1,3,0
76368,1,2,267369,267371,267373,2,4,0
76369,4,1,267373,267373,267374,0,1,0
76370,5,3,267378,267378,267381,0,3,4
76371,1,1,267379,267381,267382,2,3,0
76372,6,3,267385,267385,267388,0,3,3
76373,3,1,267388,267388,267389,0,1,0
76374,3,1,267391,267391,267392,0,1,2
76375,5,2,267396,267396,267398,0,2,4
76376,5,1,267401,267401,267402,0,1,3
76377,2,3,267403,267403,267406,0,3,1
76378,2,2,267405,267406,267408,1,3,0
76379,3,1,267408,267408,267409,0,1,0
76380,1,1,267409,267409,267410,0,1,0
76381,6,3,267415,267415,267418,0,3,5
76382,6,1,267421,267421,267422,0,1,3
76383,6,2,267427,267427,267429,0,2,5
76384,4,2,267431,267431,267433,0,2,2
76385,4,1,267435,267435,267436,0,1,2
76386,4,1,267439,267439,267440,0,1,3
76387,1,3,267440,267440,267443,0,3,0
76388,1,2,267441,267443,267445,2,4,0
76389,1,2,267442,267445,267447,3,5,0
76390,6,3,267448,267448,267451,0,3,1
76391,2,3,267450,267451,267454,1,4,0
76392,4,1,267454,267454,267455,0,1,0
76393,5,1,267459,267459,267460,0,1,4
76394,5,2,267464,267464,267466,0,2,4
76395,2,2,267466,267466,267468,0,2,0
76396,1,2,267467,267468,267470,1,3,0
76397,1,3,267468,267470,267473,2,5,0
76398,4,2,267472,267473,267475,1,3,0
76399,6,3,267478,267478,267481,0,3,3
76400,5,1,267483,267483,267484,0,1,2
76401,1,3,267484,267484,267487,0,3,0
76402,5,2,267489,267489,267491,0,2,2
76403,4,1,267493,267493,267494,0,1,2
76404,5,2,267498,267498,267500,0,2,4
76405,1,2,267499,267500,267502,1,3,0
76406,3,1,267502,267502,267503,0,1,0
76407,4,2,267506,267506,267508,0,2,3
76408,1,1,267507,267508,267509,1,2,0
76409,6,1,267513,267513,267514,0,1,4
76410,6,2,267519,267519,267521,0,2,5
76411,2,2,267521,267521,267523,0,2,0
76412,1,1,267522,267523,267524,1,2,0
76413,3,1,267525,267525,267526,0,1,1
76414,5,1,267530,267530,267531,0,1,4
76415,4,3,267534,267534,267537,0,3,3
76416,4,2,267538,267538,267540,0,2,1
76417,5,1,267543,267543,267544,0,1,3
76418,6,2,267549,267549,267551,0,2,5
76419,4,3,267553,267553,267556,0,3,2
76420,6,2,267559,267559,267561,0,2,3
76421,2,2,267561,267561,267563,0,2,0
76422,6,2,267567,267567,267569,0,2,4
76423,4,1,267571,267571,267572,0,1,2
76424,4,3,267575,267575,267578,0,3,3
76425,6,3,267581,267581,267584,0,3,3
76426,6,1,267587,267587,267588,0,1,3
76427,1,1,267588,267588,267589,0,1,0
76428,2,3,267590,267590,267593,0,3,1
76429,1,2,267591,267593,267595,2,4,0
76430,4,2,267595,267595,267597,0,2,0
76431,2,3,267597,267597,267600,0,3,0
76432,4,3,267601,267601,267604,0,3,1
76433,3,1,267604,267604,267605,0,1,0
76434,6,2,267610,267610,267612,0,2,5
76435,6,2,267616,267616,267618,0,2,4
76436,6,2,267622,267622,267624,0,2,4
76437,5,3,267627,267627,267630,0,3,3
76438,5,1,267632,267632,267633,0,1,2
76439,4,2,267636,267636,267638,0,2,3
76440,5,1,267641,267641,267642,0,1,3
76441,4,1,267645,267645,267646,0,1,3
76442,4,2,267649,267649,267651,0,2,3
76443,6,1,267655,267655,267656,0,1,4
76444,4,3,267659,267659,267662,0,3,3
76445,4,2,267663,267663,267665,0,2,1
76446,5,1,267668,267668,267669,0,1,3
76447,6,1,267674,267674,267675,0,1,5
76448,6,2,267680,267680,267682,0,2,5
76449,1,2,267681,267682,267684,1,3,0
76450,1,1,267682,267684,267685,2,3,0
76451,1,1,267683,267685,267686,2,3,0
76452,2,1,267685,267686,267687,1,2,0
76453,4,2,267689,267689,267691,0,2,2
76454,5,3,267694,267694,267697,0,3,3
76455,4,1,267698,267698,267699,0,1,1
76456,2,3,267700,267700,267703,0,3,1
76457,1,2,267701,267703,267705,2,4,0
76458,2,1,267703,267705,267706,2,3,0
76459,2,2,267705,267706,267708,1,3,0
76460,3,3,267708,267708,267711,0,3,0
76461,1,2,267709,267711,267713,2,4,0
76462,4,1,267713,267713,267714,0,1,0
76463,2,2,267715,267715,267717,0,2,1
76464,1,2,267716,267717,267719,1,3,0
76465,5,1,267721,267721,267722,0,1,2
76466,4,3,267725,267725,267728,0,3,3
76467,6,3,267731,267731,267734,0,3,3
76468,2,2,267733,267734,267736,1,3,0
76469,5,3,267738,267738,267741,0,3,2
76470,6,2,267744,267744,267746,0,2,3
76471,1,3,267745,267746,267749,1,4,0
76472,6,3,267751,267751,267754,0,3,2
76473,3,2,267754,267754,267756,0,2,0
76474,1,1,267755,267756,267757,1,2,0
76475,2,1,267757,267757,267758,0,1,0
76476,4,1,267761,267761,267762,0,1,3
76477,3,1,267764,267764,267765,0,1,2
76478,3,3,267767,267767,267770,0,3,2
76479,2,2,267769,267770,267772,1,3,0
76480,3,2,267772,267772,267774,0,2,0
76481,3,2,267775,267775,267777,0,2,1
76482,2,1,267777,267777,267778,0,1,0
76483,1,1,267778,267778,267779,0,1,0
76484,1,1,267779,267779,267780,0,1,0
76485,4,1,267783,267783,267784,0,1,3
76486,2,2,267785,267785,267787,0,2,1
76487,5,3,267790,267790,267793,0,3,3
76488,2,1,267792,267793,267794,1,2,0
76489,5,3,267797,267797,267800,0,3,3
76490,2,1,267799,267800,267801,1,2,0
76491,3,3,267802,267802,267805,0,3,1
76492,4,3,267806,267806,267809,0,3,1
76493,5,3,267811,267811,267814,0,3,2
76494,4,1,267815,267815,267816,0,1,1
76495,4,1,267819,267819,267820,0,1,3
76496,2,1,267821,267821,267822,0,1,1
76497,3,1,267824,267824,267825,0,1,2
76498,4,2,267828,267828,267830,0,2,3
76499,5,2,267833,267833,267835,0,2,3
76500,4,1,267837,267837,267838,0,1,2
76501,6,1,267843,267843,267844,0,1,5
76502,3,2,267846,267846,267848,0,2,2
76503,4,2,267850,267850,267852,0,2,2
76504,6,3,267856,267856,267859,0,3,4
76505,1,3,267857,267859,267862,2,5,0
76506,4,3,267861,267862,267865,1,4,0
76507,5,3,267866,267866,267869,0,3,1
76508,1,1,267867,267869,267870,2,3,0
76509,3,1,267870,267870,267871,0,1,0
76510,4,2,267874,267874,267876,0,2,3
76511,3,2,267877,267877,267879,0,2,1
76512,1,1,267878,267879,267880,1,2,0
76513,5,1,267883,267883,267884,0,1,3
76514,2,3,267885,267885,267888,0,3,1
76515,5,2,267890,267890,267892,0,2,2
76516,2,2,267892,267892,267894,0,2,0
76517,5,2,267897,267897,267899,0,2,3
76518,4,3,267901,267901,267904,0,3,2
76519,2,3,267903,267904,267907,1,4,0
76520,2,2,267905,267907,267909,2,4,0
76521,1,3,267906,267909,267912,3,6,0
76522,1,1,267907,267912,267913,5,6,0
76523,6,1,267913,267913,267914,0,1,0
76524,3,1,267916,267916,267917,0,1,2
76525,4,1,267920,267920,267921,0,1,3
76526,1,2,267921,267921,267923,0,2,0
76527,5,3,267926,267926,267929,0,3,3
76528,2,2,267928,267929,267931,1,3,0
76529,3,1,267931,267931,267932,0,1,0
76530,4,1,267935,267935,267936,0,1,3
76531,6,2,267941,267941,267943,0,2,5
76532,1,1,267942,267943,267944,1,2,0
76533,5,1,267947,267947,267948,0,1,3
76534,5,3,267952,267952,267955,0,3,4
76535,2,2,267954,267955,267957,1,3,0
76536,6,3,267960,267960,267963,0,3,3
76537,6,2,267966,267966,267968,0,2,3
76538,1,1,267967,267968,267969,1,2,0
76539,3,1,267970,267970,267971,0,1,1
76540,3,3,267973,267973,267976,0,3,2
76541,6,3,267979,267979,267982,0,3,3
76542,3,3,267982,267982,267985,0,3,0
76543,2,2,267984,267985,267987,1,3,0
76544,2,3,267986,267987,267990,1,4,0
76545,3,2,267989,267990,267992,1,3,0
76546,1,1,267990,267992,267993,2,3,0
76547,2,2,267992,267993,267995,1,3,0
76548,3,1,267995,267995,267996,0,1,0
76549,5,3,268000,268000,268003,0,3,4
76550,6,1,268006,268006,268007,0,1,3
76551,6,1,268012,268012,268013,0,1,5
76552,1,3,268013,268013,268016,0,3,0
76553,4,3,268017,268017,268020,0,3,1
76554,3,1,268020,268020,268021,0,1,0
76555,2,3,268022,268022,268025,0,3,1
76556,4,1,268026,268026,268027,0,1,1
76557,3,3,268029,268029,268032,0,3,2
76558,3,1,268032,268032,268033,0,1,0
76559,2,2,268034,268034,268036,0,2,1
76560,5,2,268039,268039,268041,0,2,3
76561,1,1,268040,268041,268042,1,2,0
76562,6,2,268046,268046,268048,0,2,4
76563,4,2,268050,268050,268052,0,2,2
76564,1,1,268051,268052,268053,1,2,0
76565,3,2,268054,268054,268056,0,2,1
76566,6,2,268060,268060,268062,0,2,4
76567,2,1,268062,268062,268063,0,1,0
76568,3,3,268065,268065,268068,0,3,2
76569,6,2,268071,268071,268073,0,2,3
76570,6,1,268077,268077,268078,0,1,4
76571,5,3,268082,268082,268085,0,3,4
76572,1,1,268083,268085,268086,2,3,0
76573,6,2,268089,268089,268091,0,2,3
76574,5,3,268094,268094,268097,0,3,3
76575,5,1,268099,268099,268100,0,1,2
76576,2,3,268101,268101,268104,0,3,1
76577,1,3,268102,268104,268107,2,5,0
76578,4,2,268106,268107,268109,1,3,0
76579,1,3,268107,268109,268112,2,5,0
76580,6,1,268113,268113,268114,0,1,1
76581,5,1,268118,268118,268119,0,1,4
76582,4,2,268122,268122,268124,0,2,3
76583,6,3,268128,268128,268131,0,3,4
76584,3,3,268131,268131,268134,0,3,0
76585,4,3,268135,268135,268138,0,3,1
76586,1,2,268136,268138,268140,2,4,0
76587,6,1,268142,268142,268143,0,1,2
76588,1,3,268143,268143,268146,0,3,0
76589,6,3,268149,268149,268152,0,3,3
76590,4,3,268153,268153,268156,0,3,1
76591,6,3,268159,268159,268162,0,3,3
76592,1,1,268160,268162,268163,2,3,0
76593,3,3,268163,268163,268166,0,3,0
76594,6,1,268169,268169,268170,0,1,3
76595,2,3,268171,268171,268174,0,3,1
76596,1,3,268172,268174,268177,2,5,0
76597,6,2,268178,268178,268180,0,2,1
76598,4,1,268182,268182,268183,0,1,2
76599,5,2,268187,268187,268189,0,2,4
76600,3,1,268190,268190,268191,0,1,1
76601,2,2,268192,268192,268194,0,2,1
76602,1,2,268193,268194,268196,1,3,0
76603,4,1,268197,268197,268198,0,1,1
76604,1,1,268198,268198,268199,0,1,0
76605,5,1,268203,268203,268204,0,1,4
76606,1,3,268204,268204,268207,0,3,0
76607,6,1,268210,268210,268211,0,1,3
76608,6,3,268216,268216,268219,0,3,5
76609,1,3,268217,268219,268222,2,5,0
76610,5,3,268222,268222,268225,0,3,0
76611,6,2,268228,268228,268230,0,2,3
76612,2,1,268230,268230,268231,0,1,0
76613,4,1,268234,268234,268235,0,1,3
76614,3,1,268237,268237,268238,0,1,2
76615,6,3,268243,268243,268246,0,3,5
76616,1,2,268244,268246,268248,2,4,0
76617,2,2,268246,268248,268250,2,4,0
76618,4,1,268250,268250,268251,0,1,0
76619,6,1,268256,268256,268257,0,1,5
76620,3,3,268259,268259,268262,0,3,2
76621,4,2,268263,268263,268265,0,2,1
76622,6,3,268269,268269,268272,0,3,4
76623,1,2,268270,268272,268274,2,4,0
76624,5,3,268275,268275,268278,0,3,1
76625,1,3,268276,268278,268281,2,5,0
76626,5,1,268281,268281,268282,0,1,0
76627,4,2,268285,268285,268287,0,2,3
76628,5,1,268290,268290,268291,0,1,3
76629,4,2,268294,268294,268296,0,2,3
76630,4,2,268298,268298,268300,0,2,2
76631,3,3,268301,268301,268304,0,3,1
76632,2,1,268303,268304,268305,1,2,0
76633,3,2,268306,268306,268308,0,2,1
76634,5,2,268311,268311,268313,0,2,3
76635,1,3,268312,268313,268316,1,4,0
76636,3,1,268315,268316,268317,1,2,0
76637,4,2,268319,268319,268321,0,2,2
76638,1,1,268320,268321,268322,1,2,0
76639,2,2,268322,268322,268324,0,2,0
76640,2,1,268324,268324,268325,0,1,0
76641,2,1,268326,268326,268327,0,1,1
76642,3,1,268329,268329,268330,0,1,2
76643,4,1,268333,268333,268334,0,1,3
76644,3,1,268336,268336,268337,0,1,2
76645,5,3,268341,268341,268344,0,3,4
76646,2,1,268343,268344,268345,1,2,0
76647,1,2,268344,268345,268347,1,3,0
76648,6,1,268350,268350,268351,0,1,3
76649,4,3,268354,268354,268357,0,3,3
76650,6,2,268360,268360,268362,0,2,3
76651,4,2,268364,268364,268366,0,2,2
76652,2,1,268366,268366,268367,0,1,0
76653,2,2,268368,268368,268370,0,2,1
76654,1,1,268369,268370,268371,1,2,0
76655,3,2,268372,268372,268374,0,2,1
76656,3,2,268375,268375,268377,0,2,1
76657,3,2,268378,268378,268380,0,2,1
76658,5,2,268383,268383,268385,0,2,3
76659,1,3,268384,268385,268388,1,4,0
76660,3,3,268387,268388,268391,1,4,0
76661,3,1,268390,268391,268392,1,2,0
76662,4,3,268394,268394,268397,0,3,2
76663,5,2,268399,268399,268401,0,2,2
76664,5,1,268404,268404,268405,0,1,3
76665,4,3,268408,268408,268411,0,3,3
76666,2,1,268410,268411,268412,1,2,0
76667,6,3,268416,268416,268419,0,3,4
76668,3,1,268419,268419,268420,0,1,0
76669,5,1,268424,268424,268425,0,1,4
76670,2,1,268426,268426,268427,0,1,1
76671,6,3,268432,268432,268435,0,3,5
76672,2,1,268434,268435,268436,1,2,0
76673,2,1,268436,268436,268437,0,1,0
76674,6,1,268442,268442,268443,0,1,5
76675,3,3,268445,268445,268448,0,3,2
76676,2,2,268447,268448,268450,1,3,0
76677,2,2,268449,268450,268452,1,3,0
76678,3,2,268452,268452,268454,0,2,0
76679,3,3,268455,268455,268458,0,3,1
76680,1,1,268456,268458,268459,2,3,0
76681,1,2,268457,268459,268461,2,4,0
76682,1,2,268458,268461,268463,3,5,0
76683,1,3,268459,268463,268466,4,7,0
76684,6,1,268465,268466,268467,1,2,0
76685,2,2,268467,268467,268469,0,2,0
76686,2,3,268469,268469,268472,0,3,0
76687,6,3,268475,268475,268478,0,3,3
76688,1,1,268476,268478,268479,2,3,0
76689,3,3,268479,268479,268482,0,3,0
76690,3,3,268482,268482,268485,0,3,0
76691,5,2,268487,268487,268489,0,2,2
76692,2,3,268489,268489,268492,0,3,0
76693,6,3,268495,268495,268498,0,3,3
76694,1,3,268496,268498,268501,2,5,0
76695,3,1,268499,268501,268502,2,3,0
76696,5,2,268504,268504,268506,0,2,2
76697,2,1,268506,268506,268507,0,1,0
76698,2,3,268508,268508,268511,0,3,1
76699,4,2,268512,268512,268514,0,2,1
76700,4,1,268516,268516,268517,0,1,2
76701,6,3,268522,268522,268525,0,3,5
76702,3,2,268525,268525,268527,0,2,0
76703,5,2,268530,268530,268532,0,2,3
76704,1,2,268531,268532,268534,1,3,0
76705,4,3,268535,268535,268538,0,3,1
76706,4,3,268539,268539,268542,0,3,1
76707,3,1,268542,268542,268543,0,1,0
76708,3,1,268545,268545,268546,0,1,2
76709,4,3,268549,268549,268552,0,3,3
76710,5,3,268554,268554,268557,0,3,2
76711,6,3,268560,268560,268563,0,3,3
76712,2,2,268562,268563,268565,1,3,0
76713,4,1,268566,268566,268567,0,1,1
76714,4,1,268570,268570,268571,0,1,3
76715,4,3,268574,268574,268577,0,3,3
76716,1,1,268575,268577,268578,2,3,0
76717,6,2,268581,268581,268583,0,2,3
76718,2,1,268583,268583,268584,0,1,0
76719,5,3,268588,268588,268591,0,3,4
76720,5,1,268593,268593,268594,0,1,2
76721,5,1,268598,268598,268599,0,1,4
76722,2,1,268600,268600,268601,0,1,1
76723,5,1,268605,268605,268606,0,1,4
76724,2,2,268607,268607,268609,0,2,1
76725,3,2,268610,268610,268612,0,2,1
76726,6,1,268616,268616,268617,0,1,4
76727,4,1,268620,268620,268621,0,1,3
76728,4,3,268624,268624,268627,0,3,3
76729,1,3,268625,268627,268630,2,5,0
76730,2,1,268627,268630,268631,3,4,0
76731,5,1,268632,268632,268633,0,1,1
76732,3,3,268635,268635,268638,0,3,2
76733,4,3,268639,268639,268642,0,3,1
76734,5,3,268644,268644,268647,0,3,2
76735,2,3,268646,268647,268650,1,4,0
76736,2,1,268648,268650,268651,2,3,0
76737,1,3,268649,268651,268654,2,5,0
76738,2,2,268651,268654,268656,3,5,0
76739,3,3,268654,268656,268659,2,5,0
76740,2,1,268656,268659,268660,3,4,0
76741,5,1,268661,268661,268662,0,1,1
76742,3,1,268664,268664,268665,0,1,2
76743,3,3,268667,268667,268670,0,3,2
76744,4,3,268671,268671,268674,0,3,1
76745,5,1,268676,268676,268677,0,1,2
76746,4,3,268680,268680,268683,0,3,3
76747,4,3,268684,268684,268687,0,3,1
76748,3,2,268687,268687,268689,0,2,0
76749,2,3,268689,268689,268692,0,3,0
76750,5,2,268694,268694,268696,0,2,2
76751,2,1,268696,268696,268697,0,1,0
76752,6,1,268702,268702,268703,0,1,5
76753,5,3,268707,268707,268710,0,3,4
76754,3,3,268710,268710,268713,0,3,0
76755,3,3,268713,268713,268716,0,3,0
76756,1,2,268714,268716,268718,2,4,0
76757,2,1,268716,268718,268719,2,3,0
76758,6,1,268722,268722,268723,0,1,3
76759,4,2,268726,268726,268728,0,2,3
76760,4,1,268730,268730,268731,0,1,2
76761,6,2,268736,268736,268738,0,2,5
76762,3,1,268739,268739,268740,0,1,1
76763,4,1,268743,268743,268744,0,1,3
76764,6,3,268749,268749,268752,0,3,5
76765,2,1,268751,268752,268753,1,2,0
76766,5,3,268756,268756,268759,0,3,3
76767,6,2,268762,268762,268764,0,2,3
76768,2,2,268764,268764,268766,0,2,0
76769,4,3,268768,268768,268771,0,3,2
76770,6,3,268774,268774,268777,0,3,3
76771,2,2,268776,268777,268779,1,3,0
76772,1,1,268777,268779,268780,2,3,0
76773,2,1,268779,268780,268781,1,2,0
76774,2,1,268781,268781,268782,0,1,0
76775,2,1,268783,268783,268784,0,1,1
76776,6,2,268789,268789,268791,0,2,5
76777,1,1,268790,268791,268792,1,2,0
76778,1,1,268791,268792,268793,1,2,0
76779,3,2,268794,268794,268796,0,2,1
76780,5,3,268799,268799,268802,0,3,3
76781,3,1,268802,268802,268803,0,1,0
76782,6,1,268808,268808,268809,0,1,5
76783,4,1,268812,268812,268813,0,1,3
76784,1,1,268813,268813,268814,0,1,0
76785,6,2,268819,268819,268821,0,2,5
76786,1,2,268820,268821,268823,1,3,0
76787,2,1,268822,268823,268824,1,2,0
76788,1,2,268823,268824,268826,1,3,0
76789,6,1,268829,268829,268830,0,1,3
76790,3,2,268832,268832,268834,0,2,2
76791,5,3,268837,268837,268840,0,3,3
76792,1,1,268838,268840,268841,2,3,0
76793,1,3,268839,268841,268844,2,5,0
76794,3,3,268842,268844,268847,2,5,0
76795,3,1,268845,268847,268848,2,3,0
76796,5,2,268850,268850,268852,0,2,2
76797,4,2,268854,268854,268856,0,2,2
76798,5,2,268859,268859,268861,0,2,3
76799,3,2,268862,268862,268864,0,2,1
76800,4,2,268866,268866,268868,0,2,2
76801,2,3,268868,268868,268871,0,3,0
76802,5,1,268873,268873,268874,0,1,2
76803,3,1,268876,268876,268877,0,1,2
76804,1,1,268877,268877,268878,0,1,0
76805,5,2,268882,268882,268884,0,2,4
76806,5,1,268887,268887,268888,0,1,3
76807,2,3,268889,268889,268892,0,3,1
76808,1,3,268890,268892,268895,2,5,0
76809,2,3,268892,268895,268898,3,6,0
76810,5,2,268897,268898,268900,1,3,0
76811,5,2,268902,268902,268904,0,2,2
76812,5,1,268907,268907,268908,0,1,3
76813,1,1,268908,268908,268909,0,1,0
76814,2,3,268910,268910,268913,0,3,1
76815,4,1,268914,268914,268915,0,1,1
76816,1,2,268915,268915,268917,0,2,0
76817,2,3,268917,268917,268920,0,3,0
76818,1,3,268918,268920,268923,2,5,0
76819,5,2,268923,268923,268925,0,2,0
76820,5,3,268928,268928,268931,0,3,3
76821,1,1,268929,268931,268932,2,3,0
76822,3,2,268932,268932,268934,0,2,0
76823,2,3,268934,268934,268937,0,3,0
76824,6,3,268940,268940,268943,0,3,3
76825,6,3,268946,268946,268949,0,3,3
76826,6,3,268952,268952,268955,0,3,3
76827,6,1,268958,268958,268959,0,1,3
76828,4,1,268962,268962,268963,0,1,3
76829,5,3,268967,268967,268970,0,3,4
76830,5,3,268972,268972,268975,0,3,2
76831,2,2,268974,268975,268977,1,3,0
76832,1,1,268975,268977,268978,2,3,0
76833,2,3,268977,268978,268981,1,4,0
76834,5,2,268982,268982,268984,0,2,1
76835,5,2,268987,268987,268989,0,2,3
76836,6,1,268993,268993,268994,0,1,4
76837,1,1,268994,268994,268995,0,1,0
76838,1,2,268995,268995,268997,0,2,0
76839,3,1,268998,268998,268999,0,1,1
76840,6,1,269004,269004,269005,0,1,5
76841,3,2,269007,269007,269009,0,2,2
76842,5,1,269012,269012,269013,0,1,3
76843,1,1,269013,269013,269014,0,1,0
76844,1,3,269014,269014,269017,0,3,0
76845,3,2,269017,269017,269019,0,2,0
76846,2,1,269019,269019,269020,0,1,0
76847,4,1,269023,269023,269024,0,1,3
76848,4,3,269027,269027,269030,0,3,3
76849,2,1,269029,269030,269031,1,2,0
76850,3,3,269032,269032,269035,0,3,1
76851,4,1,269036,269036,269037,0,1,1
76852,1,2,269037,269037,269039,0,2,0
76853,6,2,269043,269043,269045,0,2,4
76854,4,1,269047,269047,269048,0,1,2
76855,6,1,269053,269053,269054,0,1,5
76856,6,1,269059,269059,269060,0,1,5
76857,2,1,269061,269061,269062,0,1,1
76858,5,3,269066,269066,269069,0,3,4
76859,5,3,269071,269071,269074,0,3,2
76860,5,3,269076,269076,269079,0,3,2
76861,4,2,269080,269080,269082,0,2,1
76862,3,2,269083,269083,269085,0,2,1
76863,5,2,269088,269088,269090,0,2,3
76864,5,3,269093,269093,269096,0,3,3
76865,4,2,269097,269097,269099,0,2,1
76866,6,2,269103,269103,269105,0,2,4
76867,2,3,269105,269105,269108,0,3,0
76868,4,2,269109,269109,269111,0,2,1
76869,2,1,269111,269111,269112,0,1,0
76870,4,1,269115,269115,269116,0,1,3
76871,5,1,269120,269120,269121,0,1,4
76872,6,2,269126,269126,269128,0,2,5
76873,5,3,269131,269131,269134,0,3,3
76874,1,1,269132,269134,269135,2,3,0
76875,5,3,269137,269137,269140,0,3,2
76876,1,1,269138,269140,269141,2,3,0
76877,2,2,269140,269141,269143,1,3,0
76878,1,1,269141,269143,269144,2,3,0
76879,2,2,269143,269144,269146,1,3,0
76880,6,2,269149,269149,269151,0,2,3
76881,5,1,269154,269154,269155,0,1,3
76882,3,3,269157,269157,269160,0,3,2
76883,6,2,269163,269163,269165,0,2,3
76884,2,2,269165,269165,269167,0,2,0
76885,2,2,269167,269167,269169,0,2,0
76886,6,1,269173,269173,269174,0,1,4
76887,3,1,269176,269176,269177,0,1,2
76888,3,3,269179,269179,269182,0,3,2
76889,6,1,269185,269185,269186,0,1,3
76890,1,3,269186,269186,269189,0,3,0
76891,3,2,269189,269189,269191,0,2,0
76892,2,3,269191,269191,269194,0,3,0
76893,1,1,269192,269194,269195,2,3,0
76894,1,1,269193,269195,269196,2,3,0
76895,6,3,269199,269199,269202,0,3,3
76896,5,3,269204,269204,269207,0,3,2
76897,6,2,269210,269210,269212,0,2,3
76898,6,2,269216,269216,269218,0,2,4
76899,3,1,269219,269219,269220,0,1,1
76900,6,3,269225,269225,269228,0,3,5
76901,2,3,269227,269228,269231,1,4,0
76902,6,2,269233,269233,269235,0,2,2
76903,3,2,269236,269236,269238,0,2,1
76904,1,3,269237,269238,269241,1,4,0
76905,5,2,269242,269242,269244,0,2,1
76906,2,3,269244,269244,269247,0,3,0
76907,3,1,269247,269247,269248,0,1,0
76908,3,1,269250,269250,269251,0,1,2
76909,4,3,269254,269254,269257,0,3,3
76910,6,3,269260,269260,269263,0,3,3
76911,2,3,269262,269263,269266,1,4,0
76912,6,3,269268,269268,269271,0,3,2
76913,4,1,269272,269272,269273,0,1,1
76914,4,1,269276,269276,269277,0,1,3
76915,5,3,269281,269281,269284,0,3,4
76916,4,3,269285,269285,269288,0,3,1
76917,1,3,269286,269288,269291,2,5,0
76918,3,1,269289,269291,269292,2,3,0
76919,6,2,269295,269295,269297,0,2,3
76920,6,2,269301,269301,269303,0,2,4
76921,4,1,269305,269305,269306,0,1,2
76922,4,2,269309,269309,269311,0,2,3
76923,6,1,269315,269315,269316,0,1,4
76924,4,1,269319,269319,269320,0,1,3
76925,6,1,269325,269325,269326,0,1,5
76926,4,2,269329,269329,269331,0,2,3
76927,3,3,269332,269332,269335,0,3,1
76928,3,3,269335,269335,269338,0,3,0
76929,3,3,269338,269338,269341,0,3,0
76930,2,3,269340,269341,269344,1,4,0
76931,5,1,269345,269345,269346,0,1,1
76932,2,2,269347,269347,269349,0,2,1
76933,1,2,269348,269349,269351,1,3,0
76934,6,1,269354,269354,269355,0,1,3
76935,2,1,269356,269356,269357,0,1,1
76936,1,3,269357,269357,269360,0,3,0
76937,2,1,269359,269360,269361,1,2,0
76938,2,2,269361,269361,269363,0,2,0
76939,1,2,269362,269363,269365,1,3,0
76940,2,3,269364,269365,269368,1,4,0
76941,2,2,269366,269368,269370,2,4,0
76942,5,2,269371,269371,269373,0,2,1
76943,6,2,269377,269377,269379,0,2,4
76944,5,2,269382,269382,269384,0,2,3
76945,4,2,269386,269386,269388,0,2,2
76946,6,3,269392,269392,269395,0,3,4
76947,1,2,269393,269395,269397,2,4,0
76948,4,3,269397,269397,269400,0,3,0
76949,4,2,269401,269401,269403,0,2,1
76950,2,3,269403,269403,269406,0,3,0
76951,1,3,269404,269406,269409,2,5,0
76952,4,2,269408,269409,269411,1,3,0
76953,5,1,269413,269413,269414,0,1,2
76954,1,2,269414,269414,269416,0,2,0
76955,3,1,269417,269417,269418,0,1,1
76956,1,2,269418,269418,269420,0,2,0
76957,1,3,269419,269420,269423,1,4,0
76958,1,2,269420,269423,269425,3,5,0
76959,2,2,269422,269425,269427,3,5,0
76960,4,3,269426,269427,269430,1,4,0
76961,5,2,269431,269431,269433,0,2,1
76962,3,2,269434,269434,269436,0,2,1
76963,4,3,269438,269438,269441,0,3,2
76964,4,1,269442,269442,269443,0,1,1
76965,6,3,269448,269448,269451,0,3,5
76966,2,3,269450,269451,269454,1,4,0
76967,5,1,269455,269455,269456,0,1,1
76968,6,2,269461,269461,269463,0,2,5
76969,1,2,269462,269463,269465,1,3,0
76970,1,3,269463,269465,269468,2,5,0
76971,1,2,269464,269468,269470,4,6,0
76972,6,2,269470,269470,269472,0,2,0
76973,1,3,269471,269472,269475,1,4,0
76974,6,2,269477,269477,269479,0,2,2
76975,6,2,269483,269483,269485,0,2,4
76976,1,3,269484,269485,269488,1,4,0
76977,4,2,269488,269488,269490,0,2,0
76978,1,1,269489,269490,269491,1,2,0
76979,3,3,269492,269492,269495,0,3,1
76980,3,1,269495,269495,269496,0,1,0
76981,2,3,269497,269497,269500,0,3,1
76982,5,3,269502,269502,269505,0,3,2
76983,4,2,269506,269506,269508,0,2,1
76984,2,2,269508,269508,269510,0,2,0
76985,2,2,269510,269510,269512,0,2,0
76986,6,3,269516,269516,269519,0,3,4
76987,1,1,269517,269519,269520,2,3,0
76988,4,2,269521,269521,269523,0,2,1
76989,4,2,269525,269525,269527,0,2,2
76990,6,1,269531,269531,269532,0,1,4
76991,6,3,269537,269537,269540,0,3,5
76992,1,3,269538,269540,269543,2,5,0
76993,2,1,269540,269543,269544,3,4,0
76994,3,2,269543,269544,269546,1,3,0
76995,4,3,269547,269547,269550,0,3,1
76996,3,2,269550,269550,269552,0,2,0
76997,5,2,269555,269555,269557,0,2,3
76998,5,3,269560,269560,269563,0,3,3
76999,4,2,269564,269564,269566,0,2,1
77000,6,1,269570,269570,269571,0,1,4
77001,4,1,269574,269574,269575,0,1,3
77002,3,1,269577,269577,269578,0,1,2
77003,1,2,269578,269578,269580,0,2,0
77004,4,1,269582,269582,269583,0,1,2
77005,3,3,269585,269585,269588,0,3,2
77006,1,2,269586,269588,269590,2,4,0
77007,1,3,269587,269590,269593,3,6,0
77008,2,1,269589,269593,269594,4,5,0
77009,3,1,269592,269594,269595,2,3,0
77010,6,1,269598,269598,269599,0,1,3
77011,4,1,269602,269602,269603,0,1,3
77012,3,2,269605,269605,269607,0,2,2
77013,1,1,269606,269607,269608,1,2,0
77014,3,3,269609,269609,269612,0,3,1
77015,6,3,269615,269615,269618,0,3,3
77016,1,2,269616,269618,269620,2,4,0
77017,2,3,269618,269620,269623,2,5,0
77018,3,3,269621,269623,269626,2,5,0
77019,4,3,269625,269626,269629,1,4,0
77020,5,1,269630,269630,269631,0,1,1
77021,6,3,269636,269636,269639,0,3,5
77022,2,3,269638,269639,269642,1,4,0
77023,6,3,269644,269644,269647,0,3,2
77024,2,3,269646,269647,269650,1,4,0
77025,5,2,269651,269651,269653,0,2,1
77026,5,1,269656,269656,269657,0,1,3
77027,1,1,269657,269657,269658,0,1,0
77028,2,1,269659,269659,269660,0,1,1
77029,2,2,269661,269661,269663,0,2,1
77030,3,3,269664,269664,269667,0,3,1
77031,4,2,269668,269668,269670,0,2,1
77032,5,3,269673,269673,269676,0,3,3
77033,6,1,269679,269679,269680,0,1,3
77034,4,2,269683,269683,269685,0,2,3
77035,6,2,269689,269689,269691,0,2,4
77036,4,1,269693,269693,269694,0,1,2
77037,4,3,269697,269697,269700,0,3,3
77038,4,2,269701,269701,269703,0,2,1
77039,3,2,269704,269704,269706,0,2,1
77040,3,3,269707,269707,269710,0,3,1
77041,3,3,269710,269710,269713,0,3,0
77042,5,2,269715,269715,269717,0,2,2
77043,1,1,269716,269717,269718,1,2,0
77044,2,3,269718,269718,269721,0,3,0
77045,3,2,269721,269721,269723,0,2,0
77046,1,2,269722,269723,269725,1,3,0
77047,1,1,269723,269725,269726,2,3,0
77048,1,3,269724,269726,269729,2,5,0
77049,1,2,269725,269729,269731,4,6,0
77050,1,2,269726,269731,269733,5,7,0
77051,5,3,269731,269733,269736,2,5,0
77052,3,3,269734,269736,269739,2,5,0
77053,6,3,269740,269740,269743,0,3,1
77054,1,1,269741,269743,269744,2,3,0
77055,1,3,269742,269744,269747,2,5,0
77056,3,1,269745,269747,269748,2,3,0
77057,3,3,269748,269748,269751,0,3,0
77058,3,1,269751,269751,269752,0,1,0
77059,2,1,269753,269753,269754,0,1,1
77060,5,2,269758,269758,269760,0,2,4
77061,6,1,269764,269764,269765,0,1,4
77062,2,3,269766,269766,269769,0,3,1
77063,3,2,269769,269769,269771,0,2,0
77064,2,2,269771,269771,269773,0,2,0
77065,2,3,269773,269773,269776,0,3,0
77066,5,1,269778,269778,269779,0,1,2
77067,4,2,269782,269782,269784,0,2,3
77068,2,3,269784,269784,269787,0,3,0
77069,3,1,269787,269787,269788,0,1,0
77070,6,2,269793,269793,269795,0,2,5
77071,2,3,269795,269795,269798,0,3,0
77072,6,3,269801,269801,269804,0,3,3
77073,5,1,269806,269806,269807,0,1,2
77074,1,1,269807,269807,269808,0,1,0
77075,4,1,269811,269811,269812,0,1,3
77076,2,1,269813,269813,269814,0,1,1
77077,1,2,269814,269814,269816,0,2,0
77078,6,3,269820,269820,269823,0,3,4
77079,1,1,269821,269823,269824,2,3,0
77080,3,2,269824,269824,269826,0,2,0
77081,2,1,269826,269826,269827,0,1,0
77082,2,1,269828,269828,269829,0,1,1
77083,6,1,269834,269834,269835,0,1,5
77084,2,1,269836,269836,269837,0,1,1
77085,6,1,269842,269842,269843,0,1,5
77086,3,3,269845,269845,269848,0,3,2
77087,5,1,269850,269850,269851,0,1,2
77088,6,2,269856,269856,269858,0,2,5
77089,4,3,269860,269860,269863,0,3,2
77090,3,1,269863,269863,269864,0,1,0
77091,5,3,269868,269868,269871,0,3,4
77092,1,1,269869,269871,269872,2,3,0
77093,2,3,269871,269872,269875,1,4,0
77094,5,1,269876,269876,269877,0,1,1
77095,2,3,269878,269878,269881,0,3,1
77096,4,3,269882,269882,269885,0,3,1
77097,2,1,269884,269885,269886,1,2,0
77098,4,2,269888,269888,269890,0,2,2
77099,2,3,269890,269890,269893,0,3,0
77100,6,2,269896,269896,269898,0,2,3
77101,5,3,269901,269901,269904,0,3,3
77102,4,2,269905,269905,269907,0,2,1
77103,6,3,269911,269911,269914,0,3,4
77104,5,1,269916,269916,269917,0,1,2
77105,4,2,269920,269920,269922,0,2,3
77106,5,2,269925,269925,269927,0,2,3
77107,1,2,269926,269927,269929,1,3,0
77108,2,2,269928,269929,269931,1,3,0
77109,3,2,269931,269931,269933,0,2,0
77110,6,3,269937,269937,269940,0,3,4
77111,6,2,269943,269943,269945,0,2,3
77112,4,1,269947,269947,269948,0,1,2
77113,6,3,269953,269953,269956,0,3,5
77114,4,3,269957,269957,269960,0,3,1
77115,3,2,269960,269960,269962,0,2,0
77116,5,2,269965,269965,269967,0,2,3
77117,2,1,269967,269967,269968,0,1,0
77118,6,1,269973,269973,269974,0,1,5
77119,3,3,269976,269976,269979,0,3,2
77120,2,3,269978,269979,269982,1,4,0
77121,5,3,269983,269983,269986,0,3,1
77122,5,2,269988,269988,269990,0,2,2
77123,4,1,269992,269992,269993,0,1,2
77124,3,3,269995,269995,269998,0,3,2
77125,1,3,269996,269998,270001,2,5,0
77126,4,1,270000,270001,270002,1,2,0
77127,3,2,270003,270003,270005,0,2,1
77128,2,2,270005,270005,270007,0,2,0
77129,4,2,270009,270009,270011,0,2,2
77130,6,1,270015,270015,270016,0,1,4
77131,4,2,270019,270019,270021,0,2,3
77132,5,3,270024,270024,270027,0,3,3
77133,6,1,270030,270030,270031,0,1,3
77134,6,1,270036,270036,270037,0,1,5
77135,4,3,270040,270040,270043,0,3,3
77136,4,1,270044,270044,270045,0,1,1
77137,5,2,270049,270049,270051,0,2,4
77138,6,1,270055,270055,270056,0,1,4
77139,6,3,270061,270061,270064,0,3,5
77140,3,3,270064,270064,270067,0,3,0
77141,6,1,270070,270070,270071,0,1,3
77142,2,2,270072,270072,270074,0,2,1
77143,1,3,270073,270074,270077,1,4,0
77144,6,3,270079,270079,270082,0,3,2
77145,4,1,270083,270083,270084,0,1,1
77146,3,1,270086,270086,270087,0,1,2
77147,5,1,270091,270091,270092,0,1,4
77148,4,3,270095,270095,270098,0,3,3
77149,5,3,270100,270100,270103,0,3,2
77150,4,3,270104,270104,270107,0,3,1
77151,1,3,270105,270107,270110,2,5,0
77152,6,1,270111,270111,270112,0,1,1
77153,5,1,270116,270116,270117,0,1,4
77154,6,1,270122,270122,270123,0,1,5
77155,1,1,270123,270123,270124,0,1,0
77156,1,3,270124,270124,270127,0,3,0
77157,5,3,270129,270129,270132,0,3,2
77158,4,1,270133,270133,270134,0,1,1
77159,4,2,270137,270137,270139,0,2,3
77160,6,2,270143,270143,270145,0,2,4
77161,1,1,270144,270145,270146,1,2,0
77162,4,1,270148,270148,270149,0,1,2
77163,5,2,270153,270153,270155,0,2,4
77164,5,1,270158,270158,270159,0,1,3
77165,6,2,270164,270164,270166,0,2,5
77166,4,2,270168,270168,270170,0,2,2
77167,1,3,270169,270170,270173,1,4,0
77168,5,3,270174,270174,270177,0,3,1
77169,4,1,270178,270178,270179,0,1,1
77170,5,2,270183,270183,270185,0,2,4
77171,2,1,270185,270185,270186,0,1,0
77172,2,1,270187,270187,270188,0,1,1
77173,3,3,270190,270190,270193,0,3,2
77174,6,1,270196,270196,270197,0,1,3
77175,5,3,270201,270201,270204,0,3,4
77176,5,3,270206,270206,270209,0,3,2
77177,5,1,270211,270211,270212,0,1,2
77178,2,2,270213,270213,270215,0,2,1
77179,5,1,270218,270218,270219,0,1,3
77180,6,3,270224,270224,270227,0,3,5
77181,6,2,270230,270230,270232,0,2,3
77182,5,3,270235,270235,270238,0,3,3
77183,6,3,270241,270241,270244,0,3,3
77184,4,3,270245,270245,270248,0,3,1
77185,3,1,270248,270248,270249,0,1,0
77186,2,3,270250,270250,270253,0,3,1
77187,1,2,270251,270253,270255,2,4,0
77188,3,2,270254,270255,270257,1,3,0
77189,6,1,270260,270260,270261,0,1,3
77190,5,3,270265,270265,270268,0,3,4
77191,2,3,270267,270268,270271,1,4,0
77192,5,3,270272,270272,270275,0,3,1
77193,6,3,270278,270278,270281,0,3,3
77194,4,3,270282,270282,270285,0,3,1
77195,6,1,270288,270288,270289,0,1,3
77196,3,3,270291,270291,270294,0,3,2
77197,4,1,270295,270295,270296,0,1,1
77198,3,1,270298,270298,270299,0,1,2
77199,4,2,270302,270302,270304,0,2,3
77200,3,2,270305,270305,270307,0,2,1
77201,4,3,270309,270309,270312,0,3,2
77202,2,3,270311,270312,270315,1,4,0
77203,6,3,270317,270317,270320,0,3,2
77204,4,1,270321,270321,270322,0,1,1
77205,3,3,270324,270324,270327,0,3,2
77206,5,1,270329,270329,270330,0,1,2
77207,2,1,270331,270331,270332,0,1,1
77208,5,2,270336,270336,270338,0,2,4
77209,4,1,270340,270340,270341,0,1,2
77210,2,2,270342,270342,270344,0,2,1
77211,3,1,270345,270345,270346,0,1,1
77212,4,1,270349,270349,270350,0,1,3
77213,2,3,270351,270351,270354,0,3,1
77214,4,3,270355,270355,270358,0,3,1
77215,4,1,270359,270359,270360,0,1,1
77216,1,1,270360,270360,270361,0,1,0
77217,1,2,270361,270361,270363,0,2,0
77218,5,1,270366,270366,270367,0,1,3
77219,6,1,270372,270372,270373,0,1,5
77220,4,2,270376,270376,270378,0,2,3
77221,5,3,270381,270381,270384,0,3,3
77222,1,2,270382,270384,270386,2,4,0
77223,2,1,270384,270386,270387,2,3,0
77224,1,2,270385,270387,270389,2,4,0
77225,2,2,270387,270389,270391,2,4,0
77226,2,1,270389,270391,270392,2,3,0
77227,4,3,270393,270393,270396,0,3,1
77228,5,2,270398,270398,270400,0,2,2
77229,6,3,270404,270404,270407,0,3,4
77230,6,3,270410,270410,270413,0,3,3
77231,6,3,270416,270416,270419,0,3,3
77232,3,2,270419,270419,270421,0,2,0
77233,2,3,270421,270421,270424,0,3,0
77234,1,2,270422,270424,270426,2,4,0
77235,6,2,270428,270428,270430,0,2,2
77236,6,1,270434,270434,270435,0,1,4
77237,2,2,270436,270436,270438,0,2,1
77238,2,1,270438,270438,270439,0,1,0
77239,3,2,270441,270441,270443,0,2,2
77240,6,2,270447,270447,270449,0,2,4
77241,3,1,270450,270450,270451,0,1,1
77242,6,2,270456,270456,270458,0,2,5
77243,3,2,270459,270459,270461,0,2,1
77244,6,3,270465,270465,270468,0,3,4
77245,6,2,270471,270471,270473,0,2,3
77246,3,1,270474,270474,270475,0,1,1
77247,3,3,270477,270477,270480,0,3,2
77248,4,2,270481,270481,270483,0,2,1
77249,3,3,270484,270484,270487,0,3,1
77250,3,1,270487,270487,270488,0,1,0
77251,2,1,270489,270489,270490,0,1,1
77252,2,3,270491,270491,270494,0,3,1
77253,3,3,270494,270494,270497,0,3,0
77254,3,1,270497,270497,270498,0,1,0
77255,6,3,270503,270503,270506,0,3,5
77256,5,3,270508,270508,270511,0,3,2
77257,1,2,270509,270511,270513,2,4,0
77258,2,1,270511,270513,270514,2,3,0
77259,3,3,270514,270514,270517,0,3,0
77260,5,2,270519,270519,270521,0,2,2
77261,2,3,270521,270521,270524,0,3,0
77262,2,3,270523,270524,270527,1,4,0
77263,2,3,270525,270527,270530,2,5,0
77264,6,3,270531,270531,270534,0,3,1
77265,3,2,270534,270534,270536,0,2,0
77266,4,2,270538,270538,270540,0,2,2
77267,2,2,270540,270540,270542,0,2,0
77268,2,1,270542,270542,270543,0,1,0
77269,1,1,270543,270543,270544,0,1,0
77270,3,3,270546,270546,270549,0,3,2
77271,1,3,270547,270549,270552,2,5,0
77272,3,2,270550,270552,270554,2,4,0
77273,2,1,270552,270554,270555,2,3,0
77274,1,2,270553,270555,270557,2,4,0
77275,4,2,270557,270557,270559,0,2,0
77276,5,3,270562,270562,270565,0,3,3
77277,5,1,270567,270567,270568,0,1,2
77278,5,3,270572,270572,270575,0,3,4
77279,1,3,270573,270575,270578,2,5,0
77280,1,2,270574,270578,270580,4,6,0
77281,5,2,270579,270580,270582,1,3,0
77282,6,1,270585,270585,270586,0,1,3
77283,5,1,270590,270590,270591,0,1,4
77284,2,1,270592,270592,270593,0,1,1
77285,3,3,270595,270595,270598,0,3,2
77286,2,2,270597,270598,270600,1,3,0
77287,5,1,270602,270602,270603,0,1,2
77288,1,2,270603,270603,270605,0,2,0
77289,3,2,270606,270606,270608,0,2,1
77290,5,1,270611,270611,270612,0,1,3
77291,6,1,270617,270617,270618,0,1,5
77292,1,1,270618,270618,270619,0,1,0
77293,5,3,270623,270623,270626,0,3,4
77294,5,1,270628,270628,270629,0,1,2
77295,2,1,270630,270630,270631,0,1,1
77296,4,1,270634,270634,270635,0,1,3
77297,4,3,270638,270638,270641,0,3,3
77298,5,1,270643,270643,270644,0,1,2
77299,4,3,270647,270647,270650,0,3,3
77300,3,3,270650,270650,270653,0,3,0
77301,3,1,270653,270653,270654,0,1,0
77302,1,3,270654,270654,270657,0,3,0
77303,1,2,270655,270657,270659,2,4,0
77304,3,3,270658,270659,270662,1,4,0
77305,3,3,270661,270662,270665,1,4,0
77306,1,2,270662,270665,270667,3,5,0
77307,1,2,270663,270667,270669,4,6,0
77308,4,3,270667,270669,270672,2,5,0
77309,2,1,270669,270672,270673,3,4,0
77310,1,2,270670,270673,270675,3,5,0
77311,6,2,270676,270676,270678,0,2,1
77312,6,2,270682,270682,270684,0,2,4
77313,4,1,270686,270686,270687,0,1,2
77314,1,1,270687,270687,270688,0,1,0
77315,4,3,270691,270691,270694,0,3,3
77316,3,2,270694,270694,270696,0,2,0
77317,2,2,270696,270696,270698,0,2,0
77318,6,1,270702,270702,270703,0,1,4
77319,4,2,270706,270706,270708,0,2,3
77320,3,3,270709,270709,270712,0,3,1
77321,5,3,270714,270714,270717,0,3,2
77322,4,1,270718,270718,270719,0,1,1
77323,5,3,270723,270723,270726,0,3,4
77324,2,1,270725,270726,270727,1,2,0
77325,1,1,270726,270727,270728,1,2,0
77326,1,1,270727,270728,270729,1,2,0
77327,4,3,270731,270731,270734,0,3,2
77328,4,3,270735,270735,270738,0,3,1
77329,4,2,270739,270739,270741,0,2,1
77330,2,1,270741,270741,270742,0,1,0
77331,5,1,270746,270746,270747,0,1,4
77332,6,1,270752,270752,270753,0,1,5
77333,3,1,270755,270755,270756,0,1,2
77334,6,1,270761,270761,270762,0,1,5
77335,1,1,270762,270762,270763,0,1,0
77336,3,1,270765,270765,270766,0,1,2
77337,4,3,270769,270769,270772,0,3,3
77338,1,2,270770,270772,270774,2,4,0
77339,2,2,270772,270774,270776,2,4,0
77340,3,2,270775,270776,270778,1,3,0
77341,5,1,270780,270780,270781,0,1,2
77342,6,2,270786,270786,270788,0,2,5
77343,5,3,270791,270791,270794,0,3,3
77344,2,3,270793,270794,270797,1,4,0
77345,4,2,270797,270797,270799,0,2,0
77346,6,3,270803,270803,270806,0,3,4
77347,3,1,270806,270806,270807,0,1,0
77348,1,2,270807,270807,270809,0,2,0
77349,3,1,270810,270810,270811,0,1,1
77350,2,1,270812,270812,270813,0,1,1
77351,2,2,270814,270814,270816,0,2,1
77352,6,3,270820,270820,270823,0,3,4
77353,1,1,270821,270823,270824,2,3,0
77354,3,2,270824,270824,270826,0,2,0
77355,1,1,270825,270826,270827,1,2,0
77356,1,3,270826,270827,270830,1,4,0
77357,4,3,270830,270830,270833,0,3,0
77358,2,2,270832,270833,270835,1,3,0
77359,3,3,270835,270835,270838,0,3,0
77360,1,3,270836,270838,270841,2,5,0
77361,2,2,270838,270841,270843,3,5,0
77362,1,3,270839,270843,270846,4,7,0
77363,5,3,270844,270846,270849,2,5,0
77364,5,1,270849,270849,270850,0,1,0
77365,5,1,270854,270854,270855,0,1,4
77366,5,2,270859,270859,270861,0,2,4
77367,4,2,270863,270863,270865,0,2,2
77368,1,3,270864,270865,270868,1,4,0
77369,6,2,270870,270870,270872,0,2,2
77370,3,2,270873,270873,270875,0,2,1
77371,2,2,270875,270875,270877,0,2,0
77372,6,1,270881,270881,270882,0,1,4
77373,2,3,270883,270883,270886,0,3,1
77374,4,2,270887,270887,270889,0,2,1
77375,3,1,270890,270890,270891,0,1,1
77376,5,2,270895,270895,270897,0,2,4
77377,1,3,270896,270897,270900,1,4,0
77378,6,1,270902,270902,270903,0,1,2
77379,1,3,270903,270903,270906,0,3,0
77380,4,3,270907,270907,270910,0,3,1
77381,6,2,270913,270913,270915,0,2,3
77382,5,1,270918,270918,270919,0,1,3
77383,5,1,270923,270923,270924,0,1,4
77384,4,2,270927,270927,270929,0,2,3
77385,1,3,270928,270929,270932,1,4,0
77386,2,3,270930,270932,270935,2,5,0
77387,5,2,270935,270935,270937,0,2,0
77388,5,3,270940,270940,270943,0,3,3
77389,5,3,270945,270945,270948,0,3,2
77390,1,1,270946,270948,270949,2,3,0
77391,2,2,270948,270949,270951,1,3,0
77392,1,2,270949,270951,270953,2,4,0
77393,2,1,270951,270953,270954,2,3,0
77394,1,3,270952,270954,270957,2,5,0
77395,5,2,270957,270957,270959,0,2,0
77396,6,1,270963,270963,270964,0,1,4
77397,3,1,270966,270966,270967,0,1,2
77398,3,2,270969,270969,270971,0,2,2
77399,4,3,270973,270973,270976,0,3,2
77400,4,1,270977,270977,270978,0,1,1
77401,6,1,270983,270983,270984,0,1,5
77402,5,1,270988,270988,270989,0,1,4
77403,2,3,270990,270990,270993,0,3,1
77404,1,1,270991,270993,270994,2,3,0
77405,3,1,270994,270994,270995,0,1,0
77406,2,2,270996,270996,270998,0,2,1
77407,4,2,271000,271000,271002,0,2,2
77408,2,2,271002,271002,271004,0,2,0
77409,5,3,271007,271007,271010,0,3,3
77410,1,1,271008,271010,271011,2,3,0
77411,1,3,271009,271011,271014,2,5,0
77412,3,1,271012,271014,271015,2,3,0
77413,3,3,271015,271015,271018,0,3,0
77414,5,2,271020,271020,271022,0,2,2
77415,2,2,271022,271022,271024,0,2,0
77416,5,2,271027,271027,271029,0,2,3
77417,1,1,271028,271029,271030,1,2,0
77418,4,2,271032,271032,271034,0,2,2
77419,2,1,271034,271034,271035,0,1,0
77420,1,1,271035,271035,271036,0,1,0
77421,1,3,271036,271036,271039,0,3,0
77422,4,2,271040,271040,271042,0,2,1
77423,1,3,271041,271042,271045,1,4,0
77424,5,1,271046,271046,271047,0,1,1
77425,5,1,271051,271051,271052,0,1,4
77426,5,1,271056,271056,271057,0,1,4
77427,3,1,271059,271059,271060,0,1,2
77428,3,3,271062,271062,271065,0,3,2
77429,5,1,271067,271067,271068,0,1,2
77430,4,1,271071,271071,271072,0,1,3
77431,2,2,271073,271073,271075,0,2,1
77432,4,1,271077,271077,271078,0,1,2
77433,1,3,271078,271078,271081,0,3,0
77434,5,1,271083,271083,271084,0,1,2
77435,2,3,271085,271085,271088,0,3,1
77436,5,3,271090,271090,271093,0,3,2
77437,5,1,271095,271095,271096,0,1,2
77438,6,3,271101,271101,271104,0,3,5
77439,2,1,271103,271104,271105,1,2,0
77440,2,2,271105,271105,271107,0,2,0
77441,4,2,271109,271109,271111,0,2,2
77442,4,2,271113,271113,271115,0,2,2
77443,1,3,271114,271115,271118,1,4,0
77444,2,2,271116,271118,271120,2,4,0
77445,5,2,271121,271121,271123,0,2,1
77446,1,2,271122,271123,271125,1,3,0
77447,2,3,271124,271125,271128,1,4,0
77448,6,1,271130,271130,271131,0,1,2
77449,1,2,271131,271131,271133,0,2,0
77450,4,1,271135,271135,271136,0,1,2
77451,2,1,271137,271137,271138,0,1,1
77452,5,1,271142,271142,271143,0,1,4
77453,1,1,271143,271143,271144,0,1,0
77454,1,3,271144,271144,271147,0,3,0
77455,1,1,271145,271147,271148,2,3,0
77456,5,2,271150,271150,271152,0,2,2
77457,2,1,271152,271152,271153,0,1,0
77458,5,3,271157,271157,271160,0,3,4
77459,2,2,271159,271160,271162,1,3,0
77460,4,2,271163,271163,271165,0,2,1
77461,6,2,271169,271169,271171,0,2,4
77462,2,3,271171,271171,271174,0,3,0
77463,6,3,271177,271177,271180,0,3,3
77464,4,1,271181,271181,271182,0,1,1
77465,6,3,271187,271187,271190,0,3,5
77466,4,2,271191,271191,271193,0,2,1
77467,4,3,271195,271195,271198,0,3,2
77468,4,1,271199,271199,271200,0,1,1
77469,5,1,271204,271204,271205,0,1,4
77470,5,3,271209,271209,271212,0,3,4
77471,4,2,271213,271213,271215,0,2,1
77472,4,1,271217,271217,271218,0,1,2
77473,6,1,271223,271223,271224,0,1,5
77474,4,3,271227,271227,271230,0,3,3
77475,3,1,271230,271230,271231,0,1,0
77476,6,3,271236,271236,271239,0,3,5
77477,6,1,271242,271242,271243,0,1,3
77478,5,1,271247,271247,271248,0,1,4
77479,6,3,271253,271253,271256,0,3,5
77480,5,3,271258,271258,271261,0,3,2
77481,1,3,271259,271261,271264,2,5,0
77482,3,1,271262,271264,271265,2,3,0
77483,2,3,271264,271265,271268,1,4,0
77484,2,1,271266,271268,271269,2,3,0
77485,2,2,271268,271269,271271,1,3,0
77486,1,1,271269,271271,271272,2,3,0
77487,3,2,271272,271272,271274,0,2,0
77488,3,2,271275,271275,271277,0,2,1
77489,3,2,271278,271278,271280,0,2,1
77490,2,3,271280,271280,271283,0,3,0
77491,3,3,271283,271283,271286,0,3,0
77492,2,2,271285,271286,271288,1,3,0
77493,5,1,271290,271290,271291,0,1,2
77494,2,1,271292,271292,271293,0,1,1
77495,5,1,271297,271297,271298,0,1,4
77496,1,1,271298,271298,271299,0,1,0
77497,2,2,271300,271300,271302,0,2,1
77498,6,2,271306,271306,271308,0,2,4
77499,5,2,271311,271311,271313,0,2,3
77500,4,1,271315,271315,271316,0,1,2
77501,2,1,271317,271317,271318,0,1,1
77502,4,1,271321,271321,271322,0,1,3
77503,3,2,271324,271324,271326,0,2,2
77504,4,2,271328,271328,271330,0,2,2
77505,5,3,271333,271333,271336,0,3,3
77506,2,3,271335,271336,271339,1,4,0
77507,6,3,271341,271341,271344,0,3,2
77508,6,1,271347,271347,271348,0,1,3
77509,5,2,271352,271352,271354,0,2,4
77510,4,2,271356,271356,271358,0,2,2
77511,4,3,271360,271360,271363,0,3,2
77512,3,3,271363,271363,271366,0,3,0
77513,4,2,271367,271367,271369,0,2,1
77514,4,1,271371,271371,271372,0,1,2
77515,1,3,271372,271372,271375,0,3,0
77516,3,1,271375,271375,271376,0,1,0
77517,4,2,271379,271379,271381,0,2,3
77518,1,3,271380,271381,271384,1,4,0
77519,5,2,271385,271385,271387,0,2,1
77520,3,3,271388,271388,271391,0,3,1
77521,1,3,271389,271391,271394,2,5,0
77522,1,3,271390,271394,271397,4,7,0
77523,3,2,271393,271397,271399,4,6,0
77524,3,3,271396,271399,271402,3,6,0
77525,5,3,271401,271402,271405,1,4,0
77526,3,2,271404,271405,271407,1,3,0
77527,2,1,271406,271407,271408,1,2,0
77528,4,2,271410,271410,271412,0,2,2
77529,6,3,271416,271416,271419,0,3,4
77530,3,3,271419,271419,271422,0,3,0
77531,5,1,271424,271424,271425,0,1,2
77532,4,3,271428,271428,271431,0,3,3
77533,5,3,271433,271433,271436,0,3,2
77534,1,3,271434,271436,271439,2,5,0
77535,5,1,271439,271439,271440,0,1,0
77536,2,2,271441,271441,271443,0,2,1
77537,3,2,271444,271444,271446,0,2,1
77538,5,2,271449,271449,271451,0,2,3
77539,6,1,271455,271455,271456,0,1,4
77540,3,1,271458,271458,271459,0,1,2
77541,3,2,271461,271461,271463,0,2,2
77542,3,1,271464,271464,271465,0,1,1
77543,6,2,271470,271470,271472,0,2,5
77544,3,2,271473,271473,271475,0,2,1
77545,6,2,271479,271479,271481,0,2,4
77546,4,1,271483,271483,271484,0,1,2
77547,6,3,271489,271489,271492,0,3,5
77548,3,3,271492,271492,271495,0,3,0
77549,6,2,271498,271498,271500,0,2,3
77550,3,2,271501,271501,271503,0,2,1
77551,5,2,271506,271506,271508,0,2,3
77552,1,2,271507,271508,271510,1,3,0
77553,4,1,271511,271511,271512,0,1,1
77554,6,1,271517,271517,271518,0,1,5
77555,5,3,271522,271522,271525,0,3,4
77556,6,2,271528,271528,271530,0,2,3
77557,1,2,271529,271530,271532,1,3,0
77558,3,2,271532,271532,271534,0,2,0
77559,4,3,271536,271536,271539,0,3,2
77560,4,2,271540,271540,271542,0,2,1
77561,3,2,271543,271543,271545,0,2,1
77562,5,1,271548,271548,271549,0,1,3
77563,4,3,271552,271552,271555,0,3,3
77564,5,2,271557,271557,271559,0,2,2
77565,3,1,271560,271560,271561,0,1,1
77566,3,2,271563,271563,271565,0,2,2
77567,2,2,271565,271565,271567,0,2,0
77568,1,3,271566,271567,271570,1,4,0
77569,4,1,271570,271570,271571,0,1,0
77570,5,2,271575,271575,271577,0,2,4
77571,5,2,271580,271580,271582,0,2,3
77572,2,3,271582,271582,271585,0,3,0
77573,5,2,271587,271587,271589,0,2,2
77574,2,1,271589,271589,271590,0,1,0
77575,6,2,271595,271595,271597,0,2,5
77576,6,2,271601,271601,271603,0,2,4
77577,4,2,271605,271605,271607,0,2,2
77578,3,2,271608,271608,271610,0,2,1
77579,4,2,271612,271612,271614,0,2,2
77580,1,3,271613,271614,271617,1,4,0
77581,6,3,271619,271619,271622,0,3,2
77582,1,2,271620,271622,271624,2,4,0
77583,3,3,271623,271624,271627,1,4,0
77584,5,2,271628,271628,271630,0,2,1
77585,1,3,271629,271630,271633,1,4,0
77586,2,2,271631,271633,271635,2,4,0
77587,1,2,271632,271635,271637,3,5,0
77588,5,2,271637,271637,271639,0,2,0
77589,4,3,271641,271641,271644,0,3,2
77590,1,1,271642,271644,271645,2,3,0
77591,5,1,271647,271647,271648,0,1,2
77592,2,1,271649,271649,271650,0,1,1
77593,3,3,271652,271652,271655,0,3,2
77594,3,1,271655,271655,271656,0,1,0
77595,1,1,271656,271656,271657,0,1,0
77596,5,1,271661,271661,271662,0,1,4
77597,5,2,271666,271666,271668,0,2,4
77598,6,1,271672,271672,271673,0,1,4
77599,5,3,271677,271677,271680,0,3,4
77600,4,2,271681,271681,271683,0,2,1
77601,1,3,271682,271683,271686,1,4,0
77602,6,1,271688,271688,271689,0,1,2
77603,4,2,271692,271692,271694,0,2,3
77604,4,1,271696,271696,271697,0,1,2
77605,6,3,271702,271702,271705,0,3,5
77606,2,1,271704,271705,271706,1,2,0
77607,3,3,271707,271707,271710,0,3,1
77608,1,1,271708,271710,271711,2,3,0
77609,6,3,271714,271714,271717,0,3,3
77610,4,3,271718,271718,271721,0,3,1
77611,6,2,271724,271724,271726,0,2,3
77612,1,1,271725,271726,271727,1,2,0
77613,6,2,271731,271731,271733,0,2,4
77614,3,2,271734,271734,271736,0,2,1
77615,3,1,271737,271737,271738,0,1,1
77616,1,1,271738,271738,271739,0,1,0
77617,2,1,271740,271740,271741,0,1,1
77618,5,1,271745,271745,271746,0,1,4
77619,2,3,271747,271747,271750,0,3,1
77620,6,3,271753,271753,271756,0,3,3
77621,3,2,271756,271756,271758,0,2,0
77622,3,3,271759,271759,271762,0,3,1
77623,3,3,271762,271762,271765,0,3,0
77624,6,3,271768,271768,271771,0,3,3
77625,2,2,271770,271771,271773,1,3,0
77626,1,3,271771,271773,271776,2,5,0
77627,5,2,271776,271776,271778,0,2,0
77628,2,1,271778,271778,271779,0,1,0
77629,3,1,271781,271781,271782,0,1,2
77630,5,1,271786,271786,271787,0,1,4
77631,4,2,271790,271790,271792,0,2,3
77632,6,1,271796,271796,271797,0,1,4
77633,6,1,271802,271802,271803,0,1,5
77634,1,3,271803,271803,271806,0,3,0
77635,5,1,271808,271808,271809,0,1,2
77636,6,1,271814,271814,271815,0,1,5
77637,2,3,271816,271816,271819,0,3,1
77638,3,2,271819,271819,271821,0,2,0
77639,4,1,271823,271823,271824,0,1,2
77640,2,1,271825,271825,271826,0,1,1
77641,1,3,271826,271826,271829,0,3,0
77642,4,1,271830,271830,271831,0,1,1
77643,2,1,271832,271832,271833,0,1,1
77644,1,3,271833,271833,271836,0,3,0
77645,4,3,271837,271837,271840,0,3,1
77646,2,3,271839,271840,271843,1,4,0
77647,4,3,271843,271843,271846,0,3,0
77648,6,3,271849,271849,271852,0,3,3
77649,3,2,271852,271852,271854,0,2,0
77650,3,2,271855,271855,271857,0,2,1
77651,5,3,271860,271860,271863,0,3,3
77652,1,2,271861,271863,271865,2,4,0
77653,4,3,271865,271865,271868,0,3,0
77654,2,2,271867,271868,271870,1,3,0
77655,4,2,271871,271871,271873,0,2,1
77656,5,1,271876,271876,271877,0,1,3
77657,4,3,271880,271880,271883,0,3,3
77658,1,2,271881,271883,271885,2,4,0
77659,3,3,271884,271885,271888,1,4,0
77660,2,1,271886,271888,271889,2,3,0
77661,1,1,271887,271889,271890,2,3,0
77662,4,3,271891,271891,271894,0,3,1
77663,2,1,271893,271894,271895,1,2,0
77664,6,2,271899,271899,271901,0,2,4
77665,1,2,271900,271901,271903,1,3,0
77666,3,2,271903,271903,271905,0,2,0
77667,5,2,271908,271908,271910,0,2,3
77668,5,2,271913,271913,271915,0,2,3
77669,1,1,271914,271915,271916,1,2,0
77670,5,1,271919,271919,271920,0,1,3
77671,1,3,271920,271920,271923,0,3,0
77672,6,2,271926,271926,271928,0,2,3
77673,6,2,271932,271932,271934,0,2,4
77674,3,2,271935,271935,271937,0,2,1
77675,5,1,271940,271940,271941,0,1,3
77676,6,3,271946,271946,271949,0,3,5
77677,4,2,271950,271950,271952,0,2,1
77678,4,2,271954,271954,271956,0,2,2
77679,1,1,271955,271956,271957,1,2,0
77680,4,1,271959,271959,271960,0,1,2
77681,2,2,271961,271961,271963,0,2,1
77682,2,3,271963,271963,271966,0,3,0
77683,5,3,271968,271968,271971,0,3,2
77684,4,2,271972,271972,271974,0,2,1
77685,1,1,271973,271974,271975,1,2,0
77686,5,3,271978,271978,271981,0,3,3
77687,3,2,271981,271981,271983,0,2,0
77688,6,2,271987,271987,271989,0,2,4
77689,1,1,271988,271989,271990,1,2,0
77690,2,1,271990,271990,271991,0,1,0
77691,3,2,271993,271993,271995,0,2,2
77692,3,3,271996,271996,271999,0,3,1
77693,1,2,271997,271999,272001,2,4,0
77694,5,2,272002,272002,272004,0,2,1
77695,3,2,272005,272005,272007,0,2,1
77696,6,3,272011,272011,272014,0,3,4
77697,2,1,272013,272014,272015,1,2,0
77698,1,2,272014,272015,272017,1,3,0
77699,1,1,272015,272017,272018,2,3,0
77700,3,2,272018,272018,272020,0,2,0
77701,2,3,272020,272020,272023,0,3,0
77702,6,2,272026,272026,272028,0,2,3
77703,2,2,272028,272028,272030,0,2,0
77704,4,2,272032,272032,272034,0,2,2
77705,5,2,272037,272037,272039,0,2,3
77706,4,2,272041,272041,272043,0,2,2
77707,3,1,272044,272044,272045,0,1,1
77708,2,3,272046,272046,272049,0,3,1
77709,4,2,272050,272050,272052,0,2,1
77710,2,1,272052,272052,272053,0,1,0
77711,3,2,272055,272055,272057,0,2,2
77712,2,1,272057,272057,272058,0,1,0
77713,3,3,272060,272060,272063,0,3,2
77714,2,1,272062,272063,272064,1,2,0
77715,3,1,272065,272065,272066,0,1,1
77716,3,3,272068,272068,272071,0,3,2
77717,5,1,272073,272073,272074,0,1,2
77718,5,3,272078,272078,272081,0,3,4
77719,2,2,272080,272081,272083,1,3,0
77720,4,3,272084,272084,272087,0,3,1
77721,3,3,272087,272087,272090,0,3,0
77722,5,2,272092,272092,272094,0,2,2
77723,2,2,272094,272094,272096,0,2,0
77724,4,2,272098,272098,272100,0,2,2
77725,5,3,272103,272103,272106,0,3,3
77726,3,1,272106,272106,272107,0,1,0
77727,4,1,272110,272110,272111,0,1,3
77728,2,1,272112,272112,272113,0,1,1
77729,6,2,272118,272118,272120,0,2,5
77730,5,1,272123,272123,272124,0,1,3
77731,3,3,272126,272126,272129,0,3,2
77732,1,3,272127,272129,272132,2,5,0
77733,5,3,272132,272132,272135,0,3,0
77734,6,3,272138,272138,272141,0,3,3
77735,1,2,272139,272141,272143,2,4,0
77736,2,2,272141,272143,272145,2,4,0
77737,1,1,272142,272145,272146,3,4,0
77738,4,1,272146,272146,272147,0,1,0
77739,2,2,272148,272148,272150,0,2,1
77740,6,1,272154,272154,272155,0,1,4
77741,4,1,272158,272158,272159,0,1,3
77742,5,3,272163,272163,272166,0,3,4
77743,3,3,272166,272166,272169,0,3,0
77744,5,1,272171,272171,272172,0,1,2
77745,6,3,272177,272177,272180,0,3,5
77746,5,1,272182,272182,272183,0,1,2
77747,2,1,272184,272184,272185,0,1,1
77748,4,1,272188,272188,272189,0,1,3
77749,5,2,272193,272193,272195,0,2,4
77750,3,3,272196,272196,272199,0,3,1
77751,3,2,272199,272199,272201,0,2,0
77752,4,1,272203,272203,272204,0,1,2
77753,2,2,272205,272205,272207,0,2,1
77754,5,1,272210,272210,272211,0,1,3
77755,1,1,272211,272211,272212,0,1,0
77756,1,2,272212,272212,272214,0,2,0
77757,5,3,272217,272217,272220,0,3,3
77758,4,2,272221,272221,272223,0,2,1
77759,1,2,272222,272223,272225,1,3,0
77760,2,3,272224,272225,272228,1,4,0
77761,6,3,272230,272230,272233,0,3,2
77762,1,3,272231,272233,272236,2,5,0
77763,3,3,272234,272236,272239,2,5,0
77764,3,3,272237,272239,272242,2,5,0
77765,3,1,272240,272242,272243,2,3,0
77766,3,3,272243,272243,272246,0,3,0
77767,5,1,272248,272248,272249,0,1,2
77768,6,3,272254,272254,272257,0,3,5
77769,2,3,272256,272257,272260,1,4,0
77770,3,1,272259,272260,272261,1,2,0
77771,2,3,272261,272261,272264,0,3,0
77772,6,3,272267,272267,272270,0,3,3
77773,3,3,272270,272270,272273,0,3,0
77774,4,1,272274,272274,272275,0,1,1
77775,4,2,272278,272278,272280,0,2,3
77776,6,2,272284,272284,272286,0,2,4
77777,2,3,272286,272286,272289,0,3,0
77778,3,1,272289,272289,272290,0,1,0
77779,3,2,272292,272292,272294,0,2,2
77780,4,1,272296,272296,272297,0,1,2
77781,1,2,272297,272297,272299,0,2,0
77782,5,2,272302,272302,272304,0,2,3
77783,2,2,272304,272304,272306,0,2,0
77784,6,3,272310,272310,272313,0,3,4
77785,6,1,272316,272316,272317,0,1,3
77786,2,2,272318,272318,272320,0,2,1
77787,3,3,272321,272321,272324,0,3,1
77788,2,2,272323,272324,272326,1,3,0
77789,2,2,272325,272326,272328,1,3,0
77790,3,2,272328,272328,272330,0,2,0
77791,3,1,272331,272331,272332,0,1,1
77792,4,3,272335,272335,272338,0,3,3
77793,1,3,272336,272338,272341,2,5,0
77794,1,2,272337,272341,272343,4,6,0
77795,5,1,272342,272343,272344,1,2,0
77796,3,2,272345,272345,272347,0,2,1
77797,4,2,272349,272349,272351,0,2,2
77798,5,1,272354,272354,272355,0,1,3
77799,2,1,272356,272356,272357,0,1,1
77800,5,2,272361,272361,272363,0,2,4
77801,2,1,272363,272363,272364,0,1,0
77802,5,1,272368,272368,272369,0,1,4
77803,4,1,272372,272372,272373,0,1,3
77804,3,1,272375,272375,272376,0,1,2
77805,1,3,272376,272376,272379,0,3,0
77806,5,3,272381,272381,272384,0,3,2
77807,3,3,272384,272384,272387,0,3,0
77808,5,2,272389,272389,272391,0,2,2
77809,5,2,272394,272394,272396,0,2,3
77810,6,3,272400,272400,272403,0,3,4
77811,2,2,272402,272403,272405,1,3,0
77812,5,1,272407,272407,272408,0,1,2
77813,1,2,272408,272408,272410,0,2,0
77814,4,2,272412,272412,272414,0,2,2
77815,2,3,272414,272414,272417,0,3,0
77816,2,2,272416,272417,272419,1,3,0
77817,3,3,272419,272419,272422,0,3,0
77818,3,2,272422,272422,272424,0,2,0
77819,4,1,272426,272426,272427,0,1,2
77820,4,3,272430,272430,272433,0,3,3
77821,5,2,272435,272435,272437,0,2,2
77822,6,2,272441,272441,272443,0,2,4
77823,4,1,272445,272445,272446,0,1,2
77824,4,2,272449,272449,272451,0,2,3
77825,3,1,272452,272452,272453,0,1,1
77826,3,2,272455,272455,272457,0,2,2
77827,2,2,272457,272457,272459,0,2,0
77828,6,1,272463,272463,272464,0,1,4
77829,2,1,272465,272465,272466,0,1,1
77830,6,2,272471,272471,272473,0,2,5
77831,6,2,272477,272477,272479,0,2,4
77832,6,1,272483,272483,272484,0,1,4
77833,1,1,272484,272484,272485,0,1,0
77834,3,1,272487,272487,272488,0,1,2
77835,4,3,272491,272491,272494,0,3,3
77836,3,3,272494,272494,272497,0,3,0
77837,4,3,272498,272498,272501,0,3,1
77838,4,2,272502,272502,272504,0,2,1
77839,4,3,272506,272506,272509,0,3,2
77840,4,3,272510,272510,272513,0,3,1
77841,2,3,272512,272513,272516,1,4,0
77842,6,3,272518,272518,272521,0,3,2
77843,3,1,272521,272521,272522,0,1,0
77844,2,2,272523,272523,272525,0,2,1
77845,6,1,272529,272529,272530,0,1,4
77846,1,1,272530,272530,272531,0,1,0
77847,4,1,272534,272534,272535,0,1,3
77848,6,1,272540,272540,272541,0,1,5
77849,3,2,272543,272543,272545,0,2,2
77850,1,3,272544,272545,272548,1,4,0
77851,1,3,272545,272548,272551,3,6,0
77852,2,1,272547,272551,272552,4,5,0
77853,1,3,272548,272552,272555,4,7,0
77854,4,1,272552,272555,272556,3,4,0
77855,2,3,272554,272556,272559,2,5,0
77856,1,2,272555,272559,272561,4,6,0
77857,1,1,272556,272561,272562,5,6,0
77858,3,3,272559,272562,272565,3,6,0
77859,1,3,272560,272565,272568,5,8,0
77860,1,1,272561,272568,272569,7,8,0
77861,6,3,272567,272569,272572,2,5,0
77862,5,3,272572,272572,272575,0,3,0
77863,4,3,272576,272576,272579,0,3,1
77864,1,1,272577,272579,272580,2,3,0
77865,3,3,272580,272580,272583,0,3,0
77866,5,3,272585,272585,272588,0,3,2
77867,6,3,272591,272591,272594,0,3,3
77868,1,1,272592,272594,272595,2,3,0
77869,5,2,272597,272597,272599,0,2,2
77870,5,3,272602,272602,272605,0,3,3
77871,5,2,272607,272607,272609,0,2,2
77872,2,2,272609,272609,272611,0,2,0
77873,1,2,272610,272611,272613,1,3,0
77874,6,3,272616,272616,272619,0,3,3
77875,3,1,272619,272619,272620,0,1,0
77876,1,1,272620,272620,272621,0,1,0
77877,6,1,272626,272626,272627,0,1,5
77878,6,2,272632,272632,272634,0,2,5
77879,4,2,272636,272636,272638,0,2,2
77880,6,3,272642,272642,272645,0,3,4
77881,5,3,272647,272647,272650,0,3,2
77882,4,3,272651,272651,272654,0,3,1
77883,3,3,272654,272654,272657,0,3,0
77884,3,2,272657,272657,272659,0,2,0
77885,3,2,272660,272660,272662,0,2,1
77886,6,3,272666,272666,272669,0,3,4
77887,2,2,272668,272669,272671,1,3,0
77888,6,3,272674,272674,272677,0,3,3
77889,4,1,272678,272678,272679,0,1,1
77890,3,2,272681,272681,272683,0,2,2
77891,5,3,272686,272686,272689,0,3,3
77892,1,1,272687,272689,272690,2,3,0
77893,4,3,272691,272691,272694,0,3,1
77894,3,1,272694,272694,272695,0,1,0
77895,4,1,272698,272698,272699,0,1,3
77896,2,3,272700,272700,272703,0,3,1
77897,5,1,272705,272705,272706,0,1,2
77898,3,3,272708,272708,272711,0,3,2
77899,3,3,272711,272711,272714,0,3,0
77900,1,3,272712,272714,272717,2,5,0
77901,1,3,272713,272717,272720,4,7,0
77902,2,3,272715,272720,272723,5,8,0
77903,1,1,272716,272723,272724,7,8,0
77904,2,3,272718,272724,272727,6,9,0
77905,2,2,272720,272727,272729,7,9,0
77906,1,3,272721,272729,272732,8,11,0
77907,2,1,272723,272732,272733,9,10,0
77908,3,2,272726,272733,272735,7,9,0
77909,2,2,272728,272735,272737,7,9,0
77910,5,2,272733,272737,272739,4,6,0
77911,3,1,272736,272739,272740,3,4,0
77912,4,2,272740,272740,272742,0,2,0
77913,4,1,272744,272744,272745,0,1,2
77914,4,3,272748,272748,272751,0,3,3
77915,2,1,272750,272751,272752,1,2,0
77916,2,1,272752,272752,272753,0,1,0
77917,1,3,272753,272753,272756,0,3,0
77918,1,2,272754,272756,272758,2,4,0
77919,2,1,272756,272758,272759,2,3,0
77920,6,2,272762,272762,272764,0,2,3
77921,3,1,272765,272765,272766,0,1,1
77922,3,2,272768,272768,272770,0,2,2
77923,2,3,272770,272770,272773,0,3,0
77924,5,2,272775,272775,272777,0,2,2
77925,5,2,272780,272780,272782,0,2,3
77926,6,2,272786,272786,272788,0,2,4
77927,3,2,272789,272789,272791,0,2,1
77928,6,3,272795,272795,272798,0,3,4
77929,4,2,272799,272799,272801,0,2,1
77930,1,3,272800,272801,272804,1,4,0
77931,1,1,272801,272804,272805,3,4,0
77932,6,1,272807,272807,272808,0,1,2
77933,3,2,272810,272810,272812,0,2,2
77934,5,3,272815,272815,272818,0,3,3
77935,6,2,272821,272821,272823,0,2,3
77936,1,1,272822,272823,272824,1,2,0
77937,6,3,272828,272828,272831,0,3,4
77938,1,2,272829,272831,272833,2,4,0
77939,1,2,272830,272833,272835,3,5,0
77940,5,3,272835,272835,272838,0,3,0
77941,3,2,272838,272838,272840,0,2,0
77942,4,3,272842,272842,272845,0,3,2
77943,2,3,272844,272845,272848,1,4,0
77944,1,3,272845,272848,272851,3,6,0
77945,3,1,272848,272851,272852,3,4,0
77946,5,1,272853,272853,272854,0,1,1
77947,3,3,272856,272856,272859,0,3,2
77948,4,2,272860,272860,272862,0,2,1
77949,4,3,272864,272864,272867,0,3,2
77950,2,1,272866,272867,272868,1,2,0
77951,4,2,272870,272870,272872,0,2,2
77952,5,1,272875,272875,272876,0,1,3
77953,3,1,272878,272878,272879,0,1,2
77954,6,2,272884,272884,272886,0,2,5
77955,1,2,272885,272886,272888,1,3,0
77956,3,2,272888,272888,272890,0,2,0
77957,3,2,272891,272891,272893,0,2,1
77958,3,1,272894,272894,272895,0,1,1
77959,5,2,272899,272899,272901,0,2,4
77960,1,2,272900,272901,272903,1,3,0
77961,2,1,272902,272903,272904,1,2,0
77962,3,2,272905,272905,272907,0,2,1
77963,5,2,272910,272910,272912,0,2,3
77964,6,3,272916,272916,272919,0,3,4
77965,6,3,272922,272922,272925,0,3,3
77966,1,2,272923,272925,272927,2,4,0
77967,3,3,272926,272927,272930,1,4,0
77968,1,3,272927,272930,272933,3,6,0
77969,1,1,272928,272933,272934,5,6,0
77970,6,3,272934,272934,272937,0,3,0
77971,1,3,272935,272937,272940,2,5,0
77972,6,1,272941,272941,272942,0,1,1
77973,1,1,272942,272942,272943,0,1,0
77974,5,2,272947,272947,272949,0,2,4
77975,6,1,272953,272953,272954,0,1,4
77976,4,3,272957,272957,272960,0,3,3
77977,6,2,272963,272963,272965,0,2,3
77978,5,1,272968,272968,272969,0,1,3
77979,6,1,272974,272974,272975,0,1,5
77980,6,3,272980,272980,272983,0,3,5
77981,1,1,272981,272983,272984,2,3,0
77982,4,3,272985,272985,272988,0,3,1
77983,5,2,272990,272990,272992,0,2,2
77984,6,3,272996,272996,272999,0,3,4
77985,6,1,273002,273002,273003,0,1,3
77986,6,3,273008,273008,273011,0,3,5
77987,2,1,273010,273011,273012,1,2,0
77988,5,1,273015,273015,273016,0,1,3
77989,2,2,273017,273017,273019,0,2,1
77990,6,2,273023,273023,273025,0,2,4
77991,6,1,273029,273029,273030,0,1,4
77992,1,3,273030,273030,273033,0,3,0
77993,2,1,273032,273033,273034,1,2,0
77994,1,2,273033,273034,273036,1,3,0
77995,5,2,273038,273038,273040,0,2,2
77996,2,1,273040,273040,273041,0,1,0
77997,3,1,273043,273043,273044,0,1,2
77998,6,1,273049,273049,273050,0,1,5
77999,3,2,273052,273052,273054,0,2,2
78000,5,3,273057,273057,273060,0,3,3
78001,5,2,273062,273062,273064,0,2,2
78002,1,1,273063,273064,273065,1,2,0
78003,5,3,273068,273068,273071,0,3,3
78004,2,3,273070,273071,273074,1,4,0
78005,5,1,273075,273075,273076,0,1,1
78006,4,2,273079,273079,273081,0,2,3
78007,1,1,273080,273081,273082,1,2,0
78008,2,1,273082,273082,273083,0,1,0
78009,4,2,273086,273086,273088,0,2,3
78010,6,2,273092,273092,273094,0,2,4
78011,2,1,273094,273094,273095,0,1,0
78012,1,3,273095,273095,273098,0,3,0
78013,6,1,273101,273101,273102,0,1,3
78014,4,3,273105,273105,273108,0,3,3
78015,4,1,273109,273109,273110,0,1,1
78016,5,2,273114,273114,273116,0,2,4
78017,6,1,273120,273120,273121,0,1,4
78018,4,2,273124,273124,273126,0,2,3
78019,5,1,273129,273129,273130,0,1,3
78020,1,3,273130,273130,273133,0,3,0
78021,3,2,273133,273133,273135,0,2,0
78022,2,1,273135,273135,273136,0,1,0
78023,1,2,273136,273136,273138,0,2,0
78024,4,2,273140,273140,273142,0,2,2
78025,1,3,273141,273142,273145,1,4,0
78026,5,3,273146,273146,273149,0,3,1
78027,3,1,273149,273149,273150,0,1,0
78028,2,2,273151,273151,273153,0,2,1
78029,5,3,273156,273156,273159,0,3,3
78030,3,2,273159,273159,273161,0,2,0
78031,5,2,273164,273164,273166,0,2,3
78032,4,1,273168,273168,273169,0,1,2
78033,5,3,273173,273173,273176,0,3,4
78034,3,3,273176,273176,273179,0,3,0
78035,2,3,273178,273179,273182,1,4,0
78036,2,1,273180,273182,273183,2,3,0
78037,2,2,273182,273183,273185,1,3,0
78038,5,1,273187,273187,273188,0,1,2
78039,4,1,273191,273191,273192,0,1,3
78040,4,2,273195,273195,273197,0,2,3
78041,2,3,273197,273197,273200,0,3,0
78042,1,1,273198,273200,273201,2,3,0
78043,2,3,273200,273201,273204,1,4,0
78044,1,1,273201,273204,273205,3,4,0
78045,4,1,273205,273205,273206,0,1,0
78046,3,2,273208,273208,273210,0,2,2
78047,4,1,273212,273212,273213,0,1,2
78048,1,1,273213,273213,273214,0,1,0
78049,3,1,273216,273216,273217,0,1,2
78050,6,3,273222,273222,273225,0,3,5
78051,2,2,273224,273225,273227,1,3,0
78052,2,2,273226,273227,273229,1,3,0
78053,3,1,273229,273229,273230,0,1,0
78054,2,3,273231,273231,273234,0,3,1
78055,5,2,273236,273236,273238,0,2,2
78056,3,2,273239,273239,273241,0,2,1
78057,4,3,273243,273243,273246,0,3,2
78058,5,3,273248,273248,273251,0,3,2
78059,4,3,273252,273252,273255,0,3,1
78060,1,1,273253,273255,273256,2,3,0
78061,2,2,273255,273256,273258,1,3,0
78062,2,1,273257,273258,273259,1,2,0
78063,5,2,273262,273262,273264,0,2,3
78064,3,3,273265,273265,273268,0,3,1
78065,4,3,273269,273269,273272,0,3,1
78066,5,3,273274,273274,273277,0,3,2
78067,2,1,273276,273277,273278,1,2,0
78068,1,1,273277,273278,273279,1,2,0
78069,5,3,273282,273282,273285,0,3,3
78070,2,3,273284,273285,273288,1,4,0
78071,6,1,273290,273290,273291,0,1,2
78072,5,1,273295,273295,273296,0,1,4
78073,6,2,273301,273301,273303,0,2,5
78074,1,3,273302,273303,273306,1,4,0
78075,4,3,273306,273306,273309,0,3,0
78076,1,2,273307,273309,273311,2,4,0
78077,4,3,273311,273311,273314,0,3,0
78078,2,2,273313,273314,273316,1,3,0
78079,4,3,273317,273317,273320,0,3,1
78080,5,1,273322,273322,273323,0,1,2
78081,3,1,273325,273325,273326,0,1,2
78082,4,1,273329,273329,273330,0,1,3
78083,2,3,273331,273331,273334,0,3,1
78084,6,1,273337,273337,273338,0,1,3
78085,5,2,273342,273342,273344,0,2,4
78086,2,3,273344,273344,273347,0,3,0
78087,5,2,273349,273349,273351,0,2,2
78088,2,1,273351,273351,273352,0,1,0
78089,3,3,273354,273354,273357,0,3,2
78090,3,3,273357,273357,273360,0,3,0
78091,2,1,273359,273360,273361,1,2,0
78092,2,2,273361,273361,273363,0,2,0
78093,3,2,273364,273364,273366,0,2,1
78094,3,1,273367,273367,273368,0,1,1
78095,1,3,273368,273368,273371,0,3,0
78096,3,1,273371,273371,273372,0,1,0
78097,6,1,273377,273377,273378,0,1,5
78098,2,2,273379,273379,273381,0,2,1
78099,4,3,273383,273383,273386,0,3,2
78100,3,1,273386,273386,273387,0,1,0
78101,6,1,273392,273392,273393,0,1,5
78102,1,1,273393,273393,273394,0,1,0
78103,1,1,273394,273394,273395,0,1,0
78104,3,2,273397,273397,273399,0,2,2
78105,6,2,273403,273403,273405,0,2,4
78106,5,3,273408,273408,273411,0,3,3
78107,1,2,273409,273411,273413,2,4,0
78108,3,2,273412,273413,273415,1,3,0
78109,1,1,273413,273415,273416,2,3,0
78110,1,1,273414,273416,273417,2,3,0
78111,1,3,273415,273417,273420,2,5,0
78112,3,1,273418,273420,273421,2,3,0
78113,3,3,273421,273421,273424,0,3,0
78114,2,2,273423,273424,273426,1,3,0
78115,4,3,273427,273427,273430,0,3,1
78116,3,1,273430,273430,273431,0,1,0
78117,1,2,273431,273431,273433,0,2,0
78118,4,1,273435,273435,273436,0,1,2
78119,1,2,273436,273436,273438,0,2,0
78120,1,1,273437,273438,273439,1,2,0
78121,4,1,273441,273441,273442,0,1,2
78122,4,2,273445,273445,273447,0,2,3
78123,2,2,273447,273447,273449,0,2,0
78124,1,3,273448,273449,273452,1,4,0
78125,4,3,273452,273452,273455,0,3,0
78126,4,2,273456,273456,273458,0,2,1
78127,4,2,273460,273460,273462,0,2,2
78128,1,1,273461,273462,273463,1,2,0
78129,3,3,273464,273464,273467,0,3,1
78130,3,1,273467,273467,273468,0,1,0
78131,1,2,273468,273468,273470,0,2,0
78132,5,2,273473,273473,273475,0,2,3
78133,5,3,273478,273478,273481,0,3,3
78134,2,2,273480,273481,273483,1,3,0
78135,6,2,273486,273486,273488,0,2,3
78136,1,3,273487,273488,273491,1,4,0
78137,1,3,273488,273491,273494,3,6,0
78138,1,2,273489,273494,273496,5,7,0
78139,6,2,273495,273496,273498,1,3,0
78140,1,1,273496,273498,273499,2,3,0
78141,4,1,273500,273500,273501,0,1,1
78142,3,2,273503,273503,273505,0,2,2
78143,2,1,273505,273505,273506,0,1,0
78144,4,1,273509,273509,273510,0,1,3
78145,3,1,273512,273512,273513,0,1,2
78146,4,3,273516,273516,273519,0,3,3
78147,6,3,273522,273522,273525,0,3,3
78148,1,3,273523,273525,273528,2,5,0
78149,1,3,273524,273528,273531,4,7,0
78150,2,3,273526,273531,273534,5,8,0
78151,6,3,273532,273534,273537,2,5,0
78152,6,2,273538,273538,273540,0,2,1
78153,1,3,273539,273540,273543,1,4,0
78154,6,1,273545,273545,273546,0,1,2
78155,1,1,273546,273546,273547,0,1,0
78156,2,2,273548,273548,273550,0,2,1
78157,1,3,273549,273550,273553,1,4,0
78158,1,2,273550,273553,273555,3,5,0
78159,1,3,273551,273555,273558,4,7,0
78160,2,1,273553,273558,273559,5,6,0
78161,4,2,273557,273559,273561,2,4,0
78162,2,2,273559,273561,273563,2,4,0
78163,3,3,273562,273563,273566,1,4,0
78164,2,1,273564,273566,273567,2,3,0
78165,3,2,273567,273567,273569,0,2,0
78166,1,1,273568,273569,273570,1,2,0
78167,6,3,273574,273574,273577,0,3,4
78168,3,3,273577,273577,273580,0,3,0
78169,2,2,273579,273580,273582,1,3,0
78170,3,2,273582,273582,273584,0,2,0
78171,6,3,273588,273588,273591,0,3,4
78172,5,2,273593,273593,273595,0,2,2
78173,4,3,273597,273597,273600,0,3,2
78174,3,3,273600,273600,273603,0,3,0
78175,6,2,273606,273606,273608,0,2,3
78176,5,3,273611,273611,273614,0,3,3
78177,5,1,273616,273616,273617,0,1,2
78178,1,2,273617,273617,273619,0,2,0
78179,6,3,273623,273623,273626,0,3,4
78180,6,1,273629,273629,273630,0,1,3
78181,2,3,273631,273631,273634,0,3,1
78182,4,3,273635,273635,273638,0,3,1
78183,1,3,273636,273638,273641,2,5,0
78184,1,2,273637,273641,273643,4,6,0
78185,2,2,273639,273643,273645,4,6,0
78186,5,2,273644,273645,273647,1,3,0
78187,4,3,273648,273648,273651,0,3,1
78188,6,3,273654,273654,273657,0,3,3
78189,1,1,273655,273657,273658,2,3,0
78190,3,1,273658,273658,273659,0,1,0
78191,2,1,273660,273660,273661,0,1,1
78192,3,2,273663,273663,273665,0,2,2
78193,3,1,273666,273666,273667,0,1,1
78194,3,3,273669,273669,273672,0,3,2
78195,2,2,273671,273672,273674,1,3,0
78196,4,1,273675,273675,273676,0,1,1
78197,6,2,273681,273681,273683,0,2,5
78198,4,3,273685,273685,273688,0,3,2
78199,3,3,273688,273688,273691,0,3,0
78200,1,2,273689,273691,273693,2,4,0
78201,2,2,273691,273693,273695,2,4,0
78202,4,2,273695,273695,273697,0,2,0
78203,1,1,273696,273697,273698,1,2,0
78204,6,2,273702,273702,273704,0,2,4
78205,1,2,273703,273704,273706,1,3,0
78206,2,2,273705,273706,273708,1,3,0
78207,3,3,273708,273708,273711,0,3,0
78208,6,1,273714,273714,273715,0,1,3
78209,3,2,273717,273717,273719,0,2,2
78210,3,3,273720,273720,273723,0,3,1
78211,6,1,273726,273726,273727,0,1,3
78212,1,2,273727,273727,273729,0,2,0
78213,1,1,273728,273729,273730,1,2,0
78214,6,2,273734,273734,273736,0,2,4
78215,2,2,273736,273736,273738,0,2,0
78216,6,3,273742,273742,273745,0,3,4
78217,1,3,273743,273745,273748,2,5,0
78218,2,3,273745,273748,273751,3,6,0
78219,5,1,273750,273751,273752,1,2,0
78220,4,2,273754,273754,273756,0,2,2
78221,1,3,273755,273756,273759,1,4,0
78222,3,1,273758,273759,273760,1,2,0
78223,6,2,273764,273764,273766,0,2,4
78224,2,2,273766,273766,273768,0,2,0
78225,2,3,273768,273768,273771,0,3,0
78226,3,1,273771,273771,273772,0,1,0
78227,2,1,273773,273773,273774,0,1,1
78228,3,2,273776,273776,273778,0,2,2
78229,3,2,273779,273779,273781,0,2,1
78230,6,1,273785,273785,273786,0,1,4
78231,1,1,273786,273786,273787,0,1,0
78232,4,3,273790,273790,273793,0,3,3
78233,1,1,273791,273793,273794,2,3,0
78234,5,1,273796,273796,273797,0,1,2
78235,6,2,273802,273802,273804,0,2,5
78236,1,1,273803,273804,273805,1,2,0
78237,4,3,273807,273807,273810,0,3,2
78238,6,1,273813,273813,273814,0,1,3
78239,3,1,273816,273816,273817,0,1,2
78240,6,2,273822,273822,273824,0,2,5
78241,1,3,273823,273824,273827,1,4,0
78242,2,1,273825,273827,273828,2,3,0
78243,6,1,273831,273831,273832,0,1,3
78244,1,2,273832,273832,273834,0,2,0
78245,2,2,273834,273834,273836,0,2,0
78246,6,2,273840,273840,273842,0,2,4
78247,5,3,273845,273845,273848,0,3,3
78248,4,2,273849,273849,273851,0,2,1
78249,2,2,273851,273851,273853,0,2,0
78250,3,3,273854,273854,273857,0,3,1
78251,2,2,273856,273857,273859,1,3,0
78252,1,3,273857,273859,273862,2,5,0
78253,1,2,273858,273862,273864,4,6,0
78254,5,1,273863,273864,273865,1,2,0
78255,5,2,273868,273868,273870,0,2,3
78256,4,1,273872,273872,273873,0,1,2
78257,1,1,273873,273873,273874,0,1,0
78258,2,1,273875,273875,273876,0,1,1
78259,6,2,273881,273881,273883,0,2,5
78260,4,2,273885,273885,273887,0,2,2
78261,5,1,273890,273890,273891,0,1,3
78262,4,3,273894,273894,273897,0,3,3
78263,6,2,273900,273900,273902,0,2,3
78264,1,2,273901,273902,273904,1,3,0
78265,6,1,273907,273907,273908,0,1,3
78266,2,3,273909,273909,273912,0,3,1
78267,3,2,273912,273912,273914,0,2,0
78268,6,1,273918,273918,273919,0,1,4
78269,5,2,273923,273923,273925,0,2,4
78270,1,2,273924,273925,273927,1,3,0
78271,4,3,273928,273928,273931,0,3,1
78272,3,3,273931,273931,273934,0,3,0
78273,3,2,273934,273934,273936,0,2,0
78274,1,2,273935,273936,273938,1,3,0
78275,6,1,273941,273941,273942,0,1,3
78276,4,3,273945,273945,273948,0,3,3
78277,3,2,273948,273948,273950,0,2,0
78278,3,2,273951,273951,273953,0,2,1
78279,5,3,273956,273956,273959,0,3,3
78280,3,1,273959,273959,273960,0,1,0
78281,6,3,273965,273965,273968,0,3,5
78282,6,1,273971,273971,273972,0,1,3
78283,1,1,273972,273972,273973,0,1,0
78284,6,1,273978,273978,273979,0,1,5
78285,1,3,273979,273979,273982,0,3,0
78286,2,2,273981,273982,273984,1,3,0
78287,5,3,273986,273986,273989,0,3,2
78288,2,3,273988,273989,273992,1,4,0
78289,5,1,273993,273993,273994,0,1,1
78290,4,3,273997,273997,274000,0,3,3
78291,1,3,273998,274000,274003,2,5,0
78292,5,2,274003,274003,274005,0,2,0
78293,1,2,274004,274005,274007,1,3,0
78294,6,3,274010,274010,274013,0,3,3
78295,4,3,274014,274014,274017,0,3,1
78296,1,1,274015,274017,274018,2,3,0
78297,1,2,274016,274018,274020,2,4,0
78298,2,1,274018,274020,274021,2,3,0
78299,2,1,274020,274021,274022,1,2,0
78300,5,1,274025,274025,274026,0,1,3
78301,6,2,274031,274031,274033,0,2,5
78302,2,1,274033,274033,274034,0,1,0
78303,2,2,274035,274035,274037,0,2,1
78304,2,3,274037,274037,274040,0,3,0
78305,2,1,274039,274040,274041,1,2,0
78306,1,3,274040,274041,274044,1,4,0
78307,1,3,274041,274044,274047,3,6,0
78308,1,3,274042,274047,274050,5,8,0
78309,6,1,274048,274050,274051,2,3,0
78310,6,2,274054,274054,274056,0,2,3
78311,4,3,274058,274058,274061,0,3,2
78312,4,1,274062,274062,274063,0,1,1
78313,2,3,274064,274064,274067,0,3,1
78314,1,3,274065,274067,274070,2,5,0
78315,1,3,274066,274070,274073,4,7,0
78316,2,2,274068,274073,274075,5,7,0
78317,3,1,274071,274075,274076,4,5,0
78318,3,2,274074,274076,274078,2,4,0
78319,1,2,274075,274078,274080,3,5,0
78320,3,3,274078,274080,274083,2,5,0
78321,1,3,274079,274083,274086,4,7,0
78322,2,1,274081,274086,274087,5,6,0
78323,1,2,274082,274087,274089,5,7,0
78324,5,3,274087,274089,274092,2,5,0
78325,3,1,274090,274092,274093,2,3,0
78326,4,2,274094,274094,274096,0,2,1
78327,1,3,274095,274096,274099,1,4,0
78328,1,2,274096,274099,274101,3,5,0
78329,1,2,274097,274101,274103,4,6,0
78330,1,3,274098,274103,274106,5,8,0
78331,6,2,274104,274106,274108,2,4,0
78332,5,1,274109,274109,274110,0,1,1
78333,5,1,274114,274114,274115,0,1,4
78334,3,2,274117,274117,274119,0,2,2
78335,4,2,274121,274121,274123,0,2,2
78336,2,3,274123,274123,274126,0,3,0
78337,2,3,274125,274126,274129,1,4,0
78338,5,1,274130,274130,274131,0,1,1
78339,3,2,274133,274133,274135,0,2,2
78340,6,1,274139,274139,274140,0,1,4
78341,4,1,274143,274143,274144,0,1,3
78342,4,1,274147,274147,274148,0,1,3
78343,6,2,274153,274153,274155,0,2,5
78344,6,1,274159,274159,274160,0,1,4
78345,3,1,274162,274162,274163,0,1,2
78346,6,2,274168,274168,274170,0,2,5
78347,2,3,274170,274170,274173,0,3,0
78348,4,1,274174,274174,274175,0,1,1
78349,1,3,274175,274175,274178,0,3,0
78350,2,2,274177,274178,274180,1,3,0
78351,1,3,274178,274180,274183,2,5,0
78352,2,3,274180,274183,274186,3,6,0
78353,5,3,274185,274186,274189,1,4,0
78354,2,3,274187,274189,274192,2,5,0
78355,3,1,274190,274192,274193,2,3,0
78356,4,3,274194,274194,274197,0,3,1
78357,6,2,274200,274200,274202,0,2,3
78358,2,3,274202,274202,274205,0,3,0
78359,2,2,274204,274205,274207,1,3,0
78360,2,3,274206,274207,274210,1,4,0
78361,6,1,274212,274212,274213,0,1,2
78362,3,3,274215,274215,274218,0,3,2
78363,3,2,274218,274218,274220,0,2,0
78364,3,3,274221,274221,274224,0,3,1
78365,2,3,274223,274224,274227,1,4,0
78366,4,2,274227,274227,274229,0,2,0
78367,5,3,274232,274232,274235,0,3,3
78368,3,3,274235,274235,274238,0,3,0
78369,2,1,274237,274238,274239,1,2,0
78370,4,2,274241,274241,274243,0,2,2
78371,4,2,274245,274245,274247,0,2,2
78372,6,1,274251,274251,274252,0,1,4
78373,2,1,274253,274253,274254,0,1,1
78374,5,3,274258,274258,274261,0,3,4
78375,1,3,274259,274261,274264,2,5,0
78376,3,2,274262,274264,274266,2,4,0
78377,3,3,274265,274266,274269,1,4,0
78378,1,1,274266,274269,274270,3,4,0
78379,3,3,274269,274270,274273,1,4,0
78380,3,3,274272,274273,274276,1,4,0
78381,4,3,274276,274276,274279,0,3,0
78382,3,2,274279,274279,274281,0,2,0
78383,1,2,274280,274281,274283,1,3,0
78384,5,2,274285,274285,274287,0,2,2
78385,5,2,274290,274290,274292,0,2,3
78386,1,3,274291,274292,274295,1,4,0
78387,2,2,274293,274295,274297,2,4,0
78388,4,2,274297,274297,274299,0,2,0
78389,2,1,274299,274299,274300,0,1,0
78390,6,1,274305,274305,274306,0,1,5
78391,1,1,274306,274306,274307,0,1,0
78392,5,2,274311,274311,274313,0,2,4
78393,6,2,274317,274317,274319,0,2,4
78394,6,2,274323,274323,274325,0,2,4
78395,4,1,274327,274327,274328,0,1,2
78396,3,1,274330,274330,274331,0,1,2
78397,1,2,274331,274331,274333,0,2,0
78398,3,3,274334,274334,274337,0,3,1
78399,5,1,274339,274339,274340,0,1,2
78400,6,2,274345,274345,274347,0,2,5
78401,2,2,274347,274347,274349,0,2,0
78402,6,3,274353,274353,274356,0,3,4
78403,5,2,274358,274358,274360,0,2,2
78404,3,2,274361,274361,274363,0,2,1
78405,6,3,274367,274367,274370,0,3,4
78406,2,1,274369,274370,274371,1,2,0
78407,4,3,274373,274373,274376,0,3,2
78408,6,1,274379,274379,274380,0,1,3
78409,2,2,274381,274381,274383,0,2,1
78410,2,1,274383,274383,274384,0,1,0
78411,3,2,274386,274386,274388,0,2,2
78412,6,2,274392,274392,274394,0,2,4
78413,6,1,274398,274398,274399,0,1,4
78414,3,1,274401,274401,274402,0,1,2
78415,2,1,274403,274403,274404,0,1,1
78416,2,1,274405,274405,274406,0,1,1
78417,6,2,274411,274411,274413,0,2,5
78418,2,3,274413,274413,274416,0,3,0
78419,1,2,274414,274416,274418,2,4,0
78420,5,2,274419,274419,274421,0,2,1
78421,4,1,274423,274423,274424,0,1,2
78422,2,3,274425,274425,274428,0,3,1
78423,3,3,274428,274428,274431,0,3,0
78424,3,2,274431,274431,274433,0,2,0
78425,4,2,274435,274435,274437,0,2,2
78426,5,2,274440,274440,274442,0,2,3
78427,2,2,274442,274442,274444,0,2,0
78428,5,1,274447,274447,274448,0,1,3
78429,6,3,274453,274453,274456,0,3,5
78430,1,2,274454,274456,274458,2,4,0
78431,5,3,274459,274459,274462,0,3,1
78432,3,3,274462,274462,274465,0,3,0
78433,5,2,274467,274467,274469,0,2,2
78434,6,2,274473,274473,274475,0,2,4
78435,4,3,274477,274477,274480,0,3,2
78436,2,1,274479,274480,274481,1,2,0
78437,6,3,274485,274485,274488,0,3,4
78438,1,2,274486,274488,274490,2,4,0
78439,1,1,274487,274490,274491,3,4,0
78440,3,1,274490,274491,274492,1,2,0
78441,2,3,274492,274492,274495,0,3,0
78442,4,1,274496,274496,274497,0,1,1
78443,6,2,274502,274502,274504,0,2,5
78444,4,3,274506,274506,274509,0,3,2
78445,5,2,274511,274511,274513,0,2,2
78446,2,2,274513,274513,274515,0,2,0
78447,3,1,274516,274516,274517,0,1,1
78448,5,1,274521,274521,274522,0,1,4
78449,5,2,274526,274526,274528,0,2,4
78450,3,2,274529,274529,274531,0,2,1
78451,4,2,274533,274533,274535,0,2,2
78452,3,3,274536,274536,274539,0,3,1
78453,3,1,274539,274539,274540,0,1,0
78454,3,1,274542,274542,274543,0,1,2
78455,4,1,274546,274546,274547,0,1,3
78456,6,1,274552,274552,274553,0,1,5
78457,6,2,274558,274558,274560,0,2,5
78458,6,3,274564,274564,274567,0,3,4
78459,5,2,274569,274569,274571,0,2,2
78460,6,2,274575,274575,274577,0,2,4
78461,3,2,274578,274578,274580,0,2,1
78462,3,2,274581,274581,274583,0,2,1
78463,3,1,274584,274584,274585,0,1,1
78464,5,3,274589,274589,274592,0,3,4
78465,5,2,274594,274594,274596,0,2,2
78466,1,3,274595,274596,274599,1,4,0
78467,6,3,274601,274601,274604,0,3,2
78468,1,2,274602,274604,274606,2,4,0
78469,6,1,274608,274608,274609,0,1,2
78470,1,1,274609,274609,274610,0,1,0
78471,2,1,274611,274611,274612,0,1,1
78472,3,2,274614,274614,274616,0,2,2
78473,6,2,274620,274620,274622,0,2,4
78474,1,3,274621,274622,274625,1,4,0
78475,4,3,274625,274625,274628,0,3,0
78476,2,2,274627,274628,274630,1,3,0
78477,2,1,274629,274630,274631,1,2,0
78478,2,1,274631,274631,274632,0,1,0
78479,1,2,274632,274632,274634,0,2,0
78480,2,3,274634,274634,274637,0,3,0
78481,2,1,274636,274637,274638,1,2,0
78482,6,1,274642,274642,274643,0,1,4
78483,6,2,274648,274648,274650,0,2,5
78484,1,3,274649,274650,274653,1,4,0
78485,5,2,274654,274654,274656,0,2,1
78486,6,2,274660,274660,274662,0,2,4
78487,6,1,274666,274666,274667,0,1,4
78488,3,3,274669,274669,274672,0,3,2
78489,1,2,274670,274672,274674,2,4,0
78490,4,3,274674,274674,274677,0,3,0
78491,2,1,274676,274677,274678,1,2,0
78492,4,3,274680,274680,274683,0,3,2
78493,2,2,274682,274683,274685,1,3,0
78494,4,3,274686,274686,274689,0,3,1
78495,6,3,274692,274692,274695,0,3,3
78496,3,2,274695,274695,274697,0,2,0
78497,6,1,274701,274701,274702,0,1,4
78498,6,3,274707,274707,274710,0,3,5
78499,1,2,274708,274710,274712,2,4,0
78500,2,2,274710,274712,274714,2,4,0
78501,6,1,274716,274716,274717,0,1,2
78502,5,2,274721,274721,274723,0,2,4
78503,2,3,274723,274723,274726,0,3,0
78504,2,1,274725,274726,274727,1,2,0
78505,6,2,274731,274731,274733,0,2,4
78506,6,3,274737,274737,274740,0,3,4
78507,3,3,274740,274740,274743,0,3,0
78508,4,2,274744,274744,274746,0,2,1
78509,6,1,274750,274750,274751,0,1,4
78510,3,3,274753,274753,274756,0,3,2
78511,4,3,274757,274757,274760,0,3,1
78512,1,2,274758,274760,274762,2,4,0
78513,1,1,274759,274762,274763,3,4,0
78514,4,1,274763,274763,274764,0,1,0
78515,3,3,274766,274766,274769,0,3,2
78516,2,3,274768,274769,274772,1,4,0
78517,2,3,274770,274772,274775,2,5,0
78518,6,3,274776,274776,274779,0,3,1
78519,3,1,274779,274779,274780,0,1,0
78520,3,1,274782,274782,274783,0,1,2
78521,1,1,274783,274783,274784,0,1,0
78522,3,1,274786,274786,274787,0,1,2
78523,1,3,274787,274787,274790,0,3,0
78524,3,3,274790,274790,274793,0,3,0
78525,6,3,274796,274796,274799,0,3,3
78526,5,2,274801,274801,274803,0,2,2
78527,4,1,274805,274805,274806,0,1,2
78528,1,2,274806,274806,274808,0,2,0
78529,1,2,274807,274808,274810,1,3,0
78530,1,2,274808,274810,274812,2,4,0
78531,3,3,274811,274812,274815,1,4,0
78532,5,1,274816,274816,274817,0,1,1
78533,4,1,274820,274820,274821,0,1,3
78534,2,3,274822,274822,274825,0,3,1
78535,3,2,274825,274825,274827,0,2,0
78536,4,1,274829,274829,274830,0,1,2
78537,1,2,274830,274830,274832,0,2,0
78538,3,3,274833,274833,274836,0,3,1
78539,5,2,274838,274838,274840,0,2,2
78540,2,2,274840,274840,274842,0,2,0
78541,6,3,274846,274846,274849,0,3,4
78542,6,3,274852,274852,274855,0,3,3
78543,2,3,274854,274855,274858,1,4,0
78544,3,1,274857,274858,274859,1,2,0
78545,1,2,274858,274859,274861,1,3,0
78546,4,2,274862,274862,274864,0,2,1
78547,2,1,274864,274864,274865,0,1,0
78548,2,1,274866,274866,274867,0,1,1
78549,3,2,274869,274869,274871,0,2,2
78550,6,1,274875,274875,274876,0,1,4
78551,5,1,274880,274880,274881,0,1,4
78552,5,2,274885,274885,274887,0,2,4
78553,3,1,274888,274888,274889,0,1,1
78554,3,3,274891,274891,274894,0,3,2
78555,1,1,274892,274894,274895,2,3,0
78556,1,3,274893,274895,274898,2,5,0
78557,5,2,274898,274898,274900,0,2,0
78558,5,3,274903,274903,274906,0,3,3
78559,1,3,274904,274906,274909,2,5,0
78560,1,1,274905,274909,274910,4,5,0
78561,4,2,274909,274910,274912,1,3,0
78562,1,2,274910,274912,274914,2,4,0
78563,3,2,274913,274914,274916,1,3,0
78564,2,1,274915,274916,274917,1,2,0
78565,3,2,274918,274918,274920,0,2,1
78566,2,3,274920,274920,274923,0,3,0
78567,1,3,274921,274923,274926,2,5,0
78568,1,1,274922,274926,274927,4,5,0
78569,5,1,274927,274927,274928,0,1,0
78570,6,2,274933,274933,274935,0,2,5
78571,5,3,274938,274938,274941,0,3,3
78572,6,3,274944,274944,274947,0,3,3
78573,6,3,274950,274950,274953,0,3,3
78574,5,3,274955,274955,274958,0,3,2
78575,5,2,274960,274960,274962,0,2,2
78576,2,1,274962,274962,274963,0,1,0
78577,3,2,274965,274965,274967,0,2,2
78578,3,2,274968,274968,274970,0,2,1
78579,4,1,274972,274972,274973,0,1,2
78580,3,3,274975,274975,274978,0,3,2
78581,6,2,274981,274981,274983,0,2,3
78582,2,3,274983,274983,274986,0,3,0
78583,5,3,274988,274988,274991,0,3,2
78584,3,1,274991,274991,274992,0,1,0
78585,3,2,274994,274994,274996,0,2,2
78586,2,2,274996,274996,274998,0,2,0
78587,3,1,274999,274999,275000,0,1,1
78588,1,3,275000,275000,275003,0,3,0
78589,6,3,275006,275006,275009,0,3,3
78590,6,3,275012,275012,275015,0,3,3
78591,3,2,275015,275015,275017,0,2,0
78592,2,1,275017,275017,275018,0,1,0
78593,6,2,275023,275023,275025,0,2,5
78594,4,2,275027,275027,275029,0,2,2
78595,2,3,275029,275029,275032,0,3,0
78596,5,3,275034,275034,275037,0,3,2
78597,2,3,275036,275037,275040,1,4,0
78598,6,1,275042,275042,275043,0,1,2
78599,3,1,275045,275045,275046,0,1,2
78600,2,3,275047,275047,275050,0,3,1
78601,5,3,275052,275052,275055,0,3,2
78602,6,3,275058,275058,275061,0,3,3
78603,5,3,275063,275063,275066,0,3,2
78604,4,2,275067,275067,275069,0,2,1
78605,1,2,275068,275069,275071,1,3,0
78606,5,3,275073,275073,275076,0,3,2
78607,6,1,275079,275079,275080,0,1,3
78608,1,1,275080,275080,275081,0,1,0
78609,6,3,275086,275086,275089,0,3,5
78610,2,1,275088,275089,275090,1,2,0
78611,2,1,275090,275090,275091,0,1,0
78612,4,1,275094,275094,275095,0,1,3
78613,5,1,275099,275099,275100,0,1,4
78614,3,1,275102,275102,275103,0,1,2
78615,1,3,275103,275103,275106,0,3,0
78616,2,1,275105,275106,275107,1,2,0
78617,4,2,275109,275109,275111,0,2,2
78618,3,1,275112,275112,275113,0,1,1
78619,1,3,275113,275113,275116,0,3,0
78620,3,2,275116,275116,275118,0,2,0
78621,3,2,275119,275119,275121,0,2,1
78622,2,3,275121,275121,275124,0,3,0
78623,4,1,275125,275125,275126,0,1,1
78624,2,3,275127,275127,275130,0,3,1
78625,2,2,275129,275130,275132,1,3,0
78626,1,2,275130,275132,275134,2,4,0
78627,4,2,275134,275134,275136,0,2,0
78628,4,1,275138,275138,275139,0,1,2
78629,2,1,275140,275140,275141,0,1,1
78630,4,3,275144,275144,275147,0,3,3
78631,1,3,275145,275147,275150,2,5,0
78632,2,2,275147,275150,275152,3,5,0
78633,3,3,275150,275152,275155,2,5,0
78634,1,1,275151,275155,275156,4,5,0
78635,5,3,275156,275156,275159,0,3,0
78636,1,1,275157,275159,275160,2,3,0
78637,4,1,275161,275161,275162,0,1,1
78638,2,2,275163,275163,275165,0,2,1
78639,4,2,275167,275167,275169,0,2,2
78640,5,3,275172,275172,275175,0,3,3
78641,2,3,275174,275175,275178,1,4,0
78642,6,2,275180,275180,275182,0,2,2
78643,6,2,275186,275186,275188,0,2,4
78644,1,1,275187,275188,275189,1,2,0
78645,1,3,275188,275189,275192,1,4,0
78646,4,2,275192,275192,275194,0,2,0
78647,3,3,275195,275195,275198,0,3,1
78648,1,3,275196,275198,275201,2,5,0
78649,3,2,275199,275201,275203,2,4,0
78650,6,1,275205,275205,275206,0,1,2
78651,4,1,275209,275209,275210,0,1,3
78652,2,3,275211,275211,275214,0,3,1
78653,1,2,275212,275214,275216,2,4,0
78654,3,1,275215,275216,275217,1,2,0
78655,2,1,275217,275217,275218,0,1,0
78656,5,2,275222,275222,275224,0,2,4
78657,6,3,275228,275228,275231,0,3,4
78658,6,1,275234,275234,275235,0,1,3
78659,3,1,275237,275237,275238,0,1,2
78660,1,3,275238,275238,275241,0,3,0
78661,6,1,275244,275244,275245,0,1,3
78662,3,2,275247,275247,275249,0,2,2
78663,1,3,275248,275249,275252,1,4,0
78664,1,2,275249,275252,275254,3,5,0
78665,3,3,275252,275254,275257,2,5,0
78666,1,3,275253,275257,275260,4,7,0
78667,1,1,275254,275260,275261,6,7,0
78668,2,1,275256,275261,275262,5,6,0
78669,3,2,275259,275262,275264,3,5,0
78670,4,3,275263,275264,275267,1,4,0
78671,3,1,275266,275267,275268,1,2,0
78672,5,1,275271,275271,275272,0,1,3
78673,4,2,275275,275275,275277,0,2,3
78674,6,3,275281,275281,275284,0,3,4
78675,2,3,275283,275284,275287,1,4,0
78676,5,2,275288,275288,275290,0,2,1
78677,4,3,275292,275292,275295,0,3,2
78678,6,3,275298,275298,275301,0,3,3
78679,3,3,275301,275301,275304,0,3,0
78680,1,2,275302,275304,275306,2,4,0
78681,5,1,275307,275307,275308,0,1,1
78682,2,2,275309,275309,275311,0,2,1
78683,5,2,275314,275314,275316,0,2,3
78684,6,1,275320,275320,275321,0,1,4
78685,5,3,275325,275325,275328,0,3,4
78686,4,2,275329,275329,275331,0,2,1
78687,4,1,275333,275333,275334,0,1,2
78688,3,3,275336,275336,275339,0,3,2
78689,4,1,275340,275340,275341,0,1,1
78690,4,3,275344,275344,275347,0,3,3
78691,6,2,275350,275350,275352,0,2,3
78692,3,3,275353,275353,275356,0,3,1
78693,5,2,275358,275358,275360,0,2,2
78694,2,1,275360,275360,275361,0,1,0
78695,1,1,275361,275361,275362,0,1,0
78696,3,2,275364,275364,275366,0,2,2
78697,2,3,275366,275366,275369,0,3,0
78698,2,2,275368,275369,275371,1,3,0
78699,6,2,275374,275374,275376,0,2,3
78700,3,1,275377,275377,275378,0,1,1
78701,3,2,275380,275380,275382,0,2,2
78702,4,1,275384,275384,275385,0,1,2
78703,6,2,275390,275390,275392,0,2,5
78704,4,1,275394,275394,275395,0,1,2
78705,3,2,275397,275397,275399,0,2,2
78706,5,1,275402,275402,275403,0,1,3
78707,6,2,275408,275408,275410,0,2,5
78708,3,2,275411,275411,275413,0,2,1
78709,3,3,275414,275414,275417,0,3,1
78710,2,3,275416,275417,275420,1,4,0
78711,3,3,275419,275420,275423,1,4,0
78712,6,1,275425,275425,275426,0,1,2
78713,2,2,275427,275427,275429,0,2,1
78714,2,2,275429,275429,275431,0,2,0
78715,2,2,275431,275431,275433,0,2,0
78716,6,1,275437,275437,275438,0,1,4
78717,1,1,275438,275438,275439,0,1,0
78718,2,2,275440,275440,275442,0,2,1
78719,5,2,275445,275445,275447,0,2,3
78720,6,1,275451,275451,275452,0,1,4
78721,4,2,275455,275455,275457,0,2,3
78722,4,2,275459,275459,275461,0,2,2
78723,2,2,275461,275461,275463,0,2,0
78724,6,3,275467,275467,275470,0,3,4
78725,1,3,275468,275470,275473,2,5,0
78726,4,1,275472,275473,275474,1,2,0
78727,2,2,275474,275474,275476,0,2,0
78728,5,1,275479,275479,275480,0,1,3
78729,6,1,275485,275485,275486,0,1,5
78730,3,1,275488,275488,275489,0,1,2
78731,2,3,275490,275490,275493,0,3,1
78732,3,1,275493,275493,275494,0,1,0
78733,3,3,275496,275496,275499,0,3,2
78734,2,2,275498,275499,275501,1,3,0
78735,4,3,275502,275502,275505,0,3,1
78736,3,3,275505,275505,275508,0,3,0
78737,4,3,275509,275509,275512,0,3,1
78738,2,3,275511,275512,275515,1,4,0
78739,5,3,275516,275516,275519,0,3,1
78740,6,2,275522,275522,275524,0,2,3
78741,2,2,275524,275524,275526,0,2,0
78742,5,1,275529,275529,275530,0,1,3
78743,6,3,275535,275535,275538,0,3,5
78744,5,3,275540,275540,275543,0,3,2
78745,3,3,275543,275543,275546,0,3,0
78746,2,2,275545,275546,275548,1,3,0
78747,2,3,275547,275548,275551,1,4,0
78748,3,3,275550,275551,275554,1,4,0
78749,4,3,275554,275554,275557,0,3,0
78750,2,1,275556,275557,275558,1,2,0
78751,5,2,275561,275561,275563,0,2,3
78752,5,1,275566,275566,275567,0,1,3
78753,3,3,275569,275569,275572,0,3,2
78754,4,3,275573,275573,275576,0,3,1
78755,3,1,275576,275576,275577,0,1,0
78756,1,2,275577,275577,275579,0,2,0
78757,1,2,275578,275579,275581,1,3,0
78758,3,3,275581,275581,275584,0,3,0
78759,6,3,275587,275587,275590,0,3,3
78760,3,1,275590,275590,275591,0,1,0
78761,3,3,275593,275593,275596,0,3,2
78762,6,2,275599,275599,275601,0,2,3
78763,3,3,275602,275602,275605,0,3,1
78764,2,3,275604,275605,275608,1,4,0
78765,6,3,275610,275610,275613,0,3,2
78766,6,3,275616,275616,275619,0,3,3
78767,6,3,275622,275622,275625,0,3,3
78768,3,2,275625,275625,275627,0,2,0
78769,4,2,275629,275629,275631,0,2,2
78770,1,1,275630,275631,275632,1,2,0
78771,3,3,275633,275633,275636,0,3,1
78772,1,3,275634,275636,275639,2,5,0
78773,2,3,275636,275639,275642,3,6,0
78774,3,2,275639,275642,275644,3,5,0
78775,2,2,275641,275644,275646,3,5,0
78776,3,3,275644,275646,275649,2,5,0
78777,3,3,275647,275649,275652,2,5,0
78778,5,1,275652,275652,275653,0,1,0
78779,3,2,275655,275655,275657,0,2,2
78780,1,3,275656,275657,275660,1,4,0
78781,3,2,275659,275660,275662,1,3,0
78782,1,1,275660,275662,275663,2,3,0
78783,2,2,275662,275663,275665,1,3,0
78784,4,1,275666,275666,275667,0,1,1
78785,4,2,275670,275670,275672,0,2,3
78786,6,2,275676,275676,275678,0,2,4
78787,2,2,275678,275678,275680,0,2,0
78788,2,3,275680,275680,275683,0,3,0
78789,4,2,275684,275684,275686,0,2,1
78790,6,3,275690,275690,275693,0,3,4
78791,5,3,275695,275695,275698,0,3,2
78792,2,1,275697,275698,275699,1,2,0
78793,6,1,275703,275703,275704,0,1,4
78794,2,1,275705,275705,275706,0,1,1
78795,4,1,275709,275709,275710,0,1,3
78796,6,1,275715,275715,275716,0,1,5
78797,1,1,275716,275716,275717,0,1,0
78798,2,3,275718,275718,275721,0,3,1
78799,2,2,275720,275721,275723,1,3,0
78800,2,2,275722,275723,275725,1,3,0
78801,3,2,275725,275725,275727,0,2,0
78802,1,2,275726,275727,275729,1,3,0
78803,5,3,275731,275731,275734,0,3,2
78804,2,3,275733,275734,275737,1,4,0
78805,3,1,275736,275737,275738,1,2,0
78806,3,3,275739,275739,275742,0,3,1
78807,1,2,275740,275742,275744,2,4,0
78808,6,1,275746,275746,275747,0,1,2
78809,2,1,275748,275748,275749,0,1,1
78810,5,3,275753,275753,275756,0,3,4
78811,5,2,275758,275758,275760,0,2,2
78812,6,3,275764,275764,275767,0,3,4
78813,4,1,275768,275768,275769,0,1,1
78814,3,2,275771,275771,275773,0,2,2
78815,6,2,275777,275777,275779,0,2,4
78816,1,1,275778,275779,275780,1,2,0
78817,2,1,275780,275780,275781,0,1,0
78818,2,1,275782,275782,275783,0,1,1
78819,3,1,275785,275785,275786,0,1,2
78820,3,3,275788,275788,275791,0,3,2
78821,6,2,275794,275794,275796,0,2,3
78822,5,3,275799,275799,275802,0,3,3
78823,6,1,275805,275805,275806,0,1,3
78824,3,1,275808,275808,275809,0,1,2
78825,2,1,275810,275810,275811,0,1,1
78826,5,3,275815,275815,275818,0,3,4
78827,1,1,275816,275818,275819,2,3,0
78828,4,1,275820,275820,275821,0,1,1
78829,2,1,275822,275822,275823,0,1,1
78830,6,1,275828,275828,275829,0,1,5
78831,3,1,275831,275831,275832,0,1,2
78832,6,1,275837,275837,275838,0,1,5
78833,3,3,275840,275840,275843,0,3,2
78834,5,2,275845,275845,275847,0,2,2
78835,5,3,275850,275850,275853,0,3,3
78836,2,1,275852,275853,275854,1,2,0
78837,2,1,275854,275854,275855,0,1,0
78838,1,1,275855,275855,275856,0,1,0
78839,3,1,275858,275858,275859,0,1,2
78840,6,3,275864,275864,275867,0,3,5
78841,3,1,275867,275867,275868,0,1,0
78842,1,1,275868,275868,275869,0,1,0
78843,4,2,275872,275872,275874,0,2,3
78844,4,1,275876,275876,275877,0,1,2
78845,6,1,275882,275882,275883,0,1,5
78846,5,1,275887,275887,275888,0,1,4
78847,4,2,275891,275891,275893,0,2,3
78848,2,1,275893,275893,275894,0,1,0
78849,6,3,275899,275899,275902,0,3,5
78850,6,1,275905,275905,275906,0,1,3
78851,5,2,275910,275910,275912,0,2,4
78852,1,3,275911,275912,275915,1,4,0
78853,4,3,275915,275915,275918,0,3,0
78854,5,3,275920,275920,275923,0,3,2
78855,6,1,275926,275926,275927,0,1,3
78856,2,2,275928,275928,275930,0,2,1
78857,1,3,275929,275930,275933,1,4,0
78858,6,2,275935,275935,275937,0,2,2
78859,4,2,275939,275939,275941,0,2,2
78860,3,2,275942,275942,275944,0,2,1
78861,1,3,275943,275944,275947,1,4,0
78862,6,1,275949,275949,275950,0,1,2
78863,1,1,275950,275950,275951,0,1,0
78864,4,3,275954,275954,275957,0,3,3
78865,1,3,275955,275957,275960,2,5,0
78866,2,1,275957,275960,275961,3,4,0
78867,2,3,275959,275961,275964,2,5,0
78868,3,1,275962,275964,275965,2,3,0
78869,5,3,275967,275967,275970,0,3,2
78870,4,3,275971,275971,275974,0,3,1
78871,4,3,275975,275975,275978,0,3,1
78872,3,2,275978,275978,275980,0,2,0
78873,1,2,275979,275980,275982,1,3,0
78874,4,2,275983,275983,275985,0,2,1
78875,2,2,275985,275985,275987,0,2,0
78876,2,1,275987,275987,275988,0,1,0
78877,5,1,275992,275992,275993,0,1,4
78878,1,1,275993,275993,275994,0,1,0
78879,5,2,275998,275998,276000,0,2,4
78880,2,1,276000,276000,276001,0,1,0
78881,2,2,276002,276002,276004,0,2,1
78882,4,2,276006,276006,276008,0,2,2
78883,4,3,276010,276010,276013,0,3,2
78884,2,2,276012,276013,276015,1,3,0
78885,3,1,276015,276015,276016,0,1,0
78886,1,3,276016,276016,276019,0,3,0
78887,2,1,276018,276019,276020,1,2,0
78888,2,2,276020,276020,276022,0,2,0
78889,1,2,276021,276022,276024,1,3,0
78890,1,3,276022,276024,276027,2,5,0
78891,2,1,276024,276027,276028,3,4,0
78892,2,2,276026,276028,276030,2,4,0
78893,3,1,276029,276030,276031,1,2,0
78894,2,1,276031,276031,276032,0,1,0
78895,1,3,276032,276032,276035,0,3,0
78896,3,2,276035,276035,276037,0,2,0
78897,5,1,276040,276040,276041,0,1,3
78898,5,2,276045,276045,276047,0,2,4
78899,2,2,276047,276047,276049,0,2,0
78900,4,1,276051,276051,276052,0,1,2
78901,2,2,276053,276053,276055,0,2,1
78902,3,1,276056,276056,276057,0,1,1
78903,5,2,276061,276061,276063,0,2,4
78904,3,1,276064,276064,276065,0,1,1
78905,4,1,276068,276068,276069,0,1,3
78906,1,2,276069,276069,276071,0,2,0
78907,1,2,276070,276071,276073,1,3,0
78908,4,3,276074,276074,276077,0,3,1
78909,3,3,276077,276077,276080,0,3,0
78910,6,3,276083,276083,276086,0,3,3
78911,1,1,276084,276086,276087,2,3,0
78912,2,2,276086,276087,276089,1,3,0
78913,5,2,276091,276091,276093,0,2,2
78914,2,2,276093,276093,276095,0,2,0
78915,6,3,276099,276099,276102,0,3,4
78916,3,1,276102,276102,276103,0,1,0
78917,2,3,276104,276104,276107,0,3,1
78918,1,1,276105,276107,276108,2,3,0
78919,3,3,276108,276108,276111,0,3,0
78920,1,1,276109,276111,276112,2,3,0
78921,6,1,276115,276115,276116,0,1,3
78922,4,1,276119,276119,276120,0,1,3
78923,3,3,276122,276122,276125,0,3,2
78924,2,3,276124,276125,276128,1,4,0
78925,1,3,276125,276128,276131,3,6,0
78926,2,1,276127,276131,276132,4,5,0
78927,6,3,276133,276133,276136,0,3,1
78928,4,2,276137,276137,276139,0,2,1
78929,5,2,276142,276142,276144,0,2,3
78930,4,1,276146,276146,276147,0,1,2
78931,5,3,276151,276151,276154,0,3,4
78932,1,3,276152,276154,276157,2,5,0
78933,1,2,276153,276157,276159,4,6,0
78934,2,2,276155,276159,276161,4,6,0
78935,5,1,276160,276161,276162,1,2,0
78936,3,2,276163,276163,276165,0,2,1
78937,1,1,276164,276165,276166,1,2,0
78938,4,2,276168,276168,276170,0,2,2
78939,2,3,276170,276170,276173,0,3,0
78940,6,2,276176,276176,276178,0,2,3
78941,1,3,276177,276178,276181,1,4,0
78942,5,3,276182,276182,276185,0,3,1
78943,5,1,276187,276187,276188,0,1,2
78944,1,3,276188,276188,276191,0,3,0
78945,2,2,276190,276191,276193,1,3,0
78946,5,2,276195,276195,276197,0,2,2
78947,2,2,276197,276197,276199,0,2,0
78948,2,3,276199,276199,276202,0,3,0
78949,1,1,276200,276202,276203,2,3,0
78950,6,2,276206,276206,276208,0,2,3
78951,3,2,276209,276209,276211,0,2,1
78952,5,1,276214,276214,276215,0,1,3
78953,5,1,276219,276219,276220,0,1,4
78954,1,3,276220,276220,276223,0,3,0
78955,1,1,276221,276223,276224,2,3,0
78956,2,3,276223,276224,276227,1,4,0
78957,2,1,276225,276227,276228,2,3,0
78958,3,1,276228,276228,276229,0,1,0
78959,2,1,276230,276230,276231,0,1,1
78960,2,3,276232,276232,276235,0,3,1
78961,6,3,276238,276238,276241,0,3,3
78962,4,1,276242,276242,276243,0,1,1
78963,5,2,276247,276247,276249,0,2,4
78964,4,2,276251,276251,276253,0,2,2
78965,4,3,276255,276255,276258,0,3,2
78966,5,2,276260,276260,276262,0,2,2
78967,6,1,276266,276266,276267,0,1,4
78968,6,1,276272,276272,276273,0,1,5
78969,4,1,276276,276276,276277,0,1,3
78970,4,1,276280,276280,276281,0,1,3
78971,1,2,276281,276281,276283,0,2,0
78972,6,2,276287,276287,276289,0,2,4
78973,5,2,276292,276292,276294,0,2,3
78974,4,2,276296,276296,276298,0,2,2
78975,4,1,276300,276300,276301,0,1,2
78976,6,3,276306,276306,276309,0,3,5
78977,4,3,276310,276310,276313,0,3,1
78978,6,3,276316,276316,276319,0,3,3
78979,6,2,276322,276322,276324,0,2,3
78980,4,2,276326,276326,276328,0,2,2
78981,1,1,276327,276328,276329,1,2,0
78982,5,1,276332,276332,276333,0,1,3
78983,6,3,276338,276338,276341,0,3,5
78984,2,1,276340,276341,276342,1,2,0
78985,6,1,276346,276346,276347,0,1,4
78986,2,1,276348,276348,276349,0,1,1
78987,6,3,276354,276354,276357,0,3,5
78988,4,1,276358,276358,276359,0,1,1
78989,6,3,276364,276364,276367,0,3,5
78990,4,1,276368,276368,276369,0,1,1
78991,1,1,276369,276369,276370,0,1,0
78992,4,3,276373,276373,276376,0,3,3
78993,4,2,276377,276377,276379,0,2,1
78994,5,3,276382,276382,276385,0,3,3
78995,3,3,276385,276385,276388,0,3,0
78996,3,3,276388,276388,276391,0,3,0
78997,4,2,276392,276392,276394,0,2,1
78998,3,3,276395,276395,276398,0,3,1
78999,3,2,276398,276398,276400,0,2,0
79000,4,1,276402,276402,276403,0,1,2
79001,3,1,276405,276405,276406,0,1,2
79002,6,2,276411,276411,276413,0,2,5
79003,6,3,276417,276417,276420,0,3,4
79004,2,2,276419,276420,276422,1,3,0
79005,2,3,276421,276422,276425,1,4,0
79006,1,2,276422,276425,276427,3,5,0
79007,4,3,276426,276427,276430,1,4,0
79008,4,2,276430,276430,276432,0,2,0
79009,3,1,276433,276433,276434,0,1,1
79010,3,2,276436,276436,276438,0,2,2
79011,6,1,276442,276442,276443,0,1,4
79012,6,3,276448,276448,276451,0,3,5
79013,6,3,276454,276454,276457,0,3,3
79014,1,3,276455,276457,276460,2,5,0
79015,4,3,276459,276460,276463,1,4,0
79016,2,3,276461,276463,276466,2,5,0
79017,5,1,276466,276466,276467,0,1,0
79018,5,3,276471,276471,276474,0,3,4
79019,1,3,276472,276474,276477,2,5,0
79020,4,3,276476,276477,276480,1,4,0
79021,6,2,276482,276482,276484,0,2,2
79022,2,1,276484,276484,276485,0,1,0
79023,6,2,276490,276490,276492,0,2,5
79024,2,1,276492,276492,276493,0,1,0
79025,1,2,276493,276493,276495,0,2,0
79026,1,2,276494,276495,276497,1,3,0
79027,2,3,276496,276497,276500,1,4,0
79028,5,2,276501,276501,276503,0,2,1
79029,1,2,276502,276503,276505,1,3,0
79030,5,2,276507,276507,276509,0,2,2
79031,4,3,276511,276511,276514,0,3,2
79032,6,1,276517,276517,276518,0,1,3
79033,2,3,276519,276519,276522,0,3,1
79034,6,2,276525,276525,276527,0,2,3
79035,4,3,276529,276529,276532,0,3,2
79036,3,1,276532,276532,276533,0,1,0
79037,1,3,276533,276533,276536,0,3,0
79038,5,1,276538,276538,276539,0,1,2
79039,1,3,276539,276539,276542,0,3,0
79040,1,3,276540,276542,276545,2,5,0
79041,6,3,276546,276546,276549,0,3,1
79042,3,2,276549,276549,276551,0,2,0
79043,1,2,276550,276551,276553,1,3,0
79044,5,1,276555,276555,276556,0,1,2
79045,1,1,276556,276556,276557,0,1,0
79046,5,1,276561,276561,276562,0,1,4
79047,3,3,276564,276564,276567,0,3,2
79048,1,2,276565,276567,276569,2,4,0
79049,4,1,276569,276569,276570,0,1,0
79050,3,3,276572,276572,276575,0,3,2
79051,4,3,276576,276576,276579,0,3,1
79052,1,3,276577,276579,276582,2,5,0
79053,4,3,276581,276582,276585,1,4,0
79054,4,1,276585,276585,276586,0,1,0
79055,5,1,276590,276590,276591,0,1,4
79056,1,2,276591,276591,276593,0,2,0
79057,6,2,276597,276597,276599,0,2,4
79058,6,2,276603,276603,276605,0,2,4
79059,2,1,276605,276605,276606,0,1,0
79060,4,3,276609,276609,276612,0,3,3
79061,4,1,276613,276613,276614,0,1,1
79062,2,2,276615,276615,276617,0,2,1
79063,6,2,276621,276621,276623,0,2,4
79064,1,2,276622,276623,276625,1,3,0
79065,1,2,276623,276625,276627,2,4,0
79066,3,1,276626,276627,276628,1,2,0
79067,3,3,276629,276629,276632,0,3,1
79068,1,3,276630,276632,276635,2,5,0
79069,3,1,276633,276635,276636,2,3,0
79070,5,3,276638,276638,276641,0,3,2
79071,3,1,276641,276641,276642,0,1,0
79072,6,3,276647,276647,276650,0,3,5
79073,6,1,276653,276653,276654,0,1,3
79074,5,2,276658,276658,276660,0,2,4
79075,2,2,276660,276660,276662,0,2,0
79076,5,2,276665,276665,276667,0,2,3
79077,2,3,276667,276667,276670,0,3,0
79078,2,2,276669,276670,276672,1,3,0
79079,3,3,276672,276672,276675,0,3,0
79080,6,1,276678,276678,276679,0,1,3
79081,1,3,276679,276679,276682,0,3,0
79082,3,3,276682,276682,276685,0,3,0
79083,4,2,276686,276686,276688,0,2,1
79084,2,2,276688,276688,276690,0,2,0
79085,4,1,276692,276692,276693,0,1,2
79086,6,2,276698,276698,276700,0,2,5
79087,1,3,276699,276700,276703,1,4,0
79088,2,2,276701,276703,276705,2,4,0
79089,2,3,276703,276705,276708,2,5,0
79090,2,3,276705,276708,276711,3,6,0
79091,3,3,276708,276711,276714,3,6,0
79092,5,1,276713,276714,276715,1,2,0
79093,4,2,276717,276717,276719,0,2,2
79094,3,3,276720,276720,276723,0,3,1
79095,6,1,276726,276726,276727,0,1,3
79096,2,1,276728,276728,276729,0,1,1
79097,1,2,276729,276729,276731,0,2,0
79098,5,3,276734,276734,276737,0,3,3
79099,5,2,276739,276739,276741,0,2,2
79100,1,3,276740,276741,276744,1,4,0
79101,4,1,276744,276744,276745,0,1,0
79102,2,1,276746,276746,276747,0,1,1
79103,6,2,276752,276752,276754,0,2,5
79104,2,1,276754,276754,276755,0,1,0
79105,6,3,276760,276760,276763,0,3,5
79106,4,2,276764,276764,276766,0,2,1
79107,5,1,276769,276769,276770,0,1,3
79108,1,1,276770,276770,276771,0,1,0
79109,4,1,276774,276774,276775,0,1,3
79110,3,3,276777,276777,276780,0,3,2
79111,1,1,276778,276780,276781,2,3,0
79112,6,3,276784,276784,276787,0,3,3
79113,6,1,276790,276790,276791,0,1,3
79114,6,2,276796,276796,276798,0,2,5
79115,5,2,276801,276801,276803,0,2,3
79116,4,1,276805,276805,276806,0,1,2
79117,4,2,276809,276809,276811,0,2,3
79118,5,3,276814,276814,276817,0,3,3
79119,3,3,276817,276817,276820,0,3,0
79120,2,1,276819,276820,276821,1,2,0
79121,5,2,276824,276824,276826,0,2,3
79122,4,2,276828,276828,276830,0,2,2
79123,6,3,276834,276834,276837,0,3,4
79124,5,3,276839,276839,276842,0,3,2
79125,1,3,276840,276842,276845,2,5,0
79126,5,2,276845,276845,276847,0,2,0
79127,1,1,276846,276847,276848,1,2,0
79128,6,2,276852,276852,276854,0,2,4
79129,6,3,276858,276858,276861,0,3,4
79130,1,3,276859,276861,276864,2,5,0
79131,3,1,276862,276864,276865,2,3,0
79132,4,1,276866,276866,276867,0,1,1
79133,1,1,276867,276867,276868,0,1,0
79134,6,3,276873,276873,276876,0,3,5
79135,5,1,276878,276878,276879,0,1,2
79136,4,2,276882,276882,276884,0,2,3
79137,6,2,276888,276888,276890,0,2,4
79138,5,3,276893,276893,276896,0,3,3
79139,3,3,276896,276896,276899,0,3,0
79140,2,2,276898,276899,276901,1,3,0
79141,1,2,276899,276901,276903,2,4,0
79142,5,3,276904,276904,276907,0,3,1
79143,1,2,276905,276907,276909,2,4,0
79144,4,3,276909,276909,276912,0,3,0
79145,2,1,276911,276912,276913,1,2,0
79146,2,1,276913,276913,276914,0,1,0
79147,1,2,276914,276914,276916,0,2,0
79148,1,1,276915,276916,276917,1,2,0
79149,5,3,276920,276920,276923,0,3,3
79150,3,3,276923,276923,276926,0,3,0
79151,2,1,276925,276926,276927,1,2,0
79152,5,2,276930,276930,276932,0,2,3
79153,4,3,276934,276934,276937,0,3,2
79154,3,1,276937,276937,276938,0,1,0
79155,2,3,276939,276939,276942,0,3,1
79156,3,2,276942,276942,276944,0,2,0
79157,5,3,276947,276947,276950,0,3,3
79158,5,1,276952,276952,276953,0,1,2
79159,6,3,276958,276958,276961,0,3,5
79160,4,1,276962,276962,276963,0,1,1
79161,3,3,276965,276965,276968,0,3,2
79162,3,2,276968,276968,276970,0,2,0
79163,3,2,276971,276971,276973,0,2,1
79164,6,1,276977,276977,276978,0,1,4
79165,2,2,276979,276979,276981,0,2,1
79166,1,3,276980,276981,276984,1,4,0
79167,5,1,276985,276985,276986,0,1,1
79168,1,1,276986,276986,276987,0,1,0
79169,4,1,276990,276990,276991,0,1,3
79170,3,2,276993,276993,276995,0,2,2
79171,5,1,276998,276998,276999,0,1,3
79172,6,2,277004,277004,277006,0,2,5
79173,5,3,277009,277009,277012,0,3,3
79174,5,2,277014,277014,277016,0,2,2
79175,2,3,277016,277016,277019,0,3,0
79176,5,2,277021,277021,277023,0,2,2
79177,4,1,277025,277025,277026,0,1,2
79178,6,3,277031,277031,277034,0,3,5
79179,4,2,277035,277035,277037,0,2,1
79180,5,1,277040,277040,277041,0,1,3
79181,4,1,277044,277044,277045,0,1,3
79182,5,3,277049,277049,277052,0,3,4
79183,4,1,277053,277053,277054,0,1,1
79184,6,2,277059,277059,277061,0,2,5
79185,4,3,277063,277063,277066,0,3,2
79186,5,3,277068,277068,277071,0,3,2
79187,6,3,277074,277074,277077,0,3,3
79188,2,3,277076,277077,277080,1,4,0
79189,6,2,277082,277082,277084,0,2,2
79190,3,3,277085,277085,277088,0,3,1
79191,1,2,277086,277088,277090,2,4,0
79192,3,3,277089,277090,277093,1,4,0
79193,3,2,277092,277093,277095,1,3,0
79194,1,2,277093,277095,277097,2,4,0
79195,3,1,277096,277097,277098,1,2,0
79196,4,1,277100,277100,277101,0,1,2
79197,3,2,277103,277103,277105,0,2,2
79198,5,1,277108,277108,277109,0,1,3
79199,3,2,277111,277111,277113,0,2,2
79200,3,2,277114,277114,277116,0,2,1
79201,4,1,277118,277118,277119,0,1,2
79202,6,3,277124,277124,277127,0,3,5
79203,4,2,277128,277128,277130,0,2,1
79204,6,3,277134,277134,277137,0,3,4
79205,3,3,277137,277137,277140,0,3,0
79206,3,1,277140,277140,277141,0,1,0
79207,5,3,277145,277145,277148,0,3,4
79208,2,1,277147,277148,277149,1,2,0
79209,1,2,277148,277149,277151,1,3,0
79210,3,2,277151,277151,277153,0,2,0
79211,4,3,277155,277155,277158,0,3,2
79212,3,1,277158,277158,277159,0,1,0
79213,5,2,277163,277163,277165,0,2,4
79214,3,2,277166,277166,277168,0,2,1
79215,3,3,277169,277169,277172,0,3,1
79216,3,1,277172,277172,277173,0,1,0
79217,6,3,277178,277178,277181,0,3,5
79218,4,2,277182,277182,277184,0,2,1
79219,6,1,277188,277188,277189,0,1,4
79220,3,3,277191,277191,277194,0,3,2
79221,3,3,277194,277194,277197,0,3,0
79222,4,3,277198,277198,277201,0,3,1
79223,1,2,277199,277201,277203,2,4,0
79224,1,3,277200,277203,277206,3,6,0
79225,4,3,277204,277206,277209,2,5,0
79226,1,3,277205,277209,277212,4,7,0
79227,5,2,277210,277212,277214,2,4,0
79228,4,2,277214,277214,277216,0,2,0
79229,2,3,277216,277216,277219,0,3,0
79230,2,1,277218,277219,277220,1,2,0
79231,6,3,277224,277224,277227,0,3,4
79232,1,3,277225,277227,277230,2,5,0
79233,3,1,277228,277230,277231,2,3,0
79234,3,2,277231,277231,277233,0,2,0
79235,6,2,277237,277237,277239,0,2,4
79236,5,2,277242,277242,277244,0,2,3
79237,6,1,277248,277248,277249,0,1,4
79238,3,3,277251,277251,277254,0,3,2
79239,5,2,277256,277256,277258,0,2,2
79240,4,3,277260,277260,277263,0,3,2
79241,4,2,277264,277264,277266,0,2,1
79242,4,3,277268,277268,277271,0,3,2
79243,2,3,277270,277271,277274,1,4,0
79244,4,1,277274,277274,277275,0,1,0
79245,3,2,277277,277277,277279,0,2,2
79246,2,1,277279,277279,277280,0,1,0
79247,1,2,277280,277280,277282,0,2,0
79248,2,2,277282,277282,277284,0,2,0
79249,1,2,277283,277284,277286,1,3,0
79250,2,2,277285,277286,277288,1,3,0
79251,1,1,277286,277288,277289,2,3,0
79252,4,3,277290,277290,277293,0,3,1
79253,4,1,277294,277294,277295,0,1,1
79254,2,1,277296,277296,277297,0,1,1
79255,2,2,277298,277298,277300,0,2,1
79256,1,2,277299,277300,277302,1,3,0
79257,5,1,277304,277304,277305,0,1,2
79258,3,2,277307,277307,277309,0,2,2
79259,6,2,277313,277313,277315,0,2,4
79260,1,1,277314,277315,277316,1,2,0
79261,4,1,277318,277318,277319,0,1,2
79262,3,1,277321,277321,277322,0,1,2
79263,2,1,277323,277323,277324,0,1,1
79264,5,2,277328,277328,277330,0,2,4
79265,3,3,277331,277331,277334,0,3,1
79266,5,1,277336,277336,277337,0,1,2
79267,2,3,277338,277338,277341,0,3,1
79268,3,3,277341,277341,277344,0,3,0
79269,4,1,277345,277345,277346,0,1,1
79270,1,3,277346,277346,277349,0,3,0
79271,6,2,277352,277352,277354,0,2,3
79272,2,3,277354,277354,277357,0,3,0
79273,1,1,277355,277357,277358,2,3,0
79274,3,3,277358,277358,277361,0,3,0
79275,5,1,277363,277363,277364,0,1,2
79276,2,3,277365,277365,277368,0,3,1
79277,6,1,277371,277371,277372,0,1,3
79278,6,3,277377,277377,277380,0,3,5
79279,4,3,277381,277381,277384,0,3,1
79280,1,1,277382,277384,277385,2,3,0
79281,6,2,277388,277388,277390,0,2,3
79282,2,3,277390,277390,277393,0,3,0
79283,4,2,277394,277394,277396,0,2,1
79284,6,2,277400,277400,277402,0,2,4
79285,6,1,277406,277406,277407,0,1,4
79286,5,1,277411,277411,277412,0,1,4
79287,6,2,277417,277417,277419,0,2,5
79288,6,3,277423,277423,277426,0,3,4
79289,5,2,277428,277428,277430,0,2,2
79290,6,2,277434,277434,277436,0,2,4
79291,4,3,277438,277438,277441,0,3,2
79292,4,3,277442,277442,277445,0,3,1
79293,6,2,277448,277448,277450,0,2,3
79294,6,3,277454,277454,277457,0,3,4
79295,6,1,277460,277460,277461,0,1,3
79296,5,1,277465,277465,277466,0,1,4
79297,4,3,277469,277469,277472,0,3,3
79298,4,3,277473,277473,277476,0,3,1
79299,6,1,277479,277479,277480,0,1,3
79300,1,3,277480,277480,277483,0,3,0
79301,2,1,277482,277483,277484,1,2,0
79302,1,1,277483,277484,277485,1,2,0
79303,3,1,277486,277486,277487,0,1,1
79304,4,1,277490,277490,277491,0,1,3
79305,2,2,277492,277492,277494,0,2,1
79306,5,3,277497,277497,277500,0,3,3
79307,6,1,277503,277503,277504,0,1,3
79308,6,3,277509,277509,277512,0,3,5
79309,6,2,277515,277515,277517,0,2,3
79310,2,3,277517,277517,277520,0,3,0
79311,4,2,277521,277521,277523,0,2,1
79312,6,2,277527,277527,277529,0,2,4
79313,6,1,277533,277533,277534,0,1,4
79314,6,3,277539,277539,277542,0,3,5
79315,5,3,277544,277544,277547,0,3,2
79316,4,1,277548,277548,277549,0,1,1
79317,1,3,277549,277549,277552,0,3,0
79318,3,3,277552,277552,277555,0,3,0
79319,6,2,277558,277558,277560,0,2,3
79320,5,3,277563,277563,277566,0,3,3
79321,6,2,277569,277569,277571,0,2,3
79322,4,3,277573,277573,277576,0,3,2
79323,3,3,277576,277576,277579,0,3,0
79324,4,1,277580,277580,277581,0,1,1
79325,6,3,277586,277586,277589,0,3,5
79326,4,1,277590,277590,277591,0,1,1
79327,5,3,277595,277595,277598,0,3,4
79328,5,2,277600,277600,277602,0,2,2
79329,6,2,277606,277606,277608,0,2,4
79330,1,3,277607,277608,277611,1,4,0
79331,4,1,277611,277611,277612,0,1,0
79332,1,3,277612,277612,277615,0,3,0
79333,3,2,277615,277615,277617,0,2,0
79334,5,3,277620,277620,277623,0,3,3
79335,4,3,277624,277624,277627,0,3,1
79336,4,2,277628,277628,277630,0,2,1
79337,2,1,277630,277630,277631,0,1,0
79338,1,2,277631,277631,277633,0,2,0
79339,4,3,277635,277635,277638,0,3,2
79340,5,2,277640,277640,277642,0,2,2
79341,6,1,277646,277646,277647,0,1,4
79342,6,1,277652,277652,277653,0,1,5
79343,2,1,277654,277654,277655,0,1,1
79344,5,3,277659,277659,277662,0,3,4
79345,1,1,277660,277662,277663,2,3,0
79346,6,1,277666,277666,277667,0,1,3
79347,6,3,277672,277672,277675,0,3,5
79348,5,1,277677,277677,277678,0,1,2
79349,2,3,277679,277679,277682,0,3,1
79350,1,3,277680,277682,277685,2,5,0
79351,1,2,277681,277685,277687,4,6,0
79352,1,1,277682,277687,277688,5,6,0
79353,3,1,277685,277688,277689,3,4,0
79354,6,3,277691,277691,277694,0,3,2
79355,5,1,277696,277696,277697,0,1,2
79356,2,2,277698,277698,277700,0,2,1
79357,4,3,277702,277702,277705,0,3,2
79358,2,2,277704,277705,277707,1,3,0
79359,3,2,277707,277707,277709,0,2,0
79360,6,3,277713,277713,277716,0,3,4
79361,2,2,277715,277716,277718,1,3,0
79362,5,1,277720,277720,277721,0,1,2
79363,3,3,277723,277723,277726,0,3,2
79364,6,2,277729,277729,277731,0,2,3
79365,3,3,277732,277732,277735,0,3,1
79366,4,1,277736,277736,277737,0,1,1
79367,2,2,277738,277738,277740,0,2,1
79368,6,1,277744,277744,277745,0,1,4
79369,6,3,277750,277750,277753,0,3,5
79370,2,3,277752,277753,277756,1,4,0
79371,5,1,277757,277757,277758,0,1,1
79372,5,2,277762,277762,277764,0,2,4
79373,6,3,277768,277768,277771,0,3,4
79374,1,1,277769,277771,277772,2,3,0
79375,4,3,277773,277773,277776,0,3,1
79376,4,3,277777,277777,277780,0,3,1
79377,6,1,277783,277783,277784,0,1,3
79378,6,2,277789,277789,277791,0,2,5
79379,2,2,277791,277791,277793,0,2,0
79380,3,2,277794,277794,277796,0,2,1
79381,4,3,277798,277798,277801,0,3,2
79382,4,1,277802,277802,277803,0,1,1
79383,3,1,277805,277805,277806,0,1,2
79384,2,2,277807,277807,277809,0,2,1
79385,5,3,277812,277812,277815,0,3,3
79386,3,2,277815,277815,277817,0,2,0
79387,4,1,277819,277819,277820,0,1,2
79388,5,1,277824,277824,277825,0,1,4
79389,5,3,277829,277829,277832,0,3,4
79390,5,2,277834,277834,277836,0,2,2
79391,2,2,277836,277836,277838,0,2,0
79392,1,3,277837,277838,277841,1,4,0
79393,5,2,277842,277842,277844,0,2,1
79394,6,3,277848,277848,277851,0,3,4
79395,1,3,277849,277851,277854,2,5,0
79396,5,1,277854,277854,277855,0,1,0
79397,3,1,277857,277857,277858,0,1,2
79398,2,1,277859,277859,277860,0,1,1
79399,6,1,277865,277865,277866,0,1,5
79400,3,1,277868,277868,277869,0,1,2
79401,2,2,277870,277870,277872,0,2,1
79402,3,3,277873,277873,277876,0,3,1
79403,4,2,277877,277877,277879,0,2,1
79404,6,3,277883,277883,277886,0,3,4
79405,6,3,277889,277889,277892,0,3,3
79406,6,2,277895,277895,277897,0,2,3
79407,3,1,277898,277898,277899,0,1,1
79408,6,2,277904,277904,277906,0,2,5
79409,1,3,277905,277906,277909,1,4,0
79410,4,3,277909,277909,277912,0,3,0
79411,6,2,277915,277915,277917,0,2,3
79412,1,3,277916,277917,277920,1,4,0
79413,3,1,277919,277920,277921,1,2,0
79414,4,3,277923,277923,277926,0,3,2
79415,2,1,277925,277926,277927,1,2,0
79416,3,2,277928,277928,277930,0,2,1
79417,1,3,277929,277930,277933,1,4,0
79418,2,1,277931,277933,277934,2,3,0
79419,4,2,277935,277935,277937,0,2,1
79420,6,3,277941,277941,277944,0,3,4
79421,3,1,277944,277944,277945,0,1,0
79422,3,3,277947,277947,277950,0,3,2
79423,4,2,277951,277951,277953,0,2,1
79424,2,2,277953,277953,277955,0,2,0
79425,5,1,277958,277958,277959,0,1,3
79426,6,3,277964,277964,277967,0,3,5
79427,3,1,277967,277967,277968,0,1,0
79428,4,3,277971,277971,277974,0,3,3
79429,4,1,277975,277975,277976,0,1,1
79430,4,2,277979,277979,277981,0,2,3
79431,3,3,277982,277982,277985,0,3,1
79432,1,1,277983,277985,277986,2,3,0
79433,4,1,277987,277987,277988,0,1,1
79434,3,3,277990,277990,277993,0,3,2
79435,3,3,277993,277993,277996,0,3,0
79436,2,1,277995,277996,277997,1,2,0
79437,3,2,277998,277998,278000,0,2,1
79438,6,3,278004,278004,278007,0,3,4
79439,1,1,278005,278007,278008,2,3,0
79440,5,1,278010,278010,278011,0,1,2
79441,3,3,278013,278013,278016,0,3,2
79442,5,3,278018,278018,278021,0,3,2
79443,2,3,278020,278021,278024,1,4,0
79444,5,1,278025,278025,278026,0,1,1
79445,3,1,278028,278028,278029,0,1,2
79446,4,3,278032,278032,278035,0,3,3
79447,6,2,278038,278038,278040,0,2,3
79448,6,3,278044,278044,278047,0,3,4
79449,2,3,278046,278047,278050,1,4,0
79450,6,1,278052,278052,278053,0,1,2
79451,2,1,278054,278054,278055,0,1,1
79452,3,2,278057,278057,278059,0,2,2
79453,4,1,278061,278061,278062,0,1,2
79454,5,2,278066,278066,278068,0,2,4
79455,2,1,278068,278068,278069,0,1,0
79456,5,2,278073,278073,278075,0,2,4
79457,2,2,278075,278075,278077,0,2,0
79458,3,3,278078,278078,278081,0,3,1
79459,1,2,278079,278081,278083,2,4,0
79460,4,1,278083,278083,278084,0,1,0
79461,3,3,278086,278086,278089,0,3,2
79462,2,2,278088,278089,278091,1,3,0
79463,6,3,278094,278094,278097,0,3,3
79464,5,2,278099,278099,278101,0,2,2
79465,5,3,278104,278104,278107,0,3,3
79466,5,2,278109,278109,278111,0,2,2
79467,5,1,278114,278114,278115,0,1,3
79468,5,1,278119,278119,278120,0,1,4
79469,2,3,278121,278121,278124,0,3,1
79470,5,2,278126,278126,278128,0,2,2
79471,5,3,278131,278131,278134,0,3,3
79472,4,3,278135,278135,278138,0,3,1
79473,5,2,278140,278140,278142,0,2,2
79474,4,3,278144,278144,278147,0,3,2
79475,3,2,278147,278147,278149,0,2,0
79476,1,1,278148,278149,278150,1,2,0
79477,2,3,278150,278150,278153,0,3,0
79478,3,3,278153,278153,278156,0,3,0
79479,4,3,278157,278157,278160,0,3,1
79480,1,2,278158,278160,278162,2,4,0
79481,5,2,278163,278163,278165,0,2,1
79482,5,3,278168,278168,278171,0,3,3
79483,3,2,278171,278171,278173,0,2,0
79484,1,2,278172,278173,278175,1,3,0
79485,3,1,278175,278175,278176,0,1,0
79486,3,1,278178,278178,278179,0,1,2
79487,6,3,278184,278184,278187,0,3,5
79488,1,3,278185,278187,278190,2,5,0
79489,3,2,278188,278190,278192,2,4,0
79490,6,1,278194,278194,278195,0,1,2
79491,1,2,278195,278195,278197,0,2,0
79492,5,2,278200,278200,278202,0,2,3
79493,1,1,278201,278202,278203,1,2,0
79494,6,2,278207,278207,278209,0,2,4
79495,3,1,278210,278210,278211,0,1,1
79496,6,1,278216,278216,278217,0,1,5
79497,5,2,278221,278221,278223,0,2,4
79498,6,3,278227,278227,278230,0,3,4
79499,3,3,278230,278230,278233,0,3,0
79500,4,2,278234,278234,278236,0,2,1
79501,6,2,278240,278240,278242,0,2,4
79502,2,3,278242,278242,278245,0,3,0
79503,5,1,278247,278247,278248,0,1,2
79504,6,1,278253,278253,278254,0,1,5
79505,3,3,278256,278256,278259,0,3,2
79506,2,1,278258,278259,278260,1,2,0
79507,1,2,278259,278260,278262,1,3,0
79508,4,2,278263,278263,278265,0,2,1
79509,2,1,278265,278265,278266,0,1,0
79510,6,2,278271,278271,278273,0,2,5
79511,1,1,278272,278273,278274,1,2,0
79512,1,2,278273,278274,278276,1,3,0
79513,5,2,278278,278278,278280,0,2,2
79514,4,2,278282,278282,278284,0,2,2
79515,2,3,278284,278284,278287,0,3,0
79516,1,2,278285,278287,278289,2,4,0
79517,4,1,278289,278289,278290,0,1,0
79518,5,1,278294,278294,278295,0,1,4
79519,4,2,278298,278298,278300,0,2,3
79520,6,2,278304,278304,278306,0,2,4
79521,4,3,278308,278308,278311,0,3,2
79522,5,1,278313,278313,278314,0,1,2
79523,6,3,278319,278319,278322,0,3,5
79524,2,2,278321,278322,278324,1,3,0
79525,6,1,278327,278327,278328,0,1,3
79526,2,2,278329,278329,278331,0,2,1
79527,5,1,278334,278334,278335,0,1,3
79528,5,3,278339,278339,278342,0,3,4
79529,2,3,278341,278342,278345,1,4,0
79530,4,3,278345,278345,278348,0,3,0
79531,1,3,278346,278348,278351,2,5,0
79532,2,1,278348,278351,278352,3,4,0
79533,5,1,278353,278353,278354,0,1,1
79534,5,1,278358,278358,278359,0,1,4
79535,4,1,278362,278362,278363,0,1,3
79536,2,2,278364,278364,278366,0,2,1
79537,6,1,278370,278370,278371,0,1,4
79538,1,3,278371,278371,278374,0,3,0
79539,4,3,278375,278375,278378,0,3,1
79540,1,2,278376,278378,278380,2,4,0
79541,2,2,278378,278380,278382,2,4,0
79542,3,1,278381,278382,278383,1,2,0
79543,4,2,278385,278385,278387,0,2,2
79544,2,3,278387,278387,278390,0,3,0
79545,1,3,278388,278390,278393,2,5,0
79546,1,1,278389,278393,278394,4,5,0
79547,2,1,278391,278394,278395,3,4,0
79548,2,2,278393,278395,278397,2,4,0
79549,3,3,278396,278397,278400,1,4,0
79550,1,2,278397,278400,278402,3,5,0
79551,5,1,278402,278402,278403,0,1,0
79552,2,1,278404,278404,278405,0,1,1
79553,2,3,278406,278406,278409,0,3,1
79554,2,2,278408,278409,278411,1,3,0
79555,6,3,278414,278414,278417,0,3,3
79556,4,1,278418,278418,278419,0,1,1
79557,3,3,278421,278421,278424,0,3,2
79558,3,1,278424,278424,278425,0,1,0
79559,2,1,278426,278426,278427,0,1,1
79560,3,1,278429,278429,278430,0,1,2
79561,3,3,278432,278432,278435,0,3,2
79562,5,1,278437,278437,278438,0,1,2
79563,2,1,278439,278439,278440,0,1,1
79564,3,1,278442,278442,278443,0,1,2
79565,1,2,278443,278443,278445,0,2,0
79566,5,3,278448,278448,278451,0,3,3
79567,2,3,278450,278451,278454,1,4,0
79568,4,2,278454,278454,278456,0,2,0
79569,1,3,278455,278456,278459,1,4,0
79570,2,3,278457,278459,278462,2,5,0
79571,2,3,278459,278462,278465,3,6,0
79572,1,2,278460,278465,278467,5,7,0
79573,6,3,278466,278467,278470,1,4,0
79574,5,2,278471,278471,278473,0,2,1
79575,3,2,278474,278474,278476,0,2,1
79576,4,1,278478,278478,278479,0,1,2
79577,6,1,278484,278484,278485,0,1,5
79578,4,3,278488,278488,278491,0,3,3
79579,2,2,278490,278491,278493,1,3,0
79580,2,2,278492,278493,278495,1,3,0
79581,2,2,278494,278495,278497,1,3,0
79582,1,2,278495,278497,278499,2,4,0
79583,6,2,278501,278501,278503,0,2,2
79584,3,2,278504,278504,278506,0,2,1
79585,2,3,278506,278506,278509,0,3,0
79586,4,3,278510,278510,278513,0,3,1
79587,1,2,278511,278513,278515,2,4,0
79588,5,3,278516,278516,278519,0,3,1
79589,1,3,278517,278519,278522,2,5,0
79590,4,2,278521,278522,278524,1,3,0
79591,1,2,278522,278524,278526,2,4,0
79592,5,3,278527,278527,278530,0,3,1
79593,2,3,278529,278530,278533,1,4,0
79594,3,1,278532,278533,278534,1,2,0
79595,3,3,278535,278535,278538,0,3,1
79596,1,1,278536,278538,278539,2,3,0
79597,3,2,278539,278539,278541,0,2,0
79598,6,1,278545,278545,278546,0,1,4
79599,1,1,278546,278546,278547,0,1,0
79600,2,2,278548,278548,278550,0,2,1
79601,6,2,278554,278554,278556,0,2,4
79602,5,3,278559,278559,278562,0,3,3
79603,2,2,278561,278562,278564,1,3,0
79604,4,2,278565,278565,278567,0,2,1
79605,4,1,278569,278569,278570,0,1,2
79606,2,2,278571,278571,278573,0,2,1
79607,6,2,278577,278577,278579,0,2,4
79608,1,1,278578,278579,278580,1,2,0
79609,5,3,278583,278583,278586,0,3,3
79610,1,2,278584,278586,278588,2,4,0
79611,3,1,278587,278588,278589,1,2,0
79612,5,2,278592,278592,278594,0,2,3
79613,5,1,278597,278597,278598,0,1,3
79614,5,2,278602,278602,278604,0,2,4
79615,5,2,278607,278607,278609,0,2,3
79616,3,1,278610,278610,278611,0,1,1
79617,6,3,278616,278616,278619,0,3,5
79618,6,3,278622,278622,278625,0,3,3
79619,6,1,278628,278628,278629,0,1,3
79620,1,1,278629,278629,278630,0,1,0
79621,1,2,278630,278630,278632,0,2,0
79622,5,2,278635,278635,278637,0,2,3
79623,3,3,278638,278638,278641,0,3,1
79624,1,1,278639,278641,278642,2,3,0
79625,5,1,278644,278644,278645,0,1,2
79626,5,1,278649,278649,278650,0,1,4
79627,5,1,278654,278654,278655,0,1,4
79628,5,2,278659,278659,278661,0,2,4
79629,3,1,278662,278662,278663,0,1,1
79630,4,2,278666,278666,278668,0,2,3
79631,2,1,278668,278668,278669,0,1,0
79632,2,3,278670,278670,278673,0,3,1
79633,2,1,278672,278673,278674,1,2,0
79634,1,1,278673,278674,278675,1,2,0
79635,2,1,278675,278675,278676,0,1,0
79636,3,1,278678,278678,278679,0,1,2
79637,1,1,278679,278679,278680,0,1,0
79638,4,3,278683,278683,278686,0,3,3
79639,5,3,278688,278688,278691,0,3,2
79640,6,1,278694,278694,278695,0,1,3
79641,2,1,278696,278696,278697,0,1,1
79642,6,3,278702,278702,278705,0,3,5
79643,2,3,278704,278705,278708,1,4,0
79644,2,2,278706,278708,278710,2,4,0
79645,6,2,278712,278712,278714,0,2,2
79646,2,1,278714,278714,278715,0,1,0
79647,1,2,278715,278715,278717,0,2,0
79648,5,2,278720,278720,278722,0,2,3
79649,6,2,278726,278726,278728,0,2,4
79650,6,3,278732,278732,278735,0,3,4
79651,1,1,278733,278735,278736,2,3,0
79652,1,3,278734,278736,278739,2,5,0
79653,5,1,278739,278739,278740,0,1,0
79654,2,3,278741,278741,278744,0,3,1
79655,6,2,278747,278747,278749,0,2,3
79656,5,1,278752,278752,278753,0,1,3
79657,2,2,278754,278754,278756,0,2,1
79658,1,2,278755,278756,278758,1,3,0
79659,1,1,278756,278758,278759,2,3,0
79660,5,3,278761,278761,278764,0,3,2
79661,6,1,278767,278767,278768,0,1,3
79662,2,1,278769,278769,278770,0,1,1
79663,1,3,278770,278770,278773,0,3,0
79664,1,1,278771,278773,278774,2,3,0
79665,4,1,278775,278775,278776,0,1,1
79666,3,2,278778,278778,278780,0,2,2
79667,1,2,278779,278780,278782,1,3,0
79668,6,3,278785,278785,278788,0,3,3
79669,3,3,278788,278788,278791,0,3,0
79670,6,2,278794,278794,278796,0,2,3
79671,2,3,278796,278796,278799,0,3,0
79672,6,3,278802,278802,278805,0,3,3
79673,4,2,278806,278806,278808,0,2,1
79674,5,2,278811,278811,278813,0,2,3
79675,6,2,278817,278817,278819,0,2,4
79676,4,1,278821,278821,278822,0,1,2
79677,6,2,278827,278827,278829,0,2,5
79678,4,2,278831,278831,278833,0,2,2
79679,5,2,278836,278836,278838,0,2,3
79680,5,3,278841,278841,278844,0,3,3
79681,2,1,278843,278844,278845,1,2,0
79682,5,2,278848,278848,278850,0,2,3
79683,3,3,278851,278851,278854,0,3,1
79684,6,2,278857,278857,278859,0,2,3
79685,5,3,278862,278862,278865,0,3,3
79686,1,2,278863,278865,278867,2,4,0
79687,3,1,278866,278867,278868,1,2,0
79688,2,3,278868,278868,278871,0,3,0
79689,2,1,278870,278871,278872,1,2,0
79690,6,3,278876,278876,278879,0,3,4
79691,2,2,278878,278879,278881,1,3,0
79692,2,1,278880,278881,278882,1,2,0
79693,3,3,278883,278883,278886,0,3,1
79694,3,3,278886,278886,278889,0,3,0
79695,6,2,278892,278892,278894,0,2,3
79696,2,1,278894,278894,278895,0,1,0
79697,6,2,278900,278900,278902,0,2,5
79698,5,2,278905,278905,278907,0,2,3
79699,5,2,278910,278910,278912,0,2,3
79700,6,2,278916,278916,278918,0,2,4
79701,1,3,278917,278918,278921,1,4,0
79702,5,3,278922,278922,278925,0,3,1
79703,2,1,278924,278925,278926,1,2,0
79704,5,2,278929,278929,278931,0,2,3
79705,5,3,278934,278934,278937,0,3,3
79706,1,2,278935,278937,278939,2,4,0
79707,5,2,278940,278940,278942,0,2,1
79708,4,3,278944,278944,278947,0,3,2
79709,3,3,278947,278947,278950,0,3,0
79710,2,2,278949,278950,278952,1,3,0
79711,2,1,278951,278952,278953,1,2,0
79712,4,2,278955,278955,278957,0,2,2
79713,4,2,278959,278959,278961,0,2,2
79714,5,2,278964,278964,278966,0,2,3
79715,5,3,278969,278969,278972,0,3,3
79716,6,3,278975,278975,278978,0,3,3
79717,2,2,278977,278978,278980,1,3,0
79718,2,2,278979,278980,278982,1,3,0
79719,5,2,278984,278984,278986,0,2,2
79720,6,1,278990,278990,278991,0,1,4
79721,2,1,278992,278992,278993,0,1,1
79722,4,1,278996,278996,278997,0,1,3
79723,4,1,279000,279000,279001,0,1,3
79724,1,2,279001,279001,279003,0,2,0
79725,6,1,279007,279007,279008,0,1,4
79726,4,1,279011,279011,279012,0,1,3
79727,2,2,279013,279013,279015,0,2,1
79728,3,2,279016,279016,279018,0,2,1
79729,5,1,279021,279021,279022,0,1,3
79730,3,3,279024,279024,279027,0,3,2
79731,5,1,279029,279029,279030,0,1,2
79732,3,1,279032,279032,279033,0,1,2
79733,3,3,279035,279035,279038,0,3,2
79734,2,3,279037,279038,279041,1,4,0
79735,3,2,279040,279041,279043,1,3,0
79736,3,1,279043,279043,279044,0,1,0
79737,3,3,279046,279046,279049,0,3,2
79738,1,1,279047,279049,279050,2,3,0
79739,4,1,279051,279051,279052,0,1,1
79740,3,3,279054,279054,279057,0,3,2
79741,6,2,279060,279060,279062,0,2,3
79742,4,2,279064,279064,279066,0,2,2
79743,4,1,279068,279068,279069,0,1,2
79744,4,1,279072,279072,279073,0,1,3
79745,2,3,279074,279074,279077,0,3,1
79746,4,3,279078,279078,279081,0,3,1
79747,5,3,279083,279083,279086,0,3,2
79748,6,3,279089,279089,279092,0,3,3
79749,5,1,279094,279094,279095,0,1,2
79750,3,3,279097,279097,279100,0,3,2
79751,4,1,279101,279101,279102,0,1,1
79752,2,3,279103,279103,279106,0,3,1
79753,2,1,279105,279106,279107,1,2,0
79754,2,3,279107,279107,279110,0,3,0
79755,1,2,279108,279110,279112,2,4,0
79756,1,1,279109,279112,279113,3,4,0
79757,5,3,279114,279114,279117,0,3,1
79758,6,1,279120,279120,279121,0,1,3
79759,4,1,279124,279124,279125,0,1,3
79760,2,1,279126,279126,279127,0,1,1
79761,6,3,279132,279132,279135,0,3,5
79762,3,2,279135,279135,279137,0,2,0
79763,6,2,279141,279141,279143,0,2,4
79764,6,3,279147,279147,279150,0,3,4
79765,3,3,279150,279150,279153,0,3,0
79766,4,2,279154,279154,279156,0,2,1
79767,4,1,279158,279158,279159,0,1,2
79768,6,3,279164,279164,279167,0,3,5
79769,4,1,279168,279168,279169,0,1,1
79770,6,2,279174,279174,279176,0,2,5
79771,2,1,279176,279176,279177,0,1,0
79772,2,2,279178,279178,279180,0,2,1
79773,6,1,279184,279184,279185,0,1,4
79774,1,2,279185,279185,279187,0,2,0
79775,1,1,279186,279187,279188,1,2,0
79776,1,1,279187,279188,279189,1,2,0
79777,6,3,279193,279193,279196,0,3,4
79778,3,3,279196,279196,279199,0,3,0
79779,5,3,279201,279201,279204,0,3,2
79780,1,1,279202,279204,279205,2,3,0
79781,2,1,279204,279205,279206,1,2,0
79782,5,1,279209,279209,279210,0,1,3
79783,3,1,279212,279212,279213,0,1,2
79784,6,1,279218,279218,279219,0,1,5
79785,4,1,279222,279222,279223,0,1,3
79786,2,3,279224,279224,279227,0,3,1
79787,1,3,279225,279227,279230,2,5,0
79788,5,1,279230,279230,279231,0,1,0
79789,1,1,279231,279231,279232,0,1,0
79790,2,2,279233,279233,279235,0,2,1
79791,6,3,279239,279239,279242,0,3,4
79792,1,1,279240,279242,279243,2,3,0
79793,3,3,279243,279243,279246,0,3,0
79794,6,2,279249,279249,279251,0,2,3
79795,2,2,279251,279251,279253,0,2,0
79796,4,1,279255,279255,279256,0,1,2
79797,2,1,279257,279257,279258,0,1,1
79798,3,2,279260,279260,279262,0,2,2
79799,3,1,279263,279263,279264,0,1,1
79800,1,2,279264,279264,279266,0,2,0
79801,3,3,279267,279267,279270,0,3,1
79802,4,1,279271,279271,279272,0,1,1
79803,2,1,279273,279273,279274,0,1,1
79804,1,2,279274,279274,279276,0,2,0
79805,5,1,279279,279279,279280,0,1,3
79806,5,1,279284,279284,279285,0,1,4
79807,3,1,279287,279287,279288,0,1,2
79808,3,1,279290,279290,279291,0,1,2
79809,2,2,279292,279292,279294,0,2,1
79810,3,2,279295,279295,279297,0,2,1
79811,5,2,279300,279300,279302,0,2,3
79812,5,1,279305,279305,279306,0,1,3
79813,3,3,279308,279308,279311,0,3,2
79814,5,1,279313,279313,279314,0,1,2
79815,1,3,279314,279314,279317,0,3,0
79816,6,2,279320,279320,279322,0,2,3
79817,4,2,279324,279324,279326,0,2,2
79818,3,3,279327,279327,279330,0,3,1
79819,4,3,279331,279331,279334,0,3,1
79820,3,3,279334,279334,279337,0,3,0
79821,3,1,279337,279337,279338,0,1,0
79822,3,3,279340,279340,279343,0,3,2
79823,4,1,279344,279344,279345,0,1,1
79824,6,3,279350,279350,279353,0,3,5
79825,3,1,279353,279353,279354,0,1,0
79826,5,3,279358,279358,279361,0,3,4
79827,5,1,279363,279363,279364,0,1,2
79828,1,3,279364,279364,279367,0,3,0
79829,6,1,279370,279370,279371,0,1,3
79830,1,3,279371,279371,279374,0,3,0
79831,6,2,279377,279377,279379,0,2,3
79832,2,2,279379,279379,279381,0,2,0
79833,4,3,279383,279383,279386,0,3,2
79834,5,3,279388,279388,279391,0,3,2
79835,1,1,279389,279391,279392,2,3,0
79836,6,3,279395,279395,279398,0,3,3
79837,5,1,279400,279400,279401,0,1,2
79838,5,1,279405,279405,279406,0,1,4
79839,2,1,279407,279407,279408,0,1,1
79840,2,3,279409,279409,279412,0,3,1
79841,6,1,279415,279415,279416,0,1,3
79842,4,2,279419,279419,279421,0,2,3
79843,2,1,279421,279421,279422,0,1,0
79844,4,1,279425,279425,279426,0,1,3
79845,6,2,279431,279431,279433,0,2,5
79846,5,3,279436,279436,279439,0,3,3
79847,6,3,279442,279442,279445,0,3,3
79848,4,1,279446,279446,279447,0,1,1
79849,1,3,279447,279447,279450,0,3,0
79850,3,2,279450,279450,279452,0,2,0
79851,6,2,279456,279456,279458,0,2,4
79852,3,2,279459,279459,279461,0,2,1
79853,3,2,279462,279462,279464,0,2,1
79854,6,3,279468,279468,279471,0,3,4
79855,3,2,279471,279471,279473,0,2,0
79856,3,2,279474,279474,279476,0,2,1
79857,4,2,279478,279478,279480,0,2,2
79858,1,1,279479,279480,279481,1,2,0
79859,2,2,279481,279481,279483,0,2,0
79860,5,3,279486,279486,279489,0,3,3
79861,4,3,279490,279490,279493,0,3,1
79862,2,2,279492,279493,279495,1,3,0
79863,3,2,279495,279495,279497,0,2,0
79864,2,3,279497,279497,279500,0,3,0
79865,4,1,279501,279501,279502,0,1,1
79866,2,1,279503,279503,279504,0,1,1
79867,6,2,279509,279509,279511,0,2,5
79868,6,1,279515,279515,279516,0,1,4
79869,6,1,279521,279521,279522,0,1,5
79870,5,3,279526,279526,279529,0,3,4
79871,6,2,279532,279532,279534,0,2,3
79872,1,1,279533,279534,279535,1,2,0
79873,5,3,279538,279538,279541,0,3,3
79874,3,3,279541,279541,279544,0,3,0
79875,2,3,279543,279544,279547,1,4,0
79876,2,3,279545,279547,279550,2,5,0
79877,2,2,279547,279550,279552,3,5,0
79878,1,3,279548,279552,279555,4,7,0
79879,2,1,279550,279555,279556,5,6,0
79880,6,1,279556,279556,279557,0,1,0
79881,1,1,279557,279557,279558,0,1,0
79882,2,2,279559,279559,279561,0,2,1
79883,1,2,279560,279561,279563,1,3,0
79884,4,1,279564,279564,279565,0,1,1
79885,1,1,279565,279565,279566,0,1,0
79886,2,2,279567,279567,279569,0,2,1
79887,2,2,279569,279569,279571,0,2,0
79888,4,1,279573,279573,279574,0,1,2
79889,2,3,279575,279575,279578,0,3,1
79890,3,3,279578,279578,279581,0,3,0
79891,5,2,279583,279583,279585,0,2,2
79892,3,2,279586,279586,279588,0,2,1
79893,6,1,279592,279592,279593,0,1,4
79894,4,2,279596,279596,279598,0,2,3
79895,3,1,279599,279599,279600,0,1,1
79896,2,2,279601,279601,279603,0,2,1
79897,1,3,279602,279603,279606,1,4,0
79898,1,2,279603,279606,279608,3,5,0
79899,4,1,279607,279608,279609,1,2,0
79900,4,1,279611,279611,279612,0,1,2
79901,2,3,279613,279613,279616,0,3,1
79902,6,1,279619,279619,279620,0,1,3
79903,6,1,279625,279625,279626,0,1,5
79904,2,2,279627,279627,279629,0,2,1
79905,4,3,279631,279631,279634,0,3,2
79906,6,1,279637,279637,279638,0,1,3
79907,1,2,279638,279638,279640,0,2,0
79908,1,2,279639,279640,279642,1,3,0
79909,2,1,279641,279642,279643,1,2,0
79910,4,1,279645,279645,279646,0,1,2
79911,1,2,279646,279646,279648,0,2,0
79912,2,1,279648,279648,279649,0,1,0
79913,5,3,279653,279653,279656,0,3,4
79914,5,3,279658,279658,279661,0,3,2
79915,5,2,279663,279663,279665,0,2,2
79916,2,2,279665,279665,279667,0,2,0
79917,2,2,279667,279667,279669,0,2,0
79918,3,2,279670,279670,279672,0,2,1
79919,3,2,279673,279673,279675,0,2,1
79920,2,2,279675,279675,279677,0,2,0
79921,1,3,279676,279677,279680,1,4,0
79922,6,2,279682,279682,279684,0,2,2
79923,6,1,279688,279688,279689,0,1,4
79924,2,1,279690,279690,279691,0,1,1
79925,5,3,279695,279695,279698,0,3,4
79926,1,1,279696,279698,279699,2,3,0
79927,5,1,279701,279701,279702,0,1,2
79928,5,2,279706,279706,279708,0,2,4
79929,4,2,279710,279710,279712,0,2,2
79930,5,2,279715,279715,279717,0,2,3
79931,2,2,279717,279717,279719,0,2,0
79932,2,1,279719,279719,279720,0,1,0
79933,3,1,279722,279722,279723,0,1,2
79934,6,3,279728,279728,279731,0,3,5
79935,4,3,279732,279732,279735,0,3,1
79936,1,3,279733,279735,279738,2,5,0
79937,1,1,279734,279738,279739,4,5,0
79938,5,1,279739,279739,279740,0,1,0
79939,1,1,279740,279740,279741,0,1,0
79940,3,1,279743,279743,279744,0,1,2
79941,3,3,279746,279746,279749,0,3,2
79942,4,1,279750,279750,279751,0,1,1
79943,2,3,279752,279752,279755,0,3,1
79944,6,3,279758,279758,279761,0,3,3
79945,2,3,279760,279761,279764,1,4,0
79946,2,1,279762,279764,279765,2,3,0
79947,2,2,279764,279765,279767,1,3,0
79948,3,2,279767,279767,279769,0,2,0
79949,3,2,279770,279770,279772,0,2,1
79950,4,1,279774,279774,279775,0,1,2
79951,4,2,279778,279778,279780,0,2,3
79952,2,1,279780,279780,279781,0,1,0
79953,2,1,279782,279782,279783,0,1,1
79954,3,3,279785,279785,279788,0,3,2
79955,6,1,279791,279791,279792,0,1,3
79956,6,2,279797,279797,279799,0,2,5
79957,4,3,279801,279801,279804,0,3,2
79958,6,1,279807,279807,279808,0,1,3
79959,1,3,279808,279808,279811,0,3,0
79960,2,3,279810,279811,279814,1,4,0
79961,3,3,279813,279814,279817,1,4,0
79962,2,2,279815,279817,279819,2,4,0
79963,6,2,279821,279821,279823,0,2,2
79964,3,2,279824,279824,279826,0,2,1
79965,3,2,279827,279827,279829,0,2,1
79966,3,2,279830,279830,279832,0,2,1
79967,2,2,279832,279832,279834,0,2,0
79968,2,1,279834,279834,279835,0,1,0
79969,3,3,279837,279837,279840,0,3,2
79970,2,2,279839,279840,279842,1,3,0
79971,3,2,279842,279842,279844,0,2,0
79972,3,3,279845,279845,279848,0,3,1
79973,5,3,279850,279850,279853,0,3,2
79974,6,1,279856,279856,279857,0,1,3
79975,6,3,279862,279862,279865,0,3,5
79976,6,2,279868,279868,279870,0,2,3
79977,5,3,279873,279873,279876,0,3,3
79978,3,3,279876,279876,279879,0,3,0
79979,5,1,279881,279881,279882,0,1,2
79980,3,3,279884,279884,279887,0,3,2
79981,6,1,279890,279890,279891,0,1,3
79982,6,2,279896,279896,279898,0,2,5
79983,4,3,279900,279900,279903,0,3,2
79984,3,2,279903,279903,279905,0,2,0
79985,3,3,279906,279906,279909,0,3,1
79986,2,2,279908,279909,279911,1,3,0
79987,5,1,279913,279913,279914,0,1,2
79988,1,3,279914,279914,279917,0,3,0
79989,5,2,279919,279919,279921,0,2,2
79990,3,1,279922,279922,279923,0,1,1
79991,3,3,279925,279925,279928,0,3,2
79992,5,2,279930,279930,279932,0,2,2
79993,1,1,279931,279932,279933,1,2,0
79994,5,3,279936,279936,279939,0,3,3
79995,1,3,279937,279939,279942,2,5,0
79996,6,3,279943,279943,279946,0,3,1
79997,3,2,279946,279946,279948,0,2,0
79998,6,3,279952,279952,279955,0,3,4
79999,3,1,279955,279955,279956,0,1,0
80000,3,1,279958,279958,279959,0,1,2
80001,3,2,279961,279961,279963,0,2,2
80002,3,1,279964,279964,279965,0,1,1
80003,1,1,279965,279965,279966,0,1,0
80004,4,3,279969,279969,279972,0,3,3
80005,4,3,279973,279973,279976,0,3,1
80006,1,1,279974,279976,279977,2,3,0
80007,3,3,279977,279977,279980,0,3,0
80008,6,3,279983,279983,279986,0,3,3
80009,1,2,279984,279986,279988,2,4,0
80010,5,2,279989,279989,279991,0,2,1
80011,5,2,279994,279994,279996,0,2,3
80012,1,2,279995,279996,279998,1,3,0
80013,3,1,279998,279998,279999,0,1,0
80014,3,3,280001,280001,280004,0,3,2
80015,6,3,280007,280007,280010,0,3,3
80016,5,3,280012,280012,280015,0,3,2
80017,5,1,280017,280017,280018,0,1,2
80018,5,3,280022,280022,280025,0,3,4
80019,4,2,280026,280026,280028,0,2,1
80020,1,1,280027,280028,280029,1,2,0
80021,1,1,280028,280029,280030,1,2,0
80022,4,3,280032,280032,280035,0,3,2
80023,4,1,280036,280036,280037,0,1,1
80024,1,1,280037,280037,280038,0,1,0
80025,2,2,280039,280039,280041,0,2,1
80026,1,1,280040,280041,280042,1,2,0
80027,5,1,280045,280045,280046,0,1,3
80028,6,2,280051,280051,280053,0,2,5
80029,4,3,280055,280055,280058,0,3,2
80030,1,2,280056,280058,280060,2,4,0
80031,5,2,280061,280061,280063,0,2,1
80032,2,1,280063,280063,280064,0,1,0
80033,1,2,280064,280064,280066,0,2,0
80034,1,2,280065,280066,280068,1,3,0
80035,2,1,280067,280068,280069,1,2,0
80036,3,2,280070,280070,280072,0,2,1
80037,3,1,280073,280073,280074,0,1,1
80038,5,3,280078,280078,280081,0,3,4
80039,1,3,280079,280081,280084,2,5,0
80040,6,1,280085,280085,280086,0,1,1
80041,3,1,280088,280088,280089,0,1,2
80042,6,1,280094,280094,280095,0,1,5
80043,4,1,280098,280098,280099,0,1,3
80044,5,3,280103,280103,280106,0,3,4
80045,4,2,280107,280107,280109,0,2,1
80046,2,2,280109,280109,280111,0,2,0
80047,1,2,280110,280111,280113,1,3,0
80048,5,1,280115,280115,280116,0,1,2
80049,1,1,280116,280116,280117,0,1,0
80050,3,3,280119,280119,280122,0,3,2
80051,3,1,280122,280122,280123,0,1,0
80052,1,3,280123,280123,280126,0,3,0
80053,2,2,280125,280126,280128,1,3,0
80054,3,1,280128,280128,280129,0,1,0
80055,3,1,280131,280131,280132,0,1,2
80056,5,3,280136,280136,280139,0,3,4
80057,6,3,280142,280142,280145,0,3,3
80058,4,1,280146,280146,280147,0,1,1
80059,5,2,280151,280151,280153,0,2,4
80060,2,3,280153,280153,280156,0,3,0
80061,2,3,280155,280156,280159,1,4,0
80062,5,1,280160,280160,280161,0,1,1
80063,6,2,280166,280166,280168,0,2,5
80064,5,1,280171,280171,280172,0,1,3
80065,5,1,280176,280176,280177,0,1,4
80066,2,2,280178,280178,280180,0,2,1
80067,1,2,280179,280180,280182,1,3,0
80068,2,2,280181,280182,280184,1,3,0
80069,5,1,280186,280186,280187,0,1,2
80070,6,3,280192,280192,280195,0,3,5
80071,6,1,280198,280198,280199,0,1,3
80072,6,1,280204,280204,280205,0,1,5
80073,5,2,280209,280209,280211,0,2,4
80074,2,2,280211,280211,280213,0,2,0
80075,6,2,280217,280217,280219,0,2,4
80076,3,1,280220,280220,280221,0,1,1
80077,1,1,280221,280221,280222,0,1,0
80078,5,1,280226,280226,280227,0,1,4
80079,1,3,280227,280227,280230,0,3,0
80080,2,2,280229,280230,280232,1,3,0
80081,2,2,280231,280232,280234,1,3,0
80082,5,3,280236,280236,280239,0,3,2
80083,6,3,280242,280242,280245,0,3,3
80084,1,1,280243,280245,280246,2,3,0
80085,4,2,280247,280247,280249,0,2,1
80086,5,1,280252,280252,280253,0,1,3
80087,1,2,280253,280253,280255,0,2,0
80088,3,1,280256,280256,280257,0,1,1
80089,1,3,280257,280257,280260,0,3,0
80090,4,2,280261,280261,280263,0,2,1
80091,5,2,280266,280266,280268,0,2,3
80092,5,1,280271,280271,280272,0,1,3
80093,4,1,280275,280275,280276,0,1,3
80094,4,1,280279,280279,280280,0,1,3
80095,3,2,280282,280282,280284,0,2,2
80096,4,1,280286,280286,280287,0,1,2
80097,3,3,280289,280289,280292,0,3,2
80098,1,3,280290,280292,280295,2,5,0
80099,5,2,280295,280295,280297,0,2,0
80100,1,3,280296,280297,280300,1,4,0
80101,6,3,280302,280302,280305,0,3,2
80102,6,1,280308,280308,280309,0,1,3
80103,5,1,280313,280313,280314,0,1,4
80104,3,1,280316,280316,280317,0,1,2
80105,4,1,280320,280320,280321,0,1,3
80106,5,3,280325,280325,280328,0,3,4
80107,1,3,280326,280328,280331,2,5,0
80108,6,2,280332,280332,280334,0,2,1
80109,1,1,280333,280334,280335,1,2,0
80110,4,2,280337,280337,280339,0,2,2
80111,2,1,280339,280339,280340,0,1,0
80112,1,1,280340,280340,280341,0,1,0
80113,5,1,280345,280345,280346,0,1,4
80114,5,2,280350,280350,280352,0,2,4
80115,2,1,280352,280352,280353,0,1,0
80116,1,2,280353,280353,280355,0,2,0
80117,6,2,280359,280359,280361,0,2,4
80118,4,1,280363,280363,280364,0,1,2
80119,3,3,280366,280366,280369,0,3,2
80120,3,3,280369,280369,280372,0,3,0
80121,3,3,280372,280372,280375,0,3,0
80122,5,3,280377,280377,280380,0,3,2
80123,3,1,280380,280380,280381,0,1,0
80124,1,3,280381,280381,280384,0,3,0
80125,6,2,280387,280387,280389,0,2,3
80126,6,3,280393,280393,280396,0,3,4
80127,6,2,280399,280399,280401,0,2,3
80128,5,3,280404,280404,280407,0,3,3
80129,2,3,280406,280407,280410,1,4,0
80130,5,1,280411,280411,280412,0,1,1
80131,4,3,280415,280415,280418,0,3,3
80132,6,1,280421,280421,280422,0,1,3
80133,4,2,280425,280425,280427,0,2,3
80134,3,3,280428,280428,280431,0,3,1
80135,6,2,280434,280434,280436,0,2,3
80136,5,1,280439,280439,280440,0,1,3
80137,5,2,280444,280444,280446,0,2,4
80138,4,3,280448,280448,280451,0,3,2
80139,3,2,280451,280451,280453,0,2,0
80140,2,3,280453,280453,280456,0,3,0
80141,3,3,280456,280456,280459,0,3,0
80142,4,1,280460,280460,280461,0,1,1
80143,5,2,280465,280465,280467,0,2,4
80144,4,2,280469,280469,280471,0,2,2
80145,3,1,280472,280472,280473,0,1,1
80146,4,1,280476,280476,280477,0,1,3
80147,5,2,280481,280481,280483,0,2,4
80148,5,1,280486,280486,280487,0,1,3
80149,3,3,280489,280489,280492,0,3,2
80150,3,2,280492,280492,280494,0,2,0
80151,2,3,280494,280494,280497,0,3,0
80152,3,1,280497,280497,280498,0,1,0
80153,4,1,280501,280501,280502,0,1,3
80154,6,3,280507,280507,280510,0,3,5
80155,6,3,280513,280513,280516,0,3,3
80156,3,3,280516,280516,280519,0,3,0
80157,1,2,280517,280519,280521,2,4,0
80158,5,3,280522,280522,280525,0,3,1
80159,5,1,280527,280527,280528,0,1,2
80160,3,2,280530,280530,280532,0,2,2
80161,3,1,280533,280533,280534,0,1,1
80162,1,3,280534,280534,280537,0,3,0
80163,5,1,280539,280539,280540,0,1,2
80164,1,1,280540,280540,280541,0,1,0
80165,5,1,280545,280545,280546,0,1,4
80166,1,3,280546,280546,280549,0,3,0
80167,4,1,280550,280550,280551,0,1,1
80168,1,3,280551,280551,280554,0,3,0
80169,4,3,280555,280555,280558,0,3,1
80170,1,2,280556,280558,280560,2,4,0
80171,2,2,280558,280560,280562,2,4,0
80172,1,1,280559,280562,280563,3,4,0
80173,4,2,280563,280563,280565,0,2,0
80174,2,1,280565,280565,280566,0,1,0
80175,1,1,280566,280566,280567,0,1,0
80176,6,1,280572,280572,280573,0,1,5
80177,5,1,280577,280577,280578,0,1,4
80178,1,1,280578,280578,280579,0,1,0
80179,4,1,280582,280582,280583,0,1,3
80180,2,2,280584,280584,280586,0,2,1
80181,3,2,280587,280587,280589,0,2,1
80182,1,1,280588,280589,280590,1,2,0
80183,2,3,280590,280590,280593,0,3,0
80184,6,1,280596,280596,280597,0,1,3
80185,3,3,280599,280599,280602,0,3,2
80186,3,2,280602,280602,280604,0,2,0
80187,1,2,280603,280604,280606,1,3,0
80188,3,3,280606,280606,280609,0,3,0
80189,3,2,280609,280609,280611,0,2,0
80190,2,3,280611,280611,280614,0,3,0
80191,1,2,280612,280614,280616,2,4,0
80192,1,1,280613,280616,280617,3,4,0
80193,2,3,280615,280617,280620,2,5,0
80194,6,2,280621,280621,280623,0,2,1
80195,2,1,280623,280623,280624,0,1,0
80196,1,3,280624,280624,280627,0,3,0
80197,1,1,280625,280627,280628,2,3,0
80198,3,3,280628,280628,280631,0,3,0
80199,2,3,280630,280631,280634,1,4,0
80200,5,3,280635,280635,280638,0,3,1
80201,5,2,280640,280640,280642,0,2,2
80202,4,2,280644,280644,280646,0,2,2
80203,1,2,280645,280646,280648,1,3,0
80204,6,3,280651,280651,280654,0,3,3
80205,5,3,280656,280656,280659,0,3,2
80206,3,1,280659,280659,280660,0,1,0
80207,2,2,280661,280661,280663,0,2,1
80208,3,3,280664,280664,280667,0,3,1
80209,4,1,280668,280668,280669,0,1,1
80210,3,1,280671,280671,280672,0,1,2
80211,1,1,280672,280672,280673,0,1,0
80212,2,1,280674,280674,280675,0,1,1
80213,6,2,280680,280680,280682,0,2,5
80214,2,2,280682,280682,280684,0,2,0
80215,2,2,280684,280684,280686,0,2,0
80216,4,3,280688,280688,280691,0,3,2
80217,1,3,280689,280691,280694,2,5,0
80218,5,3,280694,280694,280697,0,3,0
80219,4,3,280698,280698,280701,0,3,1
80220,5,2,280703,280703,280705,0,2,2
80221,5,2,280708,280708,280710,0,2,3
80222,1,2,280709,280710,280712,1,3,0
80223,3,1,280712,280712,280713,0,1,0
80224,2,3,280714,280714,280717,0,3,1
80225,1,1,280715,280717,280718,2,3,0
80226,2,3,280717,280718,280721,1,4,0
80227,4,2,280721,280721,280723,0,2,0
80228,1,3,280722,280723,280726,1,4,0
80229,4,3,280726,280726,280729,0,3,0
80230,4,2,280730,280730,280732,0,2,1
80231,4,3,280734,280734,280737,0,3,2
80232,6,3,280740,280740,280743,0,3,3
80233,3,3,280743,280743,280746,0,3,0
80234,2,3,280745,280746,280749,1,4,0
80235,1,3,280746,280749,280752,3,6,0
80236,5,2,280751,280752,280754,1,3,0
80237,3,2,280754,280754,280756,0,2,0
80238,3,1,280757,280757,280758,0,1,1
80239,1,2,280758,280758,280760,0,2,0
80240,5,1,280763,280763,280764,0,1,3
80241,1,3,280764,280764,280767,0,3,0
80242,1,2,280765,280767,280769,2,4,0
80243,2,1,280767,280769,280770,2,3,0
80244,6,2,280773,280773,280775,0,2,3
80245,5,3,280778,280778,280781,0,3,3
80246,1,3,280779,280781,280784,2,5,0
80247,5,2,280784,280784,280786,0,2,0
80248,3,3,280787,280787,280790,0,3,1
80249,4,3,280791,280791,280794,0,3,1
80250,4,2,280795,280795,280797,0,2,1
80251,4,3,280799,280799,280802,0,3,2
80252,5,2,280804,280804,280806,0,2,2
80253,3,1,280807,280807,280808,0,1,1
80254,5,3,280812,280812,280815,0,3,4
80255,3,2,280815,280815,280817,0,2,0
80256,5,1,280820,280820,280821,0,1,3
80257,3,3,280823,280823,280826,0,3,2
80258,4,3,280827,280827,280830,0,3,1
80259,3,1,280830,280830,280831,0,1,0
80260,5,2,280835,280835,280837,0,2,4
80261,6,3,280841,280841,280844,0,3,4
80262,6,2,280847,280847,280849,0,2,3
80263,5,1,280852,280852,280853,0,1,3
80264,4,1,280856,280856,280857,0,1,3
80265,5,2,280861,280861,280863,0,2,4
80266,3,1,280864,280864,280865,0,1,1
80267,2,3,280866,280866,280869,0,3,1
80268,6,1,280872,280872,280873,0,1,3
80269,1,2,280873,280873,280875,0,2,0
80270,3,2,280876,280876,280878,0,2,1
80271,6,2,280882,280882,280884,0,2,4
80272,6,2,280888,280888,280890,0,2,4
80273,4,2,280892,280892,280894,0,2,2
80274,5,2,280897,280897,280899,0,2,3
80275,4,1,280901,280901,280902,0,1,2
80276,2,3,280903,280903,280906,0,3,1
80277,1,1,280904,280906,280907,2,3,0
80278,2,2,280906,280907,280909,1,3,0
80279,6,1,280912,280912,280913,0,1,3
80280,3,2,280915,280915,280917,0,2,2
80281,6,2,280921,280921,280923,0,2,4
80282,1,2,280922,280923,280925,1,3,0
80283,5,3,280927,280927,280930,0,3,2
80284,5,3,280932,280932,280935,0,3,2
80285,3,2,280935,280935,280937,0,2,0
80286,6,1,280941,280941,280942,0,1,4
80287,3,3,280944,280944,280947,0,3,2
80288,5,2,280949,280949,280951,0,2,2
80289,6,3,280955,280955,280958,0,3,4
80290,6,1,280961,280961,280962,0,1,3
80291,5,2,280966,280966,280968,0,2,4
80292,1,1,280967,280968,280969,1,2,0
80293,5,1,280972,280972,280973,0,1,3
80294,6,1,280978,280978,280979,0,1,5
80295,2,2,280980,280980,280982,0,2,1
80296,1,2,280981,280982,280984,1,3,0
80297,3,2,280984,280984,280986,0,2,0
80298,6,1,280990,280990,280991,0,1,4
80299,4,2,280994,280994,280996,0,2,3
80300,1,3,280995,280996,280999,1,4,0
80301,4,3,280999,280999,281002,0,3,0
80302,3,2,281002,281002,281004,0,2,0
80303,4,2,281006,281006,281008,0,2,2
80304,2,3,281008,281008,281011,0,3,0
80305,1,3,281009,281011,281014,2,5,0
80306,5,3,281014,281014,281017,0,3,0
80307,2,3,281016,281017,281020,1,4,0
80308,5,2,281021,281021,281023,0,2,1
80309,1,3,281022,281023,281026,1,4,0
80310,3,3,281025,281026,281029,1,4,0
80311,3,1,281028,281029,281030,1,2,0
80312,3,2,281031,281031,281033,0,2,1
80313,4,3,281035,281035,281038,0,3,2
80314,6,2,281041,281041,281043,0,2,3
80315,3,3,281044,281044,281047,0,3,1
80316,1,1,281045,281047,281048,2,3,0
80317,2,1,281047,281048,281049,1,2,0
80318,5,3,281052,281052,281055,0,3,3
80319,6,1,281058,281058,281059,0,1,3
80320,4,1,281062,281062,281063,0,1,3
80321,4,3,281066,281066,281069,0,3,3
80322,3,2,281069,281069,281071,0,2,0
80323,6,3,281075,281075,281078,0,3,4
80324,4,1,281079,281079,281080,0,1,1
80325,5,2,281084,281084,281086,0,2,4
80326,3,2,281087,281087,281089,0,2,1
80327,2,3,281089,281089,281092,0,3,0
80328,1,1,281090,281092,281093,2,3,0
80329,6,3,281096,281096,281099,0,3,3
80330,2,3,281098,281099,281102,1,4,0
80331,1,1,281099,281102,281103,3,4,0
80332,1,1,281100,281103,281104,3,4,0
80333,4,3,281104,281104,281107,0,3,0
80334,4,1,281108,281108,281109,0,1,1
80335,6,1,281114,281114,281115,0,1,5
80336,2,3,281116,281116,281119,0,3,1
80337,6,1,281122,281122,281123,0,1,3
80338,5,1,281127,281127,281128,0,1,4
80339,5,3,281132,281132,281135,0,3,4
80340,2,2,281134,281135,281137,1,3,0
80341,2,3,281136,281137,281140,1,4,0
80342,5,3,281141,281141,281144,0,3,1
80343,4,1,281145,281145,281146,0,1,1
80344,1,2,281146,281146,281148,0,2,0
80345,5,3,281151,281151,281154,0,3,3
80346,1,2,281152,281154,281156,2,4,0
80347,4,1,281156,281156,281157,0,1,0
80348,6,2,281162,281162,281164,0,2,5
80349,3,2,281165,281165,281167,0,2,1
80350,2,3,281167,281167,281170,0,3,0
80351,1,3,281168,281170,281173,2,5,0
80352,5,1,281173,281173,281174,0,1,0
80353,4,1,281177,281177,281178,0,1,3
80354,2,1,281179,281179,281180,0,1,1
80355,1,2,281180,281180,281182,0,2,0
80356,3,3,281183,281183,281186,0,3,1
80357,4,1,281187,281187,281188,0,1,1
80358,4,3,281191,281191,281194,0,3,3
80359,4,1,281195,281195,281196,0,1,1
80360,2,3,281197,281197,281200,0,3,1
80361,6,1,281203,281203,281204,0,1,3
80362,2,2,281205,281205,281207,0,2,1
80363,2,1,281207,281207,281208,0,1,0
80364,6,2,281213,281213,281215,0,2,5
80365,1,2,281214,281215,281217,1,3,0
80366,3,2,281217,281217,281219,0,2,0
80367,6,3,281223,281223,281226,0,3,4
80368,3,1,281226,281226,281227,0,1,0
80369,2,3,281228,281228,281231,0,3,1
80370,2,2,281230,281231,281233,1,3,0
80371,6,2,281236,281236,281238,0,2,3
80372,4,2,281240,281240,281242,0,2,2
80373,5,1,281245,281245,281246,0,1,3
80374,1,3,281246,281246,281249,0,3,0
80375,5,2,281251,281251,281253,0,2,2
80376,3,1,281254,281254,281255,0,1,1
80377,6,3,281260,281260,281263,0,3,5
80378,2,3,281262,281263,281266,1,4,0
80379,2,2,281264,281266,281268,2,4,0
80380,5,3,281269,281269,281272,0,3,1
80381,2,1,281271,281272,281273,1,2,0
80382,4,2,281275,281275,281277,0,2,2
80383,5,1,281280,281280,281281,0,1,3
80384,1,3,281281,281281,281284,0,3,0
80385,4,3,281285,281285,281288,0,3,1
80386,1,2,281286,281288,281290,2,4,0
80387,5,3,281291,281291,281294,0,3,1
80388,3,1,281294,281294,281295,0,1,0
80389,5,3,281299,281299,281302,0,3,4
80390,6,1,281305,281305,281306,0,1,3
80391,6,3,281311,281311,281314,0,3,5
80392,6,1,281317,281317,281318,0,1,3
80393,1,1,281318,281318,281319,0,1,0
80394,1,1,281319,281319,281320,0,1,0
80395,5,1,281324,281324,281325,0,1,4
80396,3,3,281327,281327,281330,0,3,2
80397,1,2,281328,281330,281332,2,4,0
80398,2,2,281330,281332,281334,2,4,0
80399,4,1,281334,281334,281335,0,1,0
80400,4,2,281338,281338,281340,0,2,3
80401,4,1,281342,281342,281343,0,1,2
80402,3,1,281345,281345,281346,0,1,2
80403,4,1,281349,281349,281350,0,1,3
80404,3,3,281352,281352,281355,0,3,2
80405,1,3,281353,281355,281358,2,5,0
80406,6,3,281359,281359,281362,0,3,1
80407,5,1,281364,281364,281365,0,1,2
80408,2,2,281366,281366,281368,0,2,1
80409,3,3,281369,281369,281372,0,3,1
80410,5,3,281374,281374,281377,0,3,2
80411,3,1,281377,281377,281378,0,1,0
80412,6,1,281383,281383,281384,0,1,5
80413,1,3,281384,281384,281387,0,3,0
80414,3,2,281387,281387,281389,0,2,0
80415,2,3,281389,281389,281392,0,3,0
80416,2,3,281391,281392,281395,1,4,0
80417,4,3,281395,281395,281398,0,3,0
80418,6,1,281401,281401,281402,0,1,3
80419,5,3,281406,281406,281409,0,3,4
80420,4,2,281410,281410,281412,0,2,1
80421,4,2,281414,281414,281416,0,2,2
80422,1,1,281415,281416,281417,1,2,0
80423,1,3,281416,281417,281420,1,4,0
80424,2,2,281418,281420,281422,2,4,0
80425,1,1,281419,281422,281423,3,4,0
80426,2,3,281421,281423,281426,2,5,0
80427,5,3,281426,281426,281429,0,3,0
80428,2,3,281428,281429,281432,1,4,0
80429,4,1,281432,281432,281433,0,1,0
80430,2,1,281434,281434,281435,0,1,1
80431,5,3,281439,281439,281442,0,3,4
80432,2,3,281441,281442,281445,1,4,0
80433,1,3,281442,281445,281448,3,6,0
80434,3,3,281445,281448,281451,3,6,0
80435,6,2,281451,281451,281453,0,2,0
80436,6,1,281457,281457,281458,0,1,4
80437,6,2,281463,281463,281465,0,2,5
80438,1,2,281464,281465,281467,1,3,0
80439,4,1,281468,281468,281469,0,1,1
80440,2,1,281470,281470,281471,0,1,1
80441,6,3,281476,281476,281479,0,3,5
80442,2,2,281478,281479,281481,1,3,0
80443,2,2,281480,281481,281483,1,3,0
80444,6,1,281486,281486,281487,0,1,3
80445,2,2,281488,281488,281490,0,2,1
80446,3,3,281491,281491,281494,0,3,1
80447,3,2,281494,281494,281496,0,2,0
80448,6,1,281500,281500,281501,0,1,4
80449,1,3,281501,281501,281504,0,3,0
80450,2,1,281503,281504,281505,1,2,0
80451,6,2,281509,281509,281511,0,2,4
80452,3,1,281512,281512,281513,0,1,1
80453,3,1,281515,281515,281516,0,1,2
80454,4,3,281519,281519,281522,0,3,3
80455,6,1,281525,281525,281526,0,1,3
80456,5,2,281530,281530,281532,0,2,4
80457,6,3,281536,281536,281539,0,3,4
80458,6,2,281542,281542,281544,0,2,3
80459,5,3,281547,281547,281550,0,3,3
80460,4,3,281551,281551,281554,0,3,1
80461,6,1,281557,281557,281558,0,1,3
80462,2,2,281559,281559,281561,0,2,1
80463,1,2,281560,281561,281563,1,3,0
80464,2,2,281562,281563,281565,1,3,0
80465,5,1,281567,281567,281568,0,1,2
80466,6,3,281573,281573,281576,0,3,5
80467,1,3,281574,281576,281579,2,5,0
80468,5,2,281579,281579,281581,0,2,0
80469,2,2,281581,281581,281583,0,2,0
80470,3,1,281584,281584,281585,0,1,1
80471,2,3,281586,281586,281589,0,3,1
80472,3,1,281589,281589,281590,0,1,0
80473,5,1,281594,281594,281595,0,1,4
80474,6,1,281600,281600,281601,0,1,5
80475,3,3,281603,281603,281606,0,3,2
80476,2,3,281605,281606,281609,1,4,0
80477,2,3,281607,281609,281612,2,5,0
80478,5,1,281612,281612,281613,0,1,0
80479,2,3,281614,281614,281617,0,3,1
80480,6,3,281620,281620,281623,0,3,3
80481,5,2,281625,281625,281627,0,2,2
80482,6,3,281631,281631,281634,0,3,4
80483,3,1,281634,281634,281635,0,1,0
80484,2,3,281636,281636,281639,0,3,1
80485,2,2,281638,281639,281641,1,3,0
80486,6,3,281644,281644,281647,0,3,3
80487,6,2,281650,281650,281652,0,2,3
80488,1,3,281651,281652,281655,1,4,0
80489,2,1,281653,281655,281656,2,3,0
80490,2,3,281655,281656,281659,1,4,0
80491,1,3,281656,281659,281662,3,6,0
80492,1,3,281657,281662,281665,5,8,0
80493,6,1,281663,281665,281666,2,3,0
80494,5,3,281668,281668,281671,0,3,2
80495,5,1,281673,281673,281674,0,1,2
80496,6,1,281679,281679,281680,0,1,5
80497,5,3,281684,281684,281687,0,3,4
80498,2,3,281686,281687,281690,1,4,0
80499,4,1,281690,281690,281691,0,1,0
80500,1,2,281691,281691,281693,0,2,0
80501,2,2,281693,281693,281695,0,2,0
80502,5,2,281698,281698,281700,0,2,3
80503,6,1,281704,281704,281705,0,1,4
80504,1,3,281705,281705,281708,0,3,0
80505,4,3,281709,281709,281712,0,3,1
80506,4,3,281713,281713,281716,0,3,1
80507,3,1,281716,281716,281717,0,1,0
80508,1,1,281717,281717,281718,0,1,0
80509,6,2,281723,281723,281725,0,2,5
80510,1,1,281724,281725,281726,1,2,0
80511,6,3,281730,281730,281733,0,3,4
80512,2,1,281732,281733,281734,1,2,0
80513,2,2,281734,281734,281736,0,2,0
80514,1,2,281735,281736,281738,1,3,0
80515,3,2,281738,281738,281740,0,2,0
80516,2,2,281740,281740,281742,0,2,0
80517,3,3,281743,281743,281746,0,3,1
80518,3,3,281746,281746,281749,0,3,0
80519,3,2,281749,281749,281751,0,2,0
80520,2,2,281751,281751,281753,0,2,0
80521,1,1,281752,281753,281754,1,2,0
80522,4,3,281756,281756,281759,0,3,2
80523,5,1,281761,281761,281762,0,1,2
80524,3,1,281764,281764,281765,0,1,2
80525,1,2,281765,281765,281767,0,2,0
80526,1,2,281766,281767,281769,1,3,0
80527,1,1,281767,281769,281770,2,3,0
80528,3,1,281770,281770,281771,0,1,0
80529,4,2,281774,281774,281776,0,2,3
80530,5,3,281779,281779,281782,0,3,3
80531,2,1,281781,281782,281783,1,2,0
80532,5,2,281786,281786,281788,0,2,3
80533,6,1,281792,281792,281793,0,1,4
80534,1,1,281793,281793,281794,0,1,0
80535,4,1,281797,281797,281798,0,1,3
80536,1,2,281798,281798,281800,0,2,0
80537,3,3,281801,281801,281804,0,3,1
80538,5,1,281806,281806,281807,0,1,2
80539,4,3,281810,281810,281813,0,3,3
80540,2,3,281812,281813,281816,1,4,0
80541,6,3,281818,281818,281821,0,3,2
80542,1,3,281819,281821,281824,2,5,0
80543,3,2,281822,281824,281826,2,4,0
80544,1,3,281823,281826,281829,3,6,0
80545,5,1,281828,281829,281830,1,2,0
80546,3,3,281831,281831,281834,0,3,1
80547,3,3,281834,281834,281837,0,3,0
80548,1,1,281835,281837,281838,2,3,0
80549,4,3,281839,281839,281842,0,3,1
80550,4,3,281843,281843,281846,0,3,1
80551,1,1,281844,281846,281847,2,3,0
80552,1,1,281845,281847,281848,2,3,0
80553,5,1,281850,281850,281851,0,1,2
80554,4,3,281854,281854,281857,0,3,3
80555,6,2,281860,281860,281862,0,2,3
80556,5,3,281865,281865,281868,0,3,3
80557,6,3,281871,281871,281874,0,3,3
80558,6,3,281877,281877,281880,0,3,3
80559,4,2,281881,281881,281883,0,2,1
80560,2,3,281883,281883,281886,0,3,0
80561,2,1,281885,281886,281887,1,2,0
80562,1,2,281886,281887,281889,1,3,0
80563,5,2,281891,281891,281893,0,2,2
80564,5,1,281896,281896,281897,0,1,3
80565,2,1,281898,281898,281899,0,1,1
80566,5,2,281903,281903,281905,0,2,4
80567,6,1,281909,281909,281910,0,1,4
80568,5,3,281914,281914,281917,0,3,4
80569,1,1,281915,281917,281918,2,3,0
80570,2,1,281917,281918,281919,1,2,0
80571,4,2,281921,281921,281923,0,2,2
80572,3,1,281924,281924,281925,0,1,1
80573,6,3,281930,281930,281933,0,3,5
80574,6,3,281936,281936,281939,0,3,3
80575,1,3,281937,281939,281942,2,5,0
80576,5,2,281942,281942,281944,0,2,0
80577,3,3,281945,281945,281948,0,3,1
80578,1,3,281946,281948,281951,2,5,0
80579,2,1,281948,281951,281952,3,4,0
80580,6,1,281954,281954,281955,0,1,2
80581,2,1,281956,281956,281957,0,1,1
80582,4,3,281960,281960,281963,0,3,3
80583,6,3,281966,281966,281969,0,3,3
80584,3,1,281969,281969,281970,0,1,0
80585,5,2,281974,281974,281976,0,2,4
80586,1,2,281975,281976,281978,1,3,0
80587,2,1,281977,281978,281979,1,2,0
80588,5,2,281982,281982,281984,0,2,3
80589,6,3,281988,281988,281991,0,3,4
80590,6,2,281994,281994,281996,0,2,3
80591,6,2,282000,282000,282002,0,2,4
80592,4,3,282004,282004,282007,0,3,2
80593,6,1,282010,282010,282011,0,1,3
80594,3,2,282013,282013,282015,0,2,2
80595,5,1,282018,282018,282019,0,1,3
80596,1,2,282019,282019,282021,0,2,0
80597,2,3,282021,282021,282024,0,3,0
80598,2,2,282023,282024,282026,1,3,0
80599,6,2,282029,282029,282031,0,2,3
80600,6,1,282035,282035,282036,0,1,4
80601,5,2,282040,282040,282042,0,2,4
80602,4,1,282044,282044,282045,0,1,2
80603,3,1,282047,282047,282048,0,1,2
80604,6,2,282053,282053,282055,0,2,5
80605,3,3,282056,282056,282059,0,3,1
80606,2,3,282058,282059,282062,1,4,0
80607,1,3,282059,282062,282065,3,6,0
80608,5,2,282064,282065,282067,1,3,0
80609,3,2,282067,282067,282069,0,2,0
80610,2,2,282069,282069,282071,0,2,0
80611,5,1,282074,282074,282075,0,1,3
80612,1,1,282075,282075,282076,0,1,0
80613,2,2,282077,282077,282079,0,2,1
80614,5,1,282082,282082,282083,0,1,3
80615,4,1,282086,282086,282087,0,1,3
80616,3,3,282089,282089,282092,0,3,2
80617,6,3,282095,282095,282098,0,3,3
80618,5,1,282100,282100,282101,0,1,2
80619,3,1,282103,282103,282104,0,1,2
80620,2,3,282105,282105,282108,0,3,1
80621,6,2,282111,282111,282113,0,2,3
80622,1,2,282112,282113,282115,1,3,0
80623,2,3,282114,282115,282118,1,4,0
80624,4,3,282118,282118,282121,0,3,0
80625,3,2,282121,282121,282123,0,2,0
80626,2,2,282123,282123,282125,0,2,0
80627,2,3,282125,282125,282128,0,3,0
80628,4,1,282129,282129,282130,0,1,1
80629,3,3,282132,282132,282135,0,3,2
80630,5,1,282137,282137,282138,0,1,2
80631,5,3,282142,282142,282145,0,3,4
80632,2,2,282144,282145,282147,1,3,0
80633,6,3,282150,282150,282153,0,3,3
80634,6,2,282156,282156,282158,0,2,3
80635,5,1,282161,282161,282162,0,1,3
80636,4,1,282165,282165,282166,0,1,3
80637,4,2,282169,282169,282171,0,2,3
80638,5,1,282174,282174,282175,0,1,3
80639,6,3,282180,282180,282183,0,3,5
80640,6,1,282186,282186,282187,0,1,3
80641,3,3,282189,282189,282192,0,3,2
80642,2,1,282191,282192,282193,1,2,0
80643,5,3,282196,282196,282199,0,3,3
80644,3,1,282199,282199,282200,0,1,0
80645,4,2,282203,282203,282205,0,2,3
80646,1,2,282204,282205,282207,1,3,0
80647,4,1,282208,282208,282209,0,1,1
80648,1,3,282209,282209,282212,0,3,0
80649,3,3,282212,282212,282215,0,3,0
80650,3,1,282215,282215,282216,0,1,0
80651,4,3,282219,282219,282222,0,3,3
80652,2,1,282221,282222,282223,1,2,0
80653,3,1,282224,282224,282225,0,1,1
80654,6,2,282230,282230,282232,0,2,5
80655,4,3,282234,282234,282237,0,3,2
80656,1,3,282235,282237,282240,2,5,0
80657,4,2,282239,282240,282242,1,3,0
80658,1,2,282240,282242,282244,2,4,0
80659,3,1,282243,282244,282245,1,2,0
80660,3,1,282246,282246,282247,0,1,1
80661,4,2,282250,282250,282252,0,2,3
80662,6,3,282256,282256,282259,0,3,4
80663,1,1,282257,282259,282260,2,3,0
80664,3,1,282260,282260,282261,0,1,0
80665,2,3,282262,282262,282265,0,3,1
80666,6,3,282268,282268,282271,0,3,3
80667,4,1,282272,282272,282273,0,1,1
80668,3,2,282275,282275,282277,0,2,2
80669,6,3,282281,282281,282284,0,3,4
80670,2,3,282283,282284,282287,1,4,0
80671,6,2,282289,282289,282291,0,2,2
80672,6,1,282295,282295,282296,0,1,4
80673,4,3,282299,282299,282302,0,3,3
80674,5,1,282304,282304,282305,0,1,2
80675,5,2,282309,282309,282311,0,2,4
80676,4,2,282313,282313,282315,0,2,2
80677,6,3,282319,282319,282322,0,3,4
80678,2,1,282321,282322,282323,1,2,0
80679,1,2,282322,282323,282325,1,3,0
80680,3,2,282325,282325,282327,0,2,0
80681,6,3,282331,282331,282334,0,3,4
80682,3,1,282334,282334,282335,0,1,0
80683,2,3,282336,282336,282339,0,3,1
80684,5,1,282341,282341,282342,0,1,2
80685,3,1,282344,282344,282345,0,1,2
80686,4,2,282348,282348,282350,0,2,3
80687,2,2,282350,282350,282352,0,2,0
80688,5,2,282355,282355,282357,0,2,3
80689,2,3,282357,282357,282360,0,3,0
80690,3,2,282360,282360,282362,0,2,0
80691,5,3,282365,282365,282368,0,3,3
80692,1,1,282366,282368,282369,2,3,0
80693,3,2,282369,282369,282371,0,2,0
80694,1,1,282370,282371,282372,1,2,0
80695,4,1,282374,282374,282375,0,1,2
80696,5,3,282379,282379,282382,0,3,4
80697,1,1,282380,282382,282383,2,3,0
80698,4,1,282384,282384,282385,0,1,1
80699,2,3,282386,282386,282389,0,3,1
80700,3,2,282389,282389,282391,0,2,0
80701,6,3,282395,282395,282398,0,3,4
80702,5,2,282400,282400,282402,0,2,2
80703,4,1,282404,282404,282405,0,1,2
80704,3,2,282407,282407,282409,0,2,2
80705,1,1,282408,282409,282410,1,2,0
80706,6,1,282414,282414,282415,0,1,4
80707,3,2,282417,282417,282419,0,2,2
80708,1,1,282418,282419,282420,1,2,0
80709,4,2,282422,282422,282424,0,2,2
80710,2,3,282424,282424,282427,0,3,0
80711,1,1,282425,282427,282428,2,3,0
80712,5,2,282430,282430,282432,0,2,2
80713,6,3,282436,282436,282439,0,3,4
80714,4,1,282440,282440,282441,0,1,1
80715,5,1,282445,282445,282446,0,1,4
80716,3,1,282448,282448,282449,0,1,2
80717,2,3,282450,282450,282453,0,3,1
80718,6,1,282456,282456,282457,0,1,3
80719,5,3,282461,282461,282464,0,3,4
80720,2,2,282463,282464,282466,1,3,0
80721,5,1,282468,282468,282469,0,1,2
80722,4,1,282472,282472,282473,0,1,3
80723,1,2,282473,282473,282475,0,2,0
80724,5,2,282478,282478,282480,0,2,3
80725,4,1,282482,282482,282483,0,1,2
80726,1,2,282483,282483,282485,0,2,0
80727,3,2,282486,282486,282488,0,2,1
80728,6,1,282492,282492,282493,0,1,4
80729,1,3,282493,282493,282496,0,3,0
80730,1,1,282494,282496,282497,2,3,0
80731,5,1,282499,282499,282500,0,1,2
80732,2,1,282501,282501,282502,0,1,1
80733,5,1,282506,282506,282507,0,1,4
80734,5,2,282511,282511,282513,0,2,4
80735,3,2,282514,282514,282516,0,2,1
80736,4,2,282518,282518,282520,0,2,2
80737,6,1,282524,282524,282525,0,1,4
80738,1,3,282525,282525,282528,0,3,0
80739,3,1,282528,282528,282529,0,1,0
80740,2,2,282530,282530,282532,0,2,1
80741,6,3,282536,282536,282539,0,3,4
80742,4,2,282540,282540,282542,0,2,1
80743,5,2,282545,282545,282547,0,2,3
80744,5,1,282550,282550,282551,0,1,3
80745,6,1,282556,282556,282557,0,1,5
80746,4,2,282560,282560,282562,0,2,3
80747,2,1,282562,282562,282563,0,1,0
80748,5,2,282567,282567,282569,0,2,4
80749,5,2,282572,282572,282574,0,2,3
80750,4,3,282576,282576,282579,0,3,2
80751,3,2,282579,282579,282581,0,2,0
80752,1,3,282580,282581,282584,1,4,0
80753,3,1,282583,282584,282585,1,2,0
80754,5,2,282588,282588,282590,0,2,3
80755,1,3,282589,282590,282593,1,4,0
80756,3,1,282592,282593,282594,1,2,0
80757,6,2,282598,282598,282600,0,2,4
80758,1,2,282599,282600,282602,1,3,0
80759,3,1,282602,282602,282603,0,1,0
80760,6,2,282608,282608,282610,0,2,5
80761,6,1,282614,282614,282615,0,1,4
80762,6,1,282620,282620,282621,0,1,5
80763,2,2,282622,282622,282624,0,2,1
80764,2,3,282624,282624,282627,0,3,0
80765,4,1,282628,282628,282629,0,1,1
80766,6,2,282634,282634,282636,0,2,5
80767,3,1,282637,282637,282638,0,1,1
80768,4,2,282641,282641,282643,0,2,3
80769,3,3,282644,282644,282647,0,3,1
80770,5,2,282649,282649,282651,0,2,2
80771,4,3,282653,282653,282656,0,3,2
80772,1,2,282654,282656,282658,2,4,0
80773,1,2,282655,282658,282660,3,5,0
80774,6,1,282661,282661,282662,0,1,1
80775,6,1,282667,282667,282668,0,1,5
80776,5,2,282672,282672,282674,0,2,4
80777,3,1,282675,282675,282676,0,1,1
80778,5,2,282680,282680,282682,0,2,4
80779,2,2,282682,282682,282684,0,2,0
80780,5,1,282687,282687,282688,0,1,3
80781,6,3,282693,282693,282696,0,3,5
80782,5,1,282698,282698,282699,0,1,2
80783,2,3,282700,282700,282703,0,3,1
80784,2,1,282702,282703,282704,1,2,0
80785,1,1,282703,282704,282705,1,2,0
80786,3,2,282706,282706,282708,0,2,1
80787,1,2,282707,282708,282710,1,3,0
80788,1,2,282708,282710,282712,2,4,0
80789,1,2,282709,282712,282714,3,5,0
80790,2,2,282711,282714,282716,3,5,0
80791,2,3,282713,282716,282719,3,6,0
80792,3,3,282716,282719,282722,3,6,0
80793,1,1,282717,282722,282723,5,6,0
80794,3,3,282720,282723,282726,3,6,0
80795,4,1,282724,282726,282727,2,3,0
80796,4,1,282728,282728,282729,0,1,1
80797,4,2,282732,282732,282734,0,2,3
80798,4,1,282736,282736,282737,0,1,2
80799,3,1,282739,282739,282740,0,1,2
80800,2,1,282741,282741,282742,0,1,1
80801,5,2,282746,282746,282748,0,2,4
80802,5,2,282751,282751,282753,0,2,3
80803,6,3,282757,282757,282760,0,3,4
80804,6,3,282763,282763,282766,0,3,3
80805,2,3,282765,282766,282769,1,4,0
80806,2,3,282767,282769,282772,2,5,0
80807,3,3,282770,282772,282775,2,5,0
80808,3,3,282773,282775,282778,2,5,0
80809,3,2,282776,282778,282780,2,4,0
80810,2,2,282778,282780,282782,2,4,0
80811,2,2,282780,282782,282784,2,4,0
80812,3,3,282783,282784,282787,1,4,0
80813,5,1,282788,282788,282789,0,1,1
80814,5,1,282793,282793,282794,0,1,4
80815,6,3,282799,282799,282802,0,3,5
80816,3,1,282802,282802,282803,0,1,0
80817,5,2,282807,282807,282809,0,2,4
80818,2,3,282809,282809,282812,0,3,0
80819,3,1,282812,282812,282813,0,1,0
80820,1,2,282813,282813,282815,0,2,0
80821,1,1,282814,282815,282816,1,2,0
80822,2,1,282816,282816,282817,0,1,0
80823,6,1,282822,282822,282823,0,1,5
80824,1,1,282823,282823,282824,0,1,0
80825,1,2,282824,282824,282826,0,2,0
80826,3,3,282827,282827,282830,0,3,1
80827,4,1,282831,282831,282832,0,1,1
80828,3,1,282834,282834,282835,0,1,2
80829,1,2,282835,282835,282837,0,2,0
80830,6,3,282841,282841,282844,0,3,4
80831,1,2,282842,282844,282846,2,4,0
80832,3,1,282845,282846,282847,1,2,0
80833,1,1,282846,282847,282848,1,2,0
80834,2,3,282848,282848,282851,0,3,0
80835,5,3,282853,282853,282856,0,3,2
80836,5,1,282858,282858,282859,0,1,2
80837,2,1,282860,282860,282861,0,1,1
80838,6,3,282866,282866,282869,0,3,5
80839,1,2,282867,282869,282871,2,4,0
80840,5,3,282872,282872,282875,0,3,1
80841,3,3,282875,282875,282878,0,3,0
80842,5,3,282880,282880,282883,0,3,2
80843,6,3,282886,282886,282889,0,3,3
80844,2,3,282888,282889,282892,1,4,0
80845,5,3,282893,282893,282896,0,3,1
80846,3,2,282896,282896,282898,0,2,0
80847,4,1,282900,282900,282901,0,1,2
80848,1,1,282901,282901,282902,0,1,0
80849,1,1,282902,282902,282903,0,1,0
80850,6,2,282908,282908,282910,0,2,5
80851,2,1,282910,282910,282911,0,1,0
80852,2,2,282912,282912,282914,0,2,1
80853,1,2,282913,282914,282916,1,3,0
80854,5,2,282918,282918,282920,0,2,2
80855,1,3,282919,282920,282923,1,4,0
80856,2,3,282921,282923,282926,2,5,0
80857,1,2,282922,282926,282928,4,6,0
80858,1,3,282923,282928,282931,5,8,0
80859,2,1,282925,282931,282932,6,7,0
80860,5,1,282930,282932,282933,2,3,0
80861,2,3,282932,282933,282936,1,4,0
80862,3,2,282935,282936,282938,1,3,0
80863,3,2,282938,282938,282940,0,2,0
80864,1,2,282939,282940,282942,1,3,0
80865,6,2,282945,282945,282947,0,2,3
80866,5,1,282950,282950,282951,0,1,3
80867,6,2,282956,282956,282958,0,2,5
80868,4,1,282960,282960,282961,0,1,2
80869,6,3,282966,282966,282969,0,3,5
80870,3,2,282969,282969,282971,0,2,0
80871,3,1,282972,282972,282973,0,1,1
80872,2,1,282974,282974,282975,0,1,1
80873,1,3,282975,282975,282978,0,3,0
80874,3,3,282978,282978,282981,0,3,0
80875,2,3,282980,282981,282984,1,4,0
80876,3,2,282983,282984,282986,1,3,0
80877,4,3,282987,282987,282990,0,3,1
80878,2,1,282989,282990,282991,1,2,0
80879,3,3,282992,282992,282995,0,3,1
80880,2,3,282994,282995,282998,1,4,0
80881,4,3,282998,282998,283001,0,3,0
80882,5,3,283003,283003,283006,0,3,2
80883,6,3,283009,283009,283012,0,3,3
80884,2,3,283011,283012,283015,1,4,0
80885,4,3,283015,283015,283018,0,3,0
80886,6,1,283021,283021,283022,0,1,3
80887,6,2,283027,283027,283029,0,2,5
80888,6,2,283033,283033,283035,0,2,4
80889,4,3,283037,283037,283040,0,3,2
80890,6,3,283043,283043,283046,0,3,3
80891,5,3,283048,283048,283051,0,3,2
80892,3,3,283051,283051,283054,0,3,0
80893,5,1,283056,283056,283057,0,1,2
80894,2,3,283058,283058,283061,0,3,1
80895,3,2,283061,283061,283063,0,2,0
80896,6,1,283067,283067,283068,0,1,4
80897,6,3,283073,283073,283076,0,3,5
80898,6,1,283079,283079,283080,0,1,3
80899,1,2,283080,283080,283082,0,2,0
80900,2,2,283082,283082,283084,0,2,0
80901,4,1,283086,283086,283087,0,1,2
80902,1,1,283087,283087,283088,0,1,0
80903,2,1,283089,283089,283090,0,1,1
80904,2,2,283091,283091,283093,0,2,1
80905,3,1,283094,283094,283095,0,1,1
80906,6,1,283100,283100,283101,0,1,5
80907,3,1,283103,283103,283104,0,1,2
80908,6,1,283109,283109,283110,0,1,5
80909,1,1,283110,283110,283111,0,1,0
80910,1,2,283111,283111,283113,0,2,0
80911,4,1,283115,283115,283116,0,1,2
80912,6,2,283121,283121,283123,0,2,5
80913,3,2,283124,283124,283126,0,2,1
80914,4,1,283128,283128,283129,0,1,2
80915,6,2,283134,283134,283136,0,2,5
80916,2,3,283136,283136,283139,0,3,0
80917,5,1,283141,283141,283142,0,1,2
80918,5,3,283146,283146,283149,0,3,4
80919,5,2,283151,283151,283153,0,2,2
80920,2,3,283153,283153,283156,0,3,0
80921,5,3,283158,283158,283161,0,3,2
80922,3,2,283161,283161,283163,0,2,0
80923,6,1,283167,283167,283168,0,1,4
80924,1,3,283168,283168,283171,0,3,0
80925,6,3,283174,283174,283177,0,3,3
80926,4,2,283178,283178,283180,0,2,1
80927,1,3,283179,283180,283183,1,4,0
80928,6,1,283185,283185,283186,0,1,2
80929,2,1,283187,283187,283188,0,1,1
80930,3,2,283190,283190,283192,0,2,2
80931,5,2,283195,283195,283197,0,2,3
80932,2,2,283197,283197,283199,0,2,0
80933,1,3,283198,283199,283202,1,4,0
80934,4,1,283202,283202,283203,0,1,0
80935,6,1,283208,283208,283209,0,1,5
80936,2,1,283210,283210,283211,0,1,1
80937,1,2,283211,283211,283213,0,2,0
80938,4,2,283215,283215,283217,0,2,2
80939,4,2,283219,283219,283221,0,2,2
80940,4,2,283223,283223,283225,0,2,2
80941,1,2,283224,283225,283227,1,3,0
80942,2,2,283226,283227,283229,1,3,0
80943,2,1,283228,283229,283230,1,2,0
80944,5,1,283233,283233,283234,0,1,3
80945,5,1,283238,283238,283239,0,1,4
80946,4,1,283242,283242,283243,0,1,3
80947,6,3,283248,283248,283251,0,3,5
80948,4,1,283252,283252,283253,0,1,1
80949,4,1,283256,283256,283257,0,1,3
80950,2,2,283258,283258,283260,0,2,1
80951,5,2,283263,283263,283265,0,2,3
80952,4,3,283267,283267,283270,0,3,2
80953,5,3,283272,283272,283275,0,3,2
80954,6,3,283278,283278,283281,0,3,3
80955,2,2,283280,283281,283283,1,3,0
80956,3,3,283283,283283,283286,0,3,0
80957,4,3,283287,283287,283290,0,3,1
80958,6,1,283293,283293,283294,0,1,3
80959,6,3,283299,283299,283302,0,3,5
80960,1,3,283300,283302,283305,2,5,0
80961,2,1,283302,283305,283306,3,4,0
80962,5,3,283307,283307,283310,0,3,1
80963,1,3,283308,283310,283313,2,5,0
80964,6,3,283314,283314,283317,0,3,1
80965,1,1,283315,283317,283318,2,3,0
80966,2,3,283317,283318,283321,1,4,0
80967,5,1,283322,283322,283323,0,1,1
80968,3,1,283325,283325,283326,0,1,2
80969,3,1,283328,283328,283329,0,1,2
80970,3,3,283331,283331,283334,0,3,2
80971,3,1,283334,283334,283335,0,1,0
80972,6,3,283340,283340,283343,0,3,5
80973,5,3,283345,283345,283348,0,3,2
80974,6,3,283351,283351,283354,0,3,3
80975,5,3,283356,283356,283359,0,3,2
80976,6,2,283362,283362,283364,0,2,3
80977,1,2,283363,283364,283366,1,3,0
80978,5,1,283368,283368,283369,0,1,2
80979,5,2,283373,283373,283375,0,2,4
80980,4,2,283377,283377,283379,0,2,2
80981,6,1,283383,283383,283384,0,1,4
80982,5,2,283388,283388,283390,0,2,4
80983,1,1,283389,283390,283391,1,2,0
80984,2,3,283391,283391,283394,0,3,0
80985,5,1,283396,283396,283397,0,1,2
80986,4,3,283400,283400,283403,0,3,3
80987,6,3,283406,283406,283409,0,3,3
80988,5,3,283411,283411,283414,0,3,2
80989,2,3,283413,283414,283417,1,4,0
80990,1,3,283414,283417,283420,3,6,0
80991,3,1,283417,283420,283421,3,4,0
80992,4,1,283421,283421,283422,0,1,0
80993,3,3,283424,283424,283427,0,3,2
80994,3,1,283427,283427,283428,0,1,0
80995,3,1,283430,283430,283431,0,1,2
80996,5,3,283435,283435,283438,0,3,4
80997,6,1,283441,283441,283442,0,1,3
80998,4,1,283445,283445,283446,0,1,3
80999,3,3,283448,283448,283451,0,3,2
81000,3,3,283451,283451,283454,0,3,0
81001,5,2,283456,283456,283458,0,2,2
81002,6,3,283462,283462,283465,0,3,4
81003,6,3,283468,283468,283471,0,3,3
81004,6,1,283474,283474,283475,0,1,3
81005,2,3,283476,283476,283479,0,3,1
81006,3,1,283479,283479,283480,0,1,0
81007,2,2,283481,283481,283483,0,2,1
81008,2,1,283483,283483,283484,0,1,0
81009,5,1,283488,283488,283489,0,1,4
81010,6,1,283494,283494,283495,0,1,5
81011,4,3,283498,283498,283501,0,3,3
81012,2,1,283500,283501,283502,1,2,0
81013,4,3,283504,283504,283507,0,3,2
81014,1,1,283505,283507,283508,2,3,0
81015,3,2,283508,283508,283510,0,2,0
81016,5,2,283513,283513,283515,0,2,3
81017,6,3,283519,283519,283522,0,3,4
81018,2,3,283521,283522,283525,1,4,0
81019,6,2,283527,283527,283529,0,2,2
81020,3,2,283530,283530,283532,0,2,1
81021,4,2,283534,283534,283536,0,2,2
81022,2,1,283536,283536,283537,0,1,0
81023,5,1,283541,283541,283542,0,1,4
81024,4,1,283545,283545,283546,0,1,3
81025,5,2,283550,283550,283552,0,2,4
81026,2,2,283552,283552,283554,0,2,0
81027,5,1,283557,283557,283558,0,1,3
81028,2,1,283559,283559,283560,0,1,1
81029,6,3,283565,283565,283568,0,3,5
81030,2,2,283567,283568,283570,1,3,0
81031,1,1,283568,283570,283571,2,3,0
81032,5,1,283573,283573,283574,0,1,2
81033,5,2,283578,283578,283580,0,2,4
81034,2,3,283580,283580,283583,0,3,0
81035,1,1,283581,283583,283584,2,3,0
81036,6,3,283587,283587,283590,0,3,3
81037,2,2,283589,283590,283592,1,3,0
81038,2,1,283591,283592,283593,1,2,0
81039,5,1,283596,283596,283597,0,1,3
81040,1,1,283597,283597,283598,0,1,0
81041,6,1,283603,283603,283604,0,1,5
81042,1,3,283604,283604,283607,0,3,0
81043,6,2,283610,283610,283612,0,2,3
81044,5,1,283615,283615,283616,0,1,3
81045,2,2,283617,283617,283619,0,2,1
81046,5,1,283622,283622,283623,0,1,3
81047,5,3,283627,283627,283630,0,3,4
81048,6,3,283633,283633,283636,0,3,3
81049,2,2,283635,283636,283638,1,3,0
81050,6,2,283641,283641,283643,0,2,3
81051,2,3,283643,283643,283646,0,3,0
81052,2,2,283645,283646,283648,1,3,0
81053,4,2,283649,283649,283651,0,2,1
81054,5,1,283654,283654,283655,0,1,3
81055,1,1,283655,283655,283656,0,1,0
81056,4,2,283659,283659,283661,0,2,3
81057,4,1,283663,283663,283664,0,1,2
81058,1,1,283664,283664,283665,0,1,0
81059,2,1,283666,283666,283667,0,1,1
81060,2,3,283668,283668,283671,0,3,1
81061,3,2,283671,283671,283673,0,2,0
81062,4,1,283675,283675,283676,0,1,2
81063,5,3,283680,283680,283683,0,3,4
81064,1,2,283681,283683,283685,2,4,0
81065,3,3,283684,283685,283688,1,4,0
81066,1,3,283685,283688,283691,3,6,0
81067,5,2,283690,283691,283693,1,3,0
81068,6,1,283696,283696,283697,0,1,3
81069,1,2,283697,283697,283699,0,2,0
81070,3,1,283700,283700,283701,0,1,1
81071,6,1,283706,283706,283707,0,1,5
81072,2,1,283708,283708,283709,0,1,1
81073,1,1,283709,283709,283710,0,1,0
81074,4,1,283713,283713,283714,0,1,3
81075,1,1,283714,283714,283715,0,1,0
81076,2,1,283716,283716,283717,0,1,1
81077,3,3,283719,283719,283722,0,3,2
81078,3,3,283722,283722,283725,0,3,0
81079,4,3,283726,283726,283729,0,3,1
81080,2,3,283728,283729,283732,1,4,0
81081,1,3,283729,283732,283735,3,6,0
81082,6,3,283735,283735,283738,0,3,0
81083,5,3,283740,283740,283743,0,3,2
81084,5,3,283745,283745,283748,0,3,2
81085,6,3,283751,283751,283754,0,3,3
81086,5,2,283756,283756,283758,0,2,2
81087,5,1,283761,283761,283762,0,1,3
81088,6,3,283767,283767,283770,0,3,5
81089,5,3,283772,283772,283775,0,3,2
81090,6,3,283778,283778,283781,0,3,3
81091,6,2,283784,283784,283786,0,2,3
81092,5,1,283789,283789,283790,0,1,3
81093,4,1,283793,283793,283794,0,1,3
81094,1,2,283794,283794,283796,0,2,0
81095,1,3,283795,283796,283799,1,4,0
81096,1,3,283796,283799,283802,3,6,0
81097,3,3,283799,283802,283805,3,6,0
81098,1,3,283800,283805,283808,5,8,0
81099,4,2,283804,283808,283810,4,6,0
81100,3,3,283807,283810,283813,3,6,0
81101,4,1,283811,283813,283814,2,3,0
81102,3,2,283814,283814,283816,0,2,0
81103,1,2,283815,283816,283818,1,3,0
81104,2,2,283817,283818,283820,1,3,0
81105,4,2,283821,283821,283823,0,2,1
81106,3,3,283824,283824,283827,0,3,1
81107,4,2,283828,283828,283830,0,2,1
81108,4,2,283832,283832,283834,0,2,2
81109,6,2,283838,283838,283840,0,2,4
81110,6,1,283844,283844,283845,0,1,4
81111,5,1,283849,283849,283850,0,1,4
81112,6,3,283855,283855,283858,0,3,5
81113,4,1,283859,283859,283860,0,1,1
81114,6,1,283865,283865,283866,0,1,5
81115,5,2,283870,283870,283872,0,2,4
81116,2,3,283872,283872,283875,0,3,0
81117,1,1,283873,283875,283876,2,3,0
81118,2,3,283875,283876,283879,1,4,0
81119,5,1,283880,283880,283881,0,1,1
81120,5,3,283885,283885,283888,0,3,4
81121,4,2,283889,283889,283891,0,2,1
81122,5,3,283894,283894,283897,0,3,3
81123,1,2,283895,283897,283899,2,4,0
81124,2,1,283897,283899,283900,2,3,0
81125,2,2,283899,283900,283902,1,3,0
81126,1,1,283900,283902,283903,2,3,0
81127,2,2,283902,283903,283905,1,3,0
81128,6,1,283908,283908,283909,0,1,3
81129,4,1,283912,283912,283913,0,1,3
81130,2,3,283914,283914,283917,0,3,1
81131,6,3,283920,283920,283923,0,3,3
81132,5,1,283925,283925,283926,0,1,2
81133,3,1,283928,283928,283929,0,1,2
81134,1,2,283929,283929,283931,0,2,0
81135,1,1,283930,283931,283932,1,2,0
81136,3,1,283933,283933,283934,0,1,1
81137,5,3,283938,283938,283941,0,3,4
81138,2,3,283940,283941,283944,1,4,0
81139,4,3,283944,283944,283947,0,3,0
81140,5,3,283949,283949,283952,0,3,2
81141,4,3,283953,283953,283956,0,3,1
81142,5,3,283958,283958,283961,0,3,2
81143,6,3,283964,283964,283967,0,3,3
81144,6,3,283970,283970,283973,0,3,3
81145,4,1,283974,283974,283975,0,1,1
81146,5,3,283979,283979,283982,0,3,4
81147,5,1,283984,283984,283985,0,1,2
81148,2,2,283986,283986,283988,0,2,1
81149,4,3,283990,283990,283993,0,3,2
81150,5,3,283995,283995,283998,0,3,2
81151,5,2,284000,284000,284002,0,2,2
81152,1,2,284001,284002,284004,1,3,0
81153,4,1,284005,284005,284006,0,1,1
81154,1,2,284006,284006,284008,0,2,0
81155,5,1,284011,284011,284012,0,1,3
81156,5,1,284016,284016,284017,0,1,4
81157,1,2,284017,284017,284019,0,2,0
81158,5,3,284022,284022,284025,0,3,3
81159,5,1,284027,284027,284028,0,1,2
81160,6,3,284033,284033,284036,0,3,5
81161,5,1,284038,284038,284039,0,1,2
81162,6,1,284044,284044,284045,0,1,5
81163,5,1,284049,284049,284050,0,1,4
81164,3,2,284052,284052,284054,0,2,2
81165,1,2,284053,284054,284056,1,3,0
81166,3,3,284056,284056,284059,0,3,0
81167,1,1,284057,284059,284060,2,3,0
81168,1,1,284058,284060,284061,2,3,0
81169,4,2,284062,284062,284064,0,2,1
81170,3,3,284065,284065,284068,0,3,1
81171,1,3,284066,284068,284071,2,5,0
81172,2,1,284068,284071,284072,3,4,0
81173,4,2,284072,284072,284074,0,2,0
81174,1,1,284073,284074,284075,1,2,0
81175,1,2,284074,284075,284077,1,3,0
81176,4,1,284078,284078,284079,0,1,1
81177,4,2,284082,284082,284084,0,2,3
81178,1,1,284083,284084,284085,1,2,0
81179,3,2,284086,284086,284088,0,2,1
81180,6,2,284092,284092,284094,0,2,4
81181,4,2,284096,284096,284098,0,2,2
81182,4,1,284100,284100,284101,0,1,2
81183,1,2,284101,284101,284103,0,2,0
81184,6,1,284107,284107,284108,0,1,4
81185,6,1,284113,284113,284114,0,1,5
81186,4,2,284117,284117,284119,0,2,3
81187,5,3,284122,284122,284125,0,3,3
81188,3,3,284125,284125,284128,0,3,0
81189,4,1,284129,284129,284130,0,1,1
81190,1,3,284130,284130,284133,0,3,0
81191,3,3,284133,284133,284136,0,3,0
81192,3,3,284136,284136,284139,0,3,0
81193,1,2,284137,284139,284141,2,4,0
81194,2,1,284139,284141,284142,2,3,0
81195,4,3,284143,284143,284146,0,3,1
81196,4,2,284147,284147,284149,0,2,1
81197,2,3,284149,284149,284152,0,3,0
81198,6,3,284155,284155,284158,0,3,3
81199,5,1,284160,284160,284161,0,1,2
81200,2,1,284162,284162,284163,0,1,1
81201,6,1,284168,284168,284169,0,1,5
81202,5,3,284173,284173,284176,0,3,4
81203,6,3,284179,284179,284182,0,3,3
81204,5,1,284184,284184,284185,0,1,2
81205,3,3,284187,284187,284190,0,3,2
81206,1,1,284188,284190,284191,2,3,0
81207,1,1,284189,284191,284192,2,3,0
81208,6,3,284195,284195,284198,0,3,3
81209,3,2,284198,284198,284200,0,2,0
81210,2,3,284200,284200,284203,0,3,0
81211,3,3,284203,284203,284206,0,3,0
81212,2,2,284205,284206,284208,1,3,0
81213,3,3,284208,284208,284211,0,3,0
81214,1,3,284209,284211,284214,2,5,0
81215,4,2,284213,284214,284216,1,3,0
81216,1,2,284214,284216,284218,2,4,0
81217,2,1,284216,284218,284219,2,3,0
81218,6,3,284222,284222,284225,0,3,3
81219,3,1,284225,284225,284226,0,1,0
81220,3,2,284228,284228,284230,0,2,2
81221,1,1,284229,284230,284231,1,2,0
81222,4,3,284233,284233,284236,0,3,2
81223,4,2,284237,284237,284239,0,2,1
81224,6,2,284243,284243,284245,0,2,4
81225,2,1,284245,284245,284246,0,1,0
81226,6,3,284251,284251,284254,0,3,5
81227,2,1,284253,284254,284255,1,2,0
81228,3,3,284256,284256,284259,0,3,1
81229,1,3,284257,284259,284262,2,5,0
81230,5,3,284262,284262,284265,0,3,0
81231,2,2,284264,284265,284267,1,3,0
81232,2,1,284266,284267,284268,1,2,0
81233,3,3,284269,284269,284272,0,3,1
81234,4,2,284273,284273,284275,0,2,1
81235,4,1,284277,284277,284278,0,1,2
81236,2,2,284279,284279,284281,0,2,1
81237,5,3,284284,284284,284287,0,3,3
81238,5,3,284289,284289,284292,0,3,2
81239,2,2,284291,284292,284294,1,3,0
81240,4,1,284295,284295,284296,0,1,1
81241,5,1,284300,284300,284301,0,1,4
81242,5,1,284305,284305,284306,0,1,4
81243,2,1,284307,284307,284308,0,1,1
81244,2,2,284309,284309,284311,0,2,1
81245,3,2,284312,284312,284314,0,2,1
81246,4,2,284316,284316,284318,0,2,2
81247,5,2,284321,284321,284323,0,2,3
81248,5,2,284326,284326,284328,0,2,3
81249,3,2,284329,284329,284331,0,2,1
81250,3,1,284332,284332,284333,0,1,1
81251,5,2,284337,284337,284339,0,2,4
81252,5,2,284342,284342,284344,0,2,3
81253,1,3,284343,284344,284347,1,4,0
81254,4,3,284347,284347,284350,0,3,0
81255,2,1,284349,284350,284351,1,2,0
81256,4,1,284353,284353,284354,0,1,2
81257,1,3,284354,284354,284357,0,3,0
81258,4,1,284358,284358,284359,0,1,1
81259,6,2,284364,284364,284366,0,2,5
81260,3,2,284367,284367,284369,0,2,1
81261,3,2,284370,284370,284372,0,2,1
81262,1,3,284371,284372,284375,1,4,0
81263,2,2,284373,284375,284377,2,4,0
81264,3,2,284376,284377,284379,1,3,0
81265,3,3,284379,284379,284382,0,3,0
81266,1,2,284380,284382,284384,2,4,0
81267,2,1,284382,284384,284385,2,3,0
81268,6,1,284388,284388,284389,0,1,3
81269,1,1,284389,284389,284390,0,1,0
81270,5,2,284394,284394,284396,0,2,4
81271,3,2,284397,284397,284399,0,2,1
81272,5,1,284402,284402,284403,0,1,3
81273,2,3,284404,284404,284407,0,3,1
81274,1,2,284405,284407,284409,2,4,0
81275,5,1,284410,284410,284411,0,1,1
81276,6,3,284416,284416,284419,0,3,5
81277,3,2,284419,284419,284421,0,2,0
81278,2,1,284421,284421,284422,0,1,0
81279,3,3,284424,284424,284427,0,3,2
81280,5,2,284429,284429,284431,0,2,2
81281,6,3,284435,284435,284438,0,3,4
81282,5,2,284440,284440,284442,0,2,2
81283,6,3,284446,284446,284449,0,3,4
81284,4,1,284450,284450,284451,0,1,1
81285,5,1,284455,284455,284456,0,1,4
81286,1,3,284456,284456,284459,0,3,0
81287,2,3,284458,284459,284462,1,4,0
81288,4,2,284462,284462,284464,0,2,0
81289,4,1,284466,284466,284467,0,1,2
81290,3,3,284469,284469,284472,0,3,2
81291,5,1,284474,284474,284475,0,1,2
81292,4,2,284478,284478,284480,0,2,3
81293,4,3,284482,284482,284485,0,3,2
81294,6,1,284488,284488,284489,0,1,3
81295,1,3,284489,284489,284492,0,3,0
81296,1,1,284490,284492,284493,2,3,0
81297,3,2,284493,284493,284495,0,2,0
81298,3,2,284496,284496,284498,0,2,1
81299,5,2,284501,284501,284503,0,2,3
81300,5,3,284506,284506,284509,0,3,3
81301,6,3,284512,284512,284515,0,3,3
81302,4,3,284516,284516,284519,0,3,1
81303,4,2,284520,284520,284522,0,2,1
81304,1,1,284521,284522,284523,1,2,0
81305,2,3,284523,284523,284526,0,3,0
81306,4,2,284527,284527,284529,0,2,1
81307,5,3,284532,284532,284535,0,3,3
81308,5,1,284537,284537,284538,0,1,2
81309,5,3,284542,284542,284545,0,3,4
81310,1,3,284543,284545,284548,2,5,0
81311,1,3,284544,284548,284551,4,7,0
81312,5,1,284549,284551,284552,2,3,0
81313,5,2,284554,284554,284556,0,2,2
81314,5,2,284559,284559,284561,0,2,3
81315,1,2,284560,284561,284563,1,3,0
81316,5,2,284565,284565,284567,0,2,2
81317,6,1,284571,284571,284572,0,1,4
81318,2,1,284573,284573,284574,0,1,1
81319,2,2,284575,284575,284577,0,2,1
81320,2,2,284577,284577,284579,0,2,0
81321,2,2,284579,284579,284581,0,2,0
81322,4,1,284583,284583,284584,0,1,2
81323,6,3,284589,284589,284592,0,3,5
81324,5,1,284594,284594,284595,0,1,2
81325,3,2,284597,284597,284599,0,2,2
81326,3,3,284600,284600,284603,0,3,1
81327,2,3,284602,284603,284606,1,4,0
81328,5,2,284607,284607,284609,0,2,1
81329,5,3,284612,284612,284615,0,3,3
81330,3,2,284615,284615,284617,0,2,0
81331,2,3,284617,284617,284620,0,3,0
81332,4,2,284621,284621,284623,0,2,1
81333,6,2,284627,284627,284629,0,2,4
81334,3,3,284630,284630,284633,0,3,1
81335,6,2,284636,284636,284638,0,2,3
81336,4,3,284640,284640,284643,0,3,2
81337,6,2,284646,284646,284648,0,2,3
81338,6,1,284652,284652,284653,0,1,4
81339,4,1,284656,284656,284657,0,1,3
81340,5,2,284661,284661,284663,0,2,4
81341,1,3,284662,284663,284666,1,4,0
81342,6,2,284668,284668,284670,0,2,2
81343,6,2,284674,284674,284676,0,2,4
81344,2,1,284676,284676,284677,0,1,0
81345,1,3,284677,284677,284680,0,3,0
81346,3,3,284680,284680,284683,0,3,0
81347,4,3,284684,284684,284687,0,3,1
81348,2,2,284686,284687,284689,1,3,0
81349,2,1,284688,284689,284690,1,2,0
81350,5,1,284693,284693,284694,0,1,3
81351,2,1,284695,284695,284696,0,1,1
81352,6,3,284701,284701,284704,0,3,5
81353,4,2,284705,284705,284707,0,2,1
81354,1,2,284706,284707,284709,1,3,0
81355,4,3,284710,284710,284713,0,3,1
81356,5,3,284715,284715,284718,0,3,2
81357,4,1,284719,284719,284720,0,1,1
81358,2,1,284721,284721,284722,0,1,1
81359,5,2,284726,284726,284728,0,2,4
81360,3,1,284729,284729,284730,0,1,1
81361,3,2,284732,284732,284734,0,2,2
81362,3,1,284735,284735,284736,0,1,1
81363,2,3,284737,284737,284740,0,3,1
81364,3,2,284740,284740,284742,0,2,0
81365,4,1,284744,284744,284745,0,1,2
81366,5,1,284749,284749,284750,0,1,4
81367,5,3,284754,284754,284757,0,3,4
81368,1,3,284755,284757,284760,2,5,0
81369,4,3,284759,284760,284763,1,4,0
81370,5,3,284764,284764,284767,0,3,1
81371,5,1,284769,284769,284770,0,1,2
81372,4,1,284773,284773,284774,0,1,3
81373,2,2,284775,284775,284777,0,2,1
81374,6,3,284781,284781,284784,0,3,4
81375,6,1,284787,284787,284788,0,1,3
81376,3,1,284790,284790,284791,0,1,2
81377,2,1,284792,284792,284793,0,1,1
81378,4,1,284796,284796,284797,0,1,3
81379,1,1,284797,284797,284798,0,1,0
81380,6,1,284803,284803,284804,0,1,5
81381,1,1,284804,284804,284805,0,1,0
81382,1,1,284805,284805,284806,0,1,0
81383,2,1,284807,284807,284808,0,1,1
81384,1,1,284808,284808,284809,0,1,0
81385,1,2,284809,284809,284811,0,2,0
81386,3,2,284812,284812,284814,0,2,1
81387,5,3,284817,284817,284820,0,3,3
81388,4,2,284821,284821,284823,0,2,1
81389,6,2,284827,284827,284829,0,2,4
81390,1,3,284828,284829,284832,1,4,0
81391,2,3,284830,284832,284835,2,5,0
81392,2,2,284832,284835,284837,3,5,0
81393,2,2,284834,284837,284839,3,5,0
81394,2,3,284836,284839,284842,3,6,0
81395,4,2,284840,284842,284844,2,4,0
81396,1,3,284841,284844,284847,3,6,0
81397,5,3,284846,284847,284850,1,4,0
81398,2,1,284848,284850,284851,2,3,0
81399,1,3,284849,284851,284854,2,5,0
81400,3,3,284852,284854,284857,2,5,0
81401,4,1,284856,284857,284858,1,2,0
81402,3,1,284859,284859,284860,0,1,1
81403,1,2,284860,284860,284862,0,2,0
81404,1,3,284861,284862,284865,1,4,0
81405,5,1,284866,284866,284867,0,1,1
81406,5,1,284871,284871,284872,0,1,4
81407,3,3,284874,284874,284877,0,3,2
81408,6,3,284880,284880,284883,0,3,3
81409,4,3,284884,284884,284887,0,3,1
81410,4,2,284888,284888,284890,0,2,1
81411,6,3,284894,284894,284897,0,3,4
81412,5,1,284899,284899,284900,0,1,2
81413,6,1,284905,284905,284906,0,1,5
81414,6,3,284911,284911,284914,0,3,5
81415,4,2,284915,284915,284917,0,2,1
81416,2,3,284917,284917,284920,0,3,0
81417,5,1,284922,284922,284923,0,1,2
81418,4,3,284926,284926,284929,0,3,3
81419,1,2,284927,284929,284931,2,4,0
81420,6,1,284933,284933,284934,0,1,2
81421,1,1,284934,284934,284935,0,1,0
81422,3,1,284937,284937,284938,0,1,2
81423,1,2,284938,284938,284940,0,2,0
81424,2,3,284940,284940,284943,0,3,0
81425,6,1,284946,284946,284947,0,1,3
81426,5,3,284951,284951,284954,0,3,4
81427,3,2,284954,284954,284956,0,2,0
81428,3,1,284957,284957,284958,0,1,1
81429,2,3,284959,284959,284962,0,3,1
81430,6,1,284965,284965,284966,0,1,3
81431,2,1,284967,284967,284968,0,1,1
81432,1,2,284968,284968,284970,0,2,0
81433,3,2,284971,284971,284973,0,2,1
81434,5,3,284976,284976,284979,0,3,3
81435,5,1,284981,284981,284982,0,1,2
81436,3,3,284984,284984,284987,0,3,2
81437,4,3,284988,284988,284991,0,3,1
81438,2,2,284990,284991,284993,1,3,0
81439,3,2,284993,284993,284995,0,2,0
81440,4,1,284997,284997,284998,0,1,2
81441,4,1,285001,285001,285002,0,1,3
81442,5,1,285006,285006,285007,0,1,4
81443,2,1,285008,285008,285009,0,1,1
81444,3,2,285011,285011,285013,0,2,2
81445,4,1,285015,285015,285016,0,1,2
81446,2,1,285017,285017,285018,0,1,1
81447,5,3,285022,285022,285025,0,3,4
81448,6,2,285028,285028,285030,0,2,3
81449,2,2,285030,285030,285032,0,2,0
81450,3,2,285033,285033,285035,0,2,1
81451,3,3,285036,285036,285039,0,3,1
81452,5,2,285041,285041,285043,0,2,2
81453,4,3,285045,285045,285048,0,3,2
81454,6,2,285051,285051,285053,0,2,3
81455,2,3,285053,285053,285056,0,3,0
81456,3,3,285056,285056,285059,0,3,0
81457,6,3,285062,285062,285065,0,3,3
81458,1,3,285063,285065,285068,2,5,0
81459,1,2,285064,285068,285070,4,6,0
81460,4,1,285068,285070,285071,2,3,0
81461,6,3,285074,285074,285077,0,3,3
81462,4,3,285078,285078,285081,0,3,1
81463,6,3,285084,285084,285087,0,3,3
81464,4,1,285088,285088,285089,0,1,1
81465,3,3,285091,285091,285094,0,3,2
81466,2,1,285093,285094,285095,1,2,0
81467,1,2,285094,285095,285097,1,3,0
81468,3,1,285097,285097,285098,0,1,0
81469,3,3,285100,285100,285103,0,3,2
81470,6,3,285106,285106,285109,0,3,3
81471,6,1,285112,285112,285113,0,1,3
81472,1,3,285113,285113,285116,0,3,0
81473,1,3,285114,285116,285119,2,5,0
81474,1,3,285115,285119,285122,4,7,0
81475,6,1,285121,285122,285123,1,2,0
81476,4,1,285125,285125,285126,0,1,2
81477,5,3,285130,285130,285133,0,3,4
81478,1,2,285131,285133,285135,2,4,0
81479,1,2,285132,285135,285137,3,5,0
81480,6,2,285138,285138,285140,0,2,1
81481,5,3,285143,285143,285146,0,3,3
81482,5,2,285148,285148,285150,0,2,2
81483,1,1,285149,285150,285151,1,2,0
81484,1,1,285150,285151,285152,1,2,0
81485,6,3,285156,285156,285159,0,3,4
81486,5,3,285161,285161,285164,0,3,2
81487,2,3,285163,285164,285167,1,4,0
81488,5,1,285168,285168,285169,0,1,1
81489,6,2,285174,285174,285176,0,2,5
81490,3,1,285177,285177,285178,0,1,1
81491,6,2,285183,285183,285185,0,2,5
81492,2,2,285185,285185,285187,0,2,0
81493,2,1,285187,285187,285188,0,1,0
81494,6,3,285193,285193,285196,0,3,5
81495,2,3,285195,285196,285199,1,4,0
81496,4,1,285199,285199,285200,0,1,0
81497,5,1,285204,285204,285205,0,1,4
81498,3,3,285207,285207,285210,0,3,2
81499,6,1,285213,285213,285214,0,1,3
81500,6,1,285219,285219,285220,0,1,5
81501,5,1,285224,285224,285225,0,1,4
81502,6,2,285230,285230,285232,0,2,5
81503,5,2,285235,285235,285237,0,2,3
81504,1,2,285236,285237,285239,1,3,0
81505,2,3,285238,285239,285242,1,4,0
81506,6,1,285244,285244,285245,0,1,2
81507,4,1,285248,285248,285249,0,1,3
81508,4,2,285252,285252,285254,0,2,3
81509,6,3,285258,285258,285261,0,3,4
81510,6,1,285264,285264,285265,0,1,3
81511,6,3,285270,285270,285273,0,3,5
81512,1,2,285271,285273,285275,2,4,0
81513,1,2,285272,285275,285277,3,5,0
81514,2,3,285274,285277,285280,3,6,0
81515,1,1,285275,285280,285281,5,6,0
81516,1,3,285276,285281,285284,5,8,0
81517,3,2,285279,285284,285286,5,7,0
81518,4,3,285283,285286,285289,3,6,0
81519,1,2,285284,285289,285291,5,7,0
81520,3,1,285287,285291,285292,4,5,0
81521,5,3,285292,285292,285295,0,3,0
81522,2,2,285294,285295,285297,1,3,0
81523,3,3,285297,285297,285300,0,3,0
81524,6,2,285303,285303,285305,0,2,3
81525,2,1,285305,285305,285306,0,1,0
81526,3,2,285308,285308,285310,0,2,2
81527,2,3,285310,285310,285313,0,3,0
81528,4,2,285314,285314,285316,0,2,1
81529,2,1,285316,285316,285317,0,1,0
81530,1,1,285317,285317,285318,0,1,0
81531,3,3,285320,285320,285323,0,3,2
81532,6,3,285326,285326,285329,0,3,3
81533,4,3,285330,285330,285333,0,3,1
81534,4,1,285334,285334,285335,0,1,1
81535,6,1,285340,285340,285341,0,1,5
81536,4,3,285344,285344,285347,0,3,3
81537,3,1,285347,285347,285348,0,1,0
81538,1,1,285348,285348,285349,0,1,0
81539,5,2,285353,285353,285355,0,2,4
81540,5,2,285358,285358,285360,0,2,3
81541,3,3,285361,285361,285364,0,3,1
81542,6,2,285367,285367,285369,0,2,3
81543,1,3,285368,285369,285372,1,4,0
81544,1,1,285369,285372,285373,3,4,0
81545,1,3,285370,285373,285376,3,6,0
81546,4,2,285374,285376,285378,2,4,0
81547,2,2,285376,285378,285380,2,4,0
81548,3,1,285379,285380,285381,1,2,0
81549,4,3,285383,285383,285386,0,3,2
81550,5,2,285388,285388,285390,0,2,2
81551,4,3,285392,285392,285395,0,3,2
81552,3,3,285395,285395,285398,0,3,0
81553,5,2,285400,285400,285402,0,2,2
81554,6,3,285406,285406,285409,0,3,4
81555,1,2,285407,285409,285411,2,4,0
81556,6,3,285413,285413,285416,0,3,2
81557,3,2,285416,285416,285418,0,2,0
81558,3,1,285419,285419,285420,0,1,1
81559,4,1,285423,285423,285424,0,1,3
81560,3,3,285426,285426,285429,0,3,2
81561,4,1,285430,285430,285431,0,1,1
81562,5,1,285435,285435,285436,0,1,4
81563,2,2,285437,285437,285439,0,2,1
81564,3,1,285440,285440,285441,0,1,1
81565,5,1,285445,285445,285446,0,1,4
81566,3,1,285448,285448,285449,0,1,2
81567,2,1,285450,285450,285451,0,1,1
81568,5,3,285455,285455,285458,0,3,4
81569,4,2,285459,285459,285461,0,2,1
81570,1,2,285460,285461,285463,1,3,0
81571,4,3,285464,285464,285467,0,3,1
81572,4,1,285468,285468,285469,0,1,1
81573,3,1,285471,285471,285472,0,1,2
81574,2,1,285473,285473,285474,0,1,1
81575,1,3,285474,285474,285477,0,3,0
81576,1,3,285475,285477,285480,2,5,0
81577,3,2,285478,285480,285482,2,4,0
81578,1,3,285479,285482,285485,3,6,0
81579,3,3,285482,285485,285488,3,6,0
81580,3,2,285485,285488,285490,3,5,0
81581,5,3,285490,285490,285493,0,3,0
81582,3,2,285493,285493,285495,0,2,0
81583,2,1,285495,285495,285496,0,1,0
81584,5,3,285500,285500,285503,0,3,4
81585,5,1,285505,285505,285506,0,1,2
81586,6,2,285511,285511,285513,0,2,5
81587,6,1,285517,285517,285518,0,1,4
81588,3,3,285520,285520,285523,0,3,2
81589,4,2,285524,285524,285526,0,2,1
81590,4,1,285528,285528,285529,0,1,2
81591,6,3,285534,285534,285537,0,3,5
81592,3,1,285537,285537,285538,0,1,0
81593,5,2,285542,285542,285544,0,2,4
81594,4,2,285546,285546,285548,0,2,2
81595,6,3,285552,285552,285555,0,3,4
81596,2,3,285554,285555,285558,1,4,0
81597,2,2,285556,285558,285560,2,4,0
81598,2,2,285558,285560,285562,2,4,0
81599,5,2,285563,285563,285565,0,2,1
81600,5,3,285568,285568,285571,0,3,3
81601,3,3,285571,285571,285574,0,3,0
81602,4,3,285575,285575,285578,0,3,1
81603,5,3,285580,285580,285583,0,3,2
81604,1,2,285581,285583,285585,2,4,0
81605,6,1,285587,285587,285588,0,1,2
81606,5,2,285592,285592,285594,0,2,4
81607,3,3,285595,285595,285598,0,3,1
81608,3,1,285598,285598,285599,0,1,0
81609,4,3,285602,285602,285605,0,3,3
81610,2,3,285604,285605,285608,1,4,0
81611,1,1,285605,285608,285609,3,4,0
81612,3,3,285608,285609,285612,1,4,0
81613,2,2,285610,285612,285614,2,4,0
81614,3,3,285613,285614,285617,1,4,0
81615,6,3,285619,285619,285622,0,3,2
81616,2,3,285621,285622,285625,1,4,0
81617,5,1,285626,285626,285627,0,1,1
81618,3,2,285629,285629,285631,0,2,2
81619,1,1,285630,285631,285632,1,2,0
81620,5,2,285635,285635,285637,0,2,3
81621,3,1,285638,285638,285639,0,1,1
81622,3,1,285641,285641,285642,0,1,2
81623,1,2,285642,285642,285644,0,2,0
81624,2,2,285644,285644,285646,0,2,0
81625,1,3,285645,285646,285649,1,4,0
81626,2,1,285647,285649,285650,2,3,0
81627,2,3,285649,285650,285653,1,4,0
81628,3,3,285652,285653,285656,1,4,0
81629,6,2,285658,285658,285660,0,2,2
81630,5,1,285663,285663,285664,0,1,3
81631,2,3,285665,285665,285668,0,3,1
81632,4,1,285669,285669,285670,0,1,1
81633,3,1,285672,285672,285673,0,1,2
81634,5,3,285677,285677,285680,0,3,4
81635,3,3,285680,285680,285683,0,3,0
81636,5,1,285685,285685,285686,0,1,2
81637,2,2,285687,285687,285689,0,2,1
81638,5,1,285692,285692,285693,0,1,3
81639,6,2,285698,285698,285700,0,2,5
81640,6,2,285704,285704,285706,0,2,4
81641,1,1,285705,285706,285707,1,2,0
81642,5,2,285710,285710,285712,0,2,3
81643,1,3,285711,285712,285715,1,4,0
81644,6,1,285717,285717,285718,0,1,2
81645,4,2,285721,285721,285723,0,2,3
81646,4,2,285725,285725,285727,0,2,2
81647,6,2,285731,285731,285733,0,2,4
81648,5,1,285736,285736,285737,0,1,3
81649,3,2,285739,285739,285741,0,2,2
81650,6,1,285745,285745,285746,0,1,4
81651,3,1,285748,285748,285749,0,1,2
81652,4,1,285752,285752,285753,0,1,3
81653,2,2,285754,285754,285756,0,2,1
81654,3,3,285757,285757,285760,0,3,1
81655,6,1,285763,285763,285764,0,1,3
81656,5,3,285768,285768,285771,0,3,4
81657,2,3,285770,285771,285774,1,4,0
81658,1,3,285771,285774,285777,3,6,0
81659,2,2,285773,285777,285779,4,6,0
81660,6,1,285779,285779,285780,0,1,0
81661,1,3,285780,285780,285783,0,3,0
81662,5,2,285785,285785,285787,0,2,2
81663,5,3,285790,285790,285793,0,3,3
81664,1,3,285791,285793,285796,2,5,0
81665,4,1,285795,285796,285797,1,2,0
81666,1,2,285796,285797,285799,1,3,0
81667,5,3,285801,285801,285804,0,3,2
81668,4,1,285805,285805,285806,0,1,1
81669,5,2,285810,285810,285812,0,2,4
81670,1,1,285811,285812,285813,1,2,0
81671,1,3,285812,285813,285816,1,4,0
81672,5,1,285817,285817,285818,0,1,1
81673,4,2,285821,285821,285823,0,2,3
81674,1,3,285822,285823,285826,1,4,0
81675,2,2,285824,285826,285828,2,4,0
81676,2,2,285826,285828,285830,2,4,0
81677,1,1,285827,285830,285831,3,4,0
81678,2,1,285829,285831,285832,2,3,0
81679,3,3,285832,285832,285835,0,3,0
81680,4,1,285836,285836,285837,0,1,1
81681,5,1,285841,285841,285842,0,1,4
81682,2,1,285843,285843,285844,0,1,1
81683,6,3,285849,285849,285852,0,3,5
81684,1,3,285850,285852,285855,2,5,0
81685,2,3,285852,285855,285858,3,6,0
81686,4,2,285856,285858,285860,2,4,0
81687,4,1,285860,285860,285861,0,1,0
81688,2,2,285862,285862,285864,0,2,1
81689,6,3,285868,285868,285871,0,3,4
81690,2,3,285870,285871,285874,1,4,0
81691,6,2,285876,285876,285878,0,2,2
81692,1,1,285877,285878,285879,1,2,0
81693,4,2,285881,285881,285883,0,2,2
81694,2,2,285883,285883,285885,0,2,0
81695,2,1,285885,285885,285886,0,1,0
81696,4,1,285889,285889,285890,0,1,3
81697,5,3,285894,285894,285897,0,3,4
81698,2,2,285896,285897,285899,1,3,0
81699,3,3,285899,285899,285902,0,3,0
81700,3,2,285902,285902,285904,0,2,0
81701,1,2,285903,285904,285906,1,3,0
81702,4,1,285907,285907,285908,0,1,1
81703,3,1,285910,285910,285911,0,1,2
81704,1,1,285911,285911,285912,0,1,0
81705,5,3,285916,285916,285919,0,3,4
81706,2,2,285918,285919,285921,1,3,0
81707,3,3,285921,285921,285924,0,3,0
81708,6,2,285927,285927,285929,0,2,3
81709,6,1,285933,285933,285934,0,1,4
81710,5,2,285938,285938,285940,0,2,4
81711,3,1,285941,285941,285942,0,1,1
81712,1,3,285942,285942,285945,0,3,0
81713,3,1,285945,285945,285946,0,1,0
81714,6,3,285951,285951,285954,0,3,5
81715,5,3,285956,285956,285959,0,3,2
81716,1,1,285957,285959,285960,2,3,0
81717,4,1,285961,285961,285962,0,1,1
81718,6,2,285967,285967,285969,0,2,5
81719,4,3,285971,285971,285974,0,3,2
81720,5,2,285976,285976,285978,0,2,2
81721,5,3,285981,285981,285984,0,3,3
81722,5,2,285986,285986,285988,0,2,2
81723,1,3,285987,285988,285991,1,4,0
81724,6,1,285993,285993,285994,0,1,2
81725,4,3,285997,285997,286000,0,3,3
81726,1,2,285998,286000,286002,2,4,0
81727,5,1,286003,286003,286004,0,1,1
81728,6,1,286009,286009,286010,0,1,5
81729,6,3,286015,286015,286018,0,3,5
81730,3,3,286018,286018,286021,0,3,0
81731,6,2,286024,286024,286026,0,2,3
81732,4,1,286028,286028,286029,0,1,2
81733,4,1,286032,286032,286033,0,1,3
81734,1,1,286033,286033,286034,0,1,0
81735,1,3,286034,286034,286037,0,3,0
81736,5,3,286039,286039,286042,0,3,2
81737,1,2,286040,286042,286044,2,4,0
81738,6,3,286046,286046,286049,0,3,2
81739,4,3,286050,286050,286053,0,3,1
81740,6,3,286056,286056,286059,0,3,3
81741,6,3,286062,286062,286065,0,3,3
81742,1,1,286063,286065,286066,2,3,0
81743,6,2,286069,286069,286071,0,2,3
81744,6,2,286075,286075,286077,0,2,4
81745,3,3,286078,286078,286081,0,3,1
81746,6,2,286084,286084,286086,0,2,3
81747,5,2,286089,286089,286091,0,2,3
81748,1,1,286090,286091,286092,1,2,0
81749,1,2,286091,286092,286094,1,3,0
81750,5,3,286096,286096,286099,0,3,2
81751,5,3,286101,286101,286104,0,3,2
81752,5,1,286106,286106,286107,0,1,2
81753,5,3,286111,286111,286114,0,3,4
81754,1,3,286112,286114,286117,2,5,0
81755,6,2,286118,286118,286120,0,2,1
81756,1,1,286119,286120,286121,1,2,0
81757,5,3,286124,286124,286127,0,3,3
81758,5,2,286129,286129,286131,0,2,2
81759,4,3,286133,286133,286136,0,3,2
81760,2,1,286135,286136,286137,1,2,0
81761,2,3,286137,286137,286140,0,3,0
81762,2,1,286139,286140,286141,1,2,0
81763,3,2,286142,286142,286144,0,2,1
81764,3,3,286145,286145,286148,0,3,1
81765,3,1,286148,286148,286149,0,1,0
81766,2,2,286150,286150,286152,0,2,1
81767,5,1,286155,286155,286156,0,1,3
81768,1,2,286156,286156,286158,0,2,0
81769,4,3,286160,286160,286163,0,3,2
81770,4,1,286164,286164,286165,0,1,1
81771,1,3,286165,286165,286168,0,3,0
81772,6,2,286171,286171,286173,0,2,3
81773,1,3,286172,286173,286176,1,4,0
81774,3,2,286175,286176,286178,1,3,0
81775,2,3,286177,286178,286181,1,4,0
81776,6,3,286183,286183,286186,0,3,2
81777,6,2,286189,286189,286191,0,2,3
81778,6,3,286195,286195,286198,0,3,4
81779,5,3,286200,286200,286203,0,3,2
81780,3,1,286203,286203,286204,0,1,0
81781,5,2,286208,286208,286210,0,2,4
81782,5,2,286213,286213,286215,0,2,3
81783,5,2,286218,286218,286220,0,2,3
81784,4,1,286222,286222,286223,0,1,2
81785,6,1,286228,286228,286229,0,1,5
81786,6,3,286234,286234,286237,0,3,5
81787,5,1,286239,286239,286240,0,1,2
81788,4,1,286243,286243,286244,0,1,3
81789,5,1,286248,286248,286249,0,1,4
81790,4,1,286252,286252,286253,0,1,3
81791,1,2,286253,286253,286255,0,2,0
81792,4,3,286257,286257,286260,0,3,2
81793,4,2,286261,286261,286263,0,2,1
81794,2,1,286263,286263,286264,0,1,0
81795,3,2,286266,286266,286268,0,2,2
81796,1,3,286267,286268,286271,1,4,0
81797,5,1,286272,286272,286273,0,1,1
81798,6,1,286278,286278,286279,0,1,5
81799,2,1,286280,286280,286281,0,1,1
81800,1,1,286281,286281,286282,0,1,0
81801,1,2,286282,286282,286284,0,2,0
81802,4,2,286286,286286,286288,0,2,2
81803,5,2,286291,286291,286293,0,2,3
81804,2,1,286293,286293,286294,0,1,0
81805,5,2,286298,286298,286300,0,2,4
81806,2,2,286300,286300,286302,0,2,0
81807,3,1,286303,286303,286304,0,1,1
81808,5,2,286308,286308,286310,0,2,4
81809,5,1,286313,286313,286314,0,1,3
81810,6,2,286319,286319,286321,0,2,5
81811,6,2,286325,286325,286327,0,2,4
81812,1,3,286326,286327,286330,1,4,0
81813,4,1,286330,286330,286331,0,1,0
81814,1,1,286331,286331,286332,0,1,0
81815,6,2,286337,286337,286339,0,2,5
81816,5,3,286342,286342,286345,0,3,3
81817,1,3,286343,286345,286348,2,5,0
81818,3,1,286346,286348,286349,2,3,0
81819,5,2,286351,286351,286353,0,2,2
81820,5,3,286356,286356,286359,0,3,3
81821,3,2,286359,286359,286361,0,2,0
81822,4,3,286363,286363,286366,0,3,2
81823,4,2,286367,286367,286369,0,2,1
81824,5,2,286372,286372,286374,0,2,3
81825,6,2,286378,286378,286380,0,2,4
81826,4,2,286382,286382,286384,0,2,2
81827,4,1,286386,286386,286387,0,1,2
81828,6,3,286392,286392,286395,0,3,5
81829,5,1,286397,286397,286398,0,1,2
81830,5,1,286402,286402,286403,0,1,4
81831,5,3,286407,286407,286410,0,3,4
81832,2,1,286409,286410,286411,1,2,0
81833,3,2,286412,286412,286414,0,2,1
81834,1,3,286413,286414,286417,1,4,0
81835,1,2,286414,286417,286419,3,5,0
81836,1,2,286415,286419,286421,4,6,0
81837,3,2,286418,286421,286423,3,5,0
81838,5,2,286423,286423,286425,0,2,0
81839,6,2,286429,286429,286431,0,2,4
81840,2,3,286431,286431,286434,0,3,0
81841,4,3,286435,286435,286438,0,3,1
81842,2,2,286437,286438,286440,1,3,0
81843,6,3,286443,286443,286446,0,3,3
81844,2,2,286445,286446,286448,1,3,0
81845,4,1,286449,286449,286450,0,1,1
81846,6,2,286455,286455,286457,0,2,5
81847,2,3,286457,286457,286460,0,3,0
81848,4,2,286461,286461,286463,0,2,1
81849,6,1,286467,286467,286468,0,1,4
81850,5,3,286472,286472,286475,0,3,4
81851,5,1,286477,286477,286478,0,1,2
81852,2,1,286479,286479,286480,0,1,1
81853,2,2,286481,286481,286483,0,2,1
81854,4,3,286485,286485,286488,0,3,2
81855,2,3,286487,286488,286491,1,4,0
81856,6,1,286493,286493,286494,0,1,2
81857,3,2,286496,286496,286498,0,2,2
81858,4,1,286500,286500,286501,0,1,2
81859,3,1,286503,286503,286504,0,1,2
81860,2,3,286505,286505,286508,0,3,1
81861,6,1,286511,286511,286512,0,1,3
81862,5,3,286516,286516,286519,0,3,4
81863,3,3,286519,286519,286522,0,3,0
81864,2,3,286521,286522,286525,1,4,0
81865,1,1,286522,286525,286526,3,4,0
81866,6,3,286528,286528,286531,0,3,2
81867,4,1,286532,286532,286533,0,1,1
81868,4,3,286536,286536,286539,0,3,3
81869,4,2,286540,286540,286542,0,2,1
81870,5,3,286545,286545,286548,0,3,3
81871,6,3,286551,286551,286554,0,3,3
81872,6,3,286557,286557,286560,0,3,3
81873,5,2,286562,286562,286564,0,2,2
81874,2,3,286564,286564,286567,0,3,0
81875,6,2,286570,286570,286572,0,2,3
81876,6,3,286576,286576,286579,0,3,4
81877,6,2,286582,286582,286584,0,2,3
81878,5,1,286587,286587,286588,0,1,3
81879,6,1,286593,286593,286594,0,1,5
81880,1,2,286594,286594,286596,0,2,0
81881,6,1,286600,286600,286601,0,1,4
81882,1,3,286601,286601,286604,0,3,0
81883,6,1,286607,286607,286608,0,1,3
81884,6,3,286613,286613,286616,0,3,5
81885,5,2,286618,286618,286620,0,2,2
81886,1,2,286619,286620,286622,1,3,0
81887,1,3,286620,286622,286625,2,5,0
81888,5,2,286625,286625,286627,0,2,0
81889,1,3,286626,286627,286630,1,4,0
81890,3,1,286629,286630,286631,1,2,0
81891,5,1,286634,286634,286635,0,1,3
81892,6,1,286640,286640,286641,0,1,5
81893,5,3,286645,286645,286648,0,3,4
81894,3,2,286648,286648,286650,0,2,0
81895,2,1,286650,286650,286651,0,1,0
81896,6,1,286656,286656,286657,0,1,5
81897,4,3,286660,286660,286663,0,3,3
81898,2,1,286662,286663,286664,1,2,0
81899,6,2,286668,286668,286670,0,2,4
81900,1,2,286669,286670,286672,1,3,0
81901,3,2,286672,286672,286674,0,2,0
81902,3,1,286675,286675,286676,0,1,1
81903,6,3,286681,286681,286684,0,3,5
81904,6,3,286687,286687,286690,0,3,3
81905,5,3,286692,286692,286695,0,3,2
81906,3,1,286695,286695,286696,0,1,0
81907,3,1,286698,286698,286699,0,1,2
81908,1,2,286699,286699,286701,0,2,0
81909,5,1,286704,286704,286705,0,1,3
81910,1,1,286705,286705,286706,0,1,0
81911,5,1,286710,286710,286711,0,1,4
81912,1,1,286711,286711,286712,0,1,0
81913,6,2,286717,286717,286719,0,2,5
81914,3,3,286720,286720,286723,0,3,1
81915,6,1,286726,286726,286727,0,1,3
81916,1,3,286727,286727,286730,0,3,0
81917,3,1,286730,286730,286731,0,1,0
81918,3,1,286733,286733,286734,0,1,2
81919,3,3,286736,286736,286739,0,3,2
81920,4,2,286740,286740,286742,0,2,1
81921,4,2,286744,286744,286746,0,2,2
81922,1,2,286745,286746,286748,1,3,0
81923,2,1,286747,286748,286749,1,2,0
81924,1,3,286748,286749,286752,1,4,0
81925,1,3,286749,286752,286755,3,6,0
81926,3,3,286752,286755,286758,3,6,0
81927,6,1,286758,286758,286759,0,1,0
81928,6,3,286764,286764,286767,0,3,5
81929,6,2,286770,286770,286772,0,2,3
81930,4,3,286774,286774,286777,0,3,2
81931,3,2,286777,286777,286779,0,2,0
81932,3,1,286780,286780,286781,0,1,1
81933,2,1,286782,286782,286783,0,1,1
81934,5,2,286787,286787,286789,0,2,4
81935,1,3,286788,286789,286792,1,4,0
81936,1,1,286789,286792,286793,3,4,0
81937,6,2,286795,286795,286797,0,2,2
81938,5,1,286800,286800,286801,0,1,3
81939,4,2,286804,286804,286806,0,2,3
81940,2,3,286806,286806,286809,0,3,0
81941,4,1,286810,286810,286811,0,1,1
81942,1,1,286811,286811,286812,0,1,0
81943,1,3,286812,286812,286815,0,3,0
81944,4,2,286816,286816,286818,0,2,1
81945,2,2,286818,286818,286820,0,2,0
81946,2,3,286820,286820,286823,0,3,0
81947,2,3,286822,286823,286826,1,4,0
81948,4,3,286826,286826,286829,0,3,0
81949,1,3,286827,286829,286832,2,5,0
81950,6,1,286833,286833,286834,0,1,1
81951,3,3,286836,286836,286839,0,3,2
81952,4,2,286840,286840,286842,0,2,1
81953,1,2,286841,286842,286844,1,3,0
81954,5,2,286846,286846,286848,0,2,2
81955,6,3,286852,286852,286855,0,3,4
81956,1,1,286853,286855,286856,2,3,0
81957,5,1,286858,286858,286859,0,1,2
81958,5,2,286863,286863,286865,0,2,4
81959,6,2,286869,286869,286871,0,2,4
81960,2,2,286871,286871,286873,0,2,0
81961,2,1,286873,286873,286874,0,1,0
81962,6,3,286879,286879,286882,0,3,5
81963,5,3,286884,286884,286887,0,3,2
81964,3,1,286887,286887,286888,0,1,0
81965,6,2,286893,286893,286895,0,2,5
81966,6,3,286899,286899,286902,0,3,4
81967,3,1,286902,286902,286903,0,1,0
81968,4,2,286906,286906,286908,0,2,3
81969,5,1,286911,286911,286912,0,1,3
81970,4,1,286915,286915,286916,0,1,3
81971,1,1,286916,286916,286917,0,1,0
81972,4,2,286920,286920,286922,0,2,3
81973,5,1,286925,286925,286926,0,1,3
81974,5,2,286930,286930,286932,0,2,4
81975,2,1,286932,286932,286933,0,1,0
81976,6,1,286938,286938,286939,0,1,5
81977,1,1,286939,286939,286940,0,1,0
81978,6,3,286945,286945,286948,0,3,5
81979,3,1,286948,286948,286949,0,1,0
81980,3,1,286951,286951,286952,0,1,2
81981,6,3,286957,286957,286960,0,3,5
81982,2,2,286959,286960,286962,1,3,0
81983,4,2,286963,286963,286965,0,2,1
81984,6,1,286969,286969,286970,0,1,4
81985,3,1,286972,286972,286973,0,1,2
81986,2,2,286974,286974,286976,0,2,1
81987,5,2,286979,286979,286981,0,2,3
81988,2,3,286981,286981,286984,0,3,0
81989,1,2,286982,286984,286986,2,4,0
81990,4,3,286986,286986,286989,0,3,0
81991,3,1,286989,286989,286990,0,1,0
81992,2,2,286991,286991,286993,0,2,1
81993,1,1,286992,286993,286994,1,2,0
81994,4,1,286996,286996,286997,0,1,2
81995,1,2,286997,286997,286999,0,2,0
81996,6,3,287003,287003,287006,0,3,4
81997,1,1,287004,287006,287007,2,3,0
81998,1,2,287005,287007,287009,2,4,0
81999,1,1,287006,287009,287010,3,4,0
82000,2,2,287008,287010,287012,2,4,0
82001,6,2,287014,287014,287016,0,2,2
82002,6,3,287020,287020,287023,0,3,4
82003,1,2,287021,287023,287025,2,4,0
82004,4,1,287025,287025,287026,0,1,0
82005,2,3,287027,287027,287030,0,3,1
82006,4,3,287031,287031,287034,0,3,1
82007,2,3,287033,287034,287037,1,4,0
82008,4,2,287037,287037,287039,0,2,0
82009,3,3,287040,287040,287043,0,3,1
82010,6,3,287046,287046,287049,0,3,3
82011,5,1,287051,287051,287052,0,1,2
82012,2,2,287053,287053,287055,0,2,1
82013,6,3,287059,287059,287062,0,3,4
82014,2,2,287061,287062,287064,1,3,0
82015,5,2,287066,287066,287068,0,2,2
82016,2,1,287068,287068,287069,0,1,0
82017,2,3,287070,287070,287073,0,3,1
82018,5,1,287075,287075,287076,0,1,2
82019,3,2,287078,287078,287080,0,2,2
82020,5,2,287083,287083,287085,0,2,3
82021,1,3,287084,287085,287088,1,4,0
82022,1,3,287085,287088,287091,3,6,0
82023,5,3,287090,287091,287094,1,4,0
82024,1,2,287091,287094,287096,3,5,0
82025,6,1,287097,287097,287098,0,1,1
82026,4,1,287101,287101,287102,0,1,3
82027,2,1,287103,287103,287104,0,1,1
82028,3,2,287106,287106,287108,0,2,2
82029,2,3,287108,287108,287111,0,3,0
82030,1,2,287109,287111,287113,2,4,0
82031,5,2,287114,287114,287116,0,2,1
82032,3,1,287117,287117,287118,0,1,1
82033,1,2,287118,287118,287120,0,2,0
82034,3,2,287121,287121,287123,0,2,1
82035,4,2,287125,287125,287127,0,2,2
82036,3,3,287128,287128,287131,0,3,1
82037,3,3,287131,287131,287134,0,3,0
82038,3,3,287134,287134,287137,0,3,0
82039,6,2,287140,287140,287142,0,2,3
82040,4,3,287144,287144,287147,0,3,2
82041,3,3,287147,287147,287150,0,3,0
82042,3,2,287150,287150,287152,0,2,0
82043,1,1,287151,287152,287153,1,2,0
82044,5,2,287156,287156,287158,0,2,3
82045,3,2,287159,287159,287161,0,2,1
82046,3,1,287162,287162,287163,0,1,1
82047,5,3,287167,287167,287170,0,3,4
82048,1,3,287168,287170,287173,2,5,0
82049,3,2,287171,287173,287175,2,4,0
82050,5,1,287176,287176,287177,0,1,1
82051,6,1,287182,287182,287183,0,1,5
82052,6,2,287188,287188,287190,0,2,5
82053,2,1,287190,287190,287191,0,1,0
82054,2,1,287192,287192,287193,0,1,1
82055,6,1,287198,287198,287199,0,1,5
82056,3,2,287201,287201,287203,0,2,2
82057,6,1,287207,287207,287208,0,1,4
82058,3,2,287210,287210,287212,0,2,2
82059,4,2,287214,287214,287216,0,2,2
82060,1,3,287215,287216,287219,1,4,0
82061,5,1,287220,287220,287221,0,1,1
82062,3,2,287223,287223,287225,0,2,2
82063,6,2,287229,287229,287231,0,2,4
82064,3,3,287232,287232,287235,0,3,1
82065,6,2,287238,287238,287240,0,2,3
82066,4,2,287242,287242,287244,0,2,2
82067,1,3,287243,287244,287247,1,4,0
82068,3,2,287246,287247,287249,1,3,0
82069,4,2,287250,287250,287252,0,2,1
82070,1,1,287251,287252,287253,1,2,0
82071,3,2,287254,287254,287256,0,2,1
82072,1,3,287255,287256,287259,1,4,0
82073,5,2,287260,287260,287262,0,2,1
82074,6,1,287266,287266,287267,0,1,4
82075,6,2,287272,287272,287274,0,2,5
82076,2,3,287274,287274,287277,0,3,0
82077,6,3,287280,287280,287283,0,3,3
82078,4,2,287284,287284,287286,0,2,1
82079,6,3,287290,287290,287293,0,3,4
82080,2,3,287292,287293,287296,1,4,0
82081,3,2,287295,287296,287298,1,3,0
82082,2,1,287297,287298,287299,1,2,0
82083,2,1,287299,287299,287300,0,1,0
82084,1,1,287300,287300,287301,0,1,0
82085,2,2,287302,287302,287304,0,2,1
82086,3,3,287305,287305,287308,0,3,1
82087,6,1,287311,287311,287312,0,1,3
82088,6,2,287317,287317,287319,0,2,5
82089,5,3,287322,287322,287325,0,3,3
82090,5,3,287327,287327,287330,0,3,2
82091,3,1,287330,287330,287331,0,1,0
82092,4,1,287334,287334,287335,0,1,3
82093,1,1,287335,287335,287336,0,1,0
82094,4,3,287339,287339,287342,0,3,3
82095,2,2,287341,287342,287344,1,3,0
82096,4,3,287345,287345,287348,0,3,1
82097,1,1,287346,287348,287349,2,3,0
82098,2,2,287348,287349,287351,1,3,0
82099,1,2,287349,287351,287353,2,4,0
82100,5,2,287354,287354,287356,0,2,1
82101,3,3,287357,287357,287360,0,3,1
82102,3,1,287360,287360,287361,0,1,0
82103,3,2,287363,287363,287365,0,2,2
82104,2,3,287365,287365,287368,0,3,0
82105,5,1,287370,287370,287371,0,1,2
82106,3,3,287373,287373,287376,0,3,2
82107,6,3,287379,287379,287382,0,3,3
82108,1,2,287380,287382,287384,2,4,0
82109,1,1,287381,287384,287385,3,4,0
82110,2,1,287383,287385,287386,2,3,0
82111,6,1,287389,287389,287390,0,1,3
82112,2,3,287391,287391,287394,0,3,1
82113,3,2,287394,287394,287396,0,2,0
82114,1,2,287395,287396,287398,1,3,0
82115,1,2,287396,287398,287400,2,4,0
82116,1,2,287397,287400,287402,3,5,0
82117,6,1,287403,287403,287404,0,1,1
82118,5,3,287408,287408,287411,0,3,4
82119,3,1,287411,287411,287412,0,1,0
82120,4,3,287415,287415,287418,0,3,3
82121,3,2,287418,287418,287420,0,2,0
82122,6,1,287424,287424,287425,0,1,4
82123,1,2,287425,287425,287427,0,2,0
82124,3,1,287428,287428,287429,0,1,1
82125,2,1,287430,287430,287431,0,1,1
82126,3,3,287433,287433,287436,0,3,2
82127,5,2,287438,287438,287440,0,2,2
82128,4,3,287442,287442,287445,0,3,2
82129,2,3,287444,287445,287448,1,4,0
82130,1,2,287445,287448,287450,3,5,0
82131,5,1,287450,287450,287451,0,1,0
82132,3,1,287453,287453,287454,0,1,2
82133,1,3,287454,287454,287457,0,3,0
82134,1,2,287455,287457,287459,2,4,0
82135,4,1,287459,287459,287460,0,1,0
82136,6,3,287465,287465,287468,0,3,5
82137,4,2,287469,287469,287471,0,2,1
82138,6,1,287475,287475,287476,0,1,4
82139,5,2,287480,287480,287482,0,2,4
82140,6,3,287486,287486,287489,0,3,4
82141,1,2,287487,287489,287491,2,4,0
82142,5,3,287492,287492,287495,0,3,1
82143,2,2,287494,287495,287497,1,3,0
82144,3,3,287497,287497,287500,0,3,0
82145,1,2,287498,287500,287502,2,4,0
82146,5,2,287503,287503,287505,0,2,1
82147,2,1,287505,287505,287506,0,1,0
82148,1,1,287506,287506,287507,0,1,0
82149,5,3,287511,287511,287514,0,3,4
82150,1,1,287512,287514,287515,2,3,0
82151,4,3,287516,287516,287519,0,3,1
82152,3,2,287519,287519,287521,0,2,0
82153,1,3,287520,287521,287524,1,4,0
82154,5,3,287525,287525,287528,0,3,1
82155,1,1,287526,287528,287529,2,3,0
82156,4,3,287530,287530,287533,0,3,1
82157,1,1,287531,287533,287534,2,3,0
82158,2,2,287533,287534,287536,1,3,0
82159,3,3,287536,287536,287539,0,3,0
82160,2,2,287538,287539,287541,1,3,0
82161,6,2,287544,287544,287546,0,2,3
82162,3,1,287547,287547,287548,0,1,1
82163,2,2,287549,287549,287551,0,2,1
82164,4,1,287553,287553,287554,0,1,2
82165,4,3,287557,287557,287560,0,3,3
82166,2,3,287559,287560,287563,1,4,0
82167,2,1,287561,287563,287564,2,3,0
82168,4,3,287565,287565,287568,0,3,1
82169,4,1,287569,287569,287570,0,1,1
82170,2,3,287571,287571,287574,0,3,1
82171,4,3,287575,287575,287578,0,3,1
82172,6,1,287581,287581,287582,0,1,3
82173,2,2,287583,287583,287585,0,2,1
82174,3,1,287586,287586,287587,0,1,1
82175,2,2,287588,287588,287590,0,2,1
82176,2,1,287590,287590,287591,0,1,0
82177,1,1,287591,287591,287592,0,1,0
82178,1,2,287592,287592,287594,0,2,0
82179,1,1,287593,287594,287595,1,2,0
82180,1,2,287594,287595,287597,1,3,0
82181,5,1,287599,287599,287600,0,1,2
82182,4,3,287603,287603,287606,0,3,3
82183,2,1,287605,287606,287607,1,2,0
82184,3,1,287608,287608,287609,0,1,1
82185,3,3,287611,287611,287614,0,3,2
82186,3,1,287614,287614,287615,0,1,0
82187,3,1,287617,287617,287618,0,1,2
82188,3,2,287620,287620,287622,0,2,2
82189,2,2,287622,287622,287624,0,2,0
82190,4,2,287626,287626,287628,0,2,2
82191,6,3,287632,287632,287635,0,3,4
82192,4,2,287636,287636,287638,0,2,1
82193,2,3,287638,287638,287641,0,3,0
82194,1,2,287639,287641,287643,2,4,0
82195,5,1,287644,287644,287645,0,1,1
82196,3,1,287647,287647,287648,0,1,2
82197,6,2,287653,287653,287655,0,2,5
82198,4,1,287657,287657,287658,0,1,2
82199,6,3,287663,287663,287666,0,3,5
82200,1,3,287664,287666,287669,2,5,0
82201,1,3,287665,287669,287672,4,7,0
82202,5,3,287670,287672,287675,2,5,0
82203,4,3,287674,287675,287678,1,4,0
82204,1,3,287675,287678,287681,3,6,0
82205,3,3,287678,287681,287684,3,6,0
82206,5,2,287683,287684,287686,1,3,0
82207,6,2,287689,287689,287691,0,2,3
82208,1,2,287690,287691,287693,1,3,0
82209,3,1,287693,287693,287694,0,1,0
82210,4,1,287697,287697,287698,0,1,3
82211,3,3,287700,287700,287703,0,3,2
82212,6,1,287706,287706,287707,0,1,3
82213,3,3,287709,287709,287712,0,3,2
82214,1,1,287710,287712,287713,2,3,0
82215,1,2,287711,287713,287715,2,4,0
82216,5,1,287716,287716,287717,0,1,1
82217,3,3,287719,287719,287722,0,3,2
82218,4,1,287723,287723,287724,0,1,1
82219,4,3,287727,287727,287730,0,3,3
82220,3,1,287730,287730,287731,0,1,0
82221,1,2,287731,287731,287733,0,2,0
82222,6,3,287737,287737,287740,0,3,4
82223,3,1,287740,287740,287741,0,1,0
82224,4,1,287744,287744,287745,0,1,3
82225,3,3,287747,287747,287750,0,3,2
82226,1,3,287748,287750,287753,2,5,0
82227,6,2,287754,287754,287756,0,2,1
82228,1,3,287755,287756,287759,1,4,0
82229,5,1,287760,287760,287761,0,1,1
82230,2,1,287762,287762,287763,0,1,1
82231,3,1,287765,287765,287766,0,1,2
82232,4,3,287769,287769,287772,0,3,3
82233,2,1,287771,287772,287773,1,2,0
82234,4,3,287775,287775,287778,0,3,2
82235,4,1,287779,287779,287780,0,1,1
82236,5,3,287784,287784,287787,0,3,4
82237,6,3,287790,287790,287793,0,3,3
82238,6,1,287796,287796,287797,0,1,3
82239,6,1,287802,287802,287803,0,1,5
82240,6,1,287808,287808,287809,0,1,5
82241,1,3,287809,287809,287812,0,3,0
82242,4,2,287813,287813,287815,0,2,1
82243,6,2,287819,287819,287821,0,2,4
82244,1,3,287820,287821,287824,1,4,0
82245,1,3,287821,287824,287827,3,6,0
82246,3,2,287824,287827,287829,3,5,0
82247,2,2,287826,287829,287831,3,5,0
82248,4,2,287830,287831,287833,1,3,0
82249,1,3,287831,287833,287836,2,5,0
82250,5,3,287836,287836,287839,0,3,0
82251,4,2,287840,287840,287842,0,2,1
82252,4,1,287844,287844,287845,0,1,2
82253,5,2,287849,287849,287851,0,2,4
82254,4,1,287853,287853,287854,0,1,2
82255,5,1,287858,287858,287859,0,1,4
82256,2,2,287860,287860,287862,0,2,1
82257,2,1,287862,287862,287863,0,1,0
82258,4,1,287866,287866,287867,0,1,3
82259,4,3,287870,287870,287873,0,3,3
82260,5,1,287875,287875,287876,0,1,2
82261,4,1,287879,287879,287880,0,1,3
82262,6,2,287885,287885,287887,0,2,5
82263,6,3,287891,287891,287894,0,3,4
82264,1,2,287892,287894,287896,2,4,0
82265,6,3,287898,287898,287901,0,3,2
82266,2,3,287900,287901,287904,1,4,0
82267,4,1,287904,287904,287905,0,1,0
82268,3,2,287907,287907,287909,0,2,2
82269,2,1,287909,287909,287910,0,1,0
82270,1,1,287910,287910,287911,0,1,0
82271,1,3,287911,287911,287914,0,3,0
82272,4,2,287915,287915,287917,0,2,1
82273,2,2,287917,287917,287919,0,2,0
82274,3,2,287920,287920,287922,0,2,1
82275,5,2,287925,287925,287927,0,2,3
82276,3,1,287928,287928,287929,0,1,1
82277,1,1,287929,287929,287930,0,1,0
82278,5,1,287934,287934,287935,0,1,4
82279,6,1,287940,287940,287941,0,1,5
82280,5,2,287945,287945,287947,0,2,4
82281,3,3,287948,287948,287951,0,3,1
82282,2,3,287950,287951,287954,1,4,0
82283,3,1,287953,287954,287955,1,2,0
82284,5,2,287958,287958,287960,0,2,3
82285,5,1,287963,287963,287964,0,1,3
82286,4,1,287967,287967,287968,0,1,3
82287,6,1,287973,287973,287974,0,1,5
82288,2,2,287975,287975,287977,0,2,1
82289,1,3,287976,287977,287980,1,4,0
82290,3,2,287979,287980,287982,1,3,0
82291,4,1,287983,287983,287984,0,1,1
82292,5,3,287988,287988,287991,0,3,4
82293,5,3,287993,287993,287996,0,3,2
82294,4,3,287997,287997,288000,0,3,1
82295,5,1,288002,288002,288003,0,1,2
82296,4,2,288006,288006,288008,0,2,3
82297,3,3,288009,288009,288012,0,3,1
82298,1,3,288010,288012,288015,2,5,0
82299,6,3,288016,288016,288019,0,3,1
82300,1,3,288017,288019,288022,2,5,0
82301,5,1,288022,288022,288023,0,1,0
82302,5,3,288027,288027,288030,0,3,4
82303,5,3,288032,288032,288035,0,3,2
82304,1,1,288033,288035,288036,2,3,0
82305,3,2,288036,288036,288038,0,2,0
82306,1,3,288037,288038,288041,1,4,0
82307,6,1,288043,288043,288044,0,1,2
82308,6,3,288049,288049,288052,0,3,5
82309,1,1,288050,288052,288053,2,3,0
82310,2,2,288052,288053,288055,1,3,0
82311,6,1,288058,288058,288059,0,1,3
82312,1,2,288059,288059,288061,0,2,0
82313,4,1,288063,288063,288064,0,1,2
82314,4,2,288067,288067,288069,0,2,3
82315,1,1,288068,288069,288070,1,2,0
82316,1,2,288069,288070,288072,1,3,0
82317,1,3,288070,288072,288075,2,5,0
82318,6,2,288076,288076,288078,0,2,1
82319,3,1,288079,288079,288080,0,1,1
82320,4,1,288083,288083,288084,0,1,3
82321,4,1,288087,288087,288088,0,1,3
82322,5,3,288092,288092,288095,0,3,4
82323,3,1,288095,288095,288096,0,1,0
82324,2,1,288097,288097,288098,0,1,1
82325,4,1,288101,288101,288102,0,1,3
82326,5,1,288106,288106,288107,0,1,4
82327,5,1,288111,288111,288112,0,1,4
82328,5,1,288116,288116,288117,0,1,4
82329,6,2,288122,288122,288124,0,2,5
82330,1,1,288123,288124,288125,1,2,0
82331,2,3,288125,288125,288128,0,3,0
82332,5,3,288130,288130,288133,0,3,2
82333,4,2,288134,288134,288136,0,2,1
82334,6,2,288140,288140,288142,0,2,4
82335,1,1,288141,288142,288143,1,2,0
82336,2,3,288143,288143,288146,0,3,0
82337,6,3,288149,288149,288152,0,3,3
82338,1,2,288150,288152,288154,2,4,0
82339,5,1,288155,288155,288156,0,1,1
82340,2,1,288157,288157,288158,0,1,1
82341,2,2,288159,288159,288161,0,2,1
82342,4,2,288163,288163,288165,0,2,2
82343,1,1,288164,288165,288166,1,2,0
82344,3,2,288167,288167,288169,0,2,1
82345,5,1,288172,288172,288173,0,1,3
82346,5,3,288177,288177,288180,0,3,4
82347,6,1,288183,288183,288184,0,1,3
82348,5,3,288188,288188,288191,0,3,4
82349,6,3,288194,288194,288197,0,3,3
82350,2,3,288196,288197,288200,1,4,0
82351,5,3,288201,288201,288204,0,3,1
82352,1,2,288202,288204,288206,2,4,0
82353,3,1,288205,288206,288207,1,2,0
82354,6,1,288211,288211,288212,0,1,4
82355,5,2,288216,288216,288218,0,2,4
82356,5,2,288221,288221,288223,0,2,3
82357,3,2,288224,288224,288226,0,2,1
82358,4,3,288228,288228,288231,0,3,2
82359,3,3,288231,288231,288234,0,3,0
82360,2,2,288233,288234,288236,1,3,0
82361,5,1,288238,288238,288239,0,1,2
82362,3,3,288241,288241,288244,0,3,2
82363,5,3,288246,288246,288249,0,3,2
82364,1,3,288247,288249,288252,2,5,0
82365,2,3,288249,288252,288255,3,6,0
82366,4,2,288253,288255,288257,2,4,0
82367,5,2,288258,288258,288260,0,2,1
82368,3,2,288261,288261,288263,0,2,1
82369,2,2,288263,288263,288265,0,2,0
82370,2,3,288265,288265,288268,0,3,0
82371,1,1,288266,288268,288269,2,3,0
82372,3,3,288269,288269,288272,0,3,0
82373,6,3,288275,288275,288278,0,3,3
82374,4,3,288279,288279,288282,0,3,1
82375,6,3,288285,288285,288288,0,3,3
82376,3,3,288288,288288,288291,0,3,0
82377,6,2,288294,288294,288296,0,2,3
82378,4,3,288298,288298,288301,0,3,2
82379,3,2,288301,288301,288303,0,2,0
82380,3,3,288304,288304,288307,0,3,1
82381,1,2,288305,288307,288309,2,4,0
82382,2,2,288307,288309,288311,2,4,0
82383,4,1,288311,288311,288312,0,1,0
82384,5,1,288316,288316,288317,0,1,4
82385,6,2,288322,288322,288324,0,2,5
82386,6,3,288328,288328,288331,0,3,4
82387,1,2,288329,288331,288333,2,4,0
82388,4,2,288333,288333,288335,0,2,0
82389,5,2,288338,288338,288340,0,2,3
82390,5,1,288343,288343,288344,0,1,3
82391,4,1,288347,288347,288348,0,1,3
82392,1,2,288348,288348,288350,0,2,0
82393,2,2,288350,288350,288352,0,2,0
82394,1,2,288351,288352,288354,1,3,0
82395,4,2,288355,288355,288357,0,2,1
82396,2,3,288357,288357,288360,0,3,0
82397,3,1,288360,288360,288361,0,1,0
82398,4,1,288364,288364,288365,0,1,3
82399,5,1,288369,288369,288370,0,1,4
82400,3,1,288372,288372,288373,0,1,2
82401,6,2,288378,288378,288380,0,2,5
82402,6,2,288384,288384,288386,0,2,4
82403,2,1,288386,288386,288387,0,1,0
82404,1,2,288387,288387,288389,0,2,0
82405,3,2,288390,288390,288392,0,2,1
82406,2,2,288392,288392,288394,0,2,0
82407,6,1,288398,288398,288399,0,1,4
82408,2,2,288400,288400,288402,0,2,1
82409,2,3,288402,288402,288405,0,3,0
82410,4,3,288406,288406,288409,0,3,1
82411,2,2,288408,288409,288411,1,3,0
82412,5,3,288413,288413,288416,0,3,2
82413,4,3,288417,288417,288420,0,3,1
82414,3,2,288420,288420,288422,0,2,0
82415,4,2,288424,288424,288426,0,2,2
82416,6,1,288430,288430,288431,0,1,4
82417,2,3,288432,288432,288435,0,3,1
82418,6,2,288438,288438,288440,0,2,3
82419,3,1,288441,288441,288442,0,1,1
82420,1,2,288442,288442,288444,0,2,0
82421,5,2,288447,288447,288449,0,2,3
82422,2,1,288449,288449,288450,0,1,0
82423,3,3,288452,288452,288455,0,3,2
82424,5,1,288457,288457,288458,0,1,2
82425,4,2,288461,288461,288463,0,2,3
82426,6,3,288467,288467,288470,0,3,4
82427,2,2,288469,288470,288472,1,3,0
82428,2,1,288471,288472,288473,1,2,0
82429,6,3,288477,288477,288480,0,3,4
82430,4,3,288481,288481,288484,0,3,1
82431,5,3,288486,288486,288489,0,3,2
82432,3,3,288489,288489,288492,0,3,0
82433,3,2,288492,288492,288494,0,2,0
82434,3,2,288495,288495,288497,0,2,1
82435,3,3,288498,288498,288501,0,3,1
82436,2,1,288500,288501,288502,1,2,0
82437,5,3,288505,288505,288508,0,3,3
82438,5,3,288510,288510,288513,0,3,2
82439,1,2,288511,288513,288515,2,4,0
82440,1,3,288512,288515,288518,3,6,0
82441,1,1,288513,288518,288519,5,6,0
82442,3,1,288516,288519,288520,3,4,0
82443,6,2,288522,288522,288524,0,2,2
82444,6,2,288528,288528,288530,0,2,4
82445,2,2,288530,288530,288532,0,2,0
82446,3,1,288533,288533,288534,0,1,1
82447,1,2,288534,288534,288536,0,2,0
82448,1,3,288535,288536,288539,1,4,0
82449,3,1,288538,288539,288540,1,2,0
82450,5,1,288543,288543,288544,0,1,3
82451,4,1,288547,288547,288548,0,1,3
82452,2,1,288549,288549,288550,0,1,1
82453,5,3,288554,288554,288557,0,3,4
82454,6,2,288560,288560,288562,0,2,3
82455,1,3,288561,288562,288565,1,4,0
82456,2,1,288563,288565,288566,2,3,0
82457,5,3,288568,288568,288571,0,3,2
82458,3,1,288571,288571,288572,0,1,0
82459,5,3,288576,288576,288579,0,3,4
82460,5,1,288581,288581,288582,0,1,2
82461,2,2,288583,288583,288585,0,2,1
82462,4,3,288587,288587,288590,0,3,2
82463,2,1,288589,288590,288591,1,2,0
82464,5,2,288594,288594,288596,0,2,3
82465,5,3,288599,288599,288602,0,3,3
82466,2,1,288601,288602,288603,1,2,0
82467,1,1,288602,288603,288604,1,2,0
82468,3,2,288605,288605,288607,0,2,1
82469,4,3,288609,288609,288612,0,3,2
82470,4,2,288613,288613,288615,0,2,1
82471,4,2,288617,288617,288619,0,2,2
82472,6,3,288623,288623,288626,0,3,4
82473,5,2,288628,288628,288630,0,2,2
82474,3,2,288631,288631,288633,0,2,1
82475,1,2,288632,288633,288635,1,3,0
82476,6,2,288638,288638,288640,0,2,3
82477,1,2,288639,288640,288642,1,3,0
82478,4,1,288643,288643,288644,0,1,1
82479,3,2,288646,288646,288648,0,2,2
82480,2,1,288648,288648,288649,0,1,0
82481,5,3,288653,288653,288656,0,3,4
82482,2,3,288655,288656,288659,1,4,0
82483,4,1,288659,288659,288660,0,1,0
82484,5,3,288664,288664,288667,0,3,4
82485,5,1,288669,288669,288670,0,1,2
82486,2,3,288671,288671,288674,0,3,1
82487,3,2,288674,288674,288676,0,2,0
82488,6,3,288680,288680,288683,0,3,4
82489,2,2,288682,288683,288685,1,3,0
82490,2,2,288684,288685,288687,1,3,0
82491,6,1,288690,288690,288691,0,1,3
82492,4,3,288694,288694,288697,0,3,3
82493,4,2,288698,288698,288700,0,2,1
82494,1,2,288699,288700,288702,1,3,0
82495,6,1,288705,288705,288706,0,1,3
82496,4,2,288709,288709,288711,0,2,3
82497,3,3,288712,288712,288715,0,3,1
82498,2,3,288714,288715,288718,1,4,0
82499,2,3,288716,288718,288721,2,5,0
82500,4,3,288720,288721,288724,1,4,0
82501,6,1,288726,288726,288727,0,1,2
82502,1,2,288727,288727,288729,0,2,0
82503,4,1,288731,288731,288732,0,1,2
82504,5,1,288736,288736,288737,0,1,4
82505,5,1,288741,288741,288742,0,1,4
82506,1,3,288742,288742,288745,0,3,0
82507,4,1,288746,288746,288747,0,1,1
82508,1,1,288747,288747,288748,0,1,0
82509,1,2,288748,288748,288750,0,2,0
82510,6,3,288754,288754,288757,0,3,4
82511,2,1,288756,288757,288758,1,2,0
82512,5,3,288761,288761,288764,0,3,3
82513,5,1,288766,288766,288767,0,1,2
82514,6,2,288772,288772,288774,0,2,5
82515,6,1,288778,288778,288779,0,1,4
82516,5,1,288783,288783,288784,0,1,4
82517,3,1,288786,288786,288787,0,1,2
82518,2,1,288788,288788,288789,0,1,1
82519,3,3,288791,288791,288794,0,3,2
82520,5,3,288796,288796,288799,0,3,2
82521,1,3,288797,288799,288802,2,5,0
82522,5,1,288802,288802,288803,0,1,0
82523,5,1,288807,288807,288808,0,1,4
82524,3,1,288810,288810,288811,0,1,2
82525,5,1,288815,288815,288816,0,1,4
82526,5,2,288820,288820,288822,0,2,4
82527,5,2,288825,288825,288827,0,2,3
82528,2,2,288827,288827,288829,0,2,0
82529,6,1,288833,288833,288834,0,1,4
82530,6,2,288839,288839,288841,0,2,5
82531,3,1,288842,288842,288843,0,1,1
82532,2,1,288844,288844,288845,0,1,1
82533,1,1,288845,288845,288846,0,1,0
82534,6,3,288851,288851,288854,0,3,5
82535,6,3,288857,288857,288860,0,3,3
82536,3,1,288860,288860,288861,0,1,0
82537,5,1,288865,288865,288866,0,1,4
82538,6,2,288871,288871,288873,0,2,5
82539,1,1,288872,288873,288874,1,2,0
82540,5,1,288877,288877,288878,0,1,3
82541,1,1,288878,288878,288879,0,1,0
82542,4,2,288882,288882,288884,0,2,3
82543,3,3,288885,288885,288888,0,3,1
82544,2,1,288887,288888,288889,1,2,0
82545,1,1,288888,288889,288890,1,2,0
82546,4,2,288892,288892,288894,0,2,2
82547,4,1,288896,288896,288897,0,1,2
82548,4,1,288900,288900,288901,0,1,3
82549,5,3,288905,288905,288908,0,3,4
82550,5,2,288910,288910,288912,0,2,2
82551,2,1,288912,288912,288913,0,1,0
82552,1,3,288913,288913,288916,0,3,0
82553,4,1,288917,288917,288918,0,1,1
82554,3,3,288920,288920,288923,0,3,2
82555,5,2,288925,288925,288927,0,2,2
82556,3,1,288928,288928,288929,0,1,1
82557,6,1,288934,288934,288935,0,1,5
82558,6,3,288940,288940,288943,0,3,5
82559,4,1,288944,288944,288945,0,1,1
82560,6,1,288950,288950,288951,0,1,5
82561,2,3,288952,288952,288955,0,3,1
82562,3,1,288955,288955,288956,0,1,0
82563,5,2,288960,288960,288962,0,2,4
82564,2,1,288962,288962,288963,0,1,0
82565,6,3,288968,288968,288971,0,3,5
82566,4,3,288972,288972,288975,0,3,1
82567,2,1,288974,288975,288976,1,2,0
82568,5,1,288979,288979,288980,0,1,3
82569,3,2,288982,288982,288984,0,2,2
82570,1,1,288983,288984,288985,1,2,0
82571,5,2,288988,288988,288990,0,2,3
82572,5,1,288993,288993,288994,0,1,3
82573,3,1,288996,288996,288997,0,1,2
82574,2,3,288998,288998,289001,0,3,1
82575,1,3,288999,289001,289004,2,5,0
82576,3,3,289002,289004,289007,2,5,0
82577,4,3,289006,289007,289010,1,4,0
82578,3,2,289009,289010,289012,1,3,0
82579,1,1,289010,289012,289013,2,3,0
82580,5,3,289015,289015,289018,0,3,2
82581,6,1,289021,289021,289022,0,1,3
82582,3,2,289024,289024,289026,0,2,2
82583,4,1,289028,289028,289029,0,1,2
82584,6,2,289034,289034,289036,0,2,5
82585,4,1,289038,289038,289039,0,1,2
82586,4,2,289042,289042,289044,0,2,3
82587,1,2,289043,289044,289046,1,3,0
82588,5,1,289048,289048,289049,0,1,2
82589,2,1,289050,289050,289051,0,1,1
82590,2,2,289052,289052,289054,0,2,1
82591,1,3,289053,289054,289057,1,4,0
82592,1,3,289054,289057,289060,3,6,0
82593,3,3,289057,289060,289063,3,6,0
82594,5,3,289062,289063,289066,1,4,0
82595,5,3,289067,289067,289070,0,3,1
82596,5,3,289072,289072,289075,0,3,2
82597,3,3,289075,289075,289078,0,3,0
82598,3,2,289078,289078,289080,0,2,0
82599,2,2,289080,289080,289082,0,2,0
82600,1,3,289081,289082,289085,1,4,0
82601,1,2,289082,289085,289087,3,5,0
82602,1,3,289083,289087,289090,4,7,0
82603,6,1,289089,289090,289091,1,2,0
82604,3,3,289092,289092,289095,0,3,1
82605,2,2,289094,289095,289097,1,3,0
82606,4,1,289098,289098,289099,0,1,1
82607,2,3,289100,289100,289103,0,3,1
82608,6,2,289106,289106,289108,0,2,3
82609,4,1,289110,289110,289111,0,1,2
82610,4,1,289114,289114,289115,0,1,3
82611,4,3,289118,289118,289121,0,3,3
82612,4,1,289122,289122,289123,0,1,1
82613,5,1,289127,289127,289128,0,1,4
82614,6,2,289133,289133,289135,0,2,5
82615,4,2,289137,289137,289139,0,2,2
82616,5,1,289142,289142,289143,0,1,3
82617,6,3,289148,289148,289151,0,3,5
82618,2,1,289150,289151,289152,1,2,0
82619,5,2,289155,289155,289157,0,2,3
82620,5,3,289160,289160,289163,0,3,3
82621,1,2,289161,289163,289165,2,4,0
82622,4,2,289165,289165,289167,0,2,0
82623,4,1,289169,289169,289170,0,1,2
82624,6,1,289175,289175,289176,0,1,5
82625,4,3,289179,289179,289182,0,3,3
82626,3,1,289182,289182,289183,0,1,0
82627,4,3,289186,289186,289189,0,3,3
82628,6,3,289192,289192,289195,0,3,3
82629,6,2,289198,289198,289200,0,2,3
82630,1,2,289199,289200,289202,1,3,0
82631,3,2,289202,289202,289204,0,2,0
82632,2,1,289204,289204,289205,0,1,0
82633,3,3,289207,289207,289210,0,3,2
82634,4,2,289211,289211,289213,0,2,1
82635,6,2,289217,289217,289219,0,2,4
82636,6,2,289223,289223,289225,0,2,4
82637,6,2,289229,289229,289231,0,2,4
82638,4,3,289233,289233,289236,0,3,2
82639,4,2,289237,289237,289239,0,2,1
82640,2,1,289239,289239,289240,0,1,0
82641,3,1,289242,289242,289243,0,1,2
82642,4,1,289246,289246,289247,0,1,3
82643,1,3,289247,289247,289250,0,3,0
82644,3,1,289250,289250,289251,0,1,0
82645,6,1,289256,289256,289257,0,1,5
82646,1,2,289257,289257,289259,0,2,0
82647,2,2,289259,289259,289261,0,2,0
82648,1,3,289260,289261,289264,1,4,0
82649,6,3,289266,289266,289269,0,3,2
82650,4,1,289270,289270,289271,0,1,1
82651,3,1,289273,289273,289274,0,1,2
82652,5,3,289278,289278,289281,0,3,4
82653,3,3,289281,289281,289284,0,3,0
82654,5,2,289286,289286,289288,0,2,2
82655,4,3,289290,289290,289293,0,3,2
82656,2,2,289292,289293,289295,1,3,0
82657,1,2,289293,289295,289297,2,4,0
82658,3,3,289296,289297,289300,1,4,0
82659,6,2,289302,289302,289304,0,2,2
82660,3,1,289305,289305,289306,0,1,1
82661,3,2,289308,289308,289310,0,2,2
82662,1,2,289309,289310,289312,1,3,0
82663,6,2,289315,289315,289317,0,2,3
82664,5,1,289320,289320,289321,0,1,3
82665,4,1,289324,289324,289325,0,1,3
82666,2,3,289326,289326,289329,0,3,1
82667,5,1,289331,289331,289332,0,1,2
82668,1,2,289332,289332,289334,0,2,0
82669,2,1,289334,289334,289335,0,1,0
82670,6,1,289340,289340,289341,0,1,5
82671,4,3,289344,289344,289347,0,3,3
82672,4,3,289348,289348,289351,0,3,1
82673,2,2,289350,289351,289353,1,3,0
82674,1,3,289351,289353,289356,2,5,0
82675,4,3,289355,289356,289359,1,4,0
82676,1,1,289356,289359,289360,3,4,0
82677,5,3,289361,289361,289364,0,3,1
82678,4,3,289365,289365,289368,0,3,1
82679,6,2,289371,289371,289373,0,2,3
82680,2,3,289373,289373,289376,0,3,0
82681,5,1,289378,289378,289379,0,1,2
82682,4,2,289382,289382,289384,0,2,3
82683,1,3,289383,289384,289387,1,4,0
82684,3,3,289386,289387,289390,1,4,0
82685,4,2,289390,289390,289392,0,2,0
82686,2,3,289392,289392,289395,0,3,0
82687,4,3,289396,289396,289399,0,3,1
82688,1,2,289397,289399,289401,2,4,0
82689,6,3,289403,289403,289406,0,3,2
82690,5,3,289408,289408,289411,0,3,2
82691,5,3,289413,289413,289416,0,3,2
82692,5,3,289418,289418,289421,0,3,2
82693,6,2,289424,289424,289426,0,2,3
82694,5,1,289429,289429,289430,0,1,3
82695,2,1,289431,289431,289432,0,1,1
82696,5,3,289436,289436,289439,0,3,4
82697,6,2,289442,289442,289444,0,2,3
82698,4,2,289446,289446,289448,0,2,2
82699,2,1,289448,289448,289449,0,1,0
82700,5,3,289453,289453,289456,0,3,4
82701,4,1,289457,289457,289458,0,1,1
82702,2,2,289459,289459,289461,0,2,1
82703,4,3,289463,289463,289466,0,3,2
82704,2,3,289465,289466,289469,1,4,0
82705,4,2,289469,289469,289471,0,2,0
82706,4,3,289473,289473,289476,0,3,2
82707,1,3,289474,289476,289479,2,5,0
82708,3,3,289477,289479,289482,2,5,0
82709,2,1,289479,289482,289483,3,4,0
82710,3,3,289482,289483,289486,1,4,0
82711,3,1,289485,289486,289487,1,2,0
82712,4,3,289489,289489,289492,0,3,2
82713,2,2,289491,289492,289494,1,3,0
82714,3,2,289494,289494,289496,0,2,0
82715,5,2,289499,289499,289501,0,2,3
82716,2,2,289501,289501,289503,0,2,0
82717,4,3,289505,289505,289508,0,3,2
82718,4,1,289509,289509,289510,0,1,1
82719,6,2,289515,289515,289517,0,2,5
82720,3,3,289518,289518,289521,0,3,1
82721,5,1,289523,289523,289524,0,1,2
82722,6,1,289529,289529,289530,0,1,5
82723,5,1,289534,289534,289535,0,1,4
82724,2,2,289536,289536,289538,0,2,1
82725,1,2,289537,289538,289540,1,3,0
82726,6,3,289543,289543,289546,0,3,3
82727,5,3,289548,289548,289551,0,3,2
82728,5,2,289553,289553,289555,0,2,2
82729,5,1,289558,289558,289559,0,1,3
82730,1,2,289559,289559,289561,0,2,0
82731,2,3,289561,289561,289564,0,3,0
82732,5,3,289566,289566,289569,0,3,2
82733,4,2,289570,289570,289572,0,2,1
82734,1,1,289571,289572,289573,1,2,0
82735,6,2,289577,289577,289579,0,2,4
82736,2,2,289579,289579,289581,0,2,0
82737,6,1,289585,289585,289586,0,1,4
82738,6,1,289591,289591,289592,0,1,5
82739,4,1,289595,289595,289596,0,1,3
82740,1,2,289596,289596,289598,0,2,0
82741,1,2,289597,289598,289600,1,3,0
82742,1,2,289598,289600,289602,2,4,0
82743,1,2,289599,289602,289604,3,5,0
82744,6,3,289605,289605,289608,0,3,1
82745,4,2,289609,289609,289611,0,2,1
82746,6,1,289615,289615,289616,0,1,4
82747,2,2,289617,289617,289619,0,2,1
82748,1,2,289618,289619,289621,1,3,0
82749,2,1,289620,289621,289622,1,2,0
82750,5,1,289625,289625,289626,0,1,3
82751,4,1,289629,289629,289630,0,1,3
82752,6,3,289635,289635,289638,0,3,5
82753,6,2,289641,289641,289643,0,2,3
82754,2,3,289643,289643,289646,0,3,0
82755,1,3,289644,289646,289649,2,5,0
82756,2,3,289646,289649,289652,3,6,0
82757,2,1,289648,289652,289653,4,5,0
82758,4,3,289652,289653,289656,1,4,0
82759,1,1,289653,289656,289657,3,4,0
82760,5,1,289658,289658,289659,0,1,1
82761,1,2,289659,289659,289661,0,2,0
82762,4,3,289663,289663,289666,0,3,2
82763,5,2,289668,289668,289670,0,2,2
82764,3,3,289671,289671,289674,0,3,1
82765,2,1,289673,289674,289675,1,2,0
82766,4,3,289677,289677,289680,0,3,2
82767,5,1,289682,289682,289683,0,1,2
82768,2,1,289684,289684,289685,0,1,1
82769,5,1,289689,289689,289690,0,1,4
82770,2,1,289691,289691,289692,0,1,1
82771,2,3,289693,289693,289696,0,3,1
82772,3,1,289696,289696,289697,0,1,0
82773,2,1,289698,289698,289699,0,1,1
82774,5,2,289703,289703,289705,0,2,4
82775,4,1,289707,289707,289708,0,1,2
82776,4,3,289711,289711,289714,0,3,3
82777,6,1,289717,289717,289718,0,1,3
82778,1,2,289718,289718,289720,0,2,0
82779,5,1,289723,289723,289724,0,1,3
82780,4,1,289727,289727,289728,0,1,3
82781,4,1,289731,289731,289732,0,1,3
82782,6,3,289737,289737,289740,0,3,5
82783,4,1,289741,289741,289742,0,1,1
82784,4,1,289745,289745,289746,0,1,3
82785,6,1,289751,289751,289752,0,1,5
82786,2,1,289753,289753,289754,0,1,1
82787,6,2,289759,289759,289761,0,2,5
82788,4,1,289763,289763,289764,0,1,2
82789,5,2,289768,289768,289770,0,2,4
82790,1,3,289769,289770,289773,1,4,0
82791,4,2,289773,289773,289775,0,2,0
82792,2,2,289775,289775,289777,0,2,0
82793,3,2,289778,289778,289780,0,2,1
82794,5,2,289783,289783,289785,0,2,3
82795,5,1,289788,289788,289789,0,1,3
82796,6,1,289794,289794,289795,0,1,5
82797,5,2,289799,289799,289801,0,2,4
82798,3,3,289802,289802,289805,0,3,1
82799,4,2,289806,289806,289808,0,2,1
82800,5,1,289811,289811,289812,0,1,3
82801,2,2,289813,289813,289815,0,2,1
82802,6,2,289819,289819,289821,0,2,4
82803,1,3,289820,289821,289824,1,4,0
82804,3,2,289823,289824,289826,1,3,0
82805,4,3,289827,289827,289830,0,3,1
82806,3,3,289830,289830,289833,0,3,0
82807,2,2,289832,289833,289835,1,3,0
82808,2,1,289834,289835,289836,1,2,0
82809,2,3,289836,289836,289839,0,3,0
82810,2,3,289838,289839,289842,1,4,0
82811,5,3,289843,289843,289846,0,3,1
82812,5,1,289848,289848,289849,0,1,2
82813,1,2,289849,289849,289851,0,2,0
82814,1,3,289850,289851,289854,1,4,0
82815,6,3,289856,289856,289859,0,3,2
82816,3,2,289859,289859,289861,0,2,0
82817,6,2,289865,289865,289867,0,2,4
82818,2,3,289867,289867,289870,0,3,0
82819,5,2,289872,289872,289874,0,2,2
82820,4,1,289876,289876,289877,0,1,2
82821,4,3,289880,289880,289883,0,3,3
82822,5,1,289885,289885,289886,0,1,2
82823,4,2,289889,289889,289891,0,2,3
82824,3,3,289892,289892,289895,0,3,1
82825,6,1,289898,289898,289899,0,1,3
82826,2,2,289900,289900,289902,0,2,1
82827,1,2,289901,289902,289904,1,3,0
82828,2,3,289903,289904,289907,1,4,0
82829,6,2,289909,289909,289911,0,2,2
82830,3,1,289912,289912,289913,0,1,1
82831,5,3,289917,289917,289920,0,3,4
82832,6,3,289923,289923,289926,0,3,3
82833,5,2,289928,289928,289930,0,2,2
82834,2,1,289930,289930,289931,0,1,0
82835,6,2,289936,289936,289938,0,2,5
82836,4,1,289940,289940,289941,0,1,2
82837,1,3,289941,289941,289944,0,3,0
82838,6,3,289947,289947,289950,0,3,3
82839,2,1,289949,289950,289951,1,2,0
82840,2,1,289951,289951,289952,0,1,0
82841,4,2,289955,289955,289957,0,2,3
82842,2,1,289957,289957,289958,0,1,0
82843,1,2,289958,289958,289960,0,2,0
82844,1,1,289959,289960,289961,1,2,0
82845,3,1,289962,289962,289963,0,1,1
82846,2,3,289964,289964,289967,0,3,1
82847,1,2,289965,289967,289969,2,4,0
82848,1,1,289966,289969,289970,3,4,0
82849,1,1,289967,289970,289971,3,4,0
82850,2,3,289969,289971,289974,2,5,0
82851,4,3,289973,289974,289977,1,4,0
82852,2,1,289975,289977,289978,2,3,0
82853,6,3,289981,289981,289984,0,3,3
82854,5,3,289986,289986,289989,0,3,2
82855,4,3,289990,289990,289993,0,3,1
82856,4,1,289994,289994,289995,0,1,1
82857,5,2,289999,289999,290001,0,2,4
82858,3,3,290002,290002,290005,0,3,1
82859,5,1,290007,290007,290008,0,1,2
82860,4,1,290011,290011,290012,0,1,3
82861,6,1,290017,290017,290018,0,1,5
82862,5,3,290022,290022,290025,0,3,4
82863,1,2,290023,290025,290027,2,4,0
82864,2,3,290025,290027,290030,2,5,0
82865,6,3,290031,290031,290034,0,3,1
82866,4,1,290035,290035,290036,0,1,1
82867,1,2,290036,290036,290038,0,2,0
82868,6,1,290042,290042,290043,0,1,4
82869,4,3,290046,290046,290049,0,3,3
82870,4,2,290050,290050,290052,0,2,1
82871,3,3,290053,290053,290056,0,3,1
82872,1,2,290054,290056,290058,2,4,0
82873,4,2,290058,290058,290060,0,2,0
82874,1,2,290059,290060,290062,1,3,0
82875,1,2,290060,290062,290064,2,4,0
82876,5,2,290065,290065,290067,0,2,1
82877,1,1,290066,290067,290068,1,2,0
82878,4,2,290070,290070,290072,0,2,2
82879,3,3,290073,290073,290076,0,3,1
82880,6,1,290079,290079,290080,0,1,3
82881,4,3,290083,290083,290086,0,3,3
82882,2,3,290085,290086,290089,1,4,0
82883,1,2,290086,290089,290091,3,5,0
82884,5,3,290091,290091,290094,0,3,0
82885,1,1,290092,290094,290095,2,3,0
82886,5,1,290097,290097,290098,0,1,2
82887,4,1,290101,290101,290102,0,1,3
82888,1,1,290102,290102,290103,0,1,0
82889,2,3,290104,290104,290107,0,3,1
82890,5,3,290109,290109,290112,0,3,2
82891,3,2,290112,290112,290114,0,2,0
82892,4,1,290116,290116,290117,0,1,2
82893,6,3,290122,290122,290125,0,3,5
82894,2,3,290124,290125,290128,1,4,0
82895,2,3,290126,290128,290131,2,5,0
82896,3,2,290129,290131,290133,2,4,0
82897,3,3,290132,290133,290136,1,4,0
82898,3,1,290135,290136,290137,1,2,0
82899,1,3,290136,290137,290140,1,4,0
82900,1,2,290137,290140,290142,3,5,0
82901,4,3,290141,290142,290145,1,4,0
82902,6,1,290147,290147,290148,0,1,2
82903,5,3,290152,290152,290155,0,3,4
82904,6,3,290158,290158,290161,0,3,3
82905,3,2,290161,290161,290163,0,2,0
82906,6,1,290167,290167,290168,0,1,4
82907,4,1,290171,290171,290172,0,1,3
82908,2,2,290173,290173,290175,0,2,1
82909,1,3,290174,290175,290178,1,4,0
82910,5,1,290179,290179,290180,0,1,1
82911,1,3,290180,290180,290183,0,3,0
82912,3,2,290183,290183,290185,0,2,0
82913,5,3,290188,290188,290191,0,3,3
82914,3,1,290191,290191,290192,0,1,0
82915,3,1,290194,290194,290195,0,1,2
82916,4,1,290198,290198,290199,0,1,3
82917,1,3,290199,290199,290202,0,3,0
82918,3,3,290202,290202,290205,0,3,0
82919,5,1,290207,290207,290208,0,1,2
82920,3,2,290210,290210,290212,0,2,2
82921,5,2,290215,290215,290217,0,2,3
82922,5,2,290220,290220,290222,0,2,3
82923,4,3,290224,290224,290227,0,3,2
82924,5,3,290229,290229,290232,0,3,2
82925,2,2,290231,290232,290234,1,3,0
82926,2,3,290233,290234,290237,1,4,0
82927,6,3,290239,290239,290242,0,3,2
82928,3,2,290242,290242,290244,0,2,0
82929,1,3,290243,290244,290247,1,4,0
82930,3,1,290246,290247,290248,1,2,0
82931,2,3,290248,290248,290251,0,3,0
82932,6,3,290254,290254,290257,0,3,3
82933,1,2,290255,290257,290259,2,4,0
82934,2,1,290257,290259,290260,2,3,0
82935,6,1,290263,290263,290264,0,1,3
82936,4,2,290267,290267,290269,0,2,3
82937,3,1,290270,290270,290271,0,1,1
82938,3,1,290273,290273,290274,0,1,2
82939,3,3,290276,290276,290279,0,3,2
82940,3,1,290279,290279,290280,0,1,0
82941,4,1,290283,290283,290284,0,1,3
82942,3,2,290286,290286,290288,0,2,2
82943,2,1,290288,290288,290289,0,1,0
82944,6,2,290294,290294,290296,0,2,5
82945,3,1,290297,290297,290298,0,1,1
82946,6,1,290303,290303,290304,0,1,5
82947,1,3,290304,290304,290307,0,3,0
82948,2,2,290306,290307,290309,1,3,0
82949,4,3,290310,290310,290313,0,3,1
82950,2,3,290312,290313,290316,1,4,0
82951,4,3,290316,290316,290319,0,3,0
82952,6,3,290322,290322,290325,0,3,3
82953,3,1,290325,290325,290326,0,1,0
82954,2,3,290327,290327,290330,0,3,1
82955,4,2,290331,290331,290333,0,2,1
82956,6,3,290337,290337,290340,0,3,4
82957,5,3,290342,290342,290345,0,3,2
82958,2,3,290344,290345,290348,1,4,0
82959,4,1,290348,290348,290349,0,1,0
82960,1,1,290349,290349,290350,0,1,0
82961,4,2,290353,290353,290355,0,2,3
82962,6,2,290359,290359,290361,0,2,4
82963,2,3,290361,290361,290364,0,3,0
82964,4,2,290365,290365,290367,0,2,1
82965,6,2,290371,290371,290373,0,2,4
82966,1,3,290372,290373,290376,1,4,0
82967,4,3,290376,290376,290379,0,3,0
82968,3,3,290379,290379,290382,0,3,0
82969,4,2,290383,290383,290385,0,2,1
82970,6,2,290389,290389,290391,0,2,4
82971,2,1,290391,290391,290392,0,1,0
82972,6,3,290397,290397,290400,0,3,5
82973,6,3,290403,290403,290406,0,3,3
82974,2,2,290405,290406,290408,1,3,0
82975,5,2,290410,290410,290412,0,2,2
82976,6,2,290416,290416,290418,0,2,4
82977,6,2,290422,290422,290424,0,2,4
82978,3,2,290425,290425,290427,0,2,1
82979,1,3,290426,290427,290430,1,4,0
82980,6,3,290432,290432,290435,0,3,2
82981,3,3,290435,290435,290438,0,3,0
82982,6,3,290441,290441,290444,0,3,3
82983,1,1,290442,290444,290445,2,3,0
82984,4,2,290446,290446,290448,0,2,1
82985,4,3,290450,290450,290453,0,3,2
82986,1,1,290451,290453,290454,2,3,0
82987,2,3,290453,290454,290457,1,4,0
82988,3,1,290456,290457,290458,1,2,0
82989,6,1,290462,290462,290463,0,1,4
82990,4,1,290466,290466,290467,0,1,3
82991,1,3,290467,290467,290470,0,3,0
82992,6,2,290473,290473,290475,0,2,3
82993,1,2,290474,290475,290477,1,3,0
82994,3,2,290477,290477,290479,0,2,0
82995,5,2,290482,290482,290484,0,2,3
82996,5,2,290487,290487,290489,0,2,3
82997,4,3,290491,290491,290494,0,3,2
82998,5,2,290496,290496,290498,0,2,2
82999,5,3,290501,290501,290504,0,3,3
83000,6,1,290507,290507,290508,0,1,3
83001,5,3,290512,290512,290515,0,3,4
83002,4,2,290516,290516,290518,0,2,1
83003,3,1,290519,290519,290520,0,1,1
83004,5,1,290524,290524,290525,0,1,4
83005,3,1,290527,290527,290528,0,1,2
83006,3,2,290530,290530,290532,0,2,2
83007,5,1,290535,290535,290536,0,1,3
83008,1,1,290536,290536,290537,0,1,0
83009,2,1,290538,290538,290539,0,1,1
83010,1,2,290539,290539,290541,0,2,0
83011,5,3,290544,290544,290547,0,3,3
83012,4,1,290548,290548,290549,0,1,1
83013,2,3,290550,290550,290553,0,3,1
83014,3,1,290553,290553,290554,0,1,0
83015,6,3,290559,290559,290562,0,3,5
83016,2,1,290561,290562,290563,1,2,0
83017,3,3,290564,290564,290567,0,3,1
83018,4,3,290568,290568,290571,0,3,1
83019,1,3,290569,290571,290574,2,5,0
83020,2,2,290571,290574,290576,3,5,0
83021,4,1,290575,290576,290577,1,2,0
83022,4,3,290579,290579,290582,0,3,2
83023,2,1,290581,290582,290583,1,2,0
83024,1,2,290582,290583,290585,1,3,0
83025,5,1,290587,290587,290588,0,1,2
83026,2,2,290589,290589,290591,0,2,1
83027,4,1,290593,290593,290594,0,1,2
83028,4,1,290597,290597,290598,0,1,3
83029,6,3,290603,290603,290606,0,3,5
83030,1,3,290604,290606,290609,2,5,0
83031,1,1,290605,290609,290610,4,5,0
83032,4,3,290609,290610,290613,1,4,0
83033,3,1,290612,290613,290614,1,2,0
83034,5,1,290617,290617,290618,0,1,3
83035,1,1,290618,290618,290619,0,1,0
83036,4,2,290622,290622,290624,0,2,3
83037,2,1,290624,290624,290625,0,1,0
83038,3,2,290627,290627,290629,0,2,2
83039,1,3,290628,290629,290632,1,4,0
83040,1,2,290629,290632,290634,3,5,0
83041,4,1,290633,290634,290635,1,2,0
83042,3,3,290636,290636,290639,0,3,1
83043,3,2,290639,290639,290641,0,2,0
83044,1,3,290640,290641,290644,1,4,0
83045,1,1,290641,290644,290645,3,4,0
83046,5,3,290646,290646,290649,0,3,1
83047,3,2,290649,290649,290651,0,2,0
83048,4,2,290653,290653,290655,0,2,2
83049,4,1,290657,290657,290658,0,1,2
83050,6,1,290663,290663,290664,0,1,5
83051,1,2,290664,290664,290666,0,2,0
83052,2,1,290666,290666,290667,0,1,0
83053,5,3,290671,290671,290674,0,3,4
83054,4,1,290675,290675,290676,0,1,1
83055,4,3,290679,290679,290682,0,3,3
83056,4,2,290683,290683,290685,0,2,1
83057,3,3,290686,290686,290689,0,3,1
83058,6,3,290692,290692,290695,0,3,3
83059,1,3,290693,290695,290698,2,5,0
83060,5,1,290698,290698,290699,0,1,0
83061,2,1,290700,290700,290701,0,1,1
83062,6,2,290706,290706,290708,0,2,5
83063,6,1,290712,290712,290713,0,1,4
83064,5,2,290717,290717,290719,0,2,4
83065,5,2,290722,290722,290724,0,2,3
83066,4,2,290726,290726,290728,0,2,2
83067,2,2,290728,290728,290730,0,2,0
83068,2,3,290730,290730,290733,0,3,0
83069,6,3,290736,290736,290739,0,3,3
83070,6,3,290742,290742,290745,0,3,3
83071,2,1,290744,290745,290746,1,2,0
83072,4,2,290748,290748,290750,0,2,2
83073,1,1,290749,290750,290751,1,2,0
83074,2,1,290751,290751,290752,0,1,0
83075,1,1,290752,290752,290753,0,1,0
83076,1,1,290753,290753,290754,0,1,0
83077,2,1,290755,290755,290756,0,1,1
83078,3,2,290758,290758,290760,0,2,2
83079,3,2,290761,290761,290763,0,2,1
83080,4,3,290765,290765,290768,0,3,2
83081,2,1,290767,290768,290769,1,2,0
83082,4,1,290771,290771,290772,0,1,2
83083,5,1,290776,290776,290777,0,1,4
83084,4,1,290780,290780,290781,0,1,3
83085,1,1,290781,290781,290782,0,1,0
83086,5,3,290786,290786,290789,0,3,4
83087,1,2,290787,290789,290791,2,4,0
83088,3,2,290790,290791,290793,1,3,0
83089,4,2,290794,290794,290796,0,2,1
83090,2,3,290796,290796,290799,0,3,0
83091,2,2,290798,290799,290801,1,3,0
83092,4,3,290802,290802,290805,0,3,1
83093,5,2,290807,290807,290809,0,2,2
83094,6,1,290813,290813,290814,0,1,4
83095,5,2,290818,290818,290820,0,2,4
83096,6,3,290824,290824,290827,0,3,4
83097,6,2,290830,290830,290832,0,2,3
83098,6,1,290836,290836,290837,0,1,4
83099,4,3,290840,290840,290843,0,3,3
83100,2,1,290842,290843,290844,1,2,0
83101,2,1,290844,290844,290845,0,1,0
83102,1,1,290845,290845,290846,0,1,0
83103,6,3,290851,290851,290854,0,3,5
83104,1,3,290852,290854,290857,2,5,0
83105,2,2,290854,290857,290859,3,5,0
83106,5,3,290859,290859,290862,0,3,0
83107,6,3,290865,290865,290868,0,3,3
83108,6,3,290871,290871,290874,0,3,3
83109,6,3,290877,290877,290880,0,3,3
83110,3,2,290880,290880,290882,0,2,0
83111,4,2,290884,290884,290886,0,2,2
83112,4,1,290888,290888,290889,0,1,2
83113,4,1,290892,290892,290893,0,1,3
83114,4,2,290896,290896,290898,0,2,3
83115,5,1,290901,290901,290902,0,1,3
83116,1,2,290902,290902,290904,0,2,0
83117,6,2,290908,290908,290910,0,2,4
83118,2,1,290910,290910,290911,0,1,0
83119,3,3,290913,290913,290916,0,3,2
83120,3,2,290916,290916,290918,0,2,0
83121,6,1,290922,290922,290923,0,1,4
83122,6,3,290928,290928,290931,0,3,5
83123,5,3,290933,290933,290936,0,3,2
83124,3,3,290936,290936,290939,0,3,0
83125,4,2,290940,290940,290942,0,2,1
83126,1,3,290941,290942,290945,1,4,0
83127,1,3,290942,290945,290948,3,6,0
83128,1,3,290943,290948,290951,5,8,0
83129,2,3,290945,290951,290954,6,9,0
83130,5,2,290950,290954,290956,4,6,0
83131,3,2,290953,290956,290958,3,5,0
83132,5,3,290958,290958,290961,0,3,0
83133,2,2,290960,290961,290963,1,3,0
83134,2,3,290962,290963,290966,1,4,0
83135,4,3,290966,290966,290969,0,3,0
83136,4,3,290970,290970,290973,0,3,1
83137,1,1,290971,290973,290974,2,3,0
83138,2,2,290973,290974,290976,1,3,0
83139,5,3,290978,290978,290981,0,3,2
83140,3,1,290981,290981,290982,0,1,0
83141,2,3,290983,290983,290986,0,3,1
83142,2,2,290985,290986,290988,1,3,0
83143,5,2,290990,290990,290992,0,2,2
83144,1,3,290991,290992,290995,1,4,0
83145,5,2,290996,290996,290998,0,2,1
83146,5,3,291001,291001,291004,0,3,3
83147,2,1,291003,291004,291005,1,2,0
83148,4,3,291007,291007,291010,0,3,2
83149,3,2,291010,291010,291012,0,2,0
83150,5,1,291015,291015,291016,0,1,3
83151,2,2,291017,291017,291019,0,2,1
83152,6,1,291023,291023,291024,0,1,4
83153,3,1,291026,291026,291027,0,1,2
83154,5,1,291031,291031,291032,0,1,4
83155,1,1,291032,291032,291033,0,1,0
83156,3,2,291035,291035,291037,0,2,2
83157,3,3,291038,291038,291041,0,3,1
83158,1,1,291039,291041,291042,2,3,0
83159,1,2,291040,291042,291044,2,4,0
83160,6,2,291046,291046,291048,0,2,2
83161,6,2,291052,291052,291054,0,2,4
83162,2,2,291054,291054,291056,0,2,0
83163,5,3,291059,291059,291062,0,3,3
83164,6,3,291065,291065,291068,0,3,3
83165,5,3,291070,291070,291073,0,3,2
83166,5,3,291075,291075,291078,0,3,2
83167,6,3,291081,291081,291084,0,3,3
83168,5,1,291086,291086,291087,0,1,2
83169,6,2,291092,291092,291094,0,2,5
83170,5,1,291097,291097,291098,0,1,3
83171,4,3,291101,291101,291104,0,3,3
83172,1,3,291102,291104,291107,2,5,0
83173,6,1,291108,291108,291109,0,1,1
83174,5,3,291113,291113,291116,0,3,4
83175,2,3,291115,291116,291119,1,4,0
83176,3,2,291118,291119,291121,1,3,0
83177,5,1,291123,291123,291124,0,1,2
83178,4,1,291127,291127,291128,0,1,3
83179,6,1,291133,291133,291134,0,1,5
83180,2,2,291135,291135,291137,0,2,1
83181,1,1,291136,291137,291138,1,2,0
83182,2,1,291138,291138,291139,0,1,0
83183,4,2,291142,291142,291144,0,2,3
83184,5,2,291147,291147,291149,0,2,3
83185,1,2,291148,291149,291151,1,3,0
83186,2,2,291150,291151,291153,1,3,0
83187,3,1,291153,291153,291154,0,1,0
83188,3,2,291156,291156,291158,0,2,2
83189,3,2,291159,291159,291161,0,2,1
83190,1,3,291160,291161,291164,1,4,0
83191,3,3,291163,291164,291167,1,4,0
83192,2,1,291165,291167,291168,2,3,0
83193,4,3,291169,291169,291172,0,3,1
83194,3,2,291172,291172,291174,0,2,0
83195,2,1,291174,291174,291175,0,1,0
83196,5,2,291179,291179,291181,0,2,4
83197,6,3,291185,291185,291188,0,3,4
83198,5,3,291190,291190,291193,0,3,2
83199,6,2,291196,291196,291198,0,2,3
83200,4,2,291200,291200,291202,0,2,2
83201,3,3,291203,291203,291206,0,3,1
83202,5,3,291208,291208,291211,0,3,2
83203,1,3,291209,291211,291214,2,5,0
83204,4,2,291213,291214,291216,1,3,0
83205,5,2,291218,291218,291220,0,2,2
83206,3,2,291221,291221,291223,0,2,1
83207,1,3,291222,291223,291226,1,4,0
83208,6,2,291228,291228,291230,0,2,2
83209,3,1,291231,291231,291232,0,1,1
83210,6,1,291237,291237,291238,0,1,5
83211,4,2,291241,291241,291243,0,2,3
83212,4,3,291245,291245,291248,0,3,2
83213,4,3,291249,291249,291252,0,3,1
83214,6,3,291255,291255,291258,0,3,3
83215,5,2,291260,291260,291262,0,2,2
83216,4,3,291264,291264,291267,0,3,2
83217,4,2,291268,291268,291270,0,2,1
83218,4,1,291272,291272,291273,0,1,2
83219,5,2,291277,291277,291279,0,2,4
83220,5,1,291282,291282,291283,0,1,3
83221,1,2,291283,291283,291285,0,2,0
83222,1,3,291284,291285,291288,1,4,0
83223,6,2,291290,291290,291292,0,2,2
83224,5,1,291295,291295,291296,0,1,3
83225,4,3,291299,291299,291302,0,3,3
83226,2,1,291301,291302,291303,1,2,0
83227,5,2,291306,291306,291308,0,2,3
83228,5,2,291311,291311,291313,0,2,3
83229,3,1,291314,291314,291315,0,1,1
83230,1,3,291315,291315,291318,0,3,0
83231,3,3,291318,291318,291321,0,3,0
83232,3,1,291321,291321,291322,0,1,0
83233,1,1,291322,291322,291323,0,1,0
83234,3,2,291325,291325,291327,0,2,2
83235,3,2,291328,291328,291330,0,2,1
83236,4,2,291332,291332,291334,0,2,2
83237,6,2,291338,291338,291340,0,2,4
83238,5,1,291343,291343,291344,0,1,3
83239,5,3,291348,291348,291351,0,3,4
83240,4,2,291352,291352,291354,0,2,1
83241,1,3,291353,291354,291357,1,4,0
83242,4,3,291357,291357,291360,0,3,0
83243,1,3,291358,291360,291363,2,5,0
83244,4,1,291362,291363,291364,1,2,0
83245,1,1,291363,291364,291365,1,2,0
83246,3,1,291366,291366,291367,0,1,1
83247,3,2,291369,291369,291371,0,2,2
83248,5,3,291374,291374,291377,0,3,3
83249,3,1,291377,291377,291378,0,1,0
83250,5,2,291382,291382,291384,0,2,4
83251,5,2,291387,291387,291389,0,2,3
83252,2,1,291389,291389,291390,0,1,0
83253,6,3,291395,291395,291398,0,3,5
83254,3,2,291398,291398,291400,0,2,0
83255,4,2,291402,291402,291404,0,2,2
83256,5,1,291407,291407,291408,0,1,3
83257,1,2,291408,291408,291410,0,2,0
83258,1,3,291409,291410,291413,1,4,0
83259,3,3,291412,291413,291416,1,4,0
83260,1,2,291413,291416,291418,3,5,0
83261,5,3,291418,291418,291421,0,3,0
83262,5,1,291423,291423,291424,0,1,2
83263,6,1,291429,291429,291430,0,1,5
83264,4,3,291433,291433,291436,0,3,3
83265,3,3,291436,291436,291439,0,3,0
83266,6,3,291442,291442,291445,0,3,3
83267,6,2,291448,291448,291450,0,2,3
83268,1,1,291449,291450,291451,1,2,0
83269,2,1,291451,291451,291452,0,1,0
83270,2,2,291453,291453,291455,0,2,1
83271,3,3,291456,291456,291459,0,3,1
83272,4,2,291460,291460,291462,0,2,1
83273,5,2,291465,291465,291467,0,2,3
83274,3,2,291468,291468,291470,0,2,1
83275,3,2,291471,291471,291473,0,2,1
83276,2,1,291473,291473,291474,0,1,0
83277,5,2,291478,291478,291480,0,2,4
83278,2,3,291480,291480,291483,0,3,0
83279,4,3,291484,291484,291487,0,3,1
83280,6,3,291490,291490,291493,0,3,3
83281,5,2,291495,291495,291497,0,2,2
83282,1,2,291496,291497,291499,1,3,0
83283,2,1,291498,291499,291500,1,2,0
83284,2,3,291500,291500,291503,0,3,0
83285,6,1,291506,291506,291507,0,1,3
83286,6,2,291512,291512,291514,0,2,5
83287,5,1,291517,291517,291518,0,1,3
83288,2,3,291519,291519,291522,0,3,1
83289,4,1,291523,291523,291524,0,1,1
83290,1,3,291524,291524,291527,0,3,0
83291,2,1,291526,291527,291528,1,2,0
83292,5,2,291531,291531,291533,0,2,3
83293,1,1,291532,291533,291534,1,2,0
83294,4,1,291536,291536,291537,0,1,2
83295,4,1,291540,291540,291541,0,1,3
83296,4,2,291544,291544,291546,0,2,3
83297,5,1,291549,291549,291550,0,1,3
83298,6,2,291555,291555,291557,0,2,5
83299,4,3,291559,291559,291562,0,3,2
83300,6,3,291565,291565,291568,0,3,3
83301,2,1,291567,291568,291569,1,2,0
83302,2,3,291569,291569,291572,0,3,0
83303,3,3,291572,291572,291575,0,3,0
83304,1,1,291573,291575,291576,2,3,0
83305,2,3,291575,291576,291579,1,4,0
83306,6,2,291581,291581,291583,0,2,2
83307,5,2,291586,291586,291588,0,2,3
83308,5,1,291591,291591,291592,0,1,3
83309,1,3,291592,291592,291595,0,3,0
83310,4,1,291596,291596,291597,0,1,1
83311,2,3,291598,291598,291601,0,3,1
83312,2,1,291600,291601,291602,1,2,0
83313,5,1,291605,291605,291606,0,1,3
83314,5,1,291610,291610,291611,0,1,4
83315,4,2,291614,291614,291616,0,2,3
83316,4,2,291618,291618,291620,0,2,2
83317,1,1,291619,291620,291621,1,2,0
83318,3,1,291622,291622,291623,0,1,1
83319,6,1,291628,291628,291629,0,1,5
83320,6,3,291634,291634,291637,0,3,5
83321,4,2,291638,291638,291640,0,2,1
83322,3,1,291641,291641,291642,0,1,1
83323,1,2,291642,291642,291644,0,2,0
83324,4,1,291646,291646,291647,0,1,2
83325,5,2,291651,291651,291653,0,2,4
83326,6,1,291657,291657,291658,0,1,4
83327,4,1,291661,291661,291662,0,1,3
83328,4,3,291665,291665,291668,0,3,3
83329,5,2,291670,291670,291672,0,2,2
83330,2,2,291672,291672,291674,0,2,0
83331,3,2,291675,291675,291677,0,2,1
83332,5,3,291680,291680,291683,0,3,3
83333,1,2,291681,291683,291685,2,4,0
83334,2,1,291683,291685,291686,2,3,0
83335,3,3,291686,291686,291689,0,3,0
83336,6,1,291692,291692,291693,0,1,3
83337,5,3,291697,291697,291700,0,3,4
83338,1,1,291698,291700,291701,2,3,0
83339,2,3,291700,291701,291704,1,4,0
83340,5,1,291705,291705,291706,0,1,1
83341,3,3,291708,291708,291711,0,3,2
83342,5,1,291713,291713,291714,0,1,2
83343,1,1,291714,291714,291715,0,1,0
83344,4,1,291718,291718,291719,0,1,3
83345,2,3,291720,291720,291723,0,3,1
83346,6,1,291726,291726,291727,0,1,3
83347,5,1,291731,291731,291732,0,1,4
83348,5,1,291736,291736,291737,0,1,4
83349,1,1,291737,291737,291738,0,1,0
83350,3,1,291740,291740,291741,0,1,2
83351,3,3,291743,291743,291746,0,3,2
83352,3,1,291746,291746,291747,0,1,0
83353,3,1,291749,291749,291750,0,1,2
83354,1,2,291750,291750,291752,0,2,0
83355,5,3,291755,291755,291758,0,3,3
83356,2,2,291757,291758,291760,1,3,0
83357,2,1,291759,291760,291761,1,2,0
83358,3,2,291762,291762,291764,0,2,1
83359,2,2,291764,291764,291766,0,2,0
83360,2,2,291766,291766,291768,0,2,0
83361,6,3,291772,291772,291775,0,3,4
83362,2,1,291774,291775,291776,1,2,0
83363,3,3,291777,291777,291780,0,3,1
83364,6,3,291783,291783,291786,0,3,3
83365,1,1,291784,291786,291787,2,3,0
83366,1,3,291785,291787,291790,2,5,0
83367,6,3,291791,291791,291794,0,3,1
83368,3,2,291794,291794,291796,0,2,0
83369,4,2,291798,291798,291800,0,2,2
83370,2,3,291800,291800,291803,0,3,0
83371,1,1,291801,291803,291804,2,3,0
83372,4,1,291805,291805,291806,0,1,1
83373,5,1,291810,291810,291811,0,1,4
83374,5,3,291815,291815,291818,0,3,4
83375,4,1,291819,291819,291820,0,1,1
83376,1,2,291820,291820,291822,0,2,0
83377,3,3,291823,291823,291826,0,3,1
83378,3,3,291826,291826,291829,0,3,0
83379,4,1,291830,291830,291831,0,1,1
83380,5,3,291835,291835,291838,0,3,4
83381,2,1,291837,291838,291839,1,2,0
83382,2,3,291839,291839,291842,0,3,0
83383,5,1,291844,291844,291845,0,1,2
83384,4,2,291848,291848,291850,0,2,3
83385,1,1,291849,291850,291851,1,2,0
83386,5,1,291854,291854,291855,0,1,3
83387,2,1,291856,291856,291857,0,1,1
83388,4,2,291860,291860,291862,0,2,3
83389,2,3,291862,291862,291865,0,3,0
83390,2,2,291864,291865,291867,1,3,0
83391,3,1,291867,291867,291868,0,1,0
83392,2,1,291869,291869,291870,0,1,1
83393,6,1,291875,291875,291876,0,1,5
83394,1,3,291876,291876,291879,0,3,0
83395,6,2,291882,291882,291884,0,2,3
83396,5,3,291887,291887,291890,0,3,3
83397,5,3,291892,291892,291895,0,3,2
83398,4,3,291896,291896,291899,0,3,1
83399,3,3,291899,291899,291902,0,3,0
83400,6,2,291905,291905,291907,0,2,3
83401,4,2,291909,291909,291911,0,2,2
83402,4,3,291913,291913,291916,0,3,2
83403,2,3,291915,291916,291919,1,4,0
83404,2,3,291917,291919,291922,2,5,0
83405,4,2,291921,291922,291924,1,3,0
83406,4,3,291925,291925,291928,0,3,1
83407,6,3,291931,291931,291934,0,3,3
83408,2,3,291933,291934,291937,1,4,0
83409,6,2,291939,291939,291941,0,2,2
83410,2,1,291941,291941,291942,0,1,0
83411,2,3,291943,291943,291946,0,3,1
83412,2,3,291945,291946,291949,1,4,0
83413,2,2,291947,291949,291951,2,4,0
83414,4,1,291951,291951,291952,0,1,0
83415,3,2,291954,291954,291956,0,2,2
83416,3,2,291957,291957,291959,0,2,1
83417,5,3,291962,291962,291965,0,3,3
83418,4,3,291966,291966,291969,0,3,1
83419,5,3,291971,291971,291974,0,3,2
83420,4,1,291975,291975,291976,0,1,1
83421,6,1,291981,291981,291982,0,1,5
83422,4,1,291985,291985,291986,0,1,3
83423,4,2,291989,291989,291991,0,2,3
83424,3,1,291992,291992,291993,0,1,1
83425,4,1,291996,291996,291997,0,1,3
83426,4,3,292000,292000,292003,0,3,3
83427,3,3,292003,292003,292006,0,3,0
83428,1,3,292004,292006,292009,2,5,0
83429,2,1,292006,292009,292010,3,4,0
83430,4,2,292010,292010,292012,0,2,0
83431,3,2,292013,292013,292015,0,2,1
83432,1,3,292014,292015,292018,1,4,0
83433,6,1,292020,292020,292021,0,1,2
83434,2,1,292022,292022,292023,0,1,1
83435,6,2,292028,292028,292030,0,2,5
83436,1,3,292029,292030,292033,1,4,0
83437,4,1,292033,292033,292034,0,1,0
83438,1,2,292034,292034,292036,0,2,0
83439,1,3,292035,292036,292039,1,4,0
83440,6,3,292041,292041,292044,0,3,2
83441,3,1,292044,292044,292045,0,1,0
83442,1,2,292045,292045,292047,0,2,0
83443,5,2,292050,292050,292052,0,2,3
83444,3,3,292053,292053,292056,0,3,1
83445,1,1,292054,292056,292057,2,3,0
83446,1,2,292055,292057,292059,2,4,0
83447,6,1,292061,292061,292062,0,1,2
83448,2,3,292063,292063,292066,0,3,1
83449,1,1,292064,292066,292067,2,3,0
83450,1,1,292065,292067,292068,2,3,0
83451,6,1,292071,292071,292072,0,1,3
83452,2,3,292073,292073,292076,0,3,1
83453,3,3,292076,292076,292079,0,3,0
83454,3,2,292079,292079,292081,0,2,0
83455,3,1,292082,292082,292083,0,1,1
83456,3,2,292085,292085,292087,0,2,2
83457,2,2,292087,292087,292089,0,2,0
83458,1,2,292088,292089,292091,1,3,0
83459,5,1,292093,292093,292094,0,1,2
83460,4,2,292097,292097,292099,0,2,3
83461,6,2,292103,292103,292105,0,2,4
83462,5,3,292108,292108,292111,0,3,3
83463,1,1,292109,292111,292112,2,3,0
83464,4,2,292113,292113,292115,0,2,1
83465,6,1,292119,292119,292120,0,1,4
83466,4,1,292123,292123,292124,0,1,3
83467,2,1,292125,292125,292126,0,1,1
83468,2,1,292127,292127,292128,0,1,1
83469,2,3,292129,292129,292132,0,3,1
83470,6,1,292135,292135,292136,0,1,3
83471,6,1,292141,292141,292142,0,1,5
83472,6,2,292147,292147,292149,0,2,5
83473,2,2,292149,292149,292151,0,2,0
83474,6,2,292155,292155,292157,0,2,4
83475,2,2,292157,292157,292159,0,2,0
83476,2,2,292159,292159,292161,0,2,0
83477,5,1,292164,292164,292165,0,1,3
83478,4,2,292168,292168,292170,0,2,3
83479,4,1,292172,292172,292173,0,1,2
83480,4,2,292176,292176,292178,0,2,3
83481,6,2,292182,292182,292184,0,2,4
83482,4,3,292186,292186,292189,0,3,2
83483,3,2,292189,292189,292191,0,2,0
83484,6,2,292195,292195,292197,0,2,4
83485,5,3,292200,292200,292203,0,3,3
83486,5,2,292205,292205,292207,0,2,2
83487,6,3,292211,292211,292214,0,3,4
83488,5,3,292216,292216,292219,0,3,2
83489,6,2,292222,292222,292224,0,2,3
83490,2,2,292224,292224,292226,0,2,0
83491,3,3,292227,292227,292230,0,3,1
83492,5,3,292232,292232,292235,0,3,2
83493,2,1,292234,292235,292236,1,2,0
83494,6,1,292240,292240,292241,0,1,4
83495,4,2,292244,292244,292246,0,2,3
83496,3,1,292247,292247,292248,0,1,1
83497,4,3,292251,292251,292254,0,3,3
83498,5,2,292256,292256,292258,0,2,2
83499,6,1,292262,292262,292263,0,1,4
83500,3,3,292265,292265,292268,0,3,2
83501,4,3,292269,292269,292272,0,3,1
83502,1,2,292270,292272,292274,2,4,0
83503,5,1,292275,292275,292276,0,1,1
83504,6,2,292281,292281,292283,0,2,5
83505,1,3,292282,292283,292286,1,4,0
83506,1,2,292283,292286,292288,3,5,0
83507,3,3,292286,292288,292291,2,5,0
83508,5,2,292291,292291,292293,0,2,0
83509,2,1,292293,292293,292294,0,1,0
83510,6,3,292299,292299,292302,0,3,5
83511,1,3,292300,292302,292305,2,5,0
83512,6,2,292306,292306,292308,0,2,1
83513,1,3,292307,292308,292311,1,4,0
83514,2,2,292309,292311,292313,2,4,0
83515,6,3,292315,292315,292318,0,3,2
83516,6,3,292321,292321,292324,0,3,3
83517,4,2,292325,292325,292327,0,2,1
83518,2,1,292327,292327,292328,0,1,0
83519,6,2,292333,292333,292335,0,2,5
83520,2,2,292335,292335,292337,0,2,0
83521,2,3,292337,292337,292340,0,3,0
83522,2,2,292339,292340,292342,1,3,0
83523,1,1,292340,292342,292343,2,3,0
83524,3,2,292343,292343,292345,0,2,0
83525,6,1,292349,292349,292350,0,1,4
83526,5,2,292354,292354,292356,0,2,4
83527,5,1,292359,292359,292360,0,1,3
83528,5,2,292364,292364,292366,0,2,4
83529,4,3,292368,292368,292371,0,3,2
83530,6,2,292374,292374,292376,0,2,3
83531,1,3,292375,292376,292379,1,4,0
83532,6,2,292381,292381,292383,0,2,2
83533,3,1,292384,292384,292385,0,1,1
83534,6,2,292390,292390,292392,0,2,5
83535,3,2,292393,292393,292395,0,2,1
83536,4,2,292397,292397,292399,0,2,2
83537,2,1,292399,292399,292400,0,1,0
83538,2,3,292401,292401,292404,0,3,1
83539,4,1,292405,292405,292406,0,1,1
83540,5,1,292410,292410,292411,0,1,4
83541,2,3,292412,292412,292415,0,3,1
83542,4,3,292416,292416,292419,0,3,1
83543,5,2,292421,292421,292423,0,2,2
83544,1,1,292422,292423,292424,1,2,0
83545,3,1,292425,292425,292426,0,1,1
83546,4,2,292429,292429,292431,0,2,3
83547,4,2,292433,292433,292435,0,2,2
83548,1,3,292434,292435,292438,1,4,0
83549,6,1,292440,292440,292441,0,1,2
83550,4,1,292444,292444,292445,0,1,3
83551,4,2,292448,292448,292450,0,2,3
83552,4,2,292452,292452,292454,0,2,2
83553,3,1,292455,292455,292456,0,1,1
83554,3,1,292458,292458,292459,0,1,2
83555,6,2,292464,292464,292466,0,2,5
83556,3,1,292467,292467,292468,0,1,1
83557,2,2,292469,292469,292471,0,2,1
83558,5,1,292474,292474,292475,0,1,3
83559,2,1,292476,292476,292477,0,1,1
83560,3,1,292479,292479,292480,0,1,2
83561,1,1,292480,292480,292481,0,1,0
83562,6,1,292486,292486,292487,0,1,5
83563,2,2,292488,292488,292490,0,2,1
83564,4,2,292492,292492,292494,0,2,2
83565,3,3,292495,292495,292498,0,3,1
83566,2,2,292497,292498,292500,1,3,0
83567,4,2,292501,292501,292503,0,2,1
83568,3,2,292504,292504,292506,0,2,1
83569,3,3,292507,292507,292510,0,3,1
83570,6,3,292513,292513,292516,0,3,3
83571,4,2,292517,292517,292519,0,2,1
83572,3,1,292520,292520,292521,0,1,1
83573,1,3,292521,292521,292524,0,3,0
83574,5,1,292526,292526,292527,0,1,2
83575,6,3,292532,292532,292535,0,3,5
83576,5,2,292537,292537,292539,0,2,2
83577,3,3,292540,292540,292543,0,3,1
83578,3,2,292543,292543,292545,0,2,0
83579,3,1,292546,292546,292547,0,1,1
83580,4,2,292550,292550,292552,0,2,3
83581,3,1,292553,292553,292554,0,1,1
83582,4,3,292557,292557,292560,0,3,3
83583,2,2,292559,292560,292562,1,3,0
83584,5,3,292564,292564,292567,0,3,2
83585,5,3,292569,292569,292572,0,3,2
83586,1,3,292570,292572,292575,2,5,0
83587,1,2,292571,292575,292577,4,6,0
83588,3,1,292574,292577,292578,3,4,0
83589,6,2,292580,292580,292582,0,2,2
83590,6,2,292586,292586,292588,0,2,4
83591,1,2,292587,292588,292590,1,3,0
83592,5,1,292592,292592,292593,0,1,2
83593,6,2,292598,292598,292600,0,2,5
83594,1,1,292599,292600,292601,1,2,0
83595,2,3,292601,292601,292604,0,3,0
83596,5,2,292606,292606,292608,0,2,2
83597,3,3,292609,292609,292612,0,3,1
83598,5,1,292614,292614,292615,0,1,2
83599,4,1,292618,292618,292619,0,1,3
83600,6,2,292624,292624,292626,0,2,5
83601,1,3,292625,292626,292629,1,4,0
83602,5,2,292630,292630,292632,0,2,1
83603,2,1,292632,292632,292633,0,1,0
83604,1,2,292633,292633,292635,0,2,0
83605,3,1,292636,292636,292637,0,1,1
83606,5,2,292641,292641,292643,0,2,4
83607,6,2,292647,292647,292649,0,2,4
83608,2,3,292649,292649,292652,0,3,0
83609,3,2,292652,292652,292654,0,2,0
83610,6,2,292658,292658,292660,0,2,4
83611,2,2,292660,292660,292662,0,2,0
83612,1,1,292661,292662,292663,1,2,0
83613,6,3,292667,292667,292670,0,3,4
83614,4,3,292671,292671,292674,0,3,1
83615,2,1,292673,292674,292675,1,2,0
83616,2,2,292675,292675,292677,0,2,0
83617,4,1,292679,292679,292680,0,1,2
83618,2,3,292681,292681,292684,0,3,1
83619,3,3,292684,292684,292687,0,3,0
83620,3,1,292687,292687,292688,0,1,0
83621,5,3,292692,292692,292695,0,3,4
83622,1,1,292693,292695,292696,2,3,0
83623,3,2,292696,292696,292698,0,2,0
83624,1,2,292697,292698,292700,1,3,0
83625,6,2,292703,292703,292705,0,2,3
83626,6,1,292709,292709,292710,0,1,4
83627,4,3,292713,292713,292716,0,3,3
83628,1,1,292714,292716,292717,2,3,0
83629,6,1,292720,292720,292721,0,1,3
83630,5,3,292725,292725,292728,0,3,4
83631,6,1,292731,292731,292732,0,1,3
83632,2,2,292733,292733,292735,0,2,1
83633,1,3,292734,292735,292738,1,4,0
83634,3,2,292737,292738,292740,1,3,0
83635,1,3,292738,292740,292743,2,5,0
83636,6,3,292744,292744,292747,0,3,1
83637,3,1,292747,292747,292748,0,1,0
83638,1,3,292748,292748,292751,0,3,0
83639,1,1,292749,292751,292752,2,3,0
83640,2,3,292751,292752,292755,1,4,0
83641,1,2,292752,292755,292757,3,5,0
83642,1,1,292753,292757,292758,4,5,0
83643,3,1,292756,292758,292759,2,3,0
83644,3,3,292759,292759,292762,0,3,0
83645,6,1,292765,292765,292766,0,1,3
83646,1,2,292766,292766,292768,0,2,0
83647,2,2,292768,292768,292770,0,2,0
83648,2,3,292770,292770,292773,0,3,0
83649,5,3,292775,292775,292778,0,3,2
83650,6,1,292781,292781,292782,0,1,3
83651,4,2,292785,292785,292787,0,2,3
83652,2,1,292787,292787,292788,0,1,0
83653,1,2,292788,292788,292790,0,2,0
83654,5,2,292793,292793,292795,0,2,3
83655,1,1,292794,292795,292796,1,2,0
83656,2,1,292796,292796,292797,0,1,0
83657,5,1,292801,292801,292802,0,1,4
83658,2,2,292803,292803,292805,0,2,1
83659,6,2,292809,292809,292811,0,2,4
83660,4,1,292813,292813,292814,0,1,2
83661,6,1,292819,292819,292820,0,1,5
83662,5,1,292824,292824,292825,0,1,4
83663,6,2,292830,292830,292832,0,2,5
83664,2,2,292832,292832,292834,0,2,0
83665,1,3,292833,292834,292837,1,4,0
83666,2,3,292835,292837,292840,2,5,0
83667,3,3,292838,292840,292843,2,5,0
83668,1,2,292839,292843,292845,4,6,0
83669,4,2,292843,292845,292847,2,4,0
83670,2,3,292845,292847,292850,2,5,0
83671,2,2,292847,292850,292852,3,5,0
83672,6,3,292853,292853,292856,0,3,1
83673,5,2,292858,292858,292860,0,2,2
83674,4,2,292862,292862,292864,0,2,2
83675,3,1,292865,292865,292866,0,1,1
83676,4,1,292869,292869,292870,0,1,3
83677,5,1,292874,292874,292875,0,1,4
83678,6,2,292880,292880,292882,0,2,5
83679,4,2,292884,292884,292886,0,2,2
83680,6,1,292890,292890,292891,0,1,4
83681,6,1,292896,292896,292897,0,1,5
83682,6,2,292902,292902,292904,0,2,5
83683,4,2,292906,292906,292908,0,2,2
83684,4,2,292910,292910,292912,0,2,2
83685,5,2,292915,292915,292917,0,2,3
83686,6,3,292921,292921,292924,0,3,4
83687,6,2,292927,292927,292929,0,2,3
83688,5,1,292932,292932,292933,0,1,3
83689,6,3,292938,292938,292941,0,3,5
83690,3,3,292941,292941,292944,0,3,0
83691,1,3,292942,292944,292947,2,5,0
83692,5,2,292947,292947,292949,0,2,0
83693,4,1,292951,292951,292952,0,1,2
83694,3,1,292954,292954,292955,0,1,2
83695,3,1,292957,292957,292958,0,1,2
83696,3,2,292960,292960,292962,0,2,2
83697,4,1,292964,292964,292965,0,1,2
83698,3,3,292967,292967,292970,0,3,2
83699,1,3,292968,292970,292973,2,5,0
83700,1,1,292969,292973,292974,4,5,0
83701,4,2,292973,292974,292976,1,3,0
83702,5,1,292978,292978,292979,0,1,2
83703,1,2,292979,292979,292981,0,2,0
83704,3,2,292982,292982,292984,0,2,1
83705,4,1,292986,292986,292987,0,1,2
83706,3,3,292989,292989,292992,0,3,2
83707,6,2,292995,292995,292997,0,2,3
83708,2,3,292997,292997,293000,0,3,0
83709,3,1,293000,293000,293001,0,1,0
83710,1,3,293001,293001,293004,0,3,0
83711,4,3,293005,293005,293008,0,3,1
83712,3,2,293008,293008,293010,0,2,0
83713,6,2,293014,293014,293016,0,2,4
83714,2,1,293016,293016,293017,0,1,0
83715,5,2,293021,293021,293023,0,2,4
83716,3,2,293024,293024,293026,0,2,1
83717,4,2,293028,293028,293030,0,2,2
83718,6,3,293034,293034,293037,0,3,4
83719,4,1,293038,293038,293039,0,1,1
83720,6,3,293044,293044,293047,0,3,5
83721,3,1,293047,293047,293048,0,1,0
83722,1,2,293048,293048,293050,0,2,0
83723,4,2,293052,293052,293054,0,2,2
83724,2,1,293054,293054,293055,0,1,0
83725,5,1,293059,293059,293060,0,1,4
83726,3,2,293062,293062,293064,0,2,2
83727,5,3,293067,293067,293070,0,3,3
83728,4,3,293071,293071,293074,0,3,1
83729,6,2,293077,293077,293079,0,2,3
83730,3,2,293080,293080,293082,0,2,1
83731,2,2,293082,293082,293084,0,2,0
83732,5,1,293087,293087,293088,0,1,3
83733,5,2,293092,293092,293094,0,2,4
83734,3,3,293095,293095,293098,0,3,1
83735,6,3,293101,293101,293104,0,3,3
83736,2,3,293103,293104,293107,1,4,0
83737,4,2,293107,293107,293109,0,2,0
83738,2,2,293109,293109,293111,0,2,0
83739,5,2,293114,293114,293116,0,2,3
83740,5,2,293119,293119,293121,0,2,3
83741,3,2,293122,293122,293124,0,2,1
83742,2,3,293124,293124,293127,0,3,0
83743,4,2,293128,293128,293130,0,2,1
83744,3,1,293131,293131,293132,0,1,1
83745,4,2,293135,293135,293137,0,2,3
83746,2,1,293137,293137,293138,0,1,0
83747,1,3,293138,293138,293141,0,3,0
83748,2,1,293140,293141,293142,1,2,0
83749,3,1,293143,293143,293144,0,1,1
83750,2,2,293145,293145,293147,0,2,1
83751,5,1,293150,293150,293151,0,1,3
83752,4,2,293154,293154,293156,0,2,3
83753,2,1,293156,293156,293157,0,1,0
83754,4,1,293160,293160,293161,0,1,3
83755,2,2,293162,293162,293164,0,2,1
83756,6,3,293168,293168,293171,0,3,4
83757,6,1,293174,293174,293175,0,1,3
83758,6,2,293180,293180,293182,0,2,5
83759,6,3,293186,293186,293189,0,3,4
83760,4,2,293190,293190,293192,0,2,1
83761,4,3,293194,293194,293197,0,3,2
83762,6,2,293200,293200,293202,0,2,3
83763,3,1,293203,293203,293204,0,1,1
83764,4,3,293207,293207,293210,0,3,3
83765,1,1,293208,293210,293211,2,3,0
83766,4,1,293212,293212,293213,0,1,1
83767,2,1,293214,293214,293215,0,1,1
83768,3,3,293217,293217,293220,0,3,2
83769,2,2,293219,293220,293222,1,3,0
83770,6,1,293225,293225,293226,0,1,3
83771,5,1,293230,293230,293231,0,1,4
83772,4,1,293234,293234,293235,0,1,3
83773,1,2,293235,293235,293237,0,2,0
83774,5,1,293240,293240,293241,0,1,3
83775,6,1,293246,293246,293247,0,1,5
83776,3,2,293249,293249,293251,0,2,2
83777,4,1,293253,293253,293254,0,1,2
83778,4,3,293257,293257,293260,0,3,3
83779,6,1,293263,293263,293264,0,1,3
83780,4,1,293267,293267,293268,0,1,3
83781,5,3,293272,293272,293275,0,3,4
83782,6,3,293278,293278,293281,0,3,3
83783,5,3,293283,293283,293286,0,3,2
83784,2,1,293285,293286,293287,1,2,0
83785,2,2,293287,293287,293289,0,2,0
83786,1,1,293288,293289,293290,1,2,0
83787,5,3,293293,293293,293296,0,3,3
83788,4,1,293297,293297,293298,0,1,1
83789,1,2,293298,293298,293300,0,2,0
83790,5,1,293303,293303,293304,0,1,3
83791,2,1,293305,293305,293306,0,1,1
83792,5,2,293310,293310,293312,0,2,4
83793,1,3,293311,293312,293315,1,4,0
83794,1,1,293312,293315,293316,3,4,0
83795,2,3,293314,293316,293319,2,5,0
83796,1,2,293315,293319,293321,4,6,0
83797,2,2,293317,293321,293323,4,6,0
83798,1,1,293318,293323,293324,5,6,0
83799,1,1,293319,293324,293325,5,6,0
83800,6,1,293325,293325,293326,0,1,0
83801,6,3,293331,293331,293334,0,3,5
83802,5,3,293336,293336,293339,0,3,2
83803,3,2,293339,293339,293341,0,2,0
83804,4,3,293343,293343,293346,0,3,2
83805,3,2,293346,293346,293348,0,2,0
83806,6,1,293352,293352,293353,0,1,4
83807,4,2,293356,293356,293358,0,2,3
83808,6,3,293362,293362,293365,0,3,4
83809,6,3,293368,293368,293371,0,3,3
83810,1,3,293369,293371,293374,2,5,0
83811,2,2,293371,293374,293376,3,5,0
83812,3,1,293374,293376,293377,2,3,0
83813,5,1,293379,293379,293380,0,1,2
83814,4,3,293383,293383,293386,0,3,3
83815,1,2,293384,293386,293388,2,4,0
83816,3,1,293387,293388,293389,1,2,0
83817,3,3,293390,293390,293393,0,3,1
83818,1,3,293391,293393,293396,2,5,0
83819,4,1,293395,293396,293397,1,2,0
83820,4,1,293399,293399,293400,0,1,2
83821,4,3,293403,293403,293406,0,3,3
83822,3,1,293406,293406,293407,0,1,0
83823,4,2,293410,293410,293412,0,2,3
83824,1,3,293411,293412,293415,1,4,0
83825,2,3,293413,293415,293418,2,5,0
83826,5,3,293418,293418,293421,0,3,0
83827,6,3,293424,293424,293427,0,3,3
83828,2,2,293426,293427,293429,1,3,0
83829,6,1,293432,293432,293433,0,1,3
83830,4,1,293436,293436,293437,0,1,3
83831,4,1,293440,293440,293441,0,1,3
83832,4,2,293444,293444,293446,0,2,3
83833,6,1,293450,293450,293451,0,1,4
83834,1,2,293451,293451,293453,0,2,0
83835,6,2,293457,293457,293459,0,2,4
83836,1,2,293458,293459,293461,1,3,0
83837,6,2,293464,293464,293466,0,2,3
83838,1,2,293465,293466,293468,1,3,0
83839,1,2,293466,293468,293470,2,4,0
83840,4,1,293470,293470,293471,0,1,0
83841,6,1,293476,293476,293477,0,1,5
83842,1,2,293477,293477,293479,0,2,0
83843,6,1,293483,293483,293484,0,1,4
83844,2,1,293485,293485,293486,0,1,1
83845,2,2,293487,293487,293489,0,2,1
83846,6,2,293493,293493,293495,0,2,4
83847,3,1,293496,293496,293497,0,1,1
83848,1,3,293497,293497,293500,0,3,0
83849,2,1,293499,293500,293501,1,2,0
83850,1,2,293500,293501,293503,1,3,0
83851,4,1,293504,293504,293505,0,1,1
83852,6,3,293510,293510,293513,0,3,5
83853,2,2,293512,293513,293515,1,3,0
83854,2,1,293514,293515,293516,1,2,0
83855,6,1,293520,293520,293521,0,1,4
83856,5,1,293525,293525,293526,0,1,4
83857,5,1,293530,293530,293531,0,1,4
83858,6,1,293536,293536,293537,0,1,5
83859,3,3,293539,293539,293542,0,3,2
83860,2,2,293541,293542,293544,1,3,0
83861,4,3,293545,293545,293548,0,3,1
83862,5,2,293550,293550,293552,0,2,2
83863,4,2,293554,293554,293556,0,2,2
83864,6,1,293560,293560,293561,0,1,4
83865,4,1,293564,293564,293565,0,1,3
83866,1,2,293565,293565,293567,0,2,0
83867,2,2,293567,293567,293569,0,2,0
83868,2,2,293569,293569,293571,0,2,0
83869,4,3,293573,293573,293576,0,3,2
83870,1,3,293574,293576,293579,2,5,0
83871,6,1,293580,293580,293581,0,1,1
83872,4,3,293584,293584,293587,0,3,3
83873,1,1,293585,293587,293588,2,3,0
83874,6,2,293591,293591,293593,0,2,3
83875,2,3,293593,293593,293596,0,3,0
83876,4,1,293597,293597,293598,0,1,1
83877,5,2,293602,293602,293604,0,2,4
83878,1,2,293603,293604,293606,1,3,0
83879,1,1,293604,293606,293607,2,3,0
83880,4,3,293608,293608,293611,0,3,1
83881,3,2,293611,293611,293613,0,2,0
83882,3,1,293614,293614,293615,0,1,1
83883,4,3,293618,293618,293621,0,3,3
83884,3,3,293621,293621,293624,0,3,0
83885,1,3,293622,293624,293627,2,5,0
83886,2,3,293624,293627,293630,3,6,0
83887,5,3,293629,293630,293633,1,4,0
83888,1,2,293630,293633,293635,3,5,0
83889,4,3,293634,293635,293638,1,4,0
83890,4,1,293638,293638,293639,0,1,0
83891,6,3,293644,293644,293647,0,3,5
83892,1,3,293645,293647,293650,2,5,0
83893,1,1,293646,293650,293651,4,5,0
83894,2,3,293648,293651,293654,3,6,0
83895,6,2,293654,293654,293656,0,2,0
83896,2,3,293656,293656,293659,0,3,0
83897,1,1,293657,293659,293660,2,3,0
83898,3,3,293660,293660,293663,0,3,0
83899,4,2,293664,293664,293666,0,2,1
83900,2,2,293666,293666,293668,0,2,0
83901,6,2,293672,293672,293674,0,2,4
83902,6,2,293678,293678,293680,0,2,4
83903,1,3,293679,293680,293683,1,4,0
83904,4,2,293683,293683,293685,0,2,0
83905,1,2,293684,293685,293687,1,3,0
83906,6,3,293690,293690,293693,0,3,3
83907,6,1,293696,293696,293697,0,1,3
83908,5,1,293701,293701,293702,0,1,4
83909,2,2,293703,293703,293705,0,2,1
83910,1,2,293704,293705,293707,1,3,0
83911,1,3,293705,293707,293710,2,5,0
83912,5,3,293710,293710,293713,0,3,0
83913,2,2,293712,293713,293715,1,3,0
83914,4,1,293716,293716,293717,0,1,1
83915,3,1,293719,293719,293720,0,1,2
83916,5,2,293724,293724,293726,0,2,4
83917,1,1,293725,293726,293727,1,2,0
83918,5,1,293730,293730,293731,0,1,3
83919,2,3,293732,293732,293735,0,3,1
83920,6,3,293738,293738,293741,0,3,3
83921,1,1,293739,293741,293742,2,3,0
83922,1,2,293740,293742,293744,2,4,0
83923,6,1,293746,293746,293747,0,1,2
83924,1,3,293747,293747,293750,0,3,0
83925,5,1,293752,293752,293753,0,1,2
83926,3,3,293755,293755,293758,0,3,2
83927,2,2,293757,293758,293760,1,3,0
83928,6,3,293763,293763,293766,0,3,3
83929,2,1,293765,293766,293767,1,2,0
83930,5,2,293770,293770,293772,0,2,3
83931,2,1,293772,293772,293773,0,1,0
83932,3,3,293775,293775,293778,0,3,2
83933,5,3,293780,293780,293783,0,3,2
83934,5,3,293785,293785,293788,0,3,2
83935,2,3,293787,293788,293791,1,4,0
83936,4,2,293791,293791,293793,0,2,0
83937,4,3,293795,293795,293798,0,3,2
83938,6,2,293801,293801,293803,0,2,3
83939,2,3,293803,293803,293806,0,3,0
83940,3,1,293806,293806,293807,0,1,0
83941,6,2,293812,293812,293814,0,2,5
83942,1,3,293813,293814,293817,1,4,0
83943,3,3,293816,293817,293820,1,4,0
83944,2,3,293818,293820,293823,2,5,0
83945,6,1,293824,293824,293825,0,1,1
83946,5,3,293829,293829,293832,0,3,4
83947,2,1,293831,293832,293833,1,2,0
83948,3,1,293834,293834,293835,0,1,1
83949,6,1,293840,293840,293841,0,1,5
83950,2,3,293842,293842,293845,0,3,1
83951,6,2,293848,293848,293850,0,2,3
83952,6,3,293854,293854,293857,0,3,4
83953,6,3,293860,293860,293863,0,3,3
83954,2,1,293862,293863,293864,1,2,0
83955,2,1,293864,293864,293865,0,1,0
83956,1,2,293865,293865,293867,0,2,0
83957,6,2,293871,293871,293873,0,2,4
83958,1,3,293872,293873,293876,1,4,0
83959,5,2,293877,293877,293879,0,2,1
83960,6,1,293883,293883,293884,0,1,4
83961,5,1,293888,293888,293889,0,1,4
83962,4,3,293892,293892,293895,0,3,3
83963,5,3,293897,293897,293900,0,3,2
83964,4,2,293901,293901,293903,0,2,1
83965,2,2,293903,293903,293905,0,2,0
83966,6,3,293909,293909,293912,0,3,4
83967,5,3,293914,293914,293917,0,3,2
83968,3,2,293917,293917,293919,0,2,0
83969,6,3,293923,293923,293926,0,3,4
83970,3,3,293926,293926,293929,0,3,0
83971,5,3,293931,293931,293934,0,3,2
83972,5,1,293936,293936,293937,0,1,2
83973,4,3,293940,293940,293943,0,3,3
83974,5,1,293945,293945,293946,0,1,2
83975,6,3,293951,293951,293954,0,3,5
83976,4,1,293955,293955,293956,0,1,1
83977,5,1,293960,293960,293961,0,1,4
83978,5,1,293965,293965,293966,0,1,4
83979,4,3,293969,293969,293972,0,3,3
83980,3,3,293972,293972,293975,0,3,0
83981,3,3,293975,293975,293978,0,3,0
83982,5,1,293980,293980,293981,0,1,2
83983,1,3,293981,293981,293984,0,3,0
83984,2,2,293983,293984,293986,1,3,0
83985,5,1,293988,293988,293989,0,1,2
83986,3,1,293991,293991,293992,0,1,2
83987,4,3,293995,293995,293998,0,3,3
83988,2,1,293997,293998,293999,1,2,0
83989,2,2,293999,293999,294001,0,2,0
83990,2,3,294001,294001,294004,0,3,0
83991,1,1,294002,294004,294005,2,3,0
83992,3,2,294005,294005,294007,0,2,0
83993,4,2,294009,294009,294011,0,2,2
83994,6,1,294015,294015,294016,0,1,4
83995,1,2,294016,294016,294018,0,2,0
83996,1,3,294017,294018,294021,1,4,0
83997,6,2,294023,294023,294025,0,2,2
83998,2,1,294025,294025,294026,0,1,0
83999,5,3,294030,294030,294033,0,3,4
84000,5,1,294035,294035,294036,0,1,2
84001,3,3,294038,294038,294041,0,3,2
84002,3,1,294041,294041,294042,0,1,0
84003,2,2,294043,294043,294045,0,2,1
84004,4,1,294047,294047,294048,0,1,2
84005,6,3,294053,294053,294056,0,3,5
84006,6,1,294059,294059,294060,0,1,3
84007,5,2,294064,294064,294066,0,2,4
84008,4,2,294068,294068,294070,0,2,2
84009,1,1,294069,294070,294071,1,2,0
84010,2,3,294071,294071,294074,0,3,0
84011,1,1,294072,294074,294075,2,3,0
84012,6,2,294078,294078,294080,0,2,3
84013,1,3,294079,294080,294083,1,4,0
84014,2,1,294081,294083,294084,2,3,0
84015,3,1,294084,294084,294085,0,1,0
84016,4,1,294088,294088,294089,0,1,3
84017,1,2,294089,294089,294091,0,2,0
84018,4,2,294093,294093,294095,0,2,2
84019,1,3,294094,294095,294098,1,4,0
84020,4,1,294098,294098,294099,0,1,0
84021,4,2,294102,294102,294104,0,2,3
84022,4,3,294106,294106,294109,0,3,2
84023,4,3,294110,294110,294113,0,3,1
84024,1,1,294111,294113,294114,2,3,0
84025,4,3,294115,294115,294118,0,3,1
84026,3,2,294118,294118,294120,0,2,0
84027,4,1,294122,294122,294123,0,1,2
84028,2,2,294124,294124,294126,0,2,1
84029,1,2,294125,294126,294128,1,3,0
84030,4,3,294129,294129,294132,0,3,1
84031,3,2,294132,294132,294134,0,2,0
84032,4,2,294136,294136,294138,0,2,2
84033,3,1,294139,294139,294140,0,1,1
84034,2,3,294141,294141,294144,0,3,1
84035,5,1,294146,294146,294147,0,1,2
84036,6,1,294152,294152,294153,0,1,5
84037,6,2,294158,294158,294160,0,2,5
84038,3,1,294161,294161,294162,0,1,1
84039,1,2,294162,294162,294164,0,2,0
84040,5,3,294167,294167,294170,0,3,3
84041,6,1,294173,294173,294174,0,1,3
84042,6,1,294179,294179,294180,0,1,5
84043,1,3,294180,294180,294183,0,3,0
84044,4,3,294184,294184,294187,0,3,1
84045,3,1,294187,294187,294188,0,1,0
84046,2,3,294189,294189,294192,0,3,1
84047,3,1,294192,294192,294193,0,1,0
84048,5,1,294197,294197,294198,0,1,4
84049,4,1,294201,294201,294202,0,1,3
84050,3,3,294204,294204,294207,0,3,2
84051,6,2,294210,294210,294212,0,2,3
84052,4,3,294214,294214,294217,0,3,2
84053,6,1,294220,294220,294221,0,1,3
84054,2,3,294222,294222,294225,0,3,1
84055,5,3,294227,294227,294230,0,3,2
84056,5,3,294232,294232,294235,0,3,2
84057,4,2,294236,294236,294238,0,2,1
84058,4,3,294240,294240,294243,0,3,2
84059,4,3,294244,294244,294247,0,3,1
84060,3,2,294247,294247,294249,0,2,0
84061,5,1,294252,294252,294253,0,1,3
84062,6,2,294258,294258,294260,0,2,5
84063,1,3,294259,294260,294263,1,4,0
84064,2,2,294261,294263,294265,2,4,0
84065,4,2,294265,294265,294267,0,2,0
84066,4,1,294269,294269,294270,0,1,2
84067,1,3,294270,294270,294273,0,3,0
84068,5,1,294275,294275,294276,0,1,2
84069,3,3,294278,294278,294281,0,3,2
84070,6,2,294284,294284,294286,0,2,3
84071,5,3,294289,294289,294292,0,3,3
84072,1,3,294290,294292,294295,2,5,0
84073,6,3,294296,294296,294299,0,3,1
84074,5,2,294301,294301,294303,0,2,2
84075,5,3,294306,294306,294309,0,3,3
84076,5,3,294311,294311,294314,0,3,2
84077,2,2,294313,294314,294316,1,3,0
84078,1,3,294314,294316,294319,2,5,0
84079,1,1,294315,294319,294320,4,5,0
84080,1,2,294316,294320,294322,4,6,0
84081,3,3,294319,294322,294325,3,6,0
84082,1,2,294320,294325,294327,5,7,0
84083,5,2,294325,294327,294329,2,4,0
84084,4,1,294329,294329,294330,0,1,0
84085,3,1,294332,294332,294333,0,1,2
84086,6,3,294338,294338,294341,0,3,5
84087,2,2,294340,294341,294343,1,3,0
84088,3,3,294343,294343,294346,0,3,0
84089,4,2,294347,294347,294349,0,2,1
84090,6,2,294353,294353,294355,0,2,4
84091,6,1,294359,294359,294360,0,1,4
84092,4,3,294363,294363,294366,0,3,3
84093,6,2,294369,294369,294371,0,2,3
84094,3,1,294372,294372,294373,0,1,1
84095,4,3,294376,294376,294379,0,3,3
84096,1,2,294377,294379,294381,2,4,0
84097,1,2,294378,294381,294383,3,5,0
84098,3,3,294381,294383,294386,2,5,0
84099,5,3,294386,294386,294389,0,3,0
84100,3,1,294389,294389,294390,0,1,0
84101,1,2,294390,294390,294392,0,2,0
84102,5,2,294395,294395,294397,0,2,3
84103,5,1,294400,294400,294401,0,1,3
84104,4,2,294404,294404,294406,0,2,3
84105,3,3,294407,294407,294410,0,3,1
84106,3,1,294410,294410,294411,0,1,0
84107,6,3,294416,294416,294419,0,3,5
84108,3,1,294419,294419,294420,0,1,0
84109,2,1,294421,294421,294422,0,1,1
84110,3,2,294424,294424,294426,0,2,2
84111,1,2,294425,294426,294428,1,3,0
84112,3,3,294428,294428,294431,0,3,0
84113,2,2,294430,294431,294433,1,3,0
84114,4,3,294434,294434,294437,0,3,1
84115,4,3,294438,294438,294441,0,3,1
84116,4,1,294442,294442,294443,0,1,1
84117,6,3,294448,294448,294451,0,3,5
84118,5,1,294453,294453,294454,0,1,2
84119,1,3,294454,294454,294457,0,3,0
84120,4,1,294458,294458,294459,0,1,1
84121,3,1,294461,294461,294462,0,1,2
84122,1,1,294462,294462,294463,0,1,0
84123,6,1,294468,294468,294469,0,1,5
84124,1,2,294469,294469,294471,0,2,0
84125,2,1,294471,294471,294472,0,1,0
84126,4,3,294475,294475,294478,0,3,3
84127,2,1,294477,294478,294479,1,2,0
84128,6,1,294483,294483,294484,0,1,4
84129,2,2,294485,294485,294487,0,2,1
84130,3,2,294488,294488,294490,0,2,1
84131,4,3,294492,294492,294495,0,3,2
84132,5,3,294497,294497,294500,0,3,2
84133,3,1,294500,294500,294501,0,1,0
84134,3,1,294503,294503,294504,0,1,2
84135,3,3,294506,294506,294509,0,3,2
84136,5,1,294511,294511,294512,0,1,2
84137,6,3,294517,294517,294520,0,3,5
84138,5,2,294522,294522,294524,0,2,2
84139,1,3,294523,294524,294527,1,4,0
84140,5,3,294528,294528,294531,0,3,1
84141,6,2,294534,294534,294536,0,2,3
84142,1,2,294535,294536,294538,1,3,0
84143,6,3,294541,294541,294544,0,3,3
84144,5,2,294546,294546,294548,0,2,2
84145,1,3,294547,294548,294551,1,4,0
84146,4,1,294551,294551,294552,0,1,0
84147,1,1,294552,294552,294553,0,1,0
84148,6,3,294558,294558,294561,0,3,5
84149,6,3,294564,294564,294567,0,3,3
84150,3,1,294567,294567,294568,0,1,0
84151,6,3,294573,294573,294576,0,3,5
84152,2,3,294575,294576,294579,1,4,0
84153,5,3,294580,294580,294583,0,3,1
84154,6,3,294586,294586,294589,0,3,3
84155,4,1,294590,294590,294591,0,1,1
84156,5,3,294595,294595,294598,0,3,4
84157,4,3,294599,294599,294602,0,3,1
84158,6,1,294605,294605,294606,0,1,3
84159,2,2,294607,294607,294609,0,2,1
84160,3,3,294610,294610,294613,0,3,1
84161,6,1,294616,294616,294617,0,1,3
84162,5,3,294621,294621,294624,0,3,4
84163,3,2,294624,294624,294626,0,2,0
84164,4,3,294628,294628,294631,0,3,2
84165,5,1,294633,294633,294634,0,1,2
84166,6,3,294639,294639,294642,0,3,5
84167,5,2,294644,294644,294646,0,2,2
84168,6,2,294650,294650,294652,0,2,4
84169,3,3,294653,294653,294656,0,3,1
84170,1,3,294654,294656,294659,2,5,0
84171,6,3,294660,294660,294663,0,3,1
84172,5,3,294665,294665,294668,0,3,2
84173,5,2,294670,294670,294672,0,2,2
84174,2,3,294672,294672,294675,0,3,0
84175,2,2,294674,294675,294677,1,3,0
84176,4,3,294678,294678,294681,0,3,1
84177,1,1,294679,294681,294682,2,3,0
84178,2,1,294681,294682,294683,1,2,0
84179,1,1,294682,294683,294684,1,2,0
84180,5,1,294687,294687,294688,0,1,3
84181,4,1,294691,294691,294692,0,1,3
84182,3,2,294694,294694,294696,0,2,2
84183,3,3,294697,294697,294700,0,3,1
84184,5,1,294702,294702,294703,0,1,2
84185,4,1,294706,294706,294707,0,1,3
84186,1,2,294707,294707,294709,0,2,0
84187,6,2,294713,294713,294715,0,2,4
84188,3,3,294716,294716,294719,0,3,1
84189,3,1,294719,294719,294720,0,1,0
84190,1,2,294720,294720,294722,0,2,0
84191,5,3,294725,294725,294728,0,3,3
84192,3,3,294728,294728,294731,0,3,0
84193,4,3,294732,294732,294735,0,3,1
84194,5,3,294737,294737,294740,0,3,2
84195,5,1,294742,294742,294743,0,1,2
84196,1,3,294743,294743,294746,0,3,0
84197,1,1,294744,294746,294747,2,3,0
84198,2,3,294746,294747,294750,1,4,0
84199,2,3,294748,294750,294753,2,5,0
84200,4,1,294752,294753,294754,1,2,0
84201,2,2,294754,294754,294756,0,2,0
84202,3,3,294757,294757,294760,0,3,1
84203,6,3,294763,294763,294766,0,3,3
84204,4,2,294767,294767,294769,0,2,1
84205,5,3,294772,294772,294775,0,3,3
84206,3,3,294775,294775,294778,0,3,0
84207,5,1,294780,294780,294781,0,1,2
84208,3,3,294783,294783,294786,0,3,2
84209,5,3,294788,294788,294791,0,3,2
84210,2,1,294790,294791,294792,1,2,0
84211,2,1,294792,294792,294793,0,1,0
84212,5,1,294797,294797,294798,0,1,4
84213,5,2,294802,294802,294804,0,2,4
84214,3,1,294805,294805,294806,0,1,1
84215,1,3,294806,294806,294809,0,3,0
84216,1,2,294807,294809,294811,2,4,0
84217,5,3,294812,294812,294815,0,3,1
84218,5,3,294817,294817,294820,0,3,2
84219,2,1,294819,294820,294821,1,2,0
84220,3,3,294822,294822,294825,0,3,1
84221,5,3,294827,294827,294830,0,3,2
84222,1,2,294828,294830,294832,2,4,0
84223,2,1,294830,294832,294833,2,3,0
84224,1,1,294831,294833,294834,2,3,0
84225,2,3,294833,294834,294837,1,4,0
84226,6,3,294839,294839,294842,0,3,2
84227,4,3,294843,294843,294846,0,3,1
84228,4,2,294847,294847,294849,0,2,1
84229,2,3,294849,294849,294852,0,3,0
84230,2,1,294851,294852,294853,1,2,0
84231,2,1,294853,294853,294854,0,1,0
84232,6,2,294859,294859,294861,0,2,5
84233,1,3,294860,294861,294864,1,4,0
84234,1,1,294861,294864,294865,3,4,0
84235,3,1,294864,294865,294866,1,2,0
84236,5,2,294869,294869,294871,0,2,3
84237,4,2,294873,294873,294875,0,2,2
84238,4,3,294877,294877,294880,0,3,2
84239,3,3,294880,294880,294883,0,3,0
84240,4,3,294884,294884,294887,0,3,1
84241,3,3,294887,294887,294890,0,3,0
84242,3,1,294890,294890,294891,0,1,0
84243,3,3,294893,294893,294896,0,3,2
84244,4,1,294897,294897,294898,0,1,1
84245,2,2,294899,294899,294901,0,2,1
84246,3,3,294902,294902,294905,0,3,1
84247,5,2,294907,294907,294909,0,2,2
84248,4,3,294911,294911,294914,0,3,2
84249,2,1,294913,294914,294915,1,2,0
84250,4,3,294917,294917,294920,0,3,2
84251,5,2,294922,294922,294924,0,2,2
84252,4,1,294926,294926,294927,0,1,2
84253,2,2,294928,294928,294930,0,2,1
84254,2,3,294930,294930,294933,0,3,0
84255,1,1,294931,294933,294934,2,3,0
84256,2,1,294933,294934,294935,1,2,0
84257,3,3,294936,294936,294939,0,3,1
84258,6,2,294942,294942,294944,0,2,3
84259,5,1,294947,294947,294948,0,1,3
84260,3,3,294950,294950,294953,0,3,2
84261,5,3,294955,294955,294958,0,3,2
84262,5,2,294960,294960,294962,0,2,2
84263,3,1,294963,294963,294964,0,1,1
84264,1,1,294964,294964,294965,0,1,0
84265,2,3,294966,294966,294969,0,3,1
84266,4,1,294970,294970,294971,0,1,1
84267,1,2,294971,294971,294973,0,2,0
84268,4,3,294975,294975,294978,0,3,2
84269,2,3,294977,294978,294981,1,4,0
84270,5,2,294982,294982,294984,0,2,1
84271,6,1,294988,294988,294989,0,1,4
84272,4,2,294992,294992,294994,0,2,3
84273,4,2,294996,294996,294998,0,2,2
84274,1,1,294997,294998,294999,1,2,0
84275,6,2,295003,295003,295005,0,2,4
84276,2,3,295005,295005,295008,0,3,0
84277,3,2,295008,295008,295010,0,2,0
84278,5,3,295013,295013,295016,0,3,3
84279,6,1,295019,295019,295020,0,1,3
84280,5,3,295024,295024,295027,0,3,4
84281,6,2,295030,295030,295032,0,2,3
84282,5,2,295035,295035,295037,0,2,3
84283,1,1,295036,295037,295038,1,2,0
84284,1,2,295037,295038,295040,1,3,0
84285,5,2,295042,295042,295044,0,2,2
84286,6,1,295048,295048,295049,0,1,4
84287,2,2,295050,295050,295052,0,2,1
84288,5,2,295055,295055,295057,0,2,3
84289,3,1,295058,295058,295059,0,1,1
84290,5,2,295063,295063,295065,0,2,4
84291,1,1,295064,295065,295066,1,2,0
84292,2,2,295066,295066,295068,0,2,0
84293,5,2,295071,295071,295073,0,2,3
84294,1,3,295072,295073,295076,1,4,0
84295,2,2,295074,295076,295078,2,4,0
84296,5,3,295079,295079,295082,0,3,1
84297,1,3,295080,295082,295085,2,5,0
84298,5,3,295085,295085,295088,0,3,0
84299,1,3,295086,295088,295091,2,5,0
84300,2,2,295088,295091,295093,3,5,0
84301,3,3,295091,295093,295096,2,5,0
84302,4,2,295095,295096,295098,1,3,0
84303,2,2,295097,295098,295100,1,3,0
84304,1,1,295098,295100,295101,2,3,0
84305,4,2,295102,295102,295104,0,2,1
84306,1,3,295103,295104,295107,1,4,0
84307,5,1,295108,295108,295109,0,1,1
84308,1,1,295109,295109,295110,0,1,0
84309,4,3,295113,295113,295116,0,3,3
84310,1,2,295114,295116,295118,2,4,0
84311,1,2,295115,295118,295120,3,5,0
84312,1,3,295116,295120,295123,4,7,0
84313,5,1,295121,295123,295124,2,3,0
84314,4,3,295125,295125,295128,0,3,1
84315,3,2,295128,295128,295130,0,2,0
84316,2,2,295130,295130,295132,0,2,0
84317,2,3,295132,295132,295135,0,3,0
84318,3,2,295135,295135,295137,0,2,0
84319,5,2,295140,295140,295142,0,2,3
84320,5,2,295145,295145,295147,0,2,3
84321,5,3,295150,295150,295153,0,3,3
84322,6,3,295156,295156,295159,0,3,3
84323,3,1,295159,295159,295160,0,1,0
84324,5,1,295164,295164,295165,0,1,4
84325,1,1,295165,295165,295166,0,1,0
84326,2,3,295167,295167,295170,0,3,1
84327,5,1,295172,295172,295173,0,1,2
84328,2,1,295174,295174,295175,0,1,1
84329,6,3,295180,295180,295183,0,3,5
84330,6,1,295186,295186,295187,0,1,3
84331,4,3,295190,295190,295193,0,3,3
84332,3,2,295193,295193,295195,0,2,0
84333,5,2,295198,295198,295200,0,2,3
84334,4,2,295202,295202,295204,0,2,2
84335,4,3,295206,295206,295209,0,3,2
84336,3,1,295209,295209,295210,0,1,0
84337,6,2,295215,295215,295217,0,2,5
84338,2,2,295217,295217,295219,0,2,0
84339,2,1,295219,295219,295220,0,1,0
84340,4,2,295223,295223,295225,0,2,3
84341,5,3,295228,295228,295231,0,3,3
84342,6,1,295234,295234,295235,0,1,3
84343,3,1,295237,295237,295238,0,1,2
84344,4,3,295241,295241,295244,0,3,3
84345,1,3,295242,295244,295247,2,5,0
84346,4,1,295246,295247,295248,1,2,0
84347,3,1,295249,295249,295250,0,1,1
84348,5,3,295254,295254,295257,0,3,4
84349,4,1,295258,295258,295259,0,1,1
84350,2,3,295260,295260,295263,0,3,1
84351,5,3,295265,295265,295268,0,3,2
84352,1,3,295266,295268,295271,2,5,0
84353,5,3,295271,295271,295274,0,3,0
84354,2,1,295273,295274,295275,1,2,0
84355,5,1,295278,295278,295279,0,1,3
84356,5,2,295283,295283,295285,0,2,4
84357,4,1,295287,295287,295288,0,1,2
84358,2,1,295289,295289,295290,0,1,1
84359,2,1,295291,295291,295292,0,1,1
84360,4,3,295295,295295,295298,0,3,3
84361,6,1,295301,295301,295302,0,1,3
84362,5,1,295306,295306,295307,0,1,4
84363,5,1,295311,295311,295312,0,1,4
84364,5,3,295316,295316,295319,0,3,4
84365,1,1,295317,295319,295320,2,3,0
84366,5,1,295322,295322,295323,0,1,2
84367,3,1,295325,295325,295326,0,1,2
84368,3,2,295328,295328,295330,0,2,2
84369,6,1,295334,295334,295335,0,1,4
84370,4,3,295338,295338,295341,0,3,3
84371,4,3,295342,295342,295345,0,3,1
84372,4,2,295346,295346,295348,0,2,1
84373,3,1,295349,295349,295350,0,1,1
84374,2,3,295351,295351,295354,0,3,1
84375,6,2,295357,295357,295359,0,2,3
84376,1,3,295358,295359,295362,1,4,0
84377,5,1,295363,295363,295364,0,1,1
84378,3,2,295366,295366,295368,0,2,2
84379,1,1,295367,295368,295369,1,2,0
84380,5,2,295372,295372,295374,0,2,3
84381,5,2,295377,295377,295379,0,2,3
84382,1,2,295378,295379,295381,1,3,0
84383,4,3,295382,295382,295385,0,3,1
84384,5,1,295387,295387,295388,0,1,2
84385,4,2,295391,295391,295393,0,2,3
84386,1,1,295392,295393,295394,1,2,0
84387,2,1,295394,295394,295395,0,1,0
84388,2,1,295396,295396,295397,0,1,1
84389,5,3,295401,295401,295404,0,3,4
84390,6,1,295407,295407,295408,0,1,3
84391,4,1,295411,295411,295412,0,1,3
84392,5,3,295416,295416,295419,0,3,4
84393,1,2,295417,295419,295421,2,4,0
84394,3,2,295420,295421,295423,1,3,0
84395,6,2,295426,295426,295428,0,2,3
84396,3,2,295429,295429,295431,0,2,1
84397,4,2,295433,295433,295435,0,2,2
84398,1,2,295434,295435,295437,1,3,0
84399,4,3,295438,295438,295441,0,3,1
84400,3,1,295441,295441,295442,0,1,0
84401,2,2,295443,295443,295445,0,2,1
84402,5,1,295448,295448,295449,0,1,3
84403,1,1,295449,295449,295450,0,1,0
84404,1,1,295450,295450,295451,0,1,0
84405,3,1,295453,295453,295454,0,1,2
84406,5,1,295458,295458,295459,0,1,4
84407,5,2,295463,295463,295465,0,2,4
84408,6,3,295469,295469,295472,0,3,4
84409,5,2,295474,295474,295476,0,2,2
84410,5,3,295479,295479,295482,0,3,3
84411,5,1,295484,295484,295485,0,1,2
84412,1,1,295485,295485,295486,0,1,0
84413,2,1,295487,295487,295488,0,1,1
84414,2,1,295489,295489,295490,0,1,1
84415,3,1,295492,295492,295493,0,1,2
84416,4,2,295496,295496,295498,0,2,3
84417,1,3,295497,295498,295501,1,4,0
84418,6,2,295503,295503,295505,0,2,2
84419,4,2,295507,295507,295509,0,2,2
84420,3,3,295510,295510,295513,0,3,1
84421,2,3,295512,295513,295516,1,4,0
84422,3,3,295515,295516,295519,1,4,0
84423,1,3,295516,295519,295522,3,6,0
84424,4,2,295520,295522,295524,2,4,0
84425,6,2,295526,295526,295528,0,2,2
84426,5,1,295531,295531,295532,0,1,3
84427,2,2,295533,295533,295535,0,2,1
84428,5,3,295538,295538,295541,0,3,3
84429,1,1,295539,295541,295542,2,3,0
84430,1,3,295540,295542,295545,2,5,0
84431,2,3,295542,295545,295548,3,6,0
84432,3,3,295545,295548,295551,3,6,0
84433,3,3,295548,295551,295554,3,6,0
84434,4,1,295552,295554,295555,2,3,0
84435,3,2,295555,295555,295557,0,2,0
84436,5,1,295560,295560,295561,0,1,3
84437,5,2,295565,295565,295567,0,2,4
84438,5,3,295570,295570,295573,0,3,3
84439,3,2,295573,295573,295575,0,2,0
84440,5,1,295578,295578,295579,0,1,3
84441,6,3,295584,295584,295587,0,3,5
84442,2,2,295586,295587,295589,1,3,0
84443,1,3,295587,295589,295592,2,5,0
84444,4,3,295591,295592,295595,1,4,0
84445,2,1,295593,295595,295596,2,3,0
84446,3,3,295596,295596,295599,0,3,0
84447,2,2,295598,295599,295601,1,3,0
84448,5,1,295603,295603,295604,0,1,2
84449,6,1,295609,295609,295610,0,1,5
84450,5,3,295614,295614,295617,0,3,4
84451,5,2,295619,295619,295621,0,2,2
84452,4,2,295623,295623,295625,0,2,2
84453,1,3,295624,295625,295628,1,4,0
84454,5,2,295629,295629,295631,0,2,1
84455,2,2,295631,295631,295633,0,2,0
84456,5,3,295636,295636,295639,0,3,3
84457,2,1,295638,295639,295640,1,2,0
84458,4,3,295642,295642,295645,0,3,2
84459,5,2,295647,295647,295649,0,2,2
84460,4,1,295651,295651,295652,0,1,2
84461,4,2,295655,295655,295657,0,2,3
84462,2,2,295657,295657,295659,0,2,0
84463,5,1,295662,295662,295663,0,1,3
84464,4,1,295666,295666,295667,0,1,3
84465,5,2,295671,295671,295673,0,2,4
84466,2,2,295673,295673,295675,0,2,0
84467,6,2,295679,295679,295681,0,2,4
84468,2,2,295681,295681,295683,0,2,0
84469,2,2,295683,295683,295685,0,2,0
84470,4,3,295687,295687,295690,0,3,2
84471,1,3,295688,295690,295693,2,5,0
84472,3,2,295691,295693,295695,2,4,0
84473,1,3,295692,295695,295698,3,6,0
84474,2,2,295694,295698,295700,4,6,0
84475,2,2,295696,295700,295702,4,6,0
84476,3,3,295699,295702,295705,3,6,0
84477,2,2,295701,295705,295707,4,6,0
84478,5,1,295706,295707,295708,1,2,0
84479,6,2,295712,295712,295714,0,2,4
84480,3,3,295715,295715,295718,0,3,1
84481,5,1,295720,295720,295721,0,1,2
84482,3,2,295723,295723,295725,0,2,2
84483,5,2,295728,295728,295730,0,2,3
84484,3,2,295731,295731,295733,0,2,1
84485,1,3,295732,295733,295736,1,4,0
84486,6,1,295738,295738,295739,0,1,2
84487,4,2,295742,295742,295744,0,2,3
84488,4,3,295746,295746,295749,0,3,2
84489,4,1,295750,295750,295751,0,1,1
84490,6,2,295756,295756,295758,0,2,5
84491,6,3,295762,295762,295765,0,3,4
84492,3,3,295765,295765,295768,0,3,0
84493,6,3,295771,295771,295774,0,3,3
84494,2,1,295773,295774,295775,1,2,0
84495,5,1,295778,295778,295779,0,1,3
84496,1,1,295779,295779,295780,0,1,0
84497,1,2,295780,295780,295782,0,2,0
84498,4,1,295784,295784,295785,0,1,2
84499,1,3,295785,295785,295788,0,3,0
84500,2,1,295787,295788,295789,1,2,0
84501,5,2,295792,295792,295794,0,2,3
84502,1,2,295793,295794,295796,1,3,0
84503,1,1,295794,295796,295797,2,3,0
84504,1,1,295795,295797,295798,2,3,0
84505,6,3,295801,295801,295804,0,3,3
84506,2,3,295803,295804,295807,1,4,0
84507,6,1,295809,295809,295810,0,1,2
84508,6,1,295815,295815,295816,0,1,5
84509,5,1,295820,295820,295821,0,1,4
84510,6,3,295826,295826,295829,0,3,5
84511,1,1,295827,295829,295830,2,3,0
84512,6,3,295833,295833,295836,0,3,3
84513,1,1,295834,295836,295837,2,3,0
84514,5,1,295839,295839,295840,0,1,2
84515,5,3,295844,295844,295847,0,3,4
84516,6,2,295850,295850,295852,0,2,3
84517,6,1,295856,295856,295857,0,1,4
84518,1,2,295857,295857,295859,0,2,0
84519,2,1,295859,295859,295860,0,1,0
84520,3,2,295862,295862,295864,0,2,2
84521,2,3,295864,295864,295867,0,3,0
84522,4,1,295868,295868,295869,0,1,1
84523,6,2,295874,295874,295876,0,2,5
84524,4,1,295878,295878,295879,0,1,2
84525,6,3,295884,295884,295887,0,3,5
84526,3,1,295887,295887,295888,0,1,0
84527,1,3,295888,295888,295891,0,3,0
84528,5,3,295893,295893,295896,0,3,2
84529,6,1,295899,295899,295900,0,1,3
84530,5,3,295904,295904,295907,0,3,4
84531,6,2,295910,295910,295912,0,2,3
84532,3,2,295913,295913,295915,0,2,1
84533,6,2,295919,295919,295921,0,2,4
84534,5,3,295924,295924,295927,0,3,3
84535,4,3,295928,295928,295931,0,3,1
84536,2,2,295930,295931,295933,1,3,0
84537,6,2,295936,295936,295938,0,2,3
84538,1,1,295937,295938,295939,1,2,0
84539,6,3,295943,295943,295946,0,3,4
84540,1,1,295944,295946,295947,2,3,0
84541,1,1,295945,295947,295948,2,3,0
84542,2,1,295947,295948,295949,1,2,0
84543,2,1,295949,295949,295950,0,1,0
84544,4,3,295953,295953,295956,0,3,3
84545,2,1,295955,295956,295957,1,2,0
84546,6,3,295961,295961,295964,0,3,4
84547,6,1,295967,295967,295968,0,1,3
84548,1,2,295968,295968,295970,0,2,0
84549,1,2,295969,295970,295972,1,3,0
84550,2,1,295971,295972,295973,1,2,0
84551,1,2,295972,295973,295975,1,3,0
84552,6,3,295978,295978,295981,0,3,3
84553,1,1,295979,295981,295982,2,3,0
84554,4,2,295983,295983,295985,0,2,1
84555,2,1,295985,295985,295986,0,1,0
84556,2,3,295987,295987,295990,0,3,1
84557,2,3,295989,295990,295993,1,4,0
84558,4,2,295993,295993,295995,0,2,0
84559,5,1,295998,295998,295999,0,1,3
84560,3,3,296001,296001,296004,0,3,2
84561,2,3,296003,296004,296007,1,4,0
84562,3,1,296006,296007,296008,1,2,0
84563,4,3,296010,296010,296013,0,3,2
84564,4,1,296014,296014,296015,0,1,1
84565,2,2,296016,296016,296018,0,2,1
84566,3,1,296019,296019,296020,0,1,1
84567,5,1,296024,296024,296025,0,1,4
84568,6,2,296030,296030,296032,0,2,5
84569,3,1,296033,296033,296034,0,1,1
84570,3,1,296036,296036,296037,0,1,2
84571,2,2,296038,296038,296040,0,2,1
84572,3,2,296041,296041,296043,0,2,1
84573,2,1,296043,296043,296044,0,1,0
84574,3,2,296046,296046,296048,0,2,2
84575,4,2,296050,296050,296052,0,2,2
84576,3,1,296053,296053,296054,0,1,1
84577,3,1,296056,296056,296057,0,1,2
84578,5,1,296061,296061,296062,0,1,4
84579,5,3,296066,296066,296069,0,3,4
84580,3,1,296069,296069,296070,0,1,0
84581,6,3,296075,296075,296078,0,3,5
84582,5,2,296080,296080,296082,0,2,2
84583,2,1,296082,296082,296083,0,1,0
84584,4,2,296086,296086,296088,0,2,3
84585,3,3,296089,296089,296092,0,3,1
84586,2,2,296091,296092,296094,1,3,0
84587,6,2,296097,296097,296099,0,2,3
84588,1,3,296098,296099,296102,1,4,0
84589,2,3,296100,296102,296105,2,5,0
84590,3,1,296103,296105,296106,2,3,0
84591,5,1,296108,296108,296109,0,1,2
84592,6,2,296114,296114,296116,0,2,5
84593,2,3,296116,296116,296119,0,3,0
84594,2,1,296118,296119,296120,1,2,0
84595,4,2,296122,296122,296124,0,2,2
84596,3,3,296125,296125,296128,0,3,1
84597,3,3,296128,296128,296131,0,3,0
84598,2,1,296130,296131,296132,1,2,0
84599,2,3,296132,296132,296135,0,3,0
84600,2,3,296134,296135,296138,1,4,0
84601,3,3,296137,296138,296141,1,4,0
84602,4,1,296141,296141,296142,0,1,0
84603,6,2,296147,296147,296149,0,2,5
84604,1,2,296148,296149,296151,1,3,0
84605,6,2,296154,296154,296156,0,2,3
84606,5,2,296159,296159,296161,0,2,3
84607,2,1,296161,296161,296162,0,1,0
84608,4,3,296165,296165,296168,0,3,3
84609,5,2,296170,296170,296172,0,2,2
84610,4,3,296174,296174,296177,0,3,2
84611,3,2,296177,296177,296179,0,2,0
84612,3,1,296180,296180,296181,0,1,1
84613,5,3,296185,296185,296188,0,3,4
84614,3,2,296188,296188,296190,0,2,0
84615,5,3,296193,296193,296196,0,3,3
84616,3,1,296196,296196,296197,0,1,0
84617,1,2,296197,296197,296199,0,2,0
84618,5,3,296202,296202,296205,0,3,3
84619,2,1,296204,296205,296206,1,2,0
84620,5,3,296209,296209,296212,0,3,3
84621,2,2,296211,296212,296214,1,3,0
84622,2,1,296213,296214,296215,1,2,0
84623,4,3,296217,296217,296220,0,3,2
84624,2,2,296219,296220,296222,1,3,0
84625,5,3,296224,296224,296227,0,3,2
84626,5,2,296229,296229,296231,0,2,2
84627,1,2,296230,296231,296233,1,3,0
84628,1,3,296231,296233,296236,2,5,0
84629,6,3,296237,296237,296240,0,3,1
84630,6,3,296243,296243,296246,0,3,3
84631,1,3,296244,296246,296249,2,5,0
84632,3,2,296247,296249,296251,2,4,0
84633,3,1,296250,296251,296252,1,2,0
84634,4,3,296254,296254,296257,0,3,2
84635,2,1,296256,296257,296258,1,2,0
84636,1,2,296257,296258,296260,1,3,0
84637,2,2,296259,296260,296262,1,3,0
84638,3,2,296262,296262,296264,0,2,0
84639,3,1,296265,296265,296266,0,1,1
84640,5,1,296270,296270,296271,0,1,4
84641,1,2,296271,296271,296273,0,2,0
84642,5,3,296276,296276,296279,0,3,3
84643,1,3,296277,296279,296282,2,5,0
84644,4,2,296281,296282,296284,1,3,0
84645,2,1,296283,296284,296285,1,2,0
84646,3,2,296286,296286,296288,0,2,1
84647,1,1,296287,296288,296289,1,2,0
84648,6,3,296293,296293,296296,0,3,4
84649,2,1,296295,296296,296297,1,2,0
84650,6,1,296301,296301,296302,0,1,4
84651,2,2,296303,296303,296305,0,2,1
84652,1,1,296304,296305,296306,1,2,0
84653,2,3,296306,296306,296309,0,3,0
84654,5,3,296311,296311,296314,0,3,2
84655,5,3,296316,296316,296319,0,3,2
84656,2,1,296318,296319,296320,1,2,0
84657,4,2,296322,296322,296324,0,2,2
84658,6,3,296328,296328,296331,0,3,4
84659,2,2,296330,296331,296333,1,3,0
84660,2,3,296332,296333,296336,1,4,0
84661,1,2,296333,296336,296338,3,5,0
84662,3,1,296336,296338,296339,2,3,0
84663,4,1,296340,296340,296341,0,1,1
84664,4,2,296344,296344,296346,0,2,3
84665,6,2,296350,296350,296352,0,2,4
84666,4,2,296354,296354,296356,0,2,2
84667,5,3,296359,296359,296362,0,3,3
84668,2,1,296361,296362,296363,1,2,0
84669,6,3,296367,296367,296370,0,3,4
84670,6,1,296373,296373,296374,0,1,3
84671,1,3,296374,296374,296377,0,3,0
84672,2,2,296376,296377,296379,1,3,0
84673,2,3,296378,296379,296382,1,4,0
84674,2,3,296380,296382,296385,2,5,0
84675,6,2,296386,296386,296388,0,2,1
84676,4,2,296390,296390,296392,0,2,2
84677,5,1,296395,296395,296396,0,1,3
84678,1,3,296396,296396,296399,0,3,0
84679,2,1,296398,296399,296400,1,2,0
84680,3,2,296401,296401,296403,0,2,1
84681,1,1,296402,296403,296404,1,2,0
84682,3,3,296405,296405,296408,0,3,1
84683,6,1,296411,296411,296412,0,1,3
84684,4,2,296415,296415,296417,0,2,3
84685,1,3,296416,296417,296420,1,4,0
84686,4,3,296420,296420,296423,0,3,0
84687,6,1,296426,296426,296427,0,1,3
84688,3,1,296429,296429,296430,0,1,2
84689,3,3,296432,296432,296435,0,3,2
84690,6,2,296438,296438,296440,0,2,3
84691,1,1,296439,296440,296441,1,2,0
84692,2,1,296441,296441,296442,0,1,0
84693,6,3,296447,296447,296450,0,3,5
84694,6,1,296453,296453,296454,0,1,3
84695,3,3,296456,296456,296459,0,3,2
84696,3,1,296459,296459,296460,0,1,0
84697,3,1,296462,296462,296463,0,1,2
84698,5,1,296467,296467,296468,0,1,4
84699,2,2,296469,296469,296471,0,2,1
84700,2,1,296471,296471,296472,0,1,0
84701,6,1,296477,296477,296478,0,1,5
84702,1,3,296478,296478,296481,0,3,0
84703,5,1,296483,296483,296484,0,1,2
84704,6,2,296489,296489,296491,0,2,5
84705,2,2,296491,296491,296493,0,2,0
84706,6,2,296497,296497,296499,0,2,4
84707,6,3,296503,296503,296506,0,3,4
84708,5,3,296508,296508,296511,0,3,2
84709,4,1,296512,296512,296513,0,1,1
84710,1,1,296513,296513,296514,0,1,0
84711,3,1,296516,296516,296517,0,1,2
84712,5,1,296521,296521,296522,0,1,4
84713,4,2,296525,296525,296527,0,2,3
84714,5,3,296530,296530,296533,0,3,3
84715,4,2,296534,296534,296536,0,2,1
84716,2,3,296536,296536,296539,0,3,0
84717,5,2,296541,296541,296543,0,2,2
84718,5,2,296546,296546,296548,0,2,3
84719,6,3,296552,296552,296555,0,3,4
84720,1,1,296553,296555,296556,2,3,0
84721,1,2,296554,296556,296558,2,4,0
84722,6,2,296560,296560,296562,0,2,2
84723,4,3,296564,296564,296567,0,3,2
84724,2,3,296566,296567,296570,1,4,0
84725,6,2,296572,296572,296574,0,2,2
84726,5,1,296577,296577,296578,0,1,3
84727,6,3,296583,296583,296586,0,3,5
84728,2,2,296585,296586,296588,1,3,0
84729,5,2,296590,296590,296592,0,2,2
84730,6,2,296596,296596,296598,0,2,4
84731,2,1,296598,296598,296599,0,1,0
84732,3,3,296601,296601,296604,0,3,2
84733,1,3,296602,296604,296607,2,5,0
84734,2,3,296604,296607,296610,3,6,0
84735,6,3,296610,296610,296613,0,3,0
84736,2,1,296612,296613,296614,1,2,0
84737,3,2,296615,296615,296617,0,2,1
84738,4,1,296619,296619,296620,0,1,2
84739,2,1,296621,296621,296622,0,1,1
84740,3,1,296624,296624,296625,0,1,2
84741,5,1,296629,296629,296630,0,1,4
84742,2,3,296631,296631,296634,0,3,1
84743,5,2,296636,296636,296638,0,2,2
84744,2,2,296638,296638,296640,0,2,0
84745,5,3,296643,296643,296646,0,3,3
84746,1,3,296644,296646,296649,2,5,0
84747,4,1,296648,296649,296650,1,2,0
84748,6,3,296654,296654,296657,0,3,4
84749,3,1,296657,296657,296658,0,1,0
84750,1,1,296658,296658,296659,0,1,0
84751,5,3,296663,296663,296666,0,3,4
84752,5,2,296668,296668,296670,0,2,2
84753,2,1,296670,296670,296671,0,1,0
84754,6,3,296676,296676,296679,0,3,5
84755,4,3,296680,296680,296683,0,3,1
84756,4,1,296684,296684,296685,0,1,1
84757,2,2,296686,296686,296688,0,2,1
84758,5,1,296691,296691,296692,0,1,3
84759,2,3,296693,296693,296696,0,3,1
84760,6,3,296699,296699,296702,0,3,3
84761,4,1,296703,296703,296704,0,1,1
84762,2,1,296705,296705,296706,0,1,1
84763,1,2,296706,296706,296708,0,2,0
84764,6,2,296712,296712,296714,0,2,4
84765,6,3,296718,296718,296721,0,3,4
84766,6,1,296724,296724,296725,0,1,3
84767,5,2,296729,296729,296731,0,2,4
84768,2,1,296731,296731,296732,0,1,0
84769,2,1,296733,296733,296734,0,1,1
84770,1,2,296734,296734,296736,0,2,0
84771,1,1,296735,296736,296737,1,2,0
84772,2,3,296737,296737,296740,0,3,0
84773,2,2,296739,296740,296742,1,3,0
84774,5,1,296744,296744,296745,0,1,2
84775,3,2,296747,296747,296749,0,2,2
84776,3,1,296750,296750,296751,0,1,1
84777,6,3,296756,296756,296759,0,3,5
84778,5,2,296761,296761,296763,0,2,2
84779,3,3,296764,296764,296767,0,3,1
84780,1,3,296765,296767,296770,2,5,0
84781,6,1,296771,296771,296772,0,1,1
84782,6,1,296777,296777,296778,0,1,5
84783,6,2,296783,296783,296785,0,2,5
84784,2,3,296785,296785,296788,0,3,0
84785,2,2,296787,296788,296790,1,3,0
84786,2,2,296789,296790,296792,1,3,0
84787,4,1,296793,296793,296794,0,1,1
84788,3,2,296796,296796,296798,0,2,2
84789,4,3,296800,296800,296803,0,3,2
84790,1,1,296801,296803,296804,2,3,0
84791,2,1,296803,296804,296805,1,2,0
84792,4,2,296807,296807,296809,0,2,2
84793,3,3,296810,296810,296813,0,3,1
84794,5,1,296815,296815,296816,0,1,2
84795,3,3,296818,296818,296821,0,3,2
84796,6,2,296824,296824,296826,0,2,3
84797,5,1,296829,296829,296830,0,1,3
84798,5,3,296834,296834,296837,0,3,4
84799,5,1,296839,296839,296840,0,1,2
84800,6,3,296845,296845,296848,0,3,5
84801,6,3,296851,296851,296854,0,3,3
84802,4,3,296855,296855,296858,0,3,1
84803,1,1,296856,296858,296859,2,3,0
84804,3,1,296859,296859,296860,0,1,0
84805,2,2,296861,296861,296863,0,2,1
84806,1,2,296862,296863,296865,1,3,0
84807,5,2,296867,296867,296869,0,2,2
84808,4,2,296871,296871,296873,0,2,2
84809,2,2,296873,296873,296875,0,2,0
84810,2,1,296875,296875,296876,0,1,0
84811,6,3,296881,296881,296884,0,3,5
84812,1,2,296882,296884,296886,2,4,0
84813,6,1,296888,296888,296889,0,1,2
84814,6,1,296894,296894,296895,0,1,5
84815,3,2,296897,296897,296899,0,2,2
84816,6,1,296903,296903,296904,0,1,4
84817,6,2,296909,296909,296911,0,2,5
84818,4,2,296913,296913,296915,0,2,2
84819,5,2,296918,296918,296920,0,2,3
84820,3,3,296921,296921,296924,0,3,1
84821,4,1,296925,296925,296926,0,1,1
84822,4,2,296929,296929,296931,0,2,3
84823,4,2,296933,296933,296935,0,2,2
84824,4,2,296937,296937,296939,0,2,2
84825,6,3,296943,296943,296946,0,3,4
84826,1,2,296944,296946,296948,2,4,0
84827,5,1,296949,296949,296950,0,1,1
84828,4,3,296953,296953,296956,0,3,3
84829,3,2,296956,296956,296958,0,2,0
84830,4,2,296960,296960,296962,0,2,2
84831,5,2,296965,296965,296967,0,2,3
84832,6,3,296971,296971,296974,0,3,4
84833,6,1,296977,296977,296978,0,1,3
84834,5,2,296982,296982,296984,0,2,4
84835,2,3,296984,296984,296987,0,3,0
84836,4,1,296988,296988,296989,0,1,1
84837,3,1,296991,296991,296992,0,1,2
84838,1,1,296992,296992,296993,0,1,0
84839,3,2,296995,296995,296997,0,2,2
84840,6,3,297001,297001,297004,0,3,4
84841,1,2,297002,297004,297006,2,4,0
84842,5,2,297007,297007,297009,0,2,1
84843,2,1,297009,297009,297010,0,1,0
84844,4,3,297013,297013,297016,0,3,3
84845,5,1,297018,297018,297019,0,1,2
84846,6,2,297024,297024,297026,0,2,5
84847,5,3,297029,297029,297032,0,3,3
84848,4,3,297033,297033,297036,0,3,1
84849,3,2,297036,297036,297038,0,2,0
84850,2,2,297038,297038,297040,0,2,0
84851,6,3,297044,297044,297047,0,3,4
84852,6,2,297050,297050,297052,0,2,3
84853,1,1,297051,297052,297053,1,2,0
84854,4,1,297055,297055,297056,0,1,2
84855,1,1,297056,297056,297057,0,1,0
84856,4,2,297060,297060,297062,0,2,3
84857,4,1,297064,297064,297065,0,1,2
84858,3,3,297067,297067,297070,0,3,2
84859,3,3,297070,297070,297073,0,3,0
84860,4,1,297074,297074,297075,0,1,1
84861,3,2,297077,297077,297079,0,2,2
84862,5,3,297082,297082,297085,0,3,3
84863,3,3,297085,297085,297088,0,3,0
84864,2,2,297087,297088,297090,1,3,0
84865,3,2,297090,297090,297092,0,2,0
84866,2,2,297092,297092,297094,0,2,0
84867,2,2,297094,297094,297096,0,2,0
84868,1,2,297095,297096,297098,1,3,0
84869,2,1,297097,297098,297099,1,2,0
84870,6,1,297103,297103,297104,0,1,4
84871,3,3,297106,297106,297109,0,3,2
84872,3,3,297109,297109,297112,0,3,0
84873,5,2,297114,297114,297116,0,2,2
84874,6,2,297120,297120,297122,0,2,4
84875,3,2,297123,297123,297125,0,2,1
84876,3,2,297126,297126,297128,0,2,1
84877,3,1,297129,297129,297130,0,1,1
84878,5,2,297134,297134,297136,0,2,4
84879,1,1,297135,297136,297137,1,2,0
84880,1,1,297136,297137,297138,1,2,0
84881,5,2,297141,297141,297143,0,2,3
84882,3,1,297144,297144,297145,0,1,1
84883,3,3,297147,297147,297150,0,3,2
84884,1,2,297148,297150,297152,2,4,0
84885,4,3,297152,297152,297155,0,3,0
84886,1,2,297153,297155,297157,2,4,0
84887,4,1,297157,297157,297158,0,1,0
84888,1,2,297158,297158,297160,0,2,0
84889,3,3,297161,297161,297164,0,3,1
84890,6,3,297167,297167,297170,0,3,3
84891,2,2,297169,297170,297172,1,3,0
84892,4,3,297173,297173,297176,0,3,1
84893,3,1,297176,297176,297177,0,1,0
84894,2,1,297178,297178,297179,0,1,1
84895,3,1,297181,297181,297182,0,1,2
84896,1,3,297182,297182,297185,0,3,0
84897,3,1,297185,297185,297186,0,1,0
84898,1,2,297186,297186,297188,0,2,0
84899,4,1,297190,297190,297191,0,1,2
84900,5,1,297195,297195,297196,0,1,4
84901,2,2,297197,297197,297199,0,2,1
84902,2,2,297199,297199,297201,0,2,0
84903,5,3,297204,297204,297207,0,3,3
84904,2,2,297206,297207,297209,1,3,0
84905,2,3,297208,297209,297212,1,4,0
84906,5,1,297213,297213,297214,0,1,1
84907,4,3,297217,297217,297220,0,3,3
84908,5,3,297222,297222,297225,0,3,2
84909,1,1,297223,297225,297226,2,3,0
84910,4,2,297227,297227,297229,0,2,1
84911,2,1,297229,297229,297230,0,1,0
84912,4,2,297233,297233,297235,0,2,3
84913,3,2,297236,297236,297238,0,2,1
84914,1,2,297237,297238,297240,1,3,0
84915,5,2,297242,297242,297244,0,2,2
84916,6,2,297248,297248,297250,0,2,4
84917,4,1,297252,297252,297253,0,1,2
84918,2,1,297254,297254,297255,0,1,1
84919,1,1,297255,297255,297256,0,1,0
84920,4,1,297259,297259,297260,0,1,3
84921,2,2,297261,297261,297263,0,2,1
84922,1,3,297262,297263,297266,1,4,0
84923,2,3,297264,297266,297269,2,5,0
84924,2,2,297266,297269,297271,3,5,0
84925,6,1,297272,297272,297273,0,1,1
84926,6,2,297278,297278,297280,0,2,5
84927,6,3,297284,297284,297287,0,3,4
84928,6,2,297290,297290,297292,0,2,3
84929,5,2,297295,297295,297297,0,2,3
84930,4,3,297299,297299,297302,0,3,2
84931,6,2,297305,297305,297307,0,2,3
84932,5,1,297310,297310,297311,0,1,3
84933,2,1,297312,297312,297313,0,1,1
84934,6,3,297318,297318,297321,0,3,5
84935,3,3,297321,297321,297324,0,3,0
84936,1,2,297322,297324,297326,2,4,0
84937,2,3,297324,297326,297329,2,5,0
84938,4,1,297328,297329,297330,1,2,0
84939,5,2,297333,297333,297335,0,2,3
84940,5,2,297338,297338,297340,0,2,3
84941,6,3,297344,297344,297347,0,3,4
84942,3,1,297347,297347,297348,0,1,0
84943,2,1,297349,297349,297350,0,1,1
84944,4,1,297353,297353,297354,0,1,3
84945,1,2,297354,297354,297356,0,2,0
84946,1,2,297355,297356,297358,1,3,0
84947,6,2,297361,297361,297363,0,2,3
84948,3,2,297364,297364,297366,0,2,1
84949,6,3,297370,297370,297373,0,3,4
84950,2,2,297372,297373,297375,1,3,0
84951,3,1,297375,297375,297376,0,1,0
84952,5,1,297380,297380,297381,0,1,4
84953,6,1,297386,297386,297387,0,1,5
84954,3,1,297389,297389,297390,0,1,2
84955,6,1,297395,297395,297396,0,1,5
84956,4,3,297399,297399,297402,0,3,3
84957,2,1,297401,297402,297403,1,2,0
84958,6,3,297407,297407,297410,0,3,4
84959,5,1,297412,297412,297413,0,1,2
84960,4,3,297416,297416,297419,0,3,3
84961,4,1,297420,297420,297421,0,1,1
84962,4,3,297424,297424,297427,0,3,3
84963,6,3,297430,297430,297433,0,3,3
84964,4,2,297434,297434,297436,0,2,1
84965,6,2,297440,297440,297442,0,2,4
84966,5,2,297445,297445,297447,0,2,3
84967,2,2,297447,297447,297449,0,2,0
84968,5,1,297452,297452,297453,0,1,3
84969,2,2,297454,297454,297456,0,2,1
84970,6,1,297460,297460,297461,0,1,4
84971,6,3,297466,297466,297469,0,3,5
84972,1,1,297467,297469,297470,2,3,0
84973,2,1,297469,297470,297471,1,2,0
84974,2,3,297471,297471,297474,0,3,0
84975,3,1,297474,297474,297475,0,1,0
84976,6,1,297480,297480,297481,0,1,5
84977,2,3,297482,297482,297485,0,3,1
84978,4,1,297486,297486,297487,0,1,1
84979,3,3,297489,297489,297492,0,3,2
84980,2,2,297491,297492,297494,1,3,0
84981,5,2,297496,297496,297498,0,2,2
84982,4,2,297500,297500,297502,0,2,2
84983,3,2,297503,297503,297505,0,2,1
84984,4,1,297507,297507,297508,0,1,2
84985,3,2,297510,297510,297512,0,2,2
84986,6,3,297516,297516,297519,0,3,4
84987,6,1,297522,297522,297523,0,1,3
84988,3,3,297525,297525,297528,0,3,2
84989,4,2,297529,297529,297531,0,2,1
84990,1,3,297530,297531,297534,1,4,0
84991,3,1,297533,297534,297535,1,2,0
84992,4,3,297537,297537,297540,0,3,2
84993,3,1,297540,297540,297541,0,1,0
84994,4,1,297544,297544,297545,0,1,3
84995,4,3,297548,297548,297551,0,3,3
84996,2,1,297550,297551,297552,1,2,0
84997,3,2,297553,297553,297555,0,2,1
84998,2,2,297555,297555,297557,0,2,0
84999,4,3,297559,297559,297562,0,3,2
85000,6,1,297565,297565,297566,0,1,3
85001,1,3,297566,297566,297569,0,3,0
85002,5,3,297571,297571,297574,0,3,2
85003,4,3,297575,297575,297578,0,3,1
85004,1,1,297576,297578,297579,2,3,0
85005,1,3,297577,297579,297582,2,5,0
85006,1,2,297578,297582,297584,4,6,0
85007,6,3,297584,297584,297587,0,3,0
85008,4,3,297588,297588,297591,0,3,1
85009,1,1,297589,297591,297592,2,3,0
85010,4,1,297593,297593,297594,0,1,1
85011,2,2,297595,297595,297597,0,2,1
85012,6,1,297601,297601,297602,0,1,4
85013,5,3,297606,297606,297609,0,3,4
85014,4,3,297610,297610,297613,0,3,1
85015,3,1,297613,297613,297614,0,1,0
85016,6,1,297619,297619,297620,0,1,5
85017,6,2,297625,297625,297627,0,2,5
85018,6,3,297631,297631,297634,0,3,4
85019,1,3,297632,297634,297637,2,5,0
85020,4,3,297636,297637,297640,1,4,0
85021,1,1,297637,297640,297641,3,4,0
85022,4,2,297641,297641,297643,0,2,0
85023,4,1,297645,297645,297646,0,1,2
85024,6,2,297651,297651,297653,0,2,5
85025,6,3,297657,297657,297660,0,3,4
85026,5,1,297662,297662,297663,0,1,2
85027,3,1,297665,297665,297666,0,1,2
85028,3,2,297668,297668,297670,0,2,2
85029,5,3,297673,297673,297676,0,3,3
85030,4,1,297677,297677,297678,0,1,1
85031,1,3,297678,297678,297681,0,3,0
85032,2,2,297680,297681,297683,1,3,0
85033,5,2,297685,297685,297687,0,2,2
85034,1,3,297686,297687,297690,1,4,0
85035,4,1,297690,297690,297691,0,1,0
85036,2,1,297692,297692,297693,0,1,1
85037,5,3,297697,297697,297700,0,3,4
85038,2,3,297699,297700,297703,1,4,0
85039,2,1,297701,297703,297704,2,3,0
85040,3,1,297704,297704,297705,0,1,0
85041,1,3,297705,297705,297708,0,3,0
85042,4,3,297709,297709,297712,0,3,1
85043,3,3,297712,297712,297715,0,3,0
85044,2,1,297714,297715,297716,1,2,0
85045,2,3,297716,297716,297719,0,3,0
85046,6,2,297722,297722,297724,0,2,3
85047,6,1,297728,297728,297729,0,1,4
85048,3,3,297731,297731,297734,0,3,2
85049,4,3,297735,297735,297738,0,3,1
85050,5,3,297740,297740,297743,0,3,2
85051,6,2,297746,297746,297748,0,2,3
85052,4,1,297750,297750,297751,0,1,2
85053,3,3,297753,297753,297756,0,3,2
85054,6,1,297759,297759,297760,0,1,3
85055,4,1,297763,297763,297764,0,1,3
85056,6,1,297769,297769,297770,0,1,5
85057,4,2,297773,297773,297775,0,2,3
85058,2,1,297775,297775,297776,0,1,0
85059,5,1,297780,297780,297781,0,1,4
85060,5,1,297785,297785,297786,0,1,4
85061,3,3,297788,297788,297791,0,3,2
85062,1,2,297789,297791,297793,2,4,0
85063,2,1,297791,297793,297794,2,3,0
85064,2,3,297793,297794,297797,1,4,0
85065,5,3,297798,297798,297801,0,3,1
85066,3,1,297801,297801,297802,0,1,0
85067,3,3,297804,297804,297807,0,3,2
85068,3,2,297807,297807,297809,0,2,0
85069,6,2,297813,297813,297815,0,2,4
85070,2,3,297815,297815,297818,0,3,0
85071,1,3,297816,297818,297821,2,5,0
85072,4,1,297820,297821,297822,1,2,0
85073,4,3,297824,297824,297827,0,3,2
85074,3,1,297827,297827,297828,0,1,0
85075,1,3,297828,297828,297831,0,3,0
85076,1,2,297829,297831,297833,2,4,0
85077,6,3,297835,297835,297838,0,3,2
85078,1,2,297836,297838,297840,2,4,0
85079,4,2,297840,297840,297842,0,2,0
85080,2,1,297842,297842,297843,0,1,0
85081,6,2,297848,297848,297850,0,2,5
85082,3,1,297851,297851,297852,0,1,1
85083,1,1,297852,297852,297853,0,1,0
85084,4,2,297856,297856,297858,0,2,3
85085,2,1,297858,297858,297859,0,1,0
85086,6,1,297864,297864,297865,0,1,5
85087,2,3,297866,297866,297869,0,3,1
85088,4,3,297870,297870,297873,0,3,1
85089,5,3,297875,297875,297878,0,3,2
85090,1,3,297876,297878,297881,2,5,0
85091,2,2,297878,297881,297883,3,5,0
85092,4,3,297882,297883,297886,1,4,0
85093,4,3,297886,297886,297889,0,3,0
85094,1,3,297887,297889,297892,2,5,0
85095,4,1,297891,297892,297893,1,2,0
85096,1,3,297892,297893,297896,1,4,0
85097,2,3,297894,297896,297899,2,5,0
85098,5,3,297899,297899,297902,0,3,0
85099,2,1,297901,297902,297903,1,2,0
85100,2,3,297903,297903,297906,0,3,0
85101,1,3,297904,297906,297909,2,5,0
85102,2,2,297906,297909,297911,3,5,0
85103,5,2,297911,297911,297913,0,2,0
85104,1,1,297912,297913,297914,1,2,0
85105,6,1,297918,297918,297919,0,1,4
85106,6,3,297924,297924,297927,0,3,5
85107,4,1,297928,297928,297929,0,1,1
85108,2,2,297930,297930,297932,0,2,1
85109,4,3,297934,297934,297937,0,3,2
85110,5,1,297939,297939,297940,0,1,2
85111,3,2,297942,297942,297944,0,2,2
85112,4,2,297946,297946,297948,0,2,2
85113,2,3,297948,297948,297951,0,3,0
85114,2,1,297950,297951,297952,1,2,0
85115,1,1,297951,297952,297953,1,2,0
85116,4,1,297955,297955,297956,0,1,2
85117,5,1,297960,297960,297961,0,1,4
85118,4,2,297964,297964,297966,0,2,3
85119,2,2,297966,297966,297968,0,2,0
85120,1,2,297967,297968,297970,1,3,0
85121,2,2,297969,297970,297972,1,3,0
85122,2,2,297971,297972,297974,1,3,0
85123,5,2,297976,297976,297978,0,2,2
85124,1,2,297977,297978,297980,1,3,0
85125,1,3,297978,297980,297983,2,5,0
85126,2,2,297980,297983,297985,3,5,0
85127,4,3,297984,297985,297988,1,4,0
85128,1,3,297985,297988,297991,3,6,0
85129,3,3,297988,297991,297994,3,6,0
85130,3,3,297991,297994,297997,3,6,0
85131,1,1,297992,297997,297998,5,6,0
85132,4,3,297996,297998,298001,2,5,0
85133,3,3,297999,298001,298004,2,5,0
85134,2,1,298001,298004,298005,3,4,0
85135,6,1,298007,298007,298008,0,1,2
85136,3,3,298010,298010,298013,0,3,2
85137,3,1,298013,298013,298014,0,1,0
85138,4,3,298017,298017,298020,0,3,3
85139,1,3,298018,298020,298023,2,5,0
85140,2,3,298020,298023,298026,3,6,0
85141,4,2,298024,298026,298028,2,4,0
85142,4,2,298028,298028,298030,0,2,0
85143,6,1,298034,298034,298035,0,1,4
85144,5,1,298039,298039,298040,0,1,4
85145,6,2,298045,298045,298047,0,2,5
85146,1,1,298046,298047,298048,1,2,0
85147,4,1,298050,298050,298051,0,1,2
85148,1,2,298051,298051,298053,0,2,0
85149,2,2,298053,298053,298055,0,2,0
85150,2,2,298055,298055,298057,0,2,0
85151,2,3,298057,298057,298060,0,3,0
85152,4,1,298061,298061,298062,0,1,1
85153,1,3,298062,298062,298065,0,3,0
85154,5,1,298067,298067,298068,0,1,2
85155,1,1,298068,298068,298069,0,1,0
85156,2,1,298070,298070,298071,0,1,1
85157,4,1,298074,298074,298075,0,1,3
85158,4,1,298078,298078,298079,0,1,3
85159,1,2,298079,298079,298081,0,2,0
85160,4,1,298083,298083,298084,0,1,2
85161,1,2,298084,298084,298086,0,2,0
85162,1,2,298085,298086,298088,1,3,0
85163,3,2,298088,298088,298090,0,2,0
85164,6,2,298094,298094,298096,0,2,4
85165,3,3,298097,298097,298100,0,3,1
85166,3,1,298100,298100,298101,0,1,0
85167,5,1,298105,298105,298106,0,1,4
85168,6,2,298111,298111,298113,0,2,5
85169,3,2,298114,298114,298116,0,2,1
85170,3,2,298117,298117,298119,0,2,1
85171,2,2,298119,298119,298121,0,2,0
85172,5,3,298124,298124,298127,0,3,3
85173,6,3,298130,298130,298133,0,3,3
85174,6,1,298136,298136,298137,0,1,3
85175,3,3,298139,298139,298142,0,3,2
85176,5,3,298144,298144,298147,0,3,2
85177,2,1,298146,298147,298148,1,2,0
85178,1,1,298147,298148,298149,1,2,0
85179,2,2,298149,298149,298151,0,2,0
85180,2,2,298151,298151,298153,0,2,0
85181,2,2,298153,298153,298155,0,2,0
85182,6,2,298159,298159,298161,0,2,4
85183,2,2,298161,298161,298163,0,2,0
85184,1,1,298162,298163,298164,1,2,0
85185,1,3,298163,298164,298167,1,4,0
85186,4,1,298167,298167,298168,0,1,0
85187,5,3,298172,298172,298175,0,3,4
85188,6,3,298178,298178,298181,0,3,3
85189,1,2,298179,298181,298183,2,4,0
85190,1,1,298180,298183,298184,3,4,0
85191,4,3,298184,298184,298187,0,3,0
85192,5,2,298189,298189,298191,0,2,2
85193,5,2,298194,298194,298196,0,2,3
85194,2,2,298196,298196,298198,0,2,0
85195,6,2,298202,298202,298204,0,2,4
85196,6,2,298208,298208,298210,0,2,4
85197,1,2,298209,298210,298212,1,3,0
85198,3,1,298212,298212,298213,0,1,0
85199,3,3,298215,298215,298218,0,3,2
85200,2,3,298217,298218,298221,1,4,0
85201,4,1,298221,298221,298222,0,1,0
85202,1,2,298222,298222,298224,0,2,0
85203,5,2,298227,298227,298229,0,2,3
85204,5,3,298232,298232,298235,0,3,3
85205,6,2,298238,298238,298240,0,2,3
85206,5,2,298243,298243,298245,0,2,3
85207,2,3,298245,298245,298248,0,3,0
85208,6,3,298251,298251,298254,0,3,3
85209,2,2,298253,298254,298256,1,3,0
85210,3,1,298256,298256,298257,0,1,0
85211,4,2,298260,298260,298262,0,2,3
85212,4,1,298264,298264,298265,0,1,2
85213,6,3,298270,298270,298273,0,3,5
85214,1,1,298271,298273,298274,2,3,0
85215,6,1,298277,298277,298278,0,1,3
85216,2,1,298279,298279,298280,0,1,1
85217,1,1,298280,298280,298281,0,1,0
85218,5,3,298285,298285,298288,0,3,4
85219,5,1,298290,298290,298291,0,1,2
85220,3,1,298293,298293,298294,0,1,2
85221,2,3,298295,298295,298298,0,3,1
85222,3,1,298298,298298,298299,0,1,0
85223,4,3,298302,298302,298305,0,3,3
85224,3,2,298305,298305,298307,0,2,0
85225,3,2,298308,298308,298310,0,2,1
85226,3,1,298311,298311,298312,0,1,1
85227,1,3,298312,298312,298315,0,3,0
85228,6,2,298318,298318,298320,0,2,3
85229,3,2,298321,298321,298323,0,2,1
85230,5,1,298326,298326,298327,0,1,3
85231,5,1,298331,298331,298332,0,1,4
85232,2,1,298333,298333,298334,0,1,1
85233,5,1,298338,298338,298339,0,1,4
85234,4,2,298342,298342,298344,0,2,3
85235,5,1,298347,298347,298348,0,1,3
85236,2,1,298349,298349,298350,0,1,1
85237,5,3,298354,298354,298357,0,3,4
85238,3,1,298357,298357,298358,0,1,0
85239,2,3,298359,298359,298362,0,3,1
85240,3,1,298362,298362,298363,0,1,0
85241,4,2,298366,298366,298368,0,2,3
85242,4,2,298370,298370,298372,0,2,2
85243,1,1,298371,298372,298373,1,2,0
85244,3,3,298374,298374,298377,0,3,1
85245,2,2,298376,298377,298379,1,3,0
85246,6,2,298382,298382,298384,0,2,3
85247,5,3,298387,298387,298390,0,3,3
85248,1,2,298388,298390,298392,2,4,0
85249,1,3,298389,298392,298395,3,6,0
85250,1,2,298390,298395,298397,5,7,0
85251,6,1,298396,298397,298398,1,2,0
85252,3,2,298399,298399,298401,0,2,1
85253,4,2,298403,298403,298405,0,2,2
85254,2,1,298405,298405,298406,0,1,0
85255,2,3,298407,298407,298410,0,3,1
85256,1,1,298408,298410,298411,2,3,0
85257,5,1,298413,298413,298414,0,1,2
85258,4,1,298417,298417,298418,0,1,3
85259,1,2,298418,298418,298420,0,2,0
85260,6,1,298424,298424,298425,0,1,4
85261,2,3,298426,298426,298429,0,3,1
85262,6,2,298432,298432,298434,0,2,3
85263,5,2,298437,298437,298439,0,2,3
85264,2,1,298439,298439,298440,0,1,0
85265,2,2,298441,298441,298443,0,2,1
85266,1,1,298442,298443,298444,1,2,0
85267,2,1,298444,298444,298445,0,1,0
85268,3,1,298447,298447,298448,0,1,2
85269,6,1,298453,298453,298454,0,1,5
85270,2,2,298455,298455,298457,0,2,1
85271,6,3,298461,298461,298464,0,3,4
85272,4,2,298465,298465,298467,0,2,1
85273,4,3,298469,298469,298472,0,3,2
85274,3,2,298472,298472,298474,0,2,0
85275,4,3,298476,298476,298479,0,3,2
85276,4,1,298480,298480,298481,0,1,1
85277,6,3,298486,298486,298489,0,3,5
85278,3,3,298489,298489,298492,0,3,0
85279,4,2,298493,298493,298495,0,2,1
85280,2,3,298495,298495,298498,0,3,0
85281,3,3,298498,298498,298501,0,3,0
85282,2,3,298500,298501,298504,1,4,0
85283,4,3,298504,298504,298507,0,3,0
85284,5,3,298509,298509,298512,0,3,2
85285,6,1,298515,298515,298516,0,1,3
85286,1,2,298516,298516,298518,0,2,0
85287,2,1,298518,298518,298519,0,1,0
85288,5,1,298523,298523,298524,0,1,4
85289,2,3,298525,298525,298528,0,3,1
85290,6,2,298531,298531,298533,0,2,3
85291,2,2,298533,298533,298535,0,2,0
85292,2,2,298535,298535,298537,0,2,0
85293,2,2,298537,298537,298539,0,2,0
85294,6,2,298543,298543,298545,0,2,4
85295,5,1,298548,298548,298549,0,1,3
85296,3,2,298551,298551,298553,0,2,2
85297,2,1,298553,298553,298554,0,1,0
85298,2,3,298555,298555,298558,0,3,1
85299,5,3,298560,298560,298563,0,3,2
85300,4,1,298564,298564,298565,0,1,1
85301,3,2,298567,298567,298569,0,2,2
85302,6,1,298573,298573,298574,0,1,4
85303,5,2,298578,298578,298580,0,2,4
85304,4,2,298582,298582,298584,0,2,2
85305,6,3,298588,298588,298591,0,3,4
85306,2,3,298590,298591,298594,1,4,0
85307,4,2,298594,298594,298596,0,2,0
85308,2,2,298596,298596,298598,0,2,0
85309,3,2,298599,298599,298601,0,2,1
85310,1,1,298600,298601,298602,1,2,0
85311,2,2,298602,298602,298604,0,2,0
85312,3,1,298605,298605,298606,0,1,1
85313,6,1,298611,298611,298612,0,1,5
85314,1,3,298612,298612,298615,0,3,0
85315,3,3,298615,298615,298618,0,3,0
85316,1,1,298616,298618,298619,2,3,0
85317,1,3,298617,298619,298622,2,5,0
85318,5,3,298622,298622,298625,0,3,0
85319,4,3,298626,298626,298629,0,3,1
85320,5,1,298631,298631,298632,0,1,2
85321,6,1,298637,298637,298638,0,1,5
85322,6,1,298643,298643,298644,0,1,5
85323,3,2,298646,298646,298648,0,2,2
85324,2,1,298648,298648,298649,0,1,0
85325,5,1,298653,298653,298654,0,1,4
85326,5,2,298658,298658,298660,0,2,4
85327,3,3,298661,298661,298664,0,3,1
85328,6,2,298667,298667,298669,0,2,3
85329,4,3,298671,298671,298674,0,3,2
85330,2,1,298673,298674,298675,1,2,0
85331,1,1,298674,298675,298676,1,2,0
85332,6,2,298680,298680,298682,0,2,4
85333,6,1,298686,298686,298687,0,1,4
85334,1,1,298687,298687,298688,0,1,0
85335,6,3,298693,298693,298696,0,3,5
85336,2,2,298695,298696,298698,1,3,0
85337,4,1,298699,298699,298700,0,1,1
85338,6,3,298705,298705,298708,0,3,5
85339,2,3,298707,298708,298711,1,4,0
85340,6,3,298713,298713,298716,0,3,2
85341,1,3,298714,298716,298719,2,5,0
85342,3,2,298717,298719,298721,2,4,0
85343,1,1,298718,298721,298722,3,4,0
85344,4,3,298722,298722,298725,0,3,0
85345,6,1,298728,298728,298729,0,1,3
85346,5,1,298733,298733,298734,0,1,4
85347,1,1,298734,298734,298735,0,1,0
85348,4,1,298738,298738,298739,0,1,3
85349,4,2,298742,298742,298744,0,2,3
85350,5,2,298747,298747,298749,0,2,3
85351,6,2,298753,298753,298755,0,2,4
85352,6,3,298759,298759,298762,0,3,4
85353,4,1,298763,298763,298764,0,1,1
85354,3,2,298766,298766,298768,0,2,2
85355,3,1,298769,298769,298770,0,1,1
85356,1,2,298770,298770,298772,0,2,0
85357,2,2,298772,298772,298774,0,2,0
85358,3,1,298775,298775,298776,0,1,1
85359,1,3,298776,298776,298779,0,3,0
85360,6,2,298782,298782,298784,0,2,3
85361,1,1,298783,298784,298785,1,2,0
85362,4,1,298787,298787,298788,0,1,2
85363,3,1,298790,298790,298791,0,1,2
85364,2,3,298792,298792,298795,0,3,1
85365,3,3,298795,298795,298798,0,3,0
85366,3,2,298798,298798,298800,0,2,0
85367,6,1,298804,298804,298805,0,1,4
85368,2,2,298806,298806,298808,0,2,1
85369,1,3,298807,298808,298811,1,4,0
85370,3,1,298810,298811,298812,1,2,0
85371,1,3,298811,298812,298815,1,4,0
85372,5,1,298816,298816,298817,0,1,1
85373,4,1,298820,298820,298821,0,1,3
85374,3,2,298823,298823,298825,0,2,2
85375,2,2,298825,298825,298827,0,2,0
85376,2,3,298827,298827,298830,0,3,0
85377,6,2,298833,298833,298835,0,2,3
85378,5,1,298838,298838,298839,0,1,3
85379,1,3,298839,298839,298842,0,3,0
85380,1,3,298840,298842,298845,2,5,0
85381,1,3,298841,298845,298848,4,7,0
85382,5,2,298846,298848,298850,2,4,0
85383,4,3,298850,298850,298853,0,3,0
85384,2,2,298852,298853,298855,1,3,0
85385,6,3,298858,298858,298861,0,3,3
85386,3,1,298861,298861,298862,0,1,0
85387,5,3,298866,298866,298869,0,3,4
85388,1,1,298867,298869,298870,2,3,0
85389,3,3,298870,298870,298873,0,3,0
85390,6,2,298876,298876,298878,0,2,3
85391,2,3,298878,298878,298881,0,3,0
85392,1,1,298879,298881,298882,2,3,0
85393,6,3,298885,298885,298888,0,3,3
85394,3,1,298888,298888,298889,0,1,0
85395,4,1,298892,298892,298893,0,1,3
85396,3,1,298895,298895,298896,0,1,2
85397,5,3,298900,298900,298903,0,3,4
85398,4,1,298904,298904,298905,0,1,1
85399,3,1,298907,298907,298908,0,1,2
85400,3,1,298910,298910,298911,0,1,2
85401,1,3,298911,298911,298914,0,3,0
85402,3,1,298914,298914,298915,0,1,0
85403,4,2,298918,298918,298920,0,2,3
85404,2,3,298920,298920,298923,0,3,0
85405,3,2,298923,298923,298925,0,2,0
85406,5,1,298928,298928,298929,0,1,3
85407,5,2,298933,298933,298935,0,2,4
85408,5,2,298938,298938,298940,0,2,3
85409,4,1,298942,298942,298943,0,1,2
85410,1,1,298943,298943,298944,0,1,0
85411,3,1,298946,298946,298947,0,1,2
85412,3,2,298949,298949,298951,0,2,2
85413,3,2,298952,298952,298954,0,2,1
85414,2,3,298954,298954,298957,0,3,0
85415,2,2,298956,298957,298959,1,3,0
85416,1,2,298957,298959,298961,2,4,0
85417,6,1,298963,298963,298964,0,1,2
85418,5,2,298968,298968,298970,0,2,4
85419,2,2,298970,298970,298972,0,2,0
85420,2,1,298972,298972,298973,0,1,0
85421,4,3,298976,298976,298979,0,3,3
85422,6,2,298982,298982,298984,0,2,3
85423,1,3,298983,298984,298987,1,4,0
85424,2,2,298985,298987,298989,2,4,0
85425,3,1,298988,298989,298990,1,2,0
85426,3,3,298991,298991,298994,0,3,1
85427,6,1,298997,298997,298998,0,1,3
85428,2,2,298999,298999,299001,0,2,1
85429,1,1,299000,299001,299002,1,2,0
85430,6,1,299006,299006,299007,0,1,4
85431,4,2,299010,299010,299012,0,2,3
85432,1,3,299011,299012,299015,1,4,0
85433,6,1,299017,299017,299018,0,1,2
85434,6,1,299023,299023,299024,0,1,5
85435,5,3,299028,299028,299031,0,3,4
85436,3,3,299031,299031,299034,0,3,0
85437,5,2,299036,299036,299038,0,2,2
85438,5,1,299041,299041,299042,0,1,3
85439,5,3,299046,299046,299049,0,3,4
85440,5,3,299051,299051,299054,0,3,2
85441,1,2,299052,299054,299056,2,4,0
85442,4,1,299056,299056,299057,0,1,0
85443,2,2,299058,299058,299060,0,2,1
85444,2,3,299060,299060,299063,0,3,0
85445,3,1,299063,299063,299064,0,1,0
85446,5,1,299068,299068,299069,0,1,4
85447,4,1,299072,299072,299073,0,1,3
85448,4,1,299076,299076,299077,0,1,3
85449,6,1,299082,299082,299083,0,1,5
85450,5,3,299087,299087,299090,0,3,4
85451,1,2,299088,299090,299092,2,4,0
85452,6,1,299094,299094,299095,0,1,2
85453,4,1,299098,299098,299099,0,1,3
85454,3,2,299101,299101,299103,0,2,2
85455,1,1,299102,299103,299104,1,2,0
85456,6,2,299108,299108,299110,0,2,4
85457,2,2,299110,299110,299112,0,2,0
85458,2,1,299112,299112,299113,0,1,0
85459,4,3,299116,299116,299119,0,3,3
85460,1,1,299117,299119,299120,2,3,0
85461,6,3,299123,299123,299126,0,3,3
85462,5,3,299128,299128,299131,0,3,2
85463,6,2,299134,299134,299136,0,2,3
85464,1,1,299135,299136,299137,1,2,0
85465,5,2,299140,299140,299142,0,2,3
85466,2,3,299142,299142,299145,0,3,0
85467,5,2,299147,299147,299149,0,2,2
85468,5,3,299152,299152,299155,0,3,3
85469,1,1,299153,299155,299156,2,3,0
85470,3,1,299156,299156,299157,0,1,0
85471,5,2,299161,299161,299163,0,2,4
85472,6,2,299167,299167,299169,0,2,4
85473,2,2,299169,299169,299171,0,2,0
85474,4,3,299173,299173,299176,0,3,2
85475,3,2,299176,299176,299178,0,2,0
85476,1,2,299177,299178,299180,1,3,0
85477,2,1,299179,299180,299181,1,2,0
85478,3,1,299182,299182,299183,0,1,1
85479,4,1,299186,299186,299187,0,1,3
85480,2,2,299188,299188,299190,0,2,1
85481,4,1,299192,299192,299193,0,1,2
85482,4,1,299196,299196,299197,0,1,3
85483,3,1,299199,299199,299200,0,1,2
85484,2,3,299201,299201,299204,0,3,1
85485,6,3,299207,299207,299210,0,3,3
85486,5,1,299212,299212,299213,0,1,2
85487,6,1,299218,299218,299219,0,1,5
85488,3,1,299221,299221,299222,0,1,2
85489,6,2,299227,299227,299229,0,2,5
85490,5,3,299232,299232,299235,0,3,3
85491,4,2,299236,299236,299238,0,2,1
85492,1,2,299237,299238,299240,1,3,0
85493,6,3,299243,299243,299246,0,3,3
85494,4,2,299247,299247,299249,0,2,1
85495,1,1,299248,299249,299250,1,2,0
85496,4,1,299252,299252,299253,0,1,2
85497,6,2,299258,299258,299260,0,2,5
85498,4,2,299262,299262,299264,0,2,2
85499,3,1,299265,299265,299266,0,1,1
85500,1,1,299266,299266,299267,0,1,0
85501,1,1,299267,299267,299268,0,1,0
85502,3,3,299270,299270,299273,0,3,2
85503,4,2,299274,299274,299276,0,2,1
85504,6,1,299280,299280,299281,0,1,4
85505,6,2,299286,299286,299288,0,2,5
85506,3,2,299289,299289,299291,0,2,1
85507,5,2,299294,299294,299296,0,2,3
85508,6,2,299300,299300,299302,0,2,4
85509,4,3,299304,299304,299307,0,3,2
85510,6,1,299310,299310,299311,0,1,3
85511,3,3,299313,299313,299316,0,3,2
85512,1,2,299314,299316,299318,2,4,0
85513,3,1,299317,299318,299319,1,2,0
85514,6,1,299323,299323,299324,0,1,4
85515,5,2,299328,299328,299330,0,2,4
85516,5,1,299333,299333,299334,0,1,3
85517,4,1,299337,299337,299338,0,1,3
85518,6,1,299343,299343,299344,0,1,5
85519,2,3,299345,299345,299348,0,3,1
85520,6,3,299351,299351,299354,0,3,3
85521,4,1,299355,299355,299356,0,1,1
85522,1,3,299356,299356,299359,0,3,0
85523,2,3,299358,299359,299362,1,4,0
85524,2,3,299360,299362,299365,2,5,0
85525,4,2,299364,299365,299367,1,3,0
85526,2,3,299366,299367,299370,1,4,0
85527,2,3,299368,299370,299373,2,5,0
85528,5,1,299373,299373,299374,0,1,0
85529,4,1,299377,299377,299378,0,1,3
85530,3,2,299380,299380,299382,0,2,2
85531,2,3,299382,299382,299385,0,3,0
85532,3,2,299385,299385,299387,0,2,0
85533,6,2,299391,299391,299393,0,2,4
85534,1,1,299392,299393,299394,1,2,0
85535,5,2,299397,299397,299399,0,2,3
85536,1,1,299398,299399,299400,1,2,0
85537,1,1,299399,299400,299401,1,2,0
85538,6,2,299405,299405,299407,0,2,4
85539,5,3,299410,299410,299413,0,3,3
85540,3,2,299413,299413,299415,0,2,0
85541,2,3,299415,299415,299418,0,3,0
85542,1,2,299416,299418,299420,2,4,0
85543,3,3,299419,299420,299423,1,4,0
85544,2,1,299421,299423,299424,2,3,0
85545,5,1,299426,299426,299427,0,1,2
85546,5,1,299431,299431,299432,0,1,4
85547,5,1,299436,299436,299437,0,1,4
85548,3,1,299439,299439,299440,0,1,2
85549,2,3,299441,299441,299444,0,3,1
85550,1,3,299442,299444,299447,2,5,0
85551,3,2,299445,299447,299449,2,4,0
85552,1,2,299446,299449,299451,3,5,0
85553,4,2,299450,299451,299453,1,3,0
85554,1,3,299451,299453,299456,2,5,0
85555,5,1,299456,299456,299457,0,1,0
85556,1,1,299457,299457,299458,0,1,0
85557,4,1,299461,299461,299462,0,1,3
85558,1,1,299462,299462,299463,0,1,0
85559,4,3,299466,299466,299469,0,3,3
85560,6,3,299472,299472,299475,0,3,3
85561,4,1,299476,299476,299477,0,1,1
85562,5,2,299481,299481,299483,0,2,4
85563,6,2,299487,299487,299489,0,2,4
85564,2,3,299489,299489,299492,0,3,0
85565,3,2,299492,299492,299494,0,2,0
85566,2,3,299494,299494,299497,0,3,0
85567,5,1,299499,299499,299500,0,1,2
85568,4,2,299503,299503,299505,0,2,3
85569,2,1,299505,299505,299506,0,1,0
85570,4,2,299509,299509,299511,0,2,3
85571,1,1,299510,299511,299512,1,2,0
85572,6,3,299516,299516,299519,0,3,4
85573,4,3,299520,299520,299523,0,3,1
85574,5,1,299525,299525,299526,0,1,2
85575,6,2,299531,299531,299533,0,2,5
85576,1,1,299532,299533,299534,1,2,0
85577,3,3,299535,299535,299538,0,3,1
85578,3,2,299538,299538,299540,0,2,0
85579,2,1,299540,299540,299541,0,1,0
85580,5,1,299545,299545,299546,0,1,4
85581,5,1,299550,299550,299551,0,1,4
85582,5,3,299555,299555,299558,0,3,4
85583,6,1,299561,299561,299562,0,1,3
85584,6,3,299567,299567,299570,0,3,5
85585,3,2,299570,299570,299572,0,2,0
85586,1,1,299571,299572,299573,1,2,0
85587,1,3,299572,299573,299576,1,4,0
85588,2,3,299574,299576,299579,2,5,0
85589,3,1,299577,299579,299580,2,3,0
85590,5,1,299582,299582,299583,0,1,2
85591,2,3,299584,299584,299587,0,3,1
85592,5,1,299589,299589,299590,0,1,2
85593,3,2,299592,299592,299594,0,2,2
85594,5,1,299597,299597,299598,0,1,3
85595,6,3,299603,299603,299606,0,3,5
85596,5,1,299608,299608,299609,0,1,2
85597,3,1,299611,299611,299612,0,1,2
85598,1,1,299612,299612,299613,0,1,0
85599,1,3,299613,299613,299616,0,3,0
85600,4,3,299617,299617,299620,0,3,1
85601,2,3,299619,299620,299623,1,4,0
85602,6,1,299625,299625,299626,0,1,2
85603,5,2,299630,299630,299632,0,2,4
85604,2,3,299632,299632,299635,0,3,0
85605,3,2,299635,299635,299637,0,2,0
85606,2,3,299637,299637,299640,0,3,0
85607,6,2,299643,299643,299645,0,2,3
85608,2,3,299645,299645,299648,0,3,0
85609,5,3,299650,299650,299653,0,3,2
85610,3,1,299653,299653,299654,0,1,0
85611,3,1,299656,299656,299657,0,1,2
85612,4,2,299660,299660,299662,0,2,3
85613,2,3,299662,299662,299665,0,3,0
85614,5,1,299667,299667,299668,0,1,2
85615,1,3,299668,299668,299671,0,3,0
85616,4,1,299672,299672,299673,0,1,1
85617,4,1,299676,299676,299677,0,1,3
85618,1,3,299677,299677,299680,0,3,0
85619,4,1,299681,299681,299682,0,1,1
85620,1,3,299682,299682,299685,0,3,0
85621,3,1,299685,299685,299686,0,1,0
85622,1,3,299686,299686,299689,0,3,0
85623,4,3,299690,299690,299693,0,3,1
85624,2,1,299692,299693,299694,1,2,0
85625,1,2,299693,299694,299696,1,3,0
85626,6,3,299699,299699,299702,0,3,3
85627,1,1,299700,299702,299703,2,3,0
85628,5,1,299705,299705,299706,0,1,2
85629,2,2,299707,299707,299709,0,2,1
85630,2,3,299709,299709,299712,0,3,0
85631,3,3,299712,299712,299715,0,3,0
85632,5,3,299717,299717,299720,0,3,2
85633,6,1,299723,299723,299724,0,1,3
85634,6,2,299729,299729,299731,0,2,5
85635,2,3,299731,299731,299734,0,3,0
85636,2,3,299733,299734,299737,1,4,0
85637,5,1,299738,299738,299739,0,1,1
85638,6,2,299744,299744,299746,0,2,5
85639,1,2,299745,299746,299748,1,3,0
85640,4,2,299749,299749,299751,0,2,1
85641,5,2,299754,299754,299756,0,2,3
85642,2,2,299756,299756,299758,0,2,0
85643,3,1,299759,299759,299760,0,1,1
85644,4,3,299763,299763,299766,0,3,3
85645,1,3,299764,299766,299769,2,5,0
85646,2,2,299766,299769,299771,3,5,0
85647,2,1,299768,299771,299772,3,4,0
85648,1,1,299769,299772,299773,3,4,0
85649,3,3,299772,299773,299776,1,4,0
85650,4,1,299776,299776,299777,0,1,0
85651,2,2,299778,299778,299780,0,2,1
85652,3,3,299781,299781,299784,0,3,1
85653,3,3,299784,299784,299787,0,3,0
85654,6,2,299790,299790,299792,0,2,3
85655,1,3,299791,299792,299795,1,4,0
85656,5,1,299796,299796,299797,0,1,1
85657,6,2,299802,299802,299804,0,2,5
85658,4,3,299806,299806,299809,0,3,2
85659,5,3,299811,299811,299814,0,3,2
85660,3,1,299814,299814,299815,0,1,0
85661,5,1,299819,299819,299820,0,1,4
85662,4,1,299823,299823,299824,0,1,3
85663,3,3,299826,299826,299829,0,3,2
85664,3,3,299829,299829,299832,0,3,0
85665,2,3,299831,299832,299835,1,4,0
85666,2,1,299833,299835,299836,2,3,0
85667,3,3,299836,299836,299839,0,3,0
85668,4,1,299840,299840,299841,0,1,1
85669,3,1,299843,299843,299844,0,1,2
85670,3,2,299846,299846,299848,0,2,2
85671,1,1,299847,299848,299849,1,2,0
85672,4,3,299851,299851,299854,0,3,2
85673,6,1,299857,299857,299858,0,1,3
85674,1,3,299858,299858,299861,0,3,0
85675,6,2,299864,299864,299866,0,2,3
85676,3,3,299867,299867,299870,0,3,1
85677,6,1,299873,299873,299874,0,1,3
85678,6,2,299879,299879,299881,0,2,5
85679,1,1,299880,299881,299882,1,2,0
85680,1,2,299881,299882,299884,1,3,0
85681,5,3,299886,299886,299889,0,3,2
85682,6,3,299892,299892,299895,0,3,3
85683,6,2,299898,299898,299900,0,2,3
85684,5,2,299903,299903,299905,0,2,3
85685,5,1,299908,299908,299909,0,1,3
85686,5,2,299913,299913,299915,0,2,4
85687,6,3,299919,299919,299922,0,3,4
85688,3,1,299922,299922,299923,0,1,0
85689,2,3,299924,299924,299927,0,3,1
85690,2,1,299926,299927,299928,1,2,0
85691,3,3,299929,299929,299932,0,3,1
85692,5,2,299934,299934,299936,0,2,2
85693,3,2,299937,299937,299939,0,2,1
85694,2,3,299939,299939,299942,0,3,0
85695,2,2,299941,299942,299944,1,3,0
85696,3,3,299944,299944,299947,0,3,0
85697,1,3,299945,299947,299950,2,5,0
85698,3,1,299948,299950,299951,2,3,0
85699,6,2,299954,299954,299956,0,2,3
85700,4,2,299958,299958,299960,0,2,2
85701,3,2,299961,299961,299963,0,2,1
85702,5,1,299966,299966,299967,0,1,3
85703,6,2,299972,299972,299974,0,2,5
85704,4,3,299976,299976,299979,0,3,2
85705,6,2,299982,299982,299984,0,2,3
85706,2,1,299984,299984,299985,0,1,0
85707,6,2,299990,299990,299992,0,2,5
85708,1,2,299991,299992,299994,1,3,0
85709,4,2,299995,299995,299997,0,2,1
85710,6,2,300001,300001,300003,0,2,4
85711,4,3,300005,300005,300008,0,3,2
85712,4,2,300009,300009,300011,0,2,1
85713,1,3,300010,300011,300014,1,4,0
85714,2,1,300012,300014,300015,2,3,0
85715,5,3,300017,300017,300020,0,3,2
85716,5,2,300022,300022,300024,0,2,2
85717,2,1,300024,300024,300025,0,1,0
85718,1,1,300025,300025,300026,0,1,0
85719,3,2,300028,300028,300030,0,2,2
85720,1,3,300029,300030,300033,1,4,0
85721,1,3,300030,300033,300036,3,6,0
85722,2,1,300032,300036,300037,4,5,0
85723,6,2,300038,300038,300040,0,2,1
85724,6,2,300044,300044,300046,0,2,4
85725,2,1,300046,300046,300047,0,1,0
85726,2,1,300048,300048,300049,0,1,1
85727,2,1,300050,300050,300051,0,1,1
85728,5,1,300055,300055,300056,0,1,4
85729,2,1,300057,300057,300058,0,1,1
85730,2,2,300059,300059,300061,0,2,1
85731,6,2,300065,300065,300067,0,2,4
85732,6,3,300071,300071,300074,0,3,4
85733,3,2,300074,300074,300076,0,2,0
85734,1,3,300075,300076,300079,1,4,0
85735,3,3,300078,300079,300082,1,4,0
85736,6,3,300084,300084,300087,0,3,2
85737,1,2,300085,300087,300089,2,4,0
85738,1,1,300086,300089,300090,3,4,0
85739,3,2,300089,300090,300092,1,3,0
85740,4,2,300093,300093,300095,0,2,1
85741,1,3,300094,300095,300098,1,4,0
85742,2,1,300096,300098,300099,2,3,0
85743,1,3,300097,300099,300102,2,5,0
85744,6,3,300103,300103,300106,0,3,1
85745,2,3,300105,300106,300109,1,4,0
85746,5,3,300110,300110,300113,0,3,1
85747,5,1,300115,300115,300116,0,1,2
85748,6,3,300121,300121,300124,0,3,5
85749,3,3,300124,300124,300127,0,3,0
85750,5,2,300129,300129,300131,0,2,2
85751,4,2,300133,300133,300135,0,2,2
85752,2,3,300135,300135,300138,0,3,0
85753,6,1,300141,300141,300142,0,1,3
85754,3,3,300144,300144,300147,0,3,2
85755,1,2,300145,300147,300149,2,4,0
85756,4,1,300149,300149,300150,0,1,0
85757,4,3,300153,300153,300156,0,3,3
85758,3,1,300156,300156,300157,0,1,0
85759,5,2,300161,300161,300163,0,2,4
85760,2,3,300163,300163,300166,0,3,0
85761,5,2,300168,300168,300170,0,2,2
85762,6,1,300174,300174,300175,0,1,4
85763,6,2,300180,300180,300182,0,2,5
85764,4,1,300184,300184,300185,0,1,2
85765,2,2,300186,300186,300188,0,2,1
85766,5,1,300191,300191,300192,0,1,3
85767,5,1,300196,300196,300197,0,1,4
85768,3,3,300199,300199,300202,0,3,2
85769,5,2,300204,300204,300206,0,2,2
85770,5,2,300209,300209,300211,0,2,3
85771,2,2,300211,300211,300213,0,2,0
85772,1,2,300212,300213,300215,1,3,0
85773,3,2,300215,300215,300217,0,2,0
85774,2,3,300217,300217,300220,0,3,0
85775,4,1,300221,300221,300222,0,1,1
85776,3,2,300224,300224,300226,0,2,2
85777,3,2,300227,300227,300229,0,2,1
85778,1,1,300228,300229,300230,1,2,0
85779,2,3,300230,300230,300233,0,3,0
85780,6,3,300236,300236,300239,0,3,3
85781,5,3,300241,300241,300244,0,3,2
85782,1,3,300242,300244,300247,2,5,0
85783,6,2,300248,300248,300250,0,2,1
85784,6,1,300254,300254,300255,0,1,4
85785,5,3,300259,300259,300262,0,3,4
85786,6,3,300265,300265,300268,0,3,3
85787,3,1,300268,300268,300269,0,1,0
85788,6,2,300274,300274,300276,0,2,5
85789,1,2,300275,300276,300278,1,3,0
85790,6,2,300281,300281,300283,0,2,3
85791,2,3,300283,300283,300286,0,3,0
85792,5,3,300288,300288,300291,0,3,2
85793,1,1,300289,300291,300292,2,3,0
85794,2,3,300291,300292,300295,1,4,0
85795,4,1,300295,300295,300296,0,1,0
85796,6,1,300301,300301,300302,0,1,5
85797,1,1,300302,300302,300303,0,1,0
85798,4,3,300306,300306,300309,0,3,3
85799,3,1,300309,300309,300310,0,1,0
85800,5,2,300314,300314,300316,0,2,4
85801,6,2,300320,300320,300322,0,2,4
85802,2,1,300322,300322,300323,0,1,0
85803,2,3,300324,300324,300327,0,3,1
85804,1,2,300325,300327,300329,2,4,0
85805,1,3,300326,300329,300332,3,6,0
85806,6,2,300332,300332,300334,0,2,0
85807,6,1,300338,300338,300339,0,1,4
85808,4,2,300342,300342,300344,0,2,3
85809,2,3,300344,300344,300347,0,3,0
85810,4,2,300348,300348,300350,0,2,1
85811,2,2,300350,300350,300352,0,2,0
85812,6,3,300356,300356,300359,0,3,4
85813,2,2,300358,300359,300361,1,3,0
85814,4,3,300362,300362,300365,0,3,1
85815,5,2,300367,300367,300369,0,2,2
85816,6,3,300373,300373,300376,0,3,4
85817,2,3,300375,300376,300379,1,4,0
85818,4,1,300379,300379,300380,0,1,0
85819,2,3,300381,300381,300384,0,3,1
85820,4,2,300385,300385,300387,0,2,1
85821,5,3,300390,300390,300393,0,3,3
85822,2,3,300392,300393,300396,1,4,0
85823,1,3,300393,300396,300399,3,6,0
85824,2,2,300395,300399,300401,4,6,0
85825,2,1,300397,300401,300402,4,5,0
85826,6,3,300403,300403,300406,0,3,1
85827,1,3,300404,300406,300409,2,5,0
85828,1,1,300405,300409,300410,4,5,0
85829,2,2,300407,300410,300412,3,5,0
85830,5,3,300412,300412,300415,0,3,0
85831,4,2,300416,300416,300418,0,2,1
85832,5,1,300421,300421,300422,0,1,3
85833,2,3,300423,300423,300426,0,3,1
85834,3,2,300426,300426,300428,0,2,0
85835,5,2,300431,300431,300433,0,2,3
85836,3,2,300434,300434,300436,0,2,1
85837,2,3,300436,300436,300439,0,3,0
85838,2,1,300438,300439,300440,1,2,0
85839,1,3,300439,300440,300443,1,4,0
85840,6,2,300445,300445,300447,0,2,2
85841,3,2,300448,300448,300450,0,2,1
85842,6,2,300454,300454,300456,0,2,4
85843,1,3,300455,300456,300459,1,4,0
85844,4,1,300459,300459,300460,0,1,0
85845,3,1,300462,300462,300463,0,1,2
85846,6,1,300468,300468,300469,0,1,5
85847,5,2,300473,300473,300475,0,2,4
85848,4,3,300477,300477,300480,0,3,2
85849,5,1,300482,300482,300483,0,1,2
85850,4,1,300486,300486,300487,0,1,3
85851,1,3,300487,300487,300490,0,3,0
85852,6,2,300493,300493,300495,0,2,3
85853,1,3,300494,300495,300498,1,4,0
85854,2,3,300496,300498,300501,2,5,0
85855,1,1,300497,300501,300502,4,5,0
85856,5,2,300502,300502,300504,0,2,0
85857,5,1,300507,300507,300508,0,1,3
85858,2,1,300509,300509,300510,0,1,1
85859,3,3,300512,300512,300515,0,3,2
85860,6,1,300518,300518,300519,0,1,3
85861,5,1,300523,300523,300524,0,1,4
85862,3,2,300526,300526,300528,0,2,2
85863,3,2,300529,300529,300531,0,2,1
85864,2,3,300531,300531,300534,0,3,0
85865,2,3,300533,300534,300537,1,4,0
85866,3,1,300536,300537,300538,1,2,0
85867,5,2,300541,300541,300543,0,2,3
85868,4,2,300545,300545,300547,0,2,2
85869,3,2,300548,300548,300550,0,2,1
85870,3,1,300551,300551,300552,0,1,1
85871,2,2,300553,300553,300555,0,2,1
85872,3,3,300556,300556,300559,0,3,1
85873,5,1,300561,300561,300562,0,1,2
85874,6,1,300567,300567,300568,0,1,5
85875,3,1,300570,300570,300571,0,1,2
85876,1,2,300571,300571,300573,0,2,0
85877,2,3,300573,300573,300576,0,3,0
85878,1,1,300574,300576,300577,2,3,0
85879,3,3,300577,300577,300580,0,3,0
85880,6,2,300583,300583,300585,0,2,3
85881,5,1,300588,300588,300589,0,1,3
85882,5,3,300593,300593,300596,0,3,4
85883,5,1,300598,300598,300599,0,1,2
85884,6,3,300604,300604,300607,0,3,5
85885,6,1,300610,300610,300611,0,1,3
85886,6,1,300616,300616,300617,0,1,5
85887,4,1,300620,300620,300621,0,1,3
85888,1,3,300621,300621,300624,0,3,0
85889,1,2,300622,300624,300626,2,4,0
85890,2,3,300624,300626,300629,2,5,0
85891,1,2,300625,300629,300631,4,6,0
85892,6,2,300631,300631,300633,0,2,0
85893,4,1,300635,300635,300636,0,1,2
85894,3,2,300638,300638,300640,0,2,2
85895,4,2,300642,300642,300644,0,2,2
85896,1,2,300643,300644,300646,1,3,0
85897,1,1,300644,300646,300647,2,3,0
85898,2,3,300646,300647,300650,1,4,0
85899,6,1,300652,300652,300653,0,1,2
85900,1,3,300653,300653,300656,0,3,0
85901,1,2,300654,300656,300658,2,4,0
85902,5,2,300659,300659,300661,0,2,1
85903,3,3,300662,300662,300665,0,3,1
85904,3,2,300665,300665,300667,0,2,0
85905,2,2,300667,300667,300669,0,2,0
85906,5,1,300672,300672,300673,0,1,3
85907,5,3,300677,300677,300680,0,3,4
85908,6,3,300683,300683,300686,0,3,3
85909,2,2,300685,300686,300688,1,3,0
85910,4,1,300689,300689,300690,0,1,1
85911,2,1,300691,300691,300692,0,1,1
85912,5,3,300696,300696,300699,0,3,4
85913,2,3,300698,300699,300702,1,4,0
85914,2,1,300700,300702,300703,2,3,0
85915,6,1,300706,300706,300707,0,1,3
85916,6,1,300712,300712,300713,0,1,5
85917,5,3,300717,300717,300720,0,3,4
85918,1,2,300718,300720,300722,2,4,0
85919,6,3,300724,300724,300727,0,3,2
85920,5,2,300729,300729,300731,0,2,2
85921,1,2,300730,300731,300733,1,3,0
85922,6,1,300736,300736,300737,0,1,3
85923,3,1,300739,300739,300740,0,1,2
85924,4,1,300743,300743,300744,0,1,3
85925,4,1,300747,300747,300748,0,1,3
85926,3,2,300750,300750,300752,0,2,2
85927,5,1,300755,300755,300756,0,1,3
85928,1,2,300756,300756,300758,0,2,0
85929,2,1,300758,300758,300759,0,1,0
85930,5,1,300763,300763,300764,0,1,4
85931,3,1,300766,300766,300767,0,1,2
85932,3,1,300769,300769,300770,0,1,2
85933,6,3,300775,300775,300778,0,3,5
85934,5,1,300780,300780,300781,0,1,2
85935,4,1,300784,300784,300785,0,1,3
85936,5,3,300789,300789,300792,0,3,4
85937,2,1,300791,300792,300793,1,2,0
85938,2,2,300793,300793,300795,0,2,0
85939,6,2,300799,300799,300801,0,2,4
85940,1,1,300800,300801,300802,1,2,0
85941,3,1,300803,300803,300804,0,1,1
85942,1,1,300804,300804,300805,0,1,0
85943,3,2,300807,300807,300809,0,2,2
85944,6,2,300813,300813,300815,0,2,4
85945,2,2,300815,300815,300817,0,2,0
85946,4,3,300819,300819,300822,0,3,2
85947,6,2,300825,300825,300827,0,2,3
85948,4,3,300829,300829,300832,0,3,2
85949,4,1,300833,300833,300834,0,1,1
85950,3,2,300836,300836,300838,0,2,2
85951,1,2,300837,300838,300840,1,3,0
85952,2,2,300839,300840,300842,1,3,0
85953,2,2,300841,300842,300844,1,3,0
85954,6,2,300847,300847,300849,0,2,3
85955,1,2,300848,300849,300851,1,3,0
85956,1,2,300849,300851,300853,2,4,0
85957,6,2,300855,300855,300857,0,2,2
85958,1,3,300856,300857,300860,1,4,0
85959,5,3,300861,300861,300864,0,3,1
85960,1,1,300862,300864,300865,2,3,0
85961,3,1,300865,300865,300866,0,1,0
85962,5,1,300870,300870,300871,0,1,4
85963,4,1,300874,300874,300875,0,1,3
85964,4,2,300878,300878,300880,0,2,3
85965,5,1,300883,300883,300884,0,1,3
85966,4,1,300887,300887,300888,0,1,3
85967,3,2,300890,300890,300892,0,2,2
85968,4,2,300894,300894,300896,0,2,2
85969,6,2,300900,300900,300902,0,2,4
85970,4,2,300904,300904,300906,0,2,2
85971,2,1,300906,300906,300907,0,1,0
85972,1,1,300907,300907,300908,0,1,0
85973,1,1,300908,300908,300909,0,1,0
85974,4,2,300912,300912,300914,0,2,3
85975,4,3,300916,300916,300919,0,3,2
85976,2,2,300918,300919,300921,1,3,0
85977,6,2,300924,300924,300926,0,2,3
85978,2,1,300926,300926,300927,0,1,0
85979,2,3,300928,300928,300931,0,3,1
85980,2,2,300930,300931,300933,1,3,0
85981,5,3,300935,300935,300938,0,3,2
85982,3,1,300938,300938,300939,0,1,0
85983,2,2,300940,300940,300942,0,2,1
85984,6,2,300946,300946,300948,0,2,4
85985,1,1,300947,300948,300949,1,2,0
85986,5,1,300952,300952,300953,0,1,3
85987,5,2,300957,300957,300959,0,2,4
85988,1,3,300958,300959,300962,1,4,0
85989,3,3,300961,300962,300965,1,4,0
85990,2,2,300963,300965,300967,2,4,0
85991,2,2,300965,300967,300969,2,4,0
85992,5,1,300970,300970,300971,0,1,1
85993,2,1,300972,300972,300973,0,1,1
85994,5,3,300977,300977,300980,0,3,4
85995,4,2,300981,300981,300983,0,2,1
85996,6,3,300987,300987,300990,0,3,4
85997,3,3,300990,300990,300993,0,3,0
85998,5,3,300995,300995,300998,0,3,2
85999,2,2,300997,300998,301000,1,3,0
86000,3,3,301000,301000,301003,0,3,0
86001,2,1,301002,301003,301004,1,2,0
86002,3,1,301005,301005,301006,0,1,1
86003,4,2,301009,301009,301011,0,2,3
86004,6,1,301015,301015,301016,0,1,4
86005,1,3,301016,301016,301019,0,3,0
86006,4,2,301020,301020,301022,0,2,1
86007,1,3,301021,301022,301025,1,4,0
86008,5,3,301026,301026,301029,0,3,1
86009,4,2,301030,301030,301032,0,2,1
86010,1,1,301031,301032,301033,1,2,0
86011,2,3,301033,301033,301036,0,3,0
86012,5,1,301038,301038,301039,0,1,2
86013,4,3,301042,301042,301045,0,3,3
86014,1,3,301043,301045,301048,2,5,0
86015,3,2,301046,301048,301050,2,4,0
86016,2,1,301048,301050,301051,2,3,0
86017,4,1,301052,301052,301053,0,1,1
86018,4,1,301056,301056,301057,0,1,3
86019,2,1,301058,301058,301059,0,1,1
86020,2,2,301060,301060,301062,0,2,1
86021,5,1,301065,301065,301066,0,1,3
86022,5,1,301070,301070,301071,0,1,4
86023,4,1,301074,301074,301075,0,1,3
86024,1,2,301075,301075,301077,0,2,0
86025,3,2,301078,301078,301080,0,2,1
86026,2,3,301080,301080,301083,0,3,0
86027,4,1,301084,301084,301085,0,1,1
86028,6,1,301090,301090,301091,0,1,5
86029,4,2,301094,301094,301096,0,2,3
86030,5,1,301099,301099,301100,0,1,3
86031,1,2,301100,301100,301102,0,2,0
86032,5,1,301105,301105,301106,0,1,3
86033,1,2,301106,301106,301108,0,2,0
86034,3,1,301109,301109,301110,0,1,1
86035,2,3,301111,301111,301114,0,3,1
86036,3,3,301114,301114,301117,0,3,0
86037,1,2,301115,301117,301119,2,4,0
86038,2,1,301117,301119,301120,2,3,0
86039,5,1,301122,301122,301123,0,1,2
86040,6,2,301128,301128,301130,0,2,5
86041,5,1,301133,301133,301134,0,1,3
86042,4,3,301137,301137,301140,0,3,3
86043,6,3,301143,301143,301146,0,3,3
86044,5,1,301148,301148,301149,0,1,2
86045,1,3,301149,301149,301152,0,3,0
86046,5,2,301154,301154,301156,0,2,2
86047,6,1,301160,301160,301161,0,1,4
86048,5,2,301165,301165,301167,0,2,4
86049,2,3,301167,301167,301170,0,3,0
86050,6,3,301173,301173,301176,0,3,3
86051,4,2,301177,301177,301179,0,2,1
86052,1,1,301178,301179,301180,1,2,0
86053,2,3,301180,301180,301183,0,3,0
86054,4,3,301184,301184,301187,0,3,1
86055,6,3,301190,301190,301193,0,3,3
86056,2,1,301192,301193,301194,1,2,0
86057,6,2,301198,301198,301200,0,2,4
86058,5,1,301203,301203,301204,0,1,3
86059,4,2,301207,301207,301209,0,2,3
86060,5,1,301212,301212,301213,0,1,3
86061,5,2,301217,301217,301219,0,2,4
86062,6,1,301223,301223,301224,0,1,4
86063,3,2,301226,301226,301228,0,2,2
86064,5,3,301231,301231,301234,0,3,3
86065,6,2,301237,301237,301239,0,2,3
86066,3,1,301240,301240,301241,0,1,1
86067,1,3,301241,301241,301244,0,3,0
86068,3,2,301244,301244,301246,0,2,0
86069,1,2,301245,301246,301248,1,3,0
86070,2,2,301247,301248,301250,1,3,0
86071,3,1,301250,301250,301251,0,1,0
86072,2,2,301252,301252,301254,0,2,1
86073,6,3,301258,301258,301261,0,3,4
86074,5,3,301263,301263,301266,0,3,2
86075,4,3,301267,301267,301270,0,3,1
86076,2,3,301269,301270,301273,1,4,0
86077,4,1,301273,301273,301274,0,1,0
86078,1,1,301274,301274,301275,0,1,0
86079,1,1,301275,301275,301276,0,1,0
86080,6,3,301281,301281,301284,0,3,5
86081,2,2,301283,301284,301286,1,3,0
86082,5,1,301288,301288,301289,0,1,2
86083,1,2,301289,301289,301291,0,2,0
86084,1,3,301290,301291,301294,1,4,0
86085,3,2,301293,301294,301296,1,3,0
86086,4,3,301297,301297,301300,0,3,1
86087,2,2,301299,301300,301302,1,3,0
86088,3,1,301302,301302,301303,0,1,0
86089,4,2,301306,301306,301308,0,2,3
86090,3,1,301309,301309,301310,0,1,1
86091,6,1,301315,301315,301316,0,1,5
86092,5,2,301320,301320,301322,0,2,4
86093,6,1,301326,301326,301327,0,1,4
86094,6,2,301332,301332,301334,0,2,5
86095,2,3,301334,301334,301337,0,3,0
86096,1,3,301335,301337,301340,2,5,0
86097,6,3,301341,301341,301344,0,3,1
86098,1,2,301342,301344,301346,2,4,0
86099,4,1,301346,301346,301347,0,1,0
86100,5,3,301351,301351,301354,0,3,4
86101,4,1,301355,301355,301356,0,1,1
86102,5,3,301360,301360,301363,0,3,4
86103,5,1,301365,301365,301366,0,1,2
86104,1,1,301366,301366,301367,0,1,0
86105,1,1,301367,301367,301368,0,1,0
86106,5,3,301372,301372,301375,0,3,4
86107,1,2,301373,301375,301377,2,4,0
86108,3,3,301376,301377,301380,1,4,0
86109,6,1,301382,301382,301383,0,1,2
86110,5,2,301387,301387,301389,0,2,4
86111,6,1,301393,301393,301394,0,1,4
86112,6,1,301399,301399,301400,0,1,5
86113,2,2,301401,301401,301403,0,2,1
86114,1,3,301402,301403,301406,1,4,0
86115,3,2,301405,301406,301408,1,3,0
86116,5,2,301410,301410,301412,0,2,2
86117,4,2,301414,301414,301416,0,2,2
86118,1,2,301415,301416,301418,1,3,0
86119,1,1,301416,301418,301419,2,3,0
86120,4,2,301420,301420,301422,0,2,1
86121,2,1,301422,301422,301423,0,1,0
86122,1,2,301423,301423,301425,0,2,0
86123,6,3,301429,301429,301432,0,3,4
86124,4,1,301433,301433,301434,0,1,1
86125,1,2,301434,301434,301436,0,2,0
86126,1,2,301435,301436,301438,1,3,0
86127,6,3,301441,301441,301444,0,3,3
86128,4,2,301445,301445,301447,0,2,1
86129,6,3,301451,301451,301454,0,3,4
86130,3,1,301454,301454,301455,0,1,0
86131,6,1,301460,301460,301461,0,1,5
86132,5,1,301465,301465,301466,0,1,4
86133,5,3,301470,301470,301473,0,3,4
86134,2,2,301472,301473,301475,1,3,0
86135,3,1,301475,301475,301476,0,1,0
86136,6,3,301481,301481,301484,0,3,5
86137,1,3,301482,301484,301487,2,5,0
86138,1,3,301483,301487,301490,4,7,0
86139,2,2,301485,301490,301492,5,7,0
86140,1,2,301486,301492,301494,6,8,0
86141,1,1,301487,301494,301495,7,8,0
86142,4,2,301491,301495,301497,4,6,0
86143,6,1,301497,301497,301498,0,1,0
86144,2,3,301499,301499,301502,0,3,1
86145,1,3,301500,301502,301505,2,5,0
86146,5,2,301505,301505,301507,0,2,0
86147,2,3,301507,301507,301510,0,3,0
86148,4,1,301511,301511,301512,0,1,1
86149,5,1,301516,301516,301517,0,1,4
86150,3,3,301519,301519,301522,0,3,2
86151,6,2,301525,301525,301527,0,2,3
86152,2,2,301527,301527,301529,0,2,0
86153,6,1,301533,301533,301534,0,1,4
86154,5,2,301538,301538,301540,0,2,4
86155,6,3,301544,301544,301547,0,3,4
86156,3,1,301547,301547,301548,0,1,0
86157,6,2,301553,301553,301555,0,2,5
86158,4,3,301557,301557,301560,0,3,2
86159,3,1,301560,301560,301561,0,1,0
86160,3,3,301563,301563,301566,0,3,2
86161,6,2,301569,301569,301571,0,2,3
86162,4,1,301573,301573,301574,0,1,2
86163,1,1,301574,301574,301575,0,1,0
86164,1,1,301575,301575,301576,0,1,0
86165,5,3,301580,301580,301583,0,3,4
86166,5,2,301585,301585,301587,0,2,2
86167,1,2,301586,301587,301589,1,3,0
86168,5,3,301591,301591,301594,0,3,2
86169,2,1,301593,301594,301595,1,2,0
86170,3,1,301596,301596,301597,0,1,1
86171,1,1,301597,301597,301598,0,1,0
86172,1,1,301598,301598,301599,0,1,0
86173,5,1,301603,301603,301604,0,1,4
86174,3,1,301606,301606,301607,0,1,2
86175,2,1,301608,301608,301609,0,1,1
86176,5,1,301613,301613,301614,0,1,4
86177,5,1,301618,301618,301619,0,1,4
86178,6,1,301624,301624,301625,0,1,5
86179,6,3,301630,301630,301633,0,3,5
86180,3,3,301633,301633,301636,0,3,0
86181,2,2,301635,301636,301638,1,3,0
86182,4,1,301639,301639,301640,0,1,1
86183,3,2,301642,301642,301644,0,2,2
86184,1,1,301643,301644,301645,1,2,0
86185,3,3,301646,301646,301649,0,3,1
86186,2,1,301648,301649,301650,1,2,0
86187,2,2,301650,301650,301652,0,2,0
86188,3,3,301653,301653,301656,0,3,1
86189,6,3,301659,301659,301662,0,3,3
86190,1,1,301660,301662,301663,2,3,0
86191,1,3,301661,301663,301666,2,5,0
86192,6,1,301667,301667,301668,0,1,1
86193,4,2,301671,301671,301673,0,2,3
86194,5,1,301676,301676,301677,0,1,3
86195,3,1,301679,301679,301680,0,1,2
86196,6,3,301685,301685,301688,0,3,5
86197,6,2,301691,301691,301693,0,2,3
86198,2,2,301693,301693,301695,0,2,0
86199,4,1,301697,301697,301698,0,1,2
86200,1,1,301698,301698,301699,0,1,0
86201,2,2,301700,301700,301702,0,2,1
86202,4,3,301704,301704,301707,0,3,2
86203,2,2,301706,301707,301709,1,3,0
86204,6,3,301712,301712,301715,0,3,3
86205,3,2,301715,301715,301717,0,2,0
86206,4,2,301719,301719,301721,0,2,2
86207,4,1,301723,301723,301724,0,1,2
86208,5,3,301728,301728,301731,0,3,4
86209,4,3,301732,301732,301735,0,3,1
86210,1,1,301733,301735,301736,2,3,0
86211,2,2,301735,301736,301738,1,3,0
86212,3,2,301738,301738,301740,0,2,0
86213,3,1,301741,301741,301742,0,1,1
86214,3,1,301744,301744,301745,0,1,2
86215,2,2,301746,301746,301748,0,2,1
86216,2,1,301748,301748,301749,0,1,0
86217,5,1,301753,301753,301754,0,1,4
86218,6,2,301759,301759,301761,0,2,5
86219,3,3,301762,301762,301765,0,3,1
86220,4,2,301766,301766,301768,0,2,1
86221,1,1,301767,301768,301769,1,2,0
86222,1,2,301768,301769,301771,1,3,0
86223,2,2,301770,301771,301773,1,3,0
86224,2,2,301772,301773,301775,1,3,0
86225,6,3,301778,301778,301781,0,3,3
86226,1,3,301779,301781,301784,2,5,0
86227,6,1,301785,301785,301786,0,1,1
86228,6,1,301791,301791,301792,0,1,5
86229,6,2,301797,301797,301799,0,2,5
86230,3,1,301800,301800,301801,0,1,1
86231,4,3,301804,301804,301807,0,3,3
86232,1,3,301805,301807,301810,2,5,0
86233,5,1,301810,301810,301811,0,1,0
86234,4,3,301814,301814,301817,0,3,3
86235,6,1,301820,301820,301821,0,1,3
86236,5,3,301825,301825,301828,0,3,4
86237,3,2,301828,301828,301830,0,2,0
86238,3,3,301831,301831,301834,0,3,1
86239,6,2,301837,301837,301839,0,2,3
86240,5,3,301842,301842,301845,0,3,3
86241,2,2,301844,301845,301847,1,3,0
86242,6,2,301850,301850,301852,0,2,3
86243,2,2,301852,301852,301854,0,2,0
86244,4,2,301856,301856,301858,0,2,2
86245,1,2,301857,301858,301860,1,3,0
86246,6,2,301863,301863,301865,0,2,3
86247,3,1,301866,301866,301867,0,1,1
86248,6,3,301872,301872,301875,0,3,5
86249,5,3,301877,301877,301880,0,3,2
86250,1,1,301878,301880,301881,2,3,0
86251,1,1,301879,301881,301882,2,3,0
86252,6,1,301885,301885,301886,0,1,3
86253,3,1,301888,301888,301889,0,1,2
86254,5,1,301893,301893,301894,0,1,4
86255,4,2,301897,301897,301899,0,2,3
86256,5,2,301902,301902,301904,0,2,3
86257,4,3,301906,301906,301909,0,3,2
86258,3,2,301909,301909,301911,0,2,0
86259,3,2,301912,301912,301914,0,2,1
86260,1,2,301913,301914,301916,1,3,0
86261,4,1,301917,301917,301918,0,1,1
86262,4,3,301921,301921,301924,0,3,3
86263,3,3,301924,301924,301927,0,3,0
86264,6,2,301930,301930,301932,0,2,3
86265,6,1,301936,301936,301937,0,1,4
86266,3,2,301939,301939,301941,0,2,2
86267,4,1,301943,301943,301944,0,1,2
86268,4,1,301947,301947,301948,0,1,3
86269,4,1,301951,301951,301952,0,1,3
86270,4,2,301955,301955,301957,0,2,3
86271,3,3,301958,301958,301961,0,3,1
86272,4,2,301962,301962,301964,0,2,1
86273,5,3,301967,301967,301970,0,3,3
86274,3,3,301970,301970,301973,0,3,0
86275,6,3,301976,301976,301979,0,3,3
86276,3,1,301979,301979,301980,0,1,0
86277,5,2,301984,301984,301986,0,2,4
86278,3,1,301987,301987,301988,0,1,1
86279,5,2,301992,301992,301994,0,2,4
86280,6,2,301998,301998,302000,0,2,4
86281,5,2,302003,302003,302005,0,2,3
86282,4,2,302007,302007,302009,0,2,2
86283,2,1,302009,302009,302010,0,1,0
86284,5,2,302014,302014,302016,0,2,4
86285,1,3,302015,302016,302019,1,4,0
86286,1,2,302016,302019,302021,3,5,0
86287,3,3,302019,302021,302024,2,5,0
86288,6,1,302025,302025,302026,0,1,1
86289,1,2,302026,302026,302028,0,2,0
86290,6,3,302032,302032,302035,0,3,4
86291,1,2,302033,302035,302037,2,4,0
86292,1,3,302034,302037,302040,3,6,0
86293,2,3,302036,302040,302043,4,7,0
86294,3,2,302039,302043,302045,4,6,0
86295,5,3,302044,302045,302048,1,4,0
86296,2,3,302046,302048,302051,2,5,0
86297,1,1,302047,302051,302052,4,5,0
86298,5,2,302052,302052,302054,0,2,0
86299,5,1,302057,302057,302058,0,1,3
86300,2,1,302059,302059,302060,0,1,1
86301,4,3,302063,302063,302066,0,3,3
86302,3,2,302066,302066,302068,0,2,0
86303,6,3,302072,302072,302075,0,3,4
86304,2,3,302074,302075,302078,1,4,0
86305,5,2,302079,302079,302081,0,2,1
86306,4,3,302083,302083,302086,0,3,2
86307,6,2,302089,302089,302091,0,2,3
86308,2,1,302091,302091,302092,0,1,0
86309,5,1,302096,302096,302097,0,1,4
86310,4,1,302100,302100,302101,0,1,3
86311,1,3,302101,302101,302104,0,3,0
86312,5,2,302106,302106,302108,0,2,2
86313,5,2,302111,302111,302113,0,2,3
86314,1,3,302112,302113,302116,1,4,0
86315,6,2,302118,302118,302120,0,2,2
86316,6,3,302124,302124,302127,0,3,4
86317,5,2,302129,302129,302131,0,2,2
86318,4,3,302133,302133,302136,0,3,2
86319,2,1,302135,302136,302137,1,2,0
86320,5,3,302140,302140,302143,0,3,3
86321,4,1,302144,302144,302145,0,1,1
86322,3,3,302147,302147,302150,0,3,2
86323,1,1,302148,302150,302151,2,3,0
86324,4,2,302152,302152,302154,0,2,1
86325,3,2,302155,302155,302157,0,2,1
86326,4,2,302159,302159,302161,0,2,2
86327,1,3,302160,302161,302164,1,4,0
86328,4,2,302164,302164,302166,0,2,0
86329,1,2,302165,302166,302168,1,3,0
86330,2,1,302167,302168,302169,1,2,0
86331,4,2,302171,302171,302173,0,2,2
86332,2,3,302173,302173,302176,0,3,0
86333,1,3,302174,302176,302179,2,5,0
86334,6,3,302180,302180,302183,0,3,1
86335,5,2,302185,302185,302187,0,2,2
86336,5,2,302190,302190,302192,0,2,3
86337,1,2,302191,302192,302194,1,3,0
86338,3,3,302194,302194,302197,0,3,0
86339,3,3,302197,302197,302200,0,3,0
86340,3,2,302200,302200,302202,0,2,0
86341,2,1,302202,302202,302203,0,1,0
86342,6,2,302208,302208,302210,0,2,5
86343,4,3,302212,302212,302215,0,3,2
86344,4,3,302216,302216,302219,0,3,1
86345,1,3,302217,302219,302222,2,5,0
86346,4,3,302221,302222,302225,1,4,0
86347,1,2,302222,302225,302227,3,5,0
86348,4,1,302226,302227,302228,1,2,0
86349,6,2,302232,302232,302234,0,2,4
86350,1,3,302233,302234,302237,1,4,0
86351,4,1,302237,302237,302238,0,1,0
86352,1,3,302238,302238,302241,0,3,0
86353,2,3,302240,302241,302244,1,4,0
86354,3,1,302243,302244,302245,1,2,0
86355,2,1,302245,302245,302246,0,1,0
86356,6,3,302251,302251,302254,0,3,5
86357,5,2,302256,302256,302258,0,2,2
86358,1,2,302257,302258,302260,1,3,0
86359,3,2,302260,302260,302262,0,2,0
86360,1,3,302261,302262,302265,1,4,0
86361,6,1,302267,302267,302268,0,1,2
86362,4,2,302271,302271,302273,0,2,3
86363,6,2,302277,302277,302279,0,2,4
86364,3,1,302280,302280,302281,0,1,1
86365,2,3,302282,302282,302285,0,3,1
86366,4,3,302286,302286,302289,0,3,1
86367,1,1,302287,302289,302290,2,3,0
86368,2,3,302289,302290,302293,1,4,0
86369,6,2,302295,302295,302297,0,2,2
86370,2,1,302297,302297,302298,0,1,0
86371,5,1,302302,302302,302303,0,1,4
86372,6,3,302308,302308,302311,0,3,5
86373,4,1,302312,302312,302313,0,1,1
86374,3,3,302315,302315,302318,0,3,2
86375,1,1,302316,302318,302319,2,3,0
86376,2,1,302318,302319,302320,1,2,0
86377,3,1,302321,302321,302322,0,1,1
86378,5,2,302326,302326,302328,0,2,4
86379,2,2,302328,302328,302330,0,2,0
86380,6,2,302334,302334,302336,0,2,4
86381,1,2,302335,302336,302338,1,3,0
86382,6,1,302341,302341,302342,0,1,3
86383,5,1,302346,302346,302347,0,1,4
86384,5,3,302351,302351,302354,0,3,4
86385,2,2,302353,302354,302356,1,3,0
86386,4,2,302357,302357,302359,0,2,1
86387,6,3,302363,302363,302366,0,3,4
86388,1,3,302364,302366,302369,2,5,0
86389,6,2,302370,302370,302372,0,2,1
86390,6,2,302376,302376,302378,0,2,4
86391,2,3,302378,302378,302381,0,3,0
86392,6,2,302384,302384,302386,0,2,3
86393,1,2,302385,302386,302388,1,3,0
86394,1,3,302386,302388,302391,2,5,0
86395,1,2,302387,302391,302393,4,6,0
86396,1,2,302388,302393,302395,5,7,0
86397,3,2,302391,302395,302397,4,6,0
86398,3,1,302394,302397,302398,3,4,0
86399,2,1,302396,302398,302399,2,3,0
86400,2,1,302398,302399,302400,1,2,0
86401,6,1,302404,302404,302405,0,1,4
86402,4,1,302408,302408,302409,0,1,3
86403,2,1,302410,302410,302411,0,1,1
86404,2,2,302412,302412,302414,0,2,1
86405,3,3,302415,302415,302418,0,3,1
86406,5,3,302420,302420,302423,0,3,2
86407,3,3,302423,302423,302426,0,3,0
86408,4,2,302427,302427,302429,0,2,1
86409,6,1,302433,302433,302434,0,1,4
86410,6,3,302439,302439,302442,0,3,5
86411,6,2,302445,302445,302447,0,2,3
86412,3,1,302448,302448,302449,0,1,1
86413,4,1,302452,302452,302453,0,1,3
86414,5,3,302457,302457,302460,0,3,4
86415,4,2,302461,302461,302463,0,2,1
86416,3,2,302464,302464,302466,0,2,1
86417,6,3,302470,302470,302473,0,3,4
86418,2,2,302472,302473,302475,1,3,0
86419,4,2,302476,302476,302478,0,2,1
86420,5,1,302481,302481,302482,0,1,3
86421,3,1,302484,302484,302485,0,1,2
86422,6,1,302490,302490,302491,0,1,5
86423,3,1,302493,302493,302494,0,1,2
86424,3,3,302496,302496,302499,0,3,2
86425,3,2,302499,302499,302501,0,2,0
86426,6,2,302505,302505,302507,0,2,4
86427,2,2,302507,302507,302509,0,2,0
86428,1,3,302508,302509,302512,1,4,0
86429,1,1,302509,302512,302513,3,4,0
86430,6,3,302515,302515,302518,0,3,2
86431,2,3,302517,302518,302521,1,4,0
86432,3,1,302520,302521,302522,1,2,0
86433,4,2,302524,302524,302526,0,2,2
86434,2,1,302526,302526,302527,0,1,0
86435,3,2,302529,302529,302531,0,2,2
86436,3,3,302532,302532,302535,0,3,1
86437,1,3,302533,302535,302538,2,5,0
86438,1,3,302534,302538,302541,4,7,0
86439,6,2,302540,302541,302543,1,3,0
86440,6,2,302546,302546,302548,0,2,3
86441,1,3,302547,302548,302551,1,4,0
86442,3,2,302550,302551,302553,1,3,0
86443,5,1,302555,302555,302556,0,1,2
86444,5,2,302560,302560,302562,0,2,4
86445,3,1,302563,302563,302564,0,1,1
86446,4,3,302567,302567,302570,0,3,3
86447,5,2,302572,302572,302574,0,2,2
86448,1,1,302573,302574,302575,1,2,0
86449,3,2,302576,302576,302578,0,2,1
86450,4,1,302580,302580,302581,0,1,2
86451,5,3,302585,302585,302588,0,3,4
86452,1,3,302586,302588,302591,2,5,0
86453,3,1,302589,302591,302592,2,3,0
86454,6,1,302595,302595,302596,0,1,3
86455,1,1,302596,302596,302597,0,1,0
86456,6,2,302602,302602,302604,0,2,5
86457,5,2,302607,302607,302609,0,2,3
86458,1,1,302608,302609,302610,1,2,0
86459,3,3,302611,302611,302614,0,3,1
86460,4,2,302615,302615,302617,0,2,1
86461,5,1,302620,302620,302621,0,1,3
86462,3,1,302623,302623,302624,0,1,2
86463,4,1,302627,302627,302628,0,1,3
86464,4,3,302631,302631,302634,0,3,3
86465,4,3,302635,302635,302638,0,3,1
86466,6,2,302641,302641,302643,0,2,3
86467,4,3,302645,302645,302648,0,3,2
86468,4,3,302649,302649,302652,0,3,1
86469,6,2,302655,302655,302657,0,2,3
86470,6,1,302661,302661,302662,0,1,4
86471,1,1,302662,302662,302663,0,1,0
86472,5,2,302667,302667,302669,0,2,4
86473,6,2,302673,302673,302675,0,2,4
86474,1,2,302674,302675,302677,1,3,0
86475,5,1,302679,302679,302680,0,1,2
86476,1,1,302680,302680,302681,0,1,0
86477,5,2,302685,302685,302687,0,2,4
86478,5,2,302690,302690,302692,0,2,3
86479,4,1,302694,302694,302695,0,1,2
86480,6,3,302700,302700,302703,0,3,5
86481,4,2,302704,302704,302706,0,2,1
86482,3,1,302707,302707,302708,0,1,1
86483,5,2,302712,302712,302714,0,2,4
86484,4,3,302716,302716,302719,0,3,2
86485,6,1,302722,302722,302723,0,1,3
86486,6,1,302728,302728,302729,0,1,5
86487,5,2,302733,302733,302735,0,2,4
86488,2,3,302735,302735,302738,0,3,0
86489,5,3,302740,302740,302743,0,3,2
86490,5,2,302745,302745,302747,0,2,2
86491,2,3,302747,302747,302750,0,3,0
86492,3,1,302750,302750,302751,0,1,0
86493,3,1,302753,302753,302754,0,1,2
86494,5,3,302758,302758,302761,0,3,4
86495,3,2,302761,302761,302763,0,2,0
86496,4,2,302765,302765,302767,0,2,2
86497,5,3,302770,302770,302773,0,3,3
86498,5,1,302775,302775,302776,0,1,2
86499,2,1,302777,302777,302778,0,1,1
86500,5,3,302782,302782,302785,0,3,4
86501,5,2,302787,302787,302789,0,2,2
86502,2,2,302789,302789,302791,0,2,0
86503,6,2,302795,302795,302797,0,2,4
86504,6,3,302801,302801,302804,0,3,4
86505,2,2,302803,302804,302806,1,3,0
86506,3,2,302806,302806,302808,0,2,0
86507,2,1,302808,302808,302809,0,1,0
86508,5,1,302813,302813,302814,0,1,4
86509,2,3,302815,302815,302818,0,3,1
86510,1,1,302816,302818,302819,2,3,0
86511,6,1,302822,302822,302823,0,1,3
86512,5,1,302827,302827,302828,0,1,4
86513,1,3,302828,302828,302831,0,3,0
86514,5,3,302833,302833,302836,0,3,2
86515,5,1,302838,302838,302839,0,1,2
86516,4,2,302842,302842,302844,0,2,3
86517,5,3,302847,302847,302850,0,3,3
86518,6,1,302853,302853,302854,0,1,3
86519,1,2,302854,302854,302856,0,2,0
86520,3,2,302857,302857,302859,0,2,1
86521,6,1,302863,302863,302864,0,1,4
86522,4,1,302867,302867,302868,0,1,3
86523,4,3,302871,302871,302874,0,3,3
86524,4,3,302875,302875,302878,0,3,1
86525,1,1,302876,302878,302879,2,3,0
86526,1,2,302877,302879,302881,2,4,0
86527,6,1,302883,302883,302884,0,1,2
86528,2,2,302885,302885,302887,0,2,1
86529,4,1,302889,302889,302890,0,1,2
86530,1,3,302890,302890,302893,0,3,0
86531,5,3,302895,302895,302898,0,3,2
86532,4,3,302899,302899,302902,0,3,1
86533,4,3,302903,302903,302906,0,3,1
86534,4,3,302907,302907,302910,0,3,1
86535,1,1,302908,302910,302911,2,3,0
86536,1,3,302909,302911,302914,2,5,0
86537,4,1,302913,302914,302915,1,2,0
86538,5,2,302918,302918,302920,0,2,3
86539,1,2,302919,302920,302922,1,3,0
86540,6,2,302925,302925,302927,0,2,3
86541,4,2,302929,302929,302931,0,2,2
86542,5,1,302934,302934,302935,0,1,3
86543,5,3,302939,302939,302942,0,3,4
86544,3,2,302942,302942,302944,0,2,0
86545,4,3,302946,302946,302949,0,3,2
86546,5,2,302951,302951,302953,0,2,2
86547,5,3,302956,302956,302959,0,3,3
86548,5,3,302961,302961,302964,0,3,2
86549,4,3,302965,302965,302968,0,3,1
86550,4,1,302969,302969,302970,0,1,1
86551,4,3,302973,302973,302976,0,3,3
86552,2,1,302975,302976,302977,1,2,0
86553,3,3,302978,302978,302981,0,3,1
86554,2,3,302980,302981,302984,1,4,0
86555,1,3,302981,302984,302987,3,6,0
86556,2,1,302983,302987,302988,4,5,0
86557,6,1,302989,302989,302990,0,1,1
86558,3,1,302992,302992,302993,0,1,2
86559,2,1,302994,302994,302995,0,1,1
86560,4,2,302998,302998,303000,0,2,3
86561,4,3,303002,303002,303005,0,3,2
86562,5,3,303007,303007,303010,0,3,2
86563,1,3,303008,303010,303013,2,5,0
86564,6,3,303014,303014,303017,0,3,1
86565,5,3,303019,303019,303022,0,3,2
86566,2,1,303021,303022,303023,1,2,0
86567,3,3,303024,303024,303027,0,3,1
86568,3,2,303027,303027,303029,0,2,0
86569,3,3,303030,303030,303033,0,3,1
86570,6,3,303036,303036,303039,0,3,3
86571,1,1,303037,303039,303040,2,3,0
86572,3,3,303040,303040,303043,0,3,0
86573,4,2,303044,303044,303046,0,2,1
86574,6,3,303050,303050,303053,0,3,4
86575,3,2,303053,303053,303055,0,2,0
86576,2,2,303055,303055,303057,0,2,0
86577,1,3,303056,303057,303060,1,4,0
86578,6,3,303062,303062,303065,0,3,2
86579,4,1,303066,303066,303067,0,1,1
86580,1,2,303067,303067,303069,0,2,0
86581,6,1,303073,303073,303074,0,1,4
86582,2,3,303075,303075,303078,0,3,1
86583,1,2,303076,303078,303080,2,4,0
86584,2,1,303078,303080,303081,2,3,0
86585,1,2,303079,303081,303083,2,4,0
86586,1,3,303080,303083,303086,3,6,0
86587,6,3,303086,303086,303089,0,3,0
86588,2,1,303088,303089,303090,1,2,0
86589,2,1,303090,303090,303091,0,1,0
86590,1,3,303091,303091,303094,0,3,0
86591,6,1,303097,303097,303098,0,1,3
86592,2,1,303099,303099,303100,0,1,1
86593,1,1,303100,303100,303101,0,1,0
86594,2,1,303102,303102,303103,0,1,1
86595,6,1,303108,303108,303109,0,1,5
86596,4,1,303112,303112,303113,0,1,3
86597,5,3,303117,303117,303120,0,3,4
86598,3,2,303120,303120,303122,0,2,0
86599,5,2,303125,303125,303127,0,2,3
86600,4,1,303129,303129,303130,0,1,2
86601,4,3,303133,303133,303136,0,3,3
86602,5,3,303138,303138,303141,0,3,2
86603,4,1,303142,303142,303143,0,1,1
86604,2,1,303144,303144,303145,0,1,1
86605,5,1,303149,303149,303150,0,1,4
86606,3,2,303152,303152,303154,0,2,2
86607,3,1,303155,303155,303156,0,1,1
86608,2,3,303157,303157,303160,0,3,1
86609,6,1,303163,303163,303164,0,1,3
86610,2,2,303165,303165,303167,0,2,1
86611,3,1,303168,303168,303169,0,1,1
86612,4,2,303172,303172,303174,0,2,3
86613,1,2,303173,303174,303176,1,3,0
86614,5,1,303178,303178,303179,0,1,2
86615,4,1,303182,303182,303183,0,1,3
86616,1,2,303183,303183,303185,0,2,0
86617,6,1,303189,303189,303190,0,1,4
86618,6,3,303195,303195,303198,0,3,5
86619,6,1,303201,303201,303202,0,1,3
86620,5,3,303206,303206,303209,0,3,4
86621,4,3,303210,303210,303213,0,3,1
86622,1,2,303211,303213,303215,2,4,0
86623,2,2,303213,303215,303217,2,4,0
86624,1,1,303214,303217,303218,3,4,0
86625,2,2,303216,303218,303220,2,4,0
86626,3,1,303219,303220,303221,1,2,0
86627,3,2,303222,303222,303224,0,2,1
86628,3,2,303225,303225,303227,0,2,1
86629,5,3,303230,303230,303233,0,3,3
86630,2,2,303232,303233,303235,1,3,0
86631,5,2,303237,303237,303239,0,2,2
86632,1,1,303238,303239,303240,1,2,0
86633,4,3,303242,303242,303245,0,3,2
86634,2,2,303244,303245,303247,1,3,0
86635,3,1,303247,303247,303248,0,1,0
86636,3,2,303250,303250,303252,0,2,2
86637,5,1,303255,303255,303256,0,1,3
86638,6,2,303261,303261,303263,0,2,5
86639,6,1,303267,303267,303268,0,1,4
86640,1,2,303268,303268,303270,0,2,0
86641,4,2,303272,303272,303274,0,2,2
86642,4,3,303276,303276,303279,0,3,2
86643,5,1,303281,303281,303282,0,1,2
86644,4,2,303285,303285,303287,0,2,3
86645,6,3,303291,303291,303294,0,3,4
86646,1,3,303292,303294,303297,2,5,0
86647,5,1,303297,303297,303298,0,1,0
86648,1,3,303298,303298,303301,0,3,0
86649,1,2,303299,303301,303303,2,4,0
86650,4,3,303303,303303,303306,0,3,0
86651,4,3,303307,303307,303310,0,3,1
86652,2,2,303309,303310,303312,1,3,0
86653,3,1,303312,303312,303313,0,1,0
86654,3,3,303315,303315,303318,0,3,2
86655,3,1,303318,303318,303319,0,1,0
86656,4,3,303322,303322,303325,0,3,3
86657,2,2,303324,303325,303327,1,3,0
86658,6,3,303330,303330,303333,0,3,3
86659,3,1,303333,303333,303334,0,1,0
86660,4,1,303337,303337,303338,0,1,3
86661,1,1,303338,303338,303339,0,1,0
86662,2,3,303340,303340,303343,0,3,1
86663,4,2,303344,303344,303346,0,2,1
86664,1,1,303345,303346,303347,1,2,0
86665,2,3,303347,303347,303350,0,3,0
86666,4,3,303351,303351,303354,0,3,1
86667,3,2,303354,303354,303356,0,2,0
86668,5,1,303359,303359,303360,0,1,3
86669,4,2,303363,303363,303365,0,2,3
86670,6,3,303369,303369,303372,0,3,4
86671,4,2,303373,303373,303375,0,2,1
86672,4,1,303377,303377,303378,0,1,2
86673,1,3,303378,303378,303381,0,3,0
86674,6,1,303384,303384,303385,0,1,3
86675,4,3,303388,303388,303391,0,3,3
86676,4,1,303392,303392,303393,0,1,1
86677,6,3,303398,303398,303401,0,3,5
86678,6,2,303404,303404,303406,0,2,3
86679,6,2,303410,303410,303412,0,2,4
86680,4,2,303414,303414,303416,0,2,2
86681,1,2,303415,303416,303418,1,3,0
86682,6,1,303421,303421,303422,0,1,3
86683,5,1,303426,303426,303427,0,1,4
86684,6,3,303432,303432,303435,0,3,5
86685,5,1,303437,303437,303438,0,1,2
86686,2,2,303439,303439,303441,0,2,1
86687,1,1,303440,303441,303442,1,2,0
86688,6,1,303446,303446,303447,0,1,4
86689,3,2,303449,303449,303451,0,2,2
86690,4,1,303453,303453,303454,0,1,2
86691,1,1,303454,303454,303455,0,1,0
86692,1,3,303455,303455,303458,0,3,0
86693,6,3,303461,303461,303464,0,3,3
86694,6,1,303467,303467,303468,0,1,3
86695,3,2,303470,303470,303472,0,2,2
86696,1,2,303471,303472,303474,1,3,0
86697,2,2,303473,303474,303476,1,3,0
86698,6,3,303479,303479,303482,0,3,3
86699,1,1,303480,303482,303483,2,3,0
86700,5,1,303485,303485,303486,0,1,2
86701,5,2,303490,303490,303492,0,2,4
86702,3,1,303493,303493,303494,0,1,1
86703,5,3,303498,303498,303501,0,3,4
86704,6,1,303504,303504,303505,0,1,3
86705,6,1,303510,303510,303511,0,1,5
86706,2,2,303512,303512,303514,0,2,1
86707,6,2,303518,303518,303520,0,2,4
86708,6,2,303524,303524,303526,0,2,4
86709,1,2,303525,303526,303528,1,3,0
86710,3,2,303528,303528,303530,0,2,0
86711,3,3,303531,303531,303534,0,3,1
86712,5,3,303536,303536,303539,0,3,2
86713,3,2,303539,303539,303541,0,2,0
86714,6,2,303545,303545,303547,0,2,4
86715,5,3,303550,303550,303553,0,3,3
86716,5,1,303555,303555,303556,0,1,2
86717,6,3,303561,303561,303564,0,3,5
86718,6,1,303567,303567,303568,0,1,3
86719,4,3,303571,303571,303574,0,3,3
86720,3,2,303574,303574,303576,0,2,0
86721,1,2,303575,303576,303578,1,3,0
86722,4,1,303579,303579,303580,0,1,1
86723,1,3,303580,303580,303583,0,3,0
86724,2,1,303582,303583,303584,1,2,0
86725,3,3,303585,303585,303588,0,3,1
86726,2,3,303587,303588,303591,1,4,0
86727,3,3,303590,303591,303594,1,4,0
86728,5,1,303595,303595,303596,0,1,1
86729,6,1,303601,303601,303602,0,1,5
86730,2,2,303603,303603,303605,0,2,1
86731,3,2,303606,303606,303608,0,2,1
86732,4,3,303610,303610,303613,0,3,2
86733,1,2,303611,303613,303615,2,4,0
86734,5,3,303616,303616,303619,0,3,1
86735,5,3,303621,303621,303624,0,3,2
86736,6,2,303627,303627,303629,0,2,3
86737,4,2,303631,303631,303633,0,2,2
86738,6,1,303637,303637,303638,0,1,4
86739,3,3,303640,303640,303643,0,3,2
86740,2,2,303642,303643,303645,1,3,0
86741,3,1,303645,303645,303646,0,1,0
86742,4,3,303649,303649,303652,0,3,3
86743,5,1,303654,303654,303655,0,1,2
86744,1,2,303655,303655,303657,0,2,0
86745,3,1,303658,303658,303659,0,1,1
86746,2,1,303660,303660,303661,0,1,1
86747,3,1,303663,303663,303664,0,1,2
86748,2,2,303665,303665,303667,0,2,1
86749,4,2,303669,303669,303671,0,2,2
86750,1,1,303670,303671,303672,1,2,0
86751,2,2,303672,303672,303674,0,2,0
86752,3,3,303675,303675,303678,0,3,1
86753,6,1,303681,303681,303682,0,1,3
86754,3,2,303684,303684,303686,0,2,2
86755,1,1,303685,303686,303687,1,2,0
86756,1,3,303686,303687,303690,1,4,0
86757,3,1,303689,303690,303691,1,2,0
86758,3,1,303692,303692,303693,0,1,1
86759,6,1,303698,303698,303699,0,1,5
86760,2,2,303700,303700,303702,0,2,1
86761,4,2,303704,303704,303706,0,2,2
86762,6,1,303710,303710,303711,0,1,4
86763,1,2,303711,303711,303713,0,2,0
86764,2,1,303713,303713,303714,0,1,0
86765,6,1,303719,303719,303720,0,1,5
86766,4,1,303723,303723,303724,0,1,3
86767,1,1,303724,303724,303725,0,1,0
86768,1,2,303725,303725,303727,0,2,0
86769,4,2,303729,303729,303731,0,2,2
86770,3,2,303732,303732,303734,0,2,1
86771,6,3,303738,303738,303741,0,3,4
86772,5,1,303743,303743,303744,0,1,2
86773,5,1,303748,303748,303749,0,1,4
86774,1,2,303749,303749,303751,0,2,0
86775,6,2,303755,303755,303757,0,2,4
86776,6,2,303761,303761,303763,0,2,4
86777,4,2,303765,303765,303767,0,2,2
86778,2,2,303767,303767,303769,0,2,0
86779,3,1,303770,303770,303771,0,1,1
86780,1,2,303771,303771,303773,0,2,0
86781,6,2,303777,303777,303779,0,2,4
86782,1,3,303778,303779,303782,1,4,0
86783,3,2,303781,303782,303784,1,3,0
86784,1,2,303782,303784,303786,2,4,0
86785,3,3,303785,303786,303789,1,4,0
86786,6,3,303791,303791,303794,0,3,2
86787,1,2,303792,303794,303796,2,4,0
86788,2,1,303794,303796,303797,2,3,0
86789,4,2,303798,303798,303800,0,2,1
86790,2,1,303800,303800,303801,0,1,0
86791,4,3,303804,303804,303807,0,3,3
86792,2,2,303806,303807,303809,1,3,0
86793,4,3,303810,303810,303813,0,3,1
86794,2,3,303812,303813,303816,1,4,0
86795,2,1,303814,303816,303817,2,3,0
86796,4,2,303818,303818,303820,0,2,1
86797,2,1,303820,303820,303821,0,1,0
86798,1,1,303821,303821,303822,0,1,0
86799,5,2,303826,303826,303828,0,2,4
86800,3,3,303829,303829,303832,0,3,1
86801,4,2,303833,303833,303835,0,2,1
86802,5,1,303838,303838,303839,0,1,3
86803,6,3,303844,303844,303847,0,3,5
86804,4,2,303848,303848,303850,0,2,1
86805,5,3,303853,303853,303856,0,3,3
86806,4,2,303857,303857,303859,0,2,1
86807,6,2,303863,303863,303865,0,2,4
86808,4,1,303867,303867,303868,0,1,2
86809,4,1,303871,303871,303872,0,1,3
86810,4,2,303875,303875,303877,0,2,3
86811,4,2,303879,303879,303881,0,2,2
86812,4,1,303883,303883,303884,0,1,2
86813,3,1,303886,303886,303887,0,1,2
86814,4,3,303890,303890,303893,0,3,3
86815,3,1,303893,303893,303894,0,1,0
86816,1,3,303894,303894,303897,0,3,0
86817,6,1,303900,303900,303901,0,1,3
86818,1,2,303901,303901,303903,0,2,0
86819,2,3,303903,303903,303906,0,3,0
86820,5,2,303908,303908,303910,0,2,2
86821,4,2,303912,303912,303914,0,2,2
86822,6,2,303918,303918,303920,0,2,4
86823,4,1,303922,303922,303923,0,1,2
86824,1,3,303923,303923,303926,0,3,0
86825,2,1,303925,303926,303927,1,2,0
86826,1,2,303926,303927,303929,1,3,0
86827,4,1,303930,303930,303931,0,1,1
86828,3,3,303933,303933,303936,0,3,2
86829,2,2,303935,303936,303938,1,3,0
86830,2,3,303937,303938,303941,1,4,0
86831,5,2,303942,303942,303944,0,2,1
86832,3,2,303945,303945,303947,0,2,1
86833,3,1,303948,303948,303949,0,1,1
86834,3,2,303951,303951,303953,0,2,2
86835,2,2,303953,303953,303955,0,2,0
86836,3,1,303956,303956,303957,0,1,1
86837,1,2,303957,303957,303959,0,2,0
86838,3,3,303960,303960,303963,0,3,1
86839,6,2,303966,303966,303968,0,2,3
86840,1,3,303967,303968,303971,1,4,0
86841,5,1,303972,303972,303973,0,1,1
86842,1,3,303973,303973,303976,0,3,0
86843,2,2,303975,303976,303978,1,3,0
86844,4,2,303979,303979,303981,0,2,1
86845,1,2,303980,303981,303983,1,3,0
86846,3,2,303983,303983,303985,0,2,0
86847,3,2,303986,303986,303988,0,2,1
86848,1,3,303987,303988,303991,1,4,0
86849,5,3,303992,303992,303995,0,3,1
86850,6,2,303998,303998,304000,0,2,3
86851,2,2,304000,304000,304002,0,2,0
86852,3,1,304003,304003,304004,0,1,1
86853,3,2,304006,304006,304008,0,2,2
86854,2,2,304008,304008,304010,0,2,0
86855,4,1,304012,304012,304013,0,1,2
86856,4,2,304016,304016,304018,0,2,3
86857,6,2,304022,304022,304024,0,2,4
86858,3,2,304025,304025,304027,0,2,1
86859,1,3,304026,304027,304030,1,4,0
86860,4,3,304030,304030,304033,0,3,0
86861,1,2,304031,304033,304035,2,4,0
86862,3,3,304034,304035,304038,1,4,0
86863,6,1,304040,304040,304041,0,1,2
86864,6,3,304046,304046,304049,0,3,5
86865,4,3,304050,304050,304053,0,3,1
86866,1,2,304051,304053,304055,2,4,0
86867,2,2,304053,304055,304057,2,4,0
86868,3,3,304056,304057,304060,1,4,0
86869,6,1,304062,304062,304063,0,1,2
86870,1,1,304063,304063,304064,0,1,0
86871,6,2,304069,304069,304071,0,2,5
86872,1,3,304070,304071,304074,1,4,0
86873,5,1,304075,304075,304076,0,1,1
86874,6,2,304081,304081,304083,0,2,5
86875,5,1,304086,304086,304087,0,1,3
86876,6,2,304092,304092,304094,0,2,5
86877,3,2,304095,304095,304097,0,2,1
86878,2,1,304097,304097,304098,0,1,0
86879,1,1,304098,304098,304099,0,1,0
86880,4,2,304102,304102,304104,0,2,3
86881,4,3,304106,304106,304109,0,3,2
86882,2,3,304108,304109,304112,1,4,0
86883,3,2,304111,304112,304114,1,3,0
86884,6,2,304117,304117,304119,0,2,3
86885,5,3,304122,304122,304125,0,3,3
86886,6,3,304128,304128,304131,0,3,3
86887,4,3,304132,304132,304135,0,3,1
86888,3,2,304135,304135,304137,0,2,0
86889,3,2,304138,304138,304140,0,2,1
86890,4,3,304142,304142,304145,0,3,2
86891,6,3,304148,304148,304151,0,3,3
86892,1,2,304149,304151,304153,2,4,0
86893,3,3,304152,304153,304156,1,4,0
86894,5,3,304157,304157,304160,0,3,1
86895,4,1,304161,304161,304162,0,1,1
86896,1,2,304162,304162,304164,0,2,0
86897,6,3,304168,304168,304171,0,3,4
86898,3,2,304171,304171,304173,0,2,0
86899,1,1,304172,304173,304174,1,2,0
86900,4,2,304176,304176,304178,0,2,2
86901,4,1,304180,304180,304181,0,1,2
86902,6,2,304186,304186,304188,0,2,5
86903,3,2,304189,304189,304191,0,2,1
86904,5,1,304194,304194,304195,0,1,3
86905,5,3,304199,304199,304202,0,3,4
86906,2,2,304201,304202,304204,1,3,0
86907,1,3,304202,304204,304207,2,5,0
86908,3,3,304205,304207,304210,2,5,0
86909,4,3,304209,304210,304213,1,4,0
86910,6,1,304215,304215,304216,0,1,2
86911,1,2,304216,304216,304218,0,2,0
86912,6,3,304222,304222,304225,0,3,4
86913,1,1,304223,304225,304226,2,3,0
86914,2,2,304225,304226,304228,1,3,0
86915,6,3,304231,304231,304234,0,3,3
86916,2,3,304233,304234,304237,1,4,0
86917,4,2,304237,304237,304239,0,2,0
86918,4,2,304241,304241,304243,0,2,2
86919,6,2,304247,304247,304249,0,2,4
86920,3,3,304250,304250,304253,0,3,1
86921,5,2,304255,304255,304257,0,2,2
86922,6,2,304261,304261,304263,0,2,4
86923,3,1,304264,304264,304265,0,1,1
86924,5,1,304269,304269,304270,0,1,4
86925,2,3,304271,304271,304274,0,3,1
86926,4,3,304275,304275,304278,0,3,1
86927,1,2,304276,304278,304280,2,4,0
86928,2,1,304278,304280,304281,2,3,0
86929,3,2,304281,304281,304283,0,2,0
86930,1,2,304282,304283,304285,1,3,0
86931,3,1,304285,304285,304286,0,1,0
86932,1,1,304286,304286,304287,0,1,0
86933,3,2,304289,304289,304291,0,2,2
86934,5,2,304294,304294,304296,0,2,3
86935,4,1,304298,304298,304299,0,1,2
86936,6,2,304304,304304,304306,0,2,5
86937,6,3,304310,304310,304313,0,3,4
86938,1,1,304311,304313,304314,2,3,0
86939,6,1,304317,304317,304318,0,1,3
86940,5,1,304322,304322,304323,0,1,4
86941,4,3,304326,304326,304329,0,3,3
86942,1,3,304327,304329,304332,2,5,0
86943,5,1,304332,304332,304333,0,1,0
86944,1,3,304333,304333,304336,0,3,0
86945,6,2,304339,304339,304341,0,2,3
86946,4,2,304343,304343,304345,0,2,2
86947,6,1,304349,304349,304350,0,1,4
86948,6,2,304355,304355,304357,0,2,5
86949,5,1,304360,304360,304361,0,1,3
86950,3,3,304363,304363,304366,0,3,2
86951,4,1,304367,304367,304368,0,1,1
86952,1,3,304368,304368,304371,0,3,0
86953,5,2,304373,304373,304375,0,2,2
86954,4,1,304377,304377,304378,0,1,2
86955,4,1,304381,304381,304382,0,1,3
86956,1,1,304382,304382,304383,0,1,0
86957,4,3,304386,304386,304389,0,3,3
86958,2,2,304388,304389,304391,1,3,0
86959,2,2,304390,304391,304393,1,3,0
86960,6,1,304396,304396,304397,0,1,3
86961,2,3,304398,304398,304401,0,3,1
86962,1,3,304399,304401,304404,2,5,0
86963,3,3,304402,304404,304407,2,5,0
86964,4,2,304406,304407,304409,1,3,0
86965,3,1,304409,304409,304410,0,1,0
86966,2,3,304411,304411,304414,0,3,1
86967,6,3,304417,304417,304420,0,3,3
86968,4,2,304421,304421,304423,0,2,1
86969,6,1,304427,304427,304428,0,1,4
86970,5,3,304432,304432,304435,0,3,4
86971,5,2,304437,304437,304439,0,2,2
86972,5,3,304442,304442,304445,0,3,3
86973,5,1,304447,304447,304448,0,1,2
86974,3,1,304450,304450,304451,0,1,2
86975,2,2,304452,304452,304454,0,2,1
86976,6,2,304458,304458,304460,0,2,4
86977,6,1,304464,304464,304465,0,1,4
86978,4,1,304468,304468,304469,0,1,3
86979,1,1,304469,304469,304470,0,1,0
86980,2,1,304471,304471,304472,0,1,1
86981,2,2,304473,304473,304475,0,2,1
86982,1,1,304474,304475,304476,1,2,0
86983,1,3,304475,304476,304479,1,4,0
86984,6,1,304481,304481,304482,0,1,2
86985,1,2,304482,304482,304484,0,2,0
86986,2,2,304484,304484,304486,0,2,0
86987,1,2,304485,304486,304488,1,3,0
86988,1,1,304486,304488,304489,2,3,0
86989,2,1,304488,304489,304490,1,2,0
86990,5,1,304493,304493,304494,0,1,3
86991,1,1,304494,304494,304495,0,1,0
86992,3,2,304497,304497,304499,0,2,2
86993,4,2,304501,304501,304503,0,2,2
86994,1,3,304502,304503,304506,1,4,0
86995,4,1,304506,304506,304507,0,1,0
86996,2,2,304508,304508,304510,0,2,1
86997,1,1,304509,304510,304511,1,2,0
86998,3,3,304512,304512,304515,0,3,1
86999,4,1,304516,304516,304517,0,1,1
87000,3,2,304519,304519,304521,0,2,2
87001,1,2,304520,304521,304523,1,3,0
87002,2,2,304522,304523,304525,1,3,0
87003,1,3,304523,304525,304528,2,5,0
87004,1,3,304524,304528,304531,4,7,0
87005,2,1,304526,304531,304532,5,6,0
87006,1,3,304527,304532,304535,5,8,0
87007,1,2,304528,304535,304537,7,9,0
87008,4,3,304532,304537,304540,5,8,0
87009,6,3,304538,304540,304543,2,5,0
87010,5,3,304543,304543,304546,0,3,0
87011,5,3,304548,304548,304551,0,3,2
87012,5,2,304553,304553,304555,0,2,2
87013,6,1,304559,304559,304560,0,1,4
87014,2,1,304561,304561,304562,0,1,1
87015,3,1,304564,304564,304565,0,1,2
87016,4,3,304568,304568,304571,0,3,3
87017,6,2,304574,304574,304576,0,2,3
87018,5,2,304579,304579,304581,0,2,3
87019,1,2,304580,304581,304583,1,3,0
87020,2,2,304582,304583,304585,1,3,0
87021,4,2,304586,304586,304588,0,2,1
87022,4,1,304590,304590,304591,0,1,2
87023,2,3,304592,304592,304595,0,3,1
87024,5,1,304597,304597,304598,0,1,2
87025,2,1,304599,304599,304600,0,1,1
87026,2,1,304601,304601,304602,0,1,1
87027,3,2,304604,304604,304606,0,2,2
87028,4,1,304608,304608,304609,0,1,2
87029,2,2,304610,304610,304612,0,2,1
87030,4,3,304614,304614,304617,0,3,2
87031,2,2,304616,304617,304619,1,3,0
87032,3,1,304619,304619,304620,0,1,0
87033,2,3,304621,304621,304624,0,3,1
87034,6,2,304627,304627,304629,0,2,3
87035,4,1,304631,304631,304632,0,1,2
87036,2,1,304633,304633,304634,0,1,1
87037,1,2,304634,304634,304636,0,2,0
87038,1,1,304635,304636,304637,1,2,0
87039,5,3,304640,304640,304643,0,3,3
87040,4,2,304644,304644,304646,0,2,1
87041,3,1,304647,304647,304648,0,1,1
87042,3,2,304650,304650,304652,0,2,2
87043,1,2,304651,304652,304654,1,3,0
87044,3,1,304654,304654,304655,0,1,0
87045,5,2,304659,304659,304661,0,2,4
87046,5,3,304664,304664,304667,0,3,3
87047,5,2,304669,304669,304671,0,2,2
87048,5,2,304674,304674,304676,0,2,3
87049,6,1,304680,304680,304681,0,1,4
87050,2,1,304682,304682,304683,0,1,1
87051,2,1,304684,304684,304685,0,1,1
87052,3,3,304687,304687,304690,0,3,2
87053,1,3,304688,304690,304693,2,5,0
87054,1,3,304689,304693,304696,4,7,0
87055,2,1,304691,304696,304697,5,6,0
87056,3,3,304694,304697,304700,3,6,0
87057,5,2,304699,304700,304702,1,3,0
87058,5,3,304704,304704,304707,0,3,2
87059,4,2,304708,304708,304710,0,2,1
87060,6,1,304714,304714,304715,0,1,4
87061,1,2,304715,304715,304717,0,2,0
87062,5,3,304720,304720,304723,0,3,3
87063,3,1,304723,304723,304724,0,1,0
87064,2,2,304725,304725,304727,0,2,1
87065,6,3,304731,304731,304734,0,3,4
87066,4,3,304735,304735,304738,0,3,1
87067,3,3,304738,304738,304741,0,3,0
87068,2,2,304740,304741,304743,1,3,0
87069,5,1,304745,304745,304746,0,1,2
87070,5,1,304750,304750,304751,0,1,4
87071,2,3,304752,304752,304755,0,3,1
87072,1,2,304753,304755,304757,2,4,0
87073,5,3,304758,304758,304761,0,3,1
87074,5,1,304763,304763,304764,0,1,2
87075,3,2,304766,304766,304768,0,2,2
87076,3,1,304769,304769,304770,0,1,1
87077,3,1,304772,304772,304773,0,1,2
87078,4,2,304776,304776,304778,0,2,3
87079,5,1,304781,304781,304782,0,1,3
87080,5,3,304786,304786,304789,0,3,4
87081,3,2,304789,304789,304791,0,2,0
87082,3,2,304792,304792,304794,0,2,1
87083,3,1,304795,304795,304796,0,1,1
87084,3,1,304798,304798,304799,0,1,2
87085,5,1,304803,304803,304804,0,1,4
87086,5,2,304808,304808,304810,0,2,4
87087,2,3,304810,304810,304813,0,3,0
87088,5,3,304815,304815,304818,0,3,2
87089,6,2,304821,304821,304823,0,2,3
87090,1,2,304822,304823,304825,1,3,0
87091,2,1,304824,304825,304826,1,2,0
87092,3,1,304827,304827,304828,0,1,1
87093,3,3,304830,304830,304833,0,3,2
87094,2,2,304832,304833,304835,1,3,0
87095,6,2,304838,304838,304840,0,2,3
87096,3,1,304841,304841,304842,0,1,1
87097,1,1,304842,304842,304843,0,1,0
87098,5,2,304847,304847,304849,0,2,4
87099,3,2,304850,304850,304852,0,2,1
87100,2,2,304852,304852,304854,0,2,0
87101,6,2,304858,304858,304860,0,2,4
87102,3,3,304861,304861,304864,0,3,1
87103,5,3,304866,304866,304869,0,3,2
87104,4,1,304870,304870,304871,0,1,1
87105,3,1,304873,304873,304874,0,1,2
87106,3,3,304876,304876,304879,0,3,2
87107,1,3,304877,304879,304882,2,5,0
87108,6,1,304883,304883,304884,0,1,1
87109,5,2,304888,304888,304890,0,2,4
87110,2,1,304890,304890,304891,0,1,0
87111,6,1,304896,304896,304897,0,1,5
87112,1,2,304897,304897,304899,0,2,0
87113,2,1,304899,304899,304900,0,1,0
87114,6,1,304905,304905,304906,0,1,5
87115,4,1,304909,304909,304910,0,1,3
87116,2,1,304911,304911,304912,0,1,1
87117,4,1,304915,304915,304916,0,1,3
87118,2,2,304917,304917,304919,0,2,1
87119,6,1,304923,304923,304924,0,1,4
87120,2,2,304925,304925,304927,0,2,1
87121,4,2,304929,304929,304931,0,2,2
87122,3,3,304932,304932,304935,0,3,1
87123,2,1,304934,304935,304936,1,2,0
87124,3,2,304937,304937,304939,0,2,1
87125,2,3,304939,304939,304942,0,3,0
87126,6,1,304945,304945,304946,0,1,3
87127,2,2,304947,304947,304949,0,2,1
87128,4,3,304951,304951,304954,0,3,2
87129,2,2,304953,304954,304956,1,3,0
87130,5,1,304958,304958,304959,0,1,2
87131,4,3,304962,304962,304965,0,3,3
87132,2,1,304964,304965,304966,1,2,0
87133,4,1,304968,304968,304969,0,1,2
87134,6,3,304974,304974,304977,0,3,5
87135,1,3,304975,304977,304980,2,5,0
87136,6,1,304981,304981,304982,0,1,1
87137,1,3,304982,304982,304985,0,3,0
87138,4,3,304986,304986,304989,0,3,1
87139,4,1,304990,304990,304991,0,1,1
87140,5,2,304995,304995,304997,0,2,4
87141,1,1,304996,304997,304998,1,2,0
87142,1,2,304997,304998,305000,1,3,0
87143,6,1,305003,305003,305004,0,1,3
87144,3,2,305006,305006,305008,0,2,2
87145,3,1,305009,305009,305010,0,1,1
87146,3,2,305012,305012,305014,0,2,2
87147,2,2,305014,305014,305016,0,2,0
87148,5,2,305019,305019,305021,0,2,3
87149,1,1,305020,305021,305022,1,2,0
87150,5,1,305025,305025,305026,0,1,3
87151,2,3,305027,305027,305030,0,3,1
87152,5,2,305032,305032,305034,0,2,2
87153,3,3,305035,305035,305038,0,3,1
87154,5,3,305040,305040,305043,0,3,2
87155,6,2,305046,305046,305048,0,2,3
87156,4,1,305050,305050,305051,0,1,2
87157,5,2,305055,305055,305057,0,2,4
87158,3,1,305058,305058,305059,0,1,1
87159,1,1,305059,305059,305060,0,1,0
87160,3,2,305062,305062,305064,0,2,2
87161,3,1,305065,305065,305066,0,1,1
87162,3,2,305068,305068,305070,0,2,2
87163,1,3,305069,305070,305073,1,4,0
87164,3,1,305072,305073,305074,1,2,0
87165,3,3,305075,305075,305078,0,3,1
87166,5,1,305080,305080,305081,0,1,2
87167,4,3,305084,305084,305087,0,3,3
87168,5,1,305089,305089,305090,0,1,2
87169,5,3,305094,305094,305097,0,3,4
87170,1,2,305095,305097,305099,2,4,0
87171,4,2,305099,305099,305101,0,2,0
87172,6,1,305105,305105,305106,0,1,4
87173,2,2,305107,305107,305109,0,2,1
87174,5,2,305112,305112,305114,0,2,3
87175,3,1,305115,305115,305116,0,1,1
87176,4,2,305119,305119,305121,0,2,3
87177,3,2,305122,305122,305124,0,2,1
87178,1,3,305123,305124,305127,1,4,0
87179,2,1,305125,305127,305128,2,3,0
87180,6,1,305131,305131,305132,0,1,3
87181,6,3,305137,305137,305140,0,3,5
87182,3,3,305140,305140,305143,0,3,0
87183,3,2,305143,305143,305145,0,2,0
87184,5,2,305148,305148,305150,0,2,3
87185,6,1,305154,305154,305155,0,1,4
87186,1,3,305155,305155,305158,0,3,0
87187,2,3,305157,305158,305161,1,4,0
87188,5,1,305162,305162,305163,0,1,1
87189,3,3,305165,305165,305168,0,3,2
87190,6,2,305171,305171,305173,0,2,3
87191,4,3,305175,305175,305178,0,3,2
87192,1,1,305176,305178,305179,2,3,0
87193,2,1,305178,305179,305180,1,2,0
87194,5,3,305183,305183,305186,0,3,3
87195,4,3,305187,305187,305190,0,3,1
87196,6,3,305193,305193,305196,0,3,3
87197,4,3,305197,305197,305200,0,3,1
87198,1,3,305198,305200,305203,2,5,0
87199,5,3,305203,305203,305206,0,3,0
87200,2,2,305205,305206,305208,1,3,0
87201,5,1,305210,305210,305211,0,1,2
87202,1,3,305211,305211,305214,0,3,0
87203,5,3,305216,305216,305219,0,3,2
87204,3,2,305219,305219,305221,0,2,0
87205,5,2,305224,305224,305226,0,2,3
87206,5,2,305229,305229,305231,0,2,3
87207,5,1,305234,305234,305235,0,1,3
87208,1,1,305235,305235,305236,0,1,0
87209,4,2,305239,305239,305241,0,2,3
87210,2,1,305241,305241,305242,0,1,0
87211,5,1,305246,305246,305247,0,1,4
87212,4,2,305250,305250,305252,0,2,3
87213,1,2,305251,305252,305254,1,3,0
87214,1,2,305252,305254,305256,2,4,0
87215,3,1,305255,305256,305257,1,2,0
87216,2,1,305257,305257,305258,0,1,0
87217,4,2,305261,305261,305263,0,2,3
87218,5,3,305266,305266,305269,0,3,3
87219,5,3,305271,305271,305274,0,3,2
87220,6,3,305277,305277,305280,0,3,3
87221,1,2,305278,305280,305282,2,4,0
87222,1,1,305279,305282,305283,3,4,0
87223,6,2,305285,305285,305287,0,2,2
87224,2,2,305287,305287,305289,0,2,0
87225,2,1,305289,305289,305290,0,1,0
87226,2,1,305291,305291,305292,0,1,1
87227,2,3,305293,305293,305296,0,3,1
87228,6,2,305299,305299,305301,0,2,3
87229,1,2,305300,305301,305303,1,3,0
87230,3,2,305303,305303,305305,0,2,0
87231,4,2,305307,305307,305309,0,2,2
87232,3,3,305310,305310,305313,0,3,1
87233,3,3,305313,305313,305316,0,3,0
87234,5,1,305318,305318,305319,0,1,2
87235,4,2,305322,305322,305324,0,2,3
87236,4,3,305326,305326,305329,0,3,2
87237,6,1,305332,305332,305333,0,1,3
87238,6,1,305338,305338,305339,0,1,5
87239,1,2,305339,305339,305341,0,2,0
87240,4,1,305343,305343,305344,0,1,2
87241,3,3,305346,305346,305349,0,3,2
87242,3,3,305349,305349,305352,0,3,0
87243,6,2,305355,305355,305357,0,2,3
87244,1,1,305356,305357,305358,1,2,0
87245,3,1,305359,305359,305360,0,1,1
87246,5,2,305364,305364,305366,0,2,4
87247,3,3,305367,305367,305370,0,3,1
87248,5,2,305372,305372,305374,0,2,2
87249,4,2,305376,305376,305378,0,2,2
87250,2,2,305378,305378,305380,0,2,0
87251,6,1,305384,305384,305385,0,1,4
87252,6,3,305390,305390,305393,0,3,5
87253,2,1,305392,305393,305394,1,2,0
87254,4,1,305396,305396,305397,0,1,2
87255,6,1,305402,305402,305403,0,1,5
87256,6,3,305408,305408,305411,0,3,5
87257,5,2,305413,305413,305415,0,2,2
87258,3,2,305416,305416,305418,0,2,1
87259,3,2,305419,305419,305421,0,2,1
87260,5,3,305424,305424,305427,0,3,3
87261,6,2,305430,305430,305432,0,2,3
87262,1,2,305431,305432,305434,1,3,0
87263,4,1,305435,305435,305436,0,1,1
87264,5,2,305440,305440,305442,0,2,4
87265,5,2,305445,305445,305447,0,2,3
87266,4,1,305449,305449,305450,0,1,2
87267,4,3,305453,305453,305456,0,3,3
87268,5,3,305458,305458,305461,0,3,2
87269,5,2,305463,305463,305465,0,2,2
87270,4,1,305467,305467,305468,0,1,2
87271,3,2,305470,305470,305472,0,2,2
87272,6,1,305476,305476,305477,0,1,4
87273,1,1,305477,305477,305478,0,1,0
87274,4,1,305481,305481,305482,0,1,3
87275,6,1,305487,305487,305488,0,1,5
87276,6,1,305493,305493,305494,0,1,5
87277,2,2,305495,305495,305497,0,2,1
87278,5,1,305500,305500,305501,0,1,3
87279,5,3,305505,305505,305508,0,3,4
87280,4,2,305509,305509,305511,0,2,1
87281,6,2,305515,305515,305517,0,2,4
87282,4,1,305519,305519,305520,0,1,2
87283,4,2,305523,305523,305525,0,2,3
87284,4,2,305527,305527,305529,0,2,2
87285,4,1,305531,305531,305532,0,1,2
87286,6,3,305537,305537,305540,0,3,5
87287,6,3,305543,305543,305546,0,3,3
87288,4,1,305547,305547,305548,0,1,1
87289,2,2,305549,305549,305551,0,2,1
87290,1,3,305550,305551,305554,1,4,0
87291,3,2,305553,305554,305556,1,3,0
87292,6,2,305559,305559,305561,0,2,3
87293,4,3,305563,305563,305566,0,3,2
87294,4,2,305567,305567,305569,0,2,1
87295,5,1,305572,305572,305573,0,1,3
87296,6,1,305578,305578,305579,0,1,5
87297,5,1,305583,305583,305584,0,1,4
87298,5,2,305588,305588,305590,0,2,4
87299,4,2,305592,305592,305594,0,2,2
87300,2,3,305594,305594,305597,0,3,0
87301,6,2,305600,305600,305602,0,2,3
87302,3,3,305603,305603,305606,0,3,1
87303,4,3,305607,305607,305610,0,3,1
87304,5,2,305612,305612,305614,0,2,2
87305,6,3,305618,305618,305621,0,3,4
87306,6,2,305624,305624,305626,0,2,3
87307,1,2,305625,305626,305628,1,3,0
87308,2,1,305627,305628,305629,1,2,0
87309,3,3,305630,305630,305633,0,3,1
87310,3,2,305633,305633,305635,0,2,0
87311,5,2,305638,305638,305640,0,2,3
87312,1,1,305639,305640,305641,1,2,0
87313,5,2,305644,305644,305646,0,2,3
87314,3,3,305647,305647,305650,0,3,1
87315,3,2,305650,305650,305652,0,2,0
87316,1,3,305651,305652,305655,1,4,0
87317,5,3,305656,305656,305659,0,3,1
87318,6,2,305662,305662,305664,0,2,3
87319,2,1,305664,305664,305665,0,1,0
87320,5,1,305669,305669,305670,0,1,4
87321,3,3,305672,305672,305675,0,3,2
87322,4,1,305676,305676,305677,0,1,1
87323,3,2,305679,305679,305681,0,2,2
87324,2,3,305681,305681,305684,0,3,0
87325,1,2,305682,305684,305686,2,4,0
87326,1,2,305683,305686,305688,3,5,0
87327,4,2,305687,305688,305690,1,3,0
87328,6,2,305693,305693,305695,0,2,3
87329,4,1,305697,305697,305698,0,1,2
87330,3,1,305700,305700,305701,0,1,2
87331,5,3,305705,305705,305708,0,3,4
87332,3,2,305708,305708,305710,0,2,0
87333,6,3,305714,305714,305717,0,3,4
87334,6,3,305720,305720,305723,0,3,3
87335,2,1,305722,305723,305724,1,2,0
87336,3,2,305725,305725,305727,0,2,1
87337,2,3,305727,305727,305730,0,3,0
87338,4,1,305731,305731,305732,0,1,1
87339,6,2,305737,305737,305739,0,2,5
87340,5,2,305742,305742,305744,0,2,3
87341,1,1,305743,305744,305745,1,2,0
87342,4,2,305747,305747,305749,0,2,2
87343,3,2,305750,305750,305752,0,2,1
87344,3,3,305753,305753,305756,0,3,1
87345,2,3,305755,305756,305759,1,4,0
87346,4,1,305759,305759,305760,0,1,0
87347,1,2,305760,305760,305762,0,2,0
87348,5,1,305765,305765,305766,0,1,3
87349,2,2,305767,305767,305769,0,2,1
87350,6,1,305773,305773,305774,0,1,4
87351,1,3,305774,305774,305777,0,3,0
87352,6,3,305780,305780,305783,0,3,3
87353,2,3,305782,305783,305786,1,4,0
87354,2,1,305784,305786,305787,2,3,0
87355,2,1,305786,305787,305788,1,2,0
87356,2,2,305788,305788,305790,0,2,0
87357,6,1,305794,305794,305795,0,1,4
87358,2,2,305796,305796,305798,0,2,1
87359,4,3,305800,305800,305803,0,3,2
87360,3,2,305803,305803,305805,0,2,0
87361,1,2,305804,305805,305807,1,3,0
87362,4,1,305808,305808,305809,0,1,1
87363,1,1,305809,305809,305810,0,1,0
87364,6,3,305815,305815,305818,0,3,5
87365,3,3,305818,305818,305821,0,3,0
87366,2,3,305820,305821,305824,1,4,0
87367,4,1,305824,305824,305825,0,1,0
87368,6,1,305830,305830,305831,0,1,5
87369,4,2,305834,305834,305836,0,2,3
87370,1,3,305835,305836,305839,1,4,0
87371,4,2,305839,305839,305841,0,2,0
87372,5,2,305844,305844,305846,0,2,3
87373,6,1,305850,305850,305851,0,1,4
87374,6,1,305856,305856,305857,0,1,5
87375,6,3,305862,305862,305865,0,3,5
87376,6,2,305868,305868,305870,0,2,3
87377,1,1,305869,305870,305871,1,2,0
87378,6,2,305875,305875,305877,0,2,4
87379,1,1,305876,305877,305878,1,2,0
87380,6,2,305882,305882,305884,0,2,4
87381,6,1,305888,305888,305889,0,1,4
87382,3,3,305891,305891,305894,0,3,2
87383,2,2,305893,305894,305896,1,3,0
87384,4,2,305897,305897,305899,0,2,1
87385,1,3,305898,305899,305902,1,4,0
87386,2,3,305900,305902,305905,2,5,0
87387,5,1,305905,305905,305906,0,1,0
87388,5,1,305910,305910,305911,0,1,4
87389,4,2,305914,305914,305916,0,2,3
87390,4,2,305918,305918,305920,0,2,2
87391,2,3,305920,305920,305923,0,3,0
87392,6,2,305926,305926,305928,0,2,3
87393,1,3,305927,305928,305931,1,4,0
87394,4,2,305931,305931,305933,0,2,0
87395,3,3,305934,305934,305937,0,3,1
87396,4,2,305938,305938,305940,0,2,1
87397,1,1,305939,305940,305941,1,2,0
87398,6,2,305945,305945,305947,0,2,4
87399,2,2,305947,305947,305949,0,2,0
87400,1,2,305948,305949,305951,1,3,0
87401,6,2,305954,305954,305956,0,2,3
87402,3,2,305957,305957,305959,0,2,1
87403,3,1,305960,305960,305961,0,1,1
87404,1,3,305961,305961,305964,0,3,0
87405,5,1,305966,305966,305967,0,1,2
87406,5,1,305971,305971,305972,0,1,4
87407,2,1,305973,305973,305974,0,1,1
87408,3,2,305976,305976,305978,0,2,2
87409,6,2,305982,305982,305984,0,2,4
87410,1,3,305983,305984,305987,1,4,0
87411,4,3,305987,305987,305990,0,3,0
87412,1,1,305988,305990,305991,2,3,0
87413,1,2,305989,305991,305993,2,4,0
87414,2,3,305991,305993,305996,2,5,0
87415,4,3,305995,305996,305999,1,4,0
87416,6,3,306001,306001,306004,0,3,2
87417,3,2,306004,306004,306006,0,2,0
87418,6,1,306010,306010,306011,0,1,4
87419,1,3,306011,306011,306014,0,3,0
87420,1,2,306012,306014,306016,2,4,0
87421,5,3,306017,306017,306020,0,3,1
87422,2,2,306019,306020,306022,1,3,0
87423,1,2,306020,306022,306024,2,4,0
87424,6,3,306026,306026,306029,0,3,2
87425,5,1,306031,306031,306032,0,1,2
87426,3,3,306034,306034,306037,0,3,2
87427,2,3,306036,306037,306040,1,4,0
87428,5,3,306041,306041,306044,0,3,1
87429,5,1,306046,306046,306047,0,1,2
87430,6,3,306052,306052,306055,0,3,5
87431,3,3,306055,306055,306058,0,3,0
87432,1,2,306056,306058,306060,2,4,0
87433,3,1,306059,306060,306061,1,2,0
87434,2,1,306061,306061,306062,0,1,0
87435,1,1,306062,306062,306063,0,1,0
87436,1,3,306063,306063,306066,0,3,0
87437,1,2,306064,306066,306068,2,4,0
87438,4,3,306068,306068,306071,0,3,0
87439,4,3,306072,306072,306075,0,3,1
87440,1,1,306073,306075,306076,2,3,0
87441,3,2,306076,306076,306078,0,2,0
87442,5,2,306081,306081,306083,0,2,3
87443,4,1,306085,306085,306086,0,1,2
87444,3,3,306088,306088,306091,0,3,2
87445,6,2,306094,306094,306096,0,2,3
87446,5,2,306099,306099,306101,0,2,3
87447,6,1,306105,306105,306106,0,1,4
87448,2,2,306107,306107,306109,0,2,1
87449,6,3,306113,306113,306116,0,3,4
87450,5,2,306118,306118,306120,0,2,2
87451,4,2,306122,306122,306124,0,2,2
87452,4,2,306126,306126,306128,0,2,2
87453,4,1,306130,306130,306131,0,1,2
87454,4,1,306134,306134,306135,0,1,3
87455,2,2,306136,306136,306138,0,2,1
87456,1,3,306137,306138,306141,1,4,0
87457,6,3,306143,306143,306146,0,3,2
87458,6,3,306149,306149,306152,0,3,3
87459,2,3,306151,306152,306155,1,4,0
87460,5,2,306156,306156,306158,0,2,1
87461,6,3,306162,306162,306165,0,3,4
87462,3,2,306165,306165,306167,0,2,0
87463,3,3,306168,306168,306171,0,3,1
87464,3,2,306171,306171,306173,0,2,0
87465,4,3,306175,306175,306178,0,3,2
87466,2,2,306177,306178,306180,1,3,0
87467,3,2,306180,306180,306182,0,2,0
87468,3,2,306183,306183,306185,0,2,1
87469,5,2,306188,306188,306190,0,2,3
87470,3,1,306191,306191,306192,0,1,1
87471,3,1,306194,306194,306195,0,1,2
87472,5,2,306199,306199,306201,0,2,4
87473,2,3,306201,306201,306204,0,3,0
87474,4,2,306205,306205,306207,0,2,1
87475,2,3,306207,306207,306210,0,3,0
87476,1,1,306208,306210,306211,2,3,0
87477,4,2,306212,306212,306214,0,2,1
87478,2,3,306214,306214,306217,0,3,0
87479,5,3,306219,306219,306222,0,3,2
87480,1,2,306220,306222,306224,2,4,0
87481,3,2,306223,306224,306226,1,3,0
87482,2,2,306225,306226,306228,1,3,0
87483,6,2,306231,306231,306233,0,2,3
87484,3,1,306234,306234,306235,0,1,1
87485,4,2,306238,306238,306240,0,2,3
87486,6,1,306244,306244,306245,0,1,4
87487,1,2,306245,306245,306247,0,2,0
87488,2,1,306247,306247,306248,0,1,0
87489,2,3,306249,306249,306252,0,3,1
87490,2,1,306251,306252,306253,1,2,0
87491,4,3,306255,306255,306258,0,3,2
87492,1,2,306256,306258,306260,2,4,0
87493,1,3,306257,306260,306263,3,6,0
87494,2,2,306259,306263,306265,4,6,0
87495,3,1,306262,306265,306266,3,4,0
87496,6,1,306268,306268,306269,0,1,2
87497,3,3,306271,306271,306274,0,3,2
87498,6,3,306277,306277,306280,0,3,3
87499,6,1,306283,306283,306284,0,1,3
87500,2,2,306285,306285,306287,0,2,1
87501,5,1,306290,306290,306291,0,1,3
87502,2,3,306292,306292,306295,0,3,1
87503,6,2,306298,306298,306300,0,2,3
87504,2,2,306300,306300,306302,0,2,0
87505,3,2,306303,306303,306305,0,2,1
87506,1,1,306304,306305,306306,1,2,0
87507,4,3,306308,306308,306311,0,3,2
87508,1,2,306309,306311,306313,2,4,0
87509,6,3,306315,306315,306318,0,3,2
87510,1,3,306316,306318,306321,2,5,0
87511,1,1,306317,306321,306322,4,5,0
87512,6,3,306323,306323,306326,0,3,1
87513,2,2,306325,306326,306328,1,3,0
87514,4,3,306329,306329,306332,0,3,1
87515,3,2,306332,306332,306334,0,2,0
87516,5,3,306337,306337,306340,0,3,3
87517,6,2,306343,306343,306345,0,2,3
87518,4,1,306347,306347,306348,0,1,2
87519,1,3,306348,306348,306351,0,3,0
87520,2,2,306350,306351,306353,1,3,0
87521,3,2,306353,306353,306355,0,2,0
87522,1,2,306354,306355,306357,1,3,0
87523,2,1,306356,306357,306358,1,2,0
87524,3,3,306359,306359,306362,0,3,1
87525,1,1,306360,306362,306363,2,3,0
87526,3,1,306363,306363,306364,0,1,0
87527,4,2,306367,306367,306369,0,2,3
87528,1,3,306368,306369,306372,1,4,0
87529,3,3,306371,306372,306375,1,4,0
87530,1,2,306372,306375,306377,3,5,0
87531,1,3,306373,306377,306380,4,7,0
87532,6,2,306379,306380,306382,1,3,0
87533,6,3,306385,306385,306388,0,3,3
87534,4,2,306389,306389,306391,0,2,1
87535,1,3,306390,306391,306394,1,4,0
87536,3,2,306393,306394,306396,1,3,0
87537,2,1,306395,306396,306397,1,2,0
87538,4,3,306399,306399,306402,0,3,2
87539,5,3,306404,306404,306407,0,3,2
87540,5,2,306409,306409,306411,0,2,2
87541,6,3,306415,306415,306418,0,3,4
87542,3,2,306418,306418,306420,0,2,0
87543,3,2,306421,306421,306423,0,2,1
87544,1,3,306422,306423,306426,1,4,0
87545,5,2,306427,306427,306429,0,2,1
87546,1,3,306428,306429,306432,1,4,0
87547,5,3,306433,306433,306436,0,3,1
87548,5,2,306438,306438,306440,0,2,2
87549,5,1,306443,306443,306444,0,1,3
87550,3,2,306446,306446,306448,0,2,2
87551,4,2,306450,306450,306452,0,2,2
87552,5,3,306455,306455,306458,0,3,3
87553,5,1,306460,306460,306461,0,1,2
87554,1,2,306461,306461,306463,0,2,0
87555,2,2,306463,306463,306465,0,2,0
87556,2,2,306465,306465,306467,0,2,0
87557,6,1,306471,306471,306472,0,1,4
87558,3,2,306474,306474,306476,0,2,2
87559,3,1,306477,306477,306478,0,1,1
87560,3,3,306480,306480,306483,0,3,2
87561,2,1,306482,306483,306484,1,2,0
87562,2,2,306484,306484,306486,0,2,0
87563,4,3,306488,306488,306491,0,3,2
87564,5,3,306493,306493,306496,0,3,2
87565,1,1,306494,306496,306497,2,3,0
87566,4,3,306498,306498,306501,0,3,1
87567,1,1,306499,306501,306502,2,3,0
87568,5,1,306504,306504,306505,0,1,2
87569,6,2,306510,306510,306512,0,2,5
87570,2,2,306512,306512,306514,0,2,0
87571,4,1,306516,306516,306517,0,1,2
87572,3,3,306519,306519,306522,0,3,2
87573,2,3,306521,306522,306525,1,4,0
87574,1,2,306522,306525,306527,3,5,0
87575,1,2,306523,306527,306529,4,6,0
87576,2,3,306525,306529,306532,4,7,0
87577,1,2,306526,306532,306534,6,8,0
87578,5,3,306531,306534,306537,3,6,0
87579,6,1,306537,306537,306538,0,1,0
87580,2,3,306539,306539,306542,0,3,1
87581,4,1,306543,306543,306544,0,1,1
87582,4,2,306547,306547,306549,0,2,3
87583,4,1,306551,306551,306552,0,1,2
87584,1,2,306552,306552,306554,0,2,0
87585,2,3,306554,306554,306557,0,3,0
87586,5,2,306559,306559,306561,0,2,2
87587,2,2,306561,306561,306563,0,2,0
87588,4,3,306565,306565,306568,0,3,2
87589,6,3,306571,306571,306574,0,3,3
87590,4,3,306575,306575,306578,0,3,1
87591,5,3,306580,306580,306583,0,3,2
87592,3,2,306583,306583,306585,0,2,0
87593,6,2,306589,306589,306591,0,2,4
87594,3,1,306592,306592,306593,0,1,1
87595,6,2,306598,306598,306600,0,2,5
87596,3,2,306601,306601,306603,0,2,1
87597,4,3,306605,306605,306608,0,3,2
87598,6,3,306611,306611,306614,0,3,3
87599,5,1,306616,306616,306617,0,1,2
87600,1,1,306617,306617,306618,0,1,0
87601,3,3,306620,306620,306623,0,3,2
87602,1,1,306621,306623,306624,2,3,0
87603,3,3,306624,306624,306627,0,3,0
87604,2,1,306626,306627,306628,1,2,0
87605,6,2,306632,306632,306634,0,2,4
87606,4,1,306636,306636,306637,0,1,2
87607,2,3,306638,306638,306641,0,3,1
87608,1,2,306639,306641,306643,2,4,0
87609,3,1,306642,306643,306644,1,2,0
87610,6,2,306648,306648,306650,0,2,4
87611,5,1,306653,306653,306654,0,1,3
87612,2,1,306655,306655,306656,0,1,1
87613,2,2,306657,306657,306659,0,2,1
87614,5,2,306662,306662,306664,0,2,3
87615,3,2,306665,306665,306667,0,2,1
87616,1,1,306666,306667,306668,1,2,0
87617,5,1,306671,306671,306672,0,1,3
87618,6,2,306677,306677,306679,0,2,5
87619,3,1,306680,306680,306681,0,1,1
87620,4,1,306684,306684,306685,0,1,3
87621,1,3,306685,306685,306688,0,3,0
87622,5,3,306690,306690,306693,0,3,2
87623,1,2,306691,306693,306695,2,4,0
87624,2,2,306693,306695,306697,2,4,0
87625,2,2,306695,306697,306699,2,4,0
87626,4,2,306699,306699,306701,0,2,0
87627,2,3,306701,306701,306704,0,3,0
87628,5,2,306706,306706,306708,0,2,2
87629,1,3,306707,306708,306711,1,4,0
87630,1,2,306708,306711,306713,3,5,0
87631,4,3,306712,306713,306716,1,4,0
87632,6,3,306718,306718,306721,0,3,2
87633,4,3,306722,306722,306725,0,3,1
87634,4,2,306726,306726,306728,0,2,1
87635,2,2,306728,306728,306730,0,2,0
87636,2,1,306730,306730,306731,0,1,0
87637,4,2,306734,306734,306736,0,2,3
87638,3,1,306737,306737,306738,0,1,1
87639,1,2,306738,306738,306740,0,2,0
87640,2,1,306740,306740,306741,0,1,0
87641,4,1,306744,306744,306745,0,1,3
87642,1,1,306745,306745,306746,0,1,0
87643,4,2,306749,306749,306751,0,2,3
87644,6,1,306755,306755,306756,0,1,4
87645,1,1,306756,306756,306757,0,1,0
87646,1,2,306757,306757,306759,0,2,0
87647,2,3,306759,306759,306762,0,3,0
87648,5,1,306764,306764,306765,0,1,2
87649,1,3,306765,306765,306768,0,3,0
87650,6,3,306771,306771,306774,0,3,3
87651,1,2,306772,306774,306776,2,4,0
87652,4,2,306776,306776,306778,0,2,0
87653,2,2,306778,306778,306780,0,2,0
87654,6,2,306784,306784,306786,0,2,4
87655,1,2,306785,306786,306788,1,3,0
87656,1,3,306786,306788,306791,2,5,0
87657,2,2,306788,306791,306793,3,5,0
87658,2,1,306790,306793,306794,3,4,0
87659,1,1,306791,306794,306795,3,4,0
87660,2,1,306793,306795,306796,2,3,0
87661,5,2,306798,306798,306800,0,2,2
87662,4,2,306802,306802,306804,0,2,2
87663,5,2,306807,306807,306809,0,2,3
87664,4,2,306811,306811,306813,0,2,2
87665,2,1,306813,306813,306814,0,1,0
87666,5,1,306818,306818,306819,0,1,4
87667,2,3,306820,306820,306823,0,3,1
87668,6,3,306826,306826,306829,0,3,3
87669,1,2,306827,306829,306831,2,4,0
87670,4,2,306831,306831,306833,0,2,0
87671,6,3,306837,306837,306840,0,3,4
87672,6,2,306843,306843,306845,0,2,3
87673,5,1,306848,306848,306849,0,1,3
87674,1,2,306849,306849,306851,0,2,0
87675,3,1,306852,306852,306853,0,1,1
87676,4,3,306856,306856,306859,0,3,3
87677,5,1,306861,306861,306862,0,1,2
87678,6,3,306867,306867,306870,0,3,5
87679,4,3,306871,306871,306874,0,3,1
87680,4,1,306875,306875,306876,0,1,1
87681,4,3,306879,306879,306882,0,3,3
87682,5,1,306884,306884,306885,0,1,2
87683,2,3,306886,306886,306889,0,3,1
87684,6,2,306892,306892,306894,0,2,3
87685,5,3,306897,306897,306900,0,3,3
87686,2,1,306899,306900,306901,1,2,0
87687,4,3,306903,306903,306906,0,3,2
87688,3,1,306906,306906,306907,0,1,0
87689,4,2,306910,306910,306912,0,2,3
87690,2,2,306912,306912,306914,0,2,0
87691,3,1,306915,306915,306916,0,1,1
87692,1,3,306916,306916,306919,0,3,0
87693,5,3,306921,306921,306924,0,3,2
87694,1,1,306922,306924,306925,2,3,0
87695,2,1,306924,306925,306926,1,2,0
87696,3,2,306927,306927,306929,0,2,1
87697,4,1,306931,306931,306932,0,1,2
87698,6,1,306937,306937,306938,0,1,5
87699,4,1,306941,306941,306942,0,1,3
87700,2,3,306943,306943,306946,0,3,1
87701,5,3,306948,306948,306951,0,3,2
87702,4,2,306952,306952,306954,0,2,1
87703,1,1,306953,306954,306955,1,2,0
87704,1,3,306954,306955,306958,1,4,0
87705,2,1,306956,306958,306959,2,3,0
87706,4,3,306960,306960,306963,0,3,1
87707,4,2,306964,306964,306966,0,2,1
87708,3,1,306967,306967,306968,0,1,1
87709,2,1,306969,306969,306970,0,1,1
87710,6,3,306975,306975,306978,0,3,5
87711,3,2,306978,306978,306980,0,2,0
87712,1,3,306979,306980,306983,1,4,0
87713,6,3,306985,306985,306988,0,3,2
87714,5,2,306990,306990,306992,0,2,2
87715,1,1,306991,306992,306993,1,2,0
87716,4,3,306995,306995,306998,0,3,2
87717,6,1,307001,307001,307002,0,1,3
87718,5,3,307006,307006,307009,0,3,4
87719,2,3,307008,307009,307012,1,4,0
87720,4,3,307012,307012,307015,0,3,0
87721,3,2,307015,307015,307017,0,2,0
87722,5,2,307020,307020,307022,0,2,3
87723,1,3,307021,307022,307025,1,4,0
87724,1,2,307022,307025,307027,3,5,0
87725,6,2,307028,307028,307030,0,2,1
87726,3,3,307031,307031,307034,0,3,1
87727,5,2,307036,307036,307038,0,2,2
87728,5,1,307041,307041,307042,0,1,3
87729,5,1,307046,307046,307047,0,1,4
87730,2,1,307048,307048,307049,0,1,1
87731,5,3,307053,307053,307056,0,3,4
87732,3,2,307056,307056,307058,0,2,0
87733,5,2,307061,307061,307063,0,2,3
87734,4,2,307065,307065,307067,0,2,2
87735,2,3,307067,307067,307070,0,3,0
87736,3,2,307070,307070,307072,0,2,0
87737,6,3,307076,307076,307079,0,3,4
87738,1,2,307077,307079,307081,2,4,0
87739,3,3,307080,307081,307084,1,4,0
87740,2,1,307082,307084,307085,2,3,0
87741,6,2,307088,307088,307090,0,2,3
87742,6,2,307094,307094,307096,0,2,4
87743,2,3,307096,307096,307099,0,3,0
87744,1,2,307097,307099,307101,2,4,0
87745,1,1,307098,307101,307102,3,4,0
87746,6,2,307104,307104,307106,0,2,2
87747,5,2,307109,307109,307111,0,2,3
87748,1,1,307110,307111,307112,1,2,0
87749,6,1,307116,307116,307117,0,1,4
87750,4,2,307120,307120,307122,0,2,3
87751,6,1,307126,307126,307127,0,1,4
87752,6,1,307132,307132,307133,0,1,5
87753,3,3,307135,307135,307138,0,3,2
87754,4,3,307139,307139,307142,0,3,1
87755,1,3,307140,307142,307145,2,5,0
87756,4,1,307144,307145,307146,1,2,0
87757,3,1,307147,307147,307148,0,1,1
87758,1,1,307148,307148,307149,0,1,0
87759,5,1,307153,307153,307154,0,1,4
87760,4,2,307157,307157,307159,0,2,3
87761,5,2,307162,307162,307164,0,2,3
87762,6,3,307168,307168,307171,0,3,4
87763,3,1,307171,307171,307172,0,1,0
87764,1,3,307172,307172,307175,0,3,0
87765,3,1,307175,307175,307176,0,1,0
87766,4,3,307179,307179,307182,0,3,3
87767,2,1,307181,307182,307183,1,2,0
87768,3,3,307184,307184,307187,0,3,1
87769,3,2,307187,307187,307189,0,2,0
87770,5,1,307192,307192,307193,0,1,3
87771,6,2,307198,307198,307200,0,2,5
87772,5,1,307203,307203,307204,0,1,3
87773,1,2,307204,307204,307206,0,2,0
87774,3,2,307207,307207,307209,0,2,1
87775,2,2,307209,307209,307211,0,2,0
87776,5,2,307214,307214,307216,0,2,3
87777,4,1,307218,307218,307219,0,1,2
87778,6,1,307224,307224,307225,0,1,5
87779,3,1,307227,307227,307228,0,1,2
87780,6,3,307233,307233,307236,0,3,5
87781,1,2,307234,307236,307238,2,4,0
87782,4,1,307238,307238,307239,0,1,0
87783,2,1,307240,307240,307241,0,1,1
87784,3,3,307243,307243,307246,0,3,2
87785,2,1,307245,307246,307247,1,2,0
87786,2,2,307247,307247,307249,0,2,0
87787,6,3,307253,307253,307256,0,3,4
87788,1,2,307254,307256,307258,2,4,0
87789,6,1,307260,307260,307261,0,1,2
87790,5,3,307265,307265,307268,0,3,4
87791,6,2,307271,307271,307273,0,2,3
87792,2,1,307273,307273,307274,0,1,0
87793,1,3,307274,307274,307277,0,3,0
87794,4,3,307278,307278,307281,0,3,1
87795,5,2,307283,307283,307285,0,2,2
87796,5,3,307288,307288,307291,0,3,3
87797,3,1,307291,307291,307292,0,1,0
87798,5,2,307296,307296,307298,0,2,4
87799,5,1,307301,307301,307302,0,1,3
87800,4,1,307305,307305,307306,0,1,3
87801,6,2,307311,307311,307313,0,2,5
87802,3,3,307314,307314,307317,0,3,1
87803,1,3,307315,307317,307320,2,5,0
87804,5,1,307320,307320,307321,0,1,0
87805,1,1,307321,307321,307322,0,1,0
87806,3,2,307324,307324,307326,0,2,2
87807,1,3,307325,307326,307329,1,4,0
87808,6,1,307331,307331,307332,0,1,2
87809,1,2,307332,307332,307334,0,2,0
87810,1,3,307333,307334,307337,1,4,0
87811,4,3,307337,307337,307340,0,3,0
87812,5,3,307342,307342,307345,0,3,2
87813,1,3,307343,307345,307348,2,5,0
87814,6,1,307349,307349,307350,0,1,1
87815,4,3,307353,307353,307356,0,3,3
87816,5,1,307358,307358,307359,0,1,2
87817,3,1,307361,307361,307362,0,1,2
87818,4,1,307365,307365,307366,0,1,3
87819,1,3,307366,307366,307369,0,3,0
87820,1,2,307367,307369,307371,2,4,0
87821,1,2,307368,307371,307373,3,5,0
87822,2,3,307370,307373,307376,3,6,0
87823,4,2,307374,307376,307378,2,4,0
87824,6,1,307380,307380,307381,0,1,2
87825,1,3,307381,307381,307384,0,3,0
87826,4,3,307385,307385,307388,0,3,1
87827,1,2,307386,307388,307390,2,4,0
87828,5,1,307391,307391,307392,0,1,1
87829,5,2,307396,307396,307398,0,2,4
87830,1,2,307397,307398,307400,1,3,0
87831,4,2,307401,307401,307403,0,2,1
87832,1,1,307402,307403,307404,1,2,0
87833,2,3,307404,307404,307407,0,3,0
87834,3,3,307407,307407,307410,0,3,0
87835,6,1,307413,307413,307414,0,1,3
87836,4,2,307417,307417,307419,0,2,3
87837,2,2,307419,307419,307421,0,2,0
87838,4,1,307423,307423,307424,0,1,2
87839,3,3,307426,307426,307429,0,3,2
87840,3,2,307429,307429,307431,0,2,0
87841,4,1,307433,307433,307434,0,1,2
87842,6,3,307439,307439,307442,0,3,5
87843,5,1,307444,307444,307445,0,1,2
87844,4,2,307448,307448,307450,0,2,3
87845,3,1,307451,307451,307452,0,1,1
87846,4,1,307455,307455,307456,0,1,3
87847,2,1,307457,307457,307458,0,1,1
87848,5,2,307462,307462,307464,0,2,4
87849,4,2,307466,307466,307468,0,2,2
87850,2,1,307468,307468,307469,0,1,0
87851,3,3,307471,307471,307474,0,3,2
87852,2,1,307473,307474,307475,1,2,0
87853,2,3,307475,307475,307478,0,3,0
87854,4,1,307479,307479,307480,0,1,1
87855,5,2,307484,307484,307486,0,2,4
87856,4,3,307488,307488,307491,0,3,2
87857,3,3,307491,307491,307494,0,3,0
87858,4,2,307495,307495,307497,0,2,1
87859,4,3,307499,307499,307502,0,3,2
87860,4,2,307503,307503,307505,0,2,1
87861,2,1,307505,307505,307506,0,1,0
87862,4,3,307509,307509,307512,0,3,3
87863,4,1,307513,307513,307514,0,1,1
87864,2,1,307515,307515,307516,0,1,1
87865,3,2,307518,307518,307520,0,2,2
87866,3,2,307521,307521,307523,0,2,1
87867,6,2,307527,307527,307529,0,2,4
87868,5,2,307532,307532,307534,0,2,3
87869,2,2,307534,307534,307536,0,2,0
87870,2,2,307536,307536,307538,0,2,0
87871,4,3,307540,307540,307543,0,3,2
87872,6,3,307546,307546,307549,0,3,3
87873,3,1,307549,307549,307550,0,1,0
87874,6,2,307555,307555,307557,0,2,5
87875,3,3,307558,307558,307561,0,3,1
87876,6,3,307564,307564,307567,0,3,3
87877,2,1,307566,307567,307568,1,2,0
87878,1,2,307567,307568,307570,1,3,0
87879,2,1,307569,307570,307571,1,2,0
87880,2,2,307571,307571,307573,0,2,0
87881,6,2,307577,307577,307579,0,2,4
87882,2,2,307579,307579,307581,0,2,0
87883,1,3,307580,307581,307584,1,4,0
87884,5,2,307585,307585,307587,0,2,1
87885,3,3,307588,307588,307591,0,3,1
87886,2,3,307590,307591,307594,1,4,0
87887,2,3,307592,307594,307597,2,5,0
87888,2,1,307594,307597,307598,3,4,0
87889,1,3,307595,307598,307601,3,6,0
87890,2,2,307597,307601,307603,4,6,0
87891,3,2,307600,307603,307605,3,5,0
87892,2,3,307602,307605,307608,3,6,0
87893,4,2,307606,307608,307610,2,4,0
87894,1,3,307607,307610,307613,3,6,0
87895,2,1,307609,307613,307614,4,5,0
87896,3,1,307612,307614,307615,2,3,0
87897,5,3,307617,307617,307620,0,3,2
87898,2,2,307619,307620,307622,1,3,0
87899,4,2,307623,307623,307625,0,2,1
87900,2,3,307625,307625,307628,0,3,0
87901,3,2,307628,307628,307630,0,2,0
87902,4,2,307632,307632,307634,0,2,2
87903,4,2,307636,307636,307638,0,2,2
87904,4,2,307640,307640,307642,0,2,2
87905,6,3,307646,307646,307649,0,3,4
87906,5,3,307651,307651,307654,0,3,2
87907,1,3,307652,307654,307657,2,5,0
87908,4,1,307656,307657,307658,1,2,0
87909,5,2,307661,307661,307663,0,2,3
87910,1,3,307662,307663,307666,1,4,0
87911,4,3,307666,307666,307669,0,3,0
87912,1,2,307667,307669,307671,2,4,0
87913,6,1,307673,307673,307674,0,1,2
87914,3,1,307676,307676,307677,0,1,2
87915,4,1,307680,307680,307681,0,1,3
87916,3,1,307683,307683,307684,0,1,2
87917,2,3,307685,307685,307688,0,3,1
87918,1,1,307686,307688,307689,2,3,0
87919,3,2,307689,307689,307691,0,2,0
87920,6,3,307695,307695,307698,0,3,4
87921,6,1,307701,307701,307702,0,1,3
87922,6,1,307707,307707,307708,0,1,5
87923,4,3,307711,307711,307714,0,3,3
87924,2,2,307713,307714,307716,1,3,0
87925,4,3,307717,307717,307720,0,3,1
87926,5,1,307722,307722,307723,0,1,2
87927,3,3,307725,307725,307728,0,3,2
87928,4,1,307729,307729,307730,0,1,1
87929,3,2,307732,307732,307734,0,2,2
87930,5,2,307737,307737,307739,0,2,3
87931,6,3,307743,307743,307746,0,3,4
87932,1,3,307744,307746,307749,2,5,0
87933,6,2,307750,307750,307752,0,2,1
87934,2,3,307752,307752,307755,0,3,0
87935,4,2,307756,307756,307758,0,2,1
87936,2,1,307758,307758,307759,0,1,0
87937,4,3,307762,307762,307765,0,3,3
87938,4,3,307766,307766,307769,0,3,1
87939,3,1,307769,307769,307770,0,1,0
87940,6,2,307775,307775,307777,0,2,5
87941,2,2,307777,307777,307779,0,2,0
87942,4,1,307781,307781,307782,0,1,2
87943,3,1,307784,307784,307785,0,1,2
87944,6,3,307790,307790,307793,0,3,5
87945,1,3,307791,307793,307796,2,5,0
87946,1,3,307792,307796,307799,4,7,0
87947,1,2,307793,307799,307801,6,8,0
87948,1,1,307794,307801,307802,7,8,0
87949,5,3,307799,307802,307805,3,6,0
87950,6,1,307805,307805,307806,0,1,0
87951,1,3,307806,307806,307809,0,3,0
87952,2,2,307808,307809,307811,1,3,0
87953,2,1,307810,307811,307812,1,2,0
87954,6,2,307816,307816,307818,0,2,4
87955,6,1,307822,307822,307823,0,1,4
87956,3,1,307825,307825,307826,0,1,2
87957,6,1,307831,307831,307832,0,1,5
87958,3,3,307834,307834,307837,0,3,2
87959,4,2,307838,307838,307840,0,2,1
87960,5,1,307843,307843,307844,0,1,3
87961,2,2,307845,307845,307847,0,2,1
87962,1,1,307846,307847,307848,1,2,0
87963,1,3,307847,307848,307851,1,4,0
87964,4,3,307851,307851,307854,0,3,0
87965,2,3,307853,307854,307857,1,4,0
87966,1,2,307854,307857,307859,3,5,0
87967,5,2,307859,307859,307861,0,2,0
87968,1,1,307860,307861,307862,1,2,0
87969,3,2,307863,307863,307865,0,2,1
87970,6,1,307869,307869,307870,0,1,4
87971,1,1,307870,307870,307871,0,1,0
87972,5,3,307875,307875,307878,0,3,4
87973,3,3,307878,307878,307881,0,3,0
87974,5,1,307883,307883,307884,0,1,2
87975,6,3,307889,307889,307892,0,3,5
87976,4,1,307893,307893,307894,0,1,1
87977,3,1,307896,307896,307897,0,1,2
87978,1,3,307897,307897,307900,0,3,0
87979,3,2,307900,307900,307902,0,2,0
87980,4,3,307904,307904,307907,0,3,2
87981,2,3,307906,307907,307910,1,4,0
87982,1,3,307907,307910,307913,3,6,0
87983,1,2,307908,307913,307915,5,7,0
87984,4,2,307912,307915,307917,3,5,0
87985,1,1,307913,307917,307918,4,5,0
87986,1,3,307914,307918,307921,4,7,0
87987,5,1,307919,307921,307922,2,3,0
87988,3,1,307922,307922,307923,0,1,0
87989,6,1,307928,307928,307929,0,1,5
87990,2,3,307930,307930,307933,0,3,1
87991,1,1,307931,307933,307934,2,3,0
87992,6,2,307937,307937,307939,0,2,3
87993,1,2,307938,307939,307941,1,3,0
87994,6,3,307944,307944,307947,0,3,3
87995,3,2,307947,307947,307949,0,2,0
87996,4,1,307951,307951,307952,0,1,2
87997,1,2,307952,307952,307954,0,2,0
87998,4,1,307956,307956,307957,0,1,2
87999,2,2,307958,307958,307960,0,2,1
88000,1,1,307959,307960,307961,1,2,0
88001,6,1,307965,307965,307966,0,1,4
88002,1,1,307966,307966,307967,0,1,0
88003,5,3,307971,307971,307974,0,3,4
88004,5,3,307976,307976,307979,0,3,2
88005,3,1,307979,307979,307980,0,1,0
88006,5,2,307984,307984,307986,0,2,4
88007,6,1,307990,307990,307991,0,1,4
88008,3,1,307993,307993,307994,0,1,2
88009,6,1,307999,307999,308000,0,1,5
88010,3,1,308002,308002,308003,0,1,2
88011,1,1,308003,308003,308004,0,1,0
88012,2,1,308005,308005,308006,0,1,1
88013,1,1,308006,308006,308007,0,1,0
88014,1,2,308007,308007,308009,0,2,0
88015,4,1,308011,308011,308012,0,1,2
88016,3,2,308014,308014,308016,0,2,2
88017,1,2,308015,308016,308018,1,3,0
88018,3,3,308018,308018,308021,0,3,0
88019,6,3,308024,308024,308027,0,3,3
88020,5,3,308029,308029,308032,0,3,2
88021,4,3,308033,308033,308036,0,3,1
88022,4,2,308037,308037,308039,0,2,1
88023,3,1,308040,308040,308041,0,1,1
88024,4,2,308044,308044,308046,0,2,3
88025,2,3,308046,308046,308049,0,3,0
88026,6,1,308052,308052,308053,0,1,3
88027,3,3,308055,308055,308058,0,3,2
88028,6,1,308061,308061,308062,0,1,3
88029,3,2,308064,308064,308066,0,2,2
88030,1,1,308065,308066,308067,1,2,0
88031,1,2,308066,308067,308069,1,3,0
88032,1,2,308067,308069,308071,2,4,0
88033,1,3,308068,308071,308074,3,6,0
88034,6,1,308074,308074,308075,0,1,0
88035,6,2,308080,308080,308082,0,2,5
88036,2,3,308082,308082,308085,0,3,0
88037,3,3,308085,308085,308088,0,3,0
88038,1,1,308086,308088,308089,2,3,0
88039,1,1,308087,308089,308090,2,3,0
88040,6,3,308093,308093,308096,0,3,3
88041,5,1,308098,308098,308099,0,1,2
88042,3,3,308101,308101,308104,0,3,2
88043,2,2,308103,308104,308106,1,3,0
88044,6,1,308109,308109,308110,0,1,3
88045,2,3,308111,308111,308114,0,3,1
88046,2,2,308113,308114,308116,1,3,0
88047,3,3,308116,308116,308119,0,3,0
88048,5,3,308121,308121,308124,0,3,2
88049,5,3,308126,308126,308129,0,3,2
88050,6,3,308132,308132,308135,0,3,3
88051,4,1,308136,308136,308137,0,1,1
88052,5,3,308141,308141,308144,0,3,4
88053,6,1,308147,308147,308148,0,1,3
88054,5,3,308152,308152,308155,0,3,4
88055,5,3,308157,308157,308160,0,3,2
88056,3,1,308160,308160,308161,0,1,0
88057,6,1,308166,308166,308167,0,1,5
88058,1,1,308167,308167,308168,0,1,0
88059,3,2,308170,308170,308172,0,2,2
88060,2,3,308172,308172,308175,0,3,0
88061,5,3,308177,308177,308180,0,3,2
88062,2,2,308179,308180,308182,1,3,0
88063,2,3,308181,308182,308185,1,4,0
88064,5,1,308186,308186,308187,0,1,1
88065,3,2,308189,308189,308191,0,2,2
88066,5,1,308194,308194,308195,0,1,3
88067,6,3,308200,308200,308203,0,3,5
88068,4,3,308204,308204,308207,0,3,1
88069,1,1,308205,308207,308208,2,3,0
88070,6,1,308211,308211,308212,0,1,3
88071,3,2,308214,308214,308216,0,2,2
88072,2,3,308216,308216,308219,0,3,0
88073,4,2,308220,308220,308222,0,2,1
88074,6,3,308226,308226,308229,0,3,4
88075,1,3,308227,308229,308232,2,5,0
88076,4,3,308231,308232,308235,1,4,0
88077,5,3,308236,308236,308239,0,3,1
88078,5,1,308241,308241,308242,0,1,2
88079,3,3,308244,308244,308247,0,3,2
88080,1,3,308245,308247,308250,2,5,0
88081,3,3,308248,308250,308253,2,5,0
88082,5,2,308253,308253,308255,0,2,0
88083,6,3,308259,308259,308262,0,3,4
88084,5,2,308264,308264,308266,0,2,2
88085,5,3,308269,308269,308272,0,3,3
88086,6,2,308275,308275,308277,0,2,3
88087,6,3,308281,308281,308284,0,3,4
88088,1,3,308282,308284,308287,2,5,0
88089,4,1,308286,308287,308288,1,2,0
88090,6,3,308292,308292,308295,0,3,4
88091,2,1,308294,308295,308296,1,2,0
88092,3,3,308297,308297,308300,0,3,1
88093,1,1,308298,308300,308301,2,3,0
88094,6,3,308304,308304,308307,0,3,3
88095,5,2,308309,308309,308311,0,2,2
88096,1,3,308310,308311,308314,1,4,0
88097,4,2,308314,308314,308316,0,2,0
88098,4,3,308318,308318,308321,0,3,2
88099,3,1,308321,308321,308322,0,1,0
88100,1,3,308322,308322,308325,0,3,0
88101,1,2,308323,308325,308327,2,4,0
88102,4,3,308327,308327,308330,0,3,0
88103,3,3,308330,308330,308333,0,3,0
88104,2,1,308332,308333,308334,1,2,0
88105,6,1,308338,308338,308339,0,1,4
88106,5,1,308343,308343,308344,0,1,4
88107,5,3,308348,308348,308351,0,3,4
88108,3,1,308351,308351,308352,0,1,0
88109,5,2,308356,308356,308358,0,2,4
88110,2,3,308358,308358,308361,0,3,0
88111,2,2,308360,308361,308363,1,3,0
88112,1,1,308361,308363,308364,2,3,0
88113,1,1,308362,308364,308365,2,3,0
88114,1,3,308363,308365,308368,2,5,0
88115,5,3,308368,308368,308371,0,3,0
88116,1,3,308369,308371,308374,2,5,0
88117,4,3,308373,308374,308377,1,4,0
88118,6,1,308379,308379,308380,0,1,2
88119,6,3,308385,308385,308388,0,3,5
88120,1,1,308386,308388,308389,2,3,0
88121,2,2,308388,308389,308391,1,3,0
88122,1,3,308389,308391,308394,2,5,0
88123,1,3,308390,308394,308397,4,7,0
88124,1,2,308391,308397,308399,6,8,0
88125,4,1,308395,308399,308400,4,5,0
88126,5,1,308400,308400,308401,0,1,0
88127,1,3,308401,308401,308404,0,3,0
88128,1,3,308402,308404,308407,2,5,0
88129,5,1,308407,308407,308408,0,1,0
88130,1,2,308408,308408,308410,0,2,0
88131,4,1,308412,308412,308413,0,1,2
88132,1,3,308413,308413,308416,0,3,0
88133,3,1,308416,308416,308417,0,1,0
88134,6,1,308422,308422,308423,0,1,5
88135,3,3,308425,308425,308428,0,3,2
88136,1,1,308426,308428,308429,2,3,0
88137,5,1,308431,308431,308432,0,1,2
88138,2,1,308433,308433,308434,0,1,1
88139,2,2,308435,308435,308437,0,2,1
88140,6,1,308441,308441,308442,0,1,4
88141,5,3,308446,308446,308449,0,3,4
88142,2,3,308448,308449,308452,1,4,0
88143,6,1,308454,308454,308455,0,1,2
88144,1,1,308455,308455,308456,0,1,0
88145,6,2,308461,308461,308463,0,2,5
88146,5,3,308466,308466,308469,0,3,3
88147,2,3,308468,308469,308472,1,4,0
88148,1,1,308469,308472,308473,3,4,0
88149,3,3,308472,308473,308476,1,4,0
88150,1,3,308473,308476,308479,3,6,0
88151,5,3,308478,308479,308482,1,4,0
88152,6,3,308484,308484,308487,0,3,2
88153,6,1,308490,308490,308491,0,1,3
88154,5,3,308495,308495,308498,0,3,4
88155,3,3,308498,308498,308501,0,3,0
88156,4,3,308502,308502,308505,0,3,1
88157,1,3,308503,308505,308508,2,5,0
88158,5,3,308508,308508,308511,0,3,0
88159,5,3,308513,308513,308516,0,3,2
88160,2,1,308515,308516,308517,1,2,0
88161,4,1,308519,308519,308520,0,1,2
88162,6,3,308525,308525,308528,0,3,5
88163,2,1,308527,308528,308529,1,2,0
88164,1,3,308528,308529,308532,1,4,0
88165,4,3,308532,308532,308535,0,3,0
88166,6,2,308538,308538,308540,0,2,3
88167,1,3,308539,308540,308543,1,4,0
88168,4,2,308543,308543,308545,0,2,0
88169,3,3,308546,308546,308549,0,3,1
88170,2,3,308548,308549,308552,1,4,0
88171,6,1,308554,308554,308555,0,1,2
88172,4,2,308558,308558,308560,0,2,3
88173,4,3,308562,308562,308565,0,3,2
88174,2,1,308564,308565,308566,1,2,0
88175,2,3,308566,308566,308569,0,3,0
88176,5,3,308571,308571,308574,0,3,2
88177,5,1,308576,308576,308577,0,1,2
88178,1,3,308577,308577,308580,0,3,0
88179,1,2,308578,308580,308582,2,4,0
88180,3,2,308581,308582,308584,1,3,0
88181,5,3,308586,308586,308589,0,3,2
88182,6,1,308592,308592,308593,0,1,3
88183,5,3,308597,308597,308600,0,3,4
88184,3,1,308600,308600,308601,0,1,0
88185,4,2,308604,308604,308606,0,2,3
88186,6,3,308610,308610,308613,0,3,4
88187,2,3,308612,308613,308616,1,4,0
88188,2,2,308614,308616,308618,2,4,0
88189,2,2,308616,308618,308620,2,4,0
88190,4,2,308620,308620,308622,0,2,0
88191,4,3,308624,308624,308627,0,3,2
88192,5,2,308629,308629,308631,0,2,2
88193,2,1,308631,308631,308632,0,1,0
88194,6,3,308637,308637,308640,0,3,5
88195,4,2,308641,308641,308643,0,2,1
88196,2,3,308643,308643,308646,0,3,0
88197,2,3,308645,308646,308649,1,4,0
88198,2,3,308647,308649,308652,2,5,0
88199,1,1,308648,308652,308653,4,5,0
88200,5,3,308653,308653,308656,0,3,0
88201,1,3,308654,308656,308659,2,5,0
88202,6,2,308660,308660,308662,0,2,1
88203,5,3,308665,308665,308668,0,3,3
88204,2,1,308667,308668,308669,1,2,0
88205,5,1,308672,308672,308673,0,1,3
88206,4,1,308676,308676,308677,0,1,3
88207,3,1,308679,308679,308680,0,1,2
88208,2,1,308681,308681,308682,0,1,1
88209,6,3,308687,308687,308690,0,3,5
88210,2,3,308689,308690,308693,1,4,0
88211,5,3,308694,308694,308697,0,3,1
88212,6,2,308700,308700,308702,0,2,3
88213,2,1,308702,308702,308703,0,1,0
88214,6,1,308708,308708,308709,0,1,5
88215,3,3,308711,308711,308714,0,3,2
88216,3,2,308714,308714,308716,0,2,0
88217,3,2,308717,308717,308719,0,2,1
88218,2,2,308719,308719,308721,0,2,0
88219,6,3,308725,308725,308728,0,3,4
88220,6,3,308731,308731,308734,0,3,3
88221,3,1,308734,308734,308735,0,1,0
88222,1,3,308735,308735,308738,0,3,0
88223,5,2,308740,308740,308742,0,2,2
88224,1,2,308741,308742,308744,1,3,0
88225,4,1,308745,308745,308746,0,1,1
88226,1,2,308746,308746,308748,0,2,0
88227,4,3,308750,308750,308753,0,3,2
88228,2,1,308752,308753,308754,1,2,0
88229,5,1,308757,308757,308758,0,1,3
88230,4,2,308761,308761,308763,0,2,3
88231,1,3,308762,308763,308766,1,4,0
88232,6,2,308768,308768,308770,0,2,2
88233,4,2,308772,308772,308774,0,2,2
88234,3,1,308775,308775,308776,0,1,1
88235,5,1,308780,308780,308781,0,1,4
88236,1,3,308781,308781,308784,0,3,0
88237,6,1,308787,308787,308788,0,1,3
88238,2,3,308789,308789,308792,0,3,1
88239,1,1,308790,308792,308793,2,3,0
88240,4,1,308794,308794,308795,0,1,1
88241,5,2,308799,308799,308801,0,2,4
88242,6,3,308805,308805,308808,0,3,4
88243,1,1,308806,308808,308809,2,3,0
88244,5,1,308811,308811,308812,0,1,2
88245,3,3,308814,308814,308817,0,3,2
88246,2,3,308816,308817,308820,1,4,0
88247,6,1,308822,308822,308823,0,1,2
88248,1,2,308823,308823,308825,0,2,0
88249,6,2,308829,308829,308831,0,2,4
88250,1,2,308830,308831,308833,1,3,0
88251,4,1,308834,308834,308835,0,1,1
88252,2,3,308836,308836,308839,0,3,1
88253,2,2,308838,308839,308841,1,3,0
88254,5,2,308843,308843,308845,0,2,2
88255,6,1,308849,308849,308850,0,1,4
88256,4,1,308853,308853,308854,0,1,3
88257,3,1,308856,308856,308857,0,1,2
88258,3,2,308859,308859,308861,0,2,2
88259,6,1,308865,308865,308866,0,1,4
88260,5,3,308870,308870,308873,0,3,4
88261,4,1,308874,308874,308875,0,1,1
88262,6,2,308880,308880,308882,0,2,5
88263,1,3,308881,308882,308885,1,4,0
88264,3,1,308884,308885,308886,1,2,0
88265,3,3,308887,308887,308890,0,3,1
88266,1,2,308888,308890,308892,2,4,0
88267,5,3,308893,308893,308896,0,3,1
88268,4,1,308897,308897,308898,0,1,1
88269,4,2,308901,308901,308903,0,2,3
88270,3,3,308904,308904,308907,0,3,1
88271,6,2,308910,308910,308912,0,2,3
88272,5,2,308915,308915,308917,0,2,3
88273,4,1,308919,308919,308920,0,1,2
88274,5,3,308924,308924,308927,0,3,4
88275,4,2,308928,308928,308930,0,2,1
88276,2,3,308930,308930,308933,0,3,0
88277,5,3,308935,308935,308938,0,3,2
88278,3,2,308938,308938,308940,0,2,0
88279,2,1,308940,308940,308941,0,1,0
88280,5,3,308945,308945,308948,0,3,4
88281,6,3,308951,308951,308954,0,3,3
88282,5,3,308956,308956,308959,0,3,2
88283,5,2,308961,308961,308963,0,2,2
88284,1,1,308962,308963,308964,1,2,0
88285,1,1,308963,308964,308965,1,2,0
88286,1,1,308964,308965,308966,1,2,0
88287,3,1,308967,308967,308968,0,1,1
88288,6,1,308973,308973,308974,0,1,5
88289,2,2,308975,308975,308977,0,2,1
88290,1,1,308976,308977,308978,1,2,0
88291,3,1,308979,308979,308980,0,1,1
88292,5,2,308984,308984,308986,0,2,4
88293,6,3,308990,308990,308993,0,3,4
88294,2,2,308992,308993,308995,1,3,0
88295,2,3,308994,308995,308998,1,4,0
88296,3,3,308997,308998,309001,1,4,0
88297,2,1,308999,309001,309002,2,3,0
88298,5,1,309004,309004,309005,0,1,2
88299,3,2,309007,309007,309009,0,2,2
88300,2,2,309009,309009,309011,0,2,0
88301,1,1,309010,309011,309012,1,2,0
88302,1,1,309011,309012,309013,1,2,0
88303,2,1,309013,309013,309014,0,1,0
88304,1,2,309014,309014,309016,0,2,0
88305,2,2,309016,309016,309018,0,2,0
88306,1,1,309017,309018,309019,1,2,0
88307,5,3,309022,309022,309025,0,3,3
88308,5,2,309027,309027,309029,0,2,2
88309,4,3,309031,309031,309034,0,3,2
88310,4,3,309035,309035,309038,0,3,1
88311,1,3,309036,309038,309041,2,5,0
88312,1,1,309037,309041,309042,4,5,0
88313,5,1,309042,309042,309043,0,1,0
88314,5,2,309047,309047,309049,0,2,4
88315,6,2,309053,309053,309055,0,2,4
88316,5,1,309058,309058,309059,0,1,3
88317,3,1,309061,309061,309062,0,1,2
88318,2,3,309063,309063,309066,0,3,1
88319,6,1,309069,309069,309070,0,1,3
88320,2,2,309071,309071,309073,0,2,1
88321,2,2,309073,309073,309075,0,2,0
88322,1,2,309074,309075,309077,1,3,0
88323,3,1,309077,309077,309078,0,1,0
88324,4,1,309081,309081,309082,0,1,3
88325,4,2,309085,309085,309087,0,2,3
88326,5,2,309090,309090,309092,0,2,3
88327,6,1,309096,309096,309097,0,1,4
88328,4,3,309100,309100,309103,0,3,3
88329,1,3,309101,309103,309106,2,5,0
88330,3,1,309104,309106,309107,2,3,0
88331,1,3,309105,309107,309110,2,5,0
88332,5,3,309110,309110,309113,0,3,0
88333,5,2,309115,309115,309117,0,2,2
88334,6,2,309121,309121,309123,0,2,4
88335,5,3,309126,309126,309129,0,3,3
88336,6,2,309132,309132,309134,0,2,3
88337,1,3,309133,309134,309137,1,4,0
88338,4,1,309137,309137,309138,0,1,0
88339,2,2,309139,309139,309141,0,2,1
88340,6,1,309145,309145,309146,0,1,4
88341,4,1,309149,309149,309150,0,1,3
88342,2,3,309151,309151,309154,0,3,1
88343,6,1,309157,309157,309158,0,1,3
88344,3,2,309160,309160,309162,0,2,2
88345,5,1,309165,309165,309166,0,1,3
88346,1,1,309166,309166,309167,0,1,0
88347,3,3,309169,309169,309172,0,3,2
88348,5,2,309174,309174,309176,0,2,2
88349,6,2,309180,309180,309182,0,2,4
88350,2,2,309182,309182,309184,0,2,0
88351,2,2,309184,309184,309186,0,2,0
88352,2,1,309186,309186,309187,0,1,0
88353,6,1,309192,309192,309193,0,1,5
88354,3,2,309195,309195,309197,0,2,2
88355,2,2,309197,309197,309199,0,2,0
88356,5,1,309202,309202,309203,0,1,3
88357,3,1,309205,309205,309206,0,1,2
88358,2,2,309207,309207,309209,0,2,1
88359,2,2,309209,309209,309211,0,2,0
88360,2,3,309211,309211,309214,0,3,0
88361,1,1,309212,309214,309215,2,3,0
88362,1,2,309213,309215,309217,2,4,0
88363,5,3,309218,309218,309221,0,3,1
88364,5,2,309223,309223,309225,0,2,2
88365,4,3,309227,309227,309230,0,3,2
88366,6,3,309233,309233,309236,0,3,3
88367,1,1,309234,309236,309237,2,3,0
88368,3,1,309237,309237,309238,0,1,0
88369,6,3,309243,309243,309246,0,3,5
88370,5,3,309248,309248,309251,0,3,2
88371,1,1,309249,309251,309252,2,3,0
88372,1,3,309250,309252,309255,2,5,0
88373,1,1,309251,309255,309256,4,5,0
88374,6,2,309257,309257,309259,0,2,1
88375,6,2,309263,309263,309265,0,2,4
88376,1,2,309264,309265,309267,1,3,0
88377,1,2,309265,309267,309269,2,4,0
88378,2,2,309267,309269,309271,2,4,0
88379,2,2,309269,309271,309273,2,4,0
88380,3,2,309272,309273,309275,1,3,0
88381,6,3,309278,309278,309281,0,3,3
88382,5,1,309283,309283,309284,0,1,2
88383,3,2,309286,309286,309288,0,2,2
88384,3,1,309289,309289,309290,0,1,1
88385,3,2,309292,309292,309294,0,2,2
88386,4,2,309296,309296,309298,0,2,2
88387,6,1,309302,309302,309303,0,1,4
88388,1,3,309303,309303,309306,0,3,0
88389,5,1,309308,309308,309309,0,1,2
88390,4,3,309312,309312,309315,0,3,3
88391,1,1,309313,309315,309316,2,3,0
88392,4,2,309317,309317,309319,0,2,1
88393,4,1,309321,309321,309322,0,1,2
88394,1,3,309322,309322,309325,0,3,0
88395,2,1,309324,309325,309326,1,2,0
88396,2,1,309326,309326,309327,0,1,0
88397,3,3,309329,309329,309332,0,3,2
88398,4,2,309333,309333,309335,0,2,1
88399,2,1,309335,309335,309336,0,1,0
88400,4,3,309339,309339,309342,0,3,3
88401,1,1,309340,309342,309343,2,3,0
88402,3,2,309343,309343,309345,0,2,0
88403,1,2,309344,309345,309347,1,3,0
88404,6,3,309350,309350,309353,0,3,3
88405,2,3,309352,309353,309356,1,4,0
88406,1,1,309353,309356,309357,3,4,0
88407,6,1,309359,309359,309360,0,1,2
88408,1,2,309360,309360,309362,0,2,0
88409,6,2,309366,309366,309368,0,2,4
88410,6,2,309372,309372,309374,0,2,4
88411,4,2,309376,309376,309378,0,2,2
88412,2,2,309378,309378,309380,0,2,0
88413,4,3,309382,309382,309385,0,3,2
88414,2,2,309384,309385,309387,1,3,0
88415,4,1,309388,309388,309389,0,1,1
88416,3,1,309391,309391,309392,0,1,2
88417,4,3,309395,309395,309398,0,3,3
88418,3,3,309398,309398,309401,0,3,0
88419,3,3,309401,309401,309404,0,3,0
88420,2,3,309403,309404,309407,1,4,0
88421,6,3,309409,309409,309412,0,3,2
88422,6,1,309415,309415,309416,0,1,3
88423,1,3,309416,309416,309419,0,3,0
88424,2,2,309418,309419,309421,1,3,0
88425,2,1,309420,309421,309422,1,2,0
88426,1,1,309421,309422,309423,1,2,0
88427,4,1,309425,309425,309426,0,1,2
88428,3,2,309428,309428,309430,0,2,2
88429,1,1,309429,309430,309431,1,2,0
88430,2,1,309431,309431,309432,0,1,0
88431,3,3,309434,309434,309437,0,3,2
88432,2,2,309436,309437,309439,1,3,0
88433,6,3,309442,309442,309445,0,3,3
88434,2,1,309444,309445,309446,1,2,0
88435,1,3,309445,309446,309449,1,4,0
88436,4,1,309449,309449,309450,0,1,0
88437,6,2,309455,309455,309457,0,2,5
88438,6,3,309461,309461,309464,0,3,4
88439,1,3,309462,309464,309467,2,5,0
88440,2,2,309464,309467,309469,3,5,0
88441,1,1,309465,309469,309470,4,5,0
88442,3,2,309468,309470,309472,2,4,0
88443,1,3,309469,309472,309475,3,6,0
88444,2,1,309471,309475,309476,4,5,0
88445,5,2,309476,309476,309478,0,2,0
88446,5,1,309481,309481,309482,0,1,3
88447,1,2,309482,309482,309484,0,2,0
88448,1,2,309483,309484,309486,1,3,0
88449,1,2,309484,309486,309488,2,4,0
88450,5,2,309489,309489,309491,0,2,1
88451,5,2,309494,309494,309496,0,2,3
88452,6,2,309500,309500,309502,0,2,4
88453,2,2,309502,309502,309504,0,2,0
88454,4,2,309506,309506,309508,0,2,2
88455,6,2,309512,309512,309514,0,2,4
88456,6,3,309518,309518,309521,0,3,4
88457,1,2,309519,309521,309523,2,4,0
88458,5,2,309524,309524,309526,0,2,1
88459,3,2,309527,309527,309529,0,2,1
88460,5,3,309532,309532,309535,0,3,3
88461,4,2,309536,309536,309538,0,2,1
88462,1,2,309537,309538,309540,1,3,0
88463,1,2,309538,309540,309542,2,4,0
88464,3,2,309541,309542,309544,1,3,0
88465,2,1,309543,309544,309545,1,2,0
88466,4,1,309547,309547,309548,0,1,2
88467,2,1,309549,309549,309550,0,1,1
88468,4,2,309553,309553,309555,0,2,3
88469,5,3,309558,309558,309561,0,3,3
88470,2,2,309560,309561,309563,1,3,0
88471,2,2,309562,309563,309565,1,3,0
88472,5,2,309567,309567,309569,0,2,2
88473,2,3,309569,309569,309572,0,3,0
88474,2,2,309571,309572,309574,1,3,0
88475,6,3,309577,309577,309580,0,3,3
88476,1,3,309578,309580,309583,2,5,0
88477,6,2,309584,309584,309586,0,2,1
88478,3,2,309587,309587,309589,0,2,1
88479,1,2,309588,309589,309591,1,3,0
88480,6,3,309594,309594,309597,0,3,3
88481,4,2,309598,309598,309600,0,2,1
88482,4,1,309602,309602,309603,0,1,2
88483,6,3,309608,309608,309611,0,3,5
88484,1,3,309609,309611,309614,2,5,0
88485,1,3,309610,309614,309617,4,7,0
88486,1,3,309611,309617,309620,6,9,0
88487,4,1,309615,309620,309621,5,6,0
88488,5,3,309620,309621,309624,1,4,0
88489,6,2,309626,309626,309628,0,2,2
88490,4,2,309630,309630,309632,0,2,2
88491,5,2,309635,309635,309637,0,2,3
88492,3,3,309638,309638,309641,0,3,1
88493,6,3,309644,309644,309647,0,3,3
88494,2,2,309646,309647,309649,1,3,0
88495,1,3,309647,309649,309652,2,5,0
88496,5,2,309652,309652,309654,0,2,0
88497,4,3,309656,309656,309659,0,3,2
88498,5,3,309661,309661,309664,0,3,2
88499,6,1,309667,309667,309668,0,1,3
88500,1,3,309668,309668,309671,0,3,0
88501,3,1,309671,309671,309672,0,1,0
88502,2,2,309673,309673,309675,0,2,1
88503,4,1,309677,309677,309678,0,1,2
88504,2,3,309679,309679,309682,0,3,1
88505,2,2,309681,309682,309684,1,3,0
88506,1,2,309682,309684,309686,2,4,0
88507,3,2,309685,309686,309688,1,3,0
88508,2,3,309687,309688,309691,1,4,0
88509,4,3,309691,309691,309694,0,3,0
88510,2,2,309693,309694,309696,1,3,0
88511,1,3,309694,309696,309699,2,5,0
88512,5,2,309699,309699,309701,0,2,0
88513,3,3,309702,309702,309705,0,3,1
88514,1,3,309703,309705,309708,2,5,0
88515,5,1,309708,309708,309709,0,1,0
88516,6,3,309714,309714,309717,0,3,5
88517,4,3,309718,309718,309721,0,3,1
88518,3,1,309721,309721,309722,0,1,0
88519,6,3,309727,309727,309730,0,3,5
88520,1,3,309728,309730,309733,2,5,0
88521,5,1,309733,309733,309734,0,1,0
88522,5,2,309738,309738,309740,0,2,4
88523,4,3,309742,309742,309745,0,3,2
88524,3,1,309745,309745,309746,0,1,0
88525,6,1,309751,309751,309752,0,1,5
88526,3,3,309754,309754,309757,0,3,2
88527,2,3,309756,309757,309760,1,4,0
88528,5,1,309761,309761,309762,0,1,1
88529,4,3,309765,309765,309768,0,3,3
88530,2,1,309767,309768,309769,1,2,0
88531,2,2,309769,309769,309771,0,2,0
88532,4,3,309773,309773,309776,0,3,2
88533,5,2,309778,309778,309780,0,2,2
88534,6,2,309784,309784,309786,0,2,4
88535,1,1,309785,309786,309787,1,2,0
88536,1,1,309786,309787,309788,1,2,0
88537,5,2,309791,309791,309793,0,2,3
88538,6,3,309797,309797,309800,0,3,4
88539,2,3,309799,309800,309803,1,4,0
88540,1,3,309800,309803,309806,3,6,0
88541,6,3,309806,309806,309809,0,3,0
88542,4,2,309810,309810,309812,0,2,1
88543,6,3,309816,309816,309819,0,3,4
88544,3,3,309819,309819,309822,0,3,0
88545,6,1,309825,309825,309826,0,1,3
88546,4,2,309829,309829,309831,0,2,3
88547,1,1,309830,309831,309832,1,2,0
88548,2,1,309832,309832,309833,0,1,0
88549,1,1,309833,309833,309834,0,1,0
88550,4,2,309837,309837,309839,0,2,3
88551,6,2,309843,309843,309845,0,2,4
88552,3,1,309846,309846,309847,0,1,1
88553,3,2,309849,309849,309851,0,2,2
88554,3,3,309852,309852,309855,0,3,1
88555,5,3,309857,309857,309860,0,3,2
88556,1,3,309858,309860,309863,2,5,0
88557,2,3,309860,309863,309866,3,6,0
88558,1,3,309861,309866,309869,5,8,0
88559,2,3,309863,309869,309872,6,9,0
88560,6,3,309869,309872,309875,3,6,0
88561,4,1,309873,309875,309876,2,3,0
88562,6,2,309879,309879,309881,0,2,3
88563,1,3,309880,309881,309884,1,4,0
88564,1,2,309881,309884,309886,3,5,0
88565,6,3,309887,309887,309890,0,3,1
88566,3,3,309890,309890,309893,0,3,0
88567,4,1,309894,309894,309895,0,1,1
88568,3,2,309897,309897,309899,0,2,2
88569,4,1,309901,309901,309902,0,1,2
88570,3,3,309904,309904,309907,0,3,2
88571,6,2,309910,309910,309912,0,2,3
88572,3,2,309913,309913,309915,0,2,1
88573,1,1,309914,309915,309916,1,2,0
88574,5,3,309919,309919,309922,0,3,3
88575,2,3,309921,309922,309925,1,4,0
88576,1,3,309922,309925,309928,3,6,0
88577,6,2,309928,309928,309930,0,2,0
88578,6,1,309934,309934,309935,0,1,4
88579,4,2,309938,309938,309940,0,2,3
88580,2,3,309940,309940,309943,0,3,0
88581,2,3,309942,309943,309946,1,4,0
88582,1,2,309943,309946,309948,3,5,0
88583,6,1,309949,309949,309950,0,1,1
88584,6,1,309955,309955,309956,0,1,5
88585,3,1,309958,309958,309959,0,1,2
88586,1,3,309959,309959,309962,0,3,0
88587,4,1,309963,309963,309964,0,1,1
88588,4,2,309967,309967,309969,0,2,3
88589,2,1,309969,309969,309970,0,1,0
88590,6,2,309975,309975,309977,0,2,5
88591,4,3,309979,309979,309982,0,3,2
88592,6,1,309985,309985,309986,0,1,3
88593,4,3,309989,309989,309992,0,3,3
88594,6,1,309995,309995,309996,0,1,3
88595,1,1,309996,309996,309997,0,1,0
88596,5,1,310001,310001,310002,0,1,4
88597,1,3,310002,310002,310005,0,3,0
88598,1,3,310003,310005,310008,2,5,0
88599,1,3,310004,310008,310011,4,7,0
88600,3,3,310007,310011,310014,4,7,0
88601,2,1,310009,310014,310015,5,6,0
88602,2,3,310011,310015,310018,4,7,0
88603,2,3,310013,310018,310021,5,8,0
88604,1,1,310014,310021,310022,7,8,0
88605,4,3,310018,310022,310025,4,7,0
88606,5,3,310023,310025,310028,2,5,0
88607,6,1,310029,310029,310030,0,1,1
88608,5,2,310034,310034,310036,0,2,4
88609,1,3,310035,310036,310039,1,4,0
88610,4,3,310039,310039,310042,0,3,0
88611,5,1,310044,310044,310045,0,1,2
88612,1,2,310045,310045,310047,0,2,0
88613,1,1,310046,310047,310048,1,2,0
88614,1,1,310047,310048,310049,1,2,0
88615,5,2,310052,310052,310054,0,2,3
88616,4,2,310056,310056,310058,0,2,2
88617,5,2,310061,310061,310063,0,2,3
88618,2,1,310063,310063,310064,0,1,0
88619,6,1,310069,310069,310070,0,1,5
88620,4,3,310073,310073,310076,0,3,3
88621,5,2,310078,310078,310080,0,2,2
88622,2,2,310080,310080,310082,0,2,0
88623,3,3,310083,310083,310086,0,3,1
88624,4,1,310087,310087,310088,0,1,1
88625,4,1,310091,310091,310092,0,1,3
88626,2,1,310093,310093,310094,0,1,1
88627,6,1,310099,310099,310100,0,1,5
88628,5,3,310104,310104,310107,0,3,4
88629,5,3,310109,310109,310112,0,3,2
88630,3,2,310112,310112,310114,0,2,0
88631,3,1,310115,310115,310116,0,1,1
88632,3,1,310118,310118,310119,0,1,2
88633,5,1,310123,310123,310124,0,1,4
88634,4,3,310127,310127,310130,0,3,3
88635,2,1,310129,310130,310131,1,2,0
88636,5,1,310134,310134,310135,0,1,3
88637,2,2,310136,310136,310138,0,2,1
88638,1,1,310137,310138,310139,1,2,0
88639,3,1,310140,310140,310141,0,1,1
88640,6,1,310146,310146,310147,0,1,5
88641,1,3,310147,310147,310150,0,3,0
88642,4,1,310151,310151,310152,0,1,1
88643,2,2,310153,310153,310155,0,2,1
88644,6,1,310159,310159,310160,0,1,4
88645,3,1,310162,310162,310163,0,1,2
88646,1,2,310163,310163,310165,0,2,0
88647,3,3,310166,310166,310169,0,3,1
88648,4,1,310170,310170,310171,0,1,1
88649,5,2,310175,310175,310177,0,2,4
88650,2,3,310177,310177,310180,0,3,0
88651,3,3,310180,310180,310183,0,3,0
88652,5,2,310185,310185,310187,0,2,2
88653,1,1,310186,310187,310188,1,2,0
88654,4,3,310190,310190,310193,0,3,2
88655,5,2,310195,310195,310197,0,2,2
88656,5,1,310200,310200,310201,0,1,3
88657,1,2,310201,310201,310203,0,2,0
88658,1,2,310202,310203,310205,1,3,0
88659,3,2,310205,310205,310207,0,2,0
88660,4,1,310209,310209,310210,0,1,2
88661,5,2,310214,310214,310216,0,2,4
88662,3,2,310217,310217,310219,0,2,1
88663,5,1,310222,310222,310223,0,1,3
88664,4,2,310226,310226,310228,0,2,3
88665,1,1,310227,310228,310229,1,2,0
88666,5,3,310232,310232,310235,0,3,3
88667,3,2,310235,310235,310237,0,2,0
88668,6,2,310241,310241,310243,0,2,4
88669,4,3,310245,310245,310248,0,3,2
88670,5,1,310250,310250,310251,0,1,2
88671,1,1,310251,310251,310252,0,1,0
88672,5,2,310256,310256,310258,0,2,4
88673,6,2,310262,310262,310264,0,2,4
88674,5,1,310267,310267,310268,0,1,3
88675,2,2,310269,310269,310271,0,2,1
88676,1,1,310270,310271,310272,1,2,0
88677,4,1,310274,310274,310275,0,1,2
88678,1,3,310275,310275,310278,0,3,0
88679,6,2,310281,310281,310283,0,2,3
88680,4,2,310285,310285,310287,0,2,2
88681,5,1,310290,310290,310291,0,1,3
88682,1,3,310291,310291,310294,0,3,0
88683,6,2,310297,310297,310299,0,2,3
88684,2,2,310299,310299,310301,0,2,0
88685,1,3,310300,310301,310304,1,4,0
88686,4,1,310304,310304,310305,0,1,0
88687,4,2,310308,310308,310310,0,2,3
88688,5,2,310313,310313,310315,0,2,3
88689,1,1,310314,310315,310316,1,2,0
88690,2,1,310316,310316,310317,0,1,0
88691,2,1,310318,310318,310319,0,1,1
88692,5,3,310323,310323,310326,0,3,4
88693,3,1,310326,310326,310327,0,1,0
88694,1,3,310327,310327,310330,0,3,0
88695,6,3,310333,310333,310336,0,3,3
88696,3,1,310336,310336,310337,0,1,0
88697,6,1,310342,310342,310343,0,1,5
88698,4,1,310346,310346,310347,0,1,3
88699,6,1,310352,310352,310353,0,1,5
88700,2,1,310354,310354,310355,0,1,1
88701,1,2,310355,310355,310357,0,2,0
88702,3,1,310358,310358,310359,0,1,1
88703,3,1,310361,310361,310362,0,1,2
88704,1,1,310362,310362,310363,0,1,0
88705,2,3,310364,310364,310367,0,3,1
88706,2,2,310366,310367,310369,1,3,0
88707,5,2,310371,310371,310373,0,2,2
88708,1,2,310372,310373,310375,1,3,0
88709,5,2,310377,310377,310379,0,2,2
88710,2,3,310379,310379,310382,0,3,0
88711,3,3,310382,310382,310385,0,3,0
88712,4,2,310386,310386,310388,0,2,1
88713,3,1,310389,310389,310390,0,1,1
88714,4,2,310393,310393,310395,0,2,3
88715,1,1,310394,310395,310396,1,2,0
88716,1,2,310395,310396,310398,1,3,0
88717,1,2,310396,310398,310400,2,4,0
88718,2,3,310398,310400,310403,2,5,0
88719,5,2,310403,310403,310405,0,2,0
88720,4,1,310407,310407,310408,0,1,2
88721,3,3,310410,310410,310413,0,3,2
88722,5,2,310415,310415,310417,0,2,2
88723,6,3,310421,310421,310424,0,3,4
88724,5,3,310426,310426,310429,0,3,2
88725,2,1,310428,310429,310430,1,2,0
88726,4,2,310432,310432,310434,0,2,2
88727,3,3,310435,310435,310438,0,3,1
88728,3,3,310438,310438,310441,0,3,0
88729,6,2,310444,310444,310446,0,2,3
88730,4,2,310448,310448,310450,0,2,2
88731,5,3,310453,310453,310456,0,3,3
88732,4,1,310457,310457,310458,0,1,1
88733,1,3,310458,310458,310461,0,3,0
88734,5,3,310463,310463,310466,0,3,2
88735,6,2,310469,310469,310471,0,2,3
88736,4,2,310473,310473,310475,0,2,2
88737,3,2,310476,310476,310478,0,2,1
88738,2,1,310478,310478,310479,0,1,0
88739,3,3,310481,310481,310484,0,3,2
88740,3,2,310484,310484,310486,0,2,0
88741,2,2,310486,310486,310488,0,2,0
88742,2,3,310488,310488,310491,0,3,0
88743,5,3,310493,310493,310496,0,3,2
88744,6,1,310499,310499,310500,0,1,3
88745,4,2,310503,310503,310505,0,2,3
88746,4,2,310507,310507,310509,0,2,2
88747,3,2,310510,310510,310512,0,2,1
88748,3,3,310513,310513,310516,0,3,1
88749,3,3,310516,310516,310519,0,3,0
88750,3,1,310519,310519,310520,0,1,0
88751,3,2,310522,310522,310524,0,2,2
88752,4,3,310526,310526,310529,0,3,2
88753,1,3,310527,310529,310532,2,5,0
88754,4,1,310531,310532,310533,1,2,0
88755,1,2,310532,310533,310535,1,3,0
88756,6,2,310538,310538,310540,0,2,3
88757,3,3,310541,310541,310544,0,3,1
88758,3,1,310544,310544,310545,0,1,0
88759,1,2,310545,310545,310547,0,2,0
88760,4,3,310549,310549,310552,0,3,2
88761,3,3,310552,310552,310555,0,3,0
88762,6,3,310558,310558,310561,0,3,3
88763,5,1,310563,310563,310564,0,1,2
88764,6,1,310569,310569,310570,0,1,5
88765,5,2,310574,310574,310576,0,2,4
88766,4,3,310578,310578,310581,0,3,2
88767,4,1,310582,310582,310583,0,1,1
88768,4,3,310586,310586,310589,0,3,3
88769,1,2,310587,310589,310591,2,4,0
88770,4,2,310591,310591,310593,0,2,0
88771,1,3,310592,310593,310596,1,4,0
88772,3,2,310595,310596,310598,1,3,0
88773,2,1,310597,310598,310599,1,2,0
88774,1,3,310598,310599,310602,1,4,0
88775,4,3,310602,310602,310605,0,3,0
88776,5,2,310607,310607,310609,0,2,2
88777,2,1,310609,310609,310610,0,1,0
88778,2,3,310611,310611,310614,0,3,1
88779,1,1,310612,310614,310615,2,3,0
88780,3,2,310615,310615,310617,0,2,0
88781,4,2,310619,310619,310621,0,2,2
88782,6,3,310625,310625,310628,0,3,4
88783,4,1,310629,310629,310630,0,1,1
88784,4,2,310633,310633,310635,0,2,3
88785,6,1,310639,310639,310640,0,1,4
88786,5,2,310644,310644,310646,0,2,4
88787,2,2,310646,310646,310648,0,2,0
88788,4,3,310650,310650,310653,0,3,2
88789,3,2,310653,310653,310655,0,2,0
88790,1,1,310654,310655,310656,1,2,0
88791,5,2,310659,310659,310661,0,2,3
88792,3,3,310662,310662,310665,0,3,1
88793,3,3,310665,310665,310668,0,3,0
88794,6,3,310671,310671,310674,0,3,3
88795,1,1,310672,310674,310675,2,3,0
88796,4,3,310676,310676,310679,0,3,1
88797,5,1,310681,310681,310682,0,1,2
88798,1,3,310682,310682,310685,0,3,0
88799,6,3,310688,310688,310691,0,3,3
88800,3,2,310691,310691,310693,0,2,0
88801,4,2,310695,310695,310697,0,2,2
88802,6,2,310701,310701,310703,0,2,4
88803,4,1,310705,310705,310706,0,1,2
88804,2,1,310707,310707,310708,0,1,1
88805,6,1,310713,310713,310714,0,1,5
88806,5,2,310718,310718,310720,0,2,4
88807,1,1,310719,310720,310721,1,2,0
88808,1,2,310720,310721,310723,1,3,0
88809,5,3,310725,310725,310728,0,3,2
88810,5,3,310730,310730,310733,0,3,2
88811,5,2,310735,310735,310737,0,2,2
88812,1,3,310736,310737,310740,1,4,0
88813,1,2,310737,310740,310742,3,5,0
88814,5,1,310742,310742,310743,0,1,0
88815,2,1,310744,310744,310745,0,1,1
88816,1,1,310745,310745,310746,0,1,0
88817,3,3,310748,310748,310751,0,3,2
88818,3,3,310751,310751,310754,0,3,0
88819,3,1,310754,310754,310755,0,1,0
88820,5,3,310759,310759,310762,0,3,4
88821,4,1,310763,310763,310764,0,1,1
88822,5,3,310768,310768,310771,0,3,4
88823,1,3,310769,310771,310774,2,5,0
88824,5,3,310774,310774,310777,0,3,0
88825,3,1,310777,310777,310778,0,1,0
88826,3,1,310780,310780,310781,0,1,2
88827,5,2,310785,310785,310787,0,2,4
88828,2,2,310787,310787,310789,0,2,0
88829,2,3,310789,310789,310792,0,3,0
88830,2,3,310791,310792,310795,1,4,0
88831,4,1,310795,310795,310796,0,1,0
88832,2,3,310797,310797,310800,0,3,1
88833,1,2,310798,310800,310802,2,4,0
88834,6,3,310804,310804,310807,0,3,2
88835,1,3,310805,310807,310810,2,5,0
88836,5,3,310810,310810,310813,0,3,0
88837,6,2,310816,310816,310818,0,2,3
88838,3,2,310819,310819,310821,0,2,1
88839,6,1,310825,310825,310826,0,1,4
88840,5,2,310830,310830,310832,0,2,4
88841,5,1,310835,310835,310836,0,1,3
88842,3,2,310838,310838,310840,0,2,2
88843,1,2,310839,310840,310842,1,3,0
88844,5,2,310844,310844,310846,0,2,2
88845,1,3,310845,310846,310849,1,4,0
88846,4,1,310849,310849,310850,0,1,0
88847,1,3,310850,310850,310853,0,3,0
88848,1,2,310851,310853,310855,2,4,0
88849,1,1,310852,310855,310856,3,4,0
88850,2,2,310854,310856,310858,2,4,0
88851,6,3,310860,310860,310863,0,3,2
88852,2,2,310862,310863,310865,1,3,0
88853,6,1,310868,310868,310869,0,1,3
88854,3,3,310871,310871,310874,0,3,2
88855,1,2,310872,310874,310876,2,4,0
88856,4,3,310876,310876,310879,0,3,0
88857,3,3,310879,310879,310882,0,3,0
88858,4,3,310883,310883,310886,0,3,1
88859,6,2,310889,310889,310891,0,2,3
88860,1,1,310890,310891,310892,1,2,0
88861,2,3,310892,310892,310895,0,3,0
88862,1,3,310893,310895,310898,2,5,0
88863,4,1,310897,310898,310899,1,2,0
88864,3,2,310900,310900,310902,0,2,1
88865,3,1,310903,310903,310904,0,1,1
88866,4,3,310907,310907,310910,0,3,3
88867,2,3,310909,310910,310913,1,4,0
88868,5,2,310914,310914,310916,0,2,1
88869,3,1,310917,310917,310918,0,1,1
88870,4,1,310921,310921,310922,0,1,3
88871,5,2,310926,310926,310928,0,2,4
88872,1,2,310927,310928,310930,1,3,0
88873,4,2,310931,310931,310933,0,2,1
88874,1,1,310932,310933,310934,1,2,0
88875,2,2,310934,310934,310936,0,2,0
88876,1,1,310935,310936,310937,1,2,0
88877,4,2,310939,310939,310941,0,2,2
88878,3,3,310942,310942,310945,0,3,1
88879,2,2,310944,310945,310947,1,3,0
88880,5,2,310949,310949,310951,0,2,2
88881,4,1,310953,310953,310954,0,1,2
88882,5,2,310958,310958,310960,0,2,4
88883,2,2,310960,310960,310962,0,2,0
88884,5,1,310965,310965,310966,0,1,3
88885,4,3,310969,310969,310972,0,3,3
88886,6,3,310975,310975,310978,0,3,3
88887,3,2,310978,310978,310980,0,2,0
88888,4,1,310982,310982,310983,0,1,2
88889,5,2,310987,310987,310989,0,2,4
88890,3,1,310990,310990,310991,0,1,1
88891,2,2,310992,310992,310994,0,2,1
88892,5,3,310997,310997,311000,0,3,3
88893,3,3,311000,311000,311003,0,3,0
88894,1,2,311001,311003,311005,2,4,0
88895,1,3,311002,311005,311008,3,6,0
88896,6,2,311008,311008,311010,0,2,0
88897,6,1,311014,311014,311015,0,1,4
88898,3,3,311017,311017,311020,0,3,2
88899,1,2,311018,311020,311022,2,4,0
88900,4,2,311022,311022,311024,0,2,0
88901,2,1,311024,311024,311025,0,1,0
88902,3,2,311027,311027,311029,0,2,2
88903,3,3,311030,311030,311033,0,3,1
88904,2,2,311032,311033,311035,1,3,0
88905,2,3,311034,311035,311038,1,4,0
88906,6,2,311040,311040,311042,0,2,2
88907,1,2,311041,311042,311044,1,3,0
88908,4,1,311045,311045,311046,0,1,1
88909,4,1,311049,311049,311050,0,1,3
88910,4,2,311053,311053,311055,0,2,3
88911,3,1,311056,311056,311057,0,1,1
88912,6,1,311062,311062,311063,0,1,5
88913,3,2,311065,311065,311067,0,2,2
88914,1,3,311066,311067,311070,1,4,0
88915,3,1,311069,311070,311071,1,2,0
88916,4,2,311073,311073,311075,0,2,2
88917,6,2,311079,311079,311081,0,2,4
88918,2,3,311081,311081,311084,0,3,0
88919,5,1,311086,311086,311087,0,1,2
88920,1,2,311087,311087,311089,0,2,0
88921,2,1,311089,311089,311090,0,1,0
88922,6,2,311095,311095,311097,0,2,5
88923,3,3,311098,311098,311101,0,3,1
88924,2,1,311100,311101,311102,1,2,0
88925,1,2,311101,311102,311104,1,3,0
88926,6,2,311107,311107,311109,0,2,3
88927,3,2,311110,311110,311112,0,2,1
88928,3,2,311113,311113,311115,0,2,1
88929,1,3,311114,311115,311118,1,4,0
88930,3,3,311117,311118,311121,1,4,0
88931,3,1,311120,311121,311122,1,2,0
88932,2,1,311122,311122,311123,0,1,0
88933,6,2,311128,311128,311130,0,2,5
88934,3,1,311131,311131,311132,0,1,1
88935,5,3,311136,311136,311139,0,3,4
88936,1,2,311137,311139,311141,2,4,0
88937,4,1,311141,311141,311142,0,1,0
88938,4,3,311145,311145,311148,0,3,3
88939,6,3,311151,311151,311154,0,3,3
88940,2,3,311153,311154,311157,1,4,0
88941,3,3,311156,311157,311160,1,4,0
88942,4,3,311160,311160,311163,0,3,0
88943,1,1,311161,311163,311164,2,3,0
88944,6,1,311167,311167,311168,0,1,3
88945,6,1,311173,311173,311174,0,1,5
88946,3,1,311176,311176,311177,0,1,2
88947,6,3,311182,311182,311185,0,3,5
88948,6,1,311188,311188,311189,0,1,3
88949,2,3,311190,311190,311193,0,3,1
88950,5,2,311195,311195,311197,0,2,2
88951,1,2,311196,311197,311199,1,3,0
88952,3,3,311199,311199,311202,0,3,0
88953,3,2,311202,311202,311204,0,2,0
88954,4,2,311206,311206,311208,0,2,2
88955,6,1,311212,311212,311213,0,1,4
88956,6,1,311218,311218,311219,0,1,5
88957,5,2,311223,311223,311225,0,2,4
88958,1,1,311224,311225,311226,1,2,0
88959,6,2,311230,311230,311232,0,2,4
88960,2,1,311232,311232,311233,0,1,0
88961,1,1,311233,311233,311234,0,1,0
88962,4,1,311237,311237,311238,0,1,3
88963,4,3,311241,311241,311244,0,3,3
88964,3,2,311244,311244,311246,0,2,0
88965,1,1,311245,311246,311247,1,2,0
88966,4,2,311249,311249,311251,0,2,2
88967,6,3,311255,311255,311258,0,3,4
88968,5,2,311260,311260,311262,0,2,2
88969,1,3,311261,311262,311265,1,4,0
88970,4,1,311265,311265,311266,0,1,0
88971,1,1,311266,311266,311267,0,1,0
88972,5,1,311271,311271,311272,0,1,4
88973,6,1,311277,311277,311278,0,1,5
88974,4,2,311281,311281,311283,0,2,3
88975,5,3,311286,311286,311289,0,3,3
88976,2,1,311288,311289,311290,1,2,0
88977,3,3,311291,311291,311294,0,3,1
88978,1,2,311292,311294,311296,2,4,0
88979,5,3,311297,311297,311300,0,3,1
88980,6,2,311303,311303,311305,0,2,3
88981,3,3,311306,311306,311309,0,3,1
88982,5,2,311311,311311,311313,0,2,2
88983,3,2,311314,311314,311316,0,2,1
88984,4,1,311318,311318,311319,0,1,2
88985,6,2,311324,311324,311326,0,2,5
88986,3,1,311327,311327,311328,0,1,1
88987,1,2,311328,311328,311330,0,2,0
88988,3,2,311331,311331,311333,0,2,1
88989,6,1,311337,311337,311338,0,1,4
88990,6,2,311343,311343,311345,0,2,5
88991,4,2,311347,311347,311349,0,2,2
88992,3,1,311350,311350,311351,0,1,1
88993,4,1,311354,311354,311355,0,1,3
88994,4,2,311358,311358,311360,0,2,3
88995,1,1,311359,311360,311361,1,2,0
88996,4,3,311363,311363,311366,0,3,2
88997,2,1,311365,311366,311367,1,2,0
88998,3,2,311368,311368,311370,0,2,1
88999,3,3,311371,311371,311374,0,3,1
89000,2,2,311373,311374,311376,1,3,0
89001,4,2,311377,311377,311379,0,2,1
89002,6,3,311383,311383,311386,0,3,4
89003,5,3,311388,311388,311391,0,3,2
89004,6,3,311394,311394,311397,0,3,3
89005,2,2,311396,311397,311399,1,3,0
89006,2,2,311398,311399,311401,1,3,0
89007,4,1,311402,311402,311403,0,1,1
89008,4,3,311406,311406,311409,0,3,3
89009,1,2,311407,311409,311411,2,4,0
89010,1,3,311408,311411,311414,3,6,0
89011,5,2,311413,311414,311416,1,3,0
89012,2,3,311415,311416,311419,1,4,0
89013,2,1,311417,311419,311420,2,3,0
89014,1,1,311418,311420,311421,2,3,0
89015,6,1,311424,311424,311425,0,1,3
89016,1,3,311425,311425,311428,0,3,0
89017,6,1,311431,311431,311432,0,1,3
89018,2,2,311433,311433,311435,0,2,1
89019,6,1,311439,311439,311440,0,1,4
89020,2,1,311441,311441,311442,0,1,1
89021,4,1,311445,311445,311446,0,1,3
89022,5,2,311450,311450,311452,0,2,4
89023,5,1,311455,311455,311456,0,1,3
89024,6,1,311461,311461,311462,0,1,5
89025,2,2,311463,311463,311465,0,2,1
89026,3,2,311466,311466,311468,0,2,1
89027,6,2,311472,311472,311474,0,2,4
89028,4,2,311476,311476,311478,0,2,2
89029,4,1,311480,311480,311481,0,1,2
89030,3,3,311483,311483,311486,0,3,2
89031,2,2,311485,311486,311488,1,3,0
89032,4,1,311489,311489,311490,0,1,1
89033,6,1,311495,311495,311496,0,1,5
89034,3,1,311498,311498,311499,0,1,2
89035,6,1,311504,311504,311505,0,1,5
89036,4,3,311508,311508,311511,0,3,3
89037,5,2,311513,311513,311515,0,2,2
89038,1,1,311514,311515,311516,1,2,0
89039,1,2,311515,311516,311518,1,3,0
89040,1,3,311516,311518,311521,2,5,0
89041,6,2,311522,311522,311524,0,2,1
89042,4,1,311526,311526,311527,0,1,2
89043,6,2,311532,311532,311534,0,2,5
89044,4,2,311536,311536,311538,0,2,2
89045,5,2,311541,311541,311543,0,2,3
89046,5,1,311546,311546,311547,0,1,3
89047,6,3,311552,311552,311555,0,3,5
89048,5,3,311557,311557,311560,0,3,2
89049,2,1,311559,311560,311561,1,2,0
89050,3,1,311562,311562,311563,0,1,1
89051,5,3,311567,311567,311570,0,3,4
89052,3,2,311570,311570,311572,0,2,0
89053,6,2,311576,311576,311578,0,2,4
89054,1,1,311577,311578,311579,1,2,0
89055,3,3,311580,311580,311583,0,3,1
89056,5,1,311585,311585,311586,0,1,2
89057,6,3,311591,311591,311594,0,3,5
89058,5,3,311596,311596,311599,0,3,2
89059,5,2,311601,311601,311603,0,2,2
89060,2,3,311603,311603,311606,0,3,0
89061,6,3,311609,311609,311612,0,3,3
89062,3,3,311612,311612,311615,0,3,0
89063,5,2,311617,311617,311619,0,2,2
89064,2,1,311619,311619,311620,0,1,0
89065,1,1,311620,311620,311621,0,1,0
89066,5,3,311625,311625,311628,0,3,4
89067,4,2,311629,311629,311631,0,2,1
89068,3,3,311632,311632,311635,0,3,1
89069,6,3,311638,311638,311641,0,3,3
89070,1,2,311639,311641,311643,2,4,0
89071,4,1,311643,311643,311644,0,1,0
89072,5,2,311648,311648,311650,0,2,4
89073,2,1,311650,311650,311651,0,1,0
89074,1,2,311651,311651,311653,0,2,0
89075,5,2,311656,311656,311658,0,2,3
89076,4,2,311660,311660,311662,0,2,2
89077,3,3,311663,311663,311666,0,3,1
89078,5,2,311668,311668,311670,0,2,2
89079,2,2,311670,311670,311672,0,2,0
89080,3,2,311673,311673,311675,0,2,1
89081,3,1,311676,311676,311677,0,1,1
89082,4,1,311680,311680,311681,0,1,3
89083,2,1,311682,311682,311683,0,1,1
89084,1,1,311683,311683,311684,0,1,0
89085,3,2,311686,311686,311688,0,2,2
89086,4,3,311690,311690,311693,0,3,2
89087,6,1,311696,311696,311697,0,1,3
89088,6,2,311702,311702,311704,0,2,5
89089,2,2,311704,311704,311706,0,2,0
89090,1,3,311705,311706,311709,1,4,0
89091,4,2,311709,311709,311711,0,2,0
89092,3,2,311712,311712,311714,0,2,1
89093,6,2,311718,311718,311720,0,2,4
89094,4,3,311722,311722,311725,0,3,2
89095,2,1,311724,311725,311726,1,2,0
89096,5,3,311729,311729,311732,0,3,3
89097,2,1,311731,311732,311733,1,2,0
89098,5,3,311736,311736,311739,0,3,3
89099,5,3,311741,311741,311744,0,3,2
89100,6,1,311747,311747,311748,0,1,3
89101,1,3,311748,311748,311751,0,3,0
89102,1,3,311749,311751,311754,2,5,0
89103,2,2,311751,311754,311756,3,5,0
89104,3,2,311754,311756,311758,2,4,0
89105,4,2,311758,311758,311760,0,2,0
89106,1,2,311759,311760,311762,1,3,0
89107,5,2,311764,311764,311766,0,2,2
89108,1,3,311765,311766,311769,1,4,0
89109,6,1,311771,311771,311772,0,1,2
89110,2,3,311773,311773,311776,0,3,1
89111,4,3,311777,311777,311780,0,3,1
89112,4,3,311781,311781,311784,0,3,1
89113,6,2,311787,311787,311789,0,2,3
89114,3,3,311790,311790,311793,0,3,1
89115,1,3,311791,311793,311796,2,5,0
89116,1,1,311792,311796,311797,4,5,0
89117,3,1,311795,311797,311798,2,3,0
89118,4,1,311799,311799,311800,0,1,1
89119,5,2,311804,311804,311806,0,2,4
89120,3,2,311807,311807,311809,0,2,1
89121,3,1,311810,311810,311811,0,1,1
89122,6,1,311816,311816,311817,0,1,5
89123,6,1,311822,311822,311823,0,1,5
89124,4,1,311826,311826,311827,0,1,3
89125,3,2,311829,311829,311831,0,2,2
89126,6,1,311835,311835,311836,0,1,4
89127,4,3,311839,311839,311842,0,3,3
89128,4,1,311843,311843,311844,0,1,1
89129,3,2,311846,311846,311848,0,2,2
89130,1,2,311847,311848,311850,1,3,0
89131,2,1,311849,311850,311851,1,2,0
89132,1,1,311850,311851,311852,1,2,0
89133,5,1,311855,311855,311856,0,1,3
89134,5,2,311860,311860,311862,0,2,4
89135,5,3,311865,311865,311868,0,3,3
89136,3,2,311868,311868,311870,0,2,0
89137,3,2,311871,311871,311873,0,2,1
89138,4,2,311875,311875,311877,0,2,2
89139,1,1,311876,311877,311878,1,2,0
89140,2,3,311878,311878,311881,0,3,0
89141,3,1,311881,311881,311882,0,1,0
89142,6,1,311887,311887,311888,0,1,5
89143,4,2,311891,311891,311893,0,2,3
89144,1,3,311892,311893,311896,1,4,0
89145,2,2,311894,311896,311898,2,4,0
89146,6,1,311900,311900,311901,0,1,2
89147,2,3,311902,311902,311905,0,3,1
89148,3,3,311905,311905,311908,0,3,0
89149,4,3,311909,311909,311912,0,3,1
89150,6,2,311915,311915,311917,0,2,3
89151,3,2,311918,311918,311920,0,2,1
89152,3,3,311921,311921,311924,0,3,1
89153,6,1,311927,311927,311928,0,1,3
89154,5,2,311932,311932,311934,0,2,4
89155,5,1,311937,311937,311938,0,1,3
89156,1,2,311938,311938,311940,0,2,0
89157,1,1,311939,311940,311941,1,2,0
89158,4,1,311943,311943,311944,0,1,2
89159,2,3,311945,311945,311948,0,3,1
89160,5,1,311950,311950,311951,0,1,2
89161,3,2,311953,311953,311955,0,2,2
89162,3,1,311956,311956,311957,0,1,1
89163,3,1,311959,311959,311960,0,1,2
89164,6,3,311965,311965,311968,0,3,5
89165,1,2,311966,311968,311970,2,4,0
89166,1,1,311967,311970,311971,3,4,0
89167,1,3,311968,311971,311974,3,6,0
89168,1,3,311969,311974,311977,5,8,0
89169,3,1,311972,311977,311978,5,6,0
89170,4,1,311976,311978,311979,2,3,0
89171,3,1,311979,311979,311980,0,1,0
89172,2,1,311981,311981,311982,0,1,1
89173,2,3,311983,311983,311986,0,3,1
89174,1,3,311984,311986,311989,2,5,0
89175,3,2,311987,311989,311991,2,4,0
89176,3,3,311990,311991,311994,1,4,0
89177,5,3,311995,311995,311998,0,3,1
89178,6,3,312001,312001,312004,0,3,3
89179,5,2,312006,312006,312008,0,2,2
89180,5,1,312011,312011,312012,0,1,3
89181,2,1,312013,312013,312014,0,1,1
89182,5,1,312018,312018,312019,0,1,4
89183,5,1,312023,312023,312024,0,1,4
89184,4,1,312027,312027,312028,0,1,3
89185,5,3,312032,312032,312035,0,3,4
89186,3,1,312035,312035,312036,0,1,0
89187,1,1,312036,312036,312037,0,1,0
89188,6,2,312042,312042,312044,0,2,5
89189,6,1,312048,312048,312049,0,1,4
89190,3,2,312051,312051,312053,0,2,2
89191,5,3,312056,312056,312059,0,3,3
89192,2,3,312058,312059,312062,1,4,0
89193,4,1,312062,312062,312063,0,1,0
89194,5,3,312067,312067,312070,0,3,4
89195,6,1,312073,312073,312074,0,1,3
89196,3,1,312076,312076,312077,0,1,2
89197,5,2,312081,312081,312083,0,2,4
89198,3,3,312084,312084,312087,0,3,1
89199,6,3,312090,312090,312093,0,3,3
89200,1,2,312091,312093,312095,2,4,0
89201,1,1,312092,312095,312096,3,4,0
89202,2,1,312094,312096,312097,2,3,0
89203,1,2,312095,312097,312099,2,4,0
89204,4,2,312099,312099,312101,0,2,0
89205,5,1,312104,312104,312105,0,1,3
89206,2,3,312106,312106,312109,0,3,1
89207,2,2,312108,312109,312111,1,3,0
89208,5,3,312113,312113,312116,0,3,2
89209,4,3,312117,312117,312120,0,3,1
89210,3,3,312120,312120,312123,0,3,0
89211,3,1,312123,312123,312124,0,1,0
89212,1,2,312124,312124,312126,0,2,0
89213,5,2,312129,312129,312131,0,2,3
89214,2,3,312131,312131,312134,0,3,0
89215,1,1,312132,312134,312135,2,3,0
89216,5,3,312137,312137,312140,0,3,2
89217,2,3,312139,312140,312143,1,4,0
89218,5,1,312144,312144,312145,0,1,1
89219,4,3,312148,312148,312151,0,3,3
89220,4,1,312152,312152,312153,0,1,1
89221,2,1,312154,312154,312155,0,1,1
89222,2,1,312156,312156,312157,0,1,1
89223,6,2,312162,312162,312164,0,2,5
89224,4,2,312166,312166,312168,0,2,2
89225,2,3,312168,312168,312171,0,3,0
89226,2,2,312170,312171,312173,1,3,0
89227,1,1,312171,312173,312174,2,3,0
89228,3,1,312174,312174,312175,0,1,0
89229,3,3,312177,312177,312180,0,3,2
89230,3,2,312180,312180,312182,0,2,0
89231,3,1,312183,312183,312184,0,1,1
89232,4,1,312187,312187,312188,0,1,3
89233,5,3,312192,312192,312195,0,3,4
89234,4,2,312196,312196,312198,0,2,1
89235,2,1,312198,312198,312199,0,1,0
89236,2,1,312200,312200,312201,0,1,1
89237,2,3,312202,312202,312205,0,3,1
89238,2,3,312204,312205,312208,1,4,0
89239,4,1,312208,312208,312209,0,1,0
89240,5,3,312213,312213,312216,0,3,4
89241,4,3,312217,312217,312220,0,3,1
89242,3,2,312220,312220,312222,0,2,0
89243,1,1,312221,312222,312223,1,2,0
89244,1,3,312222,312223,312226,1,4,0
89245,4,2,312226,312226,312228,0,2,0
89246,4,2,312230,312230,312232,0,2,2
89247,4,3,312234,312234,312237,0,3,2
89248,6,3,312240,312240,312243,0,3,3
89249,2,3,312242,312243,312246,1,4,0
89250,6,1,312248,312248,312249,0,1,2
89251,1,1,312249,312249,312250,0,1,0
89252,6,3,312255,312255,312258,0,3,5
89253,3,3,312258,312258,312261,0,3,0
89254,3,3,312261,312261,312264,0,3,0
89255,2,2,312263,312264,312266,1,3,0
89256,1,1,312264,312266,312267,2,3,0
89257,1,1,312265,312267,312268,2,3,0
89258,1,3,312266,312268,312271,2,5,0
89259,6,3,312272,312272,312275,0,3,1
89260,6,3,312278,312278,312281,0,3,3
89261,1,2,312279,312281,312283,2,4,0
89262,3,3,312282,312283,312286,1,4,0
89263,2,3,312284,312286,312289,2,5,0
89264,1,3,312285,312289,312292,4,7,0
89265,3,1,312288,312292,312293,4,5,0
89266,6,1,312294,312294,312295,0,1,1
89267,6,3,312300,312300,312303,0,3,5
89268,3,2,312303,312303,312305,0,2,0
89269,6,3,312309,312309,312312,0,3,4
89270,4,1,312313,312313,312314,0,1,1
89271,5,3,312318,312318,312321,0,3,4
89272,6,1,312324,312324,312325,0,1,3
89273,3,2,312327,312327,312329,0,2,2
89274,4,1,312331,312331,312332,0,1,2
89275,6,2,312337,312337,312339,0,2,5
89276,6,3,312343,312343,312346,0,3,4
89277,6,2,312349,312349,312351,0,2,3
89278,6,1,312355,312355,312356,0,1,4
89279,1,3,312356,312356,312359,0,3,0
89280,2,2,312358,312359,312361,1,3,0
89281,1,1,312359,312361,312362,2,3,0
89282,4,1,312363,312363,312364,0,1,1
89283,5,3,312368,312368,312371,0,3,4
89284,6,3,312374,312374,312377,0,3,3
89285,5,2,312379,312379,312381,0,2,2
89286,5,1,312384,312384,312385,0,1,3
89287,3,1,312387,312387,312388,0,1,2
89288,4,1,312391,312391,312392,0,1,3
89289,6,1,312397,312397,312398,0,1,5
89290,5,3,312402,312402,312405,0,3,4
89291,4,2,312406,312406,312408,0,2,1
89292,4,3,312410,312410,312413,0,3,2
89293,2,3,312412,312413,312416,1,4,0
89294,3,3,312415,312416,312419,1,4,0
89295,6,1,312421,312421,312422,0,1,2
89296,4,3,312425,312425,312428,0,3,3
89297,4,1,312429,312429,312430,0,1,1
89298,1,1,312430,312430,312431,0,1,0
89299,3,2,312433,312433,312435,0,2,2
89300,6,2,312439,312439,312441,0,2,4
89301,1,1,312440,312441,312442,1,2,0
89302,4,2,312444,312444,312446,0,2,2
89303,2,2,312446,312446,312448,0,2,0
89304,3,1,312449,312449,312450,0,1,1
89305,4,1,312453,312453,312454,0,1,3
89306,4,2,312457,312457,312459,0,2,3
89307,6,3,312463,312463,312466,0,3,4
89308,4,1,312467,312467,312468,0,1,1
89309,1,3,312468,312468,312471,0,3,0
89310,3,2,312471,312471,312473,0,2,0
89311,3,1,312474,312474,312475,0,1,1
89312,6,3,312480,312480,312483,0,3,5
89313,5,1,312485,312485,312486,0,1,2
89314,6,2,312491,312491,312493,0,2,5
89315,3,3,312494,312494,312497,0,3,1
89316,1,1,312495,312497,312498,2,3,0
89317,4,1,312499,312499,312500,0,1,1
89318,1,1,312500,312500,312501,0,1,0
89319,1,2,312501,312501,312503,0,2,0
89320,6,2,312507,312507,312509,0,2,4
89321,5,1,312512,312512,312513,0,1,3
89322,6,3,312518,312518,312521,0,3,5
89323,3,1,312521,312521,312522,0,1,0
89324,2,3,312523,312523,312526,0,3,1
89325,6,2,312529,312529,312531,0,2,3
89326,4,3,312533,312533,312536,0,3,2
89327,1,3,312534,312536,312539,2,5,0
89328,2,1,312536,312539,312540,3,4,0
89329,2,1,312538,312540,312541,2,3,0
89330,6,3,312544,312544,312547,0,3,3
89331,5,2,312549,312549,312551,0,2,2
89332,6,1,312555,312555,312556,0,1,4
89333,3,2,312558,312558,312560,0,2,2
89334,2,1,312560,312560,312561,0,1,0
89335,4,1,312564,312564,312565,0,1,3
89336,3,1,312567,312567,312568,0,1,2
89337,6,1,312573,312573,312574,0,1,5
89338,4,1,312577,312577,312578,0,1,3
89339,2,1,312579,312579,312580,0,1,1
89340,2,3,312581,312581,312584,0,3,1
89341,1,3,312582,312584,312587,2,5,0
89342,4,1,312586,312587,312588,1,2,0
89343,1,3,312587,312588,312591,1,4,0
89344,1,2,312588,312591,312593,3,5,0
89345,6,2,312594,312594,312596,0,2,1
89346,6,2,312600,312600,312602,0,2,4
89347,2,1,312602,312602,312603,0,1,0
89348,5,3,312607,312607,312610,0,3,4
89349,4,1,312611,312611,312612,0,1,1
89350,5,3,312616,312616,312619,0,3,4
89351,3,3,312619,312619,312622,0,3,0
89352,6,2,312625,312625,312627,0,2,3
89353,1,3,312626,312627,312630,1,4,0
89354,6,1,312632,312632,312633,0,1,2
89355,4,2,312636,312636,312638,0,2,3
89356,3,2,312639,312639,312641,0,2,1
89357,5,1,312644,312644,312645,0,1,3
89358,3,3,312647,312647,312650,0,3,2
89359,6,1,312653,312653,312654,0,1,3
89360,3,1,312656,312656,312657,0,1,2
89361,2,2,312658,312658,312660,0,2,1
89362,5,3,312663,312663,312666,0,3,3
89363,5,3,312668,312668,312671,0,3,2
89364,3,1,312671,312671,312672,0,1,0
89365,2,2,312673,312673,312675,0,2,1
89366,2,1,312675,312675,312676,0,1,0
89367,4,2,312679,312679,312681,0,2,3
89368,2,3,312681,312681,312684,0,3,0
89369,6,1,312687,312687,312688,0,1,3
89370,4,3,312691,312691,312694,0,3,3
89371,1,3,312692,312694,312697,2,5,0
89372,2,3,312694,312697,312700,3,6,0
89373,3,2,312697,312700,312702,3,5,0
89374,1,3,312698,312702,312705,4,7,0
89375,4,1,312702,312705,312706,3,4,0
89376,5,3,312707,312707,312710,0,3,1
89377,1,1,312708,312710,312711,2,3,0
89378,6,2,312714,312714,312716,0,2,3
89379,1,3,312715,312716,312719,1,4,0
89380,2,2,312717,312719,312721,2,4,0
89381,1,1,312718,312721,312722,3,4,0
89382,6,2,312724,312724,312726,0,2,2
89383,4,3,312728,312728,312731,0,3,2
89384,2,2,312730,312731,312733,1,3,0
89385,5,1,312735,312735,312736,0,1,2
89386,4,3,312739,312739,312742,0,3,3
89387,3,2,312742,312742,312744,0,2,0
89388,4,1,312746,312746,312747,0,1,2
89389,5,3,312751,312751,312754,0,3,4
89390,6,3,312757,312757,312760,0,3,3
89391,6,1,312763,312763,312764,0,1,3
89392,3,2,312766,312766,312768,0,2,2
89393,6,1,312772,312772,312773,0,1,4
89394,6,3,312778,312778,312781,0,3,5
89395,5,1,312783,312783,312784,0,1,2
89396,5,3,312788,312788,312791,0,3,4
89397,1,2,312789,312791,312793,2,4,0
89398,3,3,312792,312793,312796,1,4,0
89399,3,2,312795,312796,312798,1,3,0
89400,3,2,312798,312798,312800,0,2,0
89401,4,1,312802,312802,312803,0,1,2
89402,4,2,312806,312806,312808,0,2,3
89403,5,1,312811,312811,312812,0,1,3
89404,3,2,312814,312814,312816,0,2,2
89405,3,1,312817,312817,312818,0,1,1
89406,1,1,312818,312818,312819,0,1,0
89407,6,3,312824,312824,312827,0,3,5
89408,4,2,312828,312828,312830,0,2,1
89409,1,1,312829,312830,312831,1,2,0
89410,3,3,312832,312832,312835,0,3,1
89411,1,1,312833,312835,312836,2,3,0
89412,4,2,312837,312837,312839,0,2,1
89413,4,2,312841,312841,312843,0,2,2
89414,6,2,312847,312847,312849,0,2,4
89415,1,3,312848,312849,312852,1,4,0
89416,5,3,312853,312853,312856,0,3,1
89417,2,1,312855,312856,312857,1,2,0
89418,4,3,312859,312859,312862,0,3,2
89419,6,1,312865,312865,312866,0,1,3
89420,5,2,312870,312870,312872,0,2,4
89421,4,3,312874,312874,312877,0,3,2
89422,5,1,312879,312879,312880,0,1,2
89423,2,2,312881,312881,312883,0,2,1
89424,2,3,312883,312883,312886,0,3,0
89425,5,3,312888,312888,312891,0,3,2
89426,2,3,312890,312891,312894,1,4,0
89427,4,2,312894,312894,312896,0,2,0
89428,5,1,312899,312899,312900,0,1,3
89429,4,2,312903,312903,312905,0,2,3
89430,1,2,312904,312905,312907,1,3,0
89431,4,1,312908,312908,312909,0,1,1
89432,3,3,312911,312911,312914,0,3,2
89433,3,2,312914,312914,312916,0,2,0
89434,6,3,312920,312920,312923,0,3,4
89435,1,1,312921,312923,312924,2,3,0
89436,1,1,312922,312924,312925,2,3,0
89437,4,1,312926,312926,312927,0,1,1
89438,5,3,312931,312931,312934,0,3,4
89439,4,3,312935,312935,312938,0,3,1
89440,5,1,312940,312940,312941,0,1,2
89441,2,1,312942,312942,312943,0,1,1
89442,1,3,312943,312943,312946,0,3,0
89443,1,3,312944,312946,312949,2,5,0
89444,3,1,312947,312949,312950,2,3,0
89445,1,2,312948,312950,312952,2,4,0
89446,6,2,312954,312954,312956,0,2,2
89447,5,1,312959,312959,312960,0,1,3
89448,4,3,312963,312963,312966,0,3,3
89449,1,3,312964,312966,312969,2,5,0
89450,3,2,312967,312969,312971,2,4,0
89451,1,1,312968,312971,312972,3,4,0
89452,5,2,312973,312973,312975,0,2,1
89453,6,2,312979,312979,312981,0,2,4
89454,5,2,312984,312984,312986,0,2,3
89455,6,2,312990,312990,312992,0,2,4
89456,5,2,312995,312995,312997,0,2,3
89457,2,2,312997,312997,312999,0,2,0
89458,3,1,313000,313000,313001,0,1,1
89459,3,2,313003,313003,313005,0,2,2
89460,4,1,313007,313007,313008,0,1,2
89461,5,1,313012,313012,313013,0,1,4
89462,2,2,313014,313014,313016,0,2,1
89463,4,1,313018,313018,313019,0,1,2
89464,4,2,313022,313022,313024,0,2,3
89465,2,1,313024,313024,313025,0,1,0
89466,5,2,313029,313029,313031,0,2,4
89467,3,1,313032,313032,313033,0,1,1
89468,5,2,313037,313037,313039,0,2,4
89469,2,3,313039,313039,313042,0,3,0
89470,6,2,313045,313045,313047,0,2,3
89471,2,1,313047,313047,313048,0,1,0
89472,2,2,313049,313049,313051,0,2,1
89473,3,1,313052,313052,313053,0,1,1
89474,5,2,313057,313057,313059,0,2,4
89475,4,2,313061,313061,313063,0,2,2
89476,4,1,313065,313065,313066,0,1,2
89477,6,1,313071,313071,313072,0,1,5
89478,5,2,313076,313076,313078,0,2,4
89479,1,3,313077,313078,313081,1,4,0
89480,2,1,313079,313081,313082,2,3,0
89481,1,3,313080,313082,313085,2,5,0
89482,6,2,313086,313086,313088,0,2,1
89483,6,3,313092,313092,313095,0,3,4
89484,3,1,313095,313095,313096,0,1,0
89485,4,2,313099,313099,313101,0,2,3
89486,3,3,313102,313102,313105,0,3,1
89487,4,2,313106,313106,313108,0,2,1
89488,4,3,313110,313110,313113,0,3,2
89489,6,1,313116,313116,313117,0,1,3
89490,3,2,313119,313119,313121,0,2,2
89491,1,3,313120,313121,313124,1,4,0
89492,2,3,313122,313124,313127,2,5,0
89493,6,3,313128,313128,313131,0,3,1
89494,5,3,313133,313133,313136,0,3,2
89495,1,3,313134,313136,313139,2,5,0
89496,5,1,313139,313139,313140,0,1,0
89497,3,2,313142,313142,313144,0,2,2
89498,2,2,313144,313144,313146,0,2,0
89499,6,1,313150,313150,313151,0,1,4
89500,5,2,313155,313155,313157,0,2,4
89501,2,3,313157,313157,313160,0,3,0
89502,6,3,313163,313163,313166,0,3,3
89503,6,3,313169,313169,313172,0,3,3
89504,1,2,313170,313172,313174,2,4,0
89505,6,1,313176,313176,313177,0,1,2
89506,6,1,313182,313182,313183,0,1,5
89507,3,1,313185,313185,313186,0,1,2
89508,3,1,313188,313188,313189,0,1,2
89509,2,2,313190,313190,313192,0,2,1
89510,5,2,313195,313195,313197,0,2,3
89511,1,1,313196,313197,313198,1,2,0
89512,3,1,313199,313199,313200,0,1,1
89513,1,3,313200,313200,313203,0,3,0
89514,3,2,313203,313203,313205,0,2,0
89515,5,3,313208,313208,313211,0,3,3
89516,1,1,313209,313211,313212,2,3,0
89517,6,2,313215,313215,313217,0,2,3
89518,5,1,313220,313220,313221,0,1,3
89519,3,3,313223,313223,313226,0,3,2
89520,5,3,313228,313228,313231,0,3,2
89521,3,1,313231,313231,313232,0,1,0
89522,3,1,313234,313234,313235,0,1,2
89523,1,2,313235,313235,313237,0,2,0
89524,5,2,313240,313240,313242,0,2,3
89525,4,1,313244,313244,313245,0,1,2
89526,1,1,313245,313245,313246,0,1,0
89527,5,3,313250,313250,313253,0,3,4
89528,5,1,313255,313255,313256,0,1,2
89529,4,2,313259,313259,313261,0,2,3
89530,2,2,313261,313261,313263,0,2,0
89531,5,1,313266,313266,313267,0,1,3
89532,3,3,313269,313269,313272,0,3,2
89533,1,2,313270,313272,313274,2,4,0
89534,2,2,313272,313274,313276,2,4,0
89535,2,2,313274,313276,313278,2,4,0
89536,6,1,313280,313280,313281,0,1,2
89537,4,2,313284,313284,313286,0,2,3
89538,3,3,313287,313287,313290,0,3,1
89539,5,2,313292,313292,313294,0,2,2
89540,2,1,313294,313294,313295,0,1,0
89541,6,1,313300,313300,313301,0,1,5
89542,3,2,313303,313303,313305,0,2,2
89543,1,3,313304,313305,313308,1,4,0
89544,3,2,313307,313308,313310,1,3,0
89545,5,1,313312,313312,313313,0,1,2
89546,4,2,313316,313316,313318,0,2,3
89547,4,2,313320,313320,313322,0,2,2
89548,4,2,313324,313324,313326,0,2,2
89549,3,1,313327,313327,313328,0,1,1
89550,3,2,313330,313330,313332,0,2,2
89551,5,2,313335,313335,313337,0,2,3
89552,2,3,313337,313337,313340,0,3,0
89553,4,3,313341,313341,313344,0,3,1
89554,5,2,313346,313346,313348,0,2,2
89555,3,3,313349,313349,313352,0,3,1
89556,6,1,313355,313355,313356,0,1,3
89557,2,3,313357,313357,313360,0,3,1
89558,5,1,313362,313362,313363,0,1,2
89559,1,1,313363,313363,313364,0,1,0
89560,4,2,313367,313367,313369,0,2,3
89561,6,3,313373,313373,313376,0,3,4
89562,3,1,313376,313376,313377,0,1,0
89563,2,3,313378,313378,313381,0,3,1
89564,2,2,313380,313381,313383,1,3,0
89565,1,2,313381,313383,313385,2,4,0
89566,6,2,313387,313387,313389,0,2,2
89567,2,1,313389,313389,313390,0,1,0
89568,5,3,313394,313394,313397,0,3,4
89569,6,2,313400,313400,313402,0,2,3
89570,1,2,313401,313402,313404,1,3,0
89571,5,2,313406,313406,313408,0,2,2
89572,4,3,313410,313410,313413,0,3,2
89573,4,1,313414,313414,313415,0,1,1
89574,1,2,313415,313415,313417,0,2,0
89575,2,1,313417,313417,313418,0,1,0
89576,2,2,313419,313419,313421,0,2,1
89577,3,3,313422,313422,313425,0,3,1
89578,6,3,313428,313428,313431,0,3,3
89579,3,2,313431,313431,313433,0,2,0
89580,6,3,313437,313437,313440,0,3,4
89581,6,3,313443,313443,313446,0,3,3
89582,2,2,313445,313446,313448,1,3,0
89583,1,2,313446,313448,313450,2,4,0
89584,4,1,313450,313450,313451,0,1,0
89585,3,1,313453,313453,313454,0,1,2
89586,6,1,313459,313459,313460,0,1,5
89587,1,2,313460,313460,313462,0,2,0
89588,5,3,313465,313465,313468,0,3,3
89589,5,2,313470,313470,313472,0,2,2
89590,5,3,313475,313475,313478,0,3,3
89591,1,2,313476,313478,313480,2,4,0
89592,3,2,313479,313480,313482,1,3,0
89593,5,1,313484,313484,313485,0,1,2
89594,2,1,313486,313486,313487,0,1,1
89595,4,3,313490,313490,313493,0,3,3
89596,1,1,313491,313493,313494,2,3,0
89597,2,2,313493,313494,313496,1,3,0
89598,5,1,313498,313498,313499,0,1,2
89599,6,1,313504,313504,313505,0,1,5
89600,4,1,313508,313508,313509,0,1,3
89601,2,2,313510,313510,313512,0,2,1
89602,4,1,313514,313514,313515,0,1,2
89603,2,1,313516,313516,313517,0,1,1
89604,3,3,313519,313519,313522,0,3,2
89605,4,2,313523,313523,313525,0,2,1
89606,5,1,313528,313528,313529,0,1,3
89607,5,3,313533,313533,313536,0,3,4
89608,2,3,313535,313536,313539,1,4,0
89609,4,1,313539,313539,313540,0,1,0
89610,2,3,313541,313541,313544,0,3,1
89611,1,3,313542,313544,313547,2,5,0
89612,6,3,313548,313548,313551,0,3,1
89613,4,3,313552,313552,313555,0,3,1
89614,1,2,313553,313555,313557,2,4,0
89615,1,3,313554,313557,313560,3,6,0
89616,5,1,313559,313560,313561,1,2,0
89617,1,1,313560,313561,313562,1,2,0
89618,3,1,313563,313563,313564,0,1,1
89619,2,2,313565,313565,313567,0,2,1
89620,1,1,313566,313567,313568,1,2,0
89621,6,1,313572,313572,313573,0,1,4
89622,1,1,313573,313573,313574,0,1,0
89623,4,2,313577,313577,313579,0,2,3
89624,5,3,313582,313582,313585,0,3,3
89625,3,2,313585,313585,313587,0,2,0
89626,2,1,313587,313587,313588,0,1,0
89627,3,1,313590,313590,313591,0,1,2
89628,6,2,313596,313596,313598,0,2,5
89629,5,1,313601,313601,313602,0,1,3
89630,3,2,313604,313604,313606,0,2,2
89631,2,2,313606,313606,313608,0,2,0
89632,5,1,313611,313611,313612,0,1,3
89633,6,3,313617,313617,313620,0,3,5
89634,5,2,313622,313622,313624,0,2,2
89635,4,3,313626,313626,313629,0,3,2
89636,5,2,313631,313631,313633,0,2,2
89637,6,3,313637,313637,313640,0,3,4
89638,2,3,313639,313640,313643,1,4,0
89639,3,3,313642,313643,313646,1,4,0
89640,4,2,313646,313646,313648,0,2,0
89641,3,2,313649,313649,313651,0,2,1
89642,4,1,313653,313653,313654,0,1,2
89643,4,3,313657,313657,313660,0,3,3
89644,6,1,313663,313663,313664,0,1,3
89645,6,1,313669,313669,313670,0,1,5
89646,4,1,313673,313673,313674,0,1,3
89647,1,2,313674,313674,313676,0,2,0
89648,3,2,313677,313677,313679,0,2,1
89649,2,1,313679,313679,313680,0,1,0
89650,3,3,313682,313682,313685,0,3,2
89651,3,2,313685,313685,313687,0,2,0
89652,2,2,313687,313687,313689,0,2,0
89653,5,1,313692,313692,313693,0,1,3
89654,3,3,313695,313695,313698,0,3,2
89655,4,3,313699,313699,313702,0,3,1
89656,5,2,313704,313704,313706,0,2,2
89657,2,1,313706,313706,313707,0,1,0
89658,6,3,313712,313712,313715,0,3,5
89659,1,3,313713,313715,313718,2,5,0
89660,5,3,313718,313718,313721,0,3,0
89661,6,1,313724,313724,313725,0,1,3
89662,4,1,313728,313728,313729,0,1,3
89663,2,2,313730,313730,313732,0,2,1
89664,6,2,313736,313736,313738,0,2,4
89665,5,1,313741,313741,313742,0,1,3
89666,3,2,313744,313744,313746,0,2,2
89667,6,1,313750,313750,313751,0,1,4
89668,3,1,313753,313753,313754,0,1,2
89669,4,1,313757,313757,313758,0,1,3
89670,1,2,313758,313758,313760,0,2,0
89671,4,2,313762,313762,313764,0,2,2
89672,2,2,313764,313764,313766,0,2,0
89673,6,2,313770,313770,313772,0,2,4
89674,1,3,313771,313772,313775,1,4,0
89675,2,2,313773,313775,313777,2,4,0
89676,4,3,313777,313777,313780,0,3,0
89677,1,3,313778,313780,313783,2,5,0
89678,5,1,313783,313783,313784,0,1,0
89679,4,2,313787,313787,313789,0,2,3
89680,3,2,313790,313790,313792,0,2,1
89681,1,3,313791,313792,313795,1,4,0
89682,1,2,313792,313795,313797,3,5,0
89683,5,1,313797,313797,313798,0,1,0
89684,6,1,313803,313803,313804,0,1,5
89685,5,3,313808,313808,313811,0,3,4
89686,6,3,313814,313814,313817,0,3,3
89687,4,3,313818,313818,313821,0,3,1
89688,6,1,313824,313824,313825,0,1,3
89689,5,3,313829,313829,313832,0,3,4
89690,4,1,313833,313833,313834,0,1,1
89691,2,1,313835,313835,313836,0,1,1
89692,2,2,313837,313837,313839,0,2,1
89693,2,3,313839,313839,313842,0,3,0
89694,2,2,313841,313842,313844,1,3,0
89695,4,1,313845,313845,313846,0,1,1
89696,6,1,313851,313851,313852,0,1,5
89697,3,2,313854,313854,313856,0,2,2
89698,3,2,313857,313857,313859,0,2,1
89699,3,3,313860,313860,313863,0,3,1
89700,5,2,313865,313865,313867,0,2,2
89701,4,2,313869,313869,313871,0,2,2
89702,3,3,313872,313872,313875,0,3,1
89703,4,3,313876,313876,313879,0,3,1
89704,3,2,313879,313879,313881,0,2,0
89705,6,2,313885,313885,313887,0,2,4
89706,2,3,313887,313887,313890,0,3,0
89707,6,1,313893,313893,313894,0,1,3
89708,6,1,313899,313899,313900,0,1,5
89709,4,3,313903,313903,313906,0,3,3
89710,1,2,313904,313906,313908,2,4,0
89711,5,2,313909,313909,313911,0,2,1
89712,5,3,313914,313914,313917,0,3,3
89713,5,3,313919,313919,313922,0,3,2
89714,6,1,313925,313925,313926,0,1,3
89715,4,2,313929,313929,313931,0,2,3
89716,2,3,313931,313931,313934,0,3,0
89717,6,1,313937,313937,313938,0,1,3
89718,1,1,313938,313938,313939,0,1,0
89719,4,1,313942,313942,313943,0,1,3
89720,2,2,313944,313944,313946,0,2,1
89721,5,2,313949,313949,313951,0,2,3
89722,3,3,313952,313952,313955,0,3,1
89723,2,3,313954,313955,313958,1,4,0
89724,1,2,313955,313958,313960,3,5,0
89725,5,1,313960,313960,313961,0,1,0
89726,4,3,313964,313964,313967,0,3,3
89727,1,2,313965,313967,313969,2,4,0
89728,3,1,313968,313969,313970,1,2,0
89729,3,3,313971,313971,313974,0,3,1
89730,3,3,313974,313974,313977,0,3,0
89731,3,3,313977,313977,313980,0,3,0
89732,4,1,313981,313981,313982,0,1,1
89733,4,1,313985,313985,313986,0,1,3
89734,3,3,313988,313988,313991,0,3,2
89735,1,2,313989,313991,313993,2,4,0
89736,3,1,313992,313993,313994,1,2,0
89737,6,2,313998,313998,314000,0,2,4
89738,3,1,314001,314001,314002,0,1,1
89739,4,3,314005,314005,314008,0,3,3
89740,6,3,314011,314011,314014,0,3,3
89741,4,2,314015,314015,314017,0,2,1
89742,6,1,314021,314021,314022,0,1,4
89743,4,1,314025,314025,314026,0,1,3
89744,1,3,314026,314026,314029,0,3,0
89745,3,1,314029,314029,314030,0,1,0
89746,2,2,314031,314031,314033,0,2,1
89747,4,3,314035,314035,314038,0,3,2
89748,1,1,314036,314038,314039,2,3,0
89749,1,2,314037,314039,314041,2,4,0
89750,3,3,314040,314041,314044,1,4,0
89751,2,3,314042,314044,314047,2,5,0
89752,5,3,314047,314047,314050,0,3,0
89753,1,3,314048,314050,314053,2,5,0
89754,2,3,314050,314053,314056,3,6,0
89755,1,1,314051,314056,314057,5,6,0
89756,2,1,314053,314057,314058,4,5,0
89757,6,3,314059,314059,314062,0,3,1
89758,6,3,314065,314065,314068,0,3,3
89759,3,3,314068,314068,314071,0,3,0
89760,1,1,314069,314071,314072,2,3,0
89761,3,1,314072,314072,314073,0,1,0
89762,2,2,314074,314074,314076,0,2,1
89763,6,1,314080,314080,314081,0,1,4
89764,1,2,314081,314081,314083,0,2,0
89765,5,2,314086,314086,314088,0,2,3
89766,3,3,314089,314089,314092,0,3,1
89767,6,2,314095,314095,314097,0,2,3
89768,1,3,314096,314097,314100,1,4,0
89769,2,1,314098,314100,314101,2,3,0
89770,5,2,314103,314103,314105,0,2,2
89771,4,2,314107,314107,314109,0,2,2
89772,2,1,314109,314109,314110,0,1,0
89773,6,1,314115,314115,314116,0,1,5
89774,3,1,314118,314118,314119,0,1,2
89775,4,3,314122,314122,314125,0,3,3
89776,4,2,314126,314126,314128,0,2,1
89777,3,1,314129,314129,314130,0,1,1
89778,3,1,314132,314132,314133,0,1,2
89779,4,2,314136,314136,314138,0,2,3
89780,6,2,314142,314142,314144,0,2,4
89781,2,2,314144,314144,314146,0,2,0
89782,6,1,314150,314150,314151,0,1,4
89783,6,1,314156,314156,314157,0,1,5
89784,2,1,314158,314158,314159,0,1,1
89785,3,2,314161,314161,314163,0,2,2
89786,3,3,314164,314164,314167,0,3,1
89787,1,1,314165,314167,314168,2,3,0
89788,3,2,314168,314168,314170,0,2,0
89789,3,2,314171,314171,314173,0,2,1
89790,2,2,314173,314173,314175,0,2,0
89791,3,2,314176,314176,314178,0,2,1
89792,1,2,314177,314178,314180,1,3,0
89793,2,2,314179,314180,314182,1,3,0
89794,1,2,314180,314182,314184,2,4,0
89795,6,1,314186,314186,314187,0,1,2
89796,4,2,314190,314190,314192,0,2,3
89797,2,2,314192,314192,314194,0,2,0
89798,2,1,314194,314194,314195,0,1,0
89799,5,3,314199,314199,314202,0,3,4
89800,1,1,314200,314202,314203,2,3,0
89801,4,1,314204,314204,314205,0,1,1
89802,2,2,314206,314206,314208,0,2,1
89803,6,1,314212,314212,314213,0,1,4
89804,1,2,314213,314213,314215,0,2,0
89805,4,1,314217,314217,314218,0,1,2
89806,1,3,314218,314218,314221,0,3,0
89807,3,1,314221,314221,314222,0,1,0
89808,2,3,314223,314223,314226,0,3,1
89809,6,2,314229,314229,314231,0,2,3
89810,3,3,314232,314232,314235,0,3,1
89811,5,2,314237,314237,314239,0,2,2
89812,2,2,314239,314239,314241,0,2,0
89813,2,2,314241,314241,314243,0,2,0
89814,6,2,314247,314247,314249,0,2,4
89815,6,1,314253,314253,314254,0,1,4
89816,2,3,314255,314255,314258,0,3,1
89817,4,1,314259,314259,314260,0,1,1
89818,5,1,314264,314264,314265,0,1,4
89819,3,3,314267,314267,314270,0,3,2
89820,6,2,314273,314273,314275,0,2,3
89821,4,2,314277,314277,314279,0,2,2
89822,5,1,314282,314282,314283,0,1,3
89823,2,1,314284,314284,314285,0,1,1
89824,3,2,314287,314287,314289,0,2,2
89825,5,2,314292,314292,314294,0,2,3
89826,5,2,314297,314297,314299,0,2,3
89827,6,3,314303,314303,314306,0,3,4
89828,6,2,314309,314309,314311,0,2,3
89829,4,1,314313,314313,314314,0,1,2
89830,5,3,314318,314318,314321,0,3,4
89831,2,3,314320,314321,314324,1,4,0
89832,3,1,314323,314324,314325,1,2,0
89833,2,3,314325,314325,314328,0,3,0
89834,4,1,314329,314329,314330,0,1,1
89835,6,3,314335,314335,314338,0,3,5
89836,3,1,314338,314338,314339,0,1,0
89837,1,2,314339,314339,314341,0,2,0
89838,4,2,314343,314343,314345,0,2,2
89839,4,1,314347,314347,314348,0,1,2
89840,2,1,314349,314349,314350,0,1,1
89841,6,1,314355,314355,314356,0,1,5
89842,5,1,314360,314360,314361,0,1,4
89843,5,1,314365,314365,314366,0,1,4
89844,1,2,314366,314366,314368,0,2,0
89845,6,2,314372,314372,314374,0,2,4
89846,1,2,314373,314374,314376,1,3,0
89847,1,2,314374,314376,314378,2,4,0
89848,3,3,314377,314378,314381,1,4,0
89849,2,3,314379,314381,314384,2,5,0
89850,6,1,314385,314385,314386,0,1,1
89851,6,3,314391,314391,314394,0,3,5
89852,3,1,314394,314394,314395,0,1,0
89853,1,3,314395,314395,314398,0,3,0
89854,2,1,314397,314398,314399,1,2,0
89855,5,2,314402,314402,314404,0,2,3
89856,6,3,314408,314408,314411,0,3,4
89857,3,2,314411,314411,314413,0,2,0
89858,5,3,314416,314416,314419,0,3,3
89859,3,3,314419,314419,314422,0,3,0
89860,2,3,314421,314422,314425,1,4,0
89861,1,3,314422,314425,314428,3,6,0
89862,3,1,314425,314428,314429,3,4,0
89863,4,3,314429,314429,314432,0,3,0
89864,3,3,314432,314432,314435,0,3,0
89865,1,1,314433,314435,314436,2,3,0
89866,4,3,314437,314437,314440,0,3,1
89867,6,2,314443,314443,314445,0,2,3
89868,4,2,314447,314447,314449,0,2,2
89869,5,2,314452,314452,314454,0,2,3
89870,5,3,314457,314457,314460,0,3,3
89871,5,2,314462,314462,314464,0,2,2
89872,2,3,314464,314464,314467,0,3,0
89873,5,3,314469,314469,314472,0,3,2
89874,5,1,314474,314474,314475,0,1,2
89875,5,2,314479,314479,314481,0,2,4
89876,1,1,314480,314481,314482,1,2,0
89877,4,3,314484,314484,314487,0,3,2
89878,4,2,314488,314488,314490,0,2,1
89879,4,3,314492,314492,314495,0,3,2
89880,6,2,314498,314498,314500,0,2,3
89881,4,1,314502,314502,314503,0,1,2
89882,6,2,314508,314508,314510,0,2,5
89883,1,1,314509,314510,314511,1,2,0
89884,1,2,314510,314511,314513,1,3,0
89885,5,3,314515,314515,314518,0,3,2
89886,2,2,314517,314518,314520,1,3,0
89887,4,3,314521,314521,314524,0,3,1
89888,5,1,314526,314526,314527,0,1,2
89889,2,1,314528,314528,314529,0,1,1
89890,2,3,314530,314530,314533,0,3,1
89891,5,1,314535,314535,314536,0,1,2
89892,3,3,314538,314538,314541,0,3,2
89893,3,2,314541,314541,314543,0,2,0
89894,4,2,314545,314545,314547,0,2,2
89895,2,2,314547,314547,314549,0,2,0
89896,6,1,314553,314553,314554,0,1,4
89897,4,2,314557,314557,314559,0,2,3
89898,1,2,314558,314559,314561,1,3,0
89899,6,1,314564,314564,314565,0,1,3
89900,6,1,314570,314570,314571,0,1,5
89901,5,3,314575,314575,314578,0,3,4
89902,4,1,314579,314579,314580,0,1,1
89903,2,2,314581,314581,314583,0,2,1
89904,1,1,314582,314583,314584,1,2,0
89905,5,3,314587,314587,314590,0,3,3
89906,2,1,314589,314590,314591,1,2,0
89907,1,2,314590,314591,314593,1,3,0
89908,4,3,314594,314594,314597,0,3,1
89909,3,2,314597,314597,314599,0,2,0
89910,2,1,314599,314599,314600,0,1,0
89911,2,3,314601,314601,314604,0,3,1
89912,2,3,314603,314604,314607,1,4,0
89913,1,3,314604,314607,314610,3,6,0
89914,5,1,314609,314610,314611,1,2,0
89915,5,2,314614,314614,314616,0,2,3
89916,5,2,314619,314619,314621,0,2,3
89917,5,2,314624,314624,314626,0,2,3
89918,1,1,314625,314626,314627,1,2,0
89919,4,3,314629,314629,314632,0,3,2
89920,4,3,314633,314633,314636,0,3,1
89921,2,1,314635,314636,314637,1,2,0
89922,4,1,314639,314639,314640,0,1,2
89923,1,2,314640,314640,314642,0,2,0
89924,6,1,314646,314646,314647,0,1,4
89925,1,3,314647,314647,314650,0,3,0
89926,6,2,314653,314653,314655,0,2,3
89927,5,1,314658,314658,314659,0,1,3
89928,2,3,314660,314660,314663,0,3,1
89929,2,2,314662,314663,314665,1,3,0
89930,3,2,314665,314665,314667,0,2,0
89931,5,2,314670,314670,314672,0,2,3
89932,5,1,314675,314675,314676,0,1,3
89933,5,3,314680,314680,314683,0,3,4
89934,5,1,314685,314685,314686,0,1,2
89935,5,1,314690,314690,314691,0,1,4
89936,1,3,314691,314691,314694,0,3,0
89937,3,2,314694,314694,314696,0,2,0
89938,5,1,314699,314699,314700,0,1,3
89939,6,3,314705,314705,314708,0,3,5
89940,5,1,314710,314710,314711,0,1,2
89941,2,3,314712,314712,314715,0,3,1
89942,4,2,314716,314716,314718,0,2,1
89943,6,2,314722,314722,314724,0,2,4
89944,3,1,314725,314725,314726,0,1,1
89945,6,2,314731,314731,314733,0,2,5
89946,5,1,314736,314736,314737,0,1,3
89947,6,3,314742,314742,314745,0,3,5
89948,4,2,314746,314746,314748,0,2,1
89949,1,2,314747,314748,314750,1,3,0
89950,5,3,314752,314752,314755,0,3,2
89951,5,1,314757,314757,314758,0,1,2
89952,2,1,314759,314759,314760,0,1,1
89953,3,1,314762,314762,314763,0,1,2
89954,3,3,314765,314765,314768,0,3,2
89955,3,1,314768,314768,314769,0,1,0
89956,4,3,314772,314772,314775,0,3,3
89957,6,2,314778,314778,314780,0,2,3
89958,1,2,314779,314780,314782,1,3,0
89959,5,1,314784,314784,314785,0,1,2
89960,2,3,314786,314786,314789,0,3,1
89961,2,1,314788,314789,314790,1,2,0
89962,3,2,314791,314791,314793,0,2,1
89963,4,1,314795,314795,314796,0,1,2
89964,4,2,314799,314799,314801,0,2,3
89965,3,1,314802,314802,314803,0,1,1
89966,6,1,314808,314808,314809,0,1,5
89967,1,3,314809,314809,314812,0,3,0
89968,3,1,314812,314812,314813,0,1,0
89969,1,1,314813,314813,314814,0,1,0
89970,5,1,314818,314818,314819,0,1,4
89971,3,2,314821,314821,314823,0,2,2
89972,4,2,314825,314825,314827,0,2,2
89973,6,2,314831,314831,314833,0,2,4
89974,2,2,314833,314833,314835,0,2,0
89975,4,3,314837,314837,314840,0,3,2
89976,3,2,314840,314840,314842,0,2,0
89977,4,3,314844,314844,314847,0,3,2
89978,2,2,314846,314847,314849,1,3,0
89979,4,3,314850,314850,314853,0,3,1
89980,4,1,314854,314854,314855,0,1,1
89981,3,1,314857,314857,314858,0,1,2
89982,2,2,314859,314859,314861,0,2,1
89983,5,1,314864,314864,314865,0,1,3
89984,5,3,314869,314869,314872,0,3,4
89985,2,2,314871,314872,314874,1,3,0
89986,2,1,314873,314874,314875,1,2,0
89987,2,3,314875,314875,314878,0,3,0
89988,2,3,314877,314878,314881,1,4,0
89989,3,3,314880,314881,314884,1,4,0
89990,4,2,314884,314884,314886,0,2,0
89991,2,1,314886,314886,314887,0,1,0
89992,5,2,314891,314891,314893,0,2,4
89993,1,1,314892,314893,314894,1,2,0
89994,1,3,314893,314894,314897,1,4,0
89995,4,1,314897,314897,314898,0,1,0
89996,5,1,314902,314902,314903,0,1,4
89997,5,2,314907,314907,314909,0,2,4
89998,4,3,314911,314911,314914,0,3,2
89999,1,1,314912,314914,314915,2,3,0
90000,6,1,314918,314918,314919,0,1,3
90001,3,3,314921,314921,314924,0,3,2
90002,3,1,314924,314924,314925,0,1,0
90003,2,2,314926,314926,314928,0,2,1
90004,1,2,314927,314928,314930,1,3,0
90005,4,3,314931,314931,314934,0,3,1
90006,2,1,314933,314934,314935,1,2,0
90007,3,2,314936,314936,314938,0,2,1
90008,4,1,314940,314940,314941,0,1,2
90009,6,1,314946,314946,314947,0,1,5
90010,4,2,314950,314950,314952,0,2,3
90011,5,2,314955,314955,314957,0,2,3
90012,3,3,314958,314958,314961,0,3,1
90013,5,2,314963,314963,314965,0,2,2
90014,1,3,314964,314965,314968,1,4,0
90015,3,1,314967,314968,314969,1,2,0
90016,3,2,314970,314970,314972,0,2,1
90017,1,2,314971,314972,314974,1,3,0
90018,2,1,314973,314974,314975,1,2,0
90019,2,1,314975,314975,314976,0,1,0
90020,3,1,314978,314978,314979,0,1,2
90021,4,2,314982,314982,314984,0,2,3
90022,4,2,314986,314986,314988,0,2,2
90023,1,2,314987,314988,314990,1,3,0
90024,5,3,314992,314992,314995,0,3,2
90025,5,3,314997,314997,315000,0,3,2
90026,1,3,314998,315000,315003,2,5,0
90027,3,2,315001,315003,315005,2,4,0
90028,3,1,315004,315005,315006,1,2,0
90029,2,3,315006,315006,315009,0,3,0
90030,6,1,315012,315012,315013,0,1,3
90031,1,3,315013,315013,315016,0,3,0
90032,4,2,315017,315017,315019,0,2,1
90033,2,3,315019,315019,315022,0,3,0
90034,6,3,315025,315025,315028,0,3,3
90035,5,3,315030,315030,315033,0,3,2
90036,1,2,315031,315033,315035,2,4,0
90037,6,1,315037,315037,315038,0,1,2
90038,6,2,315043,315043,315045,0,2,5
90039,3,1,315046,315046,315047,0,1,1
90040,3,3,315049,315049,315052,0,3,2
90041,3,3,315052,315052,315055,0,3,0
90042,4,3,315056,315056,315059,0,3,1
90043,6,2,315062,315062,315064,0,2,3
90044,4,1,315066,315066,315067,0,1,2
90045,1,2,315067,315067,315069,0,2,0
90046,3,2,315070,315070,315072,0,2,1
90047,1,2,315071,315072,315074,1,3,0
90048,1,2,315072,315074,315076,2,4,0
90049,4,2,315076,315076,315078,0,2,0
90050,6,1,315082,315082,315083,0,1,4
90051,6,3,315088,315088,315091,0,3,5
90052,1,1,315089,315091,315092,2,3,0
90053,2,3,315091,315092,315095,1,4,0
90054,4,3,315095,315095,315098,0,3,0
90055,6,2,315101,315101,315103,0,2,3
90056,5,1,315106,315106,315107,0,1,3
90057,1,2,315107,315107,315109,0,2,0
90058,6,2,315113,315113,315115,0,2,4
90059,1,2,315114,315115,315117,1,3,0
90060,3,1,315117,315117,315118,0,1,0
90061,2,3,315119,315119,315122,0,3,1
90062,2,3,315121,315122,315125,1,4,0
90063,3,2,315124,315125,315127,1,3,0
90064,5,2,315129,315129,315131,0,2,2
90065,4,2,315133,315133,315135,0,2,2
90066,6,3,315139,315139,315142,0,3,4
90067,5,3,315144,315144,315147,0,3,2
90068,5,3,315149,315149,315152,0,3,2
90069,5,1,315154,315154,315155,0,1,2
90070,3,1,315157,315157,315158,0,1,2
90071,6,1,315163,315163,315164,0,1,5
90072,1,3,315164,315164,315167,0,3,0
90073,6,1,315170,315170,315171,0,1,3
90074,1,3,315171,315171,315174,0,3,0
90075,3,3,315174,315174,315177,0,3,0
90076,1,3,315175,315177,315180,2,5,0
90077,1,3,315176,315180,315183,4,7,0
90078,1,3,315177,315183,315186,6,9,0
90079,3,1,315180,315186,315187,6,7,0
90080,1,2,315181,315187,315189,6,8,0
90081,6,1,315187,315189,315190,2,3,0
90082,2,2,315189,315190,315192,1,3,0
90083,2,2,315191,315192,315194,1,3,0
90084,2,1,315193,315194,315195,1,2,0
90085,6,1,315199,315199,315200,0,1,4
90086,3,1,315202,315202,315203,0,1,2
90087,2,3,315204,315204,315207,0,3,1
90088,1,1,315205,315207,315208,2,3,0
90089,1,1,315206,315208,315209,2,3,0
90090,5,1,315211,315211,315212,0,1,2
90091,1,2,315212,315212,315214,0,2,0
90092,5,1,315217,315217,315218,0,1,3
90093,2,3,315219,315219,315222,0,3,1
90094,3,3,315222,315222,315225,0,3,0
90095,3,3,315225,315225,315228,0,3,0
90096,3,1,315228,315228,315229,0,1,0
90097,4,2,315232,315232,315234,0,2,3
90098,1,1,315233,315234,315235,1,2,0
90099,1,2,315234,315235,315237,1,3,0
90100,1,3,315235,315237,315240,2,5,0
90101,3,3,315238,315240,315243,2,5,0
90102,3,3,315241,315243,315246,2,5,0
90103,5,3,315246,315246,315249,0,3,0
90104,6,1,315252,315252,315253,0,1,3
90105,4,1,315256,315256,315257,0,1,3
90106,6,3,315262,315262,315265,0,3,5
90107,1,3,315263,315265,315268,2,5,0
90108,5,2,315268,315268,315270,0,2,0
90109,2,3,315270,315270,315273,0,3,0
90110,5,2,315275,315275,315277,0,2,2
90111,3,3,315278,315278,315281,0,3,1
90112,4,3,315282,315282,315285,0,3,1
90113,1,3,315283,315285,315288,2,5,0
90114,3,1,315286,315288,315289,2,3,0
90115,3,3,315289,315289,315292,0,3,0
90116,5,3,315294,315294,315297,0,3,2
90117,6,3,315300,315300,315303,0,3,3
90118,6,1,315306,315306,315307,0,1,3
90119,6,3,315312,315312,315315,0,3,5
90120,5,3,315317,315317,315320,0,3,2
90121,5,1,315322,315322,315323,0,1,2
90122,5,2,315327,315327,315329,0,2,4
90123,3,1,315330,315330,315331,0,1,1
90124,2,2,315332,315332,315334,0,2,1
90125,6,3,315338,315338,315341,0,3,4
90126,6,3,315344,315344,315347,0,3,3
90127,6,2,315350,315350,315352,0,2,3
90128,3,1,315353,315353,315354,0,1,1
90129,1,1,315354,315354,315355,0,1,0
90130,1,2,315355,315355,315357,0,2,0
90131,3,2,315358,315358,315360,0,2,1
90132,3,3,315361,315361,315364,0,3,1
90133,4,2,315365,315365,315367,0,2,1
90134,1,2,315366,315367,315369,1,3,0
90135,4,2,315370,315370,315372,0,2,1
90136,6,2,315376,315376,315378,0,2,4
90137,3,2,315379,315379,315381,0,2,1
90138,4,2,315383,315383,315385,0,2,2
90139,5,2,315388,315388,315390,0,2,3
90140,6,3,315394,315394,315397,0,3,4
90141,1,1,315395,315397,315398,2,3,0
90142,4,3,315399,315399,315402,0,3,1
90143,6,3,315405,315405,315408,0,3,3
90144,4,2,315409,315409,315411,0,2,1
90145,2,3,315411,315411,315414,0,3,0
90146,1,1,315412,315414,315415,2,3,0
90147,1,3,315413,315415,315418,2,5,0
90148,4,2,315417,315418,315420,1,3,0
90149,2,3,315419,315420,315423,1,4,0
90150,1,3,315420,315423,315426,3,6,0
90151,4,3,315424,315426,315429,2,5,0
90152,5,1,315429,315429,315430,0,1,0
90153,5,3,315434,315434,315437,0,3,4
90154,4,3,315438,315438,315441,0,3,1
90155,4,3,315442,315442,315445,0,3,1
90156,2,2,315444,315445,315447,1,3,0
90157,3,3,315447,315447,315450,0,3,0
90158,4,1,315451,315451,315452,0,1,1
90159,1,1,315452,315452,315453,0,1,0
90160,5,2,315457,315457,315459,0,2,4
90161,5,2,315462,315462,315464,0,2,3
90162,4,2,315466,315466,315468,0,2,2
90163,4,2,315470,315470,315472,0,2,2
90164,6,3,315476,315476,315479,0,3,4
90165,2,2,315478,315479,315481,1,3,0
90166,4,1,315482,315482,315483,0,1,1
90167,2,1,315484,315484,315485,0,1,1
90168,3,3,315487,315487,315490,0,3,2
90169,3,3,315490,315490,315493,0,3,0
90170,4,2,315494,315494,315496,0,2,1
90171,2,3,315496,315496,315499,0,3,0
90172,3,2,315499,315499,315501,0,2,0
90173,5,3,315504,315504,315507,0,3,3
90174,6,2,315510,315510,315512,0,2,3
90175,4,3,315514,315514,315517,0,3,2
90176,5,1,315519,315519,315520,0,1,2
90177,1,3,315520,315520,315523,0,3,0
90178,1,1,315521,315523,315524,2,3,0
90179,1,1,315522,315524,315525,2,3,0
90180,4,3,315526,315526,315529,0,3,1
90181,3,1,315529,315529,315530,0,1,0
90182,4,1,315533,315533,315534,0,1,3
90183,5,1,315538,315538,315539,0,1,4
90184,2,2,315540,315540,315542,0,2,1
90185,6,2,315546,315546,315548,0,2,4
90186,1,2,315547,315548,315550,1,3,0
90187,6,3,315553,315553,315556,0,3,3
90188,4,3,315557,315557,315560,0,3,1
90189,2,1,315559,315560,315561,1,2,0
90190,1,3,315560,315561,315564,1,4,0
90191,3,3,315563,315564,315567,1,4,0
90192,3,1,315566,315567,315568,1,2,0
90193,5,2,315571,315571,315573,0,2,3
90194,5,1,315576,315576,315577,0,1,3
90195,4,3,315580,315580,315583,0,3,3
90196,3,3,315583,315583,315586,0,3,0
90197,1,2,315584,315586,315588,2,4,0
90198,4,3,315588,315588,315591,0,3,0
90199,1,3,315589,315591,315594,2,5,0
90200,5,3,315594,315594,315597,0,3,0
90201,4,3,315598,315598,315601,0,3,1
90202,4,1,315602,315602,315603,0,1,1
90203,2,1,315604,315604,315605,0,1,1
90204,5,3,315609,315609,315612,0,3,4
90205,3,3,315612,315612,315615,0,3,0
90206,2,3,315614,315615,315618,1,4,0
90207,2,1,315616,315618,315619,2,3,0
90208,2,2,315618,315619,315621,1,3,0
90209,3,1,315621,315621,315622,0,1,0
90210,4,1,315625,315625,315626,0,1,3
90211,3,2,315628,315628,315630,0,2,2
90212,5,3,315633,315633,315636,0,3,3
90213,5,2,315638,315638,315640,0,2,2
90214,6,2,315644,315644,315646,0,2,4
90215,4,2,315648,315648,315650,0,2,2
90216,4,1,315652,315652,315653,0,1,2
90217,4,3,315656,315656,315659,0,3,3
90218,3,2,315659,315659,315661,0,2,0
90219,4,3,315663,315663,315666,0,3,2
90220,1,2,315664,315666,315668,2,4,0
90221,2,2,315666,315668,315670,2,4,0
90222,6,2,315672,315672,315674,0,2,2
90223,5,2,315677,315677,315679,0,2,3
90224,1,1,315678,315679,315680,1,2,0
90225,1,1,315679,315680,315681,1,2,0
90226,3,3,315682,315682,315685,0,3,1
90227,3,1,315685,315685,315686,0,1,0
90228,6,1,315691,315691,315692,0,1,5
90229,1,2,315692,315692,315694,0,2,0
90230,5,2,315697,315697,315699,0,2,3
90231,2,2,315699,315699,315701,0,2,0
90232,4,2,315703,315703,315705,0,2,2
90233,3,2,315706,315706,315708,0,2,1
90234,1,3,315707,315708,315711,1,4,0
90235,6,2,315713,315713,315715,0,2,2
90236,3,1,315716,315716,315717,0,1,1
90237,4,2,315720,315720,315722,0,2,3
90238,6,1,315726,315726,315727,0,1,4
90239,5,1,315731,315731,315732,0,1,4
90240,1,2,315732,315732,315734,0,2,0
90241,3,2,315735,315735,315737,0,2,1
90242,5,1,315740,315740,315741,0,1,3
90243,2,2,315742,315742,315744,0,2,1
90244,3,3,315745,315745,315748,0,3,1
90245,3,2,315748,315748,315750,0,2,0
90246,6,1,315754,315754,315755,0,1,4
90247,1,1,315755,315755,315756,0,1,0
90248,1,1,315756,315756,315757,0,1,0
90249,4,3,315760,315760,315763,0,3,3
90250,1,2,315761,315763,315765,2,4,0
90251,5,3,315766,315766,315769,0,3,1
90252,1,1,315767,315769,315770,2,3,0
90253,4,1,315771,315771,315772,0,1,1
90254,4,3,315775,315775,315778,0,3,3
90255,6,1,315781,315781,315782,0,1,3
90256,2,3,315783,315783,315786,0,3,1
90257,3,2,315786,315786,315788,0,2,0
90258,3,1,315789,315789,315790,0,1,1
90259,2,1,315791,315791,315792,0,1,1
90260,3,1,315794,315794,315795,0,1,2
90261,5,3,315799,315799,315802,0,3,4
90262,3,3,315802,315802,315805,0,3,0
90263,2,1,315804,315805,315806,1,2,0
90264,5,3,315809,315809,315812,0,3,3
90265,5,1,315814,315814,315815,0,1,2
90266,5,1,315819,315819,315820,0,1,4
90267,4,3,315823,315823,315826,0,3,3
90268,6,2,315829,315829,315831,0,2,3
90269,2,3,315831,315831,315834,0,3,0
90270,1,1,315832,315834,315835,2,3,0
90271,2,2,315834,315835,315837,1,3,0
90272,4,3,315838,315838,315841,0,3,1
90273,2,1,315840,315841,315842,1,2,0
90274,4,3,315844,315844,315847,0,3,2
90275,6,3,315850,315850,315853,0,3,3
90276,1,2,315851,315853,315855,2,4,0
90277,4,2,315855,315855,315857,0,2,0
90278,6,3,315861,315861,315864,0,3,4
90279,6,2,315867,315867,315869,0,2,3
90280,5,3,315872,315872,315875,0,3,3
90281,4,2,315876,315876,315878,0,2,1
90282,2,1,315878,315878,315879,0,1,0
90283,6,1,315884,315884,315885,0,1,5
90284,4,3,315888,315888,315891,0,3,3
90285,1,2,315889,315891,315893,2,4,0
90286,5,3,315894,315894,315897,0,3,1
90287,3,3,315897,315897,315900,0,3,0
90288,6,1,315903,315903,315904,0,1,3
90289,3,3,315906,315906,315909,0,3,2
90290,3,1,315909,315909,315910,0,1,0
90291,3,3,315912,315912,315915,0,3,2
90292,6,1,315918,315918,315919,0,1,3
90293,4,2,315922,315922,315924,0,2,3
90294,3,1,315925,315925,315926,0,1,1
90295,3,1,315928,315928,315929,0,1,2
90296,5,1,315933,315933,315934,0,1,4
90297,2,1,315935,315935,315936,0,1,1
90298,5,2,315940,315940,315942,0,2,4
90299,2,2,315942,315942,315944,0,2,0
90300,6,2,315948,315948,315950,0,2,4
90301,6,3,315954,315954,315957,0,3,4
90302,4,1,315958,315958,315959,0,1,1
90303,6,1,315964,315964,315965,0,1,5
90304,2,3,315966,315966,315969,0,3,1
90305,2,2,315968,315969,315971,1,3,0
90306,6,2,315974,315974,315976,0,2,3
90307,2,3,315976,315976,315979,0,3,0
90308,2,1,315978,315979,315980,1,2,0
90309,6,2,315984,315984,315986,0,2,4
90310,1,2,315985,315986,315988,1,3,0
90311,4,2,315989,315989,315991,0,2,1
90312,1,1,315990,315991,315992,1,2,0
90313,3,3,315993,315993,315996,0,3,1
90314,5,1,315998,315998,315999,0,1,2
90315,1,1,315999,315999,316000,0,1,0
90316,2,1,316001,316001,316002,0,1,1
90317,3,3,316004,316004,316007,0,3,2
90318,2,1,316006,316007,316008,1,2,0
90319,3,3,316009,316009,316012,0,3,1
90320,2,2,316011,316012,316014,1,3,0
90321,1,2,316012,316014,316016,2,4,0
90322,2,2,316014,316016,316018,2,4,0
90323,5,2,316019,316019,316021,0,2,1
90324,6,1,316025,316025,316026,0,1,4
90325,4,2,316029,316029,316031,0,2,3
90326,5,2,316034,316034,316036,0,2,3
90327,5,1,316039,316039,316040,0,1,3
90328,1,3,316040,316040,316043,0,3,0
90329,1,3,316041,316043,316046,2,5,0
90330,4,3,316045,316046,316049,1,4,0
90331,4,1,316049,316049,316050,0,1,0
90332,1,3,316050,316050,316053,0,3,0
90333,5,3,316055,316055,316058,0,3,2
90334,1,3,316056,316058,316061,2,5,0
90335,6,3,316062,316062,316065,0,3,1
90336,6,2,316068,316068,316070,0,2,3
90337,3,2,316071,316071,316073,0,2,1
90338,6,3,316077,316077,316080,0,3,4
90339,1,1,316078,316080,316081,2,3,0
90340,1,2,316079,316081,316083,2,4,0
90341,1,1,316080,316083,316084,3,4,0
90342,4,1,316084,316084,316085,0,1,0
90343,3,1,316087,316087,316088,0,1,2
90344,5,3,316092,316092,316095,0,3,4
90345,6,2,316098,316098,316100,0,2,3
90346,4,1,316102,316102,316103,0,1,2
90347,3,3,316105,316105,316108,0,3,2
90348,6,2,316111,316111,316113,0,2,3
90349,2,2,316113,316113,316115,0,2,0
90350,6,1,316119,316119,316120,0,1,4
90351,1,3,316120,316120,316123,0,3,0
90352,5,3,316125,316125,316128,0,3,2
90353,2,3,316127,316128,316131,1,4,0
90354,5,1,316132,316132,316133,0,1,1
90355,5,2,316137,316137,316139,0,2,4
90356,6,3,316143,316143,316146,0,3,4
90357,2,1,316145,316146,316147,1,2,0
90358,6,3,316151,316151,316154,0,3,4
90359,2,2,316153,316154,316156,1,3,0
90360,3,1,316156,316156,316157,0,1,0
90361,5,3,316161,316161,316164,0,3,4
90362,1,3,316162,316164,316167,2,5,0
90363,1,2,316163,316167,316169,4,6,0
90364,2,3,316165,316169,316172,4,7,0
90365,5,2,316170,316172,316174,2,4,0
90366,2,3,316172,316174,316177,2,5,0
90367,2,2,316174,316177,316179,3,5,0
90368,5,2,316179,316179,316181,0,2,0
90369,1,1,316180,316181,316182,1,2,0
90370,1,2,316181,316182,316184,1,3,0
90371,6,1,316187,316187,316188,0,1,3
90372,3,1,316190,316190,316191,0,1,2
90373,1,2,316191,316191,316193,0,2,0
90374,2,3,316193,316193,316196,0,3,0
90375,4,3,316197,316197,316200,0,3,1
90376,2,2,316199,316200,316202,1,3,0
90377,3,1,316202,316202,316203,0,1,0
90378,6,3,316208,316208,316211,0,3,5
90379,4,1,316212,316212,316213,0,1,1
90380,4,3,316216,316216,316219,0,3,3
90381,6,2,316222,316222,316224,0,2,3
90382,2,1,316224,316224,316225,0,1,0
90383,6,2,316230,316230,316232,0,2,5
90384,6,2,316236,316236,316238,0,2,4
90385,6,1,316242,316242,316243,0,1,4
90386,1,2,316243,316243,316245,0,2,0
90387,5,3,316248,316248,316251,0,3,3
90388,5,3,316253,316253,316256,0,3,2
90389,5,2,316258,316258,316260,0,2,2
90390,6,3,316264,316264,316267,0,3,4
90391,4,1,316268,316268,316269,0,1,1
90392,5,1,316273,316273,316274,0,1,4
90393,5,1,316278,316278,316279,0,1,4
90394,5,2,316283,316283,316285,0,2,4
90395,4,3,316287,316287,316290,0,3,2
90396,3,3,316290,316290,316293,0,3,0
90397,6,2,316296,316296,316298,0,2,3
90398,1,3,316297,316298,316301,1,4,0
90399,1,1,316298,316301,316302,3,4,0
90400,6,1,316304,316304,316305,0,1,2
90401,3,2,316307,316307,316309,0,2,2
90402,2,2,316309,316309,316311,0,2,0
90403,2,3,316311,316311,316314,0,3,0
90404,6,1,316317,316317,316318,0,1,3
90405,1,1,316318,316318,316319,0,1,0
90406,3,2,316321,316321,316323,0,2,2
90407,3,3,316324,316324,316327,0,3,1
90408,4,2,316328,316328,316330,0,2,1
90409,5,3,316333,316333,316336,0,3,3
90410,4,2,316337,316337,316339,0,2,1
90411,6,1,316343,316343,316344,0,1,4
90412,5,1,316348,316348,316349,0,1,4
90413,2,2,316350,316350,316352,0,2,1
90414,2,3,316352,316352,316355,0,3,0
90415,2,1,316354,316355,316356,1,2,0
90416,6,2,316360,316360,316362,0,2,4
90417,5,3,316365,316365,316368,0,3,3
90418,5,1,316370,316370,316371,0,1,2
90419,5,3,316375,316375,316378,0,3,4
90420,6,3,316381,316381,316384,0,3,3
90421,2,1,316383,316384,316385,1,2,0
90422,2,1,316385,316385,316386,0,1,0
90423,1,1,316386,316386,316387,0,1,0
90424,6,1,316392,316392,316393,0,1,5
90425,6,1,316398,316398,316399,0,1,5
90426,4,3,316402,316402,316405,0,3,3
90427,6,3,316408,316408,316411,0,3,3
90428,5,1,316413,316413,316414,0,1,2
90429,3,2,316416,316416,316418,0,2,2
90430,6,1,316422,316422,316423,0,1,4
90431,4,2,316426,316426,316428,0,2,3
90432,2,3,316428,316428,316431,0,3,0
90433,4,2,316432,316432,316434,0,2,1
90434,2,1,316434,316434,316435,0,1,0
90435,3,2,316437,316437,316439,0,2,2
90436,4,1,316441,316441,316442,0,1,2
90437,5,3,316446,316446,316449,0,3,4
90438,4,3,316450,316450,316453,0,3,1
90439,5,3,316455,316455,316458,0,3,2
90440,6,2,316461,316461,316463,0,2,3
90441,6,1,316467,316467,316468,0,1,4
90442,2,2,316469,316469,316471,0,2,1
90443,1,1,316470,316471,316472,1,2,0
90444,2,1,316472,316472,316473,0,1,0
90445,3,3,316475,316475,316478,0,3,2
90446,6,1,316481,316481,316482,0,1,3
90447,2,1,316483,316483,316484,0,1,1
90448,3,3,316486,316486,316489,0,3,2
90449,5,2,316491,316491,316493,0,2,2
90450,3,3,316494,316494,316497,0,3,1
90451,4,1,316498,316498,316499,0,1,1
90452,5,1,316503,316503,316504,0,1,4
90453,4,2,316507,316507,316509,0,2,3
90454,5,3,316512,316512,316515,0,3,3
90455,1,2,316513,316515,316517,2,4,0
90456,6,1,316519,316519,316520,0,1,2
90457,2,3,316521,316521,316524,0,3,1
90458,2,2,316523,316524,316526,1,3,0
90459,6,2,316529,316529,316531,0,2,3
90460,3,3,316532,316532,316535,0,3,1
90461,4,1,316536,316536,316537,0,1,1
90462,2,1,316538,316538,316539,0,1,1
90463,6,2,316544,316544,316546,0,2,5
90464,3,3,316547,316547,316550,0,3,1
90465,6,2,316553,316553,316555,0,2,3
90466,2,2,316555,316555,316557,0,2,0
90467,1,1,316556,316557,316558,1,2,0
90468,2,3,316558,316558,316561,0,3,0
90469,6,3,316564,316564,316567,0,3,3
90470,1,2,316565,316567,316569,2,4,0
90471,5,3,316570,316570,316573,0,3,1
90472,6,3,316576,316576,316579,0,3,3
90473,5,2,316581,316581,316583,0,2,2
90474,6,2,316587,316587,316589,0,2,4
90475,3,2,316590,316590,316592,0,2,1
90476,5,1,316595,316595,316596,0,1,3
90477,1,1,316596,316596,316597,0,1,0
90478,6,2,316602,316602,316604,0,2,5
90479,1,2,316603,316604,316606,1,3,0
90480,3,1,316606,316606,316607,0,1,0
90481,1,1,316607,316607,316608,0,1,0
90482,5,3,316612,316612,316615,0,3,4
90483,4,1,316616,316616,316617,0,1,1
90484,5,3,316621,316621,316624,0,3,4
90485,3,3,316624,316624,316627,0,3,0
90486,3,1,316627,316627,316628,0,1,0
90487,3,1,316630,316630,316631,0,1,2
90488,5,2,316635,316635,316637,0,2,4
90489,5,1,316640,316640,316641,0,1,3
90490,6,1,316646,316646,316647,0,1,5
90491,3,2,316649,316649,316651,0,2,2
90492,1,2,316650,316651,316653,1,3,0
90493,4,3,316654,316654,316657,0,3,1
90494,2,2,316656,316657,316659,1,3,0
90495,3,3,316659,316659,316662,0,3,0
90496,1,3,316660,316662,316665,2,5,0
90497,1,1,316661,316665,316666,4,5,0
90498,1,1,316662,316666,316667,4,5,0
90499,2,3,316664,316667,316670,3,6,0
90500,3,1,316667,316670,316671,3,4,0
90501,6,1,316673,316673,316674,0,1,2
90502,5,1,316678,316678,316679,0,1,4
90503,6,1,316684,316684,316685,0,1,5
90504,3,1,316687,316687,316688,0,1,2
90505,2,3,316689,316689,316692,0,3,1
90506,3,3,316692,316692,316695,0,3,0
90507,6,2,316698,316698,316700,0,2,3
90508,5,1,316703,316703,316704,0,1,3
90509,1,1,316704,316704,316705,0,1,0
90510,5,3,316709,316709,316712,0,3,4
90511,6,1,316715,316715,316716,0,1,3
90512,2,3,316717,316717,316720,0,3,1
90513,6,1,316723,316723,316724,0,1,3
90514,2,1,316725,316725,316726,0,1,1
90515,2,2,316727,316727,316729,0,2,1
90516,6,3,316733,316733,316736,0,3,4
90517,5,2,316738,316738,316740,0,2,2
90518,6,3,316744,316744,316747,0,3,4
90519,6,3,316750,316750,316753,0,3,3
90520,4,2,316754,316754,316756,0,2,1
90521,2,1,316756,316756,316757,0,1,0
90522,1,2,316757,316757,316759,0,2,0
90523,1,2,316758,316759,316761,1,3,0
90524,1,2,316759,316761,316763,2,4,0
90525,6,3,316765,316765,316768,0,3,2
90526,1,2,316766,316768,316770,2,4,0
90527,1,1,316767,316770,316771,3,4,0
90528,6,2,316773,316773,316775,0,2,2
90529,1,1,316774,316775,316776,1,2,0
90530,1,3,316775,316776,316779,1,4,0
90531,6,1,316781,316781,316782,0,1,2
90532,3,3,316784,316784,316787,0,3,2
90533,1,2,316785,316787,316789,2,4,0
90534,1,2,316786,316789,316791,3,5,0
90535,1,1,316787,316791,316792,4,5,0
90536,2,3,316789,316792,316795,3,6,0
90537,1,3,316790,316795,316798,5,8,0
90538,6,2,316796,316798,316800,2,4,0
90539,5,1,316801,316801,316802,0,1,1
90540,4,1,316805,316805,316806,0,1,3
90541,4,1,316809,316809,316810,0,1,3
90542,5,1,316814,316814,316815,0,1,4
90543,5,1,316819,316819,316820,0,1,4
90544,1,1,316820,316820,316821,0,1,0
90545,2,3,316822,316822,316825,0,3,1
90546,6,2,316828,316828,316830,0,2,3
90547,3,1,316831,316831,316832,0,1,1
90548,4,2,316835,316835,316837,0,2,3
90549,2,3,316837,316837,316840,0,3,0
90550,5,3,316842,316842,316845,0,3,2
90551,5,2,316847,316847,316849,0,2,2
90552,3,3,316850,316850,316853,0,3,1
90553,5,3,316855,316855,316858,0,3,2
90554,2,1,316857,316858,316859,1,2,0
90555,5,3,316862,316862,316865,0,3,3
90556,2,2,316864,316865,316867,1,3,0
90557,3,1,316867,316867,316868,0,1,0
90558,4,3,316871,316871,316874,0,3,3
90559,6,1,316877,316877,316878,0,1,3
90560,5,1,316882,316882,316883,0,1,4
90561,4,2,316886,316886,316888,0,2,3
90562,6,1,316892,316892,316893,0,1,4
90563,6,3,316898,316898,316901,0,3,5
90564,6,3,316904,316904,316907,0,3,3
90565,1,2,316905,316907,316909,2,4,0
90566,5,3,316910,316910,316913,0,3,1
90567,3,1,316913,316913,316914,0,1,0
90568,6,2,316919,316919,316921,0,2,5
90569,2,1,316921,316921,316922,0,1,0
90570,5,1,316926,316926,316927,0,1,4
90571,6,1,316932,316932,316933,0,1,5
90572,2,3,316934,316934,316937,0,3,1
90573,2,3,316936,316937,316940,1,4,0
90574,2,2,316938,316940,316942,2,4,0
90575,3,2,316941,316942,316944,1,3,0
90576,2,1,316943,316944,316945,1,2,0
90577,4,3,316947,316947,316950,0,3,2
90578,4,3,316951,316951,316954,0,3,1
90579,6,1,316957,316957,316958,0,1,3
90580,1,1,316958,316958,316959,0,1,0
90581,6,2,316964,316964,316966,0,2,5
90582,1,2,316965,316966,316968,1,3,0
90583,3,2,316968,316968,316970,0,2,0
90584,6,2,316974,316974,316976,0,2,4
90585,2,3,316976,316976,316979,0,3,0
90586,1,1,316977,316979,316980,2,3,0
90587,5,1,316982,316982,316983,0,1,2
90588,4,2,316986,316986,316988,0,2,3
90589,6,2,316992,316992,316994,0,2,4
90590,5,2,316997,316997,316999,0,2,3
90591,6,3,317003,317003,317006,0,3,4
90592,5,3,317008,317008,317011,0,3,2
90593,1,2,317009,317011,317013,2,4,0
90594,3,3,317012,317013,317016,1,4,0
90595,2,1,317014,317016,317017,2,3,0
90596,3,3,317017,317017,317020,0,3,0
90597,6,3,317023,317023,317026,0,3,3
90598,6,1,317029,317029,317030,0,1,3
90599,2,2,317031,317031,317033,0,2,1
90600,2,3,317033,317033,317036,0,3,0
90601,5,3,317038,317038,317041,0,3,2
90602,5,3,317043,317043,317046,0,3,2
90603,2,2,317045,317046,317048,1,3,0
90604,2,2,317047,317048,317050,1,3,0
90605,1,2,317048,317050,317052,2,4,0
90606,4,1,317052,317052,317053,0,1,0
90607,5,3,317057,317057,317060,0,3,4
90608,3,2,317060,317060,317062,0,2,0
90609,1,1,317061,317062,317063,1,2,0
90610,2,1,317063,317063,317064,0,1,0
90611,6,2,317069,317069,317071,0,2,5
90612,1,2,317070,317071,317073,1,3,0
90613,5,2,317075,317075,317077,0,2,2
90614,6,1,317081,317081,317082,0,1,4
90615,4,3,317085,317085,317088,0,3,3
90616,5,2,317090,317090,317092,0,2,2
90617,1,1,317091,317092,317093,1,2,0
90618,1,1,317092,317093,317094,1,2,0
90619,3,2,317095,317095,317097,0,2,1
90620,3,2,317098,317098,317100,0,2,1
90621,6,1,317104,317104,317105,0,1,4
90622,6,1,317110,317110,317111,0,1,5
90623,6,2,317116,317116,317118,0,2,5
90624,2,3,317118,317118,317121,0,3,0
90625,1,2,317119,317121,317123,2,4,0
90626,5,3,317124,317124,317127,0,3,1
90627,6,1,317130,317130,317131,0,1,3
90628,3,3,317133,317133,317136,0,3,2
90629,2,1,317135,317136,317137,1,2,0
90630,4,2,317139,317139,317141,0,2,2
90631,2,2,317141,317141,317143,0,2,0
90632,6,2,317147,317147,317149,0,2,4
90633,4,3,317151,317151,317154,0,3,2
90634,2,3,317153,317154,317157,1,4,0
90635,4,1,317157,317157,317158,0,1,0
90636,1,2,317158,317158,317160,0,2,0
90637,4,1,317162,317162,317163,0,1,2
90638,5,2,317167,317167,317169,0,2,4
90639,1,2,317168,317169,317171,1,3,0
90640,4,3,317172,317172,317175,0,3,1
90641,1,3,317173,317175,317178,2,5,0
90642,2,1,317175,317178,317179,3,4,0
90643,5,3,317180,317180,317183,0,3,1
90644,2,3,317182,317183,317186,1,4,0
90645,1,1,317183,317186,317187,3,4,0
90646,2,3,317185,317187,317190,2,5,0
90647,1,1,317186,317190,317191,4,5,0
90648,1,2,317187,317191,317193,4,6,0
90649,6,3,317193,317193,317196,0,3,0
90650,2,1,317195,317196,317197,1,2,0
90651,2,2,317197,317197,317199,0,2,0
90652,2,3,317199,317199,317202,0,3,0
90653,6,2,317205,317205,317207,0,2,3
90654,5,2,317210,317210,317212,0,2,3
90655,1,3,317211,317212,317215,1,4,0
90656,5,3,317216,317216,317219,0,3,1
90657,3,1,317219,317219,317220,0,1,0
90658,2,3,317221,317221,317224,0,3,1
90659,6,2,317227,317227,317229,0,2,3
90660,4,2,317231,317231,317233,0,2,2
90661,5,3,317236,317236,317239,0,3,3
90662,3,3,317239,317239,317242,0,3,0
90663,1,1,317240,317242,317243,2,3,0
90664,3,3,317243,317243,317246,0,3,0
90665,4,2,317247,317247,317249,0,2,1
90666,6,3,317253,317253,317256,0,3,4
90667,1,1,317254,317256,317257,2,3,0
90668,3,2,317257,317257,317259,0,2,0
90669,4,2,317261,317261,317263,0,2,2
90670,5,2,317266,317266,317268,0,2,3
90671,4,1,317270,317270,317271,0,1,2
90672,2,2,317272,317272,317274,0,2,1
90673,1,2,317273,317274,317276,1,3,0
90674,3,1,317276,317276,317277,0,1,0
90675,3,3,317279,317279,317282,0,3,2
90676,2,1,317281,317282,317283,1,2,0
90677,6,3,317287,317287,317290,0,3,4
90678,6,2,317293,317293,317295,0,2,3
90679,5,3,317298,317298,317301,0,3,3
90680,5,3,317303,317303,317306,0,3,2
90681,6,1,317309,317309,317310,0,1,3
90682,3,1,317312,317312,317313,0,1,2
90683,3,2,317315,317315,317317,0,2,2
90684,5,2,317320,317320,317322,0,2,3
90685,1,1,317321,317322,317323,1,2,0
90686,2,2,317323,317323,317325,0,2,0
90687,5,1,317328,317328,317329,0,1,3
90688,2,1,317330,317330,317331,0,1,1
90689,4,2,317334,317334,317336,0,2,3
90690,3,1,317337,317337,317338,0,1,1
90691,4,1,317341,317341,317342,0,1,3
90692,3,3,317344,317344,317347,0,3,2
90693,2,1,317346,317347,317348,1,2,0
90694,1,2,317347,317348,317350,1,3,0
90695,5,2,317352,317352,317354,0,2,2
90696,1,3,317353,317354,317357,1,4,0
90697,3,3,317356,317357,317360,1,4,0
90698,2,3,317358,317360,317363,2,5,0
90699,2,1,317360,317363,317364,3,4,0
90700,5,3,317365,317365,317368,0,3,1
90701,1,3,317366,317368,317371,2,5,0
90702,1,1,317367,317371,317372,4,5,0
90703,1,3,317368,317372,317375,4,7,0
90704,3,2,317371,317375,317377,4,6,0
90705,6,1,317377,317377,317378,0,1,0
90706,4,3,317381,317381,317384,0,3,3
90707,3,1,317384,317384,317385,0,1,0
90708,4,1,317388,317388,317389,0,1,3
90709,1,2,317389,317389,317391,0,2,0
90710,1,2,317390,317391,317393,1,3,0
90711,1,2,317391,317393,317395,2,4,0
90712,3,3,317394,317395,317398,1,4,0
90713,5,2,317399,317399,317401,0,2,1
90714,3,3,317402,317402,317405,0,3,1
90715,6,2,317408,317408,317410,0,2,3
90716,5,1,317413,317413,317414,0,1,3
90717,6,2,317419,317419,317421,0,2,5
90718,5,3,317424,317424,317427,0,3,3
90719,6,2,317430,317430,317432,0,2,3
90720,5,1,317435,317435,317436,0,1,3
90721,6,3,317441,317441,317444,0,3,5
90722,6,2,317447,317447,317449,0,2,3
90723,1,3,317448,317449,317452,1,4,0
90724,3,2,317451,317452,317454,1,3,0
90725,1,2,317452,317454,317456,2,4,0
90726,4,1,317456,317456,317457,0,1,0
90727,2,1,317458,317458,317459,0,1,1
90728,1,2,317459,317459,317461,0,2,0
90729,6,3,317465,317465,317468,0,3,4
90730,2,3,317467,317468,317471,1,4,0
90731,2,1,317469,317471,317472,2,3,0
90732,5,1,317474,317474,317475,0,1,2
90733,1,1,317475,317475,317476,0,1,0
90734,3,3,317478,317478,317481,0,3,2
90735,1,3,317479,317481,317484,2,5,0
90736,2,2,317481,317484,317486,3,5,0
90737,2,2,317483,317486,317488,3,5,0
90738,2,3,317485,317488,317491,3,6,0
90739,2,3,317487,317491,317494,4,7,0
90740,5,1,317492,317494,317495,2,3,0
90741,2,3,317494,317495,317498,1,4,0
90742,2,2,317496,317498,317500,2,4,0
90743,6,3,317502,317502,317505,0,3,2
90744,6,3,317508,317508,317511,0,3,3
90745,6,2,317514,317514,317516,0,2,3
90746,2,2,317516,317516,317518,0,2,0
90747,6,2,317522,317522,317524,0,2,4
90748,2,3,317524,317524,317527,0,3,0
90749,3,1,317527,317527,317528,0,1,0
90750,3,1,317530,317530,317531,0,1,2
90751,5,2,317535,317535,317537,0,2,4
90752,4,3,317539,317539,317542,0,3,2
90753,1,1,317540,317542,317543,2,3,0
90754,4,2,317544,317544,317546,0,2,1
90755,6,1,317550,317550,317551,0,1,4
90756,5,1,317555,317555,317556,0,1,4
90757,5,1,317560,317560,317561,0,1,4
90758,6,1,317566,317566,317567,0,1,5
90759,3,1,317569,317569,317570,0,1,2
90760,1,2,317570,317570,317572,0,2,0
90761,2,2,317572,317572,317574,0,2,0
90762,6,3,317578,317578,317581,0,3,4
90763,1,3,317579,317581,317584,2,5,0
90764,6,1,317585,317585,317586,0,1,1
90765,4,3,317589,317589,317592,0,3,3
90766,1,3,317590,317592,317595,2,5,0
90767,2,1,317592,317595,317596,3,4,0
90768,5,1,317597,317597,317598,0,1,1
90769,1,3,317598,317598,317601,0,3,0
90770,6,2,317604,317604,317606,0,2,3
90771,2,3,317606,317606,317609,0,3,0
90772,6,2,317612,317612,317614,0,2,3
90773,1,3,317613,317614,317617,1,4,0
90774,5,1,317618,317618,317619,0,1,1
90775,1,2,317619,317619,317621,0,2,0
90776,6,1,317625,317625,317626,0,1,4
90777,6,2,317631,317631,317633,0,2,5
90778,5,1,317636,317636,317637,0,1,3
90779,2,1,317638,317638,317639,0,1,1
90780,2,2,317640,317640,317642,0,2,1
90781,5,2,317645,317645,317647,0,2,3
90782,2,1,317647,317647,317648,0,1,0
90783,3,3,317650,317650,317653,0,3,2
90784,1,2,317651,317653,317655,2,4,0
90785,4,2,317655,317655,317657,0,2,0
90786,5,1,317660,317660,317661,0,1,3
90787,5,2,317665,317665,317667,0,2,4
90788,2,3,317667,317667,317670,0,3,0
90789,4,3,317671,317671,317674,0,3,1
90790,4,3,317675,317675,317678,0,3,1
90791,5,1,317680,317680,317681,0,1,2
90792,4,1,317684,317684,317685,0,1,3
90793,5,3,317689,317689,317692,0,3,4
90794,1,3,317690,317692,317695,2,5,0
90795,6,1,317696,317696,317697,0,1,1
90796,5,3,317701,317701,317704,0,3,4
90797,6,2,317707,317707,317709,0,2,3
90798,3,1,317710,317710,317711,0,1,1
90799,5,3,317715,317715,317718,0,3,4
90800,2,1,317717,317718,317719,1,2,0
90801,1,2,317718,317719,317721,1,3,0
90802,5,3,317723,317723,317726,0,3,2
90803,1,3,317724,317726,317729,2,5,0
90804,2,1,317726,317729,317730,3,4,0
90805,1,1,317727,317730,317731,3,4,0
90806,1,1,317728,317731,317732,3,4,0
90807,6,2,317734,317734,317736,0,2,2
90808,6,1,317740,317740,317741,0,1,4
90809,5,2,317745,317745,317747,0,2,4
90810,4,3,317749,317749,317752,0,3,2
90811,3,1,317752,317752,317753,0,1,0
90812,3,2,317755,317755,317757,0,2,2
90813,6,2,317761,317761,317763,0,2,4
90814,4,1,317765,317765,317766,0,1,2
90815,3,3,317768,317768,317771,0,3,2
90816,3,3,317771,317771,317774,0,3,0
90817,6,2,317777,317777,317779,0,2,3
90818,3,2,317780,317780,317782,0,2,1
90819,3,2,317783,317783,317785,0,2,1
90820,2,3,317785,317785,317788,0,3,0
90821,1,1,317786,317788,317789,2,3,0
90822,3,2,317789,317789,317791,0,2,0
90823,1,1,317790,317791,317792,1,2,0
90824,4,1,317794,317794,317795,0,1,2
90825,5,3,317799,317799,317802,0,3,4
90826,2,1,317801,317802,317803,1,2,0
90827,1,1,317802,317803,317804,1,2,0
90828,2,1,317804,317804,317805,0,1,0
90829,6,2,317810,317810,317812,0,2,5
90830,3,2,317813,317813,317815,0,2,1
90831,1,2,317814,317815,317817,1,3,0
90832,1,1,317815,317817,317818,2,3,0
90833,5,3,317820,317820,317823,0,3,2
90834,3,3,317823,317823,317826,0,3,0
90835,1,1,317824,317826,317827,2,3,0
90836,2,3,317826,317827,317830,1,4,0
90837,4,2,317830,317830,317832,0,2,0
90838,1,2,317831,317832,317834,1,3,0
90839,4,3,317835,317835,317838,0,3,1
90840,1,1,317836,317838,317839,2,3,0
90841,1,1,317837,317839,317840,2,3,0
90842,6,2,317843,317843,317845,0,2,3
90843,6,2,317849,317849,317851,0,2,4
90844,3,1,317852,317852,317853,0,1,1
90845,6,3,317858,317858,317861,0,3,5
90846,3,3,317861,317861,317864,0,3,0
90847,2,1,317863,317864,317865,1,2,0
90848,5,2,317868,317868,317870,0,2,3
90849,2,3,317870,317870,317873,0,3,0
90850,5,2,317875,317875,317877,0,2,2
90851,6,2,317881,317881,317883,0,2,4
90852,6,3,317887,317887,317890,0,3,4
90853,1,2,317888,317890,317892,2,4,0
90854,2,1,317890,317892,317893,2,3,0
90855,1,2,317891,317893,317895,2,4,0
90856,5,1,317896,317896,317897,0,1,1
90857,1,2,317897,317897,317899,0,2,0
90858,3,3,317900,317900,317903,0,3,1
90859,5,3,317905,317905,317908,0,3,2
90860,6,3,317911,317911,317914,0,3,3
90861,5,3,317916,317916,317919,0,3,2
90862,2,3,317918,317919,317922,1,4,0
90863,6,2,317924,317924,317926,0,2,2
90864,1,1,317925,317926,317927,1,2,0
90865,2,3,317927,317927,317930,0,3,0
90866,5,1,317932,317932,317933,0,1,2
90867,1,2,317933,317933,317935,0,2,0
90868,5,2,317938,317938,317940,0,2,3
90869,5,1,317943,317943,317944,0,1,3
90870,6,3,317949,317949,317952,0,3,5
90871,6,2,317955,317955,317957,0,2,3
90872,5,2,317960,317960,317962,0,2,3
90873,2,3,317962,317962,317965,0,3,0
90874,2,2,317964,317965,317967,1,3,0
90875,2,3,317966,317967,317970,1,4,0
90876,2,3,317968,317970,317973,2,5,0
90877,6,1,317974,317974,317975,0,1,1
90878,2,2,317976,317976,317978,0,2,1
90879,4,3,317980,317980,317983,0,3,2
90880,5,2,317985,317985,317987,0,2,2
90881,1,1,317986,317987,317988,1,2,0
90882,2,2,317988,317988,317990,0,2,0
90883,6,1,317994,317994,317995,0,1,4
90884,4,2,317998,317998,318000,0,2,3
90885,6,2,318004,318004,318006,0,2,4
90886,4,1,318008,318008,318009,0,1,2
90887,1,1,318009,318009,318010,0,1,0
90888,2,1,318011,318011,318012,0,1,1
90889,3,2,318014,318014,318016,0,2,2
90890,6,2,318020,318020,318022,0,2,4
90891,3,1,318023,318023,318024,0,1,1
90892,3,1,318026,318026,318027,0,1,2
90893,4,2,318030,318030,318032,0,2,3
90894,1,2,318031,318032,318034,1,3,0
90895,4,1,318035,318035,318036,0,1,1
90896,1,1,318036,318036,318037,0,1,0
90897,4,1,318040,318040,318041,0,1,3
90898,2,3,318042,318042,318045,0,3,1
90899,1,3,318043,318045,318048,2,5,0
90900,2,3,318045,318048,318051,3,6,0
90901,3,2,318048,318051,318053,3,5,0
90902,1,3,318049,318053,318056,4,7,0
90903,4,2,318053,318056,318058,3,5,0
90904,3,1,318056,318058,318059,2,3,0
90905,4,3,318060,318060,318063,0,3,1
90906,1,2,318061,318063,318065,2,4,0
90907,5,2,318066,318066,318068,0,2,1
90908,2,3,318068,318068,318071,0,3,0
90909,1,3,318069,318071,318074,2,5,0
90910,2,3,318071,318074,318077,3,6,0
90911,1,1,318072,318077,318078,5,6,0
90912,3,3,318075,318078,318081,3,6,0
90913,1,2,318076,318081,318083,5,7,0
90914,4,3,318080,318083,318086,3,6,0
90915,6,1,318086,318086,318087,0,1,0
90916,1,1,318087,318087,318088,0,1,0
90917,3,2,318090,318090,318092,0,2,2
90918,6,2,318096,318096,318098,0,2,4
90919,5,1,318101,318101,318102,0,1,3
90920,4,1,318105,318105,318106,0,1,3
90921,3,1,318108,318108,318109,0,1,2
90922,2,1,318110,318110,318111,0,1,1
90923,3,1,318113,318113,318114,0,1,2
90924,3,3,318116,318116,318119,0,3,2
90925,1,1,318117,318119,318120,2,3,0
90926,5,3,318122,318122,318125,0,3,2
90927,3,1,318125,318125,318126,0,1,0
90928,3,1,318128,318128,318129,0,1,2
90929,1,2,318129,318129,318131,0,2,0
90930,2,1,318131,318131,318132,0,1,0
90931,2,2,318133,318133,318135,0,2,1
90932,3,2,318136,318136,318138,0,2,1
90933,4,1,318140,318140,318141,0,1,2
90934,6,2,318146,318146,318148,0,2,5
90935,2,3,318148,318148,318151,0,3,0
90936,5,2,318153,318153,318155,0,2,2
90937,3,1,318156,318156,318157,0,1,1
90938,2,1,318158,318158,318159,0,1,1
90939,1,2,318159,318159,318161,0,2,0
90940,2,2,318161,318161,318163,0,2,0
90941,4,1,318165,318165,318166,0,1,2
90942,1,1,318166,318166,318167,0,1,0
90943,1,1,318167,318167,318168,0,1,0
90944,6,1,318173,318173,318174,0,1,5
90945,4,2,318177,318177,318179,0,2,3
90946,6,2,318183,318183,318185,0,2,4
90947,3,1,318186,318186,318187,0,1,1
90948,5,3,318191,318191,318194,0,3,4
90949,5,3,318196,318196,318199,0,3,2
90950,5,3,318201,318201,318204,0,3,2
90951,6,3,318207,318207,318210,0,3,3
90952,5,3,318212,318212,318215,0,3,2
90953,4,2,318216,318216,318218,0,2,1
90954,6,2,318222,318222,318224,0,2,4
90955,4,2,318226,318226,318228,0,2,2
90956,3,1,318229,318229,318230,0,1,1
90957,6,3,318235,318235,318238,0,3,5
90958,6,1,318241,318241,318242,0,1,3
90959,2,2,318243,318243,318245,0,2,1
90960,4,1,318247,318247,318248,0,1,2
90961,2,3,318249,318249,318252,0,3,1
90962,5,2,318254,318254,318256,0,2,2
90963,2,1,318256,318256,318257,0,1,0
90964,6,1,318262,318262,318263,0,1,5
90965,6,2,318268,318268,318270,0,2,5
90966,2,3,318270,318270,318273,0,3,0
90967,2,3,318272,318273,318276,1,4,0
90968,6,1,318278,318278,318279,0,1,2
90969,2,3,318280,318280,318283,0,3,1
90970,2,1,318282,318283,318284,1,2,0
90971,6,3,318288,318288,318291,0,3,4
90972,6,3,318294,318294,318297,0,3,3
90973,4,1,318298,318298,318299,0,1,1
90974,6,1,318304,318304,318305,0,1,5
90975,6,2,318310,318310,318312,0,2,5
90976,4,3,318314,318314,318317,0,3,2
90977,3,2,318317,318317,318319,0,2,0
90978,1,3,318318,318319,318322,1,4,0
90979,1,3,318319,318322,318325,3,6,0
90980,4,1,318323,318325,318326,2,3,0
90981,3,3,318326,318326,318329,0,3,0
90982,4,3,318330,318330,318333,0,3,1
90983,6,2,318336,318336,318338,0,2,3
90984,5,3,318341,318341,318344,0,3,3
90985,5,1,318346,318346,318347,0,1,2
90986,6,1,318352,318352,318353,0,1,5
90987,3,3,318355,318355,318358,0,3,2
90988,6,1,318361,318361,318362,0,1,3
90989,1,1,318362,318362,318363,0,1,0
90990,4,2,318366,318366,318368,0,2,3
90991,6,1,318372,318372,318373,0,1,4
90992,2,1,318374,318374,318375,0,1,1
90993,3,1,318377,318377,318378,0,1,2
90994,2,3,318379,318379,318382,0,3,1
90995,3,1,318382,318382,318383,0,1,0
90996,2,1,318384,318384,318385,0,1,1
90997,2,3,318386,318386,318389,0,3,1
90998,6,1,318392,318392,318393,0,1,3
90999,3,3,318395,318395,318398,0,3,2
91000,2,2,318397,318398,318400,1,3,0
91001,4,3,318401,318401,318404,0,3,1
91002,6,2,318407,318407,318409,0,2,3
91003,5,1,318412,318412,318413,0,1,3
91004,5,3,318417,318417,318420,0,3,4
91005,4,1,318421,318421,318422,0,1,1
91006,3,1,318424,318424,318425,0,1,2
91007,6,1,318430,318430,318431,0,1,5
91008,1,3,318431,318431,318434,0,3,0
91009,3,1,318434,318434,318435,0,1,0
91010,2,1,318436,318436,318437,0,1,1
91011,2,2,318438,318438,318440,0,2,1
91012,5,1,318443,318443,318444,0,1,3
91013,5,3,318448,318448,318451,0,3,4
91014,5,1,318453,318453,318454,0,1,2
91015,5,3,318458,318458,318461,0,3,4
91016,2,3,318460,318461,318464,1,4,0
91017,5,1,318465,318465,318466,0,1,1
91018,4,3,318469,318469,318472,0,3,3
91019,5,1,318474,318474,318475,0,1,2
91020,1,3,318475,318475,318478,0,3,0
91021,2,1,318477,318478,318479,1,2,0
91022,5,1,318482,318482,318483,0,1,3
91023,2,2,318484,318484,318486,0,2,1
91024,2,3,318486,318486,318489,0,3,0
91025,3,2,318489,318489,318491,0,2,0
91026,2,3,318491,318491,318494,0,3,0
91027,6,1,318497,318497,318498,0,1,3
91028,4,2,318501,318501,318503,0,2,3
91029,4,1,318505,318505,318506,0,1,2
91030,1,3,318506,318506,318509,0,3,0
91031,3,1,318509,318509,318510,0,1,0
91032,5,3,318514,318514,318517,0,3,4
91033,1,3,318515,318517,318520,2,5,0
91034,4,1,318519,318520,318521,1,2,0
91035,6,1,318525,318525,318526,0,1,4
91036,4,1,318529,318529,318530,0,1,3
91037,1,1,318530,318530,318531,0,1,0
91038,4,2,318534,318534,318536,0,2,3
91039,2,3,318536,318536,318539,0,3,0
91040,1,2,318537,318539,318541,2,4,0
91041,6,1,318543,318543,318544,0,1,2
91042,2,3,318545,318545,318548,0,3,1
91043,4,2,318549,318549,318551,0,2,1
91044,3,1,318552,318552,318553,0,1,1
91045,1,3,318553,318553,318556,0,3,0
91046,2,3,318555,318556,318559,1,4,0
91047,6,2,318561,318561,318563,0,2,2
91048,5,2,318566,318566,318568,0,2,3
91049,6,1,318572,318572,318573,0,1,4
91050,1,2,318573,318573,318575,0,2,0
91051,2,1,318575,318575,318576,0,1,0
91052,6,2,318581,318581,318583,0,2,5
91053,5,3,318586,318586,318589,0,3,3
91054,4,2,318590,318590,318592,0,2,1
91055,3,2,318593,318593,318595,0,2,1
91056,2,1,318595,318595,318596,0,1,0
91057,4,2,318599,318599,318601,0,2,3
91058,6,2,318605,318605,318607,0,2,4
91059,2,1,318607,318607,318608,0,1,0
91060,1,2,318608,318608,318610,0,2,0
91061,4,2,318612,318612,318614,0,2,2
91062,1,1,318613,318614,318615,1,2,0
91063,5,1,318618,318618,318619,0,1,3
91064,3,1,318621,318621,318622,0,1,2
91065,4,1,318625,318625,318626,0,1,3
91066,4,3,318629,318629,318632,0,3,3
91067,5,3,318634,318634,318637,0,3,2
91068,6,2,318640,318640,318642,0,2,3
91069,2,3,318642,318642,318645,0,3,0
91070,5,1,318647,318647,318648,0,1,2
91071,1,3,318648,318648,318651,0,3,0
91072,4,1,318652,318652,318653,0,1,1
91073,6,1,318658,318658,318659,0,1,5
91074,5,1,318663,318663,318664,0,1,4
91075,4,2,318667,318667,318669,0,2,3
91076,6,1,318673,318673,318674,0,1,4
91077,4,3,318677,318677,318680,0,3,3
91078,5,3,318682,318682,318685,0,3,2
91079,3,1,318685,318685,318686,0,1,0
91080,6,2,318691,318691,318693,0,2,5
91081,2,3,318693,318693,318696,0,3,0
91082,1,1,318694,318696,318697,2,3,0
91083,1,2,318695,318697,318699,2,4,0
91084,4,2,318699,318699,318701,0,2,0
91085,4,1,318703,318703,318704,0,1,2
91086,2,1,318705,318705,318706,0,1,1
91087,2,2,318707,318707,318709,0,2,1
91088,4,3,318711,318711,318714,0,3,2
91089,5,3,318716,318716,318719,0,3,2
91090,6,2,318722,318722,318724,0,2,3
91091,1,1,318723,318724,318725,1,2,0
91092,5,1,318728,318728,318729,0,1,3
91093,1,3,318729,318729,318732,0,3,0
91094,4,1,318733,318733,318734,0,1,1
91095,2,3,318735,318735,318738,0,3,1
91096,5,3,318740,318740,318743,0,3,2
91097,4,1,318744,318744,318745,0,1,1
91098,2,1,318746,318746,318747,0,1,1
91099,3,2,318749,318749,318751,0,2,2
91100,5,2,318754,318754,318756,0,2,3
91101,4,2,318758,318758,318760,0,2,2
91102,2,3,318760,318760,318763,0,3,0
91103,4,3,318764,318764,318767,0,3,1
91104,6,2,318770,318770,318772,0,2,3
91105,2,3,318772,318772,318775,0,3,0
91106,5,3,318777,318777,318780,0,3,2
91107,1,1,318778,318780,318781,2,3,0
91108,4,2,318782,318782,318784,0,2,1
91109,5,1,318787,318787,318788,0,1,3
91110,1,2,318788,318788,318790,0,2,0
91111,2,1,318790,318790,318791,0,1,0
91112,1,1,318791,318791,318792,0,1,0
91113,5,2,318796,318796,318798,0,2,4
91114,6,2,318802,318802,318804,0,2,4
91115,6,3,318808,318808,318811,0,3,4
91116,5,3,318813,318813,318816,0,3,2
91117,5,2,318818,318818,318820,0,2,2
91118,6,3,318824,318824,318827,0,3,4
91119,6,2,318830,318830,318832,0,2,3
91120,3,2,318833,318833,318835,0,2,1
91121,2,3,318835,318835,318838,0,3,0
91122,6,1,318841,318841,318842,0,1,3
91123,6,2,318847,318847,318849,0,2,5
91124,6,2,318853,318853,318855,0,2,4
91125,2,1,318855,318855,318856,0,1,0
91126,5,2,318860,318860,318862,0,2,4
91127,1,2,318861,318862,318864,1,3,0
91128,2,3,318863,318864,318867,1,4,0
91129,2,2,318865,318867,318869,2,4,0
91130,6,2,318871,318871,318873,0,2,2
91131,3,3,318874,318874,318877,0,3,1
91132,6,3,318880,318880,318883,0,3,3
91133,1,1,318881,318883,318884,2,3,0
91134,5,3,318886,318886,318889,0,3,2
91135,5,2,318891,318891,318893,0,2,2
91136,4,1,318895,318895,318896,0,1,2
91137,2,1,318897,318897,318898,0,1,1
91138,5,3,318902,318902,318905,0,3,4
91139,6,2,318908,318908,318910,0,2,3
91140,5,1,318913,318913,318914,0,1,3
91141,4,3,318917,318917,318920,0,3,3
91142,6,2,318923,318923,318925,0,2,3
91143,4,1,318927,318927,318928,0,1,2
91144,1,3,318928,318928,318931,0,3,0
91145,2,2,318930,318931,318933,1,3,0
91146,5,3,318935,318935,318938,0,3,2
91147,6,3,318941,318941,318944,0,3,3
91148,3,3,318944,318944,318947,0,3,0
91149,4,1,318948,318948,318949,0,1,1
91150,6,3,318954,318954,318957,0,3,5
91151,3,3,318957,318957,318960,0,3,0
91152,1,2,318958,318960,318962,2,4,0
91153,1,3,318959,318962,318965,3,6,0
91154,6,2,318965,318965,318967,0,2,0
91155,4,2,318969,318969,318971,0,2,2
91156,2,1,318971,318971,318972,0,1,0
91157,6,2,318977,318977,318979,0,2,5
91158,2,3,318979,318979,318982,0,3,0
91159,2,1,318981,318982,318983,1,2,0
91160,6,2,318987,318987,318989,0,2,4
91161,4,2,318991,318991,318993,0,2,2
91162,5,2,318996,318996,318998,0,2,3
91163,3,3,318999,318999,319002,0,3,1
91164,2,1,319001,319002,319003,1,2,0
91165,2,3,319003,319003,319006,0,3,0
91166,5,1,319008,319008,319009,0,1,2
91167,1,1,319009,319009,319010,0,1,0
91168,3,3,319012,319012,319015,0,3,2
91169,4,3,319016,319016,319019,0,3,1
91170,3,1,319019,319019,319020,0,1,0
91171,3,2,319022,319022,319024,0,2,2
91172,1,2,319023,319024,319026,1,3,0
91173,6,1,319029,319029,319030,0,1,3
91174,6,3,319035,319035,319038,0,3,5
91175,3,2,319038,319038,319040,0,2,0
91176,6,2,319044,319044,319046,0,2,4
91177,3,2,319047,319047,319049,0,2,1
91178,3,1,319050,319050,319051,0,1,1
91179,1,1,319051,319051,319052,0,1,0
91180,3,2,319054,319054,319056,0,2,2
91181,5,2,319059,319059,319061,0,2,3
91182,1,1,319060,319061,319062,1,2,0
91183,1,2,319061,319062,319064,1,3,0
91184,5,1,319066,319066,319067,0,1,2
91185,1,3,319067,319067,319070,0,3,0
91186,6,2,319073,319073,319075,0,2,3
91187,2,1,319075,319075,319076,0,1,0
91188,5,3,319080,319080,319083,0,3,4
91189,6,3,319086,319086,319089,0,3,3
91190,1,2,319087,319089,319091,2,4,0
91191,6,2,319093,319093,319095,0,2,2
91192,5,3,319098,319098,319101,0,3,3
91193,4,2,319102,319102,319104,0,2,1
91194,3,3,319105,319105,319108,0,3,1
91195,6,1,319111,319111,319112,0,1,3
91196,4,1,319115,319115,319116,0,1,3
91197,5,1,319120,319120,319121,0,1,4
91198,2,1,319122,319122,319123,0,1,1
91199,2,3,319124,319124,319127,0,3,1
91200,4,3,319128,319128,319131,0,3,1
91201,5,2,319133,319133,319135,0,2,2
91202,4,1,319137,319137,319138,0,1,2
91203,6,2,319143,319143,319145,0,2,5
91204,5,2,319148,319148,319150,0,2,3
91205,4,3,319152,319152,319155,0,3,2
91206,2,1,319154,319155,319156,1,2,0
91207,1,3,319155,319156,319159,1,4,0
91208,3,3,319158,319159,319162,1,4,0
91209,4,1,319162,319162,319163,0,1,0
91210,4,2,319166,319166,319168,0,2,3
91211,3,2,319169,319169,319171,0,2,1
91212,5,1,319174,319174,319175,0,1,3
91213,5,3,319179,319179,319182,0,3,4
91214,2,2,319181,319182,319184,1,3,0
91215,4,3,319185,319185,319188,0,3,1
91216,1,2,319186,319188,319190,2,4,0
91217,3,3,319189,319190,319193,1,4,0
91218,5,3,319194,319194,319197,0,3,1
91219,4,3,319198,319198,319201,0,3,1
91220,5,2,319203,319203,319205,0,2,2
91221,3,2,319206,319206,319208,0,2,1
91222,1,2,319207,319208,319210,1,3,0
91223,3,3,319210,319210,319213,0,3,0
91224,3,3,319213,319213,319216,0,3,0
91225,2,1,319215,319216,319217,1,2,0
91226,5,2,319220,319220,319222,0,2,3
91227,6,1,319226,319226,319227,0,1,4
91228,5,1,319231,319231,319232,0,1,4
91229,3,1,319234,319234,319235,0,1,2
91230,3,2,319237,319237,319239,0,2,2
91231,4,2,319241,319241,319243,0,2,2
91232,4,2,319245,319245,319247,0,2,2
91233,5,3,319250,319250,319253,0,3,3
91234,1,3,319251,319253,319256,2,5,0
91235,3,1,319254,319256,319257,2,3,0
91236,2,2,319256,319257,319259,1,3,0
91237,2,3,319258,319259,319262,1,4,0
91238,6,3,319264,319264,319267,0,3,2
91239,3,3,319267,319267,319270,0,3,0
91240,2,2,319269,319270,319272,1,3,0
91241,4,3,319273,319273,319276,0,3,1
91242,2,3,319275,319276,319279,1,4,0
91243,6,2,319281,319281,319283,0,2,2
91244,5,2,319286,319286,319288,0,2,3
91245,2,1,319288,319288,319289,0,1,0
91246,4,1,319292,319292,319293,0,1,3
91247,3,2,319295,319295,319297,0,2,2
91248,3,2,319298,319298,319300,0,2,1
91249,2,3,319300,319300,319303,0,3,0
91250,2,3,319302,319303,319306,1,4,0
91251,4,2,319306,319306,319308,0,2,0
91252,3,2,319309,319309,319311,0,2,1
91253,2,2,319311,319311,319313,0,2,0
91254,6,3,319317,319317,319320,0,3,4
91255,5,3,319322,319322,319325,0,3,2
91256,5,2,319327,319327,319329,0,2,2
91257,6,2,319333,319333,319335,0,2,4
91258,1,3,319334,319335,319338,1,4,0
91259,6,2,319340,319340,319342,0,2,2
91260,4,2,319344,319344,319346,0,2,2
91261,5,2,319349,319349,319351,0,2,3
91262,5,2,319354,319354,319356,0,2,3
91263,5,3,319359,319359,319362,0,3,3
91264,4,3,319363,319363,319366,0,3,1
91265,3,1,319366,319366,319367,0,1,0
91266,6,2,319372,319372,319374,0,2,5
91267,2,3,319374,319374,319377,0,3,0
91268,5,2,319379,319379,319381,0,2,2
91269,3,2,319382,319382,319384,0,2,1
91270,4,2,319386,319386,319388,0,2,2
91271,5,2,319391,319391,319393,0,2,3
91272,1,3,319392,319393,319396,1,4,0
91273,3,1,319395,319396,319397,1,2,0
91274,4,1,319399,319399,319400,0,1,2
91275,3,2,319402,319402,319404,0,2,2
91276,4,2,319406,319406,319408,0,2,2
91277,5,1,319411,319411,319412,0,1,3
91278,3,3,319414,319414,319417,0,3,2
91279,3,1,319417,319417,319418,0,1,0
91280,6,2,319423,319423,319425,0,2,5
91281,1,2,319424,319425,319427,1,3,0
91282,1,1,319425,319427,319428,2,3,0
91283,2,2,319427,319428,319430,1,3,0
91284,2,3,319429,319430,319433,1,4,0
91285,1,1,319430,319433,319434,3,4,0
91286,3,2,319433,319434,319436,1,3,0
91287,2,3,319435,319436,319439,1,4,0
91288,6,3,319441,319441,319444,0,3,2
91289,3,3,319444,319444,319447,0,3,0
91290,4,2,319448,319448,319450,0,2,1
91291,2,2,319450,319450,319452,0,2,0
91292,6,2,319456,319456,319458,0,2,4
91293,2,3,319458,319458,319461,0,3,0
91294,6,2,319464,319464,319466,0,2,3
91295,4,3,319468,319468,319471,0,3,2
91296,4,2,319472,319472,319474,0,2,1
91297,6,1,319478,319478,319479,0,1,4
91298,4,1,319482,319482,319483,0,1,3
91299,4,1,319486,319486,319487,0,1,3
91300,6,1,319492,319492,319493,0,1,5
91301,5,1,319497,319497,319498,0,1,4
91302,3,1,319500,319500,319501,0,1,2
91303,5,2,319505,319505,319507,0,2,4
91304,2,1,319507,319507,319508,0,1,0
91305,5,1,319512,319512,319513,0,1,4
91306,4,1,319516,319516,319517,0,1,3
91307,2,3,319518,319518,319521,0,3,1
91308,3,3,319521,319521,319524,0,3,0
91309,6,1,319527,319527,319528,0,1,3
91310,5,1,319532,319532,319533,0,1,4
91311,6,2,319538,319538,319540,0,2,5
91312,1,3,319539,319540,319543,1,4,0
91313,5,1,319544,319544,319545,0,1,1
91314,2,3,319546,319546,319549,0,3,1
91315,5,3,319551,319551,319554,0,3,2
91316,1,2,319552,319554,319556,2,4,0
91317,1,2,319553,319556,319558,3,5,0
91318,6,2,319559,319559,319561,0,2,1
91319,2,2,319561,319561,319563,0,2,0
91320,4,1,319565,319565,319566,0,1,2
91321,3,3,319568,319568,319571,0,3,2
91322,3,1,319571,319571,319572,0,1,0
91323,1,2,319572,319572,319574,0,2,0
91324,6,2,319578,319578,319580,0,2,4
91325,6,2,319584,319584,319586,0,2,4
91326,6,2,319590,319590,319592,0,2,4
91327,4,2,319594,319594,319596,0,2,2
91328,6,2,319600,319600,319602,0,2,4
91329,2,3,319602,319602,319605,0,3,0
91330,3,1,319605,319605,319606,0,1,0
91331,1,1,319606,319606,319607,0,1,0
91332,2,2,319608,319608,319610,0,2,1
91333,6,1,319614,319614,319615,0,1,4
91334,5,2,319619,319619,319621,0,2,4
91335,3,1,319622,319622,319623,0,1,1
91336,5,3,319627,319627,319630,0,3,4
91337,1,3,319628,319630,319633,2,5,0
91338,5,2,319633,319633,319635,0,2,0
91339,2,3,319635,319635,319638,0,3,0
91340,2,2,319637,319638,319640,1,3,0
91341,6,1,319643,319643,319644,0,1,3
91342,4,3,319647,319647,319650,0,3,3
91343,4,1,319651,319651,319652,0,1,1
91344,2,2,319653,319653,319655,0,2,1
91345,4,1,319657,319657,319658,0,1,2
91346,5,2,319662,319662,319664,0,2,4
91347,3,3,319665,319665,319668,0,3,1
91348,2,3,319667,319668,319671,1,4,0
91349,3,1,319670,319671,319672,1,2,0
91350,3,2,319673,319673,319675,0,2,1
91351,2,1,319675,319675,319676,0,1,0
91352,6,1,319681,319681,319682,0,1,5
91353,2,2,319683,319683,319685,0,2,1
91354,3,2,319686,319686,319688,0,2,1
91355,1,1,319687,319688,319689,1,2,0
91356,4,2,319691,319691,319693,0,2,2
91357,2,2,319693,319693,319695,0,2,0
91358,6,1,319699,319699,319700,0,1,4
91359,2,1,319701,319701,319702,0,1,1
91360,3,3,319704,319704,319707,0,3,2
91361,5,1,319709,319709,319710,0,1,2
91362,3,2,319712,319712,319714,0,2,2
91363,3,2,319715,319715,319717,0,2,1
91364,3,3,319718,319718,319721,0,3,1
91365,3,2,319721,319721,319723,0,2,0
91366,2,3,319723,319723,319726,0,3,0
91367,6,3,319729,319729,319732,0,3,3
91368,1,2,319730,319732,319734,2,4,0
91369,5,2,319735,319735,319737,0,2,1
91370,1,3,319736,319737,319740,1,4,0
91371,2,2,319738,319740,319742,2,4,0
91372,1,3,319739,319742,319745,3,6,0
91373,6,2,319745,319745,319747,0,2,0
91374,4,2,319749,319749,319751,0,2,2
91375,1,1,319750,319751,319752,1,2,0
91376,2,3,319752,319752,319755,0,3,0
91377,4,1,319756,319756,319757,0,1,1
91378,6,3,319762,319762,319765,0,3,5
91379,6,2,319768,319768,319770,0,2,3
91380,2,3,319770,319770,319773,0,3,0
91381,3,2,319773,319773,319775,0,2,0
91382,3,1,319776,319776,319777,0,1,1
91383,4,2,319780,319780,319782,0,2,3
91384,5,1,319785,319785,319786,0,1,3
91385,2,3,319787,319787,319790,0,3,1
91386,3,1,319790,319790,319791,0,1,0
91387,4,2,319794,319794,319796,0,2,3
91388,6,3,319800,319800,319803,0,3,4
91389,5,2,319805,319805,319807,0,2,2
91390,2,1,319807,319807,319808,0,1,0
91391,1,2,319808,319808,319810,0,2,0
91392,5,2,319813,319813,319815,0,2,3
91393,6,1,319819,319819,319820,0,1,4
91394,6,2,319825,319825,319827,0,2,5
91395,3,1,319828,319828,319829,0,1,1
91396,6,1,319834,319834,319835,0,1,5
91397,6,2,319840,319840,319842,0,2,5
91398,6,2,319846,319846,319848,0,2,4
91399,6,3,319852,319852,319855,0,3,4
91400,4,1,319856,319856,319857,0,1,1
91401,3,2,319859,319859,319861,0,2,2
91402,5,3,319864,319864,319867,0,3,3
91403,5,1,319869,319869,319870,0,1,2
91404,2,3,319871,319871,319874,0,3,1
91405,3,3,319874,319874,319877,0,3,0
91406,5,3,319879,319879,319882,0,3,2
91407,1,2,319880,319882,319884,2,4,0
91408,1,2,319881,319884,319886,3,5,0
91409,5,2,319886,319886,319888,0,2,0
91410,5,2,319891,319891,319893,0,2,3
91411,4,2,319895,319895,319897,0,2,2
91412,2,1,319897,319897,319898,0,1,0
91413,4,3,319901,319901,319904,0,3,3
91414,6,2,319907,319907,319909,0,2,3
91415,5,2,319912,319912,319914,0,2,3
91416,3,2,319915,319915,319917,0,2,1
91417,4,2,319919,319919,319921,0,2,2
91418,3,1,319922,319922,319923,0,1,1
91419,5,3,319927,319927,319930,0,3,4
91420,2,2,319929,319930,319932,1,3,0
91421,1,1,319930,319932,319933,2,3,0
91422,1,1,319931,319933,319934,2,3,0
91423,3,2,319934,319934,319936,0,2,0
91424,5,3,319939,319939,319942,0,3,3
91425,2,3,319941,319942,319945,1,4,0
91426,6,2,319947,319947,319949,0,2,2
91427,2,3,319949,319949,319952,0,3,0
91428,5,2,319954,319954,319956,0,2,2
91429,3,1,319957,319957,319958,0,1,1
91430,3,3,319960,319960,319963,0,3,2
91431,4,2,319964,319964,319966,0,2,1
91432,2,3,319966,319966,319969,0,3,0
91433,1,2,319967,319969,319971,2,4,0
91434,1,1,319968,319971,319972,3,4,0
91435,6,3,319974,319974,319977,0,3,2
91436,3,2,319977,319977,319979,0,2,0
91437,2,3,319979,319979,319982,0,3,0
91438,2,1,319981,319982,319983,1,2,0
91439,5,3,319986,319986,319989,0,3,3
91440,3,3,319989,319989,319992,0,3,0
91441,5,3,319994,319994,319997,0,3,2
91442,1,2,319995,319997,319999,2,4,0
91443,3,1,319998,319999,320000,1,2,0
91444,4,1,320002,320002,320003,0,1,2
91445,2,1,320004,320004,320005,0,1,1
91446,5,1,320009,320009,320010,0,1,4
91447,1,2,320010,320010,320012,0,2,0
91448,6,1,320016,320016,320017,0,1,4
91449,3,2,320019,320019,320021,0,2,2
91450,2,2,320021,320021,320023,0,2,0
91451,3,2,320024,320024,320026,0,2,1
91452,1,1,320025,320026,320027,1,2,0
91453,1,3,320026,320027,320030,1,4,0
91454,2,3,320028,320030,320033,2,5,0
91455,4,1,320032,320033,320034,1,2,0
91456,3,2,320035,320035,320037,0,2,1
91457,3,1,320038,320038,320039,0,1,1
91458,6,2,320044,320044,320046,0,2,5
91459,4,2,320048,320048,320050,0,2,2
91460,5,3,320053,320053,320056,0,3,3
91461,1,2,320054,320056,320058,2,4,0
91462,1,3,320055,320058,320061,3,6,0
91463,1,3,320056,320061,320064,5,8,0
91464,4,3,320060,320064,320067,4,7,0
91465,5,2,320065,320067,320069,2,4,0
91466,5,3,320070,320070,320073,0,3,1
91467,5,3,320075,320075,320078,0,3,2
91468,5,1,320080,320080,320081,0,1,2
91469,1,2,320081,320081,320083,0,2,0
91470,4,3,320085,320085,320088,0,3,2
91471,4,3,320089,320089,320092,0,3,1
91472,1,2,320090,320092,320094,2,4,0
91473,4,1,320094,320094,320095,0,1,0
91474,1,1,320095,320095,320096,0,1,0
91475,2,1,320097,320097,320098,0,1,1
91476,1,1,320098,320098,320099,0,1,0
91477,6,2,320104,320104,320106,0,2,5
91478,2,2,320106,320106,320108,0,2,0
91479,4,2,320110,320110,320112,0,2,2
91480,5,2,320115,320115,320117,0,2,3
91481,4,1,320119,320119,320120,0,1,2
91482,3,3,320122,320122,320125,0,3,2
91483,6,3,320128,320128,320131,0,3,3
91484,4,1,320132,320132,320133,0,1,1
91485,3,1,320135,320135,320136,0,1,2
91486,3,3,320138,320138,320141,0,3,2
91487,3,3,320141,320141,320144,0,3,0
91488,5,1,320146,320146,320147,0,1,2
91489,2,1,320148,320148,320149,0,1,1
91490,1,3,320149,320149,320152,0,3,0
91491,2,3,320151,320152,320155,1,4,0
91492,6,1,320157,320157,320158,0,1,2
91493,5,2,320162,320162,320164,0,2,4
91494,5,1,320167,320167,320168,0,1,3
91495,6,3,320173,320173,320176,0,3,5
91496,1,3,320174,320176,320179,2,5,0
91497,5,1,320179,320179,320180,0,1,0
91498,6,1,320185,320185,320186,0,1,5
91499,2,2,320187,320187,320189,0,2,1
91500,5,2,320192,320192,320194,0,2,3
91501,4,2,320196,320196,320198,0,2,2
91502,6,3,320202,320202,320205,0,3,4
91503,4,3,320206,320206,320209,0,3,1
91504,3,3,320209,320209,320212,0,3,0
91505,4,2,320213,320213,320215,0,2,1
91506,1,1,320214,320215,320216,1,2,0
91507,6,3,320220,320220,320223,0,3,4
91508,1,1,320221,320223,320224,2,3,0
91509,2,2,320223,320224,320226,1,3,0
91510,6,1,320229,320229,320230,0,1,3
91511,4,3,320233,320233,320236,0,3,3
91512,3,2,320236,320236,320238,0,2,0
91513,4,1,320240,320240,320241,0,1,2
91514,4,1,320244,320244,320245,0,1,3
91515,3,2,320247,320247,320249,0,2,2
91516,6,1,320253,320253,320254,0,1,4
91517,1,1,320254,320254,320255,0,1,0
91518,2,3,320256,320256,320259,0,3,1
91519,6,2,320262,320262,320264,0,2,3
91520,5,3,320267,320267,320270,0,3,3
91521,1,2,320268,320270,320272,2,4,0
91522,3,3,320271,320272,320275,1,4,0
91523,1,2,320272,320275,320277,3,5,0
91524,6,2,320278,320278,320280,0,2,1
91525,3,1,320281,320281,320282,0,1,1
91526,2,1,320283,320283,320284,0,1,1
91527,2,2,320285,320285,320287,0,2,1
91528,6,1,320291,320291,320292,0,1,4
91529,2,3,320293,320293,320296,0,3,1
91530,3,3,320296,320296,320299,0,3,0
91531,3,3,320299,320299,320302,0,3,0
91532,4,3,320303,320303,320306,0,3,1
91533,5,3,320308,320308,320311,0,3,2
91534,4,1,320312,320312,320313,0,1,1
91535,6,2,320318,320318,320320,0,2,5
91536,5,3,320323,320323,320326,0,3,3
91537,6,1,320329,320329,320330,0,1,3
91538,6,1,320335,320335,320336,0,1,5
91539,6,2,320341,320341,320343,0,2,5
91540,2,3,320343,320343,320346,0,3,0
91541,4,3,320347,320347,320350,0,3,1
91542,3,2,320350,320350,320352,0,2,0
91543,6,1,320356,320356,320357,0,1,4
91544,4,3,320360,320360,320363,0,3,3
91545,2,3,320362,320363,320366,1,4,0
91546,4,2,320366,320366,320368,0,2,0
91547,6,1,320372,320372,320373,0,1,4
91548,2,2,320374,320374,320376,0,2,1
91549,1,2,320375,320376,320378,1,3,0
91550,6,1,320381,320381,320382,0,1,3
91551,5,1,320386,320386,320387,0,1,4
91552,1,3,320387,320387,320390,0,3,0
91553,5,1,320392,320392,320393,0,1,2
91554,4,2,320396,320396,320398,0,2,3
91555,4,1,320400,320400,320401,0,1,2
91556,6,3,320406,320406,320409,0,3,5
91557,4,2,320410,320410,320412,0,2,1
91558,1,1,320411,320412,320413,1,2,0
91559,6,1,320417,320417,320418,0,1,4
91560,1,2,320418,320418,320420,0,2,0
91561,2,3,320420,320420,320423,0,3,0
91562,6,3,320426,320426,320429,0,3,3
91563,2,3,320428,320429,320432,1,4,0
91564,5,2,320433,320433,320435,0,2,1
91565,1,3,320434,320435,320438,1,4,0
91566,3,2,320437,320438,320440,1,3,0
91567,4,3,320441,320441,320444,0,3,1
91568,6,3,320447,320447,320450,0,3,3
91569,4,1,320451,320451,320452,0,1,1
91570,1,1,320452,320452,320453,0,1,0
91571,6,1,320458,320458,320459,0,1,5
91572,1,2,320459,320459,320461,0,2,0
91573,4,2,320463,320463,320465,0,2,2
91574,5,1,320468,320468,320469,0,1,3
91575,3,1,320471,320471,320472,0,1,2
91576,5,2,320476,320476,320478,0,2,4
91577,5,2,320481,320481,320483,0,2,3
91578,6,2,320487,320487,320489,0,2,4
91579,3,1,320490,320490,320491,0,1,1
91580,6,1,320496,320496,320497,0,1,5
91581,1,3,320497,320497,320500,0,3,0
91582,6,1,320503,320503,320504,0,1,3
91583,3,1,320506,320506,320507,0,1,2
91584,6,2,320512,320512,320514,0,2,5
91585,4,1,320516,320516,320517,0,1,2
91586,4,1,320520,320520,320521,0,1,3
91587,1,2,320521,320521,320523,0,2,0
91588,2,3,320523,320523,320526,0,3,0
91589,4,3,320527,320527,320530,0,3,1
91590,3,1,320530,320530,320531,0,1,0
91591,3,1,320533,320533,320534,0,1,2
91592,2,2,320535,320535,320537,0,2,1
91593,2,2,320537,320537,320539,0,2,0
91594,3,3,320540,320540,320543,0,3,1
91595,2,1,320542,320543,320544,1,2,0
91596,1,3,320543,320544,320547,1,4,0
91597,4,1,320547,320547,320548,0,1,0
91598,4,1,320551,320551,320552,0,1,3
91599,4,2,320555,320555,320557,0,2,3
91600,5,2,320560,320560,320562,0,2,3
91601,4,3,320564,320564,320567,0,3,2
91602,2,3,320566,320567,320570,1,4,0
91603,5,2,320571,320571,320573,0,2,1
91604,3,2,320574,320574,320576,0,2,1
91605,2,3,320576,320576,320579,0,3,0
91606,1,2,320577,320579,320581,2,4,0
91607,6,1,320583,320583,320584,0,1,2
91608,1,3,320584,320584,320587,0,3,0
91609,4,2,320588,320588,320590,0,2,1
91610,3,3,320591,320591,320594,0,3,1
91611,2,2,320593,320594,320596,1,3,0
91612,5,1,320598,320598,320599,0,1,2
91613,6,2,320604,320604,320606,0,2,5
91614,3,2,320607,320607,320609,0,2,1
91615,1,2,320608,320609,320611,1,3,0
91616,6,1,320614,320614,320615,0,1,3
91617,6,3,320620,320620,320623,0,3,5
91618,6,3,320626,320626,320629,0,3,3
91619,1,3,320627,320629,320632,2,5,0
91620,1,1,320628,320632,320633,4,5,0
91621,3,3,320631,320633,320636,2,5,0
91622,4,3,320635,320636,320639,1,4,0
91623,3,2,320638,320639,320641,1,3,0
91624,5,2,320643,320643,320645,0,2,2
91625,6,3,320649,320649,320652,0,3,4
91626,6,3,320655,320655,320658,0,3,3
91627,5,2,320660,320660,320662,0,2,2
91628,2,2,320662,320662,320664,0,2,0
91629,4,1,320666,320666,320667,0,1,2
91630,2,1,320668,320668,320669,0,1,1
91631,3,3,320671,320671,320674,0,3,2
91632,4,2,320675,320675,320677,0,2,1
91633,3,1,320678,320678,320679,0,1,1
91634,2,3,320680,320680,320683,0,3,1
91635,3,3,320683,320683,320686,0,3,0
91636,2,1,320685,320686,320687,1,2,0
91637,2,3,320687,320687,320690,0,3,0
91638,4,3,320691,320691,320694,0,3,1
91639,6,1,320697,320697,320698,0,1,3
91640,4,3,320701,320701,320704,0,3,3
91641,4,2,320705,320705,320707,0,2,1
91642,1,2,320706,320707,320709,1,3,0
91643,2,1,320708,320709,320710,1,2,0
91644,1,2,320709,320710,320712,1,3,0
91645,2,3,320711,320712,320715,1,4,0
91646,6,1,320717,320717,320718,0,1,2
91647,4,2,320721,320721,320723,0,2,3
91648,5,2,320726,320726,320728,0,2,3
91649,6,1,320732,320732,320733,0,1,4
91650,1,1,320733,320733,320734,0,1,0
91651,6,3,320739,320739,320742,0,3,5
91652,5,2,320744,320744,320746,0,2,2
91653,4,3,320748,320748,320751,0,3,2
91654,3,1,320751,320751,320752,0,1,0
91655,3,2,320754,320754,320756,0,2,2
91656,1,1,320755,320756,320757,1,2,0
91657,3,2,320758,320758,320760,0,2,1
91658,6,1,320764,320764,320765,0,1,4
91659,1,2,320765,320765,320767,0,2,0
91660,6,2,320771,320771,320773,0,2,4
91661,5,2,320776,320776,320778,0,2,3
91662,3,3,320779,320779,320782,0,3,1
91663,4,2,320783,320783,320785,0,2,1
91664,4,1,320787,320787,320788,0,1,2
91665,5,2,320792,320792,320794,0,2,4
91666,5,1,320797,320797,320798,0,1,3
91667,5,2,320802,320802,320804,0,2,4
91668,6,3,320808,320808,320811,0,3,4
91669,5,3,320813,320813,320816,0,3,2
91670,5,2,320818,320818,320820,0,2,2
91671,1,3,320819,320820,320823,1,4,0
91672,2,2,320821,320823,320825,2,4,0
91673,1,2,320822,320825,320827,3,5,0
91674,1,1,320823,320827,320828,4,5,0
91675,2,2,320825,320828,320830,3,5,0
91676,1,3,320826,320830,320833,4,7,0
91677,1,2,320827,320833,320835,6,8,0
91678,5,1,320832,320835,320836,3,4,0
91679,2,2,320834,320836,320838,2,4,0
91680,1,2,320835,320838,320840,3,5,0
91681,1,3,320836,320840,320843,4,7,0
91682,5,3,320841,320843,320846,2,5,0
91683,5,2,320846,320846,320848,0,2,0
91684,5,3,320851,320851,320854,0,3,3
91685,6,2,320857,320857,320859,0,2,3
91686,1,2,320858,320859,320861,1,3,0
91687,5,2,320863,320863,320865,0,2,2
91688,6,3,320869,320869,320872,0,3,4
91689,2,3,320871,320872,320875,1,4,0
91690,6,1,320877,320877,320878,0,1,2
91691,4,3,320881,320881,320884,0,3,3
91692,2,3,320883,320884,320887,1,4,0
91693,6,1,320889,320889,320890,0,1,2
91694,3,3,320892,320892,320895,0,3,2
91695,1,1,320893,320895,320896,2,3,0
91696,3,2,320896,320896,320898,0,2,0
91697,3,1,320899,320899,320900,0,1,1
91698,5,3,320904,320904,320907,0,3,4
91699,2,1,320906,320907,320908,1,2,0
91700,2,1,320908,320908,320909,0,1,0
91701,1,2,320909,320909,320911,0,2,0
91702,6,3,320915,320915,320918,0,3,4
91703,1,3,320916,320918,320921,2,5,0
91704,4,3,320920,320921,320924,1,4,0
91705,3,2,320923,320924,320926,1,3,0
91706,4,1,320927,320927,320928,0,1,1
91707,4,2,320931,320931,320933,0,2,3
91708,3,1,320934,320934,320935,0,1,1
91709,3,2,320937,320937,320939,0,2,2
91710,4,1,320941,320941,320942,0,1,2
91711,4,1,320945,320945,320946,0,1,3
91712,3,1,320948,320948,320949,0,1,2
91713,1,2,320949,320949,320951,0,2,0
91714,6,2,320955,320955,320957,0,2,4
91715,5,1,320960,320960,320961,0,1,3
91716,5,2,320965,320965,320967,0,2,4
91717,2,2,320967,320967,320969,0,2,0
91718,5,1,320972,320972,320973,0,1,3
91719,6,2,320978,320978,320980,0,2,5
91720,1,2,320979,320980,320982,1,3,0
91721,5,3,320984,320984,320987,0,3,2
91722,6,2,320990,320990,320992,0,2,3
91723,3,3,320993,320993,320996,0,3,1
91724,2,1,320995,320996,320997,1,2,0
91725,4,1,320999,320999,321000,0,1,2
91726,5,2,321004,321004,321006,0,2,4
91727,2,3,321006,321006,321009,0,3,0
91728,6,2,321012,321012,321014,0,2,3
91729,4,3,321016,321016,321019,0,3,2
91730,2,2,321018,321019,321021,1,3,0
91731,3,3,321021,321021,321024,0,3,0
91732,2,1,321023,321024,321025,1,2,0
91733,5,2,321028,321028,321030,0,2,3
91734,4,1,321032,321032,321033,0,1,2
91735,1,3,321033,321033,321036,0,3,0
91736,4,2,321037,321037,321039,0,2,1
91737,2,3,321039,321039,321042,0,3,0
91738,2,1,321041,321042,321043,1,2,0
91739,3,3,321044,321044,321047,0,3,1
91740,3,3,321047,321047,321050,0,3,0
91741,4,2,321051,321051,321053,0,2,1
91742,3,2,321054,321054,321056,0,2,1
91743,3,2,321057,321057,321059,0,2,1
91744,2,2,321059,321059,321061,0,2,0
91745,2,1,321061,321061,321062,0,1,0
91746,2,1,321063,321063,321064,0,1,1
91747,4,2,321067,321067,321069,0,2,3
91748,6,2,321073,321073,321075,0,2,4
91749,6,1,321079,321079,321080,0,1,4
91750,6,3,321085,321085,321088,0,3,5
91751,3,3,321088,321088,321091,0,3,0
91752,2,1,321090,321091,321092,1,2,0
91753,1,3,321091,321092,321095,1,4,0
91754,2,3,321093,321095,321098,2,5,0
91755,5,2,321098,321098,321100,0,2,0
91756,2,3,321100,321100,321103,0,3,0
91757,4,3,321104,321104,321107,0,3,1
91758,3,2,321107,321107,321109,0,2,0
91759,2,2,321109,321109,321111,0,2,0
91760,2,2,321111,321111,321113,0,2,0
91761,5,1,321116,321116,321117,0,1,3
91762,4,2,321120,321120,321122,0,2,3
91763,1,2,321121,321122,321124,1,3,0
91764,1,2,321122,321124,321126,2,4,0
91765,4,2,321126,321126,321128,0,2,0
91766,4,1,321130,321130,321131,0,1,2
91767,4,2,321134,321134,321136,0,2,3
91768,6,2,321140,321140,321142,0,2,4
91769,4,1,321144,321144,321145,0,1,2
91770,6,2,321150,321150,321152,0,2,5
91771,5,1,321155,321155,321156,0,1,3
91772,3,2,321158,321158,321160,0,2,2
91773,6,3,321164,321164,321167,0,3,4
91774,6,1,321170,321170,321171,0,1,3
91775,5,2,321175,321175,321177,0,2,4
91776,2,1,321177,321177,321178,0,1,0
91777,5,1,321182,321182,321183,0,1,4
91778,4,3,321186,321186,321189,0,3,3
91779,6,2,321192,321192,321194,0,2,3
91780,2,3,321194,321194,321197,0,3,0
91781,2,2,321196,321197,321199,1,3,0
91782,3,1,321199,321199,321200,0,1,0
91783,3,2,321202,321202,321204,0,2,2
91784,5,3,321207,321207,321210,0,3,3
91785,6,3,321213,321213,321216,0,3,3
91786,4,1,321217,321217,321218,0,1,1
91787,1,3,321218,321218,321221,0,3,0
91788,5,1,321223,321223,321224,0,1,2
91789,2,3,321225,321225,321228,0,3,1
91790,6,1,321231,321231,321232,0,1,3
91791,6,3,321237,321237,321240,0,3,5
91792,6,1,321243,321243,321244,0,1,3
91793,6,1,321249,321249,321250,0,1,5
91794,2,2,321251,321251,321253,0,2,1
91795,2,3,321253,321253,321256,0,3,0
91796,1,1,321254,321256,321257,2,3,0
91797,5,3,321259,321259,321262,0,3,2
91798,5,3,321264,321264,321267,0,3,2
91799,6,3,321270,321270,321273,0,3,3
91800,4,3,321274,321274,321277,0,3,1
91801,4,2,321278,321278,321280,0,2,1
91802,3,2,321281,321281,321283,0,2,1
91803,3,1,321284,321284,321285,0,1,1
91804,1,2,321285,321285,321287,0,2,0
91805,1,3,321286,321287,321290,1,4,0
91806,3,1,321289,321290,321291,1,2,0
91807,1,2,321290,321291,321293,1,3,0
91808,6,3,321296,321296,321299,0,3,3
91809,2,2,321298,321299,321301,1,3,0
91810,1,1,321299,321301,321302,2,3,0
91811,4,1,321303,321303,321304,0,1,1
91812,1,3,321304,321304,321307,0,3,0
91813,4,3,321308,321308,321311,0,3,1
91814,2,1,321310,321311,321312,1,2,0
91815,3,2,321313,321313,321315,0,2,1
91816,4,2,321317,321317,321319,0,2,2
91817,3,3,321320,321320,321323,0,3,1
91818,1,2,321321,321323,321325,2,4,0
91819,3,1,321324,321325,321326,1,2,0
91820,5,1,321329,321329,321330,0,1,3
91821,5,3,321334,321334,321337,0,3,4
91822,6,2,321340,321340,321342,0,2,3
91823,2,3,321342,321342,321345,0,3,0
91824,2,1,321344,321345,321346,1,2,0
91825,5,3,321349,321349,321352,0,3,3
91826,3,3,321352,321352,321355,0,3,0
91827,2,2,321354,321355,321357,1,3,0
91828,1,2,321355,321357,321359,2,4,0
91829,4,1,321359,321359,321360,0,1,0
91830,4,3,321363,321363,321366,0,3,3
91831,3,3,321366,321366,321369,0,3,0
91832,1,2,321367,321369,321371,2,4,0
91833,6,2,321373,321373,321375,0,2,2
91834,1,1,321374,321375,321376,1,2,0
91835,1,3,321375,321376,321379,1,4,0
91836,6,3,321381,321381,321384,0,3,2
91837,5,1,321386,321386,321387,0,1,2
91838,6,3,321392,321392,321395,0,3,5
91839,2,1,321394,321395,321396,1,2,0
91840,2,1,321396,321396,321397,0,1,0
91841,6,3,321402,321402,321405,0,3,5
91842,4,1,321406,321406,321407,0,1,1
91843,5,1,321411,321411,321412,0,1,4
91844,3,1,321414,321414,321415,0,1,2
91845,6,2,321420,321420,321422,0,2,5
91846,3,2,321423,321423,321425,0,2,1
91847,5,3,321428,321428,321431,0,3,3
91848,1,3,321429,321431,321434,2,5,0
91849,3,3,321432,321434,321437,2,5,0
91850,5,1,321437,321437,321438,0,1,0
91851,4,1,321441,321441,321442,0,1,3
91852,4,2,321445,321445,321447,0,2,3
91853,4,3,321449,321449,321452,0,3,2
91854,2,1,321451,321452,321453,1,2,0
91855,2,1,321453,321453,321454,0,1,0
91856,4,1,321457,321457,321458,0,1,3
91857,3,1,321460,321460,321461,0,1,2
91858,2,3,321462,321462,321465,0,3,1
91859,4,1,321466,321466,321467,0,1,1
91860,4,1,321470,321470,321471,0,1,3
91861,6,3,321476,321476,321479,0,3,5
91862,4,2,321480,321480,321482,0,2,1
91863,6,1,321486,321486,321487,0,1,4
91864,5,3,321491,321491,321494,0,3,4
91865,2,3,321493,321494,321497,1,4,0
91866,2,1,321495,321497,321498,2,3,0
91867,3,3,321498,321498,321501,0,3,0
91868,3,2,321501,321501,321503,0,2,0
91869,4,2,321505,321505,321507,0,2,2
91870,3,3,321508,321508,321511,0,3,1
91871,1,3,321509,321511,321514,2,5,0
91872,6,3,321515,321515,321518,0,3,1
91873,2,1,321517,321518,321519,1,2,0
91874,3,2,321520,321520,321522,0,2,1
91875,2,1,321522,321522,321523,0,1,0
91876,6,1,321528,321528,321529,0,1,5
91877,4,1,321532,321532,321533,0,1,3
91878,3,1,321535,321535,321536,0,1,2
91879,2,1,321537,321537,321538,0,1,1
91880,6,1,321543,321543,321544,0,1,5
91881,5,3,321548,321548,321551,0,3,4
91882,4,2,321552,321552,321554,0,2,1
91883,5,1,321557,321557,321558,0,1,3
91884,5,2,321562,321562,321564,0,2,4
91885,4,1,321566,321566,321567,0,1,2
91886,1,1,321567,321567,321568,0,1,0
91887,2,1,321569,321569,321570,0,1,1
91888,6,1,321575,321575,321576,0,1,5
91889,1,1,321576,321576,321577,0,1,0
91890,5,2,321581,321581,321583,0,2,4
91891,4,3,321585,321585,321588,0,3,2
91892,6,2,321591,321591,321593,0,2,3
91893,4,1,321595,321595,321596,0,1,2
91894,6,2,321601,321601,321603,0,2,5
91895,6,2,321607,321607,321609,0,2,4
91896,1,2,321608,321609,321611,1,3,0
91897,1,1,321609,321611,321612,2,3,0
91898,2,2,321611,321612,321614,1,3,0
91899,1,3,321612,321614,321617,2,5,0
91900,4,3,321616,321617,321620,1,4,0
91901,1,1,321617,321620,321621,3,4,0
91902,1,3,321618,321621,321624,3,6,0
91903,6,3,321624,321624,321627,0,3,0
91904,1,3,321625,321627,321630,2,5,0
91905,2,3,321627,321630,321633,3,6,0
91906,6,3,321633,321633,321636,0,3,0
91907,1,2,321634,321636,321638,2,4,0
91908,1,1,321635,321638,321639,3,4,0
91909,2,3,321637,321639,321642,2,5,0
91910,6,1,321643,321643,321644,0,1,1
91911,1,2,321644,321644,321646,0,2,0
91912,2,3,321646,321646,321649,0,3,0
91913,3,2,321649,321649,321651,0,2,0
91914,6,2,321655,321655,321657,0,2,4
91915,2,1,321657,321657,321658,0,1,0
91916,1,3,321658,321658,321661,0,3,0
91917,4,3,321662,321662,321665,0,3,1
91918,2,1,321664,321665,321666,1,2,0
91919,6,3,321670,321670,321673,0,3,4
91920,2,3,321672,321673,321676,1,4,0
91921,4,1,321676,321676,321677,0,1,0
91922,6,2,321682,321682,321684,0,2,5
91923,5,1,321687,321687,321688,0,1,3
91924,4,3,321691,321691,321694,0,3,3
91925,1,3,321692,321694,321697,2,5,0
91926,3,2,321695,321697,321699,2,4,0
91927,3,3,321698,321699,321702,1,4,0
91928,3,3,321701,321702,321705,1,4,0
91929,3,2,321704,321705,321707,1,3,0
91930,1,3,321705,321707,321710,2,5,0
91931,2,1,321707,321710,321711,3,4,0
91932,6,1,321713,321713,321714,0,1,2
91933,2,1,321715,321715,321716,0,1,1
91934,5,1,321720,321720,321721,0,1,4
91935,2,2,321722,321722,321724,0,2,1
91936,5,1,321727,321727,321728,0,1,3
91937,1,1,321728,321728,321729,0,1,0
91938,1,1,321729,321729,321730,0,1,0
91939,1,2,321730,321730,321732,0,2,0
91940,6,1,321736,321736,321737,0,1,4
91941,1,3,321737,321737,321740,0,3,0
91942,3,2,321740,321740,321742,0,2,0
91943,6,3,321746,321746,321749,0,3,4
91944,3,3,321749,321749,321752,0,3,0
91945,4,1,321753,321753,321754,0,1,1
91946,4,3,321757,321757,321760,0,3,3
91947,3,3,321760,321760,321763,0,3,0
91948,4,1,321764,321764,321765,0,1,1
91949,3,1,321767,321767,321768,0,1,2
91950,6,2,321773,321773,321775,0,2,5
91951,2,1,321775,321775,321776,0,1,0
91952,1,1,321776,321776,321777,0,1,0
91953,5,1,321781,321781,321782,0,1,4
91954,5,2,321786,321786,321788,0,2,4
91955,6,3,321792,321792,321795,0,3,4
91956,6,2,321798,321798,321800,0,2,3
91957,3,2,321801,321801,321803,0,2,1
91958,2,3,321803,321803,321806,0,3,0
91959,1,2,321804,321806,321808,2,4,0
91960,4,2,321808,321808,321810,0,2,0
91961,3,1,321811,321811,321812,0,1,1
91962,3,3,321814,321814,321817,0,3,2
91963,5,3,321819,321819,321822,0,3,2
91964,3,2,321822,321822,321824,0,2,0
91965,2,2,321824,321824,321826,0,2,0
91966,3,1,321827,321827,321828,0,1,1
91967,3,1,321830,321830,321831,0,1,2
91968,4,1,321834,321834,321835,0,1,3
91969,5,2,321839,321839,321841,0,2,4
91970,1,1,321840,321841,321842,1,2,0
91971,3,1,321843,321843,321844,0,1,1
91972,2,3,321845,321845,321848,0,3,1
91973,4,3,321849,321849,321852,0,3,1
91974,2,3,321851,321852,321855,1,4,0
91975,1,3,321852,321855,321858,3,6,0
91976,4,2,321856,321858,321860,2,4,0
91977,4,1,321860,321860,321861,0,1,0
91978,4,1,321864,321864,321865,0,1,3
91979,6,1,321870,321870,321871,0,1,5
91980,4,1,321874,321874,321875,0,1,3
91981,4,3,321878,321878,321881,0,3,3
91982,4,2,321882,321882,321884,0,2,1
91983,3,2,321885,321885,321887,0,2,1
91984,5,1,321890,321890,321891,0,1,3
91985,1,3,321891,321891,321894,0,3,0
91986,4,2,321895,321895,321897,0,2,1
91987,4,1,321899,321899,321900,0,1,2
91988,6,3,321905,321905,321908,0,3,5
91989,3,2,321908,321908,321910,0,2,0
91990,1,1,321909,321910,321911,1,2,0
91991,5,1,321914,321914,321915,0,1,3
91992,6,2,321920,321920,321922,0,2,5
91993,2,2,321922,321922,321924,0,2,0
91994,2,3,321924,321924,321927,0,3,0
91995,4,1,321928,321928,321929,0,1,1
91996,2,2,321930,321930,321932,0,2,1
91997,2,2,321932,321932,321934,0,2,0
91998,6,1,321938,321938,321939,0,1,4
91999,6,2,321944,321944,321946,0,2,5
92000,1,3,321945,321946,321949,1,4,0
92001,5,2,321950,321950,321952,0,2,1
92002,5,3,321955,321955,321958,0,3,3
92003,6,3,321961,321961,321964,0,3,3
92004,4,1,321965,321965,321966,0,1,1
92005,5,3,321970,321970,321973,0,3,4
92006,3,3,321973,321973,321976,0,3,0
92007,5,1,321978,321978,321979,0,1,2
92008,2,1,321980,321980,321981,0,1,1
92009,4,3,321984,321984,321987,0,3,3
92010,1,1,321985,321987,321988,2,3,0
92011,4,2,321989,321989,321991,0,2,1
92012,3,1,321992,321992,321993,0,1,1
92013,4,1,321996,321996,321997,0,1,3
92014,3,3,321999,321999,322002,0,3,2
92015,1,3,322000,322002,322005,2,5,0
92016,4,2,322004,322005,322007,1,3,0
92017,2,2,322006,322007,322009,1,3,0
92018,5,1,322011,322011,322012,0,1,2
92019,3,2,322014,322014,322016,0,2,2
92020,1,3,322015,322016,322019,1,4,0
92021,2,3,322017,322019,322022,2,5,0
92022,5,3,322022,322022,322025,0,3,0
92023,6,2,322028,322028,322030,0,2,3
92024,3,1,322031,322031,322032,0,1,1
92025,3,2,322034,322034,322036,0,2,2
92026,4,3,322038,322038,322041,0,3,2
92027,6,2,322044,322044,322046,0,2,3
92028,5,3,322049,322049,322052,0,3,3
92029,3,1,322052,322052,322053,0,1,0
92030,6,2,322058,322058,322060,0,2,5
92031,4,3,322062,322062,322065,0,3,2
92032,3,1,322065,322065,322066,0,1,0
92033,3,2,322068,322068,322070,0,2,2
92034,4,1,322072,322072,322073,0,1,2
92035,6,3,322078,322078,322081,0,3,5
92036,6,1,322084,322084,322085,0,1,3
92037,6,2,322090,322090,322092,0,2,5
92038,6,2,322096,322096,322098,0,2,4
92039,1,2,322097,322098,322100,1,3,0
92040,4,1,322101,322101,322102,0,1,1
92041,3,2,322104,322104,322106,0,2,2
92042,4,3,322108,322108,322111,0,3,2
92043,6,1,322114,322114,322115,0,1,3
92044,1,3,322115,322115,322118,0,3,0
92045,4,3,322119,322119,322122,0,3,1
92046,1,1,322120,322122,322123,2,3,0
92047,2,2,322122,322123,322125,1,3,0
92048,2,1,322124,322125,322126,1,2,0
92049,2,3,322126,322126,322129,0,3,0
92050,4,2,322130,322130,322132,0,2,1
92051,6,3,322136,322136,322139,0,3,4
92052,5,1,322141,322141,322142,0,1,2
92053,1,1,322142,322142,322143,0,1,0
92054,2,3,322144,322144,322147,0,3,1
92055,1,1,322145,322147,322148,2,3,0
92056,4,2,322149,322149,322151,0,2,1
92057,5,1,322154,322154,322155,0,1,3
92058,4,3,322158,322158,322161,0,3,3
92059,1,3,322159,322161,322164,2,5,0
92060,4,1,322163,322164,322165,1,2,0
92061,4,3,322167,322167,322170,0,3,2
92062,4,1,322171,322171,322172,0,1,1
92063,4,3,322175,322175,322178,0,3,3
92064,4,1,322179,322179,322180,0,1,1
92065,2,1,322181,322181,322182,0,1,1
92066,4,1,322185,322185,322186,0,1,3
92067,6,3,322191,322191,322194,0,3,5
92068,4,1,322195,322195,322196,0,1,1
92069,4,2,322199,322199,322201,0,2,3
92070,6,3,322205,322205,322208,0,3,4
92071,5,1,322210,322210,322211,0,1,2
92072,2,3,322212,322212,322215,0,3,1
92073,1,3,322213,322215,322218,2,5,0
92074,3,1,322216,322218,322219,2,3,0
92075,5,2,322221,322221,322223,0,2,2
92076,6,1,322227,322227,322228,0,1,4
92077,5,3,322232,322232,322235,0,3,4
92078,1,3,322233,322235,322238,2,5,0
92079,5,3,322238,322238,322241,0,3,0
92080,5,2,322243,322243,322245,0,2,2
92081,2,1,322245,322245,322246,0,1,0
92082,3,1,322248,322248,322249,0,1,2
92083,3,2,322251,322251,322253,0,2,2
92084,4,1,322255,322255,322256,0,1,2
92085,5,1,322260,322260,322261,0,1,4
92086,4,3,322264,322264,322267,0,3,3
92087,4,2,322268,322268,322270,0,2,1
92088,1,3,322269,322270,322273,1,4,0
92089,2,1,322271,322273,322274,2,3,0
92090,2,3,322273,322274,322277,1,4,0
92091,6,1,322279,322279,322280,0,1,2
92092,5,1,322284,322284,322285,0,1,4
92093,4,2,322288,322288,322290,0,2,3
92094,4,2,322292,322292,322294,0,2,2
92095,1,2,322293,322294,322296,1,3,0
92096,5,3,322298,322298,322301,0,3,2
92097,3,2,322301,322301,322303,0,2,0
92098,2,1,322303,322303,322304,0,1,0
92099,4,1,322307,322307,322308,0,1,3
92100,1,3,322308,322308,322311,0,3,0
92101,5,2,322313,322313,322315,0,2,2
92102,3,1,322316,322316,322317,0,1,1
92103,4,1,322320,322320,322321,0,1,3
92104,1,2,322321,322321,322323,0,2,0
92105,6,2,322327,322327,322329,0,2,4
92106,2,2,322329,322329,322331,0,2,0
92107,3,1,322332,322332,322333,0,1,1
92108,5,1,322337,322337,322338,0,1,4
92109,1,3,322338,322338,322341,0,3,0
92110,3,1,322341,322341,322342,0,1,0
92111,1,3,322342,322342,322345,0,3,0
92112,5,2,322347,322347,322349,0,2,2
92113,4,1,322351,322351,322352,0,1,2
92114,4,3,322355,322355,322358,0,3,3
92115,4,3,322359,322359,322362,0,3,1
92116,6,1,322365,322365,322366,0,1,3
92117,4,1,322369,322369,322370,0,1,3
92118,2,3,322371,322371,322374,0,3,1
92119,5,3,322376,322376,322379,0,3,2
92120,2,1,322378,322379,322380,1,2,0
92121,3,1,322381,322381,322382,0,1,1
92122,2,1,322383,322383,322384,0,1,1
92123,6,2,322389,322389,322391,0,2,5
92124,5,3,322394,322394,322397,0,3,3
92125,3,2,322397,322397,322399,0,2,0
92126,6,1,322403,322403,322404,0,1,4
92127,2,1,322405,322405,322406,0,1,1
92128,5,2,322410,322410,322412,0,2,4
92129,3,2,322413,322413,322415,0,2,1
92130,1,3,322414,322415,322418,1,4,0
92131,5,2,322419,322419,322421,0,2,1
92132,5,2,322424,322424,322426,0,2,3
92133,2,3,322426,322426,322429,0,3,0
92134,4,2,322430,322430,322432,0,2,1
92135,4,3,322434,322434,322437,0,3,2
92136,6,1,322440,322440,322441,0,1,3
92137,6,1,322446,322446,322447,0,1,5
92138,5,1,322451,322451,322452,0,1,4
92139,1,1,322452,322452,322453,0,1,0
92140,5,1,322457,322457,322458,0,1,4
92141,1,3,322458,322458,322461,0,3,0
92142,4,3,322462,322462,322465,0,3,1
92143,6,1,322468,322468,322469,0,1,3
92144,3,1,322471,322471,322472,0,1,2
92145,1,2,322472,322472,322474,0,2,0
92146,2,3,322474,322474,322477,0,3,0
92147,4,3,322478,322478,322481,0,3,1
92148,1,3,322479,322481,322484,2,5,0
92149,1,3,322480,322484,322487,4,7,0
92150,6,3,322486,322487,322490,1,4,0
92151,3,1,322489,322490,322491,1,2,0
92152,2,1,322491,322491,322492,0,1,0
92153,3,3,322494,322494,322497,0,3,2
92154,3,3,322497,322497,322500,0,3,0
92155,6,1,322503,322503,322504,0,1,3
92156,1,3,322504,322504,322507,0,3,0
92157,6,1,322510,322510,322511,0,1,3
92158,5,1,322515,322515,322516,0,1,4
92159,2,3,322517,322517,322520,0,3,1
92160,2,2,322519,322520,322522,1,3,0
92161,3,1,322522,322522,322523,0,1,0
92162,6,2,322528,322528,322530,0,2,5
92163,4,1,322532,322532,322533,0,1,2
92164,3,3,322535,322535,322538,0,3,2
92165,5,1,322540,322540,322541,0,1,2
92166,2,2,322542,322542,322544,0,2,1
92167,4,1,322546,322546,322547,0,1,2
92168,6,2,322552,322552,322554,0,2,5
92169,5,3,322557,322557,322560,0,3,3
92170,3,2,322560,322560,322562,0,2,0
92171,5,3,322565,322565,322568,0,3,3
92172,4,1,322569,322569,322570,0,1,1
92173,3,2,322572,322572,322574,0,2,2
92174,4,2,322576,322576,322578,0,2,2
92175,6,2,322582,322582,322584,0,2,4
92176,3,3,322585,322585,322588,0,3,1
92177,5,1,322590,322590,322591,0,1,2
92178,1,2,322591,322591,322593,0,2,0
92179,6,1,322597,322597,322598,0,1,4
92180,6,2,322603,322603,322605,0,2,5
92181,3,1,322606,322606,322607,0,1,1
92182,1,1,322607,322607,322608,0,1,0
92183,4,1,322611,322611,322612,0,1,3
92184,3,1,322614,322614,322615,0,1,2
92185,2,1,322616,322616,322617,0,1,1
92186,2,2,322618,322618,322620,0,2,1
92187,5,3,322623,322623,322626,0,3,3
92188,5,2,322628,322628,322630,0,2,2
92189,4,2,322632,322632,322634,0,2,2
92190,3,3,322635,322635,322638,0,3,1
92191,3,2,322638,322638,322640,0,2,0
92192,6,2,322644,322644,322646,0,2,4
92193,2,1,322646,322646,322647,0,1,0
92194,4,2,322650,322650,322652,0,2,3
92195,1,3,322651,322652,322655,1,4,0
92196,4,1,322655,322655,322656,0,1,0
92197,4,1,322659,322659,322660,0,1,3
92198,4,1,322663,322663,322664,0,1,3
92199,2,1,322665,322665,322666,0,1,1
92200,4,2,322669,322669,322671,0,2,3
92201,1,1,322670,322671,322672,1,2,0
92202,5,1,322675,322675,322676,0,1,3
92203,5,2,322680,322680,322682,0,2,4
92204,3,2,322683,322683,322685,0,2,1
92205,4,3,322687,322687,322690,0,3,2
92206,2,3,322689,322690,322693,1,4,0
92207,1,3,322690,322693,322696,3,6,0
92208,6,1,322696,322696,322697,0,1,0
92209,4,1,322700,322700,322701,0,1,3
92210,1,2,322701,322701,322703,0,2,0
92211,2,3,322703,322703,322706,0,3,0
92212,6,1,322709,322709,322710,0,1,3
92213,1,3,322710,322710,322713,0,3,0
92214,6,3,322716,322716,322719,0,3,3
92215,1,3,322717,322719,322722,2,5,0
92216,4,3,322721,322722,322725,1,4,0
92217,1,1,322722,322725,322726,3,4,0
92218,5,2,322727,322727,322729,0,2,1
92219,5,3,322732,322732,322735,0,3,3
92220,5,2,322737,322737,322739,0,2,2
92221,3,2,322740,322740,322742,0,2,1
92222,2,2,322742,322742,322744,0,2,0
92223,1,2,322743,322744,322746,1,3,0
92224,2,2,322745,322746,322748,1,3,0
92225,4,1,322749,322749,322750,0,1,1
92226,1,1,322750,322750,322751,0,1,0
92227,5,3,322755,322755,322758,0,3,4
92228,1,3,322756,322758,322761,2,5,0
92229,2,2,322758,322761,322763,3,5,0
92230,1,2,322759,322763,322765,4,6,0
92231,1,1,322760,322765,322766,5,6,0
92232,2,2,322762,322766,322768,4,6,0
92233,1,2,322763,322768,322770,5,7,0
92234,5,1,322768,322770,322771,2,3,0
92235,1,3,322769,322771,322774,2,5,0
92236,2,3,322771,322774,322777,3,6,0
92237,5,1,322776,322777,322778,1,2,0
92238,4,2,322780,322780,322782,0,2,2
92239,5,1,322785,322785,322786,0,1,3
92240,5,2,322790,322790,322792,0,2,4
92241,5,2,322795,322795,322797,0,2,3
92242,6,2,322801,322801,322803,0,2,4
92243,6,3,322807,322807,322810,0,3,4
92244,1,1,322808,322810,322811,2,3,0
92245,5,1,322813,322813,322814,0,1,2
92246,1,3,322814,322814,322817,0,3,0
92247,4,2,322818,322818,322820,0,2,1
92248,2,1,322820,322820,322821,0,1,0
92249,2,2,322822,322822,322824,0,2,1
92250,2,1,322824,322824,322825,0,1,0
92251,2,2,322826,322826,322828,0,2,1
92252,5,1,322831,322831,322832,0,1,3
92253,5,1,322836,322836,322837,0,1,4
92254,4,1,322840,322840,322841,0,1,3
92255,6,1,322846,322846,322847,0,1,5
92256,2,1,322848,322848,322849,0,1,1
92257,5,2,322853,322853,322855,0,2,4
92258,4,3,322857,322857,322860,0,3,2
92259,5,3,322862,322862,322865,0,3,2
92260,2,1,322864,322865,322866,1,2,0
92261,4,3,322868,322868,322871,0,3,2
92262,3,2,322871,322871,322873,0,2,0
92263,3,3,322874,322874,322877,0,3,1
92264,6,3,322880,322880,322883,0,3,3
92265,4,2,322884,322884,322886,0,2,1
92266,6,2,322890,322890,322892,0,2,4
92267,6,3,322896,322896,322899,0,3,4
92268,2,2,322898,322899,322901,1,3,0
92269,5,3,322903,322903,322906,0,3,2
92270,1,1,322904,322906,322907,2,3,0
92271,4,2,322908,322908,322910,0,2,1
92272,6,2,322914,322914,322916,0,2,4
92273,1,3,322915,322916,322919,1,4,0
92274,2,2,322917,322919,322921,2,4,0
92275,6,2,322923,322923,322925,0,2,2
92276,3,3,322926,322926,322929,0,3,1
92277,2,1,322928,322929,322930,1,2,0
92278,4,2,322932,322932,322934,0,2,2
92279,3,2,322935,322935,322937,0,2,1
92280,5,3,322940,322940,322943,0,3,3
92281,2,1,322942,322943,322944,1,2,0
92282,2,1,322944,322944,322945,0,1,0
92283,5,3,322949,322949,322952,0,3,4
92284,1,1,322950,322952,322953,2,3,0
92285,6,2,322956,322956,322958,0,2,3
92286,2,1,322958,322958,322959,0,1,0
92287,2,3,322960,322960,322963,0,3,1
92288,4,2,322964,322964,322966,0,2,1
92289,4,1,322968,322968,322969,0,1,2
92290,5,3,322973,322973,322976,0,3,4
92291,1,2,322974,322976,322978,2,4,0
92292,1,1,322975,322978,322979,3,4,0
92293,5,2,322980,322980,322982,0,2,1
92294,4,3,322984,322984,322987,0,3,2
92295,4,3,322988,322988,322991,0,3,1
92296,4,2,322992,322992,322994,0,2,1
92297,3,3,322995,322995,322998,0,3,1
92298,2,2,322997,322998,323000,1,3,0
92299,3,1,323000,323000,323001,0,1,0
92300,2,3,323002,323002,323005,0,3,1
92301,1,1,323003,323005,323006,2,3,0
92302,5,3,323008,323008,323011,0,3,2
92303,3,2,323011,323011,323013,0,2,0
92304,3,3,323014,323014,323017,0,3,1
92305,3,1,323017,323017,323018,0,1,0
92306,3,1,323020,323020,323021,0,1,2
92307,6,3,323026,323026,323029,0,3,5
92308,5,2,323031,323031,323033,0,2,2
92309,6,2,323037,323037,323039,0,2,4
92310,3,1,323040,323040,323041,0,1,1
92311,5,1,323045,323045,323046,0,1,4
92312,5,2,323050,323050,323052,0,2,4
92313,1,1,323051,323052,323053,1,2,0
92314,3,2,323054,323054,323056,0,2,1
92315,6,2,323060,323060,323062,0,2,4
92316,2,1,323062,323062,323063,0,1,0
92317,1,1,323063,323063,323064,0,1,0
92318,6,2,323069,323069,323071,0,2,5
92319,5,1,323074,323074,323075,0,1,3
92320,4,1,323078,323078,323079,0,1,3
92321,3,2,323081,323081,323083,0,2,2
92322,3,3,323084,323084,323087,0,3,1
92323,2,1,323086,323087,323088,1,2,0
92324,2,1,323088,323088,323089,0,1,0
92325,4,2,323092,323092,323094,0,2,3
92326,6,2,323098,323098,323100,0,2,4
92327,5,3,323103,323103,323106,0,3,3
92328,6,2,323109,323109,323111,0,2,3
92329,4,3,323113,323113,323116,0,3,2
92330,1,3,323114,323116,323119,2,5,0
92331,5,2,323119,323119,323121,0,2,0
92332,5,2,323124,323124,323126,0,2,3
92333,2,1,323126,323126,323127,0,1,0
92334,1,2,323127,323127,323129,0,2,0
92335,4,2,323131,323131,323133,0,2,2
92336,1,3,323132,323133,323136,1,4,0
92337,4,1,323136,323136,323137,0,1,0
92338,4,2,323140,323140,323142,0,2,3
92339,5,1,323145,323145,323146,0,1,3
92340,2,3,323147,323147,323150,0,3,1
92341,2,3,323149,323150,323153,1,4,0
92342,5,1,323154,323154,323155,0,1,1
92343,6,3,323160,323160,323163,0,3,5
92344,1,2,323161,323163,323165,2,4,0
92345,4,3,323165,323165,323168,0,3,0
92346,6,3,323171,323171,323174,0,3,3
92347,6,1,323177,323177,323178,0,1,3
92348,5,2,323182,323182,323184,0,2,4
92349,6,2,323188,323188,323190,0,2,4
92350,5,1,323193,323193,323194,0,1,3
92351,4,2,323197,323197,323199,0,2,3
92352,4,3,323201,323201,323204,0,3,2
92353,2,2,323203,323204,323206,1,3,0
92354,4,2,323207,323207,323209,0,2,1
92355,6,1,323213,323213,323214,0,1,4
92356,3,3,323216,323216,323219,0,3,2
92357,2,1,323218,323219,323220,1,2,0
92358,3,2,323221,323221,323223,0,2,1
92359,4,2,323225,323225,323227,0,2,2
92360,3,2,323228,323228,323230,0,2,1
92361,6,2,323234,323234,323236,0,2,4
92362,3,1,323237,323237,323238,0,1,1
92363,2,1,323239,323239,323240,0,1,1
92364,3,1,323242,323242,323243,0,1,2
92365,1,2,323243,323243,323245,0,2,0
92366,6,1,323249,323249,323250,0,1,4
92367,4,3,323253,323253,323256,0,3,3
92368,2,1,323255,323256,323257,1,2,0
92369,3,2,323258,323258,323260,0,2,1
92370,5,3,323263,323263,323266,0,3,3
92371,4,2,323267,323267,323269,0,2,1
92372,6,2,323273,323273,323275,0,2,4
92373,4,1,323277,323277,323278,0,1,2
92374,3,2,323280,323280,323282,0,2,2
92375,4,2,323284,323284,323286,0,2,2
92376,4,1,323288,323288,323289,0,1,2
92377,3,2,323291,323291,323293,0,2,2
92378,1,3,323292,323293,323296,1,4,0
92379,5,1,323297,323297,323298,0,1,1
92380,5,2,323302,323302,323304,0,2,4
92381,1,3,323303,323304,323307,1,4,0
92382,2,2,323305,323307,323309,2,4,0
92383,2,3,323307,323309,323312,2,5,0
92384,2,2,323309,323312,323314,3,5,0
92385,2,2,323311,323314,323316,3,5,0
92386,2,1,323313,323316,323317,3,4,0
92387,1,1,323314,323317,323318,3,4,0
92388,5,2,323319,323319,323321,0,2,1
92389,1,1,323320,323321,323322,1,2,0
92390,2,1,323322,323322,323323,0,1,0
92391,6,3,323328,323328,323331,0,3,5
92392,4,3,323332,323332,323335,0,3,1
92393,1,1,323333,323335,323336,2,3,0
92394,2,1,323335,323336,323337,1,2,0
92395,4,2,323339,323339,323341,0,2,2
92396,5,3,323344,323344,323347,0,3,3
92397,5,3,323349,323349,323352,0,3,2
92398,4,1,323353,323353,323354,0,1,1
92399,4,1,323357,323357,323358,0,1,3
92400,1,3,323358,323358,323361,0,3,0
92401,3,2,323361,323361,323363,0,2,0
92402,6,1,323367,323367,323368,0,1,4
92403,2,3,323369,323369,323372,0,3,1
92404,5,1,323374,323374,323375,0,1,2
92405,6,3,323380,323380,323383,0,3,5
92406,6,2,323386,323386,323388,0,2,3
92407,2,2,323388,323388,323390,0,2,0
92408,6,2,323394,323394,323396,0,2,4
92409,1,3,323395,323396,323399,1,4,0
92410,2,2,323397,323399,323401,2,4,0
92411,6,3,323403,323403,323406,0,3,2
92412,1,2,323404,323406,323408,2,4,0
92413,3,1,323407,323408,323409,1,2,0
92414,6,2,323413,323413,323415,0,2,4
92415,6,3,323419,323419,323422,0,3,4
92416,3,2,323422,323422,323424,0,2,0
92417,6,3,323428,323428,323431,0,3,4
92418,3,1,323431,323431,323432,0,1,0
92419,6,2,323437,323437,323439,0,2,5
92420,3,2,323440,323440,323442,0,2,1
92421,5,3,323445,323445,323448,0,3,3
92422,2,2,323447,323448,323450,1,3,0
92423,2,2,323449,323450,323452,1,3,0
92424,1,2,323450,323452,323454,2,4,0
92425,4,2,323454,323454,323456,0,2,0
92426,2,1,323456,323456,323457,0,1,0
92427,3,2,323459,323459,323461,0,2,2
92428,6,2,323465,323465,323467,0,2,4
92429,1,2,323466,323467,323469,1,3,0
92430,4,2,323470,323470,323472,0,2,1
92431,2,2,323472,323472,323474,0,2,0
92432,4,2,323476,323476,323478,0,2,2
92433,2,2,323478,323478,323480,0,2,0
92434,2,2,323480,323480,323482,0,2,0
92435,6,2,323486,323486,323488,0,2,4
92436,2,3,323488,323488,323491,0,3,0
92437,2,2,323490,323491,323493,1,3,0
92438,3,1,323493,323493,323494,0,1,0
92439,2,1,323495,323495,323496,0,1,1
92440,4,3,323499,323499,323502,0,3,3
92441,4,1,323503,323503,323504,0,1,1
92442,3,2,323506,323506,323508,0,2,2
92443,6,2,323512,323512,323514,0,2,4
92444,4,2,323516,323516,323518,0,2,2
92445,2,3,323518,323518,323521,0,3,0
92446,4,1,323522,323522,323523,0,1,1
92447,5,1,323527,323527,323528,0,1,4
92448,4,3,323531,323531,323534,0,3,3
92449,2,2,323533,323534,323536,1,3,0
92450,1,3,323534,323536,323539,2,5,0
92451,6,1,323540,323540,323541,0,1,1
92452,4,2,323544,323544,323546,0,2,3
92453,4,2,323548,323548,323550,0,2,2
92454,4,1,323552,323552,323553,0,1,2
92455,6,1,323558,323558,323559,0,1,5
92456,6,2,323564,323564,323566,0,2,5
92457,6,1,323570,323570,323571,0,1,4
92458,4,2,323574,323574,323576,0,2,3
92459,2,3,323576,323576,323579,0,3,0
92460,2,2,323578,323579,323581,1,3,0
92461,5,2,323583,323583,323585,0,2,2
92462,5,2,323588,323588,323590,0,2,3
92463,5,2,323593,323593,323595,0,2,3
92464,2,1,323595,323595,323596,0,1,0
92465,2,3,323597,323597,323600,0,3,1
92466,1,1,323598,323600,323601,2,3,0
92467,1,3,323599,323601,323604,2,5,0
92468,1,1,323600,323604,323605,4,5,0
92469,5,3,323605,323605,323608,0,3,0
92470,1,2,323606,323608,323610,2,4,0
92471,6,2,323612,323612,323614,0,2,2
92472,3,1,323615,323615,323616,0,1,1
92473,5,3,323620,323620,323623,0,3,4
92474,2,3,323622,323623,323626,1,4,0
92475,2,2,323624,323626,323628,2,4,0
92476,6,1,323630,323630,323631,0,1,2
92477,1,1,323631,323631,323632,0,1,0
92478,5,1,323636,323636,323637,0,1,4
92479,3,3,323639,323639,323642,0,3,2
92480,1,1,323640,323642,323643,2,3,0
92481,5,3,323645,323645,323648,0,3,2
92482,4,3,323649,323649,323652,0,3,1
92483,4,1,323653,323653,323654,0,1,1
92484,5,2,323658,323658,323660,0,2,4
92485,4,3,323662,323662,323665,0,3,2
92486,3,1,323665,323665,323666,0,1,0
92487,2,2,323667,323667,323669,0,2,1
92488,6,3,323673,323673,323676,0,3,4
92489,1,1,323674,323676,323677,2,3,0
92490,1,1,323675,323677,323678,2,3,0
92491,4,3,323679,323679,323682,0,3,1
92492,4,2,323683,323683,323685,0,2,1
92493,4,1,323687,323687,323688,0,1,2
92494,3,3,323690,323690,323693,0,3,2
92495,5,3,323695,323695,323698,0,3,2
92496,2,3,323697,323698,323701,1,4,0
92497,6,1,323703,323703,323704,0,1,2
92498,6,1,323709,323709,323710,0,1,5
92499,6,2,323715,323715,323717,0,2,5
92500,5,3,323720,323720,323723,0,3,3
92501,5,2,323725,323725,323727,0,2,2
92502,2,3,323727,323727,323730,0,3,0
92503,2,1,323729,323730,323731,1,2,0
92504,5,1,323734,323734,323735,0,1,3
92505,3,2,323737,323737,323739,0,2,2
92506,2,1,323739,323739,323740,0,1,0
92507,1,1,323740,323740,323741,0,1,0
92508,4,1,323744,323744,323745,0,1,3
92509,5,1,323749,323749,323750,0,1,4
92510,5,3,323754,323754,323757,0,3,4
92511,2,2,323756,323757,323759,1,3,0
92512,4,2,323760,323760,323762,0,2,1
92513,4,2,323764,323764,323766,0,2,2
92514,1,1,323765,323766,323767,1,2,0
92515,4,2,323769,323769,323771,0,2,2
92516,2,3,323771,323771,323774,0,3,0
92517,4,2,323775,323775,323777,0,2,1
92518,3,3,323778,323778,323781,0,3,1
92519,4,2,323782,323782,323784,0,2,1
92520,2,2,323784,323784,323786,0,2,0
92521,2,1,323786,323786,323787,0,1,0
92522,2,3,323788,323788,323791,0,3,1
92523,2,1,323790,323791,323792,1,2,0
92524,2,2,323792,323792,323794,0,2,0
92525,4,3,323796,323796,323799,0,3,2
92526,2,3,323798,323799,323802,1,4,0
92527,4,3,323802,323802,323805,0,3,0
92528,4,2,323806,323806,323808,0,2,1
92529,5,2,323811,323811,323813,0,2,3
92530,4,2,323815,323815,323817,0,2,2
92531,5,3,323820,323820,323823,0,3,3
92532,2,3,323822,323823,323826,1,4,0
92533,6,3,323828,323828,323831,0,3,2
92534,5,2,323833,323833,323835,0,2,2
92535,4,1,323837,323837,323838,0,1,2
92536,1,1,323838,323838,323839,0,1,0
92537,6,3,323844,323844,323847,0,3,5
92538,6,3,323850,323850,323853,0,3,3
92539,4,3,323854,323854,323857,0,3,1
92540,5,2,323859,323859,323861,0,2,2
92541,4,1,323863,323863,323864,0,1,2
92542,5,3,323868,323868,323871,0,3,4
92543,6,1,323874,323874,323875,0,1,3
92544,4,3,323878,323878,323881,0,3,3
92545,3,3,323881,323881,323884,0,3,0
92546,5,1,323886,323886,323887,0,1,2
92547,4,3,323890,323890,323893,0,3,3
92548,1,3,323891,323893,323896,2,5,0
92549,6,1,323897,323897,323898,0,1,1
92550,2,1,323899,323899,323900,0,1,1
92551,2,3,323901,323901,323904,0,3,1
92552,2,3,323903,323904,323907,1,4,0
92553,5,2,323908,323908,323910,0,2,1
92554,2,3,323910,323910,323913,0,3,0
92555,6,1,323916,323916,323917,0,1,3
92556,3,3,323919,323919,323922,0,3,2
92557,2,1,323921,323922,323923,1,2,0
92558,1,2,323922,323923,323925,1,3,0
92559,4,1,323926,323926,323927,0,1,1
92560,5,3,323931,323931,323934,0,3,4
92561,1,2,323932,323934,323936,2,4,0
92562,3,1,323935,323936,323937,1,2,0
92563,1,3,323936,323937,323940,1,4,0
92564,5,3,323941,323941,323944,0,3,1
92565,6,2,323947,323947,323949,0,2,3
92566,3,3,323950,323950,323953,0,3,1
92567,4,3,323954,323954,323957,0,3,1
92568,2,1,323956,323957,323958,1,2,0
92569,4,1,323960,323960,323961,0,1,2
92570,4,2,323964,323964,323966,0,2,3
92571,3,1,323967,323967,323968,0,1,1
92572,1,2,323968,323968,323970,0,2,0
92573,3,3,323971,323971,323974,0,3,1
92574,2,2,323973,323974,323976,1,3,0
92575,3,2,323976,323976,323978,0,2,0
92576,2,3,323978,323978,323981,0,3,0
92577,6,1,323984,323984,323985,0,1,3
92578,4,3,323988,323988,323991,0,3,3
92579,4,1,323992,323992,323993,0,1,1
92580,6,2,323998,323998,324000,0,2,5
92581,4,1,324002,324002,324003,0,1,2
92582,4,2,324006,324006,324008,0,2,3
92583,3,1,324009,324009,324010,0,1,1
92584,4,3,324013,324013,324016,0,3,3
92585,6,3,324019,324019,324022,0,3,3
92586,3,1,324022,324022,324023,0,1,0
92587,5,3,324027,324027,324030,0,3,4
92588,5,1,324032,324032,324033,0,1,2
92589,1,1,324033,324033,324034,0,1,0
92590,3,3,324036,324036,324039,0,3,2
92591,3,3,324039,324039,324042,0,3,0
92592,6,3,324045,324045,324048,0,3,3
92593,5,1,324050,324050,324051,0,1,2
92594,2,2,324052,324052,324054,0,2,1
92595,4,2,324056,324056,324058,0,2,2
92596,4,3,324060,324060,324063,0,3,2
92597,1,2,324061,324063,324065,2,4,0
92598,5,1,324066,324066,324067,0,1,1
92599,2,2,324068,324068,324070,0,2,1
92600,3,3,324071,324071,324074,0,3,1
92601,6,1,324077,324077,324078,0,1,3
92602,3,2,324080,324080,324082,0,2,2
92603,4,1,324084,324084,324085,0,1,2
92604,1,2,324085,324085,324087,0,2,0
92605,5,2,324090,324090,324092,0,2,3
92606,3,1,324093,324093,324094,0,1,1
92607,4,3,324097,324097,324100,0,3,3
92608,1,2,324098,324100,324102,2,4,0
92609,1,1,324099,324102,324103,3,4,0
92610,4,2,324103,324103,324105,0,2,0
92611,1,2,324104,324105,324107,1,3,0
92612,2,1,324106,324107,324108,1,2,0
92613,2,2,324108,324108,324110,0,2,0
92614,5,2,324113,324113,324115,0,2,3
92615,2,3,324115,324115,324118,0,3,0
92616,3,2,324118,324118,324120,0,2,0
92617,3,3,324121,324121,324124,0,3,1
92618,2,3,324123,324124,324127,1,4,0
92619,3,3,324126,324127,324130,1,4,0
92620,2,2,324128,324130,324132,2,4,0
92621,6,2,324134,324134,324136,0,2,2
92622,2,1,324136,324136,324137,0,1,0
92623,3,3,324139,324139,324142,0,3,2
92624,6,2,324145,324145,324147,0,2,3
92625,4,3,324149,324149,324152,0,3,2
92626,5,1,324154,324154,324155,0,1,2
92627,1,2,324155,324155,324157,0,2,0
92628,4,1,324159,324159,324160,0,1,2
92629,2,2,324161,324161,324163,0,2,1
92630,4,1,324165,324165,324166,0,1,2
92631,5,2,324170,324170,324172,0,2,4
92632,1,1,324171,324172,324173,1,2,0
92633,1,1,324172,324173,324174,1,2,0
92634,1,1,324173,324174,324175,1,2,0
92635,5,1,324178,324178,324179,0,1,3
92636,6,1,324184,324184,324185,0,1,5
92637,4,1,324188,324188,324189,0,1,3
92638,2,1,324190,324190,324191,0,1,1
92639,3,1,324193,324193,324194,0,1,2
92640,5,1,324198,324198,324199,0,1,4
92641,1,3,324199,324199,324202,0,3,0
92642,5,2,324204,324204,324206,0,2,2
92643,2,3,324206,324206,324209,0,3,0
92644,4,3,324210,324210,324213,0,3,1
92645,2,3,324212,324213,324216,1,4,0
92646,3,3,324215,324216,324219,1,4,0
92647,6,1,324221,324221,324222,0,1,2
92648,4,3,324225,324225,324228,0,3,3
92649,5,2,324230,324230,324232,0,2,2
92650,3,1,324233,324233,324234,0,1,1
92651,3,3,324236,324236,324239,0,3,2
92652,3,3,324239,324239,324242,0,3,0
92653,2,2,324241,324242,324244,1,3,0
92654,1,2,324242,324244,324246,2,4,0
92655,1,1,324243,324246,324247,3,4,0
92656,6,1,324249,324249,324250,0,1,2
92657,3,2,324252,324252,324254,0,2,2
92658,5,1,324257,324257,324258,0,1,3
92659,4,3,324261,324261,324264,0,3,3
92660,6,2,324267,324267,324269,0,2,3
92661,2,3,324269,324269,324272,0,3,0
92662,6,1,324275,324275,324276,0,1,3
92663,5,1,324280,324280,324281,0,1,4
92664,1,1,324281,324281,324282,0,1,0
92665,5,1,324286,324286,324287,0,1,4
92666,4,1,324290,324290,324291,0,1,3
92667,2,3,324292,324292,324295,0,3,1
92668,2,1,324294,324295,324296,1,2,0
92669,3,2,324297,324297,324299,0,2,1
92670,1,1,324298,324299,324300,1,2,0
92671,5,2,324303,324303,324305,0,2,3
92672,5,3,324308,324308,324311,0,3,3
92673,1,2,324309,324311,324313,2,4,0
92674,2,3,324311,324313,324316,2,5,0
92675,5,1,324316,324316,324317,0,1,0
92676,2,3,324318,324318,324321,0,3,1
92677,4,3,324322,324322,324325,0,3,1
92678,1,1,324323,324325,324326,2,3,0
92679,6,3,324329,324329,324332,0,3,3
92680,5,3,324334,324334,324337,0,3,2
92681,6,3,324340,324340,324343,0,3,3
92682,6,2,324346,324346,324348,0,2,3
92683,6,1,324352,324352,324353,0,1,4
92684,6,2,324358,324358,324360,0,2,5
92685,6,3,324364,324364,324367,0,3,4
92686,6,1,324370,324370,324371,0,1,3
92687,6,2,324376,324376,324378,0,2,5
92688,6,3,324382,324382,324385,0,3,4
92689,1,3,324383,324385,324388,2,5,0
92690,6,1,324389,324389,324390,0,1,1
92691,3,3,324392,324392,324395,0,3,2
92692,5,3,324397,324397,324400,0,3,2
92693,4,3,324401,324401,324404,0,3,1
92694,6,3,324407,324407,324410,0,3,3
92695,1,2,324408,324410,324412,2,4,0
92696,5,3,324413,324413,324416,0,3,1
92697,4,3,324417,324417,324420,0,3,1
92698,1,1,324418,324420,324421,2,3,0
92699,5,3,324423,324423,324426,0,3,2
92700,6,3,324429,324429,324432,0,3,3
92701,1,2,324430,324432,324434,2,4,0
92702,1,3,324431,324434,324437,3,6,0
92703,5,2,324436,324437,324439,1,3,0
92704,2,1,324438,324439,324440,1,2,0
92705,4,1,324442,324442,324443,0,1,2
92706,3,1,324445,324445,324446,0,1,2
92707,6,2,324451,324451,324453,0,2,5
92708,1,2,324452,324453,324455,1,3,0
92709,6,1,324458,324458,324459,0,1,3
92710,2,1,324460,324460,324461,0,1,1
92711,3,3,324463,324463,324466,0,3,2
92712,1,2,324464,324466,324468,2,4,0
92713,3,2,324467,324468,324470,1,3,0
92714,6,2,324473,324473,324475,0,2,3
92715,6,2,324479,324479,324481,0,2,4
92716,5,3,324484,324484,324487,0,3,3
92717,4,2,324488,324488,324490,0,2,1
92718,2,1,324490,324490,324491,0,1,0
92719,3,1,324493,324493,324494,0,1,2
92720,1,2,324494,324494,324496,0,2,0
92721,6,1,324500,324500,324501,0,1,4
92722,1,2,324501,324501,324503,0,2,0
92723,3,3,324504,324504,324507,0,3,1
92724,2,2,324506,324507,324509,1,3,0
92725,3,1,324509,324509,324510,0,1,0
92726,3,1,324512,324512,324513,0,1,2
92727,6,3,324518,324518,324521,0,3,5
92728,5,3,324523,324523,324526,0,3,2
92729,1,3,324524,324526,324529,2,5,0
92730,3,3,324527,324529,324532,2,5,0
92731,1,1,324528,324532,324533,4,5,0
92732,2,3,324530,324533,324536,3,6,0
92733,5,1,324535,324536,324537,1,2,0
92734,2,3,324537,324537,324540,0,3,0
92735,4,3,324541,324541,324544,0,3,1
92736,2,1,324543,324544,324545,1,2,0
92737,3,2,324546,324546,324548,0,2,1
92738,2,1,324548,324548,324549,0,1,0
92739,2,3,324550,324550,324553,0,3,1
92740,4,3,324554,324554,324557,0,3,1
92741,2,1,324556,324557,324558,1,2,0
92742,4,1,324560,324560,324561,0,1,2
92743,5,3,324565,324565,324568,0,3,4
92744,2,1,324567,324568,324569,1,2,0
92745,6,1,324573,324573,324574,0,1,4
92746,3,3,324576,324576,324579,0,3,2
92747,6,3,324582,324582,324585,0,3,3
92748,4,2,324586,324586,324588,0,2,1
92749,5,1,324591,324591,324592,0,1,3
92750,1,2,324592,324592,324594,0,2,0
92751,1,3,324593,324594,324597,1,4,0
92752,1,2,324594,324597,324599,3,5,0
92753,2,1,324596,324599,324600,3,4,0
92754,5,3,324601,324601,324604,0,3,1
92755,3,1,324604,324604,324605,0,1,0
92756,5,3,324609,324609,324612,0,3,4
92757,5,3,324614,324614,324617,0,3,2
92758,2,3,324616,324617,324620,1,4,0
92759,1,3,324617,324620,324623,3,6,0
92760,3,1,324620,324623,324624,3,4,0
92761,6,1,324626,324626,324627,0,1,2
92762,4,2,324630,324630,324632,0,2,3
92763,4,2,324634,324634,324636,0,2,2
92764,5,2,324639,324639,324641,0,2,3
92765,4,2,324643,324643,324645,0,2,2
92766,4,2,324647,324647,324649,0,2,2
92767,1,3,324648,324649,324652,1,4,0
92768,3,1,324651,324652,324653,1,2,0
92769,3,2,324654,324654,324656,0,2,1
92770,1,3,324655,324656,324659,1,4,0
92771,1,3,324656,324659,324662,3,6,0
92772,4,2,324660,324662,324664,2,4,0
92773,4,1,324664,324664,324665,0,1,0
92774,4,2,324668,324668,324670,0,2,3
92775,2,2,324670,324670,324672,0,2,0
92776,2,3,324672,324672,324675,0,3,0
92777,5,2,324677,324677,324679,0,2,2
92778,6,3,324683,324683,324686,0,3,4
92779,6,3,324689,324689,324692,0,3,3
92780,5,3,324694,324694,324697,0,3,2
92781,1,1,324695,324697,324698,2,3,0
92782,5,3,324700,324700,324703,0,3,2
92783,6,1,324706,324706,324707,0,1,3
92784,4,3,324710,324710,324713,0,3,3
92785,3,1,324713,324713,324714,0,1,0
92786,6,3,324719,324719,324722,0,3,5
92787,3,1,324722,324722,324723,0,1,0
92788,3,1,324725,324725,324726,0,1,2
92789,2,2,324727,324727,324729,0,2,1
92790,3,1,324730,324730,324731,0,1,1
92791,5,3,324735,324735,324738,0,3,4
92792,4,3,324739,324739,324742,0,3,1
92793,3,3,324742,324742,324745,0,3,0
92794,5,1,324747,324747,324748,0,1,2
92795,2,2,324749,324749,324751,0,2,1
92796,5,1,324754,324754,324755,0,1,3
92797,3,3,324757,324757,324760,0,3,2
92798,1,1,324758,324760,324761,2,3,0
92799,1,3,324759,324761,324764,2,5,0
92800,5,2,324764,324764,324766,0,2,0
92801,5,2,324769,324769,324771,0,2,3
92802,5,2,324774,324774,324776,0,2,3
92803,2,3,324776,324776,324779,0,3,0
92804,3,2,324779,324779,324781,0,2,0
92805,2,3,324781,324781,324784,0,3,0
92806,6,1,324787,324787,324788,0,1,3
92807,2,1,324789,324789,324790,0,1,1
92808,2,1,324791,324791,324792,0,1,1
92809,3,2,324794,324794,324796,0,2,2
92810,6,2,324800,324800,324802,0,2,4
92811,5,3,324805,324805,324808,0,3,3
92812,2,2,324807,324808,324810,1,3,0
92813,4,3,324811,324811,324814,0,3,1
92814,3,1,324814,324814,324815,0,1,0
92815,1,1,324815,324815,324816,0,1,0
92816,2,3,324817,324817,324820,0,3,1
92817,2,1,324819,324820,324821,1,2,0
92818,4,2,324823,324823,324825,0,2,2
92819,6,1,324829,324829,324830,0,1,4
92820,3,3,324832,324832,324835,0,3,2
92821,1,2,324833,324835,324837,2,4,0
92822,2,2,324835,324837,324839,2,4,0
92823,6,3,324841,324841,324844,0,3,2
92824,4,1,324845,324845,324846,0,1,1
92825,2,3,324847,324847,324850,0,3,1
92826,3,1,324850,324850,324851,0,1,0
92827,4,2,324854,324854,324856,0,2,3
92828,6,2,324860,324860,324862,0,2,4
92829,1,3,324861,324862,324865,1,4,0
92830,5,1,324866,324866,324867,0,1,1
92831,1,3,324867,324867,324870,0,3,0
92832,2,1,324869,324870,324871,1,2,0
92833,6,2,324875,324875,324877,0,2,4
92834,3,3,324878,324878,324881,0,3,1
92835,1,2,324879,324881,324883,2,4,0
92836,3,2,324882,324883,324885,1,3,0
92837,4,2,324886,324886,324888,0,2,1
92838,3,2,324889,324889,324891,0,2,1
92839,3,2,324892,324892,324894,0,2,1
92840,2,1,324894,324894,324895,0,1,0
92841,5,3,324899,324899,324902,0,3,4
92842,1,1,324900,324902,324903,2,3,0
92843,3,2,324903,324903,324905,0,2,0
92844,1,3,324904,324905,324908,1,4,0
92845,5,3,324909,324909,324912,0,3,1
92846,5,3,324914,324914,324917,0,3,2
92847,2,2,324916,324917,324919,1,3,0
92848,6,1,324922,324922,324923,0,1,3
92849,2,1,324924,324924,324925,0,1,1
92850,1,3,324925,324925,324928,0,3,0
92851,1,1,324926,324928,324929,2,3,0
92852,5,2,324931,324931,324933,0,2,2
92853,5,2,324936,324936,324938,0,2,3
92854,1,2,324937,324938,324940,1,3,0
92855,4,3,324941,324941,324944,0,3,1
92856,1,3,324942,324944,324947,2,5,0
92857,6,1,324948,324948,324949,0,1,1
92858,3,3,324951,324951,324954,0,3,2
92859,6,3,324957,324957,324960,0,3,3
92860,1,1,324958,324960,324961,2,3,0
92861,3,2,324961,324961,324963,0,2,0
92862,6,1,324967,324967,324968,0,1,4
92863,4,2,324971,324971,324973,0,2,3
92864,1,1,324972,324973,324974,1,2,0
92865,5,1,324977,324977,324978,0,1,3
92866,3,2,324980,324980,324982,0,2,2
92867,3,3,324983,324983,324986,0,3,1
92868,6,2,324989,324989,324991,0,2,3
92869,5,1,324994,324994,324995,0,1,3
92870,6,2,325000,325000,325002,0,2,5
92871,2,2,325002,325002,325004,0,2,0
92872,2,1,325004,325004,325005,0,1,0
92873,4,2,325008,325008,325010,0,2,3
92874,5,2,325013,325013,325015,0,2,3
92875,5,2,325018,325018,325020,0,2,3
92876,5,2,325023,325023,325025,0,2,3
92877,5,3,325028,325028,325031,0,3,3
92878,5,1,325033,325033,325034,0,1,2
92879,4,2,325037,325037,325039,0,2,3
92880,3,1,325040,325040,325041,0,1,1
92881,3,1,325043,325043,325044,0,1,2
92882,2,2,325045,325045,325047,0,2,1
92883,4,2,325049,325049,325051,0,2,2
92884,2,2,325051,325051,325053,0,2,0
92885,3,3,325054,325054,325057,0,3,1
92886,5,1,325059,325059,325060,0,1,2
92887,6,3,325065,325065,325068,0,3,5
92888,5,3,325070,325070,325073,0,3,2
92889,4,1,325074,325074,325075,0,1,1
92890,2,2,325076,325076,325078,0,2,1
92891,2,3,325078,325078,325081,0,3,0
92892,1,3,325079,325081,325084,2,5,0
92893,5,3,325084,325084,325087,0,3,0
92894,4,1,325088,325088,325089,0,1,1
92895,5,2,325093,325093,325095,0,2,4
92896,4,1,325097,325097,325098,0,1,2
92897,2,3,325099,325099,325102,0,3,1
92898,3,1,325102,325102,325103,0,1,0
92899,3,1,325105,325105,325106,0,1,2
92900,5,2,325110,325110,325112,0,2,4
92901,3,3,325113,325113,325116,0,3,1
92902,1,3,325114,325116,325119,2,5,0
92903,6,3,325120,325120,325123,0,3,1
92904,4,1,325124,325124,325125,0,1,1
92905,2,2,325126,325126,325128,0,2,1
92906,6,3,325132,325132,325135,0,3,4
92907,1,3,325133,325135,325138,2,5,0
92908,1,3,325134,325138,325141,4,7,0
92909,6,2,325140,325141,325143,1,3,0
92910,1,1,325141,325143,325144,2,3,0
92911,5,3,325146,325146,325149,0,3,2
92912,1,3,325147,325149,325152,2,5,0
92913,2,2,325149,325152,325154,3,5,0
92914,4,2,325153,325154,325156,1,3,0
92915,2,1,325155,325156,325157,1,2,0
92916,5,3,325160,325160,325163,0,3,3
92917,1,3,325161,325163,325166,2,5,0
92918,5,3,325166,325166,325169,0,3,0
92919,5,3,325171,325171,325174,0,3,2
92920,4,3,325175,325175,325178,0,3,1
92921,6,2,325181,325181,325183,0,2,3
92922,2,3,325183,325183,325186,0,3,0
92923,5,2,325188,325188,325190,0,2,2
92924,2,1,325190,325190,325191,0,1,0
92925,1,1,325191,325191,325192,0,1,0
92926,3,3,325194,325194,325197,0,3,2
92927,2,2,325196,325197,325199,1,3,0
92928,4,3,325200,325200,325203,0,3,1
92929,2,3,325202,325203,325206,1,4,0
92930,2,3,325204,325206,325209,2,5,0
92931,1,1,325205,325209,325210,4,5,0
92932,5,2,325210,325210,325212,0,2,0
92933,6,1,325216,325216,325217,0,1,4
92934,4,1,325220,325220,325221,0,1,3
92935,2,3,325222,325222,325225,0,3,1
92936,1,1,325223,325225,325226,2,3,0
92937,1,2,325224,325226,325228,2,4,0
92938,5,1,325229,325229,325230,0,1,1
92939,1,1,325230,325230,325231,0,1,0
92940,3,2,325233,325233,325235,0,2,2
92941,6,1,325239,325239,325240,0,1,4
92942,6,1,325245,325245,325246,0,1,5
92943,4,3,325249,325249,325252,0,3,3
92944,2,3,325251,325252,325255,1,4,0
92945,6,2,325257,325257,325259,0,2,2
92946,3,2,325260,325260,325262,0,2,1
92947,3,3,325263,325263,325266,0,3,1
92948,5,2,325268,325268,325270,0,2,2
92949,3,3,325271,325271,325274,0,3,1
92950,4,1,325275,325275,325276,0,1,1
92951,3,1,325278,325278,325279,0,1,2
92952,6,1,325284,325284,325285,0,1,5
92953,1,1,325285,325285,325286,0,1,0
92954,3,2,325288,325288,325290,0,2,2
92955,2,1,325290,325290,325291,0,1,0
92956,1,2,325291,325291,325293,0,2,0
92957,2,1,325293,325293,325294,0,1,0
92958,5,1,325298,325298,325299,0,1,4
92959,6,1,325304,325304,325305,0,1,5
92960,2,2,325306,325306,325308,0,2,1
92961,5,3,325311,325311,325314,0,3,3
92962,3,2,325314,325314,325316,0,2,0
92963,3,1,325317,325317,325318,0,1,1
92964,4,3,325321,325321,325324,0,3,3
92965,5,1,325326,325326,325327,0,1,2
92966,3,2,325329,325329,325331,0,2,2
92967,5,1,325334,325334,325335,0,1,3
92968,1,1,325335,325335,325336,0,1,0
92969,4,2,325339,325339,325341,0,2,3
92970,2,1,325341,325341,325342,0,1,0
92971,5,2,325346,325346,325348,0,2,4
92972,6,1,325352,325352,325353,0,1,4
92973,6,3,325358,325358,325361,0,3,5
92974,1,3,325359,325361,325364,2,5,0
92975,5,2,325364,325364,325366,0,2,0
92976,4,2,325368,325368,325370,0,2,2
92977,2,3,325370,325370,325373,0,3,0
92978,3,2,325373,325373,325375,0,2,0
92979,4,2,325377,325377,325379,0,2,2
92980,4,2,325381,325381,325383,0,2,2
92981,4,3,325385,325385,325388,0,3,2
92982,5,2,325390,325390,325392,0,2,2
92983,5,1,325395,325395,325396,0,1,3
92984,2,2,325397,325397,325399,0,2,1
92985,5,1,325402,325402,325403,0,1,3
92986,4,3,325406,325406,325409,0,3,3
92987,1,1,325407,325409,325410,2,3,0
92988,2,2,325409,325410,325412,1,3,0
92989,2,1,325411,325412,325413,1,2,0
92990,2,1,325413,325413,325414,0,1,0
92991,1,3,325414,325414,325417,0,3,0
92992,6,2,325420,325420,325422,0,2,3
92993,6,3,325426,325426,325429,0,3,4
92994,6,1,325432,325432,325433,0,1,3
92995,6,1,325438,325438,325439,0,1,5
92996,5,2,325443,325443,325445,0,2,4
92997,2,2,325445,325445,325447,0,2,0
92998,1,1,325446,325447,325448,1,2,0
92999,5,1,325451,325451,325452,0,1,3
93000,5,3,325456,325456,325459,0,3,4
93001,4,2,325460,325460,325462,0,2,1
93002,5,3,325465,325465,325468,0,3,3
93003,4,3,325469,325469,325472,0,3,1
93004,3,1,325472,325472,325473,0,1,0
93005,5,3,325477,325477,325480,0,3,4
93006,3,3,325480,325480,325483,0,3,0
93007,4,2,325484,325484,325486,0,2,1
93008,4,3,325488,325488,325491,0,3,2
93009,4,1,325492,325492,325493,0,1,1
93010,4,1,325496,325496,325497,0,1,3
93011,3,2,325499,325499,325501,0,2,2
93012,4,1,325503,325503,325504,0,1,2
93013,3,1,325506,325506,325507,0,1,2
93014,6,2,325512,325512,325514,0,2,5
93015,6,3,325518,325518,325521,0,3,4
93016,2,1,325520,325521,325522,1,2,0
93017,2,3,325522,325522,325525,0,3,0
93018,5,3,325527,325527,325530,0,3,2
93019,6,2,325533,325533,325535,0,2,3
93020,3,2,325536,325536,325538,0,2,1
93021,3,1,325539,325539,325540,0,1,1
93022,2,1,325541,325541,325542,0,1,1
93023,3,3,325544,325544,325547,0,3,2
93024,3,3,325547,325547,325550,0,3,0
93025,4,1,325551,325551,325552,0,1,1
93026,6,1,325557,325557,325558,0,1,5
93027,1,3,325558,325558,325561,0,3,0
93028,5,3,325563,325563,325566,0,3,2
93029,3,2,325566,325566,325568,0,2,0
93030,6,2,325572,325572,325574,0,2,4
93031,6,1,325578,325578,325579,0,1,4
93032,1,1,325579,325579,325580,0,1,0
93033,3,1,325582,325582,325583,0,1,2
93034,4,2,325586,325586,325588,0,2,3
93035,3,2,325589,325589,325591,0,2,1
93036,4,3,325593,325593,325596,0,3,2
93037,1,1,325594,325596,325597,2,3,0
93038,6,1,325600,325600,325601,0,1,3
93039,6,3,325606,325606,325609,0,3,5
93040,5,1,325611,325611,325612,0,1,2
93041,5,2,325616,325616,325618,0,2,4
93042,1,3,325617,325618,325621,1,4,0
93043,4,2,325621,325621,325623,0,2,0
93044,5,3,325626,325626,325629,0,3,3
93045,6,1,325632,325632,325633,0,1,3
93046,3,1,325635,325635,325636,0,1,2
93047,1,2,325636,325636,325638,0,2,0
93048,2,1,325638,325638,325639,0,1,0
93049,5,3,325643,325643,325646,0,3,4
93050,6,3,325649,325649,325652,0,3,3
93051,5,3,325654,325654,325657,0,3,2
93052,1,1,325655,325657,325658,2,3,0
93053,4,2,325659,325659,325661,0,2,1
93054,6,2,325665,325665,325667,0,2,4
93055,2,2,325667,325667,325669,0,2,0
93056,2,1,325669,325669,325670,0,1,0
93057,4,3,325673,325673,325676,0,3,3
93058,1,1,325674,325676,325677,2,3,0
93059,3,3,325677,325677,325680,0,3,0
93060,2,3,325679,325680,325683,1,4,0
93061,6,1,325685,325685,325686,0,1,2
93062,3,1,325688,325688,325689,0,1,2
93063,1,3,325689,325689,325692,0,3,0
93064,2,2,325691,325692,325694,1,3,0
93065,2,3,325693,325694,325697,1,4,0
93066,5,3,325698,325698,325701,0,3,1
93067,5,2,325703,325703,325705,0,2,2
93068,4,2,325707,325707,325709,0,2,2
93069,1,2,325708,325709,325711,1,3,0
93070,2,1,325710,325711,325712,1,2,0
93071,6,2,325716,325716,325718,0,2,4
93072,4,3,325720,325720,325723,0,3,2
93073,6,3,325726,325726,325729,0,3,3
93074,5,3,325731,325731,325734,0,3,2
93075,5,3,325736,325736,325739,0,3,2
93076,6,1,325742,325742,325743,0,1,3
93077,3,3,325745,325745,325748,0,3,2
93078,4,2,325749,325749,325751,0,2,1
93079,1,2,325750,325751,325753,1,3,0
93080,3,2,325753,325753,325755,0,2,0
93081,1,2,325754,325755,325757,1,3,0
93082,3,3,325757,325757,325760,0,3,0
93083,5,3,325762,325762,325765,0,3,2
93084,5,3,325767,325767,325770,0,3,2
93085,4,2,325771,325771,325773,0,2,1
93086,3,3,325774,325774,325777,0,3,1
93087,1,2,325775,325777,325779,2,4,0
93088,6,1,325781,325781,325782,0,1,2
93089,2,2,325783,325783,325785,0,2,1
93090,6,3,325789,325789,325792,0,3,4
93091,1,1,325790,325792,325793,2,3,0
93092,3,2,325793,325793,325795,0,2,0
93093,1,2,325794,325795,325797,1,3,0
93094,6,3,325800,325800,325803,0,3,3
93095,4,2,325804,325804,325806,0,2,1
93096,5,2,325809,325809,325811,0,2,3
93097,2,2,325811,325811,325813,0,2,0
93098,2,1,325813,325813,325814,0,1,0
93099,4,1,325817,325817,325818,0,1,3
93100,4,3,325821,325821,325824,0,3,3
93101,3,1,325824,325824,325825,0,1,0
93102,5,2,325829,325829,325831,0,2,4
93103,2,2,325831,325831,325833,0,2,0
93104,5,1,325836,325836,325837,0,1,3
93105,2,2,325838,325838,325840,0,2,1
93106,5,1,325843,325843,325844,0,1,3
93107,1,2,325844,325844,325846,0,2,0
93108,1,1,325845,325846,325847,1,2,0
93109,4,3,325849,325849,325852,0,3,2
93110,5,1,325854,325854,325855,0,1,2
93111,2,3,325856,325856,325859,0,3,1
93112,5,2,325861,325861,325863,0,2,2
93113,6,2,325867,325867,325869,0,2,4
93114,4,1,325871,325871,325872,0,1,2
93115,2,2,325873,325873,325875,0,2,1
93116,3,1,325876,325876,325877,0,1,1
93117,3,1,325879,325879,325880,0,1,2
93118,1,2,325880,325880,325882,0,2,0
93119,1,3,325881,325882,325885,1,4,0
93120,2,3,325883,325885,325888,2,5,0
93121,3,3,325886,325888,325891,2,5,0
93122,4,1,325890,325891,325892,1,2,0
93123,6,2,325896,325896,325898,0,2,4
93124,2,1,325898,325898,325899,0,1,0
93125,5,3,325903,325903,325906,0,3,4
93126,3,1,325906,325906,325907,0,1,0
93127,5,3,325911,325911,325914,0,3,4
93128,6,1,325917,325917,325918,0,1,3
93129,5,3,325922,325922,325925,0,3,4
93130,2,2,325924,325925,325927,1,3,0
93131,1,3,325925,325927,325930,2,5,0
93132,1,1,325926,325930,325931,4,5,0
93133,4,1,325930,325931,325932,1,2,0
93134,1,2,325931,325932,325934,1,3,0
93135,3,2,325934,325934,325936,0,2,0
93136,1,3,325935,325936,325939,1,4,0
93137,6,2,325941,325941,325943,0,2,2
93138,1,1,325942,325943,325944,1,2,0
93139,6,2,325948,325948,325950,0,2,4
93140,5,3,325953,325953,325956,0,3,3
93141,5,1,325958,325958,325959,0,1,2
93142,3,2,325961,325961,325963,0,2,2
93143,5,1,325966,325966,325967,0,1,3
93144,4,1,325970,325970,325971,0,1,3
93145,4,3,325974,325974,325977,0,3,3
93146,2,2,325976,325977,325979,1,3,0
93147,1,3,325977,325979,325982,2,5,0
93148,6,2,325983,325983,325985,0,2,1
93149,1,3,325984,325985,325988,1,4,0
93150,1,3,325985,325988,325991,3,6,0
93151,1,2,325986,325991,325993,5,7,0
93152,5,3,325991,325993,325996,2,5,0
93153,6,3,325997,325997,326000,0,3,1
93154,5,1,326002,326002,326003,0,1,2
93155,3,3,326005,326005,326008,0,3,2
93156,4,1,326009,326009,326010,0,1,1
93157,4,1,326013,326013,326014,0,1,3
93158,3,2,326016,326016,326018,0,2,2
93159,5,1,326021,326021,326022,0,1,3
93160,1,1,326022,326022,326023,0,1,0
93161,1,2,326023,326023,326025,0,2,0
93162,1,3,326024,326025,326028,1,4,0
93163,2,2,326026,326028,326030,2,4,0
93164,3,2,326029,326030,326032,1,3,0
93165,1,2,326030,326032,326034,2,4,0
93166,2,3,326032,326034,326037,2,5,0
93167,5,1,326037,326037,326038,0,1,0
93168,2,3,326039,326039,326042,0,3,1
93169,6,2,326045,326045,326047,0,2,3
93170,5,3,326050,326050,326053,0,3,3
93171,2,3,326052,326053,326056,1,4,0
93172,4,3,326056,326056,326059,0,3,0
93173,2,3,326058,326059,326062,1,4,0
93174,4,1,326062,326062,326063,0,1,0
93175,2,1,326064,326064,326065,0,1,1
93176,4,2,326068,326068,326070,0,2,3
93177,3,3,326071,326071,326074,0,3,1
93178,2,2,326073,326074,326076,1,3,0
93179,4,2,326077,326077,326079,0,2,1
93180,1,1,326078,326079,326080,1,2,0
93181,5,1,326083,326083,326084,0,1,3
93182,5,2,326088,326088,326090,0,2,4
93183,4,1,326092,326092,326093,0,1,2
93184,2,2,326094,326094,326096,0,2,1
93185,3,1,326097,326097,326098,0,1,1
93186,4,2,326101,326101,326103,0,2,3
93187,5,1,326106,326106,326107,0,1,3
93188,1,3,326107,326107,326110,0,3,0
93189,2,1,326109,326110,326111,1,2,0
93190,1,2,326110,326111,326113,1,3,0
93191,4,2,326114,326114,326116,0,2,1
93192,5,2,326119,326119,326121,0,2,3
93193,6,3,326125,326125,326128,0,3,4
93194,4,3,326129,326129,326132,0,3,1
93195,4,3,326133,326133,326136,0,3,1
93196,4,2,326137,326137,326139,0,2,1
93197,1,1,326138,326139,326140,1,2,0
93198,5,1,326143,326143,326144,0,1,3
93199,3,1,326146,326146,326147,0,1,2
93200,2,1,326148,326148,326149,0,1,1
93201,5,2,326153,326153,326155,0,2,4
93202,1,2,326154,326155,326157,1,3,0
93203,4,2,326158,326158,326160,0,2,1
93204,1,2,326159,326160,326162,1,3,0
93205,3,1,326162,326162,326163,0,1,0
93206,2,1,326164,326164,326165,0,1,1
93207,2,1,326166,326166,326167,0,1,1
93208,5,3,326171,326171,326174,0,3,4
93209,5,3,326176,326176,326179,0,3,2
93210,5,1,326181,326181,326182,0,1,2
93211,1,2,326182,326182,326184,0,2,0
93212,1,2,326183,326184,326186,1,3,0
93213,1,2,326184,326186,326188,2,4,0
93214,1,1,326185,326188,326189,3,4,0
93215,4,2,326189,326189,326191,0,2,0
93216,1,1,326190,326191,326192,1,2,0
93217,2,3,326192,326192,326195,0,3,0
93218,1,1,326193,326195,326196,2,3,0
93219,4,1,326197,326197,326198,0,1,1
93220,5,2,326202,326202,326204,0,2,4
93221,6,3,326208,326208,326211,0,3,4
93222,2,3,326210,326211,326214,1,4,0
93223,4,3,326214,326214,326217,0,3,0
93224,6,2,326220,326220,326222,0,2,3
93225,2,1,326222,326222,326223,0,1,0
93226,6,3,326228,326228,326231,0,3,5
93227,1,1,326229,326231,326232,2,3,0
93228,6,2,326235,326235,326237,0,2,3
93229,3,2,326238,326238,326240,0,2,1
93230,1,3,326239,326240,326243,1,4,0
93231,4,3,326243,326243,326246,0,3,0
93232,2,2,326245,326246,326248,1,3,0
93233,1,2,326246,326248,326250,2,4,0
93234,6,3,326252,326252,326255,0,3,2
93235,5,3,326257,326257,326260,0,3,2
93236,4,2,326261,326261,326263,0,2,1
93237,5,1,326266,326266,326267,0,1,3
93238,5,3,326271,326271,326274,0,3,4
93239,4,1,326275,326275,326276,0,1,1
93240,1,2,326276,326276,326278,0,2,0
93241,5,3,326281,326281,326284,0,3,3
93242,4,1,326285,326285,326286,0,1,1
93243,5,3,326290,326290,326293,0,3,4
93244,2,2,326292,326293,326295,1,3,0
93245,1,2,326293,326295,326297,2,4,0
93246,3,1,326296,326297,326298,1,2,0
93247,2,1,326298,326298,326299,0,1,0
93248,3,3,326301,326301,326304,0,3,2
93249,6,1,326307,326307,326308,0,1,3
93250,2,1,326309,326309,326310,0,1,1
93251,3,2,326312,326312,326314,0,2,2
93252,4,3,326316,326316,326319,0,3,2
93253,4,2,326320,326320,326322,0,2,1
93254,5,2,326325,326325,326327,0,2,3
93255,4,1,326329,326329,326330,0,1,2
93256,1,2,326330,326330,326332,0,2,0
93257,3,3,326333,326333,326336,0,3,1
93258,4,3,326337,326337,326340,0,3,1
93259,3,2,326340,326340,326342,0,2,0
93260,2,3,326342,326342,326345,0,3,0
93261,2,3,326344,326345,326348,1,4,0
93262,2,1,326346,326348,326349,2,3,0
93263,3,2,326349,326349,326351,0,2,0
93264,2,2,326351,326351,326353,0,2,0
93265,3,2,326354,326354,326356,0,2,1
93266,1,1,326355,326356,326357,1,2,0
93267,1,1,326356,326357,326358,1,2,0
93268,1,2,326357,326358,326360,1,3,0
93269,3,2,326360,326360,326362,0,2,0
93270,2,3,326362,326362,326365,0,3,0
93271,5,1,326367,326367,326368,0,1,2
93272,4,1,326371,326371,326372,0,1,3
93273,4,1,326375,326375,326376,0,1,3
93274,3,2,326378,326378,326380,0,2,2
93275,6,2,326384,326384,326386,0,2,4
93276,5,1,326389,326389,326390,0,1,3
93277,1,2,326390,326390,326392,0,2,0
93278,2,3,326392,326392,326395,0,3,0
93279,1,3,326393,326395,326398,2,5,0
93280,2,3,326395,326398,326401,3,6,0
93281,2,2,326397,326401,326403,4,6,0
93282,3,1,326400,326403,326404,3,4,0
93283,1,2,326401,326404,326406,3,5,0
93284,6,2,326407,326407,326409,0,2,1
93285,2,2,326409,326409,326411,0,2,0
93286,1,3,326410,326411,326414,1,4,0
93287,4,2,326414,326414,326416,0,2,0
93288,2,2,326416,326416,326418,0,2,0
93289,5,1,326421,326421,326422,0,1,3
93290,3,1,326424,326424,326425,0,1,2
93291,1,2,326425,326425,326427,0,2,0
93292,6,2,326431,326431,326433,0,2,4
93293,6,1,326437,326437,326438,0,1,4
93294,1,1,326438,326438,326439,0,1,0
93295,5,2,326443,326443,326445,0,2,4
93296,1,2,326444,326445,326447,1,3,0
93297,5,3,326449,326449,326452,0,3,2
93298,3,1,326452,326452,326453,0,1,0
93299,4,3,326456,326456,326459,0,3,3
93300,5,3,326461,326461,326464,0,3,2
93301,3,1,326464,326464,326465,0,1,0
93302,1,1,326465,326465,326466,0,1,0
93303,1,3,326466,326466,326469,0,3,0
93304,5,2,326471,326471,326473,0,2,2
93305,2,3,326473,326473,326476,0,3,0
93306,4,2,326477,326477,326479,0,2,1
93307,1,2,326478,326479,326481,1,3,0
93308,3,1,326481,326481,326482,0,1,0
93309,2,2,326483,326483,326485,0,2,1
93310,4,3,326487,326487,326490,0,3,2
93311,5,3,326492,326492,326495,0,3,2
93312,3,3,326495,326495,326498,0,3,0
93313,4,1,326499,326499,326500,0,1,1
93314,5,1,326504,326504,326505,0,1,4
93315,5,2,326509,326509,326511,0,2,4
93316,4,1,326513,326513,326514,0,1,2
93317,3,2,326516,326516,326518,0,2,2
93318,5,1,326521,326521,326522,0,1,3
93319,5,1,326526,326526,326527,0,1,4
93320,2,1,326528,326528,326529,0,1,1
93321,4,1,326532,326532,326533,0,1,3
93322,3,2,326535,326535,326537,0,2,2
93323,2,2,326537,326537,326539,0,2,0
93324,6,1,326543,326543,326544,0,1,4
93325,1,2,326544,326544,326546,0,2,0
93326,2,1,326546,326546,326547,0,1,0
93327,6,1,326552,326552,326553,0,1,5
93328,4,3,326556,326556,326559,0,3,3
93329,6,2,326562,326562,326564,0,2,3
93330,4,3,326566,326566,326569,0,3,2
93331,4,3,326570,326570,326573,0,3,1
93332,5,2,326575,326575,326577,0,2,2
93333,1,3,326576,326577,326580,1,4,0
93334,3,2,326579,326580,326582,1,3,0
93335,6,2,326585,326585,326587,0,2,3
93336,6,3,326591,326591,326594,0,3,4
93337,6,2,326597,326597,326599,0,2,3
93338,6,1,326603,326603,326604,0,1,4
93339,1,3,326604,326604,326607,0,3,0
93340,3,3,326607,326607,326610,0,3,0
93341,6,3,326613,326613,326616,0,3,3
93342,4,3,326617,326617,326620,0,3,1
93343,5,1,326622,326622,326623,0,1,2
93344,1,1,326623,326623,326624,0,1,0
93345,2,1,326625,326625,326626,0,1,1
93346,2,1,326627,326627,326628,0,1,1
93347,3,3,326630,326630,326633,0,3,2
93348,1,2,326631,326633,326635,2,4,0
93349,4,2,326635,326635,326637,0,2,0
93350,4,3,326639,326639,326642,0,3,2
93351,3,2,326642,326642,326644,0,2,0
93352,2,2,326644,326644,326646,0,2,0
93353,5,3,326649,326649,326652,0,3,3
93354,1,1,326650,326652,326653,2,3,0
93355,2,2,326652,326653,326655,1,3,0
93356,6,2,326658,326658,326660,0,2,3
93357,5,3,326663,326663,326666,0,3,3
93358,5,3,326668,326668,326671,0,3,2
93359,6,1,326674,326674,326675,0,1,3
93360,3,3,326677,326677,326680,0,3,2
93361,6,3,326683,326683,326686,0,3,3
93362,3,1,326686,326686,326687,0,1,0
93363,4,2,326690,326690,326692,0,2,3
93364,6,1,326696,326696,326697,0,1,4
93365,5,1,326701,326701,326702,0,1,4
93366,2,1,326703,326703,326704,0,1,1
93367,2,3,326705,326705,326708,0,3,1
93368,4,2,326709,326709,326711,0,2,1
93369,5,1,326714,326714,326715,0,1,3
93370,2,3,326716,326716,326719,0,3,1
93371,2,2,326718,326719,326721,1,3,0
93372,6,3,326724,326724,326727,0,3,3
93373,2,2,326726,326727,326729,1,3,0
93374,5,3,326731,326731,326734,0,3,2
93375,3,2,326734,326734,326736,0,2,0
93376,3,2,326737,326737,326739,0,2,1
93377,6,3,326743,326743,326746,0,3,4
93378,4,1,326747,326747,326748,0,1,1
93379,5,3,326752,326752,326755,0,3,4
93380,3,2,326755,326755,326757,0,2,0
93381,5,3,326760,326760,326763,0,3,3
93382,5,2,326765,326765,326767,0,2,2
93383,1,3,326766,326767,326770,1,4,0
93384,1,3,326767,326770,326773,3,6,0
93385,4,2,326771,326773,326775,2,4,0
93386,3,3,326774,326775,326778,1,4,0
93387,3,2,326777,326778,326780,1,3,0
93388,2,1,326779,326780,326781,1,2,0
93389,3,3,326782,326782,326785,0,3,1
93390,6,3,326788,326788,326791,0,3,3
93391,5,1,326793,326793,326794,0,1,2
93392,1,1,326794,326794,326795,0,1,0
93393,6,2,326800,326800,326802,0,2,5
93394,1,3,326801,326802,326805,1,4,0
93395,3,2,326804,326805,326807,1,3,0
93396,2,3,326806,326807,326810,1,4,0
93397,2,3,326808,326810,326813,2,5,0
93398,1,3,326809,326813,326816,4,7,0
93399,3,1,326812,326816,326817,4,5,0
93400,3,1,326815,326817,326818,2,3,0
93401,3,1,326818,326818,326819,0,1,0
93402,6,1,326824,326824,326825,0,1,5
93403,5,3,326829,326829,326832,0,3,4
93404,4,1,326833,326833,326834,0,1,1
93405,2,1,326835,326835,326836,0,1,1
93406,4,1,326839,326839,326840,0,1,3
93407,3,2,326842,326842,326844,0,2,2
93408,6,3,326848,326848,326851,0,3,4
93409,3,1,326851,326851,326852,0,1,0
93410,2,3,326853,326853,326856,0,3,1
93411,6,3,326859,326859,326862,0,3,3
93412,6,2,326865,326865,326867,0,2,3
93413,6,3,326871,326871,326874,0,3,4
93414,4,3,326875,326875,326878,0,3,1
93415,1,1,326876,326878,326879,2,3,0
93416,5,2,326881,326881,326883,0,2,2
93417,3,3,326884,326884,326887,0,3,1
93418,1,2,326885,326887,326889,2,4,0
93419,4,3,326889,326889,326892,0,3,0
93420,6,3,326895,326895,326898,0,3,3
93421,5,1,326900,326900,326901,0,1,2
93422,1,2,326901,326901,326903,0,2,0
93423,5,2,326906,326906,326908,0,2,3
93424,1,3,326907,326908,326911,1,4,0
93425,6,1,326913,326913,326914,0,1,2
93426,3,3,326916,326916,326919,0,3,2
93427,6,3,326922,326922,326925,0,3,3
93428,2,3,326924,326925,326928,1,4,0
93429,1,2,326925,326928,326930,3,5,0
93430,1,2,326926,326930,326932,4,6,0
93431,4,1,326930,326932,326933,2,3,0
93432,4,2,326934,326934,326936,0,2,1
93433,6,1,326940,326940,326941,0,1,4
93434,1,2,326941,326941,326943,0,2,0
93435,2,1,326943,326943,326944,0,1,0
93436,3,1,326946,326946,326947,0,1,2
93437,5,2,326951,326951,326953,0,2,4
93438,1,2,326952,326953,326955,1,3,0
93439,5,1,326957,326957,326958,0,1,2
93440,1,2,326958,326958,326960,0,2,0
93441,5,1,326963,326963,326964,0,1,3
93442,1,3,326964,326964,326967,0,3,0
93443,1,2,326965,326967,326969,2,4,0
93444,1,1,326966,326969,326970,3,4,0
93445,2,1,326968,326970,326971,2,3,0
93446,4,2,326972,326972,326974,0,2,1
93447,2,2,326974,326974,326976,0,2,0
93448,5,3,326979,326979,326982,0,3,3
93449,6,2,326985,326985,326987,0,2,3
93450,1,1,326986,326987,326988,1,2,0
93451,2,1,326988,326988,326989,0,1,0
93452,4,2,326992,326992,326994,0,2,3
93453,6,3,326998,326998,327001,0,3,4
93454,4,2,327002,327002,327004,0,2,1
93455,2,2,327004,327004,327006,0,2,0
93456,5,1,327009,327009,327010,0,1,3
93457,3,3,327012,327012,327015,0,3,2
93458,3,1,327015,327015,327016,0,1,0
93459,5,3,327020,327020,327023,0,3,4
93460,3,1,327023,327023,327024,0,1,0
93461,4,3,327027,327027,327030,0,3,3
93462,5,2,327032,327032,327034,0,2,2
93463,1,1,327033,327034,327035,1,2,0
93464,4,1,327037,327037,327038,0,1,2
93465,3,3,327040,327040,327043,0,3,2
93466,6,3,327046,327046,327049,0,3,3
93467,6,2,327052,327052,327054,0,2,3
93468,1,1,327053,327054,327055,1,2,0
93469,5,1,327058,327058,327059,0,1,3
93470,4,3,327062,327062,327065,0,3,3
93471,5,3,327067,327067,327070,0,3,2
93472,4,2,327071,327071,327073,0,2,1
93473,1,3,327072,327073,327076,1,4,0
93474,2,1,327074,327076,327077,2,3,0
93475,5,2,327079,327079,327081,0,2,2
93476,5,3,327084,327084,327087,0,3,3
93477,1,2,327085,327087,327089,2,4,0
93478,2,1,327087,327089,327090,2,3,0
93479,6,2,327093,327093,327095,0,2,3
93480,2,2,327095,327095,327097,0,2,0
93481,2,1,327097,327097,327098,0,1,0
93482,6,3,327103,327103,327106,0,3,5
93483,3,3,327106,327106,327109,0,3,0
93484,2,3,327108,327109,327112,1,4,0
93485,3,3,327111,327112,327115,1,4,0
93486,3,3,327114,327115,327118,1,4,0
93487,6,1,327120,327120,327121,0,1,2
93488,5,2,327125,327125,327127,0,2,4
93489,3,3,327128,327128,327131,0,3,1
93490,6,3,327134,327134,327137,0,3,3
93491,4,1,327138,327138,327139,0,1,1
93492,2,2,327140,327140,327142,0,2,1
93493,2,1,327142,327142,327143,0,1,0
93494,4,3,327146,327146,327149,0,3,3
93495,3,1,327149,327149,327150,0,1,0
93496,1,1,327150,327150,327151,0,1,0
93497,5,1,327155,327155,327156,0,1,4
93498,1,1,327156,327156,327157,0,1,0
93499,1,3,327157,327157,327160,0,3,0
93500,6,2,327163,327163,327165,0,2,3
93501,6,1,327169,327169,327170,0,1,4
93502,2,1,327171,327171,327172,0,1,1
93503,5,2,327176,327176,327178,0,2,4
93504,5,1,327181,327181,327182,0,1,3
93505,2,3,327183,327183,327186,0,3,1
93506,5,2,327188,327188,327190,0,2,2
93507,5,2,327193,327193,327195,0,2,3
93508,1,1,327194,327195,327196,1,2,0
93509,2,1,327196,327196,327197,0,1,0
93510,3,2,327199,327199,327201,0,2,2
93511,1,2,327200,327201,327203,1,3,0
93512,6,1,327206,327206,327207,0,1,3
93513,2,2,327208,327208,327210,0,2,1
93514,3,2,327211,327211,327213,0,2,1
93515,5,1,327216,327216,327217,0,1,3
93516,2,3,327218,327218,327221,0,3,1
93517,4,1,327222,327222,327223,0,1,1
93518,3,1,327225,327225,327226,0,1,2
93519,3,2,327228,327228,327230,0,2,2
93520,5,3,327233,327233,327236,0,3,3
93521,1,1,327234,327236,327237,2,3,0
93522,3,1,327237,327237,327238,0,1,0
93523,1,1,327238,327238,327239,0,1,0
93524,2,2,327240,327240,327242,0,2,1
93525,3,2,327243,327243,327245,0,2,1
93526,3,1,327246,327246,327247,0,1,1
93527,1,3,327247,327247,327250,0,3,0
93528,4,2,327251,327251,327253,0,2,1
93529,5,2,327256,327256,327258,0,2,3
93530,2,1,327258,327258,327259,0,1,0
93531,5,1,327263,327263,327264,0,1,4
93532,3,1,327266,327266,327267,0,1,2
93533,2,1,327268,327268,327269,0,1,1
93534,6,3,327274,327274,327277,0,3,5
93535,3,3,327277,327277,327280,0,3,0
93536,1,1,327278,327280,327281,2,3,0
93537,1,2,327279,327281,327283,2,4,0
93538,1,1,327280,327283,327284,3,4,0
93539,2,2,327282,327284,327286,2,4,0
93540,1,1,327283,327286,327287,3,4,0
93541,6,2,327289,327289,327291,0,2,2
93542,4,2,327293,327293,327295,0,2,2
93543,5,1,327298,327298,327299,0,1,3
93544,1,3,327299,327299,327302,0,3,0
93545,3,3,327302,327302,327305,0,3,0
93546,4,3,327306,327306,327309,0,3,1
93547,1,3,327307,327309,327312,2,5,0
93548,6,2,327313,327313,327315,0,2,1
93549,5,2,327318,327318,327320,0,2,3
93550,1,2,327319,327320,327322,1,3,0
93551,1,1,327320,327322,327323,2,3,0
93552,2,2,327322,327323,327325,1,3,0
93553,1,2,327323,327325,327327,2,4,0
93554,4,2,327327,327327,327329,0,2,0
93555,3,3,327330,327330,327333,0,3,1
93556,5,3,327335,327335,327338,0,3,2
93557,2,2,327337,327338,327340,1,3,0
93558,5,2,327342,327342,327344,0,2,2
93559,1,2,327343,327344,327346,1,3,0
93560,3,1,327346,327346,327347,0,1,0
93561,3,3,327349,327349,327352,0,3,2
93562,5,3,327354,327354,327357,0,3,2
93563,2,1,327356,327357,327358,1,2,0
93564,3,3,327359,327359,327362,0,3,1
93565,3,1,327362,327362,327363,0,1,0
93566,5,2,327367,327367,327369,0,2,4
93567,6,3,327373,327373,327376,0,3,4
93568,3,3,327376,327376,327379,0,3,0
93569,2,1,327378,327379,327380,1,2,0
93570,3,2,327381,327381,327383,0,2,1
93571,6,2,327387,327387,327389,0,2,4
93572,1,1,327388,327389,327390,1,2,0
93573,5,1,327393,327393,327394,0,1,3
93574,6,3,327399,327399,327402,0,3,5
93575,1,3,327400,327402,327405,2,5,0
93576,5,2,327405,327405,327407,0,2,0
93577,3,3,327408,327408,327411,0,3,1
93578,2,2,327410,327411,327413,1,3,0
93579,3,2,327413,327413,327415,0,2,0
93580,2,3,327415,327415,327418,0,3,0
93581,1,1,327416,327418,327419,2,3,0
93582,1,1,327417,327419,327420,2,3,0
93583,6,3,327423,327423,327426,0,3,3
93584,3,2,327426,327426,327428,0,2,0
93585,6,2,327432,327432,327434,0,2,4
93586,6,1,327438,327438,327439,0,1,4
93587,1,1,327439,327439,327440,0,1,0
93588,3,1,327442,327442,327443,0,1,2
93589,4,2,327446,327446,327448,0,2,3
93590,5,1,327451,327451,327452,0,1,3
93591,5,3,327456,327456,327459,0,3,4
93592,6,1,327462,327462,327463,0,1,3
93593,6,3,327468,327468,327471,0,3,5
93594,5,2,327473,327473,327475,0,2,2
93595,2,1,327475,327475,327476,0,1,0
93596,3,3,327478,327478,327481,0,3,2
93597,1,1,327479,327481,327482,2,3,0
93598,6,1,327485,327485,327486,0,1,3
93599,2,2,327487,327487,327489,0,2,1
93600,6,3,327493,327493,327496,0,3,4
93601,1,2,327494,327496,327498,2,4,0
93602,5,3,327499,327499,327502,0,3,1
93603,6,1,327505,327505,327506,0,1,3
93604,4,3,327509,327509,327512,0,3,3
93605,3,1,327512,327512,327513,0,1,0
93606,3,2,327515,327515,327517,0,2,2
93607,5,2,327520,327520,327522,0,2,3
93608,6,1,327526,327526,327527,0,1,4
93609,4,3,327530,327530,327533,0,3,3
93610,1,2,327531,327533,327535,2,4,0
93611,4,2,327535,327535,327537,0,2,0
93612,3,3,327538,327538,327541,0,3,1
93613,1,2,327539,327541,327543,2,4,0
93614,2,3,327541,327543,327546,2,5,0
93615,3,3,327544,327546,327549,2,5,0
93616,6,3,327550,327550,327553,0,3,1
93617,2,3,327552,327553,327556,1,4,0
93618,6,2,327558,327558,327560,0,2,2
93619,4,2,327562,327562,327564,0,2,2
93620,3,1,327565,327565,327566,0,1,1
93621,3,3,327568,327568,327571,0,3,2
93622,1,2,327569,327571,327573,2,4,0
93623,3,3,327572,327573,327576,1,4,0
93624,1,1,327573,327576,327577,3,4,0
93625,2,1,327575,327577,327578,2,3,0
93626,4,1,327579,327579,327580,0,1,1
93627,2,2,327581,327581,327583,0,2,1
93628,4,1,327585,327585,327586,0,1,2
93629,2,1,327587,327587,327588,0,1,1
93630,2,2,327589,327589,327591,0,2,1
93631,2,1,327591,327591,327592,0,1,0
93632,5,2,327596,327596,327598,0,2,4
93633,3,2,327599,327599,327601,0,2,1
93634,3,1,327602,327602,327603,0,1,1
93635,3,3,327605,327605,327608,0,3,2
93636,2,1,327607,327608,327609,1,2,0
93637,1,1,327608,327609,327610,1,2,0
93638,6,1,327614,327614,327615,0,1,4
93639,3,1,327617,327617,327618,0,1,2
93640,6,1,327623,327623,327624,0,1,5
93641,5,3,327628,327628,327631,0,3,4
93642,5,1,327633,327633,327634,0,1,2
93643,6,3,327639,327639,327642,0,3,5
93644,5,1,327644,327644,327645,0,1,2
93645,1,3,327645,327645,327648,0,3,0
93646,5,3,327650,327650,327653,0,3,2
93647,5,3,327655,327655,327658,0,3,2
93648,4,2,327659,327659,327661,0,2,1
93649,4,1,327663,327663,327664,0,1,2
93650,3,2,327666,327666,327668,0,2,2
93651,1,1,327667,327668,327669,1,2,0
93652,2,2,327669,327669,327671,0,2,0
93653,2,3,327671,327671,327674,0,3,0
93654,4,1,327675,327675,327676,0,1,1
93655,4,2,327679,327679,327681,0,2,3
93656,6,3,327685,327685,327688,0,3,4
93657,6,1,327691,327691,327692,0,1,3
93658,1,3,327692,327692,327695,0,3,0
93659,6,1,327698,327698,327699,0,1,3
93660,6,3,327704,327704,327707,0,3,5
93661,6,2,327710,327710,327712,0,2,3
93662,1,2,327711,327712,327714,1,3,0
93663,3,2,327714,327714,327716,0,2,0
93664,3,1,327717,327717,327718,0,1,1
93665,2,2,327719,327719,327721,0,2,1
93666,1,1,327720,327721,327722,1,2,0
93667,2,2,327722,327722,327724,0,2,0
93668,4,3,327726,327726,327729,0,3,2
93669,3,1,327729,327729,327730,0,1,0
93670,6,1,327735,327735,327736,0,1,5
93671,1,3,327736,327736,327739,0,3,0
93672,4,1,327740,327740,327741,0,1,1
93673,5,2,327745,327745,327747,0,2,4
93674,2,3,327747,327747,327750,0,3,0
93675,2,3,327749,327750,327753,1,4,0
93676,5,3,327754,327754,327757,0,3,1
93677,1,3,327755,327757,327760,2,5,0
93678,5,3,327760,327760,327763,0,3,0
93679,4,1,327764,327764,327765,0,1,1
93680,3,1,327767,327767,327768,0,1,2
93681,6,3,327773,327773,327776,0,3,5
93682,2,1,327775,327776,327777,1,2,0
93683,2,2,327777,327777,327779,0,2,0
93684,1,2,327778,327779,327781,1,3,0
93685,3,2,327781,327781,327783,0,2,0
93686,5,2,327786,327786,327788,0,2,3
93687,2,1,327788,327788,327789,0,1,0
93688,6,2,327794,327794,327796,0,2,5
93689,4,3,327798,327798,327801,0,3,2
93690,1,1,327799,327801,327802,2,3,0
93691,2,1,327801,327802,327803,1,2,0
93692,3,2,327804,327804,327806,0,2,1
93693,1,2,327805,327806,327808,1,3,0
93694,4,1,327809,327809,327810,0,1,1
93695,6,3,327815,327815,327818,0,3,5
93696,6,3,327821,327821,327824,0,3,3
93697,5,2,327826,327826,327828,0,2,2
93698,6,1,327832,327832,327833,0,1,4
93699,4,1,327836,327836,327837,0,1,3
93700,4,3,327840,327840,327843,0,3,3
93701,4,2,327844,327844,327846,0,2,1
93702,6,2,327850,327850,327852,0,2,4
93703,6,3,327856,327856,327859,0,3,4
93704,4,2,327860,327860,327862,0,2,1
93705,6,3,327866,327866,327869,0,3,4
93706,4,3,327870,327870,327873,0,3,1
93707,2,2,327872,327873,327875,1,3,0
93708,3,3,327875,327875,327878,0,3,0
93709,5,1,327880,327880,327881,0,1,2
93710,6,3,327886,327886,327889,0,3,5
93711,3,2,327889,327889,327891,0,2,0
93712,1,2,327890,327891,327893,1,3,0
93713,4,1,327894,327894,327895,0,1,1
93714,2,3,327896,327896,327899,0,3,1
93715,6,1,327902,327902,327903,0,1,3
93716,1,2,327903,327903,327905,0,2,0
93717,6,2,327909,327909,327911,0,2,4
93718,5,2,327914,327914,327916,0,2,3
93719,3,1,327917,327917,327918,0,1,1
93720,5,3,327922,327922,327925,0,3,4
93721,4,2,327926,327926,327928,0,2,1
93722,5,3,327931,327931,327934,0,3,3
93723,5,1,327936,327936,327937,0,1,2
93724,6,3,327942,327942,327945,0,3,5
93725,1,1,327943,327945,327946,2,3,0
93726,4,1,327947,327947,327948,0,1,1
93727,4,2,327951,327951,327953,0,2,3
93728,6,2,327957,327957,327959,0,2,4
93729,4,2,327961,327961,327963,0,2,2
93730,6,1,327967,327967,327968,0,1,4
93731,2,2,327969,327969,327971,0,2,1
93732,3,3,327972,327972,327975,0,3,1
93733,3,3,327975,327975,327978,0,3,0
93734,5,1,327980,327980,327981,0,1,2
93735,3,3,327983,327983,327986,0,3,2
93736,4,2,327987,327987,327989,0,2,1
93737,2,2,327989,327989,327991,0,2,0
93738,3,1,327992,327992,327993,0,1,1
93739,1,1,327993,327993,327994,0,1,0
93740,4,1,327997,327997,327998,0,1,3
93741,5,2,328002,328002,328004,0,2,4
93742,2,3,328004,328004,328007,0,3,0
93743,3,2,328007,328007,328009,0,2,0
93744,3,3,328010,328010,328013,0,3,1
93745,4,1,328014,328014,328015,0,1,1
93746,4,1,328018,328018,328019,0,1,3
93747,1,1,328019,328019,328020,0,1,0
93748,6,1,328025,328025,328026,0,1,5
93749,1,2,328026,328026,328028,0,2,0
93750,6,1,328032,328032,328033,0,1,4
93751,4,2,328036,328036,328038,0,2,3
93752,4,2,328040,328040,328042,0,2,2
93753,2,3,328042,328042,328045,0,3,0
93754,4,3,328046,328046,328049,0,3,1
93755,4,3,328050,328050,328053,0,3,1
93756,1,1,328051,328053,328054,2,3,0
93757,6,1,328057,328057,328058,0,1,3
93758,1,2,328058,328058,328060,0,2,0
93759,5,3,328063,328063,328066,0,3,3
93760,4,3,328067,328067,328070,0,3,1
93761,4,2,328071,328071,328073,0,2,1
93762,2,2,328073,328073,328075,0,2,0
93763,1,3,328074,328075,328078,1,4,0
93764,1,3,328075,328078,328081,3,6,0
93765,5,3,328080,328081,328084,1,4,0
93766,4,3,328084,328084,328087,0,3,0
93767,2,1,328086,328087,328088,1,2,0
93768,1,1,328087,328088,328089,1,2,0
93769,4,2,328091,328091,328093,0,2,2
93770,2,1,328093,328093,328094,0,1,0
93771,2,3,328095,328095,328098,0,3,1
93772,4,2,328099,328099,328101,0,2,1
93773,3,2,328102,328102,328104,0,2,1
93774,4,1,328106,328106,328107,0,1,2
93775,1,1,328107,328107,328108,0,1,0
93776,3,3,328110,328110,328113,0,3,2
93777,6,2,328116,328116,328118,0,2,3
93778,4,2,328120,328120,328122,0,2,2
93779,5,1,328125,328125,328126,0,1,3
93780,4,1,328129,328129,328130,0,1,3
93781,3,3,328132,328132,328135,0,3,2
93782,1,1,328133,328135,328136,2,3,0
93783,1,1,328134,328136,328137,2,3,0
93784,1,1,328135,328137,328138,2,3,0
93785,2,3,328137,328138,328141,1,4,0
93786,4,2,328141,328141,328143,0,2,0
93787,4,1,328145,328145,328146,0,1,2
93788,6,2,328151,328151,328153,0,2,5
93789,1,2,328152,328153,328155,1,3,0
93790,3,3,328155,328155,328158,0,3,0
93791,6,2,328161,328161,328163,0,2,3
93792,6,2,328167,328167,328169,0,2,4
93793,4,1,328171,328171,328172,0,1,2
93794,5,3,328176,328176,328179,0,3,4
93795,2,1,328178,328179,328180,1,2,0
93796,5,2,328183,328183,328185,0,2,3
93797,6,1,328189,328189,328190,0,1,4
93798,5,2,328194,328194,328196,0,2,4
93799,3,1,328197,328197,328198,0,1,1
93800,2,3,328199,328199,328202,0,3,1
93801,4,1,328203,328203,328204,0,1,1
93802,3,3,328206,328206,328209,0,3,2
93803,4,3,328210,328210,328213,0,3,1
93804,3,3,328213,328213,328216,0,3,0
93805,6,3,328219,328219,328222,0,3,3
93806,2,1,328221,328222,328223,1,2,0
93807,2,2,328223,328223,328225,0,2,0
93808,5,1,328228,328228,328229,0,1,3
93809,2,3,328230,328230,328233,0,3,1
93810,1,2,328231,328233,328235,2,4,0
93811,6,1,328237,328237,328238,0,1,2
93812,6,2,328243,328243,328245,0,2,5
93813,1,3,328244,328245,328248,1,4,0
93814,4,2,328248,328248,328250,0,2,0
93815,1,3,328249,328250,328253,1,4,0
93816,3,1,328252,328253,328254,1,2,0
93817,5,2,328257,328257,328259,0,2,3
93818,5,1,328262,328262,328263,0,1,3
93819,3,3,328265,328265,328268,0,3,2
93820,5,3,328270,328270,328273,0,3,2
93821,2,1,328272,328273,328274,1,2,0
93822,2,2,328274,328274,328276,0,2,0
93823,1,2,328275,328276,328278,1,3,0
93824,3,1,328278,328278,328279,0,1,0
93825,5,2,328283,328283,328285,0,2,4
93826,3,3,328286,328286,328289,0,3,1
93827,1,1,328287,328289,328290,2,3,0
93828,2,1,328289,328290,328291,1,2,0
93829,3,2,328292,328292,328294,0,2,1
93830,5,1,328297,328297,328298,0,1,3
93831,5,3,328302,328302,328305,0,3,4
93832,2,2,328304,328305,328307,1,3,0
93833,5,1,328309,328309,328310,0,1,2
93834,2,2,328311,328311,328313,0,2,1
93835,3,2,328314,328314,328316,0,2,1
93836,6,2,328320,328320,328322,0,2,4
93837,6,1,328326,328326,328327,0,1,4
93838,4,2,328330,328330,328332,0,2,3
93839,4,1,328334,328334,328335,0,1,2
93840,4,2,328338,328338,328340,0,2,3
93841,1,1,328339,328340,328341,1,2,0
93842,4,2,328343,328343,328345,0,2,2
93843,4,2,328347,328347,328349,0,2,2
93844,3,3,328350,328350,328353,0,3,1
93845,3,3,328353,328353,328356,0,3,0
93846,1,3,328354,328356,328359,2,5,0
93847,4,2,328358,328359,328361,1,3,0
93848,3,3,328361,328361,328364,0,3,0
93849,4,1,328365,328365,328366,0,1,1
93850,4,2,328369,328369,328371,0,2,3
93851,6,3,328375,328375,328378,0,3,4
93852,3,3,328378,328378,328381,0,3,0
93853,4,3,328382,328382,328385,0,3,1
93854,2,1,328384,328385,328386,1,2,0
93855,4,3,328388,328388,328391,0,3,2
93856,3,1,328391,328391,328392,0,1,0
93857,3,3,328394,328394,328397,0,3,2
93858,6,1,328400,328400,328401,0,1,3
93859,2,2,328402,328402,328404,0,2,1
93860,4,3,328406,328406,328409,0,3,2
93861,6,2,328412,328412,328414,0,2,3
93862,1,2,328413,328414,328416,1,3,0
93863,4,1,328417,328417,328418,0,1,1
93864,2,2,328419,328419,328421,0,2,1
93865,1,3,328420,328421,328424,1,4,0
93866,6,1,328426,328426,328427,0,1,2
93867,2,3,328428,328428,328431,0,3,1
93868,6,1,328434,328434,328435,0,1,3
93869,1,3,328435,328435,328438,0,3,0
93870,2,3,328437,328438,328441,1,4,0
93871,5,3,328442,328442,328445,0,3,1
93872,4,3,328446,328446,328449,0,3,1
93873,4,3,328450,328450,328453,0,3,1
93874,1,2,328451,328453,328455,2,4,0
93875,3,2,328454,328455,328457,1,3,0
93876,5,3,328459,328459,328462,0,3,2
93877,5,3,328464,328464,328467,0,3,2
93878,4,2,328468,328468,328470,0,2,1
93879,2,3,328470,328470,328473,0,3,0
93880,3,1,328473,328473,328474,0,1,0
93881,5,2,328478,328478,328480,0,2,4
93882,6,1,328484,328484,328485,0,1,4
93883,6,1,328490,328490,328491,0,1,5
93884,6,1,328496,328496,328497,0,1,5
93885,3,2,328499,328499,328501,0,2,2
93886,3,2,328502,328502,328504,0,2,1
93887,3,1,328505,328505,328506,0,1,1
93888,6,1,328511,328511,328512,0,1,5
93889,2,1,328513,328513,328514,0,1,1
93890,5,3,328518,328518,328521,0,3,4
93891,3,2,328521,328521,328523,0,2,0
93892,3,3,328524,328524,328527,0,3,1
93893,2,1,328526,328527,328528,1,2,0
93894,5,1,328531,328531,328532,0,1,3
93895,5,1,328536,328536,328537,0,1,4
93896,1,1,328537,328537,328538,0,1,0
93897,4,3,328541,328541,328544,0,3,3
93898,5,3,328546,328546,328549,0,3,2
93899,1,2,328547,328549,328551,2,4,0
93900,4,1,328551,328551,328552,0,1,0
93901,2,1,328553,328553,328554,0,1,1
93902,5,1,328558,328558,328559,0,1,4
93903,5,2,328563,328563,328565,0,2,4
93904,1,3,328564,328565,328568,1,4,0
93905,4,3,328568,328568,328571,0,3,0
93906,5,3,328573,328573,328576,0,3,2
93907,2,2,328575,328576,328578,1,3,0
93908,1,2,328576,328578,328580,2,4,0
93909,3,2,328579,328580,328582,1,3,0
93910,6,3,328585,328585,328588,0,3,3
93911,3,3,328588,328588,328591,0,3,0
93912,1,1,328589,328591,328592,2,3,0
93913,2,1,328591,328592,328593,1,2,0
93914,1,2,328592,328593,328595,1,3,0
93915,3,1,328595,328595,328596,0,1,0
93916,3,3,328598,328598,328601,0,3,2
93917,3,2,328601,328601,328603,0,2,0
93918,4,3,328605,328605,328608,0,3,2
93919,2,2,328607,328608,328610,1,3,0
93920,6,2,328613,328613,328615,0,2,3
93921,3,2,328616,328616,328618,0,2,1
93922,6,3,328622,328622,328625,0,3,4
93923,1,3,328623,328625,328628,2,5,0
93924,2,3,328625,328628,328631,3,6,0
93925,6,3,328631,328631,328634,0,3,0
93926,3,2,328634,328634,328636,0,2,0
93927,6,1,328640,328640,328641,0,1,4
93928,3,1,328643,328643,328644,0,1,2
93929,3,3,328646,328646,328649,0,3,2
93930,6,1,328652,328652,328653,0,1,3
93931,4,2,328656,328656,328658,0,2,3
93932,1,1,328657,328658,328659,1,2,0
93933,3,1,328660,328660,328661,0,1,1
93934,5,1,328665,328665,328666,0,1,4
93935,1,1,328666,328666,328667,0,1,0
93936,2,3,328668,328668,328671,0,3,1
93937,4,1,328672,328672,328673,0,1,1
93938,2,3,328674,328674,328677,0,3,1
93939,6,3,328680,328680,328683,0,3,3
93940,2,3,328682,328683,328686,1,4,0
93941,1,1,328683,328686,328687,3,4,0
93942,5,1,328688,328688,328689,0,1,1
93943,1,2,328689,328689,328691,0,2,0
93944,3,3,328692,328692,328695,0,3,1
93945,1,3,328693,328695,328698,2,5,0
93946,1,2,328694,328698,328700,4,6,0
93947,2,3,328696,328700,328703,4,7,0
93948,5,2,328701,328703,328705,2,4,0
93949,1,1,328702,328705,328706,3,4,0
93950,4,1,328706,328706,328707,0,1,0
93951,4,2,328710,328710,328712,0,2,3
93952,3,3,328713,328713,328716,0,3,1
93953,6,3,328719,328719,328722,0,3,3
93954,6,3,328725,328725,328728,0,3,3
93955,2,3,328727,328728,328731,1,4,0
93956,3,3,328730,328731,328734,1,4,0
93957,1,1,328731,328734,328735,3,4,0
93958,5,3,328736,328736,328739,0,3,1
93959,2,3,328738,328739,328742,1,4,0
93960,2,3,328740,328742,328745,2,5,0
93961,4,2,328744,328745,328747,1,3,0
93962,3,3,328747,328747,328750,0,3,0
93963,4,2,328751,328751,328753,0,2,1
93964,2,1,328753,328753,328754,0,1,0
93965,6,3,328759,328759,328762,0,3,5
93966,1,1,328760,328762,328763,2,3,0
93967,4,3,328764,328764,328767,0,3,1
93968,1,3,328765,328767,328770,2,5,0
93969,4,2,328769,328770,328772,1,3,0
93970,2,1,328771,328772,328773,1,2,0
93971,2,2,328773,328773,328775,0,2,0
93972,5,1,328778,328778,328779,0,1,3
93973,2,2,328780,328780,328782,0,2,1
93974,2,1,328782,328782,328783,0,1,0
93975,5,1,328787,328787,328788,0,1,4
93976,3,3,328790,328790,328793,0,3,2
93977,5,2,328795,328795,328797,0,2,2
93978,2,3,328797,328797,328800,0,3,0
93979,3,1,328800,328800,328801,0,1,0
93980,5,3,328805,328805,328808,0,3,4
93981,6,3,328811,328811,328814,0,3,3
93982,4,1,328815,328815,328816,0,1,1
93983,5,1,328820,328820,328821,0,1,4
93984,3,1,328823,328823,328824,0,1,2
93985,6,3,328829,328829,328832,0,3,5
93986,3,1,328832,328832,328833,0,1,0
93987,1,1,328833,328833,328834,0,1,0
93988,3,3,328836,328836,328839,0,3,2
93989,1,1,328837,328839,328840,2,3,0
93990,3,3,328840,328840,328843,0,3,0
93991,5,2,328845,328845,328847,0,2,2
93992,6,1,328851,328851,328852,0,1,4
93993,1,3,328852,328852,328855,0,3,0
93994,2,2,328854,328855,328857,1,3,0
93995,5,3,328859,328859,328862,0,3,2
93996,5,1,328864,328864,328865,0,1,2
93997,6,3,328870,328870,328873,0,3,5
93998,6,3,328876,328876,328879,0,3,3
93999,3,2,328879,328879,328881,0,2,0
94000,5,1,328884,328884,328885,0,1,3
94001,2,2,328886,328886,328888,0,2,1
94002,1,1,328887,328888,328889,1,2,0
94003,2,3,328889,328889,328892,0,3,0
94004,3,2,328892,328892,328894,0,2,0
94005,5,2,328897,328897,328899,0,2,3
94006,1,2,328898,328899,328901,1,3,0
94007,5,2,328903,328903,328905,0,2,2
94008,6,1,328909,328909,328910,0,1,4
94009,1,2,328910,328910,328912,0,2,0
94010,6,3,328916,328916,328919,0,3,4
94011,6,1,328922,328922,328923,0,1,3
94012,2,2,328924,328924,328926,0,2,1
94013,2,3,328926,328926,328929,0,3,0
94014,6,1,328932,328932,328933,0,1,3
94015,4,2,328936,328936,328938,0,2,3
94016,6,3,328942,328942,328945,0,3,4
94017,3,3,328945,328945,328948,0,3,0
94018,1,3,328946,328948,328951,2,5,0
94019,1,1,328947,328951,328952,4,5,0
94020,1,2,328948,328952,328954,4,6,0
94021,5,2,328953,328954,328956,1,3,0
94022,2,3,328955,328956,328959,1,4,0
94023,3,1,328958,328959,328960,1,2,0
94024,2,2,328960,328960,328962,0,2,0
94025,6,3,328966,328966,328969,0,3,4
94026,4,2,328970,328970,328972,0,2,1
94027,3,2,328973,328973,328975,0,2,1
94028,2,2,328975,328975,328977,0,2,0
94029,5,1,328980,328980,328981,0,1,3
94030,6,2,328986,328986,328988,0,2,5
94031,5,1,328991,328991,328992,0,1,3
94032,1,2,328992,328992,328994,0,2,0
94033,3,1,328995,328995,328996,0,1,1
94034,3,3,328998,328998,329001,0,3,2
94035,1,1,328999,329001,329002,2,3,0
94036,5,1,329004,329004,329005,0,1,2
94037,3,2,329007,329007,329009,0,2,2
94038,4,1,329011,329011,329012,0,1,2
94039,3,1,329014,329014,329015,0,1,2
94040,6,3,329020,329020,329023,0,3,5
94041,6,1,329026,329026,329027,0,1,3
94042,2,3,329028,329028,329031,0,3,1
94043,2,2,329030,329031,329033,1,3,0
94044,6,2,329036,329036,329038,0,2,3
94045,1,2,329037,329038,329040,1,3,0
94046,5,2,329042,329042,329044,0,2,2
94047,6,3,329048,329048,329051,0,3,4
94048,6,2,329054,329054,329056,0,2,3
94049,6,3,329060,329060,329063,0,3,4
94050,1,2,329061,329063,329065,2,4,0
94051,3,1,329064,329065,329066,1,2,0
94052,2,3,329066,329066,329069,0,3,0
94053,1,1,329067,329069,329070,2,3,0
94054,5,2,329072,329072,329074,0,2,2
94055,6,1,329078,329078,329079,0,1,4
94056,4,1,329082,329082,329083,0,1,3
94057,1,3,329083,329083,329086,0,3,0
94058,6,1,329089,329089,329090,0,1,3
94059,4,3,329093,329093,329096,0,3,3
94060,4,1,329097,329097,329098,0,1,1
94061,3,1,329100,329100,329101,0,1,2
94062,1,1,329101,329101,329102,0,1,0
94063,6,2,329107,329107,329109,0,2,5
94064,2,3,329109,329109,329112,0,3,0
94065,1,1,329110,329112,329113,2,3,0
94066,5,3,329115,329115,329118,0,3,2
94067,5,1,329120,329120,329121,0,1,2
94068,3,1,329123,329123,329124,0,1,2
94069,1,2,329124,329124,329126,0,2,0
94070,2,1,329126,329126,329127,0,1,0
94071,3,1,329129,329129,329130,0,1,2
94072,4,1,329133,329133,329134,0,1,3
94073,2,3,329135,329135,329138,0,3,1
94074,5,1,329140,329140,329141,0,1,2
94075,3,1,329143,329143,329144,0,1,2
94076,5,1,329148,329148,329149,0,1,4
94077,4,2,329152,329152,329154,0,2,3
94078,2,1,329154,329154,329155,0,1,0
94079,3,3,329157,329157,329160,0,3,2
94080,1,2,329158,329160,329162,2,4,0
94081,3,3,329161,329162,329165,1,4,0
94082,3,1,329164,329165,329166,1,2,0
94083,2,1,329166,329166,329167,0,1,0
94084,4,1,329170,329170,329171,0,1,3
94085,4,2,329174,329174,329176,0,2,3
94086,1,1,329175,329176,329177,1,2,0
94087,3,3,329178,329178,329181,0,3,1
94088,6,1,329184,329184,329185,0,1,3
94089,2,1,329186,329186,329187,0,1,1
94090,2,3,329188,329188,329191,0,3,1
94091,6,1,329194,329194,329195,0,1,3
94092,1,3,329195,329195,329198,0,3,0
94093,6,2,329201,329201,329203,0,2,3
94094,2,3,329203,329203,329206,0,3,0
94095,2,3,329205,329206,329209,1,4,0
94096,6,1,329211,329211,329212,0,1,2
94097,1,1,329212,329212,329213,0,1,0
94098,2,2,329214,329214,329216,0,2,1
94099,2,3,329216,329216,329219,0,3,0
94100,4,2,329220,329220,329222,0,2,1
94101,1,3,329221,329222,329225,1,4,0
94102,6,1,329227,329227,329228,0,1,2
94103,4,2,329231,329231,329233,0,2,3
94104,1,1,329232,329233,329234,1,2,0
94105,4,2,329236,329236,329238,0,2,2
94106,3,3,329239,329239,329242,0,3,1
94107,6,3,329245,329245,329248,0,3,3
94108,3,3,329248,329248,329251,0,3,0
94109,1,2,329249,329251,329253,2,4,0
94110,3,1,329252,329253,329254,1,2,0
94111,1,1,329253,329254,329255,1,2,0
94112,3,1,329256,329256,329257,0,1,1
94113,1,3,329257,329257,329260,0,3,0
94114,4,2,329261,329261,329263,0,2,1
94115,3,1,329264,329264,329265,0,1,1
94116,3,2,329267,329267,329269,0,2,2
94117,1,1,329268,329269,329270,1,2,0
94118,4,1,329272,329272,329273,0,1,2
94119,5,2,329277,329277,329279,0,2,4
94120,2,1,329279,329279,329280,0,1,0
94121,2,1,329281,329281,329282,0,1,1
94122,6,2,329287,329287,329289,0,2,5
94123,4,3,329291,329291,329294,0,3,2
94124,3,2,329294,329294,329296,0,2,0
94125,1,2,329295,329296,329298,1,3,0
94126,5,2,329300,329300,329302,0,2,2
94127,6,3,329306,329306,329309,0,3,4
94128,4,1,329310,329310,329311,0,1,1
94129,6,3,329316,329316,329319,0,3,5
94130,6,3,329322,329322,329325,0,3,3
94131,2,1,329324,329325,329326,1,2,0
94132,5,2,329329,329329,329331,0,2,3
94133,6,1,329335,329335,329336,0,1,4
94134,6,3,329341,329341,329344,0,3,5
94135,3,3,329344,329344,329347,0,3,0
94136,6,2,329350,329350,329352,0,2,3
94137,2,3,329352,329352,329355,0,3,0
94138,2,3,329354,329355,329358,1,4,0
94139,4,3,329358,329358,329361,0,3,0
94140,4,3,329362,329362,329365,0,3,1
94141,6,3,329368,329368,329371,0,3,3
94142,6,1,329374,329374,329375,0,1,3
94143,4,1,329378,329378,329379,0,1,3
94144,4,2,329382,329382,329384,0,2,3
94145,2,3,329384,329384,329387,0,3,0
94146,5,1,329389,329389,329390,0,1,2
94147,6,3,329395,329395,329398,0,3,5
94148,1,2,329396,329398,329400,2,4,0
94149,6,3,329402,329402,329405,0,3,2
94150,3,1,329405,329405,329406,0,1,0
94151,1,2,329406,329406,329408,0,2,0
94152,6,1,329412,329412,329413,0,1,4
94153,2,3,329414,329414,329417,0,3,1
94154,3,1,329417,329417,329418,0,1,0
94155,3,2,329420,329420,329422,0,2,2
94156,4,3,329424,329424,329427,0,3,2
94157,2,3,329426,329427,329430,1,4,0
94158,5,2,329431,329431,329433,0,2,1
94159,5,2,329436,329436,329438,0,2,3
94160,4,3,329440,329440,329443,0,3,2
94161,2,1,329442,329443,329444,1,2,0
94162,1,1,329443,329444,329445,1,2,0
94163,2,1,329445,329445,329446,0,1,0
94164,3,2,329448,329448,329450,0,2,2
94165,2,2,329450,329450,329452,0,2,0
94166,1,3,329451,329452,329455,1,4,0
94167,2,2,329453,329455,329457,2,4,0
94168,2,3,329455,329457,329460,2,5,0
94169,1,2,329456,329460,329462,4,6,0
94170,1,1,329457,329462,329463,5,6,0
94171,6,2,329463,329463,329465,0,2,0
94172,4,1,329467,329467,329468,0,1,2
94173,5,3,329472,329472,329475,0,3,4
94174,5,1,329477,329477,329478,0,1,2
94175,4,3,329481,329481,329484,0,3,3
94176,1,3,329482,329484,329487,2,5,0
94177,5,2,329487,329487,329489,0,2,0
94178,5,2,329492,329492,329494,0,2,3
94179,5,3,329497,329497,329500,0,3,3
94180,3,3,329500,329500,329503,0,3,0
94181,1,1,329501,329503,329504,2,3,0
94182,2,1,329503,329504,329505,1,2,0
94183,1,3,329504,329505,329508,1,4,0
94184,2,1,329506,329508,329509,2,3,0
94185,5,1,329511,329511,329512,0,1,2
94186,1,3,329512,329512,329515,0,3,0
94187,5,1,329517,329517,329518,0,1,2
94188,6,1,329523,329523,329524,0,1,5
94189,5,3,329528,329528,329531,0,3,4
94190,1,2,329529,329531,329533,2,4,0
94191,1,2,329530,329533,329535,3,5,0
94192,5,1,329535,329535,329536,0,1,0
94193,6,2,329541,329541,329543,0,2,5
94194,4,1,329545,329545,329546,0,1,2
94195,2,2,329547,329547,329549,0,2,1
94196,1,2,329548,329549,329551,1,3,0
94197,1,1,329549,329551,329552,2,3,0
94198,4,1,329553,329553,329554,0,1,1
94199,3,1,329556,329556,329557,0,1,2
94200,2,1,329558,329558,329559,0,1,1
94201,2,3,329560,329560,329563,0,3,1
94202,2,2,329562,329563,329565,1,3,0
94203,4,2,329566,329566,329568,0,2,1
94204,2,3,329568,329568,329571,0,3,0
94205,5,1,329573,329573,329574,0,1,2
94206,3,2,329576,329576,329578,0,2,2
94207,5,3,329581,329581,329584,0,3,3
94208,5,2,329586,329586,329588,0,2,2
94209,5,1,329591,329591,329592,0,1,3
94210,4,3,329595,329595,329598,0,3,3
94211,1,2,329596,329598,329600,2,4,0
94212,6,3,329602,329602,329605,0,3,2
94213,4,2,329606,329606,329608,0,2,1
94214,5,3,329611,329611,329614,0,3,3
94215,2,2,329613,329614,329616,1,3,0
94216,2,1,329615,329616,329617,1,2,0
94217,1,2,329616,329617,329619,1,3,0
94218,1,1,329617,329619,329620,2,3,0
94219,3,1,329620,329620,329621,0,1,0
94220,1,3,329621,329621,329624,0,3,0
94221,1,1,329622,329624,329625,2,3,0
94222,4,3,329626,329626,329629,0,3,1
94223,2,3,329628,329629,329632,1,4,0
94224,6,2,329634,329634,329636,0,2,2
94225,4,2,329638,329638,329640,0,2,2
94226,2,2,329640,329640,329642,0,2,0
94227,4,1,329644,329644,329645,0,1,2
94228,3,3,329647,329647,329650,0,3,2
94229,6,1,329653,329653,329654,0,1,3
94230,6,1,329659,329659,329660,0,1,5
94231,4,2,329663,329663,329665,0,2,3
94232,6,1,329669,329669,329670,0,1,4
94233,3,1,329672,329672,329673,0,1,2
94234,6,2,329678,329678,329680,0,2,5
94235,2,1,329680,329680,329681,0,1,0
94236,2,3,329682,329682,329685,0,3,1
94237,2,3,329684,329685,329688,1,4,0
94238,2,1,329686,329688,329689,2,3,0
94239,6,3,329692,329692,329695,0,3,3
94240,1,2,329693,329695,329697,2,4,0
94241,3,1,329696,329697,329698,1,2,0
94242,4,2,329700,329700,329702,0,2,2
94243,4,3,329704,329704,329707,0,3,2
94244,3,2,329707,329707,329709,0,2,0
94245,2,2,329709,329709,329711,0,2,0
94246,5,2,329714,329714,329716,0,2,3
94247,6,1,329720,329720,329721,0,1,4
94248,2,3,329722,329722,329725,0,3,1
94249,5,2,329727,329727,329729,0,2,2
94250,4,3,329731,329731,329734,0,3,2
94251,3,1,329734,329734,329735,0,1,0
94252,2,3,329736,329736,329739,0,3,1
94253,3,2,329739,329739,329741,0,2,0
94254,3,2,329742,329742,329744,0,2,1
94255,3,3,329745,329745,329748,0,3,1
94256,5,3,329750,329750,329753,0,3,2
94257,3,1,329753,329753,329754,0,1,0
94258,3,1,329756,329756,329757,0,1,2
94259,6,2,329762,329762,329764,0,2,5
94260,2,1,329764,329764,329765,0,1,0
94261,5,1,329769,329769,329770,0,1,4
94262,4,2,329773,329773,329775,0,2,3
94263,4,2,329777,329777,329779,0,2,2
94264,5,1,329782,329782,329783,0,1,3
94265,4,2,329786,329786,329788,0,2,3
94266,2,2,329788,329788,329790,0,2,0
94267,3,1,329791,329791,329792,0,1,1
94268,1,3,329792,329792,329795,0,3,0
94269,3,1,329795,329795,329796,0,1,0
94270,3,2,329798,329798,329800,0,2,2
94271,6,3,329804,329804,329807,0,3,4
94272,3,2,329807,329807,329809,0,2,0
94273,3,2,329810,329810,329812,0,2,1
94274,6,2,329816,329816,329818,0,2,4
94275,5,2,329821,329821,329823,0,2,3
94276,5,2,329826,329826,329828,0,2,3
94277,5,1,329831,329831,329832,0,1,3
94278,4,1,329835,329835,329836,0,1,3
94279,6,3,329841,329841,329844,0,3,5
94280,2,2,329843,329844,329846,1,3,0
94281,4,2,329847,329847,329849,0,2,1
94282,4,1,329851,329851,329852,0,1,2
94283,3,2,329854,329854,329856,0,2,2
94284,1,2,329855,329856,329858,1,3,0
94285,6,1,329861,329861,329862,0,1,3
94286,5,1,329866,329866,329867,0,1,4
94287,1,3,329867,329867,329870,0,3,0
94288,6,3,329873,329873,329876,0,3,3
94289,2,3,329875,329876,329879,1,4,0
94290,5,3,329880,329880,329883,0,3,1
94291,5,1,329885,329885,329886,0,1,2
94292,5,2,329890,329890,329892,0,2,4
94293,5,3,329895,329895,329898,0,3,3
94294,2,1,329897,329898,329899,1,2,0
94295,5,1,329902,329902,329903,0,1,3
94296,3,1,329905,329905,329906,0,1,2
94297,5,3,329910,329910,329913,0,3,4
94298,2,1,329912,329913,329914,1,2,0
94299,1,1,329913,329914,329915,1,2,0
94300,2,1,329915,329915,329916,0,1,0
94301,4,1,329919,329919,329920,0,1,3
94302,2,2,329921,329921,329923,0,2,1
94303,2,1,329923,329923,329924,0,1,0
94304,6,1,329929,329929,329930,0,1,5
94305,5,1,329934,329934,329935,0,1,4
94306,6,2,329940,329940,329942,0,2,5
94307,5,2,329945,329945,329947,0,2,3
94308,2,1,329947,329947,329948,0,1,0
94309,2,2,329949,329949,329951,0,2,1
94310,4,3,329953,329953,329956,0,3,2
94311,4,1,329957,329957,329958,0,1,1
94312,3,1,329960,329960,329961,0,1,2
94313,6,3,329966,329966,329969,0,3,5
94314,1,3,329967,329969,329972,2,5,0
94315,5,1,329972,329972,329973,0,1,0
94316,2,2,329974,329974,329976,0,2,1
94317,4,1,329978,329978,329979,0,1,2
94318,5,1,329983,329983,329984,0,1,4
94319,6,2,329989,329989,329991,0,2,5
94320,4,3,329993,329993,329996,0,3,2
94321,2,1,329995,329996,329997,1,2,0
94322,4,3,329999,329999,330002,0,3,2
94323,3,1,330002,330002,330003,0,1,0
94324,3,2,330005,330005,330007,0,2,2
94325,2,1,330007,330007,330008,0,1,0
94326,4,1,330011,330011,330012,0,1,3
94327,3,2,330014,330014,330016,0,2,2
94328,1,2,330015,330016,330018,1,3,0
94329,4,3,330019,330019,330022,0,3,1
94330,4,3,330023,330023,330026,0,3,1
94331,5,1,330028,330028,330029,0,1,2
94332,3,1,330031,330031,330032,0,1,2
94333,1,3,330032,330032,330035,0,3,0
94334,2,3,330034,330035,330038,1,4,0
94335,1,1,330035,330038,330039,3,4,0
94336,1,1,330036,330039,330040,3,4,0
94337,1,2,330037,330040,330042,3,5,0
94338,5,2,330042,330042,330044,0,2,0
94339,5,2,330047,330047,330049,0,2,3
94340,6,3,330053,330053,330056,0,3,4
94341,3,2,330056,330056,330058,0,2,0
94342,1,3,330057,330058,330061,1,4,0
94343,6,3,330063,330063,330066,0,3,2
94344,1,2,330064,330066,330068,2,4,0
94345,4,1,330068,330068,330069,0,1,0
94346,5,2,330073,330073,330075,0,2,4
94347,4,3,330077,330077,330080,0,3,2
94348,4,2,330081,330081,330083,0,2,1
94349,3,1,330084,330084,330085,0,1,1
94350,3,3,330087,330087,330090,0,3,2
94351,1,3,330088,330090,330093,2,5,0
94352,3,1,330091,330093,330094,2,3,0
94353,5,2,330096,330096,330098,0,2,2
94354,4,2,330100,330100,330102,0,2,2
94355,4,2,330104,330104,330106,0,2,2
94356,3,1,330107,330107,330108,0,1,1
94357,2,1,330109,330109,330110,0,1,1
94358,5,1,330114,330114,330115,0,1,4
94359,4,3,330118,330118,330121,0,3,3
94360,5,3,330123,330123,330126,0,3,2
94361,1,2,330124,330126,330128,2,4,0
94362,5,1,330129,330129,330130,0,1,1
94363,4,1,330133,330133,330134,0,1,3
94364,2,2,330135,330135,330137,0,2,1
94365,1,2,330136,330137,330139,1,3,0
94366,5,2,330141,330141,330143,0,2,2
94367,1,3,330142,330143,330146,1,4,0
94368,5,2,330147,330147,330149,0,2,1
94369,5,3,330152,330152,330155,0,3,3
94370,1,2,330153,330155,330157,2,4,0
94371,1,1,330154,330157,330158,3,4,0
94372,1,1,330155,330158,330159,3,4,0
94373,2,3,330157,330159,330162,2,5,0
94374,1,3,330158,330162,330165,4,7,0
94375,4,1,330162,330165,330166,3,4,0
94376,2,1,330164,330166,330167,2,3,0
94377,1,1,330165,330167,330168,2,3,0
94378,2,2,330167,330168,330170,1,3,0
94379,5,2,330172,330172,330174,0,2,2
94380,3,1,330175,330175,330176,0,1,1
94381,1,3,330176,330176,330179,0,3,0
94382,6,1,330182,330182,330183,0,1,3
94383,3,3,330185,330185,330188,0,3,2
94384,1,3,330186,330188,330191,2,5,0
94385,5,1,330191,330191,330192,0,1,0
94386,4,1,330195,330195,330196,0,1,3
94387,5,3,330200,330200,330203,0,3,4
94388,1,1,330201,330203,330204,2,3,0
94389,2,1,330203,330204,330205,1,2,0
94390,2,2,330205,330205,330207,0,2,0
94391,1,2,330206,330207,330209,1,3,0
94392,2,1,330208,330209,330210,1,2,0
94393,5,2,330213,330213,330215,0,2,3
94394,2,1,330215,330215,330216,0,1,0
94395,4,2,330219,330219,330221,0,2,3
94396,4,1,330223,330223,330224,0,1,2
94397,4,2,330227,330227,330229,0,2,3
94398,1,3,330228,330229,330232,1,4,0
94399,4,1,330232,330232,330233,0,1,0
94400,5,1,330237,330237,330238,0,1,4
94401,5,1,330242,330242,330243,0,1,4
94402,3,2,330245,330245,330247,0,2,2
94403,5,2,330250,330250,330252,0,2,3
94404,6,2,330256,330256,330258,0,2,4
94405,3,3,330259,330259,330262,0,3,1
94406,4,1,330263,330263,330264,0,1,1
94407,2,1,330265,330265,330266,0,1,1
94408,4,1,330269,330269,330270,0,1,3
94409,5,1,330274,330274,330275,0,1,4
94410,6,2,330280,330280,330282,0,2,5
94411,4,2,330284,330284,330286,0,2,2
94412,5,2,330289,330289,330291,0,2,3
94413,2,3,330291,330291,330294,0,3,0
94414,4,3,330295,330295,330298,0,3,1
94415,5,2,330300,330300,330302,0,2,2
94416,2,1,330302,330302,330303,0,1,0
94417,4,1,330306,330306,330307,0,1,3
94418,2,3,330308,330308,330311,0,3,1
94419,1,3,330309,330311,330314,2,5,0
94420,5,2,330314,330314,330316,0,2,0
94421,3,3,330317,330317,330320,0,3,1
94422,3,3,330320,330320,330323,0,3,0
94423,2,1,330322,330323,330324,1,2,0
94424,5,3,330327,330327,330330,0,3,3
94425,2,3,330329,330330,330333,1,4,0
94426,4,3,330333,330333,330336,0,3,0
94427,6,1,330339,330339,330340,0,1,3
94428,4,2,330343,330343,330345,0,2,3
94429,5,3,330348,330348,330351,0,3,3
94430,3,3,330351,330351,330354,0,3,0
94431,3,3,330354,330354,330357,0,3,0
94432,5,2,330359,330359,330361,0,2,2
94433,1,2,330360,330361,330363,1,3,0
94434,1,3,330361,330363,330366,2,5,0
94435,6,2,330367,330367,330369,0,2,1
94436,5,3,330372,330372,330375,0,3,3
94437,4,3,330376,330376,330379,0,3,1
94438,4,2,330380,330380,330382,0,2,1
94439,5,3,330385,330385,330388,0,3,3
94440,6,2,330391,330391,330393,0,2,3
94441,4,2,330395,330395,330397,0,2,2
94442,3,2,330398,330398,330400,0,2,1
94443,3,2,330401,330401,330403,0,2,1
94444,4,3,330405,330405,330408,0,3,2
94445,5,2,330410,330410,330412,0,2,2
94446,5,3,330415,330415,330418,0,3,3
94447,1,3,330416,330418,330421,2,5,0
94448,5,2,330421,330421,330423,0,2,0
94449,1,1,330422,330423,330424,1,2,0
94450,5,1,330427,330427,330428,0,1,3
94451,1,1,330428,330428,330429,0,1,0
94452,6,3,330434,330434,330437,0,3,5
94453,2,2,330436,330437,330439,1,3,0
94454,4,1,330440,330440,330441,0,1,1
94455,5,3,330445,330445,330448,0,3,4
94456,5,3,330450,330450,330453,0,3,2
94457,2,1,330452,330453,330454,1,2,0
94458,2,2,330454,330454,330456,0,2,0
94459,6,2,330460,330460,330462,0,2,4
94460,5,2,330465,330465,330467,0,2,3
94461,3,2,330468,330468,330470,0,2,1
94462,3,1,330471,330471,330472,0,1,1
94463,3,3,330474,330474,330477,0,3,2
94464,6,3,330480,330480,330483,0,3,3
94465,4,2,330484,330484,330486,0,2,1
94466,3,1,330487,330487,330488,0,1,1
94467,3,1,330490,330490,330491,0,1,2
94468,4,2,330494,330494,330496,0,2,3
94469,3,3,330497,330497,330500,0,3,1
94470,6,1,330503,330503,330504,0,1,3
94471,5,1,330508,330508,330509,0,1,4
94472,3,2,330511,330511,330513,0,2,2
94473,5,1,330516,330516,330517,0,1,3
94474,4,1,330520,330520,330521,0,1,3
94475,5,3,330525,330525,330528,0,3,4
94476,3,2,330528,330528,330530,0,2,0
94477,4,1,330532,330532,330533,0,1,2
94478,4,3,330536,330536,330539,0,3,3
94479,2,1,330538,330539,330540,1,2,0
94480,6,1,330544,330544,330545,0,1,4
94481,2,3,330546,330546,330549,0,3,1
94482,2,1,330548,330549,330550,1,2,0
94483,3,1,330551,330551,330552,0,1,1
94484,5,2,330556,330556,330558,0,2,4
94485,3,2,330559,330559,330561,0,2,1
94486,5,2,330564,330564,330566,0,2,3
94487,5,3,330569,330569,330572,0,3,3
94488,6,1,330575,330575,330576,0,1,3
94489,5,2,330580,330580,330582,0,2,4
94490,6,1,330586,330586,330587,0,1,4
94491,4,3,330590,330590,330593,0,3,3
94492,6,2,330596,330596,330598,0,2,3
94493,4,3,330600,330600,330603,0,3,2
94494,5,2,330605,330605,330607,0,2,2
94495,6,1,330611,330611,330612,0,1,4
94496,6,2,330617,330617,330619,0,2,5
94497,5,3,330622,330622,330625,0,3,3
94498,3,3,330625,330625,330628,0,3,0
94499,2,1,330627,330628,330629,1,2,0
94500,3,1,330630,330630,330631,0,1,1
94501,2,3,330632,330632,330635,0,3,1
94502,4,1,330636,330636,330637,0,1,1
94503,2,3,330638,330638,330641,0,3,1
94504,6,2,330644,330644,330646,0,2,3
94505,5,3,330649,330649,330652,0,3,3
94506,3,1,330652,330652,330653,0,1,0
94507,3,2,330655,330655,330657,0,2,2
94508,1,3,330656,330657,330660,1,4,0
94509,5,1,330661,330661,330662,0,1,1
94510,6,2,330667,330667,330669,0,2,5
94511,4,2,330671,330671,330673,0,2,2
94512,2,2,330673,330673,330675,0,2,0
94513,6,2,330679,330679,330681,0,2,4
94514,5,3,330684,330684,330687,0,3,3
94515,1,3,330685,330687,330690,2,5,0
94516,6,2,330691,330691,330693,0,2,1
94517,4,3,330695,330695,330698,0,3,2
94518,3,1,330698,330698,330699,0,1,0
94519,4,1,330702,330702,330703,0,1,3
94520,2,1,330704,330704,330705,0,1,1
94521,2,3,330706,330706,330709,0,3,1
94522,4,3,330710,330710,330713,0,3,1
94523,2,2,330712,330713,330715,1,3,0
94524,6,3,330718,330718,330721,0,3,3
94525,3,2,330721,330721,330723,0,2,0
94526,2,3,330723,330723,330726,0,3,0
94527,1,1,330724,330726,330727,2,3,0
94528,4,1,330728,330728,330729,0,1,1
94529,3,1,330731,330731,330732,0,1,2
94530,4,2,330735,330735,330737,0,2,3
94531,1,3,330736,330737,330740,1,4,0
94532,1,1,330737,330740,330741,3,4,0
94533,3,1,330740,330741,330742,1,2,0
94534,1,1,330741,330742,330743,1,2,0
94535,4,3,330745,330745,330748,0,3,2
94536,3,3,330748,330748,330751,0,3,0
94537,4,1,330752,330752,330753,0,1,1
94538,2,3,330754,330754,330757,0,3,1
94539,3,3,330757,330757,330760,0,3,0
94540,3,2,330760,330760,330762,0,2,0
94541,1,1,330761,330762,330763,1,2,0
94542,4,3,330765,330765,330768,0,3,2
94543,1,2,330766,330768,330770,2,4,0
94544,1,2,330767,330770,330772,3,5,0
94545,5,1,330772,330772,330773,0,1,0
94546,3,1,330775,330775,330776,0,1,2
94547,5,3,330780,330780,330783,0,3,4
94548,6,2,330786,330786,330788,0,2,3
94549,4,3,330790,330790,330793,0,3,2
94550,3,2,330793,330793,330795,0,2,0
94551,6,1,330799,330799,330800,0,1,4
94552,3,3,330802,330802,330805,0,3,2
94553,1,3,330803,330805,330808,2,5,0
94554,5,2,330808,330808,330810,0,2,0
94555,5,1,330813,330813,330814,0,1,3
94556,2,2,330815,330815,330817,0,2,1
94557,1,3,330816,330817,330820,1,4,0
94558,1,3,330817,330820,330823,3,6,0
94559,3,3,330820,330823,330826,3,6,0
94560,4,1,330824,330826,330827,2,3,0
94561,6,2,330830,330830,330832,0,2,3
94562,4,2,330834,330834,330836,0,2,2
94563,6,2,330840,330840,330842,0,2,4
94564,3,2,330843,330843,330845,0,2,1
94565,3,1,330846,330846,330847,0,1,1
94566,1,1,330847,330847,330848,0,1,0
94567,4,1,330851,330851,330852,0,1,3
94568,5,1,330856,330856,330857,0,1,4
94569,5,2,330861,330861,330863,0,2,4
94570,6,3,330867,330867,330870,0,3,4
94571,3,2,330870,330870,330872,0,2,0
94572,1,2,330871,330872,330874,1,3,0
94573,1,3,330872,330874,330877,2,5,0
94574,1,1,330873,330877,330878,4,5,0
94575,2,2,330875,330878,330880,3,5,0
94576,3,1,330878,330880,330881,2,3,0
94577,3,2,330881,330881,330883,0,2,0
94578,6,2,330887,330887,330889,0,2,4
94579,2,1,330889,330889,330890,0,1,0
94580,4,2,330893,330893,330895,0,2,3
94581,5,1,330898,330898,330899,0,1,3
94582,6,3,330904,330904,330907,0,3,5
94583,3,2,330907,330907,330909,0,2,0
94584,6,2,330913,330913,330915,0,2,4
94585,4,3,330917,330917,330920,0,3,2
94586,5,3,330922,330922,330925,0,3,2
94587,1,3,330923,330925,330928,2,5,0
94588,1,1,330924,330928,330929,4,5,0
94589,6,2,330930,330930,330932,0,2,1
94590,4,1,330934,330934,330935,0,1,2
94591,4,1,330938,330938,330939,0,1,3
94592,4,1,330942,330942,330943,0,1,3
94593,5,3,330947,330947,330950,0,3,4
94594,6,3,330953,330953,330956,0,3,3
94595,5,3,330958,330958,330961,0,3,2
94596,3,3,330961,330961,330964,0,3,0
94597,2,3,330963,330964,330967,1,4,0
94598,1,1,330964,330967,330968,3,4,0
94599,3,3,330967,330968,330971,1,4,0
94600,3,1,330970,330971,330972,1,2,0
94601,5,2,330975,330975,330977,0,2,3
94602,3,1,330978,330978,330979,0,1,1
94603,6,2,330984,330984,330986,0,2,5
94604,1,1,330985,330986,330987,1,2,0
94605,6,1,330991,330991,330992,0,1,4
94606,3,3,330994,330994,330997,0,3,2
94607,3,1,330997,330997,330998,0,1,0
94608,4,1,331001,331001,331002,0,1,3
94609,5,3,331006,331006,331009,0,3,4
94610,2,3,331008,331009,331012,1,4,0
94611,2,1,331010,331012,331013,2,3,0
94612,5,1,331015,331015,331016,0,1,2
94613,1,1,331016,331016,331017,0,1,0
94614,1,3,331017,331017,331020,0,3,0
94615,5,2,331022,331022,331024,0,2,2
94616,5,2,331027,331027,331029,0,2,3
94617,1,1,331028,331029,331030,1,2,0
94618,1,2,331029,331030,331032,1,3,0
94619,1,2,331030,331032,331034,2,4,0
94620,3,2,331033,331034,331036,1,3,0
94621,6,1,331039,331039,331040,0,1,3
94622,1,3,331040,331040,331043,0,3,0
94623,6,3,331046,331046,331049,0,3,3
94624,1,1,331047,331049,331050,2,3,0
94625,2,3,331049,331050,331053,1,4,0
94626,2,2,331051,331053,331055,2,4,0
94627,3,2,331054,331055,331057,1,3,0
94628,4,1,331058,331058,331059,0,1,1
94629,3,1,331061,331061,331062,0,1,2
94630,2,3,331063,331063,331066,0,3,1
94631,5,2,331068,331068,331070,0,2,2
94632,6,1,331074,331074,331075,0,1,4
94633,6,3,331080,331080,331083,0,3,5
94634,1,3,331081,331083,331086,2,5,0
94635,1,1,331082,331086,331087,4,5,0
94636,6,3,331088,331088,331091,0,3,1
94637,6,1,331094,331094,331095,0,1,3
94638,3,1,331097,331097,331098,0,1,2
94639,2,3,331099,331099,331102,0,3,1
94640,1,1,331100,331102,331103,2,3,0
94641,3,1,331103,331103,331104,0,1,0
94642,6,3,331109,331109,331112,0,3,5
94643,3,2,331112,331112,331114,0,2,0
94644,5,1,331117,331117,331118,0,1,3
94645,6,3,331123,331123,331126,0,3,5
94646,5,3,331128,331128,331131,0,3,2
94647,4,3,331132,331132,331135,0,3,1
94648,4,2,331136,331136,331138,0,2,1
94649,4,1,331140,331140,331141,0,1,2
94650,5,3,331145,331145,331148,0,3,4
94651,6,1,331151,331151,331152,0,1,3
94652,5,1,331156,331156,331157,0,1,4
94653,2,3,331158,331158,331161,0,3,1
94654,2,1,331160,331161,331162,1,2,0
94655,4,2,331164,331164,331166,0,2,2
94656,4,2,331168,331168,331170,0,2,2
94657,2,2,331170,331170,331172,0,2,0
94658,5,3,331175,331175,331178,0,3,3
94659,6,3,331181,331181,331184,0,3,3
94660,4,1,331185,331185,331186,0,1,1
94661,3,3,331188,331188,331191,0,3,2
94662,2,2,331190,331191,331193,1,3,0
94663,6,1,331196,331196,331197,0,1,3
94664,2,3,331198,331198,331201,0,3,1
94665,1,1,331199,331201,331202,2,3,0
94666,6,1,331205,331205,331206,0,1,3
94667,3,2,331208,331208,331210,0,2,2
94668,1,2,331209,331210,331212,1,3,0
94669,1,2,331210,331212,331214,2,4,0
94670,6,2,331216,331216,331218,0,2,2
94671,1,1,331217,331218,331219,1,2,0
94672,6,1,331223,331223,331224,0,1,4
94673,1,1,331224,331224,331225,0,1,0
94674,6,1,331230,331230,331231,0,1,5
94675,6,1,331236,331236,331237,0,1,5
94676,2,1,331238,331238,331239,0,1,1
94677,4,1,331242,331242,331243,0,1,3
94678,6,1,331248,331248,331249,0,1,5
94679,2,1,331250,331250,331251,0,1,1
94680,6,1,331256,331256,331257,0,1,5
94681,1,2,331257,331257,331259,0,2,0
94682,4,3,331261,331261,331264,0,3,2
94683,3,1,331264,331264,331265,0,1,0
94684,6,2,331270,331270,331272,0,2,5
94685,1,2,331271,331272,331274,1,3,0
94686,5,3,331276,331276,331279,0,3,2
94687,2,3,331278,331279,331282,1,4,0
94688,6,1,331284,331284,331285,0,1,2
94689,4,3,331288,331288,331291,0,3,3
94690,4,1,331292,331292,331293,0,1,1
94691,3,3,331295,331295,331298,0,3,2
94692,5,1,331300,331300,331301,0,1,2
94693,1,3,331301,331301,331304,0,3,0
94694,2,2,331303,331304,331306,1,3,0
94695,6,2,331309,331309,331311,0,2,3
94696,6,1,331315,331315,331316,0,1,4
94697,6,2,331321,331321,331323,0,2,5
94698,4,2,331325,331325,331327,0,2,2
94699,4,1,331329,331329,331330,0,1,2
94700,2,3,331331,331331,331334,0,3,1
94701,3,1,331334,331334,331335,0,1,0
94702,2,2,331336,331336,331338,0,2,1
94703,5,1,331341,331341,331342,0,1,3
94704,5,2,331346,331346,331348,0,2,4
94705,3,3,331349,331349,331352,0,3,1
94706,3,3,331352,331352,331355,0,3,0
94707,3,2,331355,331355,331357,0,2,0
94708,6,3,331361,331361,331364,0,3,4
94709,4,3,331365,331365,331368,0,3,1
94710,5,2,331370,331370,331372,0,2,2
94711,6,1,331376,331376,331377,0,1,4
94712,1,2,331377,331377,331379,0,2,0
94713,6,1,331383,331383,331384,0,1,4
94714,5,1,331388,331388,331389,0,1,4
94715,1,3,331389,331389,331392,0,3,0
94716,5,3,331394,331394,331397,0,3,2
94717,2,1,331396,331397,331398,1,2,0
94718,5,2,331401,331401,331403,0,2,3
94719,4,2,331405,331405,331407,0,2,2
94720,1,1,331406,331407,331408,1,2,0
94721,1,1,331407,331408,331409,1,2,0
94722,4,2,331411,331411,331413,0,2,2
94723,6,1,331417,331417,331418,0,1,4
94724,5,2,331422,331422,331424,0,2,4
94725,2,2,331424,331424,331426,0,2,0
94726,4,3,331428,331428,331431,0,3,2
94727,5,3,331433,331433,331436,0,3,2
94728,1,2,331434,331436,331438,2,4,0
94729,6,3,331440,331440,331443,0,3,2
94730,6,2,331446,331446,331448,0,2,3
94731,4,2,331450,331450,331452,0,2,2
94732,6,1,331456,331456,331457,0,1,4
94733,6,3,331462,331462,331465,0,3,5
94734,1,3,331463,331465,331468,2,5,0
94735,1,1,331464,331468,331469,4,5,0
94736,2,1,331466,331469,331470,3,4,0
94737,4,1,331470,331470,331471,0,1,0
94738,5,3,331475,331475,331478,0,3,4
94739,2,1,331477,331478,331479,1,2,0
94740,6,1,331483,331483,331484,0,1,4
94741,1,3,331484,331484,331487,0,3,0
94742,3,3,331487,331487,331490,0,3,0
94743,6,2,331493,331493,331495,0,2,3
94744,2,2,331495,331495,331497,0,2,0
94745,3,3,331498,331498,331501,0,3,1
94746,6,3,331504,331504,331507,0,3,3
94747,4,3,331508,331508,331511,0,3,1
94748,1,1,331509,331511,331512,2,3,0
94749,3,3,331512,331512,331515,0,3,0
94750,4,2,331516,331516,331518,0,2,1
94751,3,2,331519,331519,331521,0,2,1
94752,6,2,331525,331525,331527,0,2,4
94753,2,1,331527,331527,331528,0,1,0
94754,2,2,331529,331529,331531,0,2,1
94755,6,1,331535,331535,331536,0,1,4
94756,3,3,331538,331538,331541,0,3,2
94757,2,1,331540,331541,331542,1,2,0
94758,3,3,331543,331543,331546,0,3,1
94759,4,3,331547,331547,331550,0,3,1
94760,3,1,331550,331550,331551,0,1,0
94761,3,2,331553,331553,331555,0,2,2
94762,4,1,331557,331557,331558,0,1,2
94763,1,3,331558,331558,331561,0,3,0
94764,5,3,331563,331563,331566,0,3,2
94765,1,2,331564,331566,331568,2,4,0
94766,1,2,331565,331568,331570,3,5,0
94767,1,3,331566,331570,331573,4,7,0
94768,6,2,331572,331573,331575,1,3,0
94769,3,2,331575,331575,331577,0,2,0
94770,4,2,331579,331579,331581,0,2,2
94771,5,2,331584,331584,331586,0,2,3
94772,1,2,331585,331586,331588,1,3,0
94773,3,3,331588,331588,331591,0,3,0
94774,3,3,331591,331591,331594,0,3,0
94775,1,1,331592,331594,331595,2,3,0
94776,2,1,331594,331595,331596,1,2,0
94777,4,2,331598,331598,331600,0,2,2
94778,2,3,331600,331600,331603,0,3,0
94779,3,1,331603,331603,331604,0,1,0
94780,5,3,331608,331608,331611,0,3,4
94781,3,2,331611,331611,331613,0,2,0
94782,5,2,331616,331616,331618,0,2,3
94783,3,3,331619,331619,331622,0,3,1
94784,3,1,331622,331622,331623,0,1,0
94785,1,3,331623,331623,331626,0,3,0
94786,6,2,331629,331629,331631,0,2,3
94787,4,2,331633,331633,331635,0,2,2
94788,1,2,331634,331635,331637,1,3,0
94789,1,3,331635,331637,331640,2,5,0
94790,1,3,331636,331640,331643,4,7,0
94791,5,1,331641,331643,331644,2,3,0
94792,3,1,331644,331644,331645,0,1,0
94793,5,1,331649,331649,331650,0,1,4
94794,6,2,331655,331655,331657,0,2,5
94795,1,1,331656,331657,331658,1,2,0
94796,6,2,331662,331662,331664,0,2,4
94797,4,2,331666,331666,331668,0,2,2
94798,3,2,331669,331669,331671,0,2,1
94799,5,1,331674,331674,331675,0,1,3
94800,2,3,331676,331676,331679,0,3,1
94801,2,3,331678,331679,331682,1,4,0
94802,4,2,331682,331682,331684,0,2,0
94803,4,3,331686,331686,331689,0,3,2
94804,3,3,331689,331689,331692,0,3,0
94805,4,1,331693,331693,331694,0,1,1
94806,5,3,331698,331698,331701,0,3,4
94807,2,2,331700,331701,331703,1,3,0
94808,4,1,331704,331704,331705,0,1,1
94809,4,3,331708,331708,331711,0,3,3
94810,2,1,331710,331711,331712,1,2,0
94811,2,3,331712,331712,331715,0,3,0
94812,3,1,331715,331715,331716,0,1,0
94813,6,3,331721,331721,331724,0,3,5
94814,1,3,331722,331724,331727,2,5,0
94815,1,3,331723,331727,331730,4,7,0
94816,1,3,331724,331730,331733,6,9,0
94817,4,1,331728,331733,331734,5,6,0
94818,2,2,331730,331734,331736,4,6,0
94819,5,1,331735,331736,331737,1,2,0
94820,2,1,331737,331737,331738,0,1,0
94821,2,2,331739,331739,331741,0,2,1
94822,2,2,331741,331741,331743,0,2,0
94823,5,1,331746,331746,331747,0,1,3
94824,6,2,331752,331752,331754,0,2,5
94825,6,3,331758,331758,331761,0,3,4
94826,5,1,331763,331763,331764,0,1,2
94827,2,1,331765,331765,331766,0,1,1
94828,6,3,331771,331771,331774,0,3,5
94829,1,2,331772,331774,331776,2,4,0
94830,2,1,331774,331776,331777,2,3,0
94831,2,2,331776,331777,331779,1,3,0
94832,1,1,331777,331779,331780,2,3,0
94833,4,1,331781,331781,331782,0,1,1
94834,2,2,331783,331783,331785,0,2,1
94835,2,2,331785,331785,331787,0,2,0
94836,3,2,331788,331788,331790,0,2,1
94837,2,2,331790,331790,331792,0,2,0
94838,6,1,331796,331796,331797,0,1,4
94839,3,3,331799,331799,331802,0,3,2
94840,3,2,331802,331802,331804,0,2,0
94841,6,2,331808,331808,331810,0,2,4
94842,4,3,331812,331812,331815,0,3,2
94843,5,3,331817,331817,331820,0,3,2
94844,5,1,331822,331822,331823,0,1,2
94845,2,3,331824,331824,331827,0,3,1
94846,4,1,331828,331828,331829,0,1,1
94847,2,2,331830,331830,331832,0,2,1
94848,5,1,331835,331835,331836,0,1,3
94849,1,1,331836,331836,331837,0,1,0
94850,2,3,331838,331838,331841,0,3,1
94851,5,3,331843,331843,331846,0,3,2
94852,6,3,331849,331849,331852,0,3,3
94853,6,1,331855,331855,331856,0,1,3
94854,2,3,331857,331857,331860,0,3,1
94855,3,2,331860,331860,331862,0,2,0
94856,2,3,331862,331862,331865,0,3,0
94857,4,1,331866,331866,331867,0,1,1
94858,5,2,331871,331871,331873,0,2,4
94859,4,3,331875,331875,331878,0,3,2
94860,2,2,331877,331878,331880,1,3,0
94861,3,2,331880,331880,331882,0,2,0
94862,4,3,331884,331884,331887,0,3,2
94863,6,1,331890,331890,331891,0,1,3
94864,1,2,331891,331891,331893,0,2,0
94865,2,3,331893,331893,331896,0,3,0
94866,6,3,331899,331899,331902,0,3,3
94867,1,3,331900,331902,331905,2,5,0
94868,2,2,331902,331905,331907,3,5,0
94869,6,1,331908,331908,331909,0,1,1
94870,1,3,331909,331909,331912,0,3,0
94871,3,3,331912,331912,331915,0,3,0
94872,4,3,331916,331916,331919,0,3,1
94873,2,1,331918,331919,331920,1,2,0
94874,4,2,331922,331922,331924,0,2,2
94875,5,2,331927,331927,331929,0,2,3
94876,4,2,331931,331931,331933,0,2,2
94877,6,1,331937,331937,331938,0,1,4
94878,4,1,331941,331941,331942,0,1,3
94879,5,1,331946,331946,331947,0,1,4
94880,5,1,331951,331951,331952,0,1,4
94881,1,1,331952,331952,331953,0,1,0
94882,1,2,331953,331953,331955,0,2,0
94883,5,3,331958,331958,331961,0,3,3
94884,6,1,331964,331964,331965,0,1,3
94885,3,1,331967,331967,331968,0,1,2
94886,6,1,331973,331973,331974,0,1,5
94887,1,2,331974,331974,331976,0,2,0
94888,6,3,331980,331980,331983,0,3,4
94889,2,3,331982,331983,331986,1,4,0
94890,2,3,331984,331986,331989,2,5,0
94891,1,2,331985,331989,331991,4,6,0
94892,5,2,331990,331991,331993,1,3,0
94893,1,3,331991,331993,331996,2,5,0
94894,4,1,331995,331996,331997,1,2,0
94895,1,2,331996,331997,331999,1,3,0
94896,5,3,332001,332001,332004,0,3,2
94897,6,1,332007,332007,332008,0,1,3
94898,3,3,332010,332010,332013,0,3,2
94899,1,2,332011,332013,332015,2,4,0
94900,1,1,332012,332015,332016,3,4,0
94901,3,3,332015,332016,332019,1,4,0
94902,3,3,332018,332019,332022,1,4,0
94903,4,3,332022,332022,332025,0,3,0
94904,3,3,332025,332025,332028,0,3,0
94905,1,3,332026,332028,332031,2,5,0
94906,6,2,332032,332032,332034,0,2,1
94907,3,1,332035,332035,332036,0,1,1
94908,4,2,332039,332039,332041,0,2,3
94909,6,2,332045,332045,332047,0,2,4
94910,4,3,332049,332049,332052,0,3,2
94911,6,3,332055,332055,332058,0,3,3
94912,6,1,332061,332061,332062,0,1,3
94913,1,3,332062,332062,332065,0,3,0
94914,1,3,332063,332065,332068,2,5,0
94915,3,2,332066,332068,332070,2,4,0
94916,3,2,332069,332070,332072,1,3,0
94917,1,1,332070,332072,332073,2,3,0
94918,6,3,332076,332076,332079,0,3,3
94919,2,3,332078,332079,332082,1,4,0
94920,2,3,332080,332082,332085,2,5,0
94921,4,3,332084,332085,332088,1,4,0
94922,4,1,332088,332088,332089,0,1,0
94923,1,2,332089,332089,332091,0,2,0
94924,1,2,332090,332091,332093,1,3,0
94925,6,3,332096,332096,332099,0,3,3
94926,6,2,332102,332102,332104,0,2,3
94927,3,1,332105,332105,332106,0,1,1
94928,6,3,332111,332111,332114,0,3,5
94929,4,1,332115,332115,332116,0,1,1
94930,1,3,332116,332116,332119,0,3,0
94931,3,2,332119,332119,332121,0,2,0
94932,2,3,332121,332121,332124,0,3,0
94933,3,2,332124,332124,332126,0,2,0
94934,3,1,332127,332127,332128,0,1,1
94935,6,3,332133,332133,332136,0,3,5
94936,3,1,332136,332136,332137,0,1,0
94937,1,3,332137,332137,332140,0,3,0
94938,1,2,332138,332140,332142,2,4,0
94939,6,2,332144,332144,332146,0,2,2
94940,6,3,332150,332150,332153,0,3,4
94941,4,2,332154,332154,332156,0,2,1
94942,5,2,332159,332159,332161,0,2,3
94943,2,1,332161,332161,332162,0,1,0
94944,4,2,332165,332165,332167,0,2,3
94945,5,3,332170,332170,332173,0,3,3
94946,1,1,332171,332173,332174,2,3,0
94947,3,2,332174,332174,332176,0,2,0
94948,1,2,332175,332176,332178,1,3,0
94949,2,2,332177,332178,332180,1,3,0
94950,4,2,332181,332181,332183,0,2,1
94951,1,2,332182,332183,332185,1,3,0
94952,3,3,332185,332185,332188,0,3,0
94953,4,3,332189,332189,332192,0,3,1
94954,5,2,332194,332194,332196,0,2,2
94955,6,2,332200,332200,332202,0,2,4
94956,3,2,332203,332203,332205,0,2,1
94957,5,3,332208,332208,332211,0,3,3
94958,2,1,332210,332211,332212,1,2,0
94959,2,2,332212,332212,332214,0,2,0
94960,3,2,332215,332215,332217,0,2,1
94961,3,3,332218,332218,332221,0,3,1
94962,4,1,332222,332222,332223,0,1,1
94963,1,1,332223,332223,332224,0,1,0
94964,4,3,332227,332227,332230,0,3,3
94965,5,3,332232,332232,332235,0,3,2
94966,4,3,332236,332236,332239,0,3,1
94967,1,1,332237,332239,332240,2,3,0
94968,3,1,332240,332240,332241,0,1,0
94969,3,1,332243,332243,332244,0,1,2
94970,3,3,332246,332246,332249,0,3,2
94971,3,2,332249,332249,332251,0,2,0
94972,2,1,332251,332251,332252,0,1,0
94973,5,3,332256,332256,332259,0,3,4
94974,4,3,332260,332260,332263,0,3,1
94975,6,3,332266,332266,332269,0,3,3
94976,2,1,332268,332269,332270,1,2,0
94977,6,1,332274,332274,332275,0,1,4
94978,1,2,332275,332275,332277,0,2,0
94979,1,1,332276,332277,332278,1,2,0
94980,6,3,332282,332282,332285,0,3,4
94981,2,3,332284,332285,332288,1,4,0
94982,1,3,332285,332288,332291,3,6,0
94983,1,1,332286,332291,332292,5,6,0
94984,6,3,332292,332292,332295,0,3,0
94985,6,2,332298,332298,332300,0,2,3
94986,2,1,332300,332300,332301,0,1,0
94987,5,2,332305,332305,332307,0,2,4
94988,5,1,332310,332310,332311,0,1,3
94989,6,2,332316,332316,332318,0,2,5
94990,6,1,332322,332322,332323,0,1,4
94991,5,1,332327,332327,332328,0,1,4
94992,6,2,332333,332333,332335,0,2,5
94993,2,3,332335,332335,332338,0,3,0
94994,3,1,332338,332338,332339,0,1,0
94995,5,3,332343,332343,332346,0,3,4
94996,3,2,332346,332346,332348,0,2,0
94997,1,3,332347,332348,332351,1,4,0
94998,2,1,332349,332351,332352,2,3,0
94999,4,1,332353,332353,332354,0,1,1
95000,3,2,332356,332356,332358,0,2,2
95001,1,1,332357,332358,332359,1,2,0
95002,6,3,332363,332363,332366,0,3,4
95003,3,1,332366,332366,332367,0,1,0
95004,3,3,332369,332369,332372,0,3,2
95005,4,2,332373,332373,332375,0,2,1
95006,1,3,332374,332375,332378,1,4,0
95007,5,2,332379,332379,332381,0,2,1
95008,2,3,332381,332381,332384,0,3,0
95009,1,3,332382,332384,332387,2,5,0
95010,6,2,332388,332388,332390,0,2,1
95011,6,2,332394,332394,332396,0,2,4
95012,3,3,332397,332397,332400,0,3,1
95013,4,3,332401,332401,332404,0,3,1
95014,3,3,332404,332404,332407,0,3,0
95015,6,3,332410,332410,332413,0,3,3
95016,3,3,332413,332413,332416,0,3,0
95017,4,1,332417,332417,332418,0,1,1
95018,3,3,332420,332420,332423,0,3,2
95019,1,1,332421,332423,332424,2,3,0
95020,5,1,332426,332426,332427,0,1,2
95021,4,1,332430,332430,332431,0,1,3
95022,4,1,332434,332434,332435,0,1,3
95023,6,1,332440,332440,332441,0,1,5
95024,5,1,332445,332445,332446,0,1,4
95025,1,1,332446,332446,332447,0,1,0
95026,3,1,332449,332449,332450,0,1,2
95027,2,3,332451,332451,332454,0,3,1
95028,4,1,332455,332455,332456,0,1,1
95029,5,1,332460,332460,332461,0,1,4
95030,2,1,332462,332462,332463,0,1,1
95031,4,3,332466,332466,332469,0,3,3
95032,6,3,332472,332472,332475,0,3,3
95033,5,1,332477,332477,332478,0,1,2
95034,5,2,332482,332482,332484,0,2,4
95035,5,1,332487,332487,332488,0,1,3
95036,2,1,332489,332489,332490,0,1,1
95037,3,3,332492,332492,332495,0,3,2
95038,4,1,332496,332496,332497,0,1,1
95039,1,3,332497,332497,332500,0,3,0
95040,3,2,332500,332500,332502,0,2,0
95041,1,3,332501,332502,332505,1,4,0
95042,4,1,332505,332505,332506,0,1,0
95043,4,1,332509,332509,332510,0,1,3
95044,1,3,332510,332510,332513,0,3,0
95045,3,3,332513,332513,332516,0,3,0
95046,4,1,332517,332517,332518,0,1,1
95047,4,3,332521,332521,332524,0,3,3
95048,4,3,332525,332525,332528,0,3,1
95049,3,2,332528,332528,332530,0,2,0
95050,5,1,332533,332533,332534,0,1,3
95051,6,3,332539,332539,332542,0,3,5
95052,5,2,332544,332544,332546,0,2,2
95053,1,3,332545,332546,332549,1,4,0
95054,3,1,332548,332549,332550,1,2,0
95055,6,3,332554,332554,332557,0,3,4
95056,1,3,332555,332557,332560,2,5,0
95057,2,1,332557,332560,332561,3,4,0
95058,4,2,332561,332561,332563,0,2,0
95059,5,2,332566,332566,332568,0,2,3
95060,1,2,332567,332568,332570,1,3,0
95061,4,3,332571,332571,332574,0,3,1
95062,2,2,332573,332574,332576,1,3,0
95063,4,1,332577,332577,332578,0,1,1
95064,1,1,332578,332578,332579,0,1,0
95065,4,2,332582,332582,332584,0,2,3
95066,4,3,332586,332586,332589,0,3,2
95067,1,1,332587,332589,332590,2,3,0
95068,5,3,332592,332592,332595,0,3,2
95069,3,2,332595,332595,332597,0,2,0
95070,1,3,332596,332597,332600,1,4,0
95071,6,3,332602,332602,332605,0,3,2
95072,5,1,332607,332607,332608,0,1,2
95073,6,3,332613,332613,332616,0,3,5
95074,4,2,332617,332617,332619,0,2,1
95075,2,2,332619,332619,332621,0,2,0
95076,3,1,332622,332622,332623,0,1,1
95077,1,1,332623,332623,332624,0,1,0
95078,1,2,332624,332624,332626,0,2,0
95079,5,2,332629,332629,332631,0,2,3
95080,3,2,332632,332632,332634,0,2,1
95081,5,2,332637,332637,332639,0,2,3
95082,3,2,332640,332640,332642,0,2,1
95083,1,2,332641,332642,332644,1,3,0
95084,1,2,332642,332644,332646,2,4,0
95085,3,2,332645,332646,332648,1,3,0
95086,2,1,332647,332648,332649,1,2,0
95087,2,2,332649,332649,332651,0,2,0
95088,1,1,332650,332651,332652,1,2,0
95089,3,1,332653,332653,332654,0,1,1
95090,4,1,332657,332657,332658,0,1,3
95091,1,2,332658,332658,332660,0,2,0
95092,1,2,332659,332660,332662,1,3,0
95093,4,1,332663,332663,332664,0,1,1
95094,2,1,332665,332665,332666,0,1,1
95095,5,1,332670,332670,332671,0,1,4
95096,5,1,332675,332675,332676,0,1,4
95097,2,2,332677,332677,332679,0,2,1
95098,4,3,332681,332681,332684,0,3,2
95099,3,3,332684,332684,332687,0,3,0
95100,5,2,332689,332689,332691,0,2,2
95101,6,2,332695,332695,332697,0,2,4
95102,4,1,332699,332699,332700,0,1,2
95103,4,1,332703,332703,332704,0,1,3
95104,2,1,332705,332705,332706,0,1,1
95105,3,1,332708,332708,332709,0,1,2
95106,3,1,332711,332711,332712,0,1,2
95107,6,3,332717,332717,332720,0,3,5
95108,5,3,332722,332722,332725,0,3,2
95109,2,3,332724,332725,332728,1,4,0
95110,1,2,332725,332728,332730,3,5,0
95111,6,3,332731,332731,332734,0,3,1
95112,1,1,332732,332734,332735,2,3,0
95113,3,2,332735,332735,332737,0,2,0
95114,4,1,332739,332739,332740,0,1,2
95115,1,1,332740,332740,332741,0,1,0
95116,4,1,332744,332744,332745,0,1,3
95117,3,3,332747,332747,332750,0,3,2
95118,2,2,332749,332750,332752,1,3,0
95119,4,2,332753,332753,332755,0,2,1
95120,1,1,332754,332755,332756,1,2,0
95121,3,3,332757,332757,332760,0,3,1
95122,4,2,332761,332761,332763,0,2,1
95123,2,1,332763,332763,332764,0,1,0
95124,5,1,332768,332768,332769,0,1,4
95125,1,3,332769,332769,332772,0,3,0
95126,4,3,332773,332773,332776,0,3,1
95127,4,2,332777,332777,332779,0,2,1
95128,6,1,332783,332783,332784,0,1,4
95129,4,2,332787,332787,332789,0,2,3
95130,3,1,332790,332790,332791,0,1,1
95131,4,3,332794,332794,332797,0,3,3
95132,1,3,332795,332797,332800,2,5,0
95133,1,1,332796,332800,332801,4,5,0
95134,5,2,332801,332801,332803,0,2,0
95135,2,2,332803,332803,332805,0,2,0
95136,3,2,332806,332806,332808,0,2,1
95137,1,2,332807,332808,332810,1,3,0
95138,5,3,332812,332812,332815,0,3,2
95139,5,3,332817,332817,332820,0,3,2
95140,5,2,332822,332822,332824,0,2,2
95141,6,3,332828,332828,332831,0,3,4
95142,4,3,332832,332832,332835,0,3,1
95143,1,3,332833,332835,332838,2,5,0
95144,4,2,332837,332838,332840,1,3,0
95145,1,1,332838,332840,332841,2,3,0
95146,5,3,332843,332843,332846,0,3,2
95147,4,2,332847,332847,332849,0,2,1
95148,4,2,332851,332851,332853,0,2,2
95149,6,3,332857,332857,332860,0,3,4
95150,1,1,332858,332860,332861,2,3,0
95151,1,3,332859,332861,332864,2,5,0
95152,2,2,332861,332864,332866,3,5,0
95153,2,3,332863,332866,332869,3,6,0
95154,3,3,332866,332869,332872,3,6,0
95155,2,2,332868,332872,332874,4,6,0
95156,5,2,332873,332874,332876,1,3,0
95157,6,3,332879,332879,332882,0,3,3
95158,6,1,332885,332885,332886,0,1,3
95159,5,1,332890,332890,332891,0,1,4
95160,1,1,332891,332891,332892,0,1,0
95161,1,1,332892,332892,332893,0,1,0
95162,1,3,332893,332893,332896,0,3,0
95163,5,3,332898,332898,332901,0,3,2
95164,4,2,332902,332902,332904,0,2,1
95165,6,2,332908,332908,332910,0,2,4
95166,1,1,332909,332910,332911,1,2,0
95167,2,1,332911,332911,332912,0,1,0
95168,4,2,332915,332915,332917,0,2,3
95169,3,1,332918,332918,332919,0,1,1
95170,4,1,332922,332922,332923,0,1,3
95171,4,1,332926,332926,332927,0,1,3
95172,6,3,332932,332932,332935,0,3,5
95173,3,1,332935,332935,332936,0,1,0
95174,1,3,332936,332936,332939,0,3,0
95175,1,1,332937,332939,332940,2,3,0
95176,1,2,332938,332940,332942,2,4,0
95177,4,2,332942,332942,332944,0,2,0
95178,6,3,332948,332948,332951,0,3,4
95179,6,3,332954,332954,332957,0,3,3
95180,4,1,332958,332958,332959,0,1,1
95181,1,1,332959,332959,332960,0,1,0
95182,6,2,332965,332965,332967,0,2,5
95183,1,2,332966,332967,332969,1,3,0
95184,5,2,332971,332971,332973,0,2,2
95185,2,1,332973,332973,332974,0,1,0
95186,5,3,332978,332978,332981,0,3,4
95187,1,3,332979,332981,332984,2,5,0
95188,1,1,332980,332984,332985,4,5,0
95189,6,2,332986,332986,332988,0,2,1
95190,2,3,332988,332988,332991,0,3,0
95191,5,1,332993,332993,332994,0,1,2
95192,1,3,332994,332994,332997,0,3,0
95193,4,2,332998,332998,333000,0,2,1
95194,5,1,333003,333003,333004,0,1,3
95195,4,3,333007,333007,333010,0,3,3
95196,1,3,333008,333010,333013,2,5,0
95197,3,2,333011,333013,333015,2,4,0
95198,1,1,333012,333015,333016,3,4,0
95199,3,2,333015,333016,333018,1,3,0
95200,2,3,333017,333018,333021,1,4,0
95201,2,3,333019,333021,333024,2,5,0
95202,4,3,333023,333024,333027,1,4,0
95203,5,1,333028,333028,333029,0,1,1
95204,1,1,333029,333029,333030,0,1,0
95205,2,1,333031,333031,333032,0,1,1
95206,1,1,333032,333032,333033,0,1,0
95207,3,1,333035,333035,333036,0,1,2
95208,3,1,333038,333038,333039,0,1,2
95209,6,2,333044,333044,333046,0,2,5
95210,6,1,333050,333050,333051,0,1,4
95211,1,1,333051,333051,333052,0,1,0
95212,6,2,333057,333057,333059,0,2,5
95213,6,2,333063,333063,333065,0,2,4
95214,3,3,333066,333066,333069,0,3,1
95215,3,3,333069,333069,333072,0,3,0
95216,6,3,333075,333075,333078,0,3,3
95217,6,2,333081,333081,333083,0,2,3
95218,3,2,333084,333084,333086,0,2,1
95219,6,2,333090,333090,333092,0,2,4
95220,3,3,333093,333093,333096,0,3,1
95221,3,3,333096,333096,333099,0,3,0
95222,2,3,333098,333099,333102,1,4,0
95223,2,3,333100,333102,333105,2,5,0
95224,4,2,333104,333105,333107,1,3,0
95225,5,1,333109,333109,333110,0,1,2
95226,1,1,333110,333110,333111,0,1,0
95227,3,2,333113,333113,333115,0,2,2
95228,2,1,333115,333115,333116,0,1,0
95229,5,3,333120,333120,333123,0,3,4
95230,4,3,333124,333124,333127,0,3,1
95231,5,3,333129,333129,333132,0,3,2
95232,1,2,333130,333132,333134,2,4,0
95233,3,3,333133,333134,333137,1,4,0
95234,4,2,333137,333137,333139,0,2,0
95235,1,1,333138,333139,333140,1,2,0
95236,1,1,333139,333140,333141,1,2,0
95237,6,1,333145,333145,333146,0,1,4
95238,3,1,333148,333148,333149,0,1,2
95239,3,1,333151,333151,333152,0,1,2
95240,2,2,333153,333153,333155,0,2,1
95241,6,3,333159,333159,333162,0,3,4
95242,3,1,333162,333162,333163,0,1,0
95243,4,3,333166,333166,333169,0,3,3
95244,6,3,333172,333172,333175,0,3,3
95245,1,1,333173,333175,333176,2,3,0
95246,3,3,333176,333176,333179,0,3,0
95247,3,1,333179,333179,333180,0,1,0
95248,4,1,333183,333183,333184,0,1,3
95249,4,1,333187,333187,333188,0,1,3
95250,2,3,333189,333189,333192,0,3,1
95251,5,1,333194,333194,333195,0,1,2
95252,1,2,333195,333195,333197,0,2,0
95253,1,3,333196,333197,333200,1,4,0
95254,3,1,333199,333200,333201,1,2,0
95255,1,3,333200,333201,333204,1,4,0
95256,2,2,333202,333204,333206,2,4,0
95257,6,1,333208,333208,333209,0,1,2
95258,6,3,333214,333214,333217,0,3,5
95259,4,2,333218,333218,333220,0,2,1
95260,6,2,333224,333224,333226,0,2,4
95261,2,1,333226,333226,333227,0,1,0
95262,2,3,333228,333228,333231,0,3,1
95263,1,3,333229,333231,333234,2,5,0
95264,6,3,333235,333235,333238,0,3,1
95265,4,3,333239,333239,333242,0,3,1
95266,4,1,333243,333243,333244,0,1,1
95267,6,3,333249,333249,333252,0,3,5
95268,1,3,333250,333252,333255,2,5,0
95269,5,2,333255,333255,333257,0,2,0
95270,2,3,333257,333257,333260,0,3,0
95271,4,3,333261,333261,333264,0,3,1
95272,1,3,333262,333264,333267,2,5,0
95273,2,3,333264,333267,333270,3,6,0
95274,1,1,333265,333270,333271,5,6,0
95275,2,3,333267,333271,333274,4,7,0
95276,3,2,333270,333274,333276,4,6,0
95277,6,1,333276,333276,333277,0,1,0
95278,3,2,333279,333279,333281,0,2,2
95279,2,2,333281,333281,333283,0,2,0
95280,2,2,333283,333283,333285,0,2,0
95281,3,1,333286,333286,333287,0,1,1
95282,5,2,333291,333291,333293,0,2,4
95283,1,2,333292,333293,333295,1,3,0
95284,6,1,333298,333298,333299,0,1,3
95285,1,3,333299,333299,333302,0,3,0
95286,3,1,333302,333302,333303,0,1,0
95287,6,2,333308,333308,333310,0,2,5
95288,5,1,333313,333313,333314,0,1,3
95289,6,1,333319,333319,333320,0,1,5
95290,1,3,333320,333320,333323,0,3,0
95291,6,1,333326,333326,333327,0,1,3
95292,6,1,333332,333332,333333,0,1,5
95293,2,1,333334,333334,333335,0,1,1
95294,4,1,333338,333338,333339,0,1,3
95295,5,1,333343,333343,333344,0,1,4
95296,4,1,333347,333347,333348,0,1,3
95297,5,1,333352,333352,333353,0,1,4
95298,2,3,333354,333354,333357,0,3,1
95299,6,1,333360,333360,333361,0,1,3
95300,6,1,333366,333366,333367,0,1,5
95301,3,3,333369,333369,333372,0,3,2
95302,4,2,333373,333373,333375,0,2,1
95303,5,1,333378,333378,333379,0,1,3
95304,2,3,333380,333380,333383,0,3,1
95305,2,3,333382,333383,333386,1,4,0
95306,6,2,333388,333388,333390,0,2,2
95307,2,2,333390,333390,333392,0,2,0
95308,1,2,333391,333392,333394,1,3,0
95309,6,2,333397,333397,333399,0,2,3
95310,2,1,333399,333399,333400,0,1,0
95311,3,3,333402,333402,333405,0,3,2
95312,1,3,333403,333405,333408,2,5,0
95313,1,1,333404,333408,333409,4,5,0
95314,6,3,333410,333410,333413,0,3,1
95315,1,2,333411,333413,333415,2,4,0
95316,1,1,333412,333415,333416,3,4,0
95317,6,1,333418,333418,333419,0,1,2
95318,4,2,333422,333422,333424,0,2,3
95319,5,1,333427,333427,333428,0,1,3
95320,4,3,333431,333431,333434,0,3,3
95321,6,1,333437,333437,333438,0,1,3
95322,4,3,333441,333441,333444,0,3,3
95323,3,3,333444,333444,333447,0,3,0
95324,1,2,333445,333447,333449,2,4,0
95325,1,1,333446,333449,333450,3,4,0
95326,6,1,333452,333452,333453,0,1,2
95327,4,1,333456,333456,333457,0,1,3
95328,1,2,333457,333457,333459,0,2,0
95329,2,1,333459,333459,333460,0,1,0
95330,3,1,333462,333462,333463,0,1,2
95331,5,3,333467,333467,333470,0,3,4
95332,2,3,333469,333470,333473,1,4,0
95333,6,2,333475,333475,333477,0,2,2
95334,5,2,333480,333480,333482,0,2,3
95335,4,3,333484,333484,333487,0,3,2
95336,4,3,333488,333488,333491,0,3,1
95337,2,3,333490,333491,333494,1,4,0
95338,3,3,333493,333494,333497,1,4,0
95339,4,2,333497,333497,333499,0,2,0
95340,4,3,333501,333501,333504,0,3,2
95341,1,2,333502,333504,333506,2,4,0
95342,1,3,333503,333506,333509,3,6,0
95343,5,1,333508,333509,333510,1,2,0
95344,4,3,333512,333512,333515,0,3,2
95345,2,1,333514,333515,333516,1,2,0
95346,6,3,333520,333520,333523,0,3,4
95347,3,2,333523,333523,333525,0,2,0
95348,5,2,333528,333528,333530,0,2,3
95349,1,3,333529,333530,333533,1,4,0
95350,1,2,333530,333533,333535,3,5,0
95351,6,1,333536,333536,333537,0,1,1
95352,1,3,333537,333537,333540,0,3,0
95353,5,3,333542,333542,333545,0,3,2
95354,1,3,333543,333545,333548,2,5,0
95355,6,1,333549,333549,333550,0,1,1
95356,3,3,333552,333552,333555,0,3,2
95357,4,2,333556,333556,333558,0,2,1
95358,4,3,333560,333560,333563,0,3,2
95359,6,2,333566,333566,333568,0,2,3
95360,2,1,333568,333568,333569,0,1,0
95361,6,1,333574,333574,333575,0,1,5
95362,4,1,333578,333578,333579,0,1,3
95363,3,2,333581,333581,333583,0,2,2
95364,5,3,333586,333586,333589,0,3,3
95365,2,1,333588,333589,333590,1,2,0
95366,6,3,333594,333594,333597,0,3,4
95367,1,3,333595,333597,333600,2,5,0
95368,4,1,333599,333600,333601,1,2,0
95369,6,3,333605,333605,333608,0,3,4
95370,1,2,333606,333608,333610,2,4,0
95371,4,3,333610,333610,333613,0,3,0
95372,3,3,333613,333613,333616,0,3,0
95373,2,1,333615,333616,333617,1,2,0
95374,3,2,333618,333618,333620,0,2,1
95375,4,2,333622,333622,333624,0,2,2
95376,2,3,333624,333624,333627,0,3,0
95377,6,3,333630,333630,333633,0,3,3
95378,2,1,333632,333633,333634,1,2,0
95379,5,2,333637,333637,333639,0,2,3
95380,3,1,333640,333640,333641,0,1,1
95381,2,3,333642,333642,333645,0,3,1
95382,3,1,333645,333645,333646,0,1,0
95383,4,3,333649,333649,333652,0,3,3
95384,3,3,333652,333652,333655,0,3,0
95385,3,1,333655,333655,333656,0,1,0
95386,2,3,333657,333657,333660,0,3,1
95387,4,2,333661,333661,333663,0,2,1
95388,2,1,333663,333663,333664,0,1,0
95389,3,3,333666,333666,333669,0,3,2
95390,6,3,333672,333672,333675,0,3,3
95391,5,2,333677,333677,333679,0,2,2
95392,2,3,333679,333679,333682,0,3,0
95393,2,2,333681,333682,333684,1,3,0
95394,3,2,333684,333684,333686,0,2,0
95395,3,3,333687,333687,333690,0,3,1
95396,5,2,333692,333692,333694,0,2,2
95397,2,3,333694,333694,333697,0,3,0
95398,1,3,333695,333697,333700,2,5,0
95399,5,3,333700,333700,333703,0,3,0
95400,5,1,333705,333705,333706,0,1,2
95401,3,1,333708,333708,333709,0,1,2
95402,4,3,333712,333712,333715,0,3,3
95403,1,2,333713,333715,333717,2,4,0
95404,2,3,333715,333717,333720,2,5,0
95405,4,2,333719,333720,333722,1,3,0
95406,5,1,333724,333724,333725,0,1,2
95407,4,1,333728,333728,333729,0,1,3
95408,5,1,333733,333733,333734,0,1,4
95409,2,3,333735,333735,333738,0,3,1
95410,3,1,333738,333738,333739,0,1,0
95411,2,2,333740,333740,333742,0,2,1
95412,4,1,333744,333744,333745,0,1,2
95413,6,1,333750,333750,333751,0,1,5
95414,3,3,333753,333753,333756,0,3,2
95415,1,2,333754,333756,333758,2,4,0
95416,6,3,333760,333760,333763,0,3,2
95417,5,2,333765,333765,333767,0,2,2
95418,4,2,333769,333769,333771,0,2,2
95419,1,2,333770,333771,333773,1,3,0
95420,2,1,333772,333773,333774,1,2,0
95421,4,2,333776,333776,333778,0,2,2
95422,5,1,333781,333781,333782,0,1,3
95423,1,3,333782,333782,333785,0,3,0
95424,2,3,333784,333785,333788,1,4,0
95425,5,1,333789,333789,333790,0,1,1
95426,3,1,333792,333792,333793,0,1,2
95427,2,1,333794,333794,333795,0,1,1
95428,1,3,333795,333795,333798,0,3,0
95429,4,2,333799,333799,333801,0,2,1
95430,6,3,333805,333805,333808,0,3,4
95431,5,1,333810,333810,333811,0,1,2
95432,5,1,333815,333815,333816,0,1,4
95433,4,1,333819,333819,333820,0,1,3
95434,2,1,333821,333821,333822,0,1,1
95435,4,3,333825,333825,333828,0,3,3
95436,5,2,333830,333830,333832,0,2,2
95437,1,3,333831,333832,333835,1,4,0
95438,6,2,333837,333837,333839,0,2,2
95439,3,1,333840,333840,333841,0,1,1
95440,5,2,333845,333845,333847,0,2,4
95441,5,1,333850,333850,333851,0,1,3
95442,4,3,333854,333854,333857,0,3,3
95443,4,2,333858,333858,333860,0,2,1
95444,5,2,333863,333863,333865,0,2,3
95445,6,1,333869,333869,333870,0,1,4
95446,5,1,333874,333874,333875,0,1,4
95447,1,3,333875,333875,333878,0,3,0
95448,1,3,333876,333878,333881,2,5,0
95449,2,3,333878,333881,333884,3,6,0
95450,4,2,333882,333884,333886,2,4,0
95451,1,3,333883,333886,333889,3,6,0
95452,6,3,333889,333889,333892,0,3,0
95453,1,3,333890,333892,333895,2,5,0
95454,5,1,333895,333895,333896,0,1,0
95455,3,3,333898,333898,333901,0,3,2
95456,2,1,333900,333901,333902,1,2,0
95457,2,2,333902,333902,333904,0,2,0
95458,2,2,333904,333904,333906,0,2,0
95459,5,1,333909,333909,333910,0,1,3
95460,6,3,333915,333915,333918,0,3,5
95461,5,2,333920,333920,333922,0,2,2
95462,3,2,333923,333923,333925,0,2,1
95463,2,3,333925,333925,333928,0,3,0
95464,4,3,333929,333929,333932,0,3,1
95465,6,2,333935,333935,333937,0,2,3
95466,1,3,333936,333937,333940,1,4,0
95467,5,3,333941,333941,333944,0,3,1
95468,4,3,333945,333945,333948,0,3,1
95469,2,1,333947,333948,333949,1,2,0
95470,3,3,333950,333950,333953,0,3,1
95471,3,3,333953,333953,333956,0,3,0
95472,5,2,333958,333958,333960,0,2,2
95473,5,3,333963,333963,333966,0,3,3
95474,4,3,333967,333967,333970,0,3,1
95475,6,1,333973,333973,333974,0,1,3
95476,4,3,333977,333977,333980,0,3,3
95477,2,1,333979,333980,333981,1,2,0
95478,1,3,333980,333981,333984,1,4,0
95479,3,2,333983,333984,333986,1,3,0
95480,4,1,333987,333987,333988,0,1,1
95481,4,1,333991,333991,333992,0,1,3
95482,3,1,333994,333994,333995,0,1,2
95483,6,1,334000,334000,334001,0,1,5
95484,1,1,334001,334001,334002,0,1,0
95485,1,2,334002,334002,334004,0,2,0
95486,4,2,334006,334006,334008,0,2,2
95487,6,3,334012,334012,334015,0,3,4
95488,1,3,334013,334015,334018,2,5,0
95489,1,2,334014,334018,334020,4,6,0
95490,3,3,334017,334020,334023,3,6,0
95491,2,2,334019,334023,334025,4,6,0
95492,3,1,334022,334025,334026,3,4,0
95493,4,2,334026,334026,334028,0,2,0
95494,2,1,334028,334028,334029,0,1,0
95495,2,1,334030,334030,334031,0,1,1
95496,2,1,334032,334032,334033,0,1,1
95497,6,3,334038,334038,334041,0,3,5
95498,6,3,334044,334044,334047,0,3,3
95499,2,2,334046,334047,334049,1,3,0
95500,3,1,334049,334049,334050,0,1,0
95501,1,1,334050,334050,334051,0,1,0
95502,5,2,334055,334055,334057,0,2,4
95503,2,2,334057,334057,334059,0,2,0
95504,6,1,334063,334063,334064,0,1,4
95505,4,3,334067,334067,334070,0,3,3
95506,6,3,334073,334073,334076,0,3,3
95507,5,3,334078,334078,334081,0,3,2
95508,1,1,334079,334081,334082,2,3,0
95509,2,1,334081,334082,334083,1,2,0
95510,4,3,334085,334085,334088,0,3,2
95511,6,2,334091,334091,334093,0,2,3
95512,5,1,334096,334096,334097,0,1,3
95513,6,1,334102,334102,334103,0,1,5
95514,1,3,334103,334103,334106,0,3,0
95515,3,2,334106,334106,334108,0,2,0
95516,5,1,334111,334111,334112,0,1,3
95517,3,3,334114,334114,334117,0,3,2
95518,6,1,334120,334120,334121,0,1,3
95519,1,2,334121,334121,334123,0,2,0
95520,4,2,334125,334125,334127,0,2,2
95521,2,3,334127,334127,334130,0,3,0
95522,5,3,334132,334132,334135,0,3,2
95523,5,1,334137,334137,334138,0,1,2
95524,1,3,334138,334138,334141,0,3,0
95525,3,1,334141,334141,334142,0,1,0
95526,5,3,334146,334146,334149,0,3,4
95527,5,1,334151,334151,334152,0,1,2
95528,6,3,334157,334157,334160,0,3,5
95529,6,2,334163,334163,334165,0,2,3
95530,5,3,334168,334168,334171,0,3,3
95531,3,3,334171,334171,334174,0,3,0
95532,6,3,334177,334177,334180,0,3,3
95533,5,2,334182,334182,334184,0,2,2
95534,1,1,334183,334184,334185,1,2,0
95535,5,2,334188,334188,334190,0,2,3
95536,5,3,334193,334193,334196,0,3,3
95537,2,1,334195,334196,334197,1,2,0
95538,3,1,334198,334198,334199,0,1,1
95539,4,3,334202,334202,334205,0,3,3
95540,5,3,334207,334207,334210,0,3,2
95541,2,1,334209,334210,334211,1,2,0
95542,2,1,334211,334211,334212,0,1,0
95543,2,3,334213,334213,334216,0,3,1
95544,4,3,334217,334217,334220,0,3,1
95545,3,1,334220,334220,334221,0,1,0
95546,3,2,334223,334223,334225,0,2,2
95547,4,1,334227,334227,334228,0,1,2
95548,5,3,334232,334232,334235,0,3,4
95549,4,2,334236,334236,334238,0,2,1
95550,5,1,334241,334241,334242,0,1,3
95551,1,2,334242,334242,334244,0,2,0
95552,6,2,334248,334248,334250,0,2,4
95553,4,2,334252,334252,334254,0,2,2
95554,3,1,334255,334255,334256,0,1,1
95555,5,2,334260,334260,334262,0,2,4
95556,4,2,334264,334264,334266,0,2,2
95557,6,3,334270,334270,334273,0,3,4
95558,3,1,334273,334273,334274,0,1,0
95559,3,3,334276,334276,334279,0,3,2
95560,1,2,334277,334279,334281,2,4,0
95561,6,3,334283,334283,334286,0,3,2
95562,3,1,334286,334286,334287,0,1,0
95563,2,3,334288,334288,334291,0,3,1
95564,2,3,334290,334291,334294,1,4,0
95565,3,2,334293,334294,334296,1,3,0
95566,3,3,334296,334296,334299,0,3,0
95567,4,1,334300,334300,334301,0,1,1
95568,1,2,334301,334301,334303,0,2,0
95569,5,3,334306,334306,334309,0,3,3
95570,6,1,334312,334312,334313,0,1,3
95571,1,3,334313,334313,334316,0,3,0
95572,5,2,334318,334318,334320,0,2,2
95573,1,2,334319,334320,334322,1,3,0
95574,1,3,334320,334322,334325,2,5,0
95575,4,3,334324,334325,334328,1,4,0
95576,6,1,334330,334330,334331,0,1,2
95577,3,1,334333,334333,334334,0,1,2
95578,2,1,334335,334335,334336,0,1,1
95579,1,1,334336,334336,334337,0,1,0
95580,4,1,334340,334340,334341,0,1,3
95581,4,3,334344,334344,334347,0,3,3
95582,6,1,334350,334350,334351,0,1,3
95583,1,2,334351,334351,334353,0,2,0
95584,1,3,334352,334353,334356,1,4,0
95585,2,3,334354,334356,334359,2,5,0
95586,4,3,334358,334359,334362,1,4,0
95587,5,2,334363,334363,334365,0,2,1
95588,4,3,334367,334367,334370,0,3,2
95589,1,2,334368,334370,334372,2,4,0
95590,4,3,334372,334372,334375,0,3,0
95591,6,3,334378,334378,334381,0,3,3
95592,2,1,334380,334381,334382,1,2,0
95593,2,1,334382,334382,334383,0,1,0
95594,4,1,334386,334386,334387,0,1,3
95595,6,1,334392,334392,334393,0,1,5
95596,3,1,334395,334395,334396,0,1,2
95597,2,3,334397,334397,334400,0,3,1
95598,5,3,334402,334402,334405,0,3,2
95599,1,1,334403,334405,334406,2,3,0
95600,2,3,334405,334406,334409,1,4,0
95601,4,2,334409,334409,334411,0,2,0
95602,1,1,334410,334411,334412,1,2,0
95603,4,2,334414,334414,334416,0,2,2
95604,2,2,334416,334416,334418,0,2,0
95605,2,2,334418,334418,334420,0,2,0
95606,6,3,334424,334424,334427,0,3,4
95607,5,1,334429,334429,334430,0,1,2
95608,4,2,334433,334433,334435,0,2,3
95609,1,3,334434,334435,334438,1,4,0
95610,2,1,334436,334438,334439,2,3,0
95611,5,3,334441,334441,334444,0,3,2
95612,3,3,334444,334444,334447,0,3,0
95613,4,2,334448,334448,334450,0,2,1
95614,1,2,334449,334450,334452,1,3,0
95615,5,3,334454,334454,334457,0,3,2
95616,3,1,334457,334457,334458,0,1,0
95617,6,2,334463,334463,334465,0,2,5
95618,4,1,334467,334467,334468,0,1,2
95619,1,1,334468,334468,334469,0,1,0
95620,3,3,334471,334471,334474,0,3,2
95621,2,1,334473,334474,334475,1,2,0
95622,3,2,334476,334476,334478,0,2,1
95623,1,3,334477,334478,334481,1,4,0
95624,1,1,334478,334481,334482,3,4,0
95625,5,3,334483,334483,334486,0,3,1
95626,3,2,334486,334486,334488,0,2,0
95627,5,1,334491,334491,334492,0,1,3
95628,6,1,334497,334497,334498,0,1,5
95629,4,3,334501,334501,334504,0,3,3
95630,2,2,334503,334504,334506,1,3,0
95631,1,2,334504,334506,334508,2,4,0
95632,4,2,334508,334508,334510,0,2,0
95633,4,2,334512,334512,334514,0,2,2
95634,3,2,334515,334515,334517,0,2,1
95635,4,3,334519,334519,334522,0,3,2
95636,6,2,334525,334525,334527,0,2,3
95637,2,2,334527,334527,334529,0,2,0
95638,3,1,334530,334530,334531,0,1,1
95639,1,2,334531,334531,334533,0,2,0
95640,4,3,334535,334535,334538,0,3,2
95641,2,3,334537,334538,334541,1,4,0
95642,3,3,334540,334541,334544,1,4,0
95643,1,2,334541,334544,334546,3,5,0
95644,4,2,334545,334546,334548,1,3,0
95645,4,3,334549,334549,334552,0,3,1
95646,3,3,334552,334552,334555,0,3,0
95647,3,3,334555,334555,334558,0,3,0
95648,2,3,334557,334558,334561,1,4,0
95649,4,1,334561,334561,334562,0,1,0
95650,6,3,334567,334567,334570,0,3,5
95651,1,3,334568,334570,334573,2,5,0
95652,1,3,334569,334573,334576,4,7,0
95653,5,3,334574,334576,334579,2,5,0
95654,2,3,334576,334579,334582,3,6,0
95655,5,3,334581,334582,334585,1,4,0
95656,4,2,334585,334585,334587,0,2,0
95657,6,1,334591,334591,334592,0,1,4
95658,6,3,334597,334597,334600,0,3,5
95659,5,3,334602,334602,334605,0,3,2
95660,4,3,334606,334606,334609,0,3,1
95661,5,3,334611,334611,334614,0,3,2
95662,4,2,334615,334615,334617,0,2,1
95663,2,3,334617,334617,334620,0,3,0
95664,4,1,334621,334621,334622,0,1,1
95665,1,2,334622,334622,334624,0,2,0
95666,3,3,334625,334625,334628,0,3,1
95667,5,2,334630,334630,334632,0,2,2
95668,4,2,334634,334634,334636,0,2,2
95669,6,1,334640,334640,334641,0,1,4
95670,1,1,334641,334641,334642,0,1,0
95671,6,1,334647,334647,334648,0,1,5
95672,5,1,334652,334652,334653,0,1,4
95673,3,3,334655,334655,334658,0,3,2
95674,5,3,334660,334660,334663,0,3,2
95675,2,2,334662,334663,334665,1,3,0
95676,5,3,334667,334667,334670,0,3,2
95677,6,3,334673,334673,334676,0,3,3
95678,5,3,334678,334678,334681,0,3,2
95679,1,1,334679,334681,334682,2,3,0
95680,4,2,334683,334683,334685,0,2,1
95681,6,2,334689,334689,334691,0,2,4
95682,1,1,334690,334691,334692,1,2,0
95683,1,2,334691,334692,334694,1,3,0
95684,4,2,334695,334695,334697,0,2,1
95685,6,1,334701,334701,334702,0,1,4
95686,1,2,334702,334702,334704,0,2,0
95687,6,1,334708,334708,334709,0,1,4
95688,2,2,334710,334710,334712,0,2,1
95689,1,2,334711,334712,334714,1,3,0
95690,5,2,334716,334716,334718,0,2,2
95691,3,3,334719,334719,334722,0,3,1
95692,3,3,334722,334722,334725,0,3,0
95693,4,1,334726,334726,334727,0,1,1
95694,2,1,334728,334728,334729,0,1,1
95695,1,1,334729,334729,334730,0,1,0
95696,5,2,334734,334734,334736,0,2,4
95697,4,2,334738,334738,334740,0,2,2
95698,5,3,334743,334743,334746,0,3,3
95699,4,3,334747,334747,334750,0,3,1
95700,6,1,334753,334753,334754,0,1,3
95701,4,3,334757,334757,334760,0,3,3
95702,5,3,334762,334762,334765,0,3,2
95703,2,2,334764,334765,334767,1,3,0
95704,4,1,334768,334768,334769,0,1,1
95705,6,1,334774,334774,334775,0,1,5
95706,1,2,334775,334775,334777,0,2,0
95707,1,2,334776,334777,334779,1,3,0
95708,3,2,334779,334779,334781,0,2,0
95709,5,3,334784,334784,334787,0,3,3
95710,6,3,334790,334790,334793,0,3,3
95711,4,2,334794,334794,334796,0,2,1
95712,6,2,334800,334800,334802,0,2,4
95713,4,3,334804,334804,334807,0,3,2
95714,1,3,334805,334807,334810,2,5,0
95715,2,1,334807,334810,334811,3,4,0
95716,2,1,334809,334811,334812,2,3,0
95717,2,3,334811,334812,334815,1,4,0
95718,4,3,334815,334815,334818,0,3,0
95719,3,2,334818,334818,334820,0,2,0
95720,5,3,334823,334823,334826,0,3,3
95721,6,1,334829,334829,334830,0,1,3
95722,3,2,334832,334832,334834,0,2,2
95723,3,3,334835,334835,334838,0,3,1
95724,3,2,334838,334838,334840,0,2,0
95725,3,3,334841,334841,334844,0,3,1
95726,5,3,334846,334846,334849,0,3,2
95727,1,3,334847,334849,334852,2,5,0
95728,1,2,334848,334852,334854,4,6,0
95729,6,1,334854,334854,334855,0,1,0
95730,3,1,334857,334857,334858,0,1,2
95731,1,1,334858,334858,334859,0,1,0
95732,3,2,334861,334861,334863,0,2,2
95733,4,2,334865,334865,334867,0,2,2
95734,4,2,334869,334869,334871,0,2,2
95735,3,2,334872,334872,334874,0,2,1
95736,3,3,334875,334875,334878,0,3,1
95737,4,3,334879,334879,334882,0,3,1
95738,4,2,334883,334883,334885,0,2,1
95739,1,2,334884,334885,334887,1,3,0
95740,5,2,334889,334889,334891,0,2,2
95741,3,1,334892,334892,334893,0,1,1
95742,4,1,334896,334896,334897,0,1,3
95743,4,2,334900,334900,334902,0,2,3
95744,1,3,334901,334902,334905,1,4,0
95745,5,3,334906,334906,334909,0,3,1
95746,6,2,334912,334912,334914,0,2,3
95747,4,3,334916,334916,334919,0,3,2
95748,5,2,334921,334921,334923,0,2,2
95749,3,1,334924,334924,334925,0,1,1
95750,2,2,334926,334926,334928,0,2,1
95751,3,3,334929,334929,334932,0,3,1
95752,2,1,334931,334932,334933,1,2,0
95753,4,2,334935,334935,334937,0,2,2
95754,4,3,334939,334939,334942,0,3,2
95755,5,1,334944,334944,334945,0,1,2
95756,2,1,334946,334946,334947,0,1,1
95757,5,2,334951,334951,334953,0,2,4
95758,4,2,334955,334955,334957,0,2,2
95759,3,2,334958,334958,334960,0,2,1
95760,4,1,334962,334962,334963,0,1,2
95761,4,3,334966,334966,334969,0,3,3
95762,5,1,334971,334971,334972,0,1,2
95763,4,2,334975,334975,334977,0,2,3
95764,5,3,334980,334980,334983,0,3,3
95765,2,1,334982,334983,334984,1,2,0
95766,5,1,334987,334987,334988,0,1,3
95767,5,2,334992,334992,334994,0,2,4
95768,1,3,334993,334994,334997,1,4,0
95769,5,2,334998,334998,335000,0,2,1
95770,2,2,335000,335000,335002,0,2,0
95771,6,1,335006,335006,335007,0,1,4
95772,2,1,335008,335008,335009,0,1,1
95773,5,2,335013,335013,335015,0,2,4
95774,2,1,335015,335015,335016,0,1,0
95775,1,1,335016,335016,335017,0,1,0
95776,1,1,335017,335017,335018,0,1,0
95777,4,3,335021,335021,335024,0,3,3
95778,1,1,335022,335024,335025,2,3,0
95779,2,2,335024,335025,335027,1,3,0
95780,1,2,335025,335027,335029,2,4,0
95781,2,1,335027,335029,335030,2,3,0
95782,2,2,335029,335030,335032,1,3,0
95783,1,3,335030,335032,335035,2,5,0
95784,1,3,335031,335035,335038,4,7,0
95785,4,2,335035,335038,335040,3,5,0
95786,2,1,335037,335040,335041,3,4,0
95787,6,2,335043,335043,335045,0,2,2
95788,5,2,335048,335048,335050,0,2,3
95789,4,2,335052,335052,335054,0,2,2
95790,6,3,335058,335058,335061,0,3,4
95791,1,3,335059,335061,335064,2,5,0
95792,2,1,335061,335064,335065,3,4,0
95793,4,3,335065,335065,335068,0,3,0
95794,4,1,335069,335069,335070,0,1,1
95795,3,1,335072,335072,335073,0,1,2
95796,2,2,335074,335074,335076,0,2,1
95797,2,3,335076,335076,335079,0,3,0
95798,5,3,335081,335081,335084,0,3,2
95799,4,1,335085,335085,335086,0,1,1
95800,3,2,335088,335088,335090,0,2,2
95801,6,3,335094,335094,335097,0,3,4
95802,6,1,335100,335100,335101,0,1,3
95803,1,2,335101,335101,335103,0,2,0
95804,2,2,335103,335103,335105,0,2,0
95805,4,1,335107,335107,335108,0,1,2
95806,1,3,335108,335108,335111,0,3,0
95807,4,3,335112,335112,335115,0,3,1
95808,2,3,335114,335115,335118,1,4,0
95809,1,2,335115,335118,335120,3,5,0
95810,4,3,335119,335120,335123,1,4,0
95811,4,2,335123,335123,335125,0,2,0
95812,2,1,335125,335125,335126,0,1,0
95813,2,2,335127,335127,335129,0,2,1
95814,1,1,335128,335129,335130,1,2,0
95815,3,3,335131,335131,335134,0,3,1
95816,2,1,335133,335134,335135,1,2,0
95817,1,3,335134,335135,335138,1,4,0
95818,3,2,335137,335138,335140,1,3,0
95819,5,2,335142,335142,335144,0,2,2
95820,1,3,335143,335144,335147,1,4,0
95821,3,1,335146,335147,335148,1,2,0
95822,5,1,335151,335151,335152,0,1,3
95823,2,2,335153,335153,335155,0,2,1
95824,3,1,335156,335156,335157,0,1,1
95825,4,3,335160,335160,335163,0,3,3
95826,3,2,335163,335163,335165,0,2,0
95827,3,3,335166,335166,335169,0,3,1
95828,6,1,335172,335172,335173,0,1,3
95829,4,2,335176,335176,335178,0,2,3
95830,6,3,335182,335182,335185,0,3,4
95831,5,1,335187,335187,335188,0,1,2
95832,5,1,335192,335192,335193,0,1,4
95833,6,1,335198,335198,335199,0,1,5
95834,2,2,335200,335200,335202,0,2,1
95835,2,2,335202,335202,335204,0,2,0
95836,2,3,335204,335204,335207,0,3,0
95837,2,2,335206,335207,335209,1,3,0
95838,2,3,335208,335209,335212,1,4,0
95839,2,3,335210,335212,335215,2,5,0
95840,6,1,335216,335216,335217,0,1,1
95841,5,2,335221,335221,335223,0,2,4
95842,4,2,335225,335225,335227,0,2,2
95843,5,2,335230,335230,335232,0,2,3
95844,5,2,335235,335235,335237,0,2,3
95845,4,1,335239,335239,335240,0,1,2
95846,3,3,335242,335242,335245,0,3,2
95847,6,2,335248,335248,335250,0,2,3
95848,4,3,335252,335252,335255,0,3,2
95849,5,3,335257,335257,335260,0,3,2
95850,4,2,335261,335261,335263,0,2,1
95851,1,2,335262,335263,335265,1,3,0
95852,3,1,335265,335265,335266,0,1,0
95853,2,1,335267,335267,335268,0,1,1
95854,4,3,335271,335271,335274,0,3,3
95855,1,3,335272,335274,335277,2,5,0
95856,6,2,335278,335278,335280,0,2,1
95857,1,1,335279,335280,335281,1,2,0
95858,4,1,335283,335283,335284,0,1,2
95859,5,1,335288,335288,335289,0,1,4
95860,4,2,335292,335292,335294,0,2,3
95861,3,2,335295,335295,335297,0,2,1
95862,1,2,335296,335297,335299,1,3,0
95863,4,2,335300,335300,335302,0,2,1
95864,2,2,335302,335302,335304,0,2,0
95865,3,3,335305,335305,335308,0,3,1
95866,4,3,335309,335309,335312,0,3,1
95867,5,3,335314,335314,335317,0,3,2
95868,1,2,335315,335317,335319,2,4,0
95869,6,2,335321,335321,335323,0,2,2
95870,6,3,335327,335327,335330,0,3,4
95871,1,1,335328,335330,335331,2,3,0
95872,5,3,335333,335333,335336,0,3,2
95873,4,1,335337,335337,335338,0,1,1
95874,4,1,335341,335341,335342,0,1,3
95875,4,3,335345,335345,335348,0,3,3
95876,4,1,335349,335349,335350,0,1,1
95877,1,2,335350,335350,335352,0,2,0
95878,5,3,335355,335355,335358,0,3,3
95879,1,1,335356,335358,335359,2,3,0
95880,4,1,335360,335360,335361,0,1,1
95881,6,3,335366,335366,335369,0,3,5
95882,4,3,335370,335370,335373,0,3,1
95883,1,3,335371,335373,335376,2,5,0
95884,6,2,335377,335377,335379,0,2,1
95885,5,2,335382,335382,335384,0,2,3
95886,6,2,335388,335388,335390,0,2,4
95887,3,1,335391,335391,335392,0,1,1
95888,1,3,335392,335392,335395,0,3,0
95889,4,2,335396,335396,335398,0,2,1
95890,6,1,335402,335402,335403,0,1,4
95891,6,3,335408,335408,335411,0,3,5
95892,5,3,335413,335413,335416,0,3,2
95893,2,2,335415,335416,335418,1,3,0
95894,2,1,335417,335418,335419,1,2,0
95895,2,1,335419,335419,335420,0,1,0
95896,6,2,335425,335425,335427,0,2,5
95897,4,1,335429,335429,335430,0,1,2
95898,5,1,335434,335434,335435,0,1,4
95899,2,3,335436,335436,335439,0,3,1
95900,3,3,335439,335439,335442,0,3,0
95901,6,2,335445,335445,335447,0,2,3
95902,2,3,335447,335447,335450,0,3,0
95903,1,3,335448,335450,335453,2,5,0
95904,6,3,335454,335454,335457,0,3,1
95905,6,3,335460,335460,335463,0,3,3
95906,6,1,335466,335466,335467,0,1,3
95907,4,1,335470,335470,335471,0,1,3
95908,2,3,335472,335472,335475,0,3,1
95909,3,3,335475,335475,335478,0,3,0
95910,5,3,335480,335480,335483,0,3,2
95911,3,3,335483,335483,335486,0,3,0
95912,4,3,335487,335487,335490,0,3,1
95913,4,1,335491,335491,335492,0,1,1
95914,3,1,335494,335494,335495,0,1,2
95915,5,1,335499,335499,335500,0,1,4
95916,4,2,335503,335503,335505,0,2,3
95917,2,1,335505,335505,335506,0,1,0
95918,2,3,335507,335507,335510,0,3,1
95919,3,1,335510,335510,335511,0,1,0
95920,1,3,335511,335511,335514,0,3,0
95921,2,1,335513,335514,335515,1,2,0
95922,3,3,335516,335516,335519,0,3,1
95923,6,1,335522,335522,335523,0,1,3
95924,1,2,335523,335523,335525,0,2,0
95925,2,3,335525,335525,335528,0,3,0
95926,4,1,335529,335529,335530,0,1,1
95927,3,2,335532,335532,335534,0,2,2
95928,1,2,335533,335534,335536,1,3,0
95929,1,2,335534,335536,335538,2,4,0
95930,5,3,335539,335539,335542,0,3,1
95931,1,1,335540,335542,335543,2,3,0
95932,5,2,335545,335545,335547,0,2,2
95933,6,3,335551,335551,335554,0,3,4
95934,5,2,335556,335556,335558,0,2,2
95935,5,2,335561,335561,335563,0,2,3
95936,3,1,335564,335564,335565,0,1,1
95937,5,3,335569,335569,335572,0,3,4
95938,4,2,335573,335573,335575,0,2,1
95939,4,2,335577,335577,335579,0,2,2
95940,3,3,335580,335580,335583,0,3,1
95941,5,1,335585,335585,335586,0,1,2
95942,5,2,335590,335590,335592,0,2,4
95943,3,1,335593,335593,335594,0,1,1
95944,1,2,335594,335594,335596,0,2,0
95945,6,2,335600,335600,335602,0,2,4
95946,4,1,335604,335604,335605,0,1,2
95947,6,1,335610,335610,335611,0,1,5
95948,1,2,335611,335611,335613,0,2,0
95949,5,1,335616,335616,335617,0,1,3
95950,4,3,335620,335620,335623,0,3,3
95951,5,2,335625,335625,335627,0,2,2
95952,6,3,335631,335631,335634,0,3,4
95953,6,1,335637,335637,335638,0,1,3
95954,4,1,335641,335641,335642,0,1,3
95955,3,2,335644,335644,335646,0,2,2
95956,1,1,335645,335646,335647,1,2,0
95957,1,3,335646,335647,335650,1,4,0
95958,1,2,335647,335650,335652,3,5,0
95959,2,2,335649,335652,335654,3,5,0
95960,6,3,335655,335655,335658,0,3,1
95961,4,1,335659,335659,335660,0,1,1
95962,2,2,335661,335661,335663,0,2,1
95963,3,2,335664,335664,335666,0,2,1
95964,4,3,335668,335668,335671,0,3,2
95965,3,1,335671,335671,335672,0,1,0
95966,5,1,335676,335676,335677,0,1,4
95967,4,2,335680,335680,335682,0,2,3
95968,5,2,335685,335685,335687,0,2,3
95969,4,1,335689,335689,335690,0,1,2
95970,4,2,335693,335693,335695,0,2,3
95971,2,3,335695,335695,335698,0,3,0
95972,1,3,335696,335698,335701,2,5,0
95973,4,1,335700,335701,335702,1,2,0
95974,1,3,335701,335702,335705,1,4,0
95975,6,1,335707,335707,335708,0,1,2
95976,5,2,335712,335712,335714,0,2,4
95977,4,3,335716,335716,335719,0,3,2
95978,4,2,335720,335720,335722,0,2,1
95979,2,1,335722,335722,335723,0,1,0
95980,4,3,335726,335726,335729,0,3,3
95981,3,1,335729,335729,335730,0,1,0
95982,4,2,335733,335733,335735,0,2,3
95983,2,2,335735,335735,335737,0,2,0
95984,2,2,335737,335737,335739,0,2,0
95985,6,3,335743,335743,335746,0,3,4
95986,1,3,335744,335746,335749,2,5,0
95987,2,3,335746,335749,335752,3,6,0
95988,3,1,335749,335752,335753,3,4,0
95989,1,3,335750,335753,335756,3,6,0
95990,1,2,335751,335756,335758,5,7,0
95991,6,3,335757,335758,335761,1,4,0
95992,4,1,335761,335761,335762,0,1,0
95993,6,2,335767,335767,335769,0,2,5
95994,2,1,335769,335769,335770,0,1,0
95995,5,2,335774,335774,335776,0,2,4
95996,6,1,335780,335780,335781,0,1,4
95997,4,1,335784,335784,335785,0,1,3
95998,1,3,335785,335785,335788,0,3,0
95999,1,2,335786,335788,335790,2,4,0
96000,6,2,335792,335792,335794,0,2,2
96001,3,2,335795,335795,335797,0,2,1
96002,2,3,335797,335797,335800,0,3,0
96003,4,2,335801,335801,335803,0,2,1
96004,6,3,335807,335807,335810,0,3,4
96005,1,2,335808,335810,335812,2,4,0
96006,1,3,335809,335812,335815,3,6,0
96007,6,2,335815,335815,335817,0,2,0
96008,1,1,335816,335817,335818,1,2,0
96009,5,1,335821,335821,335822,0,1,3
96010,4,2,335825,335825,335827,0,2,3
96011,4,1,335829,335829,335830,0,1,2
96012,2,2,335831,335831,335833,0,2,1
96013,2,3,335833,335833,335836,0,3,0
96014,4,1,335837,335837,335838,0,1,1
96015,6,3,335843,335843,335846,0,3,5
96016,4,3,335847,335847,335850,0,3,1
96017,3,1,335850,335850,335851,0,1,0
96018,1,3,335851,335851,335854,0,3,0
96019,5,1,335856,335856,335857,0,1,2
96020,4,3,335860,335860,335863,0,3,3
96021,1,3,335861,335863,335866,2,5,0
96022,4,3,335865,335866,335869,1,4,0
96023,5,2,335870,335870,335872,0,2,1
96024,4,3,335874,335874,335877,0,3,2
96025,2,3,335876,335877,335880,1,4,0
96026,1,1,335877,335880,335881,3,4,0
96027,1,1,335878,335881,335882,3,4,0
96028,2,3,335880,335882,335885,2,5,0
96029,5,3,335885,335885,335888,0,3,0
96030,4,1,335889,335889,335890,0,1,1
96031,4,3,335893,335893,335896,0,3,3
96032,5,1,335898,335898,335899,0,1,2
96033,5,1,335903,335903,335904,0,1,4
96034,2,1,335905,335905,335906,0,1,1
96035,6,2,335911,335911,335913,0,2,5
96036,6,1,335917,335917,335918,0,1,4
96037,2,1,335919,335919,335920,0,1,1
96038,5,2,335924,335924,335926,0,2,4
96039,2,3,335926,335926,335929,0,3,0
96040,4,3,335930,335930,335933,0,3,1
96041,5,1,335935,335935,335936,0,1,2
96042,5,2,335940,335940,335942,0,2,4
96043,3,3,335943,335943,335946,0,3,1
96044,5,3,335948,335948,335951,0,3,2
96045,2,2,335950,335951,335953,1,3,0
96046,1,3,335951,335953,335956,2,5,0
96047,2,1,335953,335956,335957,3,4,0
96048,4,3,335957,335957,335960,0,3,0
96049,6,3,335963,335963,335966,0,3,3
96050,2,3,335965,335966,335969,1,4,0
96051,6,2,335971,335971,335973,0,2,2
96052,2,1,335973,335973,335974,0,1,0
96053,1,1,335974,335974,335975,0,1,0
96054,5,2,335979,335979,335981,0,2,4
96055,2,1,335981,335981,335982,0,1,0
96056,2,2,335983,335983,335985,0,2,1
96057,5,2,335988,335988,335990,0,2,3
96058,2,1,335990,335990,335991,0,1,0
96059,1,2,335991,335991,335993,0,2,0
96060,1,2,335992,335993,335995,1,3,0
96061,1,1,335993,335995,335996,2,3,0
96062,2,2,335995,335996,335998,1,3,0
96063,5,1,336000,336000,336001,0,1,2
96064,5,1,336005,336005,336006,0,1,4
96065,2,1,336007,336007,336008,0,1,1
96066,3,3,336010,336010,336013,0,3,2
96067,1,3,336011,336013,336016,2,5,0
96068,3,3,336014,336016,336019,2,5,0
96069,5,1,336019,336019,336020,0,1,0
96070,5,3,336024,336024,336027,0,3,4
96071,4,1,336028,336028,336029,0,1,1
96072,2,3,336030,336030,336033,0,3,1
96073,6,1,336036,336036,336037,0,1,3
96074,5,3,336041,336041,336044,0,3,4
96075,4,2,336045,336045,336047,0,2,1
96076,4,3,336049,336049,336052,0,3,2
96077,3,3,336052,336052,336055,0,3,0
96078,5,3,336057,336057,336060,0,3,2
96079,6,2,336063,336063,336065,0,2,3
96080,1,2,336064,336065,336067,1,3,0
96081,3,2,336067,336067,336069,0,2,0
96082,4,3,336071,336071,336074,0,3,2
96083,4,2,336075,336075,336077,0,2,1
96084,5,2,336080,336080,336082,0,2,3
96085,4,2,336084,336084,336086,0,2,2
96086,1,2,336085,336086,336088,1,3,0
96087,1,2,336086,336088,336090,2,4,0
96088,5,2,336091,336091,336093,0,2,1
96089,3,2,336094,336094,336096,0,2,1
96090,6,3,336100,336100,336103,0,3,4
96091,5,2,336105,336105,336107,0,2,2
96092,5,1,336110,336110,336111,0,1,3
96093,1,1,336111,336111,336112,0,1,0
96094,2,1,336113,336113,336114,0,1,1
96095,2,3,336115,336115,336118,0,3,1
96096,6,1,336121,336121,336122,0,1,3
96097,5,3,336126,336126,336129,0,3,4
96098,1,3,336127,336129,336132,2,5,0
96099,3,2,336130,336132,336134,2,4,0
96100,1,1,336131,336134,336135,3,4,0
96101,1,1,336132,336135,336136,3,4,0
96102,2,3,336134,336136,336139,2,5,0
96103,1,2,336135,336139,336141,4,6,0
96104,6,2,336141,336141,336143,0,2,0
96105,6,2,336147,336147,336149,0,2,4
96106,1,1,336148,336149,336150,1,2,0
96107,4,1,336152,336152,336153,0,1,2
96108,5,2,336157,336157,336159,0,2,4
96109,5,2,336162,336162,336164,0,2,3
96110,6,3,336168,336168,336171,0,3,4
96111,5,1,336173,336173,336174,0,1,2
96112,5,1,336178,336178,336179,0,1,4
96113,2,3,336180,336180,336183,0,3,1
96114,6,1,336186,336186,336187,0,1,3
96115,1,1,336187,336187,336188,0,1,0
96116,4,3,336191,336191,336194,0,3,3
96117,3,2,336194,336194,336196,0,2,0
96118,5,1,336199,336199,336200,0,1,3
96119,4,3,336203,336203,336206,0,3,3
96120,2,1,336205,336206,336207,1,2,0
96121,5,2,336210,336210,336212,0,2,3
96122,1,2,336211,336212,336214,1,3,0
96123,3,2,336214,336214,336216,0,2,0
96124,3,3,336217,336217,336220,0,3,1
96125,2,3,336219,336220,336223,1,4,0
96126,3,3,336222,336223,336226,1,4,0
96127,6,2,336228,336228,336230,0,2,2
96128,4,2,336232,336232,336234,0,2,2
96129,3,1,336235,336235,336236,0,1,1
96130,6,1,336241,336241,336242,0,1,5
96131,3,1,336244,336244,336245,0,1,2
96132,4,3,336248,336248,336251,0,3,3
96133,4,3,336252,336252,336255,0,3,1
96134,2,2,336254,336255,336257,1,3,0
96135,5,1,336259,336259,336260,0,1,2
96136,5,2,336264,336264,336266,0,2,4
96137,2,3,336266,336266,336269,0,3,0
96138,1,2,336267,336269,336271,2,4,0
96139,5,2,336272,336272,336274,0,2,1
96140,3,1,336275,336275,336276,0,1,1
96141,5,2,336280,336280,336282,0,2,4
96142,6,3,336286,336286,336289,0,3,4
96143,5,1,336291,336291,336292,0,1,2
96144,5,3,336296,336296,336299,0,3,4
96145,4,2,336300,336300,336302,0,2,1
96146,4,2,336304,336304,336306,0,2,2
96147,5,3,336309,336309,336312,0,3,3
96148,1,1,336310,336312,336313,2,3,0
96149,2,3,336312,336313,336316,1,4,0
96150,1,2,336313,336316,336318,3,5,0
96151,5,3,336318,336318,336321,0,3,0
96152,4,2,336322,336322,336324,0,2,1
96153,5,1,336327,336327,336328,0,1,3
96154,5,3,336332,336332,336335,0,3,4
96155,5,1,336337,336337,336338,0,1,2
96156,3,2,336340,336340,336342,0,2,2
96157,3,3,336343,336343,336346,0,3,1
96158,4,1,336347,336347,336348,0,1,1
96159,1,2,336348,336348,336350,0,2,0
96160,4,3,336352,336352,336355,0,3,2
96161,3,3,336355,336355,336358,0,3,0
96162,6,2,336361,336361,336363,0,2,3
96163,1,2,336362,336363,336365,1,3,0
96164,3,3,336365,336365,336368,0,3,0
96165,3,2,336368,336368,336370,0,2,0
96166,2,2,336370,336370,336372,0,2,0
96167,5,1,336375,336375,336376,0,1,3
96168,4,1,336379,336379,336380,0,1,3
96169,2,2,336381,336381,336383,0,2,1
96170,2,1,336383,336383,336384,0,1,0
96171,6,3,336389,336389,336392,0,3,5
96172,3,2,336392,336392,336394,0,2,0
96173,1,1,336393,336394,336395,1,2,0
96174,4,3,336397,336397,336400,0,3,2
96175,6,2,336403,336403,336405,0,2,3
96176,1,2,336404,336405,336407,1,3,0
96177,1,2,336405,336407,336409,2,4,0
96178,6,2,336411,336411,336413,0,2,2
96179,4,1,336415,336415,336416,0,1,2
96180,3,3,336418,336418,336421,0,3,2
96181,2,1,336420,336421,336422,1,2,0
96182,3,3,336423,336423,336426,0,3,1
96183,4,3,336427,336427,336430,0,3,1
96184,2,2,336429,336430,336432,1,3,0
96185,1,1,336430,336432,336433,2,3,0
96186,2,3,336432,336433,336436,1,4,0
96187,6,2,336438,336438,336440,0,2,2
96188,5,1,336443,336443,336444,0,1,3
96189,2,3,336445,336445,336448,0,3,1
96190,2,1,336447,336448,336449,1,2,0
96191,6,3,336453,336453,336456,0,3,4
96192,3,3,336456,336456,336459,0,3,0
96193,5,3,336461,336461,336464,0,3,2
96194,4,3,336465,336465,336468,0,3,1
96195,5,3,336470,336470,336473,0,3,2
96196,4,2,336474,336474,336476,0,2,1
96197,6,3,336480,336480,336483,0,3,4
96198,4,3,336484,336484,336487,0,3,1
96199,5,1,336489,336489,336490,0,1,2
96200,2,1,336491,336491,336492,0,1,1
96201,4,2,336495,336495,336497,0,2,3
96202,6,3,336501,336501,336504,0,3,4
96203,4,3,336505,336505,336508,0,3,1
96204,3,1,336508,336508,336509,0,1,0
96205,6,1,336514,336514,336515,0,1,5
96206,6,2,336520,336520,336522,0,2,5
96207,3,2,336523,336523,336525,0,2,1
96208,3,1,336526,336526,336527,0,1,1
96209,2,3,336528,336528,336531,0,3,1
96210,2,1,336530,336531,336532,1,2,0
96211,5,2,336535,336535,336537,0,2,3
96212,2,1,336537,336537,336538,0,1,0
96213,4,1,336541,336541,336542,0,1,3
96214,3,1,336544,336544,336545,0,1,2
96215,2,2,336546,336546,336548,0,2,1
96216,6,1,336552,336552,336553,0,1,4
96217,4,2,336556,336556,336558,0,2,3
96218,3,1,336559,336559,336560,0,1,1
96219,2,1,336561,336561,336562,0,1,1
96220,1,1,336562,336562,336563,0,1,0
96221,3,3,336565,336565,336568,0,3,2
96222,6,3,336571,336571,336574,0,3,3
96223,5,3,336576,336576,336579,0,3,2
96224,2,2,336578,336579,336581,1,3,0
96225,4,2,336582,336582,336584,0,2,1
96226,3,2,336585,336585,336587,0,2,1
96227,2,2,336587,336587,336589,0,2,0
96228,4,3,336591,336591,336594,0,3,2
96229,3,2,336594,336594,336596,0,2,0
96230,2,3,336596,336596,336599,0,3,0
96231,1,1,336597,336599,336600,2,3,0
96232,3,1,336600,336600,336601,0,1,0
96233,3,3,336603,336603,336606,0,3,2
96234,6,2,336609,336609,336611,0,2,3
96235,3,3,336612,336612,336615,0,3,1
96236,6,2,336618,336618,336620,0,2,3
96237,1,1,336619,336620,336621,1,2,0
96238,3,1,336622,336622,336623,0,1,1
96239,2,2,336624,336624,336626,0,2,1
96240,2,3,336626,336626,336629,0,3,0
96241,6,1,336632,336632,336633,0,1,3
96242,3,3,336635,336635,336638,0,3,2
96243,1,2,336636,336638,336640,2,4,0
96244,5,3,336641,336641,336644,0,3,1
96245,2,3,336643,336644,336647,1,4,0
96246,5,3,336648,336648,336651,0,3,1
96247,3,3,336651,336651,336654,0,3,0
96248,4,3,336655,336655,336658,0,3,1
96249,3,2,336658,336658,336660,0,2,0
96250,6,1,336664,336664,336665,0,1,4
96251,2,1,336666,336666,336667,0,1,1
96252,6,1,336672,336672,336673,0,1,5
96253,6,1,336678,336678,336679,0,1,5
96254,2,2,336680,336680,336682,0,2,1
96255,3,1,336683,336683,336684,0,1,1
96256,6,1,336689,336689,336690,0,1,5
96257,4,3,336693,336693,336696,0,3,3
96258,6,3,336699,336699,336702,0,3,3
96259,1,2,336700,336702,336704,2,4,0
96260,1,3,336701,336704,336707,3,6,0
96261,2,2,336703,336707,336709,4,6,0
96262,5,2,336708,336709,336711,1,3,0
96263,5,1,336713,336713,336714,0,1,2
96264,6,1,336719,336719,336720,0,1,5
96265,2,2,336721,336721,336723,0,2,1
96266,6,3,336727,336727,336730,0,3,4
96267,5,2,336732,336732,336734,0,2,2
96268,3,1,336735,336735,336736,0,1,1
96269,2,1,336737,336737,336738,0,1,1
96270,5,2,336742,336742,336744,0,2,4
96271,3,2,336745,336745,336747,0,2,1
96272,1,1,336746,336747,336748,1,2,0
96273,3,2,336749,336749,336751,0,2,1
96274,5,2,336754,336754,336756,0,2,3
96275,6,3,336760,336760,336763,0,3,4
96276,3,3,336763,336763,336766,0,3,0
96277,4,3,336767,336767,336770,0,3,1
96278,1,3,336768,336770,336773,2,5,0
96279,6,2,336774,336774,336776,0,2,1
96280,5,1,336779,336779,336780,0,1,3
96281,2,3,336781,336781,336784,0,3,1
96282,6,3,336787,336787,336790,0,3,3
96283,4,1,336791,336791,336792,0,1,1
96284,6,1,336797,336797,336798,0,1,5
96285,4,1,336801,336801,336802,0,1,3
96286,1,3,336802,336802,336805,0,3,0
96287,5,3,336807,336807,336810,0,3,2
96288,1,3,336808,336810,336813,2,5,0
96289,3,1,336811,336813,336814,2,3,0
96290,5,1,336816,336816,336817,0,1,2
96291,5,1,336821,336821,336822,0,1,4
96292,3,2,336824,336824,336826,0,2,2
96293,2,3,336826,336826,336829,0,3,0
96294,2,1,336828,336829,336830,1,2,0
96295,5,3,336833,336833,336836,0,3,3
96296,1,2,336834,336836,336838,2,4,0
96297,6,3,336840,336840,336843,0,3,2
96298,5,2,336845,336845,336847,0,2,2
96299,3,3,336848,336848,336851,0,3,1
96300,3,1,336851,336851,336852,0,1,0
96301,1,2,336852,336852,336854,0,2,0
96302,2,1,336854,336854,336855,0,1,0
96303,5,1,336859,336859,336860,0,1,4
96304,4,2,336863,336863,336865,0,2,3
96305,2,3,336865,336865,336868,0,3,0
96306,4,1,336869,336869,336870,0,1,1
96307,2,2,336871,336871,336873,0,2,1
96308,5,3,336876,336876,336879,0,3,3
96309,5,1,336881,336881,336882,0,1,2
96310,1,2,336882,336882,336884,0,2,0
96311,2,3,336884,336884,336887,0,3,0
96312,3,3,336887,336887,336890,0,3,0
96313,4,2,336891,336891,336893,0,2,1
96314,2,3,336893,336893,336896,0,3,0
96315,5,1,336898,336898,336899,0,1,2
96316,1,1,336899,336899,336900,0,1,0
96317,6,2,336905,336905,336907,0,2,5
96318,5,1,336910,336910,336911,0,1,3
96319,3,1,336913,336913,336914,0,1,2
96320,2,1,336915,336915,336916,0,1,1
96321,1,3,336916,336916,336919,0,3,0
96322,3,3,336919,336919,336922,0,3,0
96323,5,2,336924,336924,336926,0,2,2
96324,6,3,336930,336930,336933,0,3,4
96325,2,1,336932,336933,336934,1,2,0
96326,6,2,336938,336938,336940,0,2,4
96327,5,1,336943,336943,336944,0,1,3
96328,4,3,336947,336947,336950,0,3,3
96329,4,1,336951,336951,336952,0,1,1
96330,1,3,336952,336952,336955,0,3,0
96331,6,3,336958,336958,336961,0,3,3
96332,2,1,336960,336961,336962,1,2,0
96333,6,2,336966,336966,336968,0,2,4
96334,2,1,336968,336968,336969,0,1,0
96335,6,2,336974,336974,336976,0,2,5
96336,4,2,336978,336978,336980,0,2,2
96337,1,1,336979,336980,336981,1,2,0
96338,3,1,336982,336982,336983,0,1,1
96339,2,2,336984,336984,336986,0,2,1
96340,5,3,336989,336989,336992,0,3,3
96341,2,2,336991,336992,336994,1,3,0
96342,4,2,336995,336995,336997,0,2,1
96343,1,2,336996,336997,336999,1,3,0
96344,4,1,337000,337000,337001,0,1,1
96345,2,2,337002,337002,337004,0,2,1
96346,3,1,337005,337005,337006,0,1,1
96347,2,2,337007,337007,337009,0,2,1
96348,2,3,337009,337009,337012,0,3,0
96349,4,2,337013,337013,337015,0,2,1
96350,1,2,337014,337015,337017,1,3,0
96351,1,3,337015,337017,337020,2,5,0
96352,6,1,337021,337021,337022,0,1,1
96353,2,1,337023,337023,337024,0,1,1
96354,3,2,337026,337026,337028,0,2,2
96355,4,3,337030,337030,337033,0,3,2
96356,3,2,337033,337033,337035,0,2,0
96357,4,2,337037,337037,337039,0,2,2
96358,6,2,337043,337043,337045,0,2,4
96359,1,2,337044,337045,337047,1,3,0
96360,1,1,337045,337047,337048,2,3,0
96361,3,2,337048,337048,337050,0,2,0
96362,4,2,337052,337052,337054,0,2,2
96363,4,2,337056,337056,337058,0,2,2
96364,2,2,337058,337058,337060,0,2,0
96365,2,1,337060,337060,337061,0,1,0
96366,6,2,337066,337066,337068,0,2,5
96367,5,2,337071,337071,337073,0,2,3
96368,4,2,337075,337075,337077,0,2,2
96369,5,1,337080,337080,337081,0,1,3
96370,6,2,337086,337086,337088,0,2,5
96371,6,1,337092,337092,337093,0,1,4
96372,3,2,337095,337095,337097,0,2,2
96373,2,1,337097,337097,337098,0,1,0
96374,4,2,337101,337101,337103,0,2,3
96375,1,3,337102,337103,337106,1,4,0
96376,3,1,337105,337106,337107,1,2,0
96377,2,3,337107,337107,337110,0,3,0
96378,4,3,337111,337111,337114,0,3,1
96379,4,2,337115,337115,337117,0,2,1
96380,5,3,337120,337120,337123,0,3,3
96381,2,3,337122,337123,337126,1,4,0
96382,4,3,337126,337126,337129,0,3,0
96383,5,3,337131,337131,337134,0,3,2
96384,1,2,337132,337134,337136,2,4,0
96385,1,1,337133,337136,337137,3,4,0
96386,6,3,337139,337139,337142,0,3,2
96387,6,3,337145,337145,337148,0,3,3
96388,6,1,337151,337151,337152,0,1,3
96389,5,1,337156,337156,337157,0,1,4
96390,4,1,337160,337160,337161,0,1,3
96391,6,1,337166,337166,337167,0,1,5
96392,5,1,337171,337171,337172,0,1,4
96393,3,3,337174,337174,337177,0,3,2
96394,2,2,337176,337177,337179,1,3,0
96395,5,1,337181,337181,337182,0,1,2
96396,1,1,337182,337182,337183,0,1,0
96397,4,1,337186,337186,337187,0,1,3
96398,1,1,337187,337187,337188,0,1,0
96399,1,1,337188,337188,337189,0,1,0
96400,2,1,337190,337190,337191,0,1,1
96401,4,2,337194,337194,337196,0,2,3
96402,2,3,337196,337196,337199,0,3,0
96403,2,3,337198,337199,337202,1,4,0
96404,2,3,337200,337202,337205,2,5,0
96405,2,1,337202,337205,337206,3,4,0
96406,3,3,337205,337206,337209,1,4,0
96407,1,3,337206,337209,337212,3,6,0
96408,4,1,337210,337212,337213,2,3,0
96409,4,2,337214,337214,337216,0,2,1
96410,5,3,337219,337219,337222,0,3,3
96411,6,2,337225,337225,337227,0,2,3
96412,4,1,337229,337229,337230,0,1,2
96413,2,1,337231,337231,337232,0,1,1
96414,2,1,337233,337233,337234,0,1,1
96415,1,3,337234,337234,337237,0,3,0
96416,1,2,337235,337237,337239,2,4,0
96417,5,3,337240,337240,337243,0,3,1
96418,1,1,337241,337243,337244,2,3,0
96419,5,3,337246,337246,337249,0,3,2
96420,2,3,337248,337249,337252,1,4,0
96421,6,2,337254,337254,337256,0,2,2
96422,2,1,337256,337256,337257,0,1,0
96423,4,2,337260,337260,337262,0,2,3
96424,1,2,337261,337262,337264,1,3,0
96425,6,1,337267,337267,337268,0,1,3
96426,4,2,337271,337271,337273,0,2,3
96427,4,3,337275,337275,337278,0,3,2
96428,4,2,337279,337279,337281,0,2,1
96429,5,3,337284,337284,337287,0,3,3
96430,6,1,337290,337290,337291,0,1,3
96431,4,1,337294,337294,337295,0,1,3
96432,5,2,337299,337299,337301,0,2,4
96433,2,1,337301,337301,337302,0,1,0
96434,4,2,337305,337305,337307,0,2,3
96435,5,2,337310,337310,337312,0,2,3
96436,4,3,337314,337314,337317,0,3,2
96437,4,3,337318,337318,337321,0,3,1
96438,3,2,337321,337321,337323,0,2,0
96439,4,3,337325,337325,337328,0,3,2
96440,3,1,337328,337328,337329,0,1,0
96441,3,3,337331,337331,337334,0,3,2
96442,6,2,337337,337337,337339,0,2,3
96443,4,3,337341,337341,337344,0,3,2
96444,1,3,337342,337344,337347,2,5,0
96445,1,3,337343,337347,337350,4,7,0
96446,5,1,337348,337350,337351,2,3,0
96447,3,1,337351,337351,337352,0,1,0
96448,6,1,337357,337357,337358,0,1,5
96449,4,1,337361,337361,337362,0,1,3
96450,5,3,337366,337366,337369,0,3,4
96451,1,3,337367,337369,337372,2,5,0
96452,1,3,337368,337372,337375,4,7,0
96453,4,1,337372,337375,337376,3,4,0
96454,6,1,337378,337378,337379,0,1,2
96455,2,1,337380,337380,337381,0,1,1
96456,3,2,337383,337383,337385,0,2,2
96457,5,2,337388,337388,337390,0,2,3
96458,3,3,337391,337391,337394,0,3,1
96459,4,2,337395,337395,337397,0,2,1
96460,6,1,337401,337401,337402,0,1,4
96461,5,1,337406,337406,337407,0,1,4
96462,5,3,337411,337411,337414,0,3,4
96463,6,1,337417,337417,337418,0,1,3
96464,4,2,337421,337421,337423,0,2,3
96465,3,1,337424,337424,337425,0,1,1
96466,2,1,337426,337426,337427,0,1,1
96467,3,3,337429,337429,337432,0,3,2
96468,3,1,337432,337432,337433,0,1,0
96469,2,3,337434,337434,337437,0,3,1
96470,6,1,337440,337440,337441,0,1,3
96471,2,3,337442,337442,337445,0,3,1
96472,1,3,337443,337445,337448,2,5,0
96473,6,2,337449,337449,337451,0,2,1
96474,4,2,337453,337453,337455,0,2,2
96475,3,1,337456,337456,337457,0,1,1
96476,4,2,337460,337460,337462,0,2,3
96477,5,1,337465,337465,337466,0,1,3
96478,2,1,337467,337467,337468,0,1,1
96479,4,3,337471,337471,337474,0,3,3
96480,5,2,337476,337476,337478,0,2,2
96481,1,3,337477,337478,337481,1,4,0
96482,3,2,337480,337481,337483,1,3,0
96483,4,3,337484,337484,337487,0,3,1
96484,2,1,337486,337487,337488,1,2,0
96485,6,1,337492,337492,337493,0,1,4
96486,5,1,337497,337497,337498,0,1,4
96487,5,1,337502,337502,337503,0,1,4
96488,4,1,337506,337506,337507,0,1,3
96489,1,1,337507,337507,337508,0,1,0
96490,6,2,337513,337513,337515,0,2,5
96491,5,2,337518,337518,337520,0,2,3
96492,3,1,337521,337521,337522,0,1,1
96493,2,1,337523,337523,337524,0,1,1
96494,2,3,337525,337525,337528,0,3,1
96495,6,3,337531,337531,337534,0,3,3
96496,6,2,337537,337537,337539,0,2,3
96497,6,2,337543,337543,337545,0,2,4
96498,2,1,337545,337545,337546,0,1,0
96499,6,2,337551,337551,337553,0,2,5
96500,3,2,337554,337554,337556,0,2,1
96501,6,1,337560,337560,337561,0,1,4
96502,4,3,337564,337564,337567,0,3,3
96503,6,1,337570,337570,337571,0,1,3
96504,2,2,337572,337572,337574,0,2,1
96505,4,3,337576,337576,337579,0,3,2
96506,6,3,337582,337582,337585,0,3,3
96507,3,1,337585,337585,337586,0,1,0
96508,4,1,337589,337589,337590,0,1,3
96509,5,2,337594,337594,337596,0,2,4
96510,6,1,337600,337600,337601,0,1,4
96511,5,1,337605,337605,337606,0,1,4
96512,5,1,337610,337610,337611,0,1,4
96513,6,2,337616,337616,337618,0,2,5
96514,6,3,337622,337622,337625,0,3,4
96515,5,3,337627,337627,337630,0,3,2
96516,2,1,337629,337630,337631,1,2,0
96517,1,2,337630,337631,337633,1,3,0
96518,5,3,337635,337635,337638,0,3,2
96519,5,2,337640,337640,337642,0,2,2
96520,2,2,337642,337642,337644,0,2,0
96521,6,1,337648,337648,337649,0,1,4
96522,4,2,337652,337652,337654,0,2,3
96523,2,3,337654,337654,337657,0,3,0
96524,6,1,337660,337660,337661,0,1,3
96525,2,3,337662,337662,337665,0,3,1
96526,1,3,337663,337665,337668,2,5,0
96527,5,1,337668,337668,337669,0,1,0
96528,2,2,337670,337670,337672,0,2,1
96529,6,3,337676,337676,337679,0,3,4
96530,3,3,337679,337679,337682,0,3,0
96531,6,1,337685,337685,337686,0,1,3
96532,1,2,337686,337686,337688,0,2,0
96533,1,3,337687,337688,337691,1,4,0
96534,3,1,337690,337691,337692,1,2,0
96535,3,2,337693,337693,337695,0,2,1
96536,1,2,337694,337695,337697,1,3,0
96537,3,2,337697,337697,337699,0,2,0
96538,3,3,337700,337700,337703,0,3,1
96539,6,1,337706,337706,337707,0,1,3
96540,3,2,337709,337709,337711,0,2,2
96541,1,3,337710,337711,337714,1,4,0
96542,2,2,337712,337714,337716,2,4,0
96543,1,2,337713,337716,337718,3,5,0
96544,1,3,337714,337718,337721,4,7,0
96545,3,2,337717,337721,337723,4,6,0
96546,2,3,337719,337723,337726,4,7,0
96547,1,2,337720,337726,337728,6,8,0
96548,1,1,337721,337728,337729,7,8,0
96549,5,3,337726,337729,337732,3,6,0
96550,5,3,337731,337732,337735,1,4,0
96551,2,3,337733,337735,337738,2,5,0
96552,1,1,337734,337738,337739,4,5,0
96553,5,2,337739,337739,337741,0,2,0
96554,5,3,337744,337744,337747,0,3,3
96555,2,2,337746,337747,337749,1,3,0
96556,4,1,337750,337750,337751,0,1,1
96557,3,3,337753,337753,337756,0,3,2
96558,3,1,337756,337756,337757,0,1,0
96559,6,2,337762,337762,337764,0,2,5
96560,4,2,337766,337766,337768,0,2,2
96561,1,2,337767,337768,337770,1,3,0
96562,6,1,337773,337773,337774,0,1,3
96563,4,3,337777,337777,337780,0,3,3
96564,6,3,337783,337783,337786,0,3,3
96565,2,2,337785,337786,337788,1,3,0
96566,1,2,337786,337788,337790,2,4,0
96567,3,3,337789,337790,337793,1,4,0
96568,5,2,337794,337794,337796,0,2,1
96569,6,3,337800,337800,337803,0,3,4
96570,5,1,337805,337805,337806,0,1,2
96571,4,1,337809,337809,337810,0,1,3
96572,1,2,337810,337810,337812,0,2,0
96573,2,1,337812,337812,337813,0,1,0
96574,1,2,337813,337813,337815,0,2,0
96575,5,1,337818,337818,337819,0,1,3
96576,6,1,337824,337824,337825,0,1,5
96577,6,2,337830,337830,337832,0,2,5
96578,2,1,337832,337832,337833,0,1,0
96579,5,2,337837,337837,337839,0,2,4
96580,3,1,337840,337840,337841,0,1,1
96581,3,3,337843,337843,337846,0,3,2
96582,1,2,337844,337846,337848,2,4,0
96583,6,2,337850,337850,337852,0,2,2
96584,1,3,337851,337852,337855,1,4,0
96585,5,1,337856,337856,337857,0,1,1
96586,3,2,337859,337859,337861,0,2,2
96587,3,2,337862,337862,337864,0,2,1
96588,1,2,337863,337864,337866,1,3,0
96589,2,3,337865,337866,337869,1,4,0
96590,2,2,337867,337869,337871,2,4,0
96591,5,3,337872,337872,337875,0,3,1
96592,2,3,337874,337875,337878,1,4,0
96593,4,2,337878,337878,337880,0,2,0
96594,2,2,337880,337880,337882,0,2,0
96595,4,2,337884,337884,337886,0,2,2
96596,2,3,337886,337886,337889,0,3,0
96597,6,2,337892,337892,337894,0,2,3
96598,5,3,337897,337897,337900,0,3,3
96599,2,3,337899,337900,337903,1,4,0
96600,1,1,337900,337903,337904,3,4,0
96601,3,1,337903,337904,337905,1,2,0
96602,1,3,337904,337905,337908,1,4,0
96603,4,1,337908,337908,337909,0,1,0
96604,4,1,337912,337912,337913,0,1,3
96605,6,3,337918,337918,337921,0,3,5
96606,6,1,337924,337924,337925,0,1,3
96607,6,2,337930,337930,337932,0,2,5
96608,5,1,337935,337935,337936,0,1,3
96609,5,1,337940,337940,337941,0,1,4
96610,4,2,337944,337944,337946,0,2,3
96611,4,2,337948,337948,337950,0,2,2
96612,6,1,337954,337954,337955,0,1,4
96613,3,2,337957,337957,337959,0,2,2
96614,3,1,337960,337960,337961,0,1,1
96615,2,2,337962,337962,337964,0,2,1
96616,4,1,337966,337966,337967,0,1,2
96617,3,2,337969,337969,337971,0,2,2
96618,2,2,337971,337971,337973,0,2,0
96619,3,3,337974,337974,337977,0,3,1
96620,3,3,337977,337977,337980,0,3,0
96621,1,1,337978,337980,337981,2,3,0
96622,3,2,337981,337981,337983,0,2,0
96623,1,2,337982,337983,337985,1,3,0
96624,6,3,337988,337988,337991,0,3,3
96625,5,1,337993,337993,337994,0,1,2
96626,4,3,337997,337997,338000,0,3,3
96627,5,2,338002,338002,338004,0,2,2
96628,1,3,338003,338004,338007,1,4,0
96629,4,2,338007,338007,338009,0,2,0
96630,5,2,338012,338012,338014,0,2,3
96631,5,1,338017,338017,338018,0,1,3
96632,6,2,338023,338023,338025,0,2,5
96633,3,1,338026,338026,338027,0,1,1
96634,3,1,338029,338029,338030,0,1,2
96635,2,2,338031,338031,338033,0,2,1
96636,5,1,338036,338036,338037,0,1,3
96637,5,3,338041,338041,338044,0,3,4
96638,1,1,338042,338044,338045,2,3,0
96639,4,2,338046,338046,338048,0,2,1
96640,2,3,338048,338048,338051,0,3,0
96641,6,2,338054,338054,338056,0,2,3
96642,1,2,338055,338056,338058,1,3,0
96643,1,1,338056,338058,338059,2,3,0
96644,6,2,338062,338062,338064,0,2,3
96645,5,3,338067,338067,338070,0,3,3
96646,5,1,338072,338072,338073,0,1,2
96647,1,1,338073,338073,338074,0,1,0
96648,4,3,338077,338077,338080,0,3,3
96649,2,2,338079,338080,338082,1,3,0
96650,6,3,338085,338085,338088,0,3,3
96651,3,1,338088,338088,338089,0,1,0
96652,1,1,338089,338089,338090,0,1,0
96653,1,3,338090,338090,338093,0,3,0
96654,3,2,338093,338093,338095,0,2,0
96655,2,3,338095,338095,338098,0,3,0
96656,6,3,338101,338101,338104,0,3,3
96657,1,3,338102,338104,338107,2,5,0
96658,3,1,338105,338107,338108,2,3,0
96659,4,3,338109,338109,338112,0,3,1
96660,2,3,338111,338112,338115,1,4,0
96661,3,3,338114,338115,338118,1,4,0
96662,6,1,338120,338120,338121,0,1,2
96663,4,1,338124,338124,338125,0,1,3
96664,6,3,338130,338130,338133,0,3,5
96665,5,1,338135,338135,338136,0,1,2
96666,3,2,338138,338138,338140,0,2,2
96667,5,2,338143,338143,338145,0,2,3
96668,1,3,338144,338145,338148,1,4,0
96669,5,2,338149,338149,338151,0,2,1
96670,6,2,338155,338155,338157,0,2,4
96671,4,1,338159,338159,338160,0,1,2
96672,3,2,338162,338162,338164,0,2,2
96673,2,2,338164,338164,338166,0,2,0
96674,4,2,338168,338168,338170,0,2,2
96675,4,1,338172,338172,338173,0,1,2
96676,2,3,338174,338174,338177,0,3,1
96677,1,2,338175,338177,338179,2,4,0
96678,6,2,338181,338181,338183,0,2,2
96679,3,1,338184,338184,338185,0,1,1
96680,5,1,338189,338189,338190,0,1,4
96681,6,2,338195,338195,338197,0,2,5
96682,5,3,338200,338200,338203,0,3,3
96683,6,2,338206,338206,338208,0,2,3
96684,2,1,338208,338208,338209,0,1,0
96685,3,3,338211,338211,338214,0,3,2
96686,1,3,338212,338214,338217,2,5,0
96687,2,2,338214,338217,338219,3,5,0
96688,4,2,338218,338219,338221,1,3,0
96689,3,1,338221,338221,338222,0,1,0
96690,4,2,338225,338225,338227,0,2,3
96691,2,1,338227,338227,338228,0,1,0
96692,3,2,338230,338230,338232,0,2,2
96693,4,1,338234,338234,338235,0,1,2
96694,5,1,338239,338239,338240,0,1,4
96695,5,1,338244,338244,338245,0,1,4
96696,3,2,338247,338247,338249,0,2,2
96697,5,2,338252,338252,338254,0,2,3
96698,6,1,338258,338258,338259,0,1,4
96699,4,2,338262,338262,338264,0,2,3
96700,1,3,338263,338264,338267,1,4,0
96701,1,3,338264,338267,338270,3,6,0
96702,5,1,338269,338270,338271,1,2,0
96703,4,1,338273,338273,338274,0,1,2
96704,6,3,338279,338279,338282,0,3,5
96705,4,2,338283,338283,338285,0,2,1
96706,5,1,338288,338288,338289,0,1,3
96707,4,1,338292,338292,338293,0,1,3
96708,3,3,338295,338295,338298,0,3,2
96709,5,2,338300,338300,338302,0,2,2
96710,2,3,338302,338302,338305,0,3,0
96711,6,3,338308,338308,338311,0,3,3
96712,2,3,338310,338311,338314,1,4,0
96713,5,2,338315,338315,338317,0,2,1
96714,5,3,338320,338320,338323,0,3,3
96715,2,2,338322,338323,338325,1,3,0
96716,5,1,338327,338327,338328,0,1,2
96717,3,2,338330,338330,338332,0,2,2
96718,2,2,338332,338332,338334,0,2,0
96719,1,2,338333,338334,338336,1,3,0
96720,3,2,338336,338336,338338,0,2,0
96721,1,2,338337,338338,338340,1,3,0
96722,4,1,338341,338341,338342,0,1,1
96723,2,1,338343,338343,338344,0,1,1
96724,5,3,338348,338348,338351,0,3,4
96725,2,3,338350,338351,338354,1,4,0
96726,6,1,338356,338356,338357,0,1,2
96727,3,2,338359,338359,338361,0,2,2
96728,2,2,338361,338361,338363,0,2,0
96729,1,3,338362,338363,338366,1,4,0
96730,6,2,338368,338368,338370,0,2,2
96731,4,1,338372,338372,338373,0,1,2
96732,2,2,338374,338374,338376,0,2,1
96733,6,3,338380,338380,338383,0,3,4
96734,5,2,338385,338385,338387,0,2,2
96735,1,1,338386,338387,338388,1,2,0
96736,1,1,338387,338388,338389,1,2,0
96737,3,2,338390,338390,338392,0,2,1
96738,1,3,338391,338392,338395,1,4,0
96739,2,1,338393,338395,338396,2,3,0
96740,2,2,338395,338396,338398,1,3,0
96741,3,1,338398,338398,338399,0,1,0
96742,2,1,338400,338400,338401,0,1,1
96743,4,1,338404,338404,338405,0,1,3
96744,4,2,338408,338408,338410,0,2,3
96745,2,3,338410,338410,338413,0,3,0
96746,5,3,338415,338415,338418,0,3,2
96747,1,2,338416,338418,338420,2,4,0
96748,4,3,338420,338420,338423,0,3,0
96749,1,1,338421,338423,338424,2,3,0
96750,3,3,338424,338424,338427,0,3,0
96751,6,1,338430,338430,338431,0,1,3
96752,6,2,338436,338436,338438,0,2,5
96753,6,2,338442,338442,338444,0,2,4
96754,4,2,338446,338446,338448,0,2,2
96755,6,1,338452,338452,338453,0,1,4
96756,3,3,338455,338455,338458,0,3,2
96757,4,2,338459,338459,338461,0,2,1
96758,4,3,338463,338463,338466,0,3,2
96759,3,2,338466,338466,338468,0,2,0
96760,4,2,338470,338470,338472,0,2,2
96761,1,2,338471,338472,338474,1,3,0
96762,3,3,338474,338474,338477,0,3,0
96763,6,1,338480,338480,338481,0,1,3
96764,2,3,338482,338482,338485,0,3,1
96765,2,2,338484,338485,338487,1,3,0
96766,4,3,338488,338488,338491,0,3,1
96767,2,1,338490,338491,338492,1,2,0
96768,3,3,338493,338493,338496,0,3,1
96769,6,2,338499,338499,338501,0,2,3
96770,4,2,338503,338503,338505,0,2,2
96771,4,3,338507,338507,338510,0,3,2
96772,3,1,338510,338510,338511,0,1,0
96773,3,3,338513,338513,338516,0,3,2
96774,5,1,338518,338518,338519,0,1,2
96775,3,1,338521,338521,338522,0,1,2
96776,5,2,338526,338526,338528,0,2,4
96777,6,2,338532,338532,338534,0,2,4
96778,3,1,338535,338535,338536,0,1,1
96779,1,2,338536,338536,338538,0,2,0
96780,2,1,338538,338538,338539,0,1,0
96781,1,3,338539,338539,338542,0,3,0
96782,4,1,338543,338543,338544,0,1,1
96783,1,1,338544,338544,338545,0,1,0
96784,6,3,338550,338550,338553,0,3,5
96785,1,2,338551,338553,338555,2,4,0
96786,2,2,338553,338555,338557,2,4,0
96787,4,3,338557,338557,338560,0,3,0
96788,6,2,338563,338563,338565,0,2,3
96789,3,2,338566,338566,338568,0,2,1
96790,6,2,338572,338572,338574,0,2,4
96791,2,2,338574,338574,338576,0,2,0
96792,2,3,338576,338576,338579,0,3,0
96793,3,2,338579,338579,338581,0,2,0
96794,2,2,338581,338581,338583,0,2,0
96795,4,3,338585,338585,338588,0,3,2
96796,2,2,338587,338588,338590,1,3,0
96797,3,2,338590,338590,338592,0,2,0
96798,4,2,338594,338594,338596,0,2,2
96799,4,1,338598,338598,338599,0,1,2
96800,3,2,338601,338601,338603,0,2,2
96801,4,3,338605,338605,338608,0,3,2
96802,5,3,338610,338610,338613,0,3,2
96803,3,2,338613,338613,338615,0,2,0
96804,2,3,338615,338615,338618,0,3,0
96805,5,2,338620,338620,338622,0,2,2
96806,5,2,338625,338625,338627,0,2,3
96807,2,3,338627,338627,338630,0,3,0
96808,4,2,338631,338631,338633,0,2,1
96809,3,1,338634,338634,338635,0,1,1
96810,6,2,338640,338640,338642,0,2,5
96811,5,3,338645,338645,338648,0,3,3
96812,1,3,338646,338648,338651,2,5,0
96813,4,1,338650,338651,338652,1,2,0
96814,1,2,338651,338652,338654,1,3,0
96815,6,3,338657,338657,338660,0,3,3
96816,6,2,338663,338663,338665,0,2,3
96817,5,2,338668,338668,338670,0,2,3
96818,1,2,338669,338670,338672,1,3,0
96819,3,3,338672,338672,338675,0,3,0
96820,6,3,338678,338678,338681,0,3,3
96821,5,2,338683,338683,338685,0,2,2
96822,1,1,338684,338685,338686,1,2,0
96823,3,1,338687,338687,338688,0,1,1
96824,5,3,338692,338692,338695,0,3,4
96825,6,2,338698,338698,338700,0,2,3
96826,3,2,338701,338701,338703,0,2,1
96827,6,2,338707,338707,338709,0,2,4
96828,5,2,338712,338712,338714,0,2,3
96829,2,3,338714,338714,338717,0,3,0
96830,3,2,338717,338717,338719,0,2,0
96831,3,3,338720,338720,338723,0,3,1
96832,1,1,338721,338723,338724,2,3,0
96833,4,2,338725,338725,338727,0,2,1
96834,2,1,338727,338727,338728,0,1,0
96835,5,2,338732,338732,338734,0,2,4
96836,1,3,338733,338734,338737,1,4,0
96837,5,2,338738,338738,338740,0,2,1
96838,1,3,338739,338740,338743,1,4,0
96839,3,3,338742,338743,338746,1,4,0
96840,3,2,338745,338746,338748,1,3,0
96841,3,2,338748,338748,338750,0,2,0
96842,3,1,338751,338751,338752,0,1,1
96843,3,1,338754,338754,338755,0,1,2
96844,3,1,338757,338757,338758,0,1,2
96845,6,3,338763,338763,338766,0,3,5
96846,4,1,338767,338767,338768,0,1,1
96847,4,1,338771,338771,338772,0,1,3
96848,4,3,338775,338775,338778,0,3,3
96849,4,1,338779,338779,338780,0,1,1
96850,6,2,338785,338785,338787,0,2,5
96851,2,3,338787,338787,338790,0,3,0
96852,4,2,338791,338791,338793,0,2,1
96853,1,1,338792,338793,338794,1,2,0
96854,2,3,338794,338794,338797,0,3,0
96855,6,3,338800,338800,338803,0,3,3
96856,3,1,338803,338803,338804,0,1,0
96857,5,1,338808,338808,338809,0,1,4
96858,5,2,338813,338813,338815,0,2,4
96859,4,1,338817,338817,338818,0,1,2
96860,1,3,338818,338818,338821,0,3,0
96861,6,1,338824,338824,338825,0,1,3
96862,2,3,338826,338826,338829,0,3,1
96863,6,1,338832,338832,338833,0,1,3
96864,1,3,338833,338833,338836,0,3,0
96865,1,1,338834,338836,338837,2,3,0
96866,6,2,338840,338840,338842,0,2,3
96867,1,1,338841,338842,338843,1,2,0
96868,5,2,338846,338846,338848,0,2,3
96869,4,1,338850,338850,338851,0,1,2
96870,6,1,338856,338856,338857,0,1,5
96871,3,3,338859,338859,338862,0,3,2
96872,2,1,338861,338862,338863,1,2,0
96873,6,1,338867,338867,338868,0,1,4
96874,1,3,338868,338868,338871,0,3,0
96875,5,3,338873,338873,338876,0,3,2
96876,2,3,338875,338876,338879,1,4,0
96877,3,2,338878,338879,338881,1,3,0
96878,5,2,338883,338883,338885,0,2,2
96879,5,2,338888,338888,338890,0,2,3
96880,1,3,338889,338890,338893,1,4,0
96881,5,2,338894,338894,338896,0,2,1
96882,6,3,338900,338900,338903,0,3,4
96883,1,1,338901,338903,338904,2,3,0
96884,5,1,338906,338906,338907,0,1,2
96885,1,1,338907,338907,338908,0,1,0
96886,4,3,338911,338911,338914,0,3,3
96887,6,3,338917,338917,338920,0,3,3
96888,5,2,338922,338922,338924,0,2,2
96889,6,1,338928,338928,338929,0,1,4
96890,2,1,338930,338930,338931,0,1,1
96891,3,2,338933,338933,338935,0,2,2
96892,3,3,338936,338936,338939,0,3,1
96893,2,1,338938,338939,338940,1,2,0
96894,4,2,338942,338942,338944,0,2,2
96895,4,2,338946,338946,338948,0,2,2
96896,6,3,338952,338952,338955,0,3,4
96897,6,1,338958,338958,338959,0,1,3
96898,3,2,338961,338961,338963,0,2,2
96899,1,1,338962,338963,338964,1,2,0
96900,5,1,338967,338967,338968,0,1,3
96901,3,1,338970,338970,338971,0,1,2
96902,2,2,338972,338972,338974,0,2,1
96903,4,2,338976,338976,338978,0,2,2
96904,4,1,338980,338980,338981,0,1,2
96905,2,3,338982,338982,338985,0,3,1
96906,4,2,338986,338986,338988,0,2,1
96907,6,2,338992,338992,338994,0,2,4
96908,5,3,338997,338997,339000,0,3,3
96909,3,1,339000,339000,339001,0,1,0
96910,1,1,339001,339001,339002,0,1,0
96911,1,1,339002,339002,339003,0,1,0
96912,2,2,339004,339004,339006,0,2,1
96913,1,1,339005,339006,339007,1,2,0
96914,3,2,339008,339008,339010,0,2,1
96915,3,1,339011,339011,339012,0,1,1
96916,5,2,339016,339016,339018,0,2,4
96917,5,1,339021,339021,339022,0,1,3
96918,5,1,339026,339026,339027,0,1,4
96919,4,2,339030,339030,339032,0,2,3
96920,1,3,339031,339032,339035,1,4,0
96921,3,1,339034,339035,339036,1,2,0
96922,3,3,339037,339037,339040,0,3,1
96923,3,3,339040,339040,339043,0,3,0
96924,6,3,339046,339046,339049,0,3,3
96925,2,2,339048,339049,339051,1,3,0
96926,4,3,339052,339052,339055,0,3,1
96927,1,2,339053,339055,339057,2,4,0
96928,2,3,339055,339057,339060,2,5,0
96929,6,2,339061,339061,339063,0,2,1
96930,5,2,339066,339066,339068,0,2,3
96931,2,1,339068,339068,339069,0,1,0
96932,3,2,339071,339071,339073,0,2,2
96933,1,3,339072,339073,339076,1,4,0
96934,4,3,339076,339076,339079,0,3,0
96935,6,1,339082,339082,339083,0,1,3
96936,5,1,339087,339087,339088,0,1,4
96937,4,3,339091,339091,339094,0,3,3
96938,6,1,339097,339097,339098,0,1,3
96939,5,3,339102,339102,339105,0,3,4
96940,5,1,339107,339107,339108,0,1,2
96941,2,1,339109,339109,339110,0,1,1
96942,3,2,339112,339112,339114,0,2,2
96943,3,1,339115,339115,339116,0,1,1
96944,6,1,339121,339121,339122,0,1,5
96945,1,2,339122,339122,339124,0,2,0
96946,3,1,339125,339125,339126,0,1,1
96947,4,2,339129,339129,339131,0,2,3
96948,1,3,339130,339131,339134,1,4,0
96949,4,3,339134,339134,339137,0,3,0
96950,2,3,339136,339137,339140,1,4,0
96951,2,1,339138,339140,339141,2,3,0
96952,6,1,339144,339144,339145,0,1,3
96953,4,3,339148,339148,339151,0,3,3
96954,6,2,339154,339154,339156,0,2,3
96955,1,1,339155,339156,339157,1,2,0
96956,6,3,339161,339161,339164,0,3,4
96957,1,3,339162,339164,339167,2,5,0
96958,1,3,339163,339167,339170,4,7,0
96959,2,2,339165,339170,339172,5,7,0
96960,6,3,339171,339172,339175,1,4,0
96961,5,3,339176,339176,339179,0,3,1
96962,1,2,339177,339179,339181,2,4,0
96963,1,3,339178,339181,339184,3,6,0
96964,4,1,339182,339184,339185,2,3,0
96965,5,1,339187,339187,339188,0,1,2
96966,2,1,339189,339189,339190,0,1,1
96967,5,1,339194,339194,339195,0,1,4
96968,5,3,339199,339199,339202,0,3,4
96969,2,1,339201,339202,339203,1,2,0
96970,4,1,339205,339205,339206,0,1,2
96971,1,1,339206,339206,339207,0,1,0
96972,5,2,339211,339211,339213,0,2,4
96973,2,3,339213,339213,339216,0,3,0
96974,3,2,339216,339216,339218,0,2,0
96975,4,3,339220,339220,339223,0,3,2
96976,3,1,339223,339223,339224,0,1,0
96977,2,1,339225,339225,339226,0,1,1
96978,1,2,339226,339226,339228,0,2,0
96979,6,2,339232,339232,339234,0,2,4
96980,4,2,339236,339236,339238,0,2,2
96981,5,3,339241,339241,339244,0,3,3
96982,4,3,339245,339245,339248,0,3,1
96983,2,1,339247,339248,339249,1,2,0
96984,6,2,339253,339253,339255,0,2,4
96985,6,3,339259,339259,339262,0,3,4
96986,5,3,339264,339264,339267,0,3,2
96987,4,2,339268,339268,339270,0,2,1
96988,6,1,339274,339274,339275,0,1,4
96989,2,1,339276,339276,339277,0,1,1
96990,5,3,339281,339281,339284,0,3,4
96991,4,3,339285,339285,339288,0,3,1
96992,6,3,339291,339291,339294,0,3,3
96993,4,3,339295,339295,339298,0,3,1
96994,6,2,339301,339301,339303,0,2,3
96995,3,3,339304,339304,339307,0,3,1
96996,2,2,339306,339307,339309,1,3,0
96997,3,3,339309,339309,339312,0,3,0
96998,2,1,339311,339312,339313,1,2,0
96999,1,3,339312,339313,339316,1,4,0
97000,2,3,339314,339316,339319,2,5,0
97001,6,1,339320,339320,339321,0,1,1
97002,4,2,339324,339324,339326,0,2,3
97003,1,3,339325,339326,339329,1,4,0
97004,1,2,339326,339329,339331,3,5,0
97005,3,1,339329,339331,339332,2,3,0
97006,4,3,339333,339333,339336,0,3,1
97007,2,3,339335,339336,339339,1,4,0
97008,2,3,339337,339339,339342,2,5,0
97009,4,2,339341,339342,339344,1,3,0
97010,5,2,339346,339346,339348,0,2,2
97011,2,2,339348,339348,339350,0,2,0
97012,3,2,339351,339351,339353,0,2,1
97013,4,2,339355,339355,339357,0,2,2
97014,2,2,339357,339357,339359,0,2,0
97015,5,3,339362,339362,339365,0,3,3
97016,2,2,339364,339365,339367,1,3,0
97017,2,2,339366,339367,339369,1,3,0
97018,1,2,339367,339369,339371,2,4,0
97019,6,1,339373,339373,339374,0,1,2
97020,4,3,339377,339377,339380,0,3,3
97021,2,3,339379,339380,339383,1,4,0
97022,6,2,339385,339385,339387,0,2,2
97023,1,2,339386,339387,339389,1,3,0
97024,6,2,339392,339392,339394,0,2,3
97025,4,3,339396,339396,339399,0,3,2
97026,5,3,339401,339401,339404,0,3,2
97027,3,2,339404,339404,339406,0,2,0
97028,4,3,339408,339408,339411,0,3,2
97029,5,2,339413,339413,339415,0,2,2
97030,5,1,339418,339418,339419,0,1,3
97031,5,3,339423,339423,339426,0,3,4
97032,1,2,339424,339426,339428,2,4,0
97033,4,2,339428,339428,339430,0,2,0
97034,3,1,339431,339431,339432,0,1,1
97035,1,1,339432,339432,339433,0,1,0
97036,6,2,339438,339438,339440,0,2,5
97037,1,2,339439,339440,339442,1,3,0
97038,5,1,339444,339444,339445,0,1,2
97039,5,2,339449,339449,339451,0,2,4
97040,5,3,339454,339454,339457,0,3,3
97041,5,3,339459,339459,339462,0,3,2
97042,3,2,339462,339462,339464,0,2,0
97043,2,3,339464,339464,339467,0,3,0
97044,1,3,339465,339467,339470,2,5,0
97045,6,2,339471,339471,339473,0,2,1
97046,4,2,339475,339475,339477,0,2,2
97047,6,1,339481,339481,339482,0,1,4
97048,5,3,339486,339486,339489,0,3,4
97049,6,3,339492,339492,339495,0,3,3
97050,3,1,339495,339495,339496,0,1,0
97051,5,1,339500,339500,339501,0,1,4
97052,1,3,339501,339501,339504,0,3,0
97053,6,2,339507,339507,339509,0,2,3
97054,2,1,339509,339509,339510,0,1,0
97055,5,2,339514,339514,339516,0,2,4
97056,5,2,339519,339519,339521,0,2,3
97057,5,3,339524,339524,339527,0,3,3
97058,4,3,339528,339528,339531,0,3,1
97059,1,3,339529,339531,339534,2,5,0
97060,1,3,339530,339534,339537,4,7,0
97061,2,3,339532,339537,339540,5,8,0
97062,2,1,339534,339540,339541,6,7,0
97063,3,3,339537,339541,339544,4,7,0
97064,1,3,339538,339544,339547,6,9,0
97065,6,1,339544,339547,339548,3,4,0
97066,1,1,339545,339548,339549,3,4,0
97067,5,2,339550,339550,339552,0,2,1
97068,4,2,339554,339554,339556,0,2,2
97069,1,3,339555,339556,339559,1,4,0
97070,5,3,339560,339560,339563,0,3,1
97071,3,3,339563,339563,339566,0,3,0
97072,3,2,339566,339566,339568,0,2,0
97073,3,2,339569,339569,339571,0,2,1
97074,2,2,339571,339571,339573,0,2,0
97075,6,1,339577,339577,339578,0,1,4
97076,3,2,339580,339580,339582,0,2,2
97077,6,2,339586,339586,339588,0,2,4
97078,1,3,339587,339588,339591,1,4,0
97079,6,3,339593,339593,339596,0,3,2
97080,5,2,339598,339598,339600,0,2,2
97081,5,2,339603,339603,339605,0,2,3
97082,3,2,339606,339606,339608,0,2,1
97083,6,2,339612,339612,339614,0,2,4
97084,5,1,339617,339617,339618,0,1,3
97085,2,3,339619,339619,339622,0,3,1
97086,4,1,339623,339623,339624,0,1,1
97087,5,1,339628,339628,339629,0,1,4
97088,6,1,339634,339634,339635,0,1,5
97089,3,2,339637,339637,339639,0,2,2
97090,1,3,339638,339639,339642,1,4,0
97091,2,3,339640,339642,339645,2,5,0
97092,2,2,339642,339645,339647,3,5,0
97093,1,3,339643,339647,339650,4,7,0
97094,1,1,339644,339650,339651,6,7,0
97095,1,3,339645,339651,339654,6,9,0
97096,4,3,339649,339654,339657,5,8,0
97097,3,3,339652,339657,339660,5,8,0
97098,4,1,339656,339660,339661,4,5,0
97099,1,2,339657,339661,339663,4,6,0
97100,5,3,339662,339663,339666,1,4,0
97101,1,2,339663,339666,339668,3,5,0
97102,5,1,339668,339668,339669,0,1,0
97103,5,3,339673,339673,339676,0,3,4
97104,2,1,339675,339676,339677,1,2,0
97105,4,1,339679,339679,339680,0,1,2
97106,3,2,339682,339682,339684,0,2,2
97107,4,1,339686,339686,339687,0,1,2
97108,4,1,339690,339690,339691,0,1,3
97109,6,1,339696,339696,339697,0,1,5
97110,1,1,339697,339697,339698,0,1,0
97111,6,1,339703,339703,339704,0,1,5
97112,4,1,339707,339707,339708,0,1,3
97113,4,1,339711,339711,339712,0,1,3
97114,3,3,339714,339714,339717,0,3,2
97115,2,3,339716,339717,339720,1,4,0
97116,6,2,339722,339722,339724,0,2,2
97117,2,3,339724,339724,339727,0,3,0
97118,5,2,339729,339729,339731,0,2,2
97119,2,1,339731,339731,339732,0,1,0
97120,5,2,339736,339736,339738,0,2,4
97121,2,2,339738,339738,339740,0,2,0
97122,6,3,339744,339744,339747,0,3,4
97123,3,3,339747,339747,339750,0,3,0
97124,6,1,339753,339753,339754,0,1,3
97125,5,2,339758,339758,339760,0,2,4
97126,1,1,339759,339760,339761,1,2,0
97127,4,3,339763,339763,339766,0,3,2
97128,2,3,339765,339766,339769,1,4,0
97129,2,2,339767,339769,339771,2,4,0
97130,1,2,339768,339771,339773,3,5,0
97131,4,1,339772,339773,339774,1,2,0
97132,4,2,339776,339776,339778,0,2,2
97133,5,3,339781,339781,339784,0,3,3
97134,3,1,339784,339784,339785,0,1,0
97135,5,2,339789,339789,339791,0,2,4
97136,2,1,339791,339791,339792,0,1,0
97137,3,1,339794,339794,339795,0,1,2
97138,3,3,339797,339797,339800,0,3,2
97139,3,2,339800,339800,339802,0,2,0
97140,2,2,339802,339802,339804,0,2,0
97141,4,1,339806,339806,339807,0,1,2
97142,2,1,339808,339808,339809,0,1,1
97143,1,2,339809,339809,339811,0,2,0
97144,5,2,339814,339814,339816,0,2,3
97145,1,3,339815,339816,339819,1,4,0
97146,5,1,339820,339820,339821,0,1,1
97147,6,3,339826,339826,339829,0,3,5
97148,5,1,339831,339831,339832,0,1,2
97149,3,1,339834,339834,339835,0,1,2
97150,1,2,339835,339835,339837,0,2,0
97151,6,1,339841,339841,339842,0,1,4
97152,2,2,339843,339843,339845,0,2,1
97153,5,2,339848,339848,339850,0,2,3
97154,3,1,339851,339851,339852,0,1,1
97155,4,2,339855,339855,339857,0,2,3
97156,4,3,339859,339859,339862,0,3,2
97157,5,1,339864,339864,339865,0,1,2
97158,5,2,339869,339869,339871,0,2,4
97159,4,1,339873,339873,339874,0,1,2
97160,5,3,339878,339878,339881,0,3,4
97161,2,3,339880,339881,339884,1,4,0
97162,6,2,339886,339886,339888,0,2,2
97163,5,2,339891,339891,339893,0,2,3
97164,4,2,339895,339895,339897,0,2,2
97165,6,3,339901,339901,339904,0,3,4
97166,5,1,339906,339906,339907,0,1,2
97167,3,1,339909,339909,339910,0,1,2
97168,4,1,339913,339913,339914,0,1,3
97169,3,1,339916,339916,339917,0,1,2
97170,3,1,339919,339919,339920,0,1,2
97171,4,1,339923,339923,339924,0,1,3
97172,5,1,339928,339928,339929,0,1,4
97173,4,1,339932,339932,339933,0,1,3
97174,2,3,339934,339934,339937,0,3,1
97175,5,1,339939,339939,339940,0,1,2
97176,5,3,339944,339944,339947,0,3,4
97177,5,1,339949,339949,339950,0,1,2
97178,4,2,339953,339953,339955,0,2,3
97179,5,2,339958,339958,339960,0,2,3
97180,4,1,339962,339962,339963,0,1,2
97181,1,3,339963,339963,339966,0,3,0
97182,2,3,339965,339966,339969,1,4,0
97183,5,1,339970,339970,339971,0,1,1
97184,6,3,339976,339976,339979,0,3,5
97185,3,3,339979,339979,339982,0,3,0
97186,1,2,339980,339982,339984,2,4,0
97187,1,1,339981,339984,339985,3,4,0
97188,5,1,339986,339986,339987,0,1,1
97189,6,2,339992,339992,339994,0,2,5
97190,5,1,339997,339997,339998,0,1,3
97191,2,2,339999,339999,340001,0,2,1
97192,5,2,340004,340004,340006,0,2,3
97193,1,3,340005,340006,340009,1,4,0
97194,3,3,340008,340009,340012,1,4,0
97195,6,3,340014,340014,340017,0,3,2
97196,5,1,340019,340019,340020,0,1,2
97197,2,3,340021,340021,340024,0,3,1
97198,3,1,340024,340024,340025,0,1,0
97199,4,1,340028,340028,340029,0,1,3
97200,5,3,340033,340033,340036,0,3,4
97201,2,3,340035,340036,340039,1,4,0
97202,3,3,340038,340039,340042,1,4,0
97203,2,2,340040,340042,340044,2,4,0
97204,6,2,340046,340046,340048,0,2,2
97205,5,2,340051,340051,340053,0,2,3
97206,2,1,340053,340053,340054,0,1,0
97207,1,2,340054,340054,340056,0,2,0
97208,5,2,340059,340059,340061,0,2,3
97209,4,2,340063,340063,340065,0,2,2
97210,6,2,340069,340069,340071,0,2,4
97211,6,1,340075,340075,340076,0,1,4
97212,5,1,340080,340080,340081,0,1,4
97213,6,3,340086,340086,340089,0,3,5
97214,3,1,340089,340089,340090,0,1,0
97215,6,1,340095,340095,340096,0,1,5
97216,1,1,340096,340096,340097,0,1,0
97217,1,1,340097,340097,340098,0,1,0
97218,1,1,340098,340098,340099,0,1,0
97219,2,2,340100,340100,340102,0,2,1
97220,6,3,340106,340106,340109,0,3,4
97221,3,1,340109,340109,340110,0,1,0
97222,4,2,340113,340113,340115,0,2,3
97223,4,2,340117,340117,340119,0,2,2
97224,2,1,340119,340119,340120,0,1,0
97225,6,1,340125,340125,340126,0,1,5
97226,6,1,340131,340131,340132,0,1,5
97227,4,1,340135,340135,340136,0,1,3
97228,3,2,340138,340138,340140,0,2,2
97229,3,3,340141,340141,340144,0,3,1
97230,3,1,340144,340144,340145,0,1,0
97231,3,3,340147,340147,340150,0,3,2
97232,1,3,340148,340150,340153,2,5,0
97233,1,3,340149,340153,340156,4,7,0
97234,1,3,340150,340156,340159,6,9,0
97235,3,3,340153,340159,340162,6,9,0
97236,4,1,340157,340162,340163,5,6,0
97237,3,3,340160,340163,340166,3,6,0
97238,5,3,340165,340166,340169,1,4,0
97239,3,3,340168,340169,340172,1,4,0
97240,4,2,340172,340172,340174,0,2,0
97241,3,1,340175,340175,340176,0,1,1
97242,2,1,340177,340177,340178,0,1,1
97243,4,3,340181,340181,340184,0,3,3
97244,4,2,340185,340185,340187,0,2,1
97245,1,3,340186,340187,340190,1,4,0
97246,6,1,340192,340192,340193,0,1,2
97247,3,3,340195,340195,340198,0,3,2
97248,2,2,340197,340198,340200,1,3,0
97249,4,3,340201,340201,340204,0,3,1
97250,4,2,340205,340205,340207,0,2,1
97251,5,1,340210,340210,340211,0,1,3
97252,6,1,340216,340216,340217,0,1,5
97253,3,2,340219,340219,340221,0,2,2
97254,4,3,340223,340223,340226,0,3,2
97255,4,2,340227,340227,340229,0,2,1
97256,2,2,340229,340229,340231,0,2,0
97257,2,2,340231,340231,340233,0,2,0
97258,2,2,340233,340233,340235,0,2,0
97259,2,2,340235,340235,340237,0,2,0
97260,5,2,340240,340240,340242,0,2,3
97261,4,3,340244,340244,340247,0,3,2
97262,1,2,340245,340247,340249,2,4,0
97263,1,2,340246,340249,340251,3,5,0
97264,6,2,340252,340252,340254,0,2,1
97265,5,1,340257,340257,340258,0,1,3
97266,6,3,340263,340263,340266,0,3,5
97267,4,3,340267,340267,340270,0,3,1
97268,2,1,340269,340270,340271,1,2,0
97269,2,3,340271,340271,340274,0,3,0
97270,2,1,340273,340274,340275,1,2,0
97271,5,1,340278,340278,340279,0,1,3
97272,6,2,340284,340284,340286,0,2,5
97273,2,3,340286,340286,340289,0,3,0
97274,4,3,340290,340290,340293,0,3,1
97275,5,3,340295,340295,340298,0,3,2
97276,1,1,340296,340298,340299,2,3,0
97277,5,1,340301,340301,340302,0,1,2
97278,2,3,340303,340303,340306,0,3,1
97279,5,1,340308,340308,340309,0,1,2
97280,3,3,340311,340311,340314,0,3,2
97281,6,3,340317,340317,340320,0,3,3
97282,3,3,340320,340320,340323,0,3,0
97283,2,2,340322,340323,340325,1,3,0
97284,3,1,340325,340325,340326,0,1,0
97285,4,1,340329,340329,340330,0,1,3
97286,2,2,340331,340331,340333,0,2,1
97287,3,3,340334,340334,340337,0,3,1
97288,5,2,340339,340339,340341,0,2,2
97289,3,2,340342,340342,340344,0,2,1
97290,3,3,340345,340345,340348,0,3,1
97291,6,2,340351,340351,340353,0,2,3
97292,4,3,340355,340355,340358,0,3,2
97293,1,1,340356,340358,340359,2,3,0
97294,2,2,340358,340359,340361,1,3,0
97295,2,1,340360,340361,340362,1,2,0
97296,5,3,340365,340365,340368,0,3,3
97297,6,2,340371,340371,340373,0,2,3
97298,6,3,340377,340377,340380,0,3,4
97299,6,1,340383,340383,340384,0,1,3
97300,5,1,340388,340388,340389,0,1,4
97301,3,2,340391,340391,340393,0,2,2
97302,3,3,340394,340394,340397,0,3,1
97303,2,2,340396,340397,340399,1,3,0
97304,5,3,340401,340401,340404,0,3,2
97305,5,1,340406,340406,340407,0,1,2
97306,1,3,340407,340407,340410,0,3,0
97307,1,3,340408,340410,340413,2,5,0
97308,2,3,340410,340413,340416,3,6,0
97309,5,1,340415,340416,340417,1,2,0
97310,3,2,340418,340418,340420,0,2,1
97311,4,2,340422,340422,340424,0,2,2
97312,3,1,340425,340425,340426,0,1,1
97313,1,1,340426,340426,340427,0,1,0
97314,1,1,340427,340427,340428,0,1,0
97315,1,2,340428,340428,340430,0,2,0
97316,1,3,340429,340430,340433,1,4,0
97317,2,3,340431,340433,340436,2,5,0
97318,4,1,340435,340436,340437,1,2,0
97319,3,2,340438,340438,340440,0,2,1
97320,1,2,340439,340440,340442,1,3,0
97321,3,3,340442,340442,340445,0,3,0
97322,1,2,340443,340445,340447,2,4,0
97323,5,2,340448,340448,340450,0,2,1
97324,6,1,340454,340454,340455,0,1,4
97325,6,1,340460,340460,340461,0,1,5
97326,1,3,340461,340461,340464,0,3,0
97327,5,2,340466,340466,340468,0,2,2
97328,4,2,340470,340470,340472,0,2,2
97329,3,1,340473,340473,340474,0,1,1
97330,6,3,340479,340479,340482,0,3,5
97331,2,1,340481,340482,340483,1,2,0
97332,4,1,340485,340485,340486,0,1,2
97333,6,2,340491,340491,340493,0,2,5
97334,2,1,340493,340493,340494,0,1,0
97335,5,1,340498,340498,340499,0,1,4
97336,3,3,340501,340501,340504,0,3,2
97337,5,3,340506,340506,340509,0,3,2
97338,1,2,340507,340509,340511,2,4,0
97339,6,1,340513,340513,340514,0,1,2
97340,4,3,340517,340517,340520,0,3,3
97341,5,1,340522,340522,340523,0,1,2
97342,1,1,340523,340523,340524,0,1,0
97343,4,3,340527,340527,340530,0,3,3
97344,5,2,340532,340532,340534,0,2,2
97345,4,3,340536,340536,340539,0,3,2
97346,6,1,340542,340542,340543,0,1,3
97347,3,3,340545,340545,340548,0,3,2
97348,1,1,340546,340548,340549,2,3,0
97349,5,1,340551,340551,340552,0,1,2
97350,6,2,340557,340557,340559,0,2,5
97351,6,1,340563,340563,340564,0,1,4
97352,5,1,340568,340568,340569,0,1,4
97353,3,1,340571,340571,340572,0,1,2
97354,2,1,340573,340573,340574,0,1,1
97355,5,3,340578,340578,340581,0,3,4
97356,2,1,340580,340581,340582,1,2,0
97357,6,3,340586,340586,340589,0,3,4
97358,3,3,340589,340589,340592,0,3,0
97359,5,1,340594,340594,340595,0,1,2
97360,1,2,340595,340595,340597,0,2,0
97361,6,1,340601,340601,340602,0,1,4
97362,6,2,340607,340607,340609,0,2,5
97363,5,3,340612,340612,340615,0,3,3
97364,1,2,340613,340615,340617,2,4,0
97365,6,3,340619,340619,340622,0,3,2
97366,6,3,340625,340625,340628,0,3,3
97367,1,2,340626,340628,340630,2,4,0
97368,3,1,340629,340630,340631,1,2,0
97369,1,3,340630,340631,340634,1,4,0
97370,4,2,340634,340634,340636,0,2,0
97371,5,1,340639,340639,340640,0,1,3
97372,4,3,340643,340643,340646,0,3,3
97373,1,2,340644,340646,340648,2,4,0
97374,1,3,340645,340648,340651,3,6,0
97375,3,3,340648,340651,340654,3,6,0
97376,6,1,340654,340654,340655,0,1,0
97377,2,3,340656,340656,340659,0,3,1
97378,2,3,340658,340659,340662,1,4,0
97379,6,3,340664,340664,340667,0,3,2
97380,1,3,340665,340667,340670,2,5,0
97381,3,2,340668,340670,340672,2,4,0
97382,6,2,340674,340674,340676,0,2,2
97383,5,1,340679,340679,340680,0,1,3
97384,1,1,340680,340680,340681,0,1,0
97385,4,2,340684,340684,340686,0,2,3
97386,6,2,340690,340690,340692,0,2,4
97387,2,2,340692,340692,340694,0,2,0
97388,4,2,340696,340696,340698,0,2,2
97389,3,2,340699,340699,340701,0,2,1
97390,4,1,340703,340703,340704,0,1,2
97391,1,2,340704,340704,340706,0,2,0
97392,4,1,340708,340708,340709,0,1,2
97393,1,2,340709,340709,340711,0,2,0
97394,3,1,340712,340712,340713,0,1,1
97395,1,2,340713,340713,340715,0,2,0
97396,3,3,340716,340716,340719,0,3,1
97397,5,3,340721,340721,340724,0,3,2
97398,4,2,340725,340725,340727,0,2,1
97399,2,3,340727,340727,340730,0,3,0
97400,6,3,340733,340733,340736,0,3,3
97401,1,3,340734,340736,340739,2,5,0
97402,6,3,340740,340740,340743,0,3,1
97403,3,1,340743,340743,340744,0,1,0
97404,6,2,340749,340749,340751,0,2,5
97405,4,2,340753,340753,340755,0,2,2
97406,5,3,340758,340758,340761,0,3,3
97407,6,1,340764,340764,340765,0,1,3
97408,1,3,340765,340765,340768,0,3,0
97409,3,1,340768,340768,340769,0,1,0
97410,1,1,340769,340769,340770,0,1,0
97411,5,1,340774,340774,340775,0,1,4
97412,6,3,340780,340780,340783,0,3,5
97413,5,3,340785,340785,340788,0,3,2
97414,3,2,340788,340788,340790,0,2,0
97415,3,3,340791,340791,340794,0,3,1
97416,3,1,340794,340794,340795,0,1,0
97417,5,3,340799,340799,340802,0,3,4
97418,2,3,340801,340802,340805,1,4,0
97419,6,2,340807,340807,340809,0,2,2
97420,6,1,340813,340813,340814,0,1,4
97421,1,1,340814,340814,340815,0,1,0
97422,4,2,340818,340818,340820,0,2,3
97423,6,2,340824,340824,340826,0,2,4
97424,4,2,340828,340828,340830,0,2,2
97425,6,3,340834,340834,340837,0,3,4
97426,2,1,340836,340837,340838,1,2,0
97427,3,2,340839,340839,340841,0,2,1
97428,1,2,340840,340841,340843,1,3,0
97429,5,2,340845,340845,340847,0,2,2
97430,2,2,340847,340847,340849,0,2,0
97431,1,1,340848,340849,340850,1,2,0
97432,6,2,340854,340854,340856,0,2,4
97433,4,2,340858,340858,340860,0,2,2
97434,6,2,340864,340864,340866,0,2,4
97435,5,3,340869,340869,340872,0,3,3
97436,2,2,340871,340872,340874,1,3,0
97437,6,1,340877,340877,340878,0,1,3
97438,1,2,340878,340878,340880,0,2,0
97439,1,1,340879,340880,340881,1,2,0
97440,5,1,340884,340884,340885,0,1,3
97441,3,3,340887,340887,340890,0,3,2
97442,1,3,340888,340890,340893,2,5,0
97443,3,2,340891,340893,340895,2,4,0
97444,2,1,340893,340895,340896,2,3,0
97445,6,1,340899,340899,340900,0,1,3
97446,2,2,340901,340901,340903,0,2,1
97447,1,2,340902,340903,340905,1,3,0
97448,4,1,340906,340906,340907,0,1,1
97449,1,2,340907,340907,340909,0,2,0
97450,5,1,340912,340912,340913,0,1,3
97451,6,2,340918,340918,340920,0,2,5
97452,3,2,340921,340921,340923,0,2,1
97453,2,1,340923,340923,340924,0,1,0
97454,3,3,340926,340926,340929,0,3,2
97455,6,3,340932,340932,340935,0,3,3
97456,3,3,340935,340935,340938,0,3,0
97457,5,1,340940,340940,340941,0,1,2
97458,4,3,340944,340944,340947,0,3,3
97459,3,2,340947,340947,340949,0,2,0
97460,1,2,340948,340949,340951,1,3,0
97461,1,3,340949,340951,340954,2,5,0
97462,4,3,340953,340954,340957,1,4,0
97463,6,2,340959,340959,340961,0,2,2
97464,6,1,340965,340965,340966,0,1,4
97465,1,1,340966,340966,340967,0,1,0
97466,5,2,340971,340971,340973,0,2,4
97467,1,2,340972,340973,340975,1,3,0
97468,1,3,340973,340975,340978,2,5,0
97469,3,3,340976,340978,340981,2,5,0
97470,6,1,340982,340982,340983,0,1,1
97471,4,1,340986,340986,340987,0,1,3
97472,5,3,340991,340991,340994,0,3,4
97473,4,2,340995,340995,340997,0,2,1
97474,2,3,340997,340997,341000,0,3,0
97475,2,2,340999,341000,341002,1,3,0
97476,4,2,341003,341003,341005,0,2,1
97477,1,2,341004,341005,341007,1,3,0
97478,4,1,341008,341008,341009,0,1,1
97479,2,1,341010,341010,341011,0,1,1
97480,3,2,341013,341013,341015,0,2,2
97481,6,3,341019,341019,341022,0,3,4
97482,2,3,341021,341022,341025,1,4,0
97483,5,1,341026,341026,341027,0,1,1
97484,3,2,341029,341029,341031,0,2,2
97485,1,1,341030,341031,341032,1,2,0
97486,3,1,341033,341033,341034,0,1,1
97487,2,1,341035,341035,341036,0,1,1
97488,6,2,341041,341041,341043,0,2,5
97489,2,3,341043,341043,341046,0,3,0
97490,3,1,341046,341046,341047,0,1,0
97491,3,2,341049,341049,341051,0,2,2
97492,6,3,341055,341055,341058,0,3,4
97493,4,2,341059,341059,341061,0,2,1
97494,3,3,341062,341062,341065,0,3,1
97495,6,2,341068,341068,341070,0,2,3
97496,1,2,341069,341070,341072,1,3,0
97497,3,2,341072,341072,341074,0,2,0
97498,4,2,341076,341076,341078,0,2,2
97499,6,3,341082,341082,341085,0,3,4
97500,4,2,341086,341086,341088,0,2,1
97501,6,2,341092,341092,341094,0,2,4
97502,4,2,341096,341096,341098,0,2,2
97503,6,1,341102,341102,341103,0,1,4
97504,2,3,341104,341104,341107,0,3,1
97505,5,3,341109,341109,341112,0,3,2
97506,2,1,341111,341112,341113,1,2,0
97507,4,3,341115,341115,341118,0,3,2
97508,1,3,341116,341118,341121,2,5,0
97509,1,1,341117,341121,341122,4,5,0
97510,5,3,341122,341122,341125,0,3,0
97511,6,2,341128,341128,341130,0,2,3
97512,5,1,341133,341133,341134,0,1,3
97513,6,3,341139,341139,341142,0,3,5
97514,4,3,341143,341143,341146,0,3,1
97515,1,3,341144,341146,341149,2,5,0
97516,2,3,341146,341149,341152,3,6,0
97517,4,2,341150,341152,341154,2,4,0
97518,2,1,341152,341154,341155,2,3,0
97519,3,3,341155,341155,341158,0,3,0
97520,1,1,341156,341158,341159,2,3,0
97521,6,3,341162,341162,341165,0,3,3
97522,5,3,341167,341167,341170,0,3,2
97523,2,1,341169,341170,341171,1,2,0
97524,6,2,341175,341175,341177,0,2,4
97525,4,3,341179,341179,341182,0,3,2
97526,3,2,341182,341182,341184,0,2,0
97527,6,3,341188,341188,341191,0,3,4
97528,3,3,341191,341191,341194,0,3,0
97529,5,1,341196,341196,341197,0,1,2
97530,1,3,341197,341197,341200,0,3,0
97531,4,2,341201,341201,341203,0,2,1
97532,2,1,341203,341203,341204,0,1,0
97533,6,3,341209,341209,341212,0,3,5
97534,6,2,341215,341215,341217,0,2,3
97535,2,3,341217,341217,341220,0,3,0
97536,5,2,341222,341222,341224,0,2,2
97537,3,1,341225,341225,341226,0,1,1
97538,6,3,341231,341231,341234,0,3,5
97539,5,2,341236,341236,341238,0,2,2
97540,3,1,341239,341239,341240,0,1,1
97541,1,3,341240,341240,341243,0,3,0
97542,3,1,341243,341243,341244,0,1,0
97543,2,1,341245,341245,341246,0,1,1
97544,5,2,341250,341250,341252,0,2,4
97545,6,2,341256,341256,341258,0,2,4
97546,1,2,341257,341258,341260,1,3,0
97547,6,1,341263,341263,341264,0,1,3
97548,1,3,341264,341264,341267,0,3,0
97549,2,2,341266,341267,341269,1,3,0
97550,1,3,341267,341269,341272,2,5,0
97551,5,1,341272,341272,341273,0,1,0
97552,1,3,341273,341273,341276,0,3,0
97553,4,1,341277,341277,341278,0,1,1
97554,2,2,341279,341279,341281,0,2,1
97555,3,2,341282,341282,341284,0,2,1
97556,5,1,341287,341287,341288,0,1,3
97557,4,2,341291,341291,341293,0,2,3
97558,1,1,341292,341293,341294,1,2,0
97559,2,2,341294,341294,341296,0,2,0
97560,1,2,341295,341296,341298,1,3,0
97561,1,3,341296,341298,341301,2,5,0
97562,6,2,341302,341302,341304,0,2,1
97563,5,2,341307,341307,341309,0,2,3
97564,6,3,341313,341313,341316,0,3,4
97565,6,3,341319,341319,341322,0,3,3
97566,2,3,341321,341322,341325,1,4,0
97567,3,1,341324,341325,341326,1,2,0
97568,3,3,341327,341327,341330,0,3,1
97569,4,1,341331,341331,341332,0,1,1
97570,1,1,341332,341332,341333,0,1,0
97571,5,3,341337,341337,341340,0,3,4
97572,5,1,341342,341342,341343,0,1,2
97573,4,3,341346,341346,341349,0,3,3
97574,1,1,341347,341349,341350,2,3,0
97575,2,1,341349,341350,341351,1,2,0
97576,3,3,341352,341352,341355,0,3,1
97577,1,2,341353,341355,341357,2,4,0
97578,4,2,341357,341357,341359,0,2,0
97579,3,2,341360,341360,341362,0,2,1
97580,4,3,341364,341364,341367,0,3,2
97581,3,1,341367,341367,341368,0,1,0
97582,3,3,341370,341370,341373,0,3,2
97583,4,1,341374,341374,341375,0,1,1
97584,3,2,341377,341377,341379,0,2,2
97585,2,1,341379,341379,341380,0,1,0
97586,6,1,341385,341385,341386,0,1,5
97587,2,1,341387,341387,341388,0,1,1
97588,4,2,341391,341391,341393,0,2,3
97589,4,2,341395,341395,341397,0,2,2
97590,3,2,341398,341398,341400,0,2,1
97591,6,3,341404,341404,341407,0,3,4
97592,6,2,341410,341410,341412,0,2,3
97593,6,3,341416,341416,341419,0,3,4
97594,6,1,341422,341422,341423,0,1,3
97595,5,3,341427,341427,341430,0,3,4
97596,3,3,341430,341430,341433,0,3,0
97597,2,2,341432,341433,341435,1,3,0
97598,3,3,341435,341435,341438,0,3,0
97599,3,3,341438,341438,341441,0,3,0
97600,4,3,341442,341442,341445,0,3,1
97601,2,3,341444,341445,341448,1,4,0
97602,2,3,341446,341448,341451,2,5,0
97603,6,3,341452,341452,341455,0,3,1
97604,5,3,341457,341457,341460,0,3,2
97605,5,2,341462,341462,341464,0,2,2
97606,4,1,341466,341466,341467,0,1,2
97607,1,1,341467,341467,341468,0,1,0
97608,1,2,341468,341468,341470,0,2,0
97609,5,1,341473,341473,341474,0,1,3
97610,6,1,341479,341479,341480,0,1,5
97611,6,3,341485,341485,341488,0,3,5
97612,3,1,341488,341488,341489,0,1,0
97613,3,1,341491,341491,341492,0,1,2
97614,2,3,341493,341493,341496,0,3,1
97615,1,1,341494,341496,341497,2,3,0
97616,3,3,341497,341497,341500,0,3,0
97617,1,3,341498,341500,341503,2,5,0
97618,1,3,341499,341503,341506,4,7,0
97619,3,1,341502,341506,341507,4,5,0
97620,2,3,341504,341507,341510,3,6,0
97621,2,2,341506,341510,341512,4,6,0
97622,3,2,341509,341512,341514,3,5,0
97623,1,3,341510,341514,341517,4,7,0
97624,2,2,341512,341517,341519,5,7,0
97625,1,2,341513,341519,341521,6,8,0
97626,3,3,341516,341521,341524,5,8,0
97627,4,3,341520,341524,341527,4,7,0
97628,3,2,341523,341527,341529,4,6,0
97629,4,2,341527,341529,341531,2,4,0
97630,4,2,341531,341531,341533,0,2,0
97631,4,3,341535,341535,341538,0,3,2
97632,2,1,341537,341538,341539,1,2,0
97633,6,1,341543,341543,341544,0,1,4
97634,5,1,341548,341548,341549,0,1,4
97635,6,3,341554,341554,341557,0,3,5
97636,4,3,341558,341558,341561,0,3,1
97637,1,1,341559,341561,341562,2,3,0
97638,2,2,341561,341562,341564,1,3,0
97639,4,1,341565,341565,341566,0,1,1
97640,4,2,341569,341569,341571,0,2,3
97641,2,3,341571,341571,341574,0,3,0
97642,1,3,341572,341574,341577,2,5,0
97643,5,1,341577,341577,341578,0,1,0
97644,5,1,341582,341582,341583,0,1,4
97645,1,3,341583,341583,341586,0,3,0
97646,2,1,341585,341586,341587,1,2,0
97647,4,1,341589,341589,341590,0,1,2
97648,2,3,341591,341591,341594,0,3,1
97649,5,3,341596,341596,341599,0,3,2
97650,3,2,341599,341599,341601,0,2,0
97651,5,3,341604,341604,341607,0,3,3
97652,3,2,341607,341607,341609,0,2,0
97653,5,1,341612,341612,341613,0,1,3
97654,1,1,341613,341613,341614,0,1,0
97655,2,1,341615,341615,341616,0,1,1
97656,6,2,341621,341621,341623,0,2,5
97657,6,3,341627,341627,341630,0,3,4
97658,3,3,341630,341630,341633,0,3,0
97659,4,1,341634,341634,341635,0,1,1
97660,1,2,341635,341635,341637,0,2,0
97661,6,2,341641,341641,341643,0,2,4
97662,4,1,341645,341645,341646,0,1,2
97663,6,3,341651,341651,341654,0,3,5
97664,4,1,341655,341655,341656,0,1,1
97665,1,2,341656,341656,341658,0,2,0
97666,2,3,341658,341658,341661,0,3,0
97667,3,1,341661,341661,341662,0,1,0
97668,6,3,341667,341667,341670,0,3,5
97669,4,2,341671,341671,341673,0,2,1
97670,4,1,341675,341675,341676,0,1,2
97671,1,3,341676,341676,341679,0,3,0
97672,6,3,341682,341682,341685,0,3,3
97673,6,3,341688,341688,341691,0,3,3
97674,2,2,341690,341691,341693,1,3,0
97675,4,3,341694,341694,341697,0,3,1
97676,1,2,341695,341697,341699,2,4,0
97677,6,2,341701,341701,341703,0,2,2
97678,5,2,341706,341706,341708,0,2,3
97679,3,3,341709,341709,341712,0,3,1
97680,1,3,341710,341712,341715,2,5,0
97681,1,1,341711,341715,341716,4,5,0
97682,2,2,341713,341716,341718,3,5,0
97683,5,1,341718,341718,341719,0,1,0
97684,1,3,341719,341719,341722,0,3,0
97685,5,2,341724,341724,341726,0,2,2
97686,4,3,341728,341728,341731,0,3,2
97687,2,2,341730,341731,341733,1,3,0
97688,5,3,341735,341735,341738,0,3,2
97689,3,1,341738,341738,341739,0,1,0
97690,4,3,341742,341742,341745,0,3,3
97691,6,1,341748,341748,341749,0,1,3
97692,2,3,341750,341750,341753,0,3,1
97693,6,3,341756,341756,341759,0,3,3
97694,5,1,341761,341761,341762,0,1,2
97695,6,1,341767,341767,341768,0,1,5
97696,5,2,341772,341772,341774,0,2,4
97697,5,2,341777,341777,341779,0,2,3
97698,6,1,341783,341783,341784,0,1,4
97699,6,1,341789,341789,341790,0,1,5
97700,1,1,341790,341790,341791,0,1,0
97701,3,1,341793,341793,341794,0,1,2
97702,4,2,341797,341797,341799,0,2,3
97703,1,1,341798,341799,341800,1,2,0
97704,6,3,341804,341804,341807,0,3,4
97705,1,2,341805,341807,341809,2,4,0
97706,6,3,341811,341811,341814,0,3,2
97707,2,2,341813,341814,341816,1,3,0
97708,6,1,341819,341819,341820,0,1,3
97709,6,2,341825,341825,341827,0,2,5
97710,5,1,341830,341830,341831,0,1,3
97711,5,2,341835,341835,341837,0,2,4
97712,5,3,341840,341840,341843,0,3,3
97713,4,1,341844,341844,341845,0,1,1
97714,6,3,341850,341850,341853,0,3,5
97715,4,2,341854,341854,341856,0,2,1
97716,2,3,341856,341856,341859,0,3,0
97717,2,2,341858,341859,341861,1,3,0
97718,2,2,341860,341861,341863,1,3,0
97719,5,3,341865,341865,341868,0,3,2
97720,1,3,341866,341868,341871,2,5,0
97721,6,2,341872,341872,341874,0,2,1
97722,4,2,341876,341876,341878,0,2,2
97723,1,2,341877,341878,341880,1,3,0
97724,6,3,341883,341883,341886,0,3,3
97725,2,1,341885,341886,341887,1,2,0
97726,4,1,341889,341889,341890,0,1,2
97727,3,2,341892,341892,341894,0,2,2
97728,5,1,341897,341897,341898,0,1,3
97729,6,2,341903,341903,341905,0,2,5
97730,1,2,341904,341905,341907,1,3,0
97731,6,3,341910,341910,341913,0,3,3
97732,2,3,341912,341913,341916,1,4,0
97733,1,1,341913,341916,341917,3,4,0
97734,6,3,341919,341919,341922,0,3,2
97735,6,2,341925,341925,341927,0,2,3
97736,1,3,341926,341927,341930,1,4,0
97737,4,3,341930,341930,341933,0,3,0
97738,5,1,341935,341935,341936,0,1,2
97739,1,2,341936,341936,341938,0,2,0
97740,2,3,341938,341938,341941,0,3,0
97741,6,2,341944,341944,341946,0,2,3
97742,1,1,341945,341946,341947,1,2,0
97743,1,3,341946,341947,341950,1,4,0
97744,2,3,341948,341950,341953,2,5,0
97745,5,1,341953,341953,341954,0,1,0
97746,1,3,341954,341954,341957,0,3,0
97747,2,2,341956,341957,341959,1,3,0
97748,6,3,341962,341962,341965,0,3,3
97749,6,1,341968,341968,341969,0,1,3
97750,5,1,341973,341973,341974,0,1,4
97751,1,2,341974,341974,341976,0,2,0
97752,2,2,341976,341976,341978,0,2,0
97753,4,3,341980,341980,341983,0,3,2
97754,4,3,341984,341984,341987,0,3,1
97755,6,2,341990,341990,341992,0,2,3
97756,6,3,341996,341996,341999,0,3,4
97757,3,3,341999,341999,342002,0,3,0
97758,4,2,342003,342003,342005,0,2,1
97759,3,3,342006,342006,342009,0,3,1
97760,1,3,342007,342009,342012,2,5,0
97761,1,1,342008,342012,342013,4,5,0
97762,3,2,342011,342013,342015,2,4,0
97763,3,2,342014,342015,342017,1,3,0
97764,3,2,342017,342017,342019,0,2,0
97765,6,3,342023,342023,342026,0,3,4
97766,3,2,342026,342026,342028,0,2,0
97767,5,1,342031,342031,342032,0,1,3
97768,4,1,342035,342035,342036,0,1,3
97769,2,1,342037,342037,342038,0,1,1
97770,5,2,342042,342042,342044,0,2,4
97771,3,2,342045,342045,342047,0,2,1
97772,1,1,342046,342047,342048,1,2,0
97773,1,2,342047,342048,342050,1,3,0
97774,5,2,342052,342052,342054,0,2,2
97775,3,1,342055,342055,342056,0,1,1
97776,4,3,342059,342059,342062,0,3,3
97777,4,3,342063,342063,342066,0,3,1
97778,2,2,342065,342066,342068,1,3,0
97779,3,1,342068,342068,342069,0,1,0
97780,3,3,342071,342071,342074,0,3,2
97781,6,2,342077,342077,342079,0,2,3
97782,4,2,342081,342081,342083,0,2,2
97783,4,1,342085,342085,342086,0,1,2
97784,2,1,342087,342087,342088,0,1,1
97785,1,3,342088,342088,342091,0,3,0
97786,5,2,342093,342093,342095,0,2,2
97787,1,2,342094,342095,342097,1,3,0
97788,6,2,342100,342100,342102,0,2,3
97789,3,1,342103,342103,342104,0,1,1
97790,2,3,342105,342105,342108,0,3,1
97791,2,1,342107,342108,342109,1,2,0
97792,1,2,342108,342109,342111,1,3,0
97793,1,3,342109,342111,342114,2,5,0
97794,5,3,342114,342114,342117,0,3,0
97795,1,1,342115,342117,342118,2,3,0
97796,3,2,342118,342118,342120,0,2,0
97797,6,2,342124,342124,342126,0,2,4
97798,6,2,342130,342130,342132,0,2,4
97799,1,2,342131,342132,342134,1,3,0
97800,3,3,342134,342134,342137,0,3,0
97801,6,3,342140,342140,342143,0,3,3
97802,6,2,342146,342146,342148,0,2,3
97803,4,1,342150,342150,342151,0,1,2
97804,6,3,342156,342156,342159,0,3,5
97805,6,3,342162,342162,342165,0,3,3
97806,1,2,342163,342165,342167,2,4,0
97807,1,1,342164,342167,342168,3,4,0
97808,6,2,342170,342170,342172,0,2,2
97809,1,1,342171,342172,342173,1,2,0
97810,1,1,342172,342173,342174,1,2,0
97811,2,3,342174,342174,342177,0,3,0
97812,5,2,342179,342179,342181,0,2,2
97813,4,2,342183,342183,342185,0,2,2
97814,2,2,342185,342185,342187,0,2,0
97815,1,3,342186,342187,342190,1,4,0
97816,5,2,342191,342191,342193,0,2,1
97817,5,2,342196,342196,342198,0,2,3
97818,5,2,342201,342201,342203,0,2,3
97819,5,3,342206,342206,342209,0,3,3
97820,2,1,342208,342209,342210,1,2,0
97821,5,2,342213,342213,342215,0,2,3
97822,4,2,342217,342217,342219,0,2,2
97823,3,1,342220,342220,342221,0,1,1
97824,1,1,342221,342221,342222,0,1,0
97825,1,3,342222,342222,342225,0,3,0
97826,2,3,342224,342225,342228,1,4,0
97827,2,2,342226,342228,342230,2,4,0
97828,4,2,342230,342230,342232,0,2,0
97829,6,1,342236,342236,342237,0,1,4
97830,2,1,342238,342238,342239,0,1,1
97831,2,1,342240,342240,342241,0,1,1
97832,2,3,342242,342242,342245,0,3,1
97833,3,1,342245,342245,342246,0,1,0
97834,6,3,342251,342251,342254,0,3,5
97835,1,2,342252,342254,342256,2,4,0
97836,4,1,342256,342256,342257,0,1,0
97837,6,2,342262,342262,342264,0,2,5
97838,6,2,342268,342268,342270,0,2,4
97839,5,3,342273,342273,342276,0,3,3
97840,4,2,342277,342277,342279,0,2,1
97841,4,1,342281,342281,342282,0,1,2
97842,1,3,342282,342282,342285,0,3,0
97843,5,3,342287,342287,342290,0,3,2
97844,3,2,342290,342290,342292,0,2,0
97845,2,2,342292,342292,342294,0,2,0
97846,3,1,342295,342295,342296,0,1,1
97847,4,2,342299,342299,342301,0,2,3
97848,1,1,342300,342301,342302,1,2,0
97849,6,3,342306,342306,342309,0,3,4
97850,6,1,342312,342312,342313,0,1,3
97851,6,1,342318,342318,342319,0,1,5
97852,5,2,342323,342323,342325,0,2,4
97853,2,3,342325,342325,342328,0,3,0
97854,6,3,342331,342331,342334,0,3,3
97855,5,3,342336,342336,342339,0,3,2
97856,5,1,342341,342341,342342,0,1,2
97857,3,1,342344,342344,342345,0,1,2
97858,6,2,342350,342350,342352,0,2,5
97859,3,3,342353,342353,342356,0,3,1
97860,1,3,342354,342356,342359,2,5,0
97861,2,2,342356,342359,342361,3,5,0
97862,4,2,342360,342361,342363,1,3,0
97863,1,2,342361,342363,342365,2,4,0
97864,3,2,342364,342365,342367,1,3,0
97865,1,2,342365,342367,342369,2,4,0
97866,5,1,342370,342370,342371,0,1,1
97867,1,1,342371,342371,342372,0,1,0
97868,4,1,342375,342375,342376,0,1,3
97869,4,1,342379,342379,342380,0,1,3
97870,6,2,342385,342385,342387,0,2,5
97871,1,3,342386,342387,342390,1,4,0
97872,1,3,342387,342390,342393,3,6,0
97873,6,3,342393,342393,342396,0,3,0
97874,1,1,342394,342396,342397,2,3,0
97875,3,1,342397,342397,342398,0,1,0
97876,2,1,342399,342399,342400,0,1,1
97877,5,2,342404,342404,342406,0,2,4
97878,2,2,342406,342406,342408,0,2,0
97879,3,1,342409,342409,342410,0,1,1
97880,3,3,342412,342412,342415,0,3,2
97881,5,1,342417,342417,342418,0,1,2
97882,4,1,342421,342421,342422,0,1,3
97883,6,1,342427,342427,342428,0,1,5
97884,2,2,342429,342429,342431,0,2,1
97885,3,3,342432,342432,342435,0,3,1
97886,6,1,342438,342438,342439,0,1,3
97887,6,1,342444,342444,342445,0,1,5
97888,6,3,342450,342450,342453,0,3,5
97889,2,3,342452,342453,342456,1,4,0
97890,2,3,342454,342456,342459,2,5,0
97891,4,1,342458,342459,342460,1,2,0
97892,2,2,342460,342460,342462,0,2,0
97893,1,2,342461,342462,342464,1,3,0
97894,4,2,342465,342465,342467,0,2,1
97895,1,3,342466,342467,342470,1,4,0
97896,5,1,342471,342471,342472,0,1,1
97897,1,1,342472,342472,342473,0,1,0
97898,5,1,342477,342477,342478,0,1,4
97899,1,3,342478,342478,342481,0,3,0
97900,2,1,342480,342481,342482,1,2,0
97901,2,1,342482,342482,342483,0,1,0
97902,3,2,342485,342485,342487,0,2,2
97903,1,3,342486,342487,342490,1,4,0
97904,6,3,342492,342492,342495,0,3,2
97905,6,3,342498,342498,342501,0,3,3
97906,2,2,342500,342501,342503,1,3,0
97907,2,1,342502,342503,342504,1,2,0
97908,5,3,342507,342507,342510,0,3,3
97909,2,3,342509,342510,342513,1,4,0
97910,4,2,342513,342513,342515,0,2,0
97911,6,2,342519,342519,342521,0,2,4
97912,2,1,342521,342521,342522,0,1,0
97913,3,2,342524,342524,342526,0,2,2
97914,6,1,342530,342530,342531,0,1,4
97915,1,2,342531,342531,342533,0,2,0
97916,5,3,342536,342536,342539,0,3,3
97917,6,2,342542,342542,342544,0,2,3
97918,1,1,342543,342544,342545,1,2,0
97919,6,1,342549,342549,342550,0,1,4
97920,6,2,342555,342555,342557,0,2,5
97921,4,1,342559,342559,342560,0,1,2
97922,1,3,342560,342560,342563,0,3,0
97923,3,2,342563,342563,342565,0,2,0
97924,5,1,342568,342568,342569,0,1,3
97925,5,3,342573,342573,342576,0,3,4
97926,2,1,342575,342576,342577,1,2,0
97927,3,2,342578,342578,342580,0,2,1
97928,6,3,342584,342584,342587,0,3,4
97929,4,3,342588,342588,342591,0,3,1
97930,2,1,342590,342591,342592,1,2,0
97931,4,1,342594,342594,342595,0,1,2
97932,1,3,342595,342595,342598,0,3,0
97933,4,1,342599,342599,342600,0,1,1
97934,5,2,342604,342604,342606,0,2,4
97935,5,3,342609,342609,342612,0,3,3
97936,3,1,342612,342612,342613,0,1,0
97937,6,3,342618,342618,342621,0,3,5
97938,6,1,342624,342624,342625,0,1,3
97939,4,3,342628,342628,342631,0,3,3
97940,3,3,342631,342631,342634,0,3,0
97941,2,3,342633,342634,342637,1,4,0
97942,1,3,342634,342637,342640,3,6,0
97943,3,3,342637,342640,342643,3,6,0
97944,6,1,342643,342643,342644,0,1,0
97945,5,2,342648,342648,342650,0,2,4
97946,3,1,342651,342651,342652,0,1,1
97947,4,2,342655,342655,342657,0,2,3
97948,4,1,342659,342659,342660,0,1,2
97949,1,2,342660,342660,342662,0,2,0
97950,3,1,342663,342663,342664,0,1,1
97951,3,1,342666,342666,342667,0,1,2
97952,4,3,342670,342670,342673,0,3,3
97953,4,1,342674,342674,342675,0,1,1
97954,3,3,342677,342677,342680,0,3,2
97955,5,3,342682,342682,342685,0,3,2
97956,4,3,342686,342686,342689,0,3,1
97957,4,1,342690,342690,342691,0,1,1
97958,4,2,342694,342694,342696,0,2,3
97959,3,2,342697,342697,342699,0,2,1
97960,3,3,342700,342700,342703,0,3,1
97961,5,3,342705,342705,342708,0,3,2
97962,2,1,342707,342708,342709,1,2,0
97963,1,2,342708,342709,342711,1,3,0
97964,1,2,342709,342711,342713,2,4,0
97965,5,1,342714,342714,342715,0,1,1
97966,6,1,342720,342720,342721,0,1,5
97967,1,1,342721,342721,342722,0,1,0
97968,4,3,342725,342725,342728,0,3,3
97969,1,2,342726,342728,342730,2,4,0
97970,3,3,342729,342730,342733,1,4,0
97971,1,2,342730,342733,342735,3,5,0
97972,1,3,342731,342735,342738,4,7,0
97973,4,1,342735,342738,342739,3,4,0
97974,6,1,342741,342741,342742,0,1,2
97975,6,3,342747,342747,342750,0,3,5
97976,4,1,342751,342751,342752,0,1,1
97977,5,2,342756,342756,342758,0,2,4
97978,4,1,342760,342760,342761,0,1,2
97979,5,1,342765,342765,342766,0,1,4
97980,4,1,342769,342769,342770,0,1,3
97981,5,3,342774,342774,342777,0,3,4
97982,3,1,342777,342777,342778,0,1,0
97983,4,3,342781,342781,342784,0,3,3
97984,1,2,342782,342784,342786,2,4,0
97985,1,2,342783,342786,342788,3,5,0
97986,3,3,342786,342788,342791,2,5,0
97987,4,3,342790,342791,342794,1,4,0
97988,5,1,342795,342795,342796,0,1,1
97989,6,3,342801,342801,342804,0,3,5
97990,2,2,342803,342804,342806,1,3,0
97991,3,2,342806,342806,342808,0,2,0
97992,5,2,342811,342811,342813,0,2,3
97993,6,2,342817,342817,342819,0,2,4
97994,4,1,342821,342821,342822,0,1,2
97995,5,3,342826,342826,342829,0,3,4
97996,5,1,342831,342831,342832,0,1,2
97997,6,1,342837,342837,342838,0,1,5
97998,1,2,342838,342838,342840,0,2,0
97999,6,2,342844,342844,342846,0,2,4
98000,5,3,342849,342849,342852,0,3,3
98001,4,1,342853,342853,342854,0,1,1
98002,6,3,342859,342859,342862,0,3,5
98003,5,1,342864,342864,342865,0,1,2
98004,4,1,342868,342868,342869,0,1,3
98005,4,2,342872,342872,342874,0,2,3
98006,1,2,342873,342874,342876,1,3,0
98007,5,3,342878,342878,342881,0,3,2
98008,3,2,342881,342881,342883,0,2,0
98009,2,1,342883,342883,342884,0,1,0
98010,4,1,342887,342887,342888,0,1,3
98011,4,1,342891,342891,342892,0,1,3
98012,2,3,342893,342893,342896,0,3,1
98013,5,3,342898,342898,342901,0,3,2
98014,5,2,342903,342903,342905,0,2,2
98015,1,1,342904,342905,342906,1,2,0
98016,3,3,342907,342907,342910,0,3,1
98017,2,1,342909,342910,342911,1,2,0
98018,2,1,342911,342911,342912,0,1,0
98019,2,1,342913,342913,342914,0,1,1
98020,3,1,342916,342916,342917,0,1,2
98021,3,3,342919,342919,342922,0,3,2
98022,2,3,342921,342922,342925,1,4,0
98023,4,3,342925,342925,342928,0,3,0
98024,2,1,342927,342928,342929,1,2,0
98025,4,3,342931,342931,342934,0,3,2
98026,1,3,342932,342934,342937,2,5,0
98027,1,3,342933,342937,342940,4,7,0
98028,6,3,342939,342940,342943,1,4,0
98029,5,1,342944,342944,342945,0,1,1
98030,4,2,342948,342948,342950,0,2,3
98031,4,2,342952,342952,342954,0,2,2
98032,2,1,342954,342954,342955,0,1,0
98033,4,3,342958,342958,342961,0,3,3
98034,2,2,342960,342961,342963,1,3,0
98035,4,3,342964,342964,342967,0,3,1
98036,2,1,342966,342967,342968,1,2,0
98037,6,1,342972,342972,342973,0,1,4
98038,3,3,342975,342975,342978,0,3,2
98039,2,1,342977,342978,342979,1,2,0
98040,1,2,342978,342979,342981,1,3,0
98041,3,3,342981,342981,342984,0,3,0
98042,5,2,342986,342986,342988,0,2,2
98043,2,2,342988,342988,342990,0,2,0
98044,5,1,342993,342993,342994,0,1,3
98045,1,2,342994,342994,342996,0,2,0
98046,6,1,343000,343000,343001,0,1,4
98047,5,1,343005,343005,343006,0,1,4
98048,1,3,343006,343006,343009,0,3,0
98049,6,3,343012,343012,343015,0,3,3
98050,2,3,343014,343015,343018,1,4,0
98051,6,3,343020,343020,343023,0,3,2
98052,5,1,343025,343025,343026,0,1,2
98053,1,1,343026,343026,343027,0,1,0
98054,5,1,343031,343031,343032,0,1,4
98055,4,2,343035,343035,343037,0,2,3
98056,4,1,343039,343039,343040,0,1,2
98057,3,2,343042,343042,343044,0,2,2
98058,5,3,343047,343047,343050,0,3,3
98059,6,2,343053,343053,343055,0,2,3
98060,1,2,343054,343055,343057,1,3,0
98061,3,3,343057,343057,343060,0,3,0
98062,1,3,343058,343060,343063,2,5,0
98063,1,1,343059,343063,343064,4,5,0
98064,6,2,343065,343065,343067,0,2,1
98065,2,3,343067,343067,343070,0,3,0
98066,6,2,343073,343073,343075,0,2,3
98067,4,1,343077,343077,343078,0,1,2
98068,4,3,343081,343081,343084,0,3,3
98069,1,1,343082,343084,343085,2,3,0
98070,4,2,343086,343086,343088,0,2,1
98071,3,3,343089,343089,343092,0,3,1
98072,6,2,343095,343095,343097,0,2,3
98073,4,2,343099,343099,343101,0,2,2
98074,5,1,343104,343104,343105,0,1,3
98075,5,2,343109,343109,343111,0,2,4
98076,6,3,343115,343115,343118,0,3,4
98077,1,2,343116,343118,343120,2,4,0
98078,4,3,343120,343120,343123,0,3,0
98079,5,1,343125,343125,343126,0,1,2
98080,6,3,343131,343131,343134,0,3,5
98081,3,2,343134,343134,343136,0,2,0
98082,6,1,343140,343140,343141,0,1,4
98083,6,3,343146,343146,343149,0,3,5
98084,4,3,343150,343150,343153,0,3,1
98085,5,2,343155,343155,343157,0,2,2
98086,6,1,343161,343161,343162,0,1,4
98087,3,1,343164,343164,343165,0,1,2
98088,1,3,343165,343165,343168,0,3,0
98089,1,2,343166,343168,343170,2,4,0
98090,5,3,343171,343171,343174,0,3,1
98091,6,2,343177,343177,343179,0,2,3
98092,5,1,343182,343182,343183,0,1,3
98093,5,2,343187,343187,343189,0,2,4
98094,3,3,343190,343190,343193,0,3,1
98095,6,3,343196,343196,343199,0,3,3
98096,6,3,343202,343202,343205,0,3,3
98097,1,1,343203,343205,343206,2,3,0
98098,2,1,343205,343206,343207,1,2,0
98099,3,1,343208,343208,343209,0,1,1
98100,4,2,343212,343212,343214,0,2,3
98101,2,3,343214,343214,343217,0,3,0
98102,6,1,343220,343220,343221,0,1,3
98103,1,1,343221,343221,343222,0,1,0
98104,4,3,343225,343225,343228,0,3,3
98105,6,2,343231,343231,343233,0,2,3
98106,4,2,343235,343235,343237,0,2,2
98107,4,3,343239,343239,343242,0,3,2
98108,2,2,343241,343242,343244,1,3,0
98109,1,3,343242,343244,343247,2,5,0
98110,3,3,343245,343247,343250,2,5,0
98111,2,3,343247,343250,343253,3,6,0
98112,4,1,343251,343253,343254,2,3,0
98113,3,2,343254,343254,343256,0,2,0
98114,4,2,343258,343258,343260,0,2,2
98115,4,1,343262,343262,343263,0,1,2
98116,2,1,343264,343264,343265,0,1,1
98117,1,3,343265,343265,343268,0,3,0
98118,5,3,343270,343270,343273,0,3,2
98119,5,2,343275,343275,343277,0,2,2
98120,1,3,343276,343277,343280,1,4,0
98121,1,1,343277,343280,343281,3,4,0
98122,5,1,343282,343282,343283,0,1,1
98123,6,3,343288,343288,343291,0,3,5
98124,5,1,343293,343293,343294,0,1,2
98125,5,3,343298,343298,343301,0,3,4
98126,5,1,343303,343303,343304,0,1,2
98127,4,2,343307,343307,343309,0,2,3
98128,3,1,343310,343310,343311,0,1,1
98129,3,2,343313,343313,343315,0,2,2
98130,6,1,343319,343319,343320,0,1,4
98131,4,2,343323,343323,343325,0,2,3
98132,6,3,343329,343329,343332,0,3,4
98133,5,1,343334,343334,343335,0,1,2
98134,2,1,343336,343336,343337,0,1,1
98135,1,2,343337,343337,343339,0,2,0
98136,1,3,343338,343339,343342,1,4,0
98137,2,1,343340,343342,343343,2,3,0
98138,4,1,343344,343344,343345,0,1,1
98139,1,3,343345,343345,343348,0,3,0
98140,2,2,343347,343348,343350,1,3,0
98141,1,1,343348,343350,343351,2,3,0
98142,1,3,343349,343351,343354,2,5,0
98143,3,1,343352,343354,343355,2,3,0
98144,6,2,343358,343358,343360,0,2,3
98145,5,3,343363,343363,343366,0,3,3
98146,2,3,343365,343366,343369,1,4,0
98147,1,3,343366,343369,343372,3,6,0
98148,6,3,343372,343372,343375,0,3,0
98149,3,2,343375,343375,343377,0,2,0
98150,2,1,343377,343377,343378,0,1,0
98151,1,3,343378,343378,343381,0,3,0
98152,1,1,343379,343381,343382,2,3,0
98153,1,1,343380,343382,343383,2,3,0
98154,5,1,343385,343385,343386,0,1,2
98155,2,1,343387,343387,343388,0,1,1
98156,3,3,343390,343390,343393,0,3,2
98157,2,2,343392,343393,343395,1,3,0
98158,4,2,343396,343396,343398,0,2,1
98159,3,1,343399,343399,343400,0,1,1
98160,4,1,343403,343403,343404,0,1,3
98161,4,3,343407,343407,343410,0,3,3
98162,4,2,343411,343411,343413,0,2,1
98163,6,1,343417,343417,343418,0,1,4
98164,3,3,343420,343420,343423,0,3,2
98165,1,2,343421,343423,343425,2,4,0
98166,3,1,343424,343425,343426,1,2,0
98167,2,3,343426,343426,343429,0,3,0
98168,2,3,343428,343429,343432,1,4,0
98169,4,1,343432,343432,343433,0,1,0
98170,1,2,343433,343433,343435,0,2,0
98171,2,1,343435,343435,343436,0,1,0
98172,6,3,343441,343441,343444,0,3,5
98173,1,2,343442,343444,343446,2,4,0
98174,6,1,343448,343448,343449,0,1,2
98175,3,3,343451,343451,343454,0,3,2
98176,5,1,343456,343456,343457,0,1,2
98177,4,3,343460,343460,343463,0,3,3
98178,6,1,343466,343466,343467,0,1,3
98179,1,3,343467,343467,343470,0,3,0
98180,4,2,343471,343471,343473,0,2,1
98181,1,1,343472,343473,343474,1,2,0
98182,1,1,343473,343474,343475,1,2,0
98183,3,3,343476,343476,343479,0,3,1
98184,3,3,343479,343479,343482,0,3,0
98185,5,2,343484,343484,343486,0,2,2
98186,3,2,343487,343487,343489,0,2,1
98187,2,1,343489,343489,343490,0,1,0
98188,4,3,343493,343493,343496,0,3,3
98189,1,2,343494,343496,343498,2,4,0
98190,1,1,343495,343498,343499,3,4,0
98191,4,3,343499,343499,343502,0,3,0
98192,4,2,343503,343503,343505,0,2,1
98193,2,1,343505,343505,343506,0,1,0
98194,2,3,343507,343507,343510,0,3,1
98195,2,2,343509,343510,343512,1,3,0
98196,6,1,343515,343515,343516,0,1,3
98197,6,2,343521,343521,343523,0,2,5
98198,5,2,343526,343526,343528,0,2,3
98199,2,3,343528,343528,343531,0,3,0
98200,1,1,343529,343531,343532,2,3,0
98201,3,1,343532,343532,343533,0,1,0
98202,2,1,343534,343534,343535,0,1,1
98203,4,1,343538,343538,343539,0,1,3
98204,6,1,343544,343544,343545,0,1,5
98205,1,1,343545,343545,343546,0,1,0
98206,4,3,343549,343549,343552,0,3,3
98207,3,2,343552,343552,343554,0,2,0
98208,6,2,343558,343558,343560,0,2,4
98209,4,2,343562,343562,343564,0,2,2
98210,2,2,343564,343564,343566,0,2,0
98211,4,3,343568,343568,343571,0,3,2
98212,4,1,343572,343572,343573,0,1,1
98213,3,3,343575,343575,343578,0,3,2
98214,4,3,343579,343579,343582,0,3,1
98215,3,1,343582,343582,343583,0,1,0
98216,5,2,343587,343587,343589,0,2,4
98217,4,2,343591,343591,343593,0,2,2
98218,6,2,343597,343597,343599,0,2,4
98219,6,2,343603,343603,343605,0,2,4
98220,5,3,343608,343608,343611,0,3,3
98221,2,3,343610,343611,343614,1,4,0
98222,4,3,343614,343614,343617,0,3,0
98223,4,2,343618,343618,343620,0,2,1
98224,1,2,343619,343620,343622,1,3,0
98225,6,1,343625,343625,343626,0,1,3
98226,1,3,343626,343626,343629,0,3,0
98227,4,3,343630,343630,343633,0,3,1
98228,4,2,343634,343634,343636,0,2,1
98229,4,3,343638,343638,343641,0,3,2
98230,4,1,343642,343642,343643,0,1,1
98231,4,1,343646,343646,343647,0,1,3
98232,4,3,343650,343650,343653,0,3,3
98233,6,1,343656,343656,343657,0,1,3
98234,2,2,343658,343658,343660,0,2,1
98235,5,2,343663,343663,343665,0,2,3
98236,1,1,343664,343665,343666,1,2,0
98237,1,2,343665,343666,343668,1,3,0
98238,1,2,343666,343668,343670,2,4,0
98239,4,2,343670,343670,343672,0,2,0
98240,6,1,343676,343676,343677,0,1,4
98241,3,1,343679,343679,343680,0,1,2
98242,4,3,343683,343683,343686,0,3,3
98243,5,2,343688,343688,343690,0,2,2
98244,5,1,343693,343693,343694,0,1,3
98245,4,1,343697,343697,343698,0,1,3
98246,3,1,343700,343700,343701,0,1,2
98247,2,2,343702,343702,343704,0,2,1
98248,5,2,343707,343707,343709,0,2,3
98249,1,3,343708,343709,343712,1,4,0
98250,4,2,343712,343712,343714,0,2,0
98251,5,1,343717,343717,343718,0,1,3
98252,6,2,343723,343723,343725,0,2,5
98253,1,1,343724,343725,343726,1,2,0
98254,5,2,343729,343729,343731,0,2,3
98255,2,1,343731,343731,343732,0,1,0
98256,6,2,343737,343737,343739,0,2,5
98257,6,3,343743,343743,343746,0,3,4
98258,6,2,343749,343749,343751,0,2,3
98259,3,1,343752,343752,343753,0,1,1
98260,2,2,343754,343754,343756,0,2,1
98261,3,1,343757,343757,343758,0,1,1
98262,1,3,343758,343758,343761,0,3,0
98263,4,3,343762,343762,343765,0,3,1
98264,3,1,343765,343765,343766,0,1,0
98265,4,1,343769,343769,343770,0,1,3
98266,3,1,343772,343772,343773,0,1,2
98267,6,2,343778,343778,343780,0,2,5
98268,2,1,343780,343780,343781,0,1,0
98269,3,1,343783,343783,343784,0,1,2
98270,5,1,343788,343788,343789,0,1,4
98271,1,1,343789,343789,343790,0,1,0
98272,2,1,343791,343791,343792,0,1,1
98273,4,1,343795,343795,343796,0,1,3
98274,5,2,343800,343800,343802,0,2,4
98275,4,2,343804,343804,343806,0,2,2
98276,3,3,343807,343807,343810,0,3,1
98277,4,2,343811,343811,343813,0,2,1
98278,6,3,343817,343817,343820,0,3,4
98279,3,3,343820,343820,343823,0,3,0
98280,5,1,343825,343825,343826,0,1,2
98281,3,1,343828,343828,343829,0,1,2
98282,4,2,343832,343832,343834,0,2,3
98283,3,2,343835,343835,343837,0,2,1
98284,3,3,343838,343838,343841,0,3,1
98285,4,3,343842,343842,343845,0,3,1
98286,2,3,343844,343845,343848,1,4,0
98287,5,1,343849,343849,343850,0,1,1
98288,2,3,343851,343851,343854,0,3,1
98289,4,3,343855,343855,343858,0,3,1
98290,2,2,343857,343858,343860,1,3,0
98291,4,1,343861,343861,343862,0,1,1
98292,4,2,343865,343865,343867,0,2,3
98293,2,3,343867,343867,343870,0,3,0
98294,6,2,343873,343873,343875,0,2,3
98295,3,3,343876,343876,343879,0,3,1
98296,6,2,343882,343882,343884,0,2,3
98297,3,2,343885,343885,343887,0,2,1
98298,2,1,343887,343887,343888,0,1,0
98299,2,2,343889,343889,343891,0,2,1
98300,1,3,343890,343891,343894,1,4,0
98301,3,2,343893,343894,343896,1,3,0
98302,5,2,343898,343898,343900,0,2,2
98303,4,1,343902,343902,343903,0,1,2
98304,3,2,343905,343905,343907,0,2,2
98305,6,3,343911,343911,343914,0,3,4
98306,4,3,343915,343915,343918,0,3,1
98307,2,2,343917,343918,343920,1,3,0
98308,6,1,343923,343923,343924,0,1,3
98309,6,2,343929,343929,343931,0,2,5
98310,6,2,343935,343935,343937,0,2,4
98311,1,1,343936,343937,343938,1,2,0
98312,6,2,343942,343942,343944,0,2,4
98313,4,3,343946,343946,343949,0,3,2
98314,1,1,343947,343949,343950,2,3,0
98315,3,1,343950,343950,343951,0,1,0
98316,3,1,343953,343953,343954,0,1,2
98317,4,3,343957,343957,343960,0,3,3
98318,3,3,343960,343960,343963,0,3,0
98319,3,3,343963,343963,343966,0,3,0
98320,3,3,343966,343966,343969,0,3,0
98321,5,2,343971,343971,343973,0,2,2
98322,4,3,343975,343975,343978,0,3,2
98323,3,3,343978,343978,343981,0,3,0
98324,6,2,343984,343984,343986,0,2,3
98325,1,3,343985,343986,343989,1,4,0
98326,3,2,343988,343989,343991,1,3,0
98327,3,1,343991,343991,343992,0,1,0
98328,1,2,343992,343992,343994,0,2,0
98329,5,3,343997,343997,344000,0,3,3
98330,5,1,344002,344002,344003,0,1,2
98331,6,3,344008,344008,344011,0,3,5
98332,4,2,344012,344012,344014,0,2,1
98333,4,1,344016,344016,344017,0,1,2
98334,1,1,344017,344017,344018,0,1,0
98335,6,3,344023,344023,344026,0,3,5
98336,4,1,344027,344027,344028,0,1,1
98337,3,2,344030,344030,344032,0,2,2
98338,3,2,344033,344033,344035,0,2,1
98339,5,3,344038,344038,344041,0,3,3
98340,3,2,344041,344041,344043,0,2,0
98341,1,1,344042,344043,344044,1,2,0
98342,4,2,344046,344046,344048,0,2,2
98343,2,3,344048,344048,344051,0,3,0
98344,1,2,344049,344051,344053,2,4,0
98345,5,3,344054,344054,344057,0,3,1
98346,4,2,344058,344058,344060,0,2,1
98347,3,2,344061,344061,344063,0,2,1
98348,1,3,344062,344063,344066,1,4,0
98349,3,1,344065,344066,344067,1,2,0
98350,6,3,344071,344071,344074,0,3,4
98351,5,1,344076,344076,344077,0,1,2
98352,6,3,344082,344082,344085,0,3,5
98353,4,1,344086,344086,344087,0,1,1
98354,5,1,344091,344091,344092,0,1,4
98355,5,3,344096,344096,344099,0,3,4
98356,6,3,344102,344102,344105,0,3,3
98357,5,3,344107,344107,344110,0,3,2
98358,1,1,344108,344110,344111,2,3,0
98359,5,1,344113,344113,344114,0,1,2
98360,4,2,344117,344117,344119,0,2,3
98361,2,1,344119,344119,344120,0,1,0
98362,4,2,344123,344123,344125,0,2,3
98363,3,2,344126,344126,344128,0,2,1
98364,4,1,344130,344130,344131,0,1,2
98365,1,2,344131,344131,344133,0,2,0
98366,1,2,344132,344133,344135,1,3,0
98367,3,2,344135,344135,344137,0,2,0
98368,5,2,344140,344140,344142,0,2,3
98369,1,3,344141,344142,344145,1,4,0
98370,5,1,344146,344146,344147,0,1,1
98371,5,3,344151,344151,344154,0,3,4
98372,5,2,344156,344156,344158,0,2,2
98373,6,3,344162,344162,344165,0,3,4
98374,5,3,344167,344167,344170,0,3,2
98375,1,1,344168,344170,344171,2,3,0
98376,4,3,344172,344172,344175,0,3,1
98377,3,1,344175,344175,344176,0,1,0
98378,2,1,344177,344177,344178,0,1,1
98379,4,3,344181,344181,344184,0,3,3
98380,1,3,344182,344184,344187,2,5,0
98381,3,2,344185,344187,344189,2,4,0
98382,2,2,344187,344189,344191,2,4,0
98383,3,3,344190,344191,344194,1,4,0
98384,3,2,344193,344194,344196,1,3,0
98385,6,3,344199,344199,344202,0,3,3
98386,1,2,344200,344202,344204,2,4,0
98387,2,3,344202,344204,344207,2,5,0
98388,4,1,344206,344207,344208,1,2,0
98389,4,3,344210,344210,344213,0,3,2
98390,2,2,344212,344213,344215,1,3,0
98391,1,1,344213,344215,344216,2,3,0
98392,6,3,344219,344219,344222,0,3,3
98393,6,2,344225,344225,344227,0,2,3
98394,5,2,344230,344230,344232,0,2,3
98395,3,1,344233,344233,344234,0,1,1
98396,5,1,344238,344238,344239,0,1,4
98397,1,1,344239,344239,344240,0,1,0
98398,5,2,344244,344244,344246,0,2,4
98399,5,1,344249,344249,344250,0,1,3
98400,1,3,344250,344250,344253,0,3,0
98401,1,3,344251,344253,344256,2,5,0
98402,5,1,344256,344256,344257,0,1,0
98403,2,1,344258,344258,344259,0,1,1
98404,2,1,344260,344260,344261,0,1,1
98405,2,3,344262,344262,344265,0,3,1
98406,3,3,344265,344265,344268,0,3,0
98407,4,3,344269,344269,344272,0,3,1
98408,1,2,344270,344272,344274,2,4,0
98409,1,1,344271,344274,344275,3,4,0
98410,1,3,344272,344275,344278,3,6,0
98411,6,3,344278,344278,344281,0,3,0
98412,4,2,344282,344282,344284,0,2,1
98413,2,2,344284,344284,344286,0,2,0
98414,4,1,344288,344288,344289,0,1,2
98415,3,2,344291,344291,344293,0,2,2
98416,6,2,344297,344297,344299,0,2,4
98417,3,2,344300,344300,344302,0,2,1
98418,5,3,344305,344305,344308,0,3,3
98419,1,3,344306,344308,344311,2,5,0
98420,6,3,344312,344312,344315,0,3,1
98421,3,2,344315,344315,344317,0,2,0
98422,6,1,344321,344321,344322,0,1,4
98423,4,1,344325,344325,344326,0,1,3
98424,5,1,344330,344330,344331,0,1,4
98425,2,1,344332,344332,344333,0,1,1
98426,6,3,344338,344338,344341,0,3,5
98427,6,1,344344,344344,344345,0,1,3
98428,3,3,344347,344347,344350,0,3,2
98429,4,3,344351,344351,344354,0,3,1
98430,6,2,344357,344357,344359,0,2,3
98431,4,2,344361,344361,344363,0,2,2
98432,3,1,344364,344364,344365,0,1,1
98433,5,3,344369,344369,344372,0,3,4
98434,3,3,344372,344372,344375,0,3,0
98435,1,2,344373,344375,344377,2,4,0
98436,5,3,344378,344378,344381,0,3,1
98437,6,3,344384,344384,344387,0,3,3
98438,4,3,344388,344388,344391,0,3,1
98439,6,2,344394,344394,344396,0,2,3
98440,4,1,344398,344398,344399,0,1,2
98441,1,1,344399,344399,344400,0,1,0
98442,1,2,344400,344400,344402,0,2,0
98443,5,2,344405,344405,344407,0,2,3
98444,2,2,344407,344407,344409,0,2,0
98445,2,3,344409,344409,344412,0,3,0
98446,1,3,344410,344412,344415,2,5,0
98447,2,3,344412,344415,344418,3,6,0
98448,4,1,344416,344418,344419,2,3,0
98449,5,3,344421,344421,344424,0,3,2
98450,3,2,344424,344424,344426,0,2,0
98451,6,3,344430,344430,344433,0,3,4
98452,1,1,344431,344433,344434,2,3,0
98453,4,3,344435,344435,344438,0,3,1
98454,1,3,344436,344438,344441,2,5,0
98455,5,1,344441,344441,344442,0,1,0
98456,1,1,344442,344442,344443,0,1,0
98457,6,2,344448,344448,344450,0,2,5
98458,6,1,344454,344454,344455,0,1,4
98459,3,3,344457,344457,344460,0,3,2
98460,2,2,344459,344460,344462,1,3,0
98461,1,1,344460,344462,344463,2,3,0
98462,1,3,344461,344463,344466,2,5,0
98463,1,1,344462,344466,344467,4,5,0
98464,3,2,344465,344467,344469,2,4,0
98465,2,1,344467,344469,344470,2,3,0
98466,5,1,344472,344472,344473,0,1,2
98467,4,1,344476,344476,344477,0,1,3
98468,4,3,344480,344480,344483,0,3,3
98469,3,1,344483,344483,344484,0,1,0
98470,6,3,344489,344489,344492,0,3,5
98471,2,2,344491,344492,344494,1,3,0
98472,6,1,344497,344497,344498,0,1,3
98473,4,1,344501,344501,344502,0,1,3
98474,2,1,344503,344503,344504,0,1,1
98475,1,1,344504,344504,344505,0,1,0
98476,1,2,344505,344505,344507,0,2,0
98477,4,1,344509,344509,344510,0,1,2
98478,4,3,344513,344513,344516,0,3,3
98479,2,3,344515,344516,344519,1,4,0
98480,5,3,344520,344520,344523,0,3,1
98481,4,2,344524,344524,344526,0,2,1
98482,1,1,344525,344526,344527,1,2,0
98483,5,2,344530,344530,344532,0,2,3
98484,6,2,344536,344536,344538,0,2,4
98485,4,2,344540,344540,344542,0,2,2
98486,4,1,344544,344544,344545,0,1,2
98487,2,3,344546,344546,344549,0,3,1
98488,6,2,344552,344552,344554,0,2,3
98489,2,2,344554,344554,344556,0,2,0
98490,1,1,344555,344556,344557,1,2,0
98491,6,2,344561,344561,344563,0,2,4
98492,3,2,344564,344564,344566,0,2,1
98493,6,1,344570,344570,344571,0,1,4
98494,6,3,344576,344576,344579,0,3,5
98495,4,1,344580,344580,344581,0,1,1
98496,3,3,344583,344583,344586,0,3,2
98497,5,1,344588,344588,344589,0,1,2
98498,6,3,344594,344594,344597,0,3,5
98499,6,1,344600,344600,344601,0,1,3
98500,6,1,344606,344606,344607,0,1,5
98501,3,3,344609,344609,344612,0,3,2
98502,5,1,344614,344614,344615,0,1,2
98503,4,3,344618,344618,344621,0,3,3
98504,1,3,344619,344621,344624,2,5,0
98505,4,1,344623,344624,344625,1,2,0
98506,5,2,344628,344628,344630,0,2,3
98507,1,1,344629,344630,344631,1,2,0
98508,6,1,344635,344635,344636,0,1,4
98509,4,2,344639,344639,344641,0,2,3
98510,5,2,344644,344644,344646,0,2,3
98511,6,2,344650,344650,344652,0,2,4
98512,5,2,344655,344655,344657,0,2,3
98513,6,2,344661,344661,344663,0,2,4
98514,6,3,344667,344667,344670,0,3,4
98515,6,1,344673,344673,344674,0,1,3
98516,1,1,344674,344674,344675,0,1,0
98517,5,2,344679,344679,344681,0,2,4
98518,3,3,344682,344682,344685,0,3,1
98519,6,1,344688,344688,344689,0,1,3
98520,5,2,344693,344693,344695,0,2,4
98521,3,2,344696,344696,344698,0,2,1
98522,2,3,344698,344698,344701,0,3,0
98523,6,2,344704,344704,344706,0,2,3
98524,5,1,344709,344709,344710,0,1,3
98525,5,3,344714,344714,344717,0,3,4
98526,6,1,344720,344720,344721,0,1,3
98527,2,3,344722,344722,344725,0,3,1
98528,4,3,344726,344726,344729,0,3,1
98529,6,3,344732,344732,344735,0,3,3
98530,6,3,344738,344738,344741,0,3,3
98531,3,2,344741,344741,344743,0,2,0
98532,3,2,344744,344744,344746,0,2,1
98533,5,3,344749,344749,344752,0,3,3
98534,2,1,344751,344752,344753,1,2,0
98535,3,2,344754,344754,344756,0,2,1
98536,1,3,344755,344756,344759,1,4,0
98537,4,2,344759,344759,344761,0,2,0
98538,1,2,344760,344761,344763,1,3,0
98539,3,1,344763,344763,344764,0,1,0
98540,3,2,344766,344766,344768,0,2,2
98541,2,2,344768,344768,344770,0,2,0
98542,5,3,344773,344773,344776,0,3,3
98543,5,1,344778,344778,344779,0,1,2
98544,3,2,344781,344781,344783,0,2,2
98545,3,2,344784,344784,344786,0,2,1
98546,1,2,344785,344786,344788,1,3,0
98547,4,3,344789,344789,344792,0,3,1
98548,4,3,344793,344793,344796,0,3,1
98549,4,2,344797,344797,344799,0,2,1
98550,5,3,344802,344802,344805,0,3,3
98551,1,3,344803,344805,344808,2,5,0
98552,2,1,344805,344808,344809,3,4,0
98553,2,3,344807,344809,344812,2,5,0
98554,3,2,344810,344812,344814,2,4,0
98555,3,2,344813,344814,344816,1,3,0
98556,1,2,344814,344816,344818,2,4,0
98557,5,2,344819,344819,344821,0,2,1
98558,4,3,344823,344823,344826,0,3,2
98559,2,1,344825,344826,344827,1,2,0
98560,1,2,344826,344827,344829,1,3,0
98561,1,3,344827,344829,344832,2,5,0
98562,5,2,344832,344832,344834,0,2,0
98563,4,2,344836,344836,344838,0,2,2
98564,6,1,344842,344842,344843,0,1,4
98565,5,2,344847,344847,344849,0,2,4
98566,1,1,344848,344849,344850,1,2,0
98567,6,2,344854,344854,344856,0,2,4
98568,2,3,344856,344856,344859,0,3,0
98569,5,2,344861,344861,344863,0,2,2
98570,5,2,344866,344866,344868,0,2,3
98571,4,3,344870,344870,344873,0,3,2
98572,1,2,344871,344873,344875,2,4,0
98573,5,3,344876,344876,344879,0,3,1
98574,6,3,344882,344882,344885,0,3,3
98575,1,3,344883,344885,344888,2,5,0
98576,2,3,344885,344888,344891,3,6,0
98577,1,3,344886,344891,344894,5,8,0
98578,5,1,344891,344894,344895,3,4,0
98579,3,3,344894,344895,344898,1,4,0
98580,1,1,344895,344898,344899,3,4,0
98581,2,2,344897,344899,344901,2,4,0
98582,3,3,344900,344901,344904,1,4,0
98583,5,1,344905,344905,344906,0,1,1
98584,2,2,344907,344907,344909,0,2,1
98585,4,2,344911,344911,344913,0,2,2
98586,4,2,344915,344915,344917,0,2,2
98587,1,3,344916,344917,344920,1,4,0
98588,1,2,344917,344920,344922,3,5,0
98589,4,3,344921,344922,344925,1,4,0
98590,3,1,344924,344925,344926,1,2,0
98591,3,1,344927,344927,344928,0,1,1
98592,6,3,344933,344933,344936,0,3,5
98593,3,3,344936,344936,344939,0,3,0
98594,1,3,344937,344939,344942,2,5,0
98595,2,1,344939,344942,344943,3,4,0
98596,6,2,344945,344945,344947,0,2,2
98597,1,3,344946,344947,344950,1,4,0
98598,5,2,344951,344951,344953,0,2,1
98599,4,3,344955,344955,344958,0,3,2
98600,6,2,344961,344961,344963,0,2,3
98601,2,3,344963,344963,344966,0,3,0
98602,5,3,344968,344968,344971,0,3,2
98603,3,2,344971,344971,344973,0,2,0
98604,2,1,344973,344973,344974,0,1,0
98605,6,1,344979,344979,344980,0,1,5
98606,1,3,344980,344980,344983,0,3,0
98607,3,3,344983,344983,344986,0,3,0
98608,1,2,344984,344986,344988,2,4,0
98609,4,1,344988,344988,344989,0,1,0
98610,3,1,344991,344991,344992,0,1,2
98611,3,2,344994,344994,344996,0,2,2
98612,1,1,344995,344996,344997,1,2,0
98613,2,3,344997,344997,345000,0,3,0
98614,2,1,344999,345000,345001,1,2,0
98615,6,2,345005,345005,345007,0,2,4
98616,5,3,345010,345010,345013,0,3,3
98617,6,1,345016,345016,345017,0,1,3
98618,3,2,345019,345019,345021,0,2,2
98619,3,1,345022,345022,345023,0,1,1
98620,3,3,345025,345025,345028,0,3,2
98621,4,2,345029,345029,345031,0,2,1
98622,2,2,345031,345031,345033,0,2,0
98623,6,2,345037,345037,345039,0,2,4
98624,6,1,345043,345043,345044,0,1,4
98625,1,1,345044,345044,345045,0,1,0
98626,6,1,345050,345050,345051,0,1,5
98627,1,3,345051,345051,345054,0,3,0
98628,5,2,345056,345056,345058,0,2,2
98629,2,3,345058,345058,345061,0,3,0
98630,3,3,345061,345061,345064,0,3,0
98631,6,2,345067,345067,345069,0,2,3
98632,2,2,345069,345069,345071,0,2,0
98633,2,2,345071,345071,345073,0,2,0
98634,3,1,345074,345074,345075,0,1,1
98635,2,2,345076,345076,345078,0,2,1
98636,5,2,345081,345081,345083,0,2,3
98637,6,2,345087,345087,345089,0,2,4
98638,2,1,345089,345089,345090,0,1,0
98639,4,2,345093,345093,345095,0,2,3
98640,6,1,345099,345099,345100,0,1,4
98641,5,1,345104,345104,345105,0,1,4
98642,3,2,345107,345107,345109,0,2,2
98643,3,3,345110,345110,345113,0,3,1
98644,5,1,345115,345115,345116,0,1,2
98645,4,1,345119,345119,345120,0,1,3
98646,4,2,345123,345123,345125,0,2,3
98647,1,3,345124,345125,345128,1,4,0
98648,5,1,345129,345129,345130,0,1,1
98649,6,1,345135,345135,345136,0,1,5
98650,6,1,345141,345141,345142,0,1,5
98651,6,2,345147,345147,345149,0,2,5
98652,6,1,345153,345153,345154,0,1,4
98653,4,2,345157,345157,345159,0,2,3
98654,3,3,345160,345160,345163,0,3,1
98655,6,1,345166,345166,345167,0,1,3
98656,1,2,345167,345167,345169,0,2,0
98657,5,1,345172,345172,345173,0,1,3
98658,5,3,345177,345177,345180,0,3,4
98659,3,3,345180,345180,345183,0,3,0
98660,5,2,345185,345185,345187,0,2,2
98661,5,3,345190,345190,345193,0,3,3
98662,1,1,345191,345193,345194,2,3,0
98663,5,1,345196,345196,345197,0,1,2
98664,3,3,345199,345199,345202,0,3,2
98665,2,3,345201,345202,345205,1,4,0
98666,3,2,345204,345205,345207,1,3,0
98667,5,1,345209,345209,345210,0,1,2
98668,2,3,345211,345211,345214,0,3,1
98669,1,3,345212,345214,345217,2,5,0
98670,4,3,345216,345217,345220,1,4,0
98671,2,3,345218,345220,345223,2,5,0
98672,5,3,345223,345223,345226,0,3,0
98673,2,1,345225,345226,345227,1,2,0
98674,5,1,345230,345230,345231,0,1,3
98675,6,3,345236,345236,345239,0,3,5
98676,1,2,345237,345239,345241,2,4,0
98677,3,3,345240,345241,345244,1,4,0
98678,6,1,345246,345246,345247,0,1,2
98679,5,2,345251,345251,345253,0,2,4
98680,2,3,345253,345253,345256,0,3,0
98681,5,1,345258,345258,345259,0,1,2
98682,6,2,345264,345264,345266,0,2,5
98683,2,2,345266,345266,345268,0,2,0
98684,2,1,345268,345268,345269,0,1,0
98685,5,1,345273,345273,345274,0,1,4
98686,2,2,345275,345275,345277,0,2,1
98687,6,1,345281,345281,345282,0,1,4
98688,5,1,345286,345286,345287,0,1,4
98689,6,3,345292,345292,345295,0,3,5
98690,2,1,345294,345295,345296,1,2,0
98691,1,3,345295,345296,345299,1,4,0
98692,6,1,345301,345301,345302,0,1,2
98693,3,3,345304,345304,345307,0,3,2
98694,6,2,345310,345310,345312,0,2,3
98695,1,3,345311,345312,345315,1,4,0
98696,4,3,345315,345315,345318,0,3,0
98697,1,1,345316,345318,345319,2,3,0
98698,3,3,345319,345319,345322,0,3,0
98699,2,1,345321,345322,345323,1,2,0
98700,5,3,345326,345326,345329,0,3,3
98701,2,2,345328,345329,345331,1,3,0
98702,1,1,345329,345331,345332,2,3,0
98703,3,1,345332,345332,345333,0,1,0
98704,4,2,345336,345336,345338,0,2,3
98705,2,1,345338,345338,345339,0,1,0
98706,3,1,345341,345341,345342,0,1,2
98707,3,2,345344,345344,345346,0,2,2
98708,5,3,345349,345349,345352,0,3,3
98709,1,2,345350,345352,345354,2,4,0
98710,3,1,345353,345354,345355,1,2,0
98711,3,1,345356,345356,345357,0,1,1
98712,1,2,345357,345357,345359,0,2,0
98713,2,1,345359,345359,345360,0,1,0
98714,3,2,345362,345362,345364,0,2,2
98715,3,3,345365,345365,345368,0,3,1
98716,5,1,345370,345370,345371,0,1,2
98717,6,3,345376,345376,345379,0,3,5
98718,2,2,345378,345379,345381,1,3,0
98719,6,2,345384,345384,345386,0,2,3
98720,6,1,345390,345390,345391,0,1,4
98721,1,1,345391,345391,345392,0,1,0
98722,3,1,345394,345394,345395,0,1,2
98723,4,3,345398,345398,345401,0,3,3
98724,2,1,345400,345401,345402,1,2,0
98725,2,2,345402,345402,345404,0,2,0
98726,4,1,345406,345406,345407,0,1,2
98727,5,1,345411,345411,345412,0,1,4
98728,4,2,345415,345415,345417,0,2,3
98729,1,2,345416,345417,345419,1,3,0
98730,4,2,345420,345420,345422,0,2,1
98731,5,3,345425,345425,345428,0,3,3
98732,5,1,345430,345430,345431,0,1,2
98733,3,1,345433,345433,345434,0,1,2
98734,1,2,345434,345434,345436,0,2,0
98735,2,1,345436,345436,345437,0,1,0
98736,4,2,345440,345440,345442,0,2,3
98737,5,3,345445,345445,345448,0,3,3
98738,5,1,345450,345450,345451,0,1,2
98739,4,3,345454,345454,345457,0,3,3
98740,4,1,345458,345458,345459,0,1,1
98741,4,2,345462,345462,345464,0,2,3
98742,6,1,345468,345468,345469,0,1,4
98743,6,2,345474,345474,345476,0,2,5
98744,1,1,345475,345476,345477,1,2,0
98745,5,1,345480,345480,345481,0,1,3
98746,5,3,345485,345485,345488,0,3,4
98747,5,2,345490,345490,345492,0,2,2
98748,3,1,345493,345493,345494,0,1,1
98749,6,3,345499,345499,345502,0,3,5
98750,1,2,345500,345502,345504,2,4,0
98751,1,2,345501,345504,345506,3,5,0
98752,2,2,345503,345506,345508,3,5,0
98753,1,1,345504,345508,345509,4,5,0
98754,3,3,345507,345509,345512,2,5,0
98755,5,1,345512,345512,345513,0,1,0
98756,1,1,345513,345513,345514,0,1,0
98757,5,2,345518,345518,345520,0,2,4
98758,3,2,345521,345521,345523,0,2,1
98759,3,3,345524,345524,345527,0,3,1
98760,3,3,345527,345527,345530,0,3,0
98761,6,1,345533,345533,345534,0,1,3
98762,2,3,345535,345535,345538,0,3,1
98763,1,3,345536,345538,345541,2,5,0
98764,4,1,345540,345541,345542,1,2,0
98765,2,2,345542,345542,345544,0,2,0
98766,2,3,345544,345544,345547,0,3,0
98767,3,2,345547,345547,345549,0,2,0
98768,3,3,345550,345550,345553,0,3,1
98769,1,1,345551,345553,345554,2,3,0
98770,4,3,345555,345555,345558,0,3,1
98771,2,1,345557,345558,345559,1,2,0
98772,4,2,345561,345561,345563,0,2,2
98773,6,2,345567,345567,345569,0,2,4
98774,3,2,345570,345570,345572,0,2,1
98775,1,1,345571,345572,345573,1,2,0
98776,6,3,345577,345577,345580,0,3,4
98777,3,2,345580,345580,345582,0,2,0
98778,5,1,345585,345585,345586,0,1,3
98779,3,1,345588,345588,345589,0,1,2
98780,4,1,345592,345592,345593,0,1,3
98781,6,3,345598,345598,345601,0,3,5
98782,4,2,345602,345602,345604,0,2,1
98783,4,3,345606,345606,345609,0,3,2
98784,4,2,345610,345610,345612,0,2,1
98785,5,1,345615,345615,345616,0,1,3
98786,5,1,345620,345620,345621,0,1,4
98787,1,3,345621,345621,345624,0,3,0
98788,3,2,345624,345624,345626,0,2,0
98789,6,1,345630,345630,345631,0,1,4
98790,1,3,345631,345631,345634,0,3,0
98791,6,1,345637,345637,345638,0,1,3
98792,2,3,345639,345639,345642,0,3,1
98793,4,2,345643,345643,345645,0,2,1
98794,5,2,345648,345648,345650,0,2,3
98795,6,1,345654,345654,345655,0,1,4
98796,5,3,345659,345659,345662,0,3,4
98797,1,1,345660,345662,345663,2,3,0
98798,2,1,345662,345663,345664,1,2,0
98799,5,1,345667,345667,345668,0,1,3
98800,5,2,345672,345672,345674,0,2,4
98801,5,3,345677,345677,345680,0,3,3
98802,1,1,345678,345680,345681,2,3,0
98803,5,2,345683,345683,345685,0,2,2
98804,4,1,345687,345687,345688,0,1,2
98805,3,2,345690,345690,345692,0,2,2
98806,3,3,345693,345693,345696,0,3,1
98807,3,3,345696,345696,345699,0,3,0
98808,3,1,345699,345699,345700,0,1,0
98809,3,1,345702,345702,345703,0,1,2
98810,3,1,345705,345705,345706,0,1,2
98811,3,2,345708,345708,345710,0,2,2
98812,5,1,345713,345713,345714,0,1,3
98813,2,3,345715,345715,345718,0,3,1
98814,5,3,345720,345720,345723,0,3,2
98815,5,1,345725,345725,345726,0,1,2
98816,6,2,345731,345731,345733,0,2,5
98817,5,2,345736,345736,345738,0,2,3
98818,3,1,345739,345739,345740,0,1,1
98819,5,3,345744,345744,345747,0,3,4
98820,4,3,345748,345748,345751,0,3,1
98821,6,1,345754,345754,345755,0,1,3
98822,5,1,345759,345759,345760,0,1,4
98823,6,3,345765,345765,345768,0,3,5
98824,4,1,345769,345769,345770,0,1,1
98825,6,1,345775,345775,345776,0,1,5
98826,5,3,345780,345780,345783,0,3,4
98827,6,2,345786,345786,345788,0,2,3
98828,5,3,345791,345791,345794,0,3,3
98829,2,2,345793,345794,345796,1,3,0
98830,5,1,345798,345798,345799,0,1,2
98831,2,2,345800,345800,345802,0,2,1
98832,5,1,345805,345805,345806,0,1,3
98833,2,3,345807,345807,345810,0,3,1
98834,3,1,345810,345810,345811,0,1,0
98835,4,2,345814,345814,345816,0,2,3
98836,1,3,345815,345816,345819,1,4,0
98837,2,3,345817,345819,345822,2,5,0
98838,2,3,345819,345822,345825,3,6,0
98839,2,3,345821,345825,345828,4,7,0
98840,2,2,345823,345828,345830,5,7,0
98841,3,3,345826,345830,345833,4,7,0
98842,4,2,345830,345833,345835,3,5,0
98843,6,3,345836,345836,345839,0,3,1
98844,6,1,345842,345842,345843,0,1,3
98845,3,2,345845,345845,345847,0,2,2
98846,3,1,345848,345848,345849,0,1,1
98847,2,1,345850,345850,345851,0,1,1
98848,5,1,345855,345855,345856,0,1,4
98849,5,1,345860,345860,345861,0,1,4
98850,1,2,345861,345861,345863,0,2,0
98851,3,3,345864,345864,345867,0,3,1
98852,4,3,345868,345868,345871,0,3,1
98853,3,2,345871,345871,345873,0,2,0
98854,2,2,345873,345873,345875,0,2,0
98855,1,1,345874,345875,345876,1,2,0
98856,3,3,345877,345877,345880,0,3,1
98857,4,1,345881,345881,345882,0,1,1
98858,4,1,345885,345885,345886,0,1,3
98859,6,3,345891,345891,345894,0,3,5
98860,2,1,345893,345894,345895,1,2,0
98861,4,3,345897,345897,345900,0,3,2
98862,3,3,345900,345900,345903,0,3,0
98863,2,2,345902,345903,345905,1,3,0
98864,4,3,345906,345906,345909,0,3,1
98865,6,3,345912,345912,345915,0,3,3
98866,3,1,345915,345915,345916,0,1,0
98867,2,2,345917,345917,345919,0,2,1
98868,1,2,345918,345919,345921,1,3,0
98869,3,1,345921,345921,345922,0,1,0
98870,5,2,345926,345926,345928,0,2,4
98871,1,2,345927,345928,345930,1,3,0
98872,1,3,345928,345930,345933,2,5,0
98873,4,1,345932,345933,345934,1,2,0
98874,5,2,345937,345937,345939,0,2,3
98875,6,2,345943,345943,345945,0,2,4
98876,6,3,345949,345949,345952,0,3,4
98877,4,1,345953,345953,345954,0,1,1
98878,2,2,345955,345955,345957,0,2,1
98879,5,3,345960,345960,345963,0,3,3
98880,2,2,345962,345963,345965,1,3,0
98881,5,2,345967,345967,345969,0,2,2
98882,3,3,345970,345970,345973,0,3,1
98883,3,1,345973,345973,345974,0,1,0
98884,2,1,345975,345975,345976,0,1,1
98885,6,3,345981,345981,345984,0,3,5
98886,3,1,345984,345984,345985,0,1,0
98887,6,3,345990,345990,345993,0,3,5
98888,3,3,345993,345993,345996,0,3,0
98889,1,1,345994,345996,345997,2,3,0
98890,5,1,345999,345999,346000,0,1,2
98891,6,2,346005,346005,346007,0,2,5
98892,2,3,346007,346007,346010,0,3,0
98893,4,2,346011,346011,346013,0,2,1
98894,2,1,346013,346013,346014,0,1,0
98895,3,3,346016,346016,346019,0,3,2
98896,6,1,346022,346022,346023,0,1,3
98897,6,3,346028,346028,346031,0,3,5
98898,6,2,346034,346034,346036,0,2,3
98899,1,1,346035,346036,346037,1,2,0
98900,3,2,346038,346038,346040,0,2,1
98901,1,2,346039,346040,346042,1,3,0
98902,2,1,346041,346042,346043,1,2,0
98903,2,3,346043,346043,346046,0,3,0
98904,5,3,346048,346048,346051,0,3,2
98905,2,2,346050,346051,346053,1,3,0
98906,6,2,346056,346056,346058,0,2,3
98907,2,2,346058,346058,346060,0,2,0
98908,4,2,346062,346062,346064,0,2,2
98909,1,3,346063,346064,346067,1,4,0
98910,4,2,346067,346067,346069,0,2,0
98911,4,3,346071,346071,346074,0,3,2
98912,4,1,346075,346075,346076,0,1,1
98913,6,1,346081,346081,346082,0,1,5
98914,3,3,346084,346084,346087,0,3,2
98915,2,3,346086,346087,346090,1,4,0
98916,3,2,346089,346090,346092,1,3,0
98917,5,3,346094,346094,346097,0,3,2
98918,2,3,346096,346097,346100,1,4,0
98919,6,1,346102,346102,346103,0,1,2
98920,4,2,346106,346106,346108,0,2,3
98921,1,2,346107,346108,346110,1,3,0
98922,2,3,346109,346110,346113,1,4,0
98923,5,2,346114,346114,346116,0,2,1
98924,5,1,346119,346119,346120,0,1,3
98925,2,3,346121,346121,346124,0,3,1
98926,4,2,346125,346125,346127,0,2,1
98927,3,1,346128,346128,346129,0,1,1
98928,6,3,346134,346134,346137,0,3,5
98929,5,1,346139,346139,346140,0,1,2
98930,3,2,346142,346142,346144,0,2,2
98931,5,2,346147,346147,346149,0,2,3
98932,1,2,346148,346149,346151,1,3,0
98933,6,1,346154,346154,346155,0,1,3
98934,4,3,346158,346158,346161,0,3,3
98935,3,2,346161,346161,346163,0,2,0
98936,2,1,346163,346163,346164,0,1,0
98937,6,1,346169,346169,346170,0,1,5
98938,1,1,346170,346170,346171,0,1,0
98939,3,2,346173,346173,346175,0,2,2
98940,5,2,346178,346178,346180,0,2,3
98941,4,3,346182,346182,346185,0,3,2
98942,1,3,346183,346185,346188,2,5,0
98943,1,3,346184,346188,346191,4,7,0
98944,3,1,346187,346191,346192,4,5,0
98945,2,2,346189,346192,346194,3,5,0
98946,6,1,346195,346195,346196,0,1,1
98947,1,2,346196,346196,346198,0,2,0
98948,6,3,346202,346202,346205,0,3,4
98949,1,2,346203,346205,346207,2,4,0
98950,6,3,346209,346209,346212,0,3,2
98951,1,2,346210,346212,346214,2,4,0
98952,5,1,346215,346215,346216,0,1,1
98953,4,3,346219,346219,346222,0,3,3
98954,4,3,346223,346223,346226,0,3,1
98955,2,1,346225,346226,346227,1,2,0
98956,3,2,346228,346228,346230,0,2,1
98957,2,1,346230,346230,346231,0,1,0
98958,2,1,346232,346232,346233,0,1,1
98959,3,1,346235,346235,346236,0,1,2
98960,2,3,346237,346237,346240,0,3,1
98961,4,1,346241,346241,346242,0,1,1
98962,3,1,346244,346244,346245,0,1,2
98963,4,2,346248,346248,346250,0,2,3
98964,5,3,346253,346253,346256,0,3,3
98965,4,3,346257,346257,346260,0,3,1
98966,2,3,346259,346260,346263,1,4,0
98967,5,2,346264,346264,346266,0,2,1
98968,6,2,346270,346270,346272,0,2,4
98969,4,2,346274,346274,346276,0,2,2
98970,4,1,346278,346278,346279,0,1,2
98971,1,2,346279,346279,346281,0,2,0
98972,5,3,346284,346284,346287,0,3,3
98973,6,1,346290,346290,346291,0,1,3
98974,6,3,346296,346296,346299,0,3,5
98975,5,3,346301,346301,346304,0,3,2
98976,6,2,346307,346307,346309,0,2,3
98977,1,1,346308,346309,346310,1,2,0
98978,2,2,346310,346310,346312,0,2,0
98979,1,1,346311,346312,346313,1,2,0
98980,1,2,346312,346313,346315,1,3,0
98981,2,3,346314,346315,346318,1,4,0
98982,3,1,346317,346318,346319,1,2,0
98983,2,1,346319,346319,346320,0,1,0
98984,4,2,346323,346323,346325,0,2,3
98985,5,2,346328,346328,346330,0,2,3
98986,6,2,346334,346334,346336,0,2,4
98987,2,1,346336,346336,346337,0,1,0
98988,2,3,346338,346338,346341,0,3,1
98989,3,3,346341,346341,346344,0,3,0
98990,3,1,346344,346344,346345,0,1,0
98991,2,3,346346,346346,346349,0,3,1
98992,5,3,346351,346351,346354,0,3,2
98993,4,3,346355,346355,346358,0,3,1
98994,1,3,346356,346358,346361,2,5,0
98995,1,3,346357,346361,346364,4,7,0
98996,5,3,346362,346364,346367,2,5,0
98997,6,1,346368,346368,346369,0,1,1
98998,3,3,346371,346371,346374,0,3,2
98999,3,3,346374,346374,346377,0,3,0
99000,4,1,346378,346378,346379,0,1,1
99001,5,1,346383,346383,346384,0,1,4
99002,6,3,346389,346389,346392,0,3,5
99003,5,2,346394,346394,346396,0,2,2
99004,2,3,346396,346396,346399,0,3,0
99005,2,3,346398,346399,346402,1,4,0
99006,6,1,346404,346404,346405,0,1,2
99007,3,2,346407,346407,346409,0,2,2
99008,2,3,346409,346409,346412,0,3,0
99009,6,1,346415,346415,346416,0,1,3
99010,2,3,346417,346417,346420,0,3,1
99011,4,1,346421,346421,346422,0,1,1
99012,1,2,346422,346422,346424,0,2,0
99013,2,3,346424,346424,346427,0,3,0
99014,1,1,346425,346427,346428,2,3,0
99015,1,2,346426,346428,346430,2,4,0
99016,3,1,346429,346430,346431,1,2,0
99017,2,1,346431,346431,346432,0,1,0
99018,3,2,346434,346434,346436,0,2,2
99019,6,2,346440,346440,346442,0,2,4
99020,6,3,346446,346446,346449,0,3,4
99021,2,3,346448,346449,346452,1,4,0
99022,3,2,346451,346452,346454,1,3,0
99023,6,3,346457,346457,346460,0,3,3
99024,1,3,346458,346460,346463,2,5,0
99025,4,3,346462,346463,346466,1,4,0
99026,5,2,346467,346467,346469,0,2,1
99027,6,2,346473,346473,346475,0,2,4
99028,5,1,346478,346478,346479,0,1,3
99029,4,1,346482,346482,346483,0,1,3
99030,6,3,346488,346488,346491,0,3,5
99031,5,2,346493,346493,346495,0,2,2
99032,3,3,346496,346496,346499,0,3,1
99033,3,2,346499,346499,346501,0,2,0
99034,4,2,346503,346503,346505,0,2,2
99035,2,3,346505,346505,346508,0,3,0
99036,5,1,346510,346510,346511,0,1,2
99037,3,1,346513,346513,346514,0,1,2
99038,3,3,346516,346516,346519,0,3,2
99039,5,3,346521,346521,346524,0,3,2
99040,6,1,346527,346527,346528,0,1,3
99041,5,1,346532,346532,346533,0,1,4
99042,2,3,346534,346534,346537,0,3,1
99043,4,1,346538,346538,346539,0,1,1
99044,2,2,346540,346540,346542,0,2,1
99045,4,1,346544,346544,346545,0,1,2
99046,4,3,346548,346548,346551,0,3,3
99047,6,2,346554,346554,346556,0,2,3
99048,3,2,346557,346557,346559,0,2,1
99049,5,3,346562,346562,346565,0,3,3
99050,4,3,346566,346566,346569,0,3,1
99051,3,3,346569,346569,346572,0,3,0
99052,6,3,346575,346575,346578,0,3,3
99053,5,1,346580,346580,346581,0,1,2
99054,4,1,346584,346584,346585,0,1,3
99055,4,2,346588,346588,346590,0,2,3
99056,3,3,346591,346591,346594,0,3,1
99057,2,2,346593,346594,346596,1,3,0
99058,5,1,346598,346598,346599,0,1,2
99059,6,3,346604,346604,346607,0,3,5
99060,5,3,346609,346609,346612,0,3,2
99061,4,2,346613,346613,346615,0,2,1
99062,2,1,346615,346615,346616,0,1,0
99063,2,1,346617,346617,346618,0,1,1
99064,6,2,346623,346623,346625,0,2,5
99065,6,1,346629,346629,346630,0,1,4
99066,5,3,346634,346634,346637,0,3,4
99067,6,1,346640,346640,346641,0,1,3
99068,5,2,346645,346645,346647,0,2,4
99069,6,2,346651,346651,346653,0,2,4
99070,1,2,346652,346653,346655,1,3,0
99071,5,2,346657,346657,346659,0,2,2
99072,6,3,346663,346663,346666,0,3,4
99073,3,2,346666,346666,346668,0,2,0
99074,3,3,346669,346669,346672,0,3,1
99075,1,3,346670,346672,346675,2,5,0
99076,4,1,346674,346675,346676,1,2,0
99077,2,3,346676,346676,346679,0,3,0
99078,5,2,346681,346681,346683,0,2,2
99079,5,2,346686,346686,346688,0,2,3
99080,1,1,346687,346688,346689,1,2,0
99081,3,1,346690,346690,346691,0,1,1
99082,2,3,346692,346692,346695,0,3,1
99083,3,3,346695,346695,346698,0,3,0
99084,6,2,346701,346701,346703,0,2,3
99085,2,3,346703,346703,346706,0,3,0
99086,6,3,346709,346709,346712,0,3,3
99087,3,1,346712,346712,346713,0,1,0
99088,1,3,346713,346713,346716,0,3,0
99089,3,2,346716,346716,346718,0,2,0
99090,1,3,346717,346718,346721,1,4,0
99091,2,2,346719,346721,346723,2,4,0
99092,4,2,346723,346723,346725,0,2,0
99093,1,2,346724,346725,346727,1,3,0
99094,3,2,346727,346727,346729,0,2,0
99095,2,2,346729,346729,346731,0,2,0
99096,6,2,346735,346735,346737,0,2,4
99097,1,3,346736,346737,346740,1,4,0
99098,2,1,346738,346740,346741,2,3,0
99099,4,1,346742,346742,346743,0,1,1
99100,2,2,346744,346744,346746,0,2,1
99101,1,3,346745,346746,346749,1,4,0
99102,1,2,346746,346749,346751,3,5,0
99103,1,2,346747,346751,346753,4,6,0
99104,1,2,346748,346753,346755,5,7,0
99105,2,3,346750,346755,346758,5,8,0
99106,5,3,346755,346758,346761,3,6,0
99107,4,1,346759,346761,346762,2,3,0
99108,3,2,346762,346762,346764,0,2,0
99109,3,2,346765,346765,346767,0,2,1
99110,2,2,346767,346767,346769,0,2,0
99111,6,1,346773,346773,346774,0,1,4
99112,4,2,346777,346777,346779,0,2,3
99113,6,3,346783,346783,346786,0,3,4
99114,3,2,346786,346786,346788,0,2,0
99115,6,3,346792,346792,346795,0,3,4
99116,1,3,346793,346795,346798,2,5,0
99117,4,3,346797,346798,346801,1,4,0
99118,5,1,346802,346802,346803,0,1,1
99119,6,2,346808,346808,346810,0,2,5
99120,4,3,346812,346812,346815,0,3,2
99121,4,2,346816,346816,346818,0,2,1
99122,4,3,346820,346820,346823,0,3,2
99123,5,2,346825,346825,346827,0,2,2
99124,3,3,346828,346828,346831,0,3,1
99125,1,2,346829,346831,346833,2,4,0
99126,4,2,346833,346833,346835,0,2,0
99127,2,3,346835,346835,346838,0,3,0
99128,2,3,346837,346838,346841,1,4,0
99129,5,2,346842,346842,346844,0,2,1
99130,5,3,346847,346847,346850,0,3,3
99131,3,3,346850,346850,346853,0,3,0
99132,6,3,346856,346856,346859,0,3,3
99133,2,1,346858,346859,346860,1,2,0
99134,1,3,346859,346860,346863,1,4,0
99135,3,2,346862,346863,346865,1,3,0
99136,2,1,346864,346865,346866,1,2,0
99137,5,3,346869,346869,346872,0,3,3
99138,5,2,346874,346874,346876,0,2,2
99139,2,3,346876,346876,346879,0,3,0
99140,2,3,346878,346879,346882,1,4,0
99141,5,3,346883,346883,346886,0,3,1
99142,1,1,346884,346886,346887,2,3,0
99143,5,3,346889,346889,346892,0,3,2
99144,4,3,346893,346893,346896,0,3,1
99145,3,1,346896,346896,346897,0,1,0
99146,6,2,346902,346902,346904,0,2,5
99147,1,1,346903,346904,346905,1,2,0
99148,3,3,346906,346906,346909,0,3,1
99149,1,3,346907,346909,346912,2,5,0
99150,3,2,346910,346912,346914,2,4,0
99151,5,2,346915,346915,346917,0,2,1
99152,3,1,346918,346918,346919,0,1,1
99153,2,2,346920,346920,346922,0,2,1
99154,4,2,346924,346924,346926,0,2,2
99155,6,2,346930,346930,346932,0,2,4
99156,2,3,346932,346932,346935,0,3,0
99157,3,1,346935,346935,346936,0,1,0
99158,6,1,346941,346941,346942,0,1,5
99159,5,1,346946,346946,346947,0,1,4
99160,6,1,346952,346952,346953,0,1,5
99161,2,1,346954,346954,346955,0,1,1
99162,3,2,346957,346957,346959,0,2,2
99163,6,3,346963,346963,346966,0,3,4
99164,3,3,346966,346966,346969,0,3,0
99165,2,1,346968,346969,346970,1,2,0
99166,3,2,346971,346971,346973,0,2,1
99167,4,3,346975,346975,346978,0,3,2
99168,3,2,346978,346978,346980,0,2,0
99169,3,3,346981,346981,346984,0,3,1
99170,4,2,346985,346985,346987,0,2,1
99171,2,1,346987,346987,346988,0,1,0
99172,4,1,346991,346991,346992,0,1,3
99173,5,3,346996,346996,346999,0,3,4
99174,3,2,346999,346999,347001,0,2,0
99175,4,1,347003,347003,347004,0,1,2
99176,3,2,347006,347006,347008,0,2,2
99177,6,1,347012,347012,347013,0,1,4
99178,1,3,347013,347013,347016,0,3,0
99179,4,2,347017,347017,347019,0,2,1
99180,4,2,347021,347021,347023,0,2,2
99181,3,1,347024,347024,347025,0,1,1
99182,4,2,347028,347028,347030,0,2,3
99183,1,1,347029,347030,347031,1,2,0
99184,4,1,347033,347033,347034,0,1,2
99185,6,3,347039,347039,347042,0,3,5
99186,6,2,347045,347045,347047,0,2,3
99187,4,3,347049,347049,347052,0,3,2
99188,2,1,347051,347052,347053,1,2,0
99189,5,2,347056,347056,347058,0,2,3
99190,6,3,347062,347062,347065,0,3,4
99191,1,3,347063,347065,347068,2,5,0
99192,6,1,347069,347069,347070,0,1,1
99193,4,2,347073,347073,347075,0,2,3
99194,3,1,347076,347076,347077,0,1,1
99195,6,1,347082,347082,347083,0,1,5
99196,1,1,347083,347083,347084,0,1,0
99197,4,3,347087,347087,347090,0,3,3
99198,6,1,347093,347093,347094,0,1,3
99199,6,1,347099,347099,347100,0,1,5
99200,1,1,347100,347100,347101,0,1,0
99201,6,3,347106,347106,347109,0,3,5
99202,2,1,347108,347109,347110,1,2,0
99203,4,3,347112,347112,347115,0,3,2
99204,1,2,347113,347115,347117,2,4,0
99205,2,1,347115,347117,347118,2,3,0
99206,6,1,347121,347121,347122,0,1,3
99207,5,1,347126,347126,347127,0,1,4
99208,2,1,347128,347128,347129,0,1,1
99209,6,2,347134,347134,347136,0,2,5
99210,3,3,347137,347137,347140,0,3,1
99211,5,2,347142,347142,347144,0,2,2
99212,4,2,347146,347146,347148,0,2,2
99213,2,1,347148,347148,347149,0,1,0
99214,2,3,347150,347150,347153,0,3,1
99215,2,2,347152,347153,347155,1,3,0
99216,4,3,347156,347156,347159,0,3,1
99217,3,1,347159,347159,347160,0,1,0
99218,3,3,347162,347162,347165,0,3,2
99219,6,2,347168,347168,347170,0,2,3
99220,4,3,347172,347172,347175,0,3,2
99221,5,1,347177,347177,347178,0,1,2
99222,2,3,347179,347179,347182,0,3,1
99223,3,3,347182,347182,347185,0,3,0
99224,3,1,347185,347185,347186,0,1,0
99225,4,3,347189,347189,347192,0,3,3
99226,1,3,347190,347192,347195,2,5,0
99227,1,3,347191,347195,347198,4,7,0
99228,2,2,347193,347198,347200,5,7,0
99229,1,2,347194,347200,347202,6,8,0
99230,2,2,347196,347202,347204,6,8,0
99231,3,1,347199,347204,347205,5,6,0
99232,5,1,347204,347205,347206,1,2,0
99233,1,2,347205,347206,347208,1,3,0
99234,4,2,347209,347209,347211,0,2,1
99235,1,1,347210,347211,347212,1,2,0
99236,1,1,347211,347212,347213,1,2,0
99237,2,3,347213,347213,347216,0,3,0
99238,3,1,347216,347216,347217,0,1,0
99239,5,2,347221,347221,347223,0,2,4
99240,6,3,347227,347227,347230,0,3,4
99241,3,3,347230,347230,347233,0,3,0
99242,6,2,347236,347236,347238,0,2,3
99243,3,1,347239,347239,347240,0,1,1
99244,4,2,347243,347243,347245,0,2,3
99245,4,3,347247,347247,347250,0,3,2
99246,1,2,347248,347250,347252,2,4,0
99247,3,3,347251,347252,347255,1,4,0
99248,2,1,347253,347255,347256,2,3,0
99249,5,1,347258,347258,347259,0,1,2
99250,6,2,347264,347264,347266,0,2,5
99251,3,2,347267,347267,347269,0,2,1
99252,3,2,347270,347270,347272,0,2,1
99253,5,1,347275,347275,347276,0,1,3
99254,2,2,347277,347277,347279,0,2,1
99255,1,2,347278,347279,347281,1,3,0
99256,1,3,347279,347281,347284,2,5,0
99257,1,1,347280,347284,347285,4,5,0
99258,5,1,347285,347285,347286,0,1,0
99259,3,2,347288,347288,347290,0,2,2
99260,5,1,347293,347293,347294,0,1,3
99261,4,2,347297,347297,347299,0,2,3
99262,4,2,347301,347301,347303,0,2,2
99263,1,3,347302,347303,347306,1,4,0
99264,3,2,347305,347306,347308,1,3,0
99265,2,2,347307,347308,347310,1,3,0
99266,3,3,347310,347310,347313,0,3,0
99267,1,1,347311,347313,347314,2,3,0
99268,2,3,347313,347314,347317,1,4,0
99269,6,3,347319,347319,347322,0,3,2
99270,5,3,347324,347324,347327,0,3,2
99271,1,1,347325,347327,347328,2,3,0
99272,3,1,347328,347328,347329,0,1,0
99273,6,3,347334,347334,347337,0,3,5
99274,6,2,347340,347340,347342,0,2,3
99275,2,1,347342,347342,347343,0,1,0
99276,3,3,347345,347345,347348,0,3,2
99277,2,1,347347,347348,347349,1,2,0
99278,2,2,347349,347349,347351,0,2,0
99279,2,2,347351,347351,347353,0,2,0
99280,6,2,347357,347357,347359,0,2,4
99281,5,1,347362,347362,347363,0,1,3
99282,4,3,347366,347366,347369,0,3,3
99283,5,1,347371,347371,347372,0,1,2
99284,6,1,347377,347377,347378,0,1,5
99285,6,1,347383,347383,347384,0,1,5
99286,4,1,347387,347387,347388,0,1,3
99287,4,2,347391,347391,347393,0,2,3
99288,2,3,347393,347393,347396,0,3,0
99289,4,2,347397,347397,347399,0,2,1
99290,2,2,347399,347399,347401,0,2,0
99291,4,2,347403,347403,347405,0,2,2
99292,5,3,347408,347408,347411,0,3,3
99293,2,3,347410,347411,347414,1,4,0
99294,4,1,347414,347414,347415,0,1,0
99295,3,2,347417,347417,347419,0,2,2
99296,1,2,347418,347419,347421,1,3,0
99297,6,3,347424,347424,347427,0,3,3
99298,6,3,347430,347430,347433,0,3,3
99299,6,1,347436,347436,347437,0,1,3
99300,5,1,347441,347441,347442,0,1,4
99301,6,2,347447,347447,347449,0,2,5
99302,2,3,347449,347449,347452,0,3,0
99303,3,2,347452,347452,347454,0,2,0
99304,1,3,347453,347454,347457,1,4,0
99305,4,1,347457,347457,347458,0,1,0
99306,5,1,347462,347462,347463,0,1,4
99307,5,2,347467,347467,347469,0,2,4
99308,3,1,347470,347470,347471,0,1,1
99309,4,1,347474,347474,347475,0,1,3
99310,2,1,347476,347476,347477,0,1,1
99311,6,3,347482,347482,347485,0,3,5
99312,3,1,347485,347485,347486,0,1,0
99313,5,2,347490,347490,347492,0,2,4
99314,2,2,347492,347492,347494,0,2,0
99315,3,3,347495,347495,347498,0,3,1
99316,1,2,347496,347498,347500,2,4,0
99317,1,1,347497,347500,347501,3,4,0
99318,3,2,347500,347501,347503,1,3,0
99319,1,2,347501,347503,347505,2,4,0
99320,1,1,347502,347505,347506,3,4,0
99321,5,2,347507,347507,347509,0,2,1
99322,1,3,347508,347509,347512,1,4,0
99323,2,3,347510,347512,347515,2,5,0
99324,3,1,347513,347515,347516,2,3,0
99325,1,2,347514,347516,347518,2,4,0
99326,3,2,347517,347518,347520,1,3,0
99327,1,1,347518,347520,347521,2,3,0
99328,6,1,347524,347524,347525,0,1,3
99329,3,1,347527,347527,347528,0,1,2
99330,1,2,347528,347528,347530,0,2,0
99331,2,1,347530,347530,347531,0,1,0
99332,2,2,347532,347532,347534,0,2,1
99333,5,3,347537,347537,347540,0,3,3
99334,6,1,347543,347543,347544,0,1,3
99335,4,1,347547,347547,347548,0,1,3
99336,6,2,347553,347553,347555,0,2,5
99337,5,2,347558,347558,347560,0,2,3
99338,6,1,347564,347564,347565,0,1,4
99339,4,3,347568,347568,347571,0,3,3
99340,2,3,347570,347571,347574,1,4,0
99341,2,2,347572,347574,347576,2,4,0
99342,5,2,347577,347577,347579,0,2,1
99343,6,1,347583,347583,347584,0,1,4
99344,5,3,347588,347588,347591,0,3,4
99345,3,2,347591,347591,347593,0,2,0
99346,6,3,347597,347597,347600,0,3,4
99347,1,3,347598,347600,347603,2,5,0
99348,1,1,347599,347603,347604,4,5,0
99349,5,1,347604,347604,347605,0,1,0
99350,3,2,347607,347607,347609,0,2,2
99351,1,3,347608,347609,347612,1,4,0
99352,1,1,347609,347612,347613,3,4,0
99353,5,2,347614,347614,347616,0,2,1
99354,2,3,347616,347616,347619,0,3,0
99355,5,1,347621,347621,347622,0,1,2
99356,2,1,347623,347623,347624,0,1,1
99357,6,1,347629,347629,347630,0,1,5
99358,4,2,347633,347633,347635,0,2,3
99359,1,3,347634,347635,347638,1,4,0
99360,1,3,347635,347638,347641,3,6,0
99361,1,1,347636,347641,347642,5,6,0
99362,2,3,347638,347642,347645,4,7,0
99363,4,1,347642,347645,347646,3,4,0
99364,3,2,347645,347646,347648,1,3,0
99365,5,1,347650,347650,347651,0,1,2
99366,4,3,347654,347654,347657,0,3,3
99367,5,2,347659,347659,347661,0,2,2
99368,4,3,347663,347663,347666,0,3,2
99369,1,1,347664,347666,347667,2,3,0
99370,5,1,347669,347669,347670,0,1,2
99371,4,2,347673,347673,347675,0,2,3
99372,2,2,347675,347675,347677,0,2,0
99373,1,3,347676,347677,347680,1,4,0
99374,1,2,347677,347680,347682,3,5,0
99375,1,2,347678,347682,347684,4,6,0
99376,1,1,347679,347684,347685,5,6,0
99377,6,2,347685,347685,347687,0,2,0
99378,3,3,347688,347688,347691,0,3,1
99379,3,2,347691,347691,347693,0,2,0
99380,1,2,347692,347693,347695,1,3,0
99381,3,2,347695,347695,347697,0,2,0
99382,5,2,347700,347700,347702,0,2,3
99383,3,2,347703,347703,347705,0,2,1
99384,3,3,347706,347706,347709,0,3,1
99385,3,2,347709,347709,347711,0,2,0
99386,5,2,347714,347714,347716,0,2,3
99387,6,1,347720,347720,347721,0,1,4
99388,4,3,347724,347724,347727,0,3,3
99389,5,3,347729,347729,347732,0,3,2
99390,1,2,347730,347732,347734,2,4,0
99391,5,3,347735,347735,347738,0,3,1
99392,5,3,347740,347740,347743,0,3,2
99393,6,3,347746,347746,347749,0,3,3
99394,1,1,347747,347749,347750,2,3,0
99395,4,1,347751,347751,347752,0,1,1
99396,4,2,347755,347755,347757,0,2,3
99397,1,1,347756,347757,347758,1,2,0
99398,1,3,347757,347758,347761,1,4,0
99399,2,3,347759,347761,347764,2,5,0
99400,1,1,347760,347764,347765,4,5,0
99401,4,3,347764,347765,347768,1,4,0
99402,4,1,347768,347768,347769,0,1,0
99403,4,2,347772,347772,347774,0,2,3
99404,2,1,347774,347774,347775,0,1,0
99405,3,2,347777,347777,347779,0,2,2
99406,3,2,347780,347780,347782,0,2,1
99407,6,1,347786,347786,347787,0,1,4
99408,1,2,347787,347787,347789,0,2,0
99409,5,2,347792,347792,347794,0,2,3
99410,5,1,347797,347797,347798,0,1,3
99411,1,3,347798,347798,347801,0,3,0
99412,6,1,347804,347804,347805,0,1,3
99413,6,1,347810,347810,347811,0,1,5
99414,5,1,347815,347815,347816,0,1,4
99415,3,3,347818,347818,347821,0,3,2
99416,1,3,347819,347821,347824,2,5,0
99417,1,3,347820,347824,347827,4,7,0
99418,3,3,347823,347827,347830,4,7,0
99419,4,1,347827,347830,347831,3,4,0
99420,6,1,347833,347833,347834,0,1,2
99421,1,1,347834,347834,347835,0,1,0
99422,1,3,347835,347835,347838,0,3,0
99423,3,2,347838,347838,347840,0,2,0
99424,5,2,347843,347843,347845,0,2,3
99425,6,2,347849,347849,347851,0,2,4
99426,1,3,347850,347851,347854,1,4,0
99427,1,3,347851,347854,347857,3,6,0
99428,5,3,347856,347857,347860,1,4,0
99429,4,2,347860,347860,347862,0,2,0
99430,6,3,347866,347866,347869,0,3,4
99431,3,1,347869,347869,347870,0,1,0
99432,3,3,347872,347872,347875,0,3,2
99433,5,1,347877,347877,347878,0,1,2
99434,4,2,347881,347881,347883,0,2,3
99435,2,2,347883,347883,347885,0,2,0
99436,4,2,347887,347887,347889,0,2,2
99437,6,2,347893,347893,347895,0,2,4
99438,3,1,347896,347896,347897,0,1,1
99439,2,3,347898,347898,347901,0,3,1
99440,3,2,347901,347901,347903,0,2,0
99441,4,1,347905,347905,347906,0,1,2
99442,3,1,347908,347908,347909,0,1,2
99443,4,1,347912,347912,347913,0,1,3
99444,6,1,347918,347918,347919,0,1,5
99445,6,1,347924,347924,347925,0,1,5
99446,4,1,347928,347928,347929,0,1,3
99447,4,1,347932,347932,347933,0,1,3
99448,6,2,347938,347938,347940,0,2,5
99449,4,1,347942,347942,347943,0,1,2
99450,1,2,347943,347943,347945,0,2,0
99451,2,3,347945,347945,347948,0,3,0
99452,2,2,347947,347948,347950,1,3,0
99453,3,2,347950,347950,347952,0,2,0
99454,5,1,347955,347955,347956,0,1,3
99455,1,3,347956,347956,347959,0,3,0
99456,1,2,347957,347959,347961,2,4,0
99457,2,3,347959,347961,347964,2,5,0
99458,5,3,347964,347964,347967,0,3,0
99459,4,2,347968,347968,347970,0,2,1
99460,2,2,347970,347970,347972,0,2,0
99461,3,2,347973,347973,347975,0,2,1
99462,6,1,347979,347979,347980,0,1,4
99463,3,2,347982,347982,347984,0,2,2
99464,5,2,347987,347987,347989,0,2,3
99465,2,2,347989,347989,347991,0,2,0
99466,2,2,347991,347991,347993,0,2,0
99467,5,3,347996,347996,347999,0,3,3
99468,4,2,348000,348000,348002,0,2,1
99469,3,1,348003,348003,348004,0,1,1
99470,3,3,348006,348006,348009,0,3,2
99471,1,3,348007,348009,348012,2,5,0
99472,5,2,348012,348012,348014,0,2,0
99473,3,2,348015,348015,348017,0,2,1
99474,4,2,348019,348019,348021,0,2,2
99475,5,1,348024,348024,348025,0,1,3
99476,1,2,348025,348025,348027,0,2,0
99477,2,2,348027,348027,348029,0,2,0
99478,6,1,348033,348033,348034,0,1,4
99479,6,1,348039,348039,348040,0,1,5
99480,1,1,348040,348040,348041,0,1,0
99481,1,2,348041,348041,348043,0,2,0
99482,1,1,348042,348043,348044,1,2,0
99483,2,1,348044,348044,348045,0,1,0
99484,5,1,348049,348049,348050,0,1,4
99485,5,2,348054,348054,348056,0,2,4
99486,4,1,348058,348058,348059,0,1,2
99487,3,2,348061,348061,348063,0,2,2
99488,4,3,348065,348065,348068,0,3,2
99489,6,2,348071,348071,348073,0,2,3
99490,3,2,348074,348074,348076,0,2,1
99491,1,1,348075,348076,348077,1,2,0
99492,3,3,348078,348078,348081,0,3,1
99493,6,3,348084,348084,348087,0,3,3
99494,4,1,348088,348088,348089,0,1,1
99495,5,1,348093,348093,348094,0,1,4
99496,1,1,348094,348094,348095,0,1,0
99497,5,1,348099,348099,348100,0,1,4
99498,1,3,348100,348100,348103,0,3,0
99499,3,2,348103,348103,348105,0,2,0
99500,4,2,348107,348107,348109,0,2,2
99501,3,1,348110,348110,348111,0,1,1
99502,6,3,348116,348116,348119,0,3,5
99503,6,1,348122,348122,348123,0,1,3
99504,3,1,348125,348125,348126,0,1,2
99505,1,1,348126,348126,348127,0,1,0
99506,2,1,348128,348128,348129,0,1,1
99507,2,2,348130,348130,348132,0,2,1
99508,4,3,348134,348134,348137,0,3,2
99509,5,2,348139,348139,348141,0,2,2
99510,1,2,348140,348141,348143,1,3,0
99511,3,2,348143,348143,348145,0,2,0
99512,3,2,348146,348146,348148,0,2,1
99513,6,2,348152,348152,348154,0,2,4
99514,1,3,348153,348154,348157,1,4,0
99515,4,1,348157,348157,348158,0,1,0
99516,1,2,348158,348158,348160,0,2,0
99517,1,1,348159,348160,348161,1,2,0
99518,4,3,348163,348163,348166,0,3,2
99519,6,2,348169,348169,348171,0,2,3
99520,3,2,348172,348172,348174,0,2,1
99521,5,2,348177,348177,348179,0,2,3
99522,3,3,348180,348180,348183,0,3,1
99523,3,2,348183,348183,348185,0,2,0
99524,3,1,348186,348186,348187,0,1,1
99525,4,1,348190,348190,348191,0,1,3
99526,6,3,348196,348196,348199,0,3,5
99527,6,2,348202,348202,348204,0,2,3
99528,4,2,348206,348206,348208,0,2,2
99529,5,2,348211,348211,348213,0,2,3
99530,4,2,348215,348215,348217,0,2,2
99531,5,3,348220,348220,348223,0,3,3
99532,2,2,348222,348223,348225,1,3,0
99533,6,2,348228,348228,348230,0,2,3
99534,1,2,348229,348230,348232,1,3,0
99535,4,2,348233,348233,348235,0,2,1
99536,3,3,348236,348236,348239,0,3,1
99537,4,2,348240,348240,348242,0,2,1
99538,1,1,348241,348242,348243,1,2,0
99539,6,3,348247,348247,348250,0,3,4
99540,4,3,348251,348251,348254,0,3,1
99541,3,2,348254,348254,348256,0,2,0
99542,5,3,348259,348259,348262,0,3,3
99543,4,2,348263,348263,348265,0,2,1
99544,4,1,348267,348267,348268,0,1,2
99545,1,2,348268,348268,348270,0,2,0
99546,5,3,348273,348273,348276,0,3,3
99547,4,3,348277,348277,348280,0,3,1
99548,4,1,348281,348281,348282,0,1,1
99549,2,2,348283,348283,348285,0,2,1
99550,5,3,348288,348288,348291,0,3,3
99551,4,2,348292,348292,348294,0,2,1
99552,3,2,348295,348295,348297,0,2,1
99553,2,2,348297,348297,348299,0,2,0
99554,4,2,348301,348301,348303,0,2,2
99555,3,1,348304,348304,348305,0,1,1
99556,4,3,348308,348308,348311,0,3,3
99557,6,1,348314,348314,348315,0,1,3
99558,4,2,348318,348318,348320,0,2,3
99559,2,2,348320,348320,348322,0,2,0
99560,1,1,348321,348322,348323,1,2,0
99561,4,2,348325,348325,348327,0,2,2
99562,6,3,348331,348331,348334,0,3,4
99563,4,1,348335,348335,348336,0,1,1
99564,4,3,348339,348339,348342,0,3,3
99565,2,1,348341,348342,348343,1,2,0
99566,6,1,348347,348347,348348,0,1,4
99567,3,1,348350,348350,348351,0,1,2
99568,2,1,348352,348352,348353,0,1,1
99569,4,2,348356,348356,348358,0,2,3
99570,2,2,348358,348358,348360,0,2,0
99571,3,3,348361,348361,348364,0,3,1
99572,5,1,348366,348366,348367,0,1,2
99573,6,2,348372,348372,348374,0,2,5
99574,6,3,348378,348378,348381,0,3,4
99575,5,3,348383,348383,348386,0,3,2
99576,1,2,348384,348386,348388,2,4,0
99577,1,1,348385,348388,348389,3,4,0
99578,2,1,348387,348389,348390,2,3,0
99579,5,1,348392,348392,348393,0,1,2
99580,6,1,348398,348398,348399,0,1,5
99581,5,2,348403,348403,348405,0,2,4
99582,6,3,348409,348409,348412,0,3,4
99583,5,1,348414,348414,348415,0,1,2
99584,1,1,348415,348415,348416,0,1,0
99585,4,3,348419,348419,348422,0,3,3
99586,5,3,348424,348424,348427,0,3,2
99587,3,2,348427,348427,348429,0,2,0
99588,2,3,348429,348429,348432,0,3,0
99589,6,2,348435,348435,348437,0,2,3
99590,5,1,348440,348440,348441,0,1,3
99591,5,3,348445,348445,348448,0,3,4
99592,4,1,348449,348449,348450,0,1,1
99593,2,2,348451,348451,348453,0,2,1
99594,1,3,348452,348453,348456,1,4,0
99595,4,2,348456,348456,348458,0,2,0
99596,2,1,348458,348458,348459,0,1,0
99597,4,2,348462,348462,348464,0,2,3
99598,5,2,348467,348467,348469,0,2,3
99599,3,3,348470,348470,348473,0,3,1
99600,5,2,348475,348475,348477,0,2,2
99601,6,2,348481,348481,348483,0,2,4
99602,5,2,348486,348486,348488,0,2,3
99603,3,3,348489,348489,348492,0,3,1
99604,2,1,348491,348492,348493,1,2,0
99605,6,3,348497,348497,348500,0,3,4
99606,2,2,348499,348500,348502,1,3,0
99607,2,3,348501,348502,348505,1,4,0
99608,6,3,348507,348507,348510,0,3,2
99609,3,3,348510,348510,348513,0,3,0
99610,6,2,348516,348516,348518,0,2,3
99611,3,1,348519,348519,348520,0,1,1
99612,2,2,348521,348521,348523,0,2,1
99613,6,2,348527,348527,348529,0,2,4
99614,1,1,348528,348529,348530,1,2,0
99615,4,1,348532,348532,348533,0,1,2
99616,1,1,348533,348533,348534,0,1,0
99617,1,2,348534,348534,348536,0,2,0
99618,2,2,348536,348536,348538,0,2,0
99619,2,2,348538,348538,348540,0,2,0
99620,4,1,348542,348542,348543,0,1,2
99621,3,3,348545,348545,348548,0,3,2
99622,5,1,348550,348550,348551,0,1,2
99623,3,1,348553,348553,348554,0,1,2
99624,2,2,348555,348555,348557,0,2,1
99625,2,1,348557,348557,348558,0,1,0
99626,4,3,348561,348561,348564,0,3,3
99627,3,1,348564,348564,348565,0,1,0
99628,3,3,348567,348567,348570,0,3,2
99629,3,1,348570,348570,348571,0,1,0
99630,6,1,348576,348576,348577,0,1,5
99631,1,3,348577,348577,348580,0,3,0
99632,2,3,348579,348580,348583,1,4,0
99633,4,2,348583,348583,348585,0,2,0
99634,4,1,348587,348587,348588,0,1,2
99635,2,1,348589,348589,348590,0,1,1
99636,3,1,348592,348592,348593,0,1,2
99637,2,2,348594,348594,348596,0,2,1
99638,4,1,348598,348598,348599,0,1,2
99639,6,1,348604,348604,348605,0,1,5
99640,2,1,348606,348606,348607,0,1,1
99641,4,1,348610,348610,348611,0,1,3
99642,2,2,348612,348612,348614,0,2,1
99643,2,2,348614,348614,348616,0,2,0
99644,1,3,348615,348616,348619,1,4,0
99645,3,2,348618,348619,348621,1,3,0
99646,3,2,348621,348621,348623,0,2,0
99647,5,3,348626,348626,348629,0,3,3
99648,3,1,348629,348629,348630,0,1,0
99649,6,2,348635,348635,348637,0,2,5
99650,3,1,348638,348638,348639,0,1,1
99651,1,1,348639,348639,348640,0,1,0
99652,4,1,348643,348643,348644,0,1,3
99653,3,3,348646,348646,348649,0,3,2
99654,1,2,348647,348649,348651,2,4,0
99655,1,3,348648,348651,348654,3,6,0
99656,6,3,348654,348654,348657,0,3,0
99657,1,3,348655,348657,348660,2,5,0
99658,3,1,348658,348660,348661,2,3,0
99659,3,2,348661,348661,348663,0,2,0
99660,5,1,348666,348666,348667,0,1,3
99661,2,3,348668,348668,348671,0,3,1
99662,1,3,348669,348671,348674,2,5,0
99663,1,2,348670,348674,348676,4,6,0
99664,5,3,348675,348676,348679,1,4,0
99665,6,3,348681,348681,348684,0,3,2
99666,1,2,348682,348684,348686,2,4,0
99667,6,1,348688,348688,348689,0,1,2
99668,3,1,348691,348691,348692,0,1,2
99669,1,3,348692,348692,348695,0,3,0
99670,6,2,348698,348698,348700,0,2,3
99671,5,1,348703,348703,348704,0,1,3
99672,4,1,348707,348707,348708,0,1,3
99673,2,3,348709,348709,348712,0,3,1
99674,2,1,348711,348712,348713,1,2,0
99675,4,3,348715,348715,348718,0,3,2
99676,6,3,348721,348721,348724,0,3,3
99677,4,2,348725,348725,348727,0,2,1
99678,3,3,348728,348728,348731,0,3,1
99679,6,2,348734,348734,348736,0,2,3
99680,6,1,348740,348740,348741,0,1,4
99681,5,2,348745,348745,348747,0,2,4
99682,6,1,348751,348751,348752,0,1,4
99683,1,2,348752,348752,348754,0,2,0
99684,1,3,348753,348754,348757,1,4,0
99685,4,1,348757,348757,348758,0,1,0
99686,5,1,348762,348762,348763,0,1,4
99687,2,3,348764,348764,348767,0,3,1
99688,3,1,348767,348767,348768,0,1,0
99689,2,2,348769,348769,348771,0,2,1
99690,6,3,348775,348775,348778,0,3,4
99691,2,3,348777,348778,348781,1,4,0
99692,6,2,348783,348783,348785,0,2,2
99693,4,3,348787,348787,348790,0,3,2
99694,5,3,348792,348792,348795,0,3,2
99695,3,2,348795,348795,348797,0,2,0
99696,4,2,348799,348799,348801,0,2,2
99697,5,2,348804,348804,348806,0,2,3
99698,1,3,348805,348806,348809,1,4,0
99699,5,3,348810,348810,348813,0,3,1
99700,6,3,348816,348816,348819,0,3,3
99701,6,1,348822,348822,348823,0,1,3
99702,6,2,348828,348828,348830,0,2,5
99703,4,3,348832,348832,348835,0,3,2
99704,3,1,348835,348835,348836,0,1,0
99705,3,1,348838,348838,348839,0,1,2
99706,2,3,348840,348840,348843,0,3,1
99707,2,1,348842,348843,348844,1,2,0
99708,6,3,348848,348848,348851,0,3,4
99709,2,1,348850,348851,348852,1,2,0
99710,4,1,348854,348854,348855,0,1,2
99711,5,3,348859,348859,348862,0,3,4
99712,1,1,348860,348862,348863,2,3,0
99713,5,3,348865,348865,348868,0,3,2
99714,1,3,348866,348868,348871,2,5,0
99715,4,2,348870,348871,348873,1,3,0
99716,2,2,348872,348873,348875,1,3,0
99717,5,1,348877,348877,348878,0,1,2
99718,2,1,348879,348879,348880,0,1,1
99719,1,3,348880,348880,348883,0,3,0
99720,4,1,348884,348884,348885,0,1,1
99721,5,1,348889,348889,348890,0,1,4
99722,1,3,348890,348890,348893,0,3,0
99723,4,1,348894,348894,348895,0,1,1
99724,4,3,348898,348898,348901,0,3,3
99725,4,3,348902,348902,348905,0,3,1
99726,6,1,348908,348908,348909,0,1,3
99727,2,2,348910,348910,348912,0,2,1
99728,1,3,348911,348912,348915,1,4,0
99729,4,3,348915,348915,348918,0,3,0
99730,4,2,348919,348919,348921,0,2,1
99731,1,1,348920,348921,348922,1,2,0
99732,1,2,348921,348922,348924,1,3,0
99733,3,1,348924,348924,348925,0,1,0
99734,2,2,348926,348926,348928,0,2,1
99735,6,2,348932,348932,348934,0,2,4
99736,1,1,348933,348934,348935,1,2,0
99737,2,1,348935,348935,348936,0,1,0
99738,1,1,348936,348936,348937,0,1,0
99739,1,3,348937,348937,348940,0,3,0
99740,3,1,348940,348940,348941,0,1,0
99741,4,1,348944,348944,348945,0,1,3
99742,5,3,348949,348949,348952,0,3,4
99743,4,1,348953,348953,348954,0,1,1
99744,6,3,348959,348959,348962,0,3,5
99745,2,2,348961,348962,348964,1,3,0
99746,3,2,348964,348964,348966,0,2,0
99747,1,3,348965,348966,348969,1,4,0
99748,1,3,348966,348969,348972,3,6,0
99749,5,2,348971,348972,348974,1,3,0
99750,5,3,348976,348976,348979,0,3,2
99751,4,2,348980,348980,348982,0,2,1
99752,1,3,348981,348982,348985,1,4,0
99753,4,2,348985,348985,348987,0,2,0
99754,1,2,348986,348987,348989,1,3,0
99755,6,2,348992,348992,348994,0,2,3
99756,4,3,348996,348996,348999,0,3,2
99757,5,2,349001,349001,349003,0,2,2
99758,2,2,349003,349003,349005,0,2,0
99759,3,1,349006,349006,349007,0,1,1
99760,1,2,349007,349007,349009,0,2,0
99761,3,3,349010,349010,349013,0,3,1
99762,6,1,349016,349016,349017,0,1,3
99763,5,3,349021,349021,349024,0,3,4
99764,6,3,349027,349027,349030,0,3,3
99765,2,2,349029,349030,349032,1,3,0
99766,6,2,349035,349035,349037,0,2,3
99767,2,3,349037,349037,349040,0,3,0
99768,2,2,349039,349040,349042,1,3,0
99769,2,2,349041,349042,349044,1,3,0
99770,3,1,349044,349044,349045,0,1,0
99771,3,2,349047,349047,349049,0,2,2
99772,5,3,349052,349052,349055,0,3,3
99773,1,1,349053,349055,349056,2,3,0
99774,4,1,349057,349057,349058,0,1,1
99775,2,2,349059,349059,349061,0,2,1
99776,5,1,349064,349064,349065,0,1,3
99777,2,1,349066,349066,349067,0,1,1
99778,4,3,349070,349070,349073,0,3,3
99779,1,1,349071,349073,349074,2,3,0
99780,3,3,349074,349074,349077,0,3,0
99781,4,2,349078,349078,349080,0,2,1
99782,3,3,349081,349081,349084,0,3,1
99783,1,2,349082,349084,349086,2,4,0
99784,1,3,349083,349086,349089,3,6,0
99785,3,3,349086,349089,349092,3,6,0
99786,1,1,349087,349092,349093,5,6,0
99787,3,3,349090,349093,349096,3,6,0
99788,4,2,349094,349096,349098,2,4,0
99789,4,3,349098,349098,349101,0,3,0
99790,1,2,349099,349101,349103,2,4,0
99791,3,3,349102,349103,349106,1,4,0
99792,2,1,349104,349106,349107,2,3,0
99793,5,2,349109,349109,349111,0,2,2
99794,3,3,349112,349112,349115,0,3,1
99795,3,2,349115,349115,349117,0,2,0
99796,3,3,349118,349118,349121,0,3,1
99797,6,2,349124,349124,349126,0,2,3
99798,6,3,349130,349130,349133,0,3,4
99799,6,2,349136,349136,349138,0,2,3
99800,4,1,349140,349140,349141,0,1,2
99801,4,2,349144,349144,349146,0,2,3
99802,1,3,349145,349146,349149,1,4,0
99803,5,2,349150,349150,349152,0,2,1
99804,6,2,349156,349156,349158,0,2,4
99805,5,3,349161,349161,349164,0,3,3
99806,2,3,349163,349164,349167,1,4,0
99807,2,1,349165,349167,349168,2,3,0
99808,5,3,349170,349170,349173,0,3,2
99809,3,3,349173,349173,349176,0,3,0
99810,4,1,349177,349177,349178,0,1,1
99811,3,1,349180,349180,349181,0,1,2
99812,5,2,349185,349185,349187,0,2,4
99813,1,3,349186,349187,349190,1,4,0
99814,2,1,349188,349190,349191,2,3,0
99815,6,1,349194,349194,349195,0,1,3
99816,3,1,349197,349197,349198,0,1,2
99817,2,1,349199,349199,349200,0,1,1
99818,1,1,349200,349200,349201,0,1,0
99819,5,3,349205,349205,349208,0,3,4
99820,3,3,349208,349208,349211,0,3,0
99821,6,1,349214,349214,349215,0,1,3
99822,5,1,349219,349219,349220,0,1,4
99823,3,2,349222,349222,349224,0,2,2
99824,3,2,349225,349225,349227,0,2,1
99825,4,1,349229,349229,349230,0,1,2
99826,5,2,349234,349234,349236,0,2,4
99827,3,2,349237,349237,349239,0,2,1
99828,6,1,349243,349243,349244,0,1,4
99829,2,3,349245,349245,349248,0,3,1
99830,1,3,349246,349248,349251,2,5,0
99831,2,3,349248,349251,349254,3,6,0
99832,3,3,349251,349254,349257,3,6,0
99833,1,3,349252,349257,349260,5,8,0
99834,6,3,349258,349260,349263,2,5,0
99835,4,1,349262,349263,349264,1,2,0
99836,3,2,349265,349265,349267,0,2,1
99837,4,3,349269,349269,349272,0,3,2
99838,1,2,349270,349272,349274,2,4,0
99839,5,1,349275,349275,349276,0,1,1
99840,6,3,349281,349281,349284,0,3,5
99841,2,1,349283,349284,349285,1,2,0
99842,5,1,349288,349288,349289,0,1,3
99843,5,3,349293,349293,349296,0,3,4
99844,1,3,349294,349296,349299,2,5,0
99845,3,3,349297,349299,349302,2,5,0
99846,4,1,349301,349302,349303,1,2,0
99847,1,3,349302,349303,349306,1,4,0
99848,4,3,349306,349306,349309,0,3,0
99849,3,3,349309,349309,349312,0,3,0
99850,2,1,349311,349312,349313,1,2,0
99851,2,3,349313,349313,349316,0,3,0
99852,4,2,349317,349317,349319,0,2,1
99853,4,2,349321,349321,349323,0,2,2
99854,3,2,349324,349324,349326,0,2,1
99855,4,3,349328,349328,349331,0,3,2
99856,4,1,349332,349332,349333,0,1,1
99857,4,1,349336,349336,349337,0,1,3
99858,1,3,349337,349337,349340,0,3,0
99859,5,2,349342,349342,349344,0,2,2
99860,6,1,349348,349348,349349,0,1,4
99861,4,1,349352,349352,349353,0,1,3
99862,2,2,349354,349354,349356,0,2,1
99863,6,1,349360,349360,349361,0,1,4
99864,2,2,349362,349362,349364,0,2,1
99865,6,3,349368,349368,349371,0,3,4
99866,5,1,349373,349373,349374,0,1,2
99867,2,1,349375,349375,349376,0,1,1
99868,3,2,349378,349378,349380,0,2,2
99869,4,1,349382,349382,349383,0,1,2
99870,1,2,349383,349383,349385,0,2,0
99871,6,2,349389,349389,349391,0,2,4
99872,4,2,349393,349393,349395,0,2,2
99873,3,2,349396,349396,349398,0,2,1
99874,4,3,349400,349400,349403,0,3,2
99875,4,1,349404,349404,349405,0,1,1
99876,1,2,349405,349405,349407,0,2,0
99877,2,2,349407,349407,349409,0,2,0
99878,4,3,349411,349411,349414,0,3,2
99879,3,2,349414,349414,349416,0,2,0
99880,5,3,349419,349419,349422,0,3,3
99881,1,1,349420,349422,349423,2,3,0
99882,1,1,349421,349423,349424,2,3,0
99883,6,3,349427,349427,349430,0,3,3
99884,2,2,349429,349430,349432,1,3,0
99885,4,1,349433,349433,349434,0,1,1
99886,2,3,349435,349435,349438,0,3,1
99887,5,1,349440,349440,349441,0,1,2
99888,1,3,349441,349441,349444,0,3,0
99889,2,2,349443,349444,349446,1,3,0
99890,6,2,349449,349449,349451,0,2,3
99891,1,1,349450,349451,349452,1,2,0
99892,6,1,349456,349456,349457,0,1,4
99893,6,3,349462,349462,349465,0,3,5
99894,6,3,349468,349468,349471,0,3,3
99895,4,1,349472,349472,349473,0,1,1
99896,3,2,349475,349475,349477,0,2,2
99897,3,1,349478,349478,349479,0,1,1
99898,3,3,349481,349481,349484,0,3,2
99899,2,1,349483,349484,349485,1,2,0
99900,1,2,349484,349485,349487,1,3,0
99901,2,2,349486,349487,349489,1,3,0
99902,3,1,349489,349489,349490,0,1,0
99903,6,2,349495,349495,349497,0,2,5
99904,4,2,349499,349499,349501,0,2,2
99905,3,2,349502,349502,349504,0,2,1
99906,3,1,349505,349505,349506,0,1,1
99907,5,1,349510,349510,349511,0,1,4
99908,6,3,349516,349516,349519,0,3,5
99909,4,3,349520,349520,349523,0,3,1
99910,3,3,349523,349523,349526,0,3,0
99911,1,1,349524,349526,349527,2,3,0
99912,2,3,349526,349527,349530,1,4,0
99913,4,2,349530,349530,349532,0,2,0
99914,3,3,349533,349533,349536,0,3,1
99915,6,3,349539,349539,349542,0,3,3
99916,2,1,349541,349542,349543,1,2,0
99917,1,3,349542,349543,349546,1,4,0
99918,3,2,349545,349546,349548,1,3,0
99919,6,2,349551,349551,349553,0,2,3
99920,2,2,349553,349553,349555,0,2,0
99921,1,1,349554,349555,349556,1,2,0
99922,2,2,349556,349556,349558,0,2,0
99923,6,3,349562,349562,349565,0,3,4
99924,3,2,349565,349565,349567,0,2,0
99925,1,2,349566,349567,349569,1,3,0
99926,5,2,349571,349571,349573,0,2,2
99927,1,1,349572,349573,349574,1,2,0
99928,6,1,349578,349578,349579,0,1,4
99929,4,3,349582,349582,349585,0,3,3
99930,6,1,349588,349588,349589,0,1,3
99931,6,1,349594,349594,349595,0,1,5
99932,1,2,349595,349595,349597,0,2,0
99933,2,3,349597,349597,349600,0,3,0
99934,3,1,349600,349600,349601,0,1,0
99935,6,2,349606,349606,349608,0,2,5
99936,2,1,349608,349608,349609,0,1,0
99937,2,2,349610,349610,349612,0,2,1
99938,2,1,349612,349612,349613,0,1,0
99939,3,3,349615,349615,349618,0,3,2
99940,2,2,349617,349618,349620,1,3,0
99941,6,3,349623,349623,349626,0,3,3
99942,4,2,349627,349627,349629,0,2,1
99943,3,2,349630,349630,349632,0,2,1
99944,6,3,349636,349636,349639,0,3,4
99945,1,2,349637,349639,349641,2,4,0
99946,2,1,349639,349641,349642,2,3,0
99947,1,2,349640,349642,349644,2,4,0
99948,6,2,349646,349646,349648,0,2,2
99949,5,2,349651,349651,349653,0,2,3
99950,3,3,349654,349654,349657,0,3,1
99951,6,1,349660,349660,349661,0,1,3
99952,2,1,349662,349662,349663,0,1,1
99953,2,3,349664,349664,349667,0,3,1
99954,5,2,349669,349669,349671,0,2,2
99955,6,3,349675,349675,349678,0,3,4
99956,1,2,349676,349678,349680,2,4,0
99957,2,2,349678,349680,349682,2,4,0
99958,5,3,349683,349683,349686,0,3,1
99959,6,3,349689,349689,349692,0,3,3
99960,1,3,349690,349692,349695,2,5,0
99961,4,1,349694,349695,349696,1,2,0
99962,5,2,349699,349699,349701,0,2,3
99963,5,3,349704,349704,349707,0,3,3
99964,1,3,349705,349707,349710,2,5,0
99965,3,1,349708,349710,349711,2,3,0
99966,2,1,349710,349711,349712,1,2,0
99967,2,1,349712,349712,349713,0,1,0
99968,4,3,349716,349716,349719,0,3,3
99969,4,2,349720,349720,349722,0,2,1
99970,6,3,349726,349726,349729,0,3,4
99971,2,2,349728,349729,349731,1,3,0
99972,5,2,349733,349733,349735,0,2,2
99973,5,1,349738,349738,349739,0,1,3
99974,4,2,349742,349742,349744,0,2,3
99975,5,3,349747,349747,349750,0,3,3
99976,4,2,349751,349751,349753,0,2,1
99977,6,2,349757,349757,349759,0,2,4
99978,1,1,349758,349759,349760,1,2,0
99979,3,1,349761,349761,349762,0,1,1
99980,1,2,349762,349762,349764,0,2,0
99981,6,2,349768,349768,349770,0,2,4
99982,1,1,349769,349770,349771,1,2,0
99983,1,3,349770,349771,349774,1,4,0
99984,2,1,349772,349774,349775,2,3,0
99985,1,2,349773,349775,349777,2,4,0
99986,5,2,349778,349778,349780,0,2,1
99987,6,2,349784,349784,349786,0,2,4
99988,4,3,349788,349788,349791,0,3,2
99989,4,2,349792,349792,349794,0,2,1
99990,1,2,349793,349794,349796,1,3,0
99991,3,1,349796,349796,349797,0,1,0
99992,1,1,349797,349797,349798,0,1,0
99993,1,2,349798,349798,349800,0,2,0
99994,4,1,349802,349802,349803,0,1,2
99995,3,3,349805,349805,349808,0,3,2
99996,5,1,349810,349810,349811,0,1,2
99997,6,2,349816,349816,349818,0,2,5
99998,6,2,349822,349822,349824,0,2,4
99999,3,1,349825,349825,349826,0,1,1
